rk,player,nation,squad,comp,season,age,born,ninety_mins_played,tackles,tackles_won,def_third_tackles,mid_third_tackles,att_third_tackles,dribblers_tackled,dribblers_challenged,tackle_pct,challenges_lost,blocks,shots_blocked,passes_blocked,interceptions,tackles_interceptions,clearances,errors,position,age_range,general_position,country,continent
3,Yunis Abdelhamid,MAR,Reims,Ligue 1,2020,32.0,1987.0,32.1,59,37,36,23,0,26,42,61.9,16,34,15,19,61,120,132,0,DF,30-34,Defender,Morocco,Africa
4,Sabit Abdulai,GHA,Getafe,La Liga,2020,21.0,1999.0,0.7,2,0,1,1,0,1,3,33.3,2,0,0,0,0,2,0,0,MF,20-24,Midfielder,Ghana,Africa
6,Laurent Abergel,FRA,Lorient,Ligue 1,2020,27.0,1993.0,32.9,145,84,64,69,12,54,162,33.3,108,64,6,58,46,191,12,0,MF,25-29,Midfielder,France,Europe
7,Charles Abi,FRA,Saint-Étienne,Ligue 1,2020,20.0,2000.0,10.1,8,2,5,0,3,3,12,25.0,9,6,2,4,4,12,5,0,"FW,MF",20-24,Forward,France,Europe
10,David Abraham,ARG,Eint Frankfurt,Bundesliga,2020,34.0,1986.0,13.6,18,12,13,3,2,11,17,64.7,6,13,4,9,17,35,34,0,DF,30-34,Defender,Argentina,South America
11,Tammy Abraham,ENG,Chelsea,Premier League,2020,22.0,1997.0,11.6,7,5,3,3,1,1,7,14.3,6,6,0,6,5,12,17,0,FW,20-24,Forward,England,Europe
12,Amir Abrashi,ALB,Freiburg,Bundesliga,2020,30.0,1990.0,0.7,1,1,1,0,0,0,0,,0,1,1,0,2,3,1,0,"MF,DF",30-34,Midfielder,Albania,Europe
13,Gennaro Acampora,ITA,Spezia,Serie A,2020,26.0,1994.0,4.9,6,4,1,4,1,2,7,28.6,5,4,1,3,4,10,4,0,"MF,FW",25-29,Midfielder,Italy,Europe
14,Francesco Acerbi,ITA,Lazio,Serie A,2020,32.0,1988.0,31.3,51,32,34,13,4,18,40,45.0,22,24,15,9,76,127,121,2,DF,30-34,Defender,Italy,Europe
15,Ragnar Ache,GER,Eint Frankfurt,Bundesliga,2020,22.0,1998.0,1.1,2,0,0,1,1,0,0,,0,1,0,1,1,3,1,0,"FW,DF",20-24,Forward,Germany,Europe
16,Marcos Acuña,ARG,Sevilla,La Liga,2020,28.0,1991.0,25.9,62,42,34,20,8,23,41,56.1,18,23,2,21,23,85,30,1,DF,25-29,Defender,Argentina,South America
18,Tyler Adams,USA,RB Leipzig,Bundesliga,2020,21.0,1999.0,20.6,35,24,12,15,8,17,31,54.8,14,22,5,17,29,64,30,0,"MF,DF",20-24,Midfielder,United States,North America
19,Sargis Adamyan,ARM,Hoffenheim,Bundesliga,2020,27.0,1993.0,5.3,9,4,4,3,2,7,14,50.0,7,2,0,2,6,15,1,0,"FW,MF",25-29,Forward,Armenia,Asia
20,Tosin Adarabioyo,ENG,Fulham,Premier League,2020,22.0,1997.0,32.8,37,19,30,6,1,19,40,47.5,21,26,20,6,42,79,197,2,DF,20-24,Defender,England,Europe
22,Yacine Adli,FRA,Bordeaux,Ligue 1,2020,20.0,2000.0,26.9,74,37,30,33,11,35,92,38.0,57,27,2,25,39,113,17,2,MF,20-24,Midfielder,France,Europe
23,Andrea Adorante,ITA,Parma,Serie A,2020,20.0,2000.0,0.1,0,0,0,0,0,0,0,,0,0,0,0,0,0,0,0,FW,20-24,Forward,Italy,Europe
27,Felix Agu,GER,Werder Bremen,Bundesliga,2020,20.0,1999.0,7.8,20,9,10,9,1,10,18,55.6,8,14,3,11,12,32,18,0,DF,20-24,Defender,Germany,Europe
28,Kevin Agudelo,COL,Spezia,Serie A,2020,21.0,1998.0,15.1,39,28,9,15,15,12,34,35.3,22,30,0,30,10,49,2,0,FW,20-24,Forward,Colombia,South America
29,Nayef Aguerd,MAR,Rennes,Ligue 1,2020,24.0,1996.0,35.0,37,30,28,9,0,21,33,63.6,12,34,22,12,47,84,102,0,DF,20-24,Defender,Morocco,Africa
30,Sergio Agüero,ARG,Manchester City,Premier League,2020,32.0,1988.0,6.2,4,1,0,2,2,2,11,18.2,9,2,0,2,2,6,0,0,FW,30-34,Forward,Argentina,South America
31,Ruben Aguilar,FRA,Monaco,Ligue 1,2020,27.0,1993.0,24.7,63,37,32,21,10,32,52,61.5,20,30,3,27,47,110,43,1,"DF,MF",25-29,Defender,France,Europe
34,Jean-Eudes Aholou,CIV,Strasbourg,Ligue 1,2020,26.0,1994.0,23.8,46,25,18,25,3,19,48,39.6,29,17,5,12,53,99,32,0,MF,25-29,Midfielder,Ivory Coast,Africa
35,Jean-Eudes Aholou,CIV,Monaco,Ligue 1,2020,26.0,1994.0,0.4,1,0,0,1,0,1,3,33.3,2,0,0,0,1,2,1,0,MF,25-29,Midfielder,Ivory Coast,Africa
36,Joseph Aidoo,GHA,Celta Vigo,La Liga,2020,24.0,1995.0,14.3,26,17,17,9,0,12,21,57.1,9,7,4,3,25,51,88,1,DF,20-24,Defender,Ghana,Africa
37,Ola Aina,NGA,Fulham,Premier League,2020,23.0,1996.0,29.6,37,20,22,7,8,21,43,48.8,22,22,6,16,45,82,94,2,DF,20-24,Defender,Nigeria,Africa
38,Rayan Aït-Nouri,ALG,Wolves,Premier League,2020,19.0,2001.0,15.6,29,16,18,10,1,13,27,48.1,14,14,1,13,15,44,25,0,DF,Under 20,Defender,Algeria,Africa
39,Rayan Aït-Nouri,ALG,Angers,Ligue 1,2020,19.0,2001.0,2.1,3,2,1,2,0,3,5,60.0,2,2,1,1,4,7,1,0,DF,Under 20,Defender,Algeria,Africa
40,Semi Ajayi,NGA,West Brom,Premier League,2020,26.0,1993.0,30.9,40,14,34,6,0,23,41,56.1,18,51,32,19,42,82,122,2,DF,25-29,Defender,Nigeria,Africa
41,Ludovic Ajorque,FRA,Strasbourg,Ligue 1,2020,26.0,1994.0,33.0,30,18,6,18,6,7,31,22.6,24,14,5,9,11,41,54,0,FW,25-29,Forward,France,Europe
42,Manuel Akanji,SUI,Dortmund,Bundesliga,2020,25.0,1995.0,26.1,41,22,23,12,6,19,31,61.3,12,23,10,13,49,90,70,1,DF,25-29,Defender,Switzerland,Europe
43,Carlos Akapo,EQG,Cádiz,La Liga,2020,27.0,1993.0,9.6,18,14,14,4,0,10,18,55.6,8,16,3,13,19,37,33,0,DF,25-29,Defender,Equatorial Guinea,Africa
44,Marley Aké,FRA,Marseille,Ligue 1,2020,19.0,2001.0,1.6,3,3,1,0,2,0,1,0.0,1,2,0,2,0,3,1,0,FW,Under 20,Forward,France,Europe
45,Nathan Aké,NED,Manchester City,Premier League,2020,25.0,1995.0,8.9,10,5,3,6,1,3,4,75.0,1,2,1,1,9,19,23,0,DF,25-29,Defender,Netherlands,Europe
46,Paul Akouokou,CIV,Betis,La Liga,2020,22.0,1997.0,4.2,11,8,2,8,1,5,8,62.5,3,3,1,2,6,17,7,0,MF,20-24,Midfielder,Ivory Coast,Africa
48,Kevin Akpoguma,NGA,Hoffenheim,Bundesliga,2020,25.0,1995.0,13.2,18,12,11,6,1,8,14,57.1,6,28,15,13,13,31,32,2,DF,25-29,Defender,Nigeria,Africa
49,David Alaba,AUT,Bayern Munich,Bundesliga,2020,28.0,1992.0,29.7,37,21,14,19,4,17,32,53.1,15,29,13,16,43,80,60,0,"DF,MF",25-29,Defender,Austria,Europe
50,Sofiane Alakouch,MAR,Nîmes,Ligue 1,2020,22.0,1998.0,16.7,53,33,30,16,7,29,45,64.4,16,17,2,15,21,74,38,0,DF,20-24,Defender,Morocco,Africa
52,Lucas Alario,ARG,Leverkusen,Bundesliga,2020,27.0,1992.0,13.8,8,2,2,5,1,2,4,50.0,2,9,1,8,2,10,10,0,FW,25-29,Forward,Argentina,South America
56,Marc Albrighton,ENG,Leicester City,Premier League,2020,30.0,1989.0,19.4,33,19,14,15,4,16,45,35.6,29,29,3,26,17,50,27,1,"DF,FW",30-34,Defender,England,Europe
61,Omar Alderete,PAR,Hertha BSC,Bundesliga,2020,23.0,1996.0,14.4,16,10,11,5,0,7,16,43.8,9,14,10,4,21,37,61,1,DF,20-24,Defender,Paraguay,South America
67,Trent Alexander-Arnold,ENG,Liverpool,Premier League,2020,21.0,1998.0,33.7,56,33,31,18,7,36,56,64.3,20,24,3,21,49,105,50,3,DF,20-24,Defender,England,Europe
71,Rachid Alioui,MAR,Angers,Ligue 1,2020,28.0,1992.0,0.2,0,0,0,0,0,0,1,0.0,1,0,0,0,0,0,0,0,FW,25-29,Forward,Morocco,Africa
72,Alisson,BRA,Liverpool,Premier League,2020,27.0,1992.0,33.0,3,2,3,0,0,3,4,75.0,1,0,0,0,2,5,26,7,GK,25-29,Goalkeeper,Brazil,South America
72,Alisson,BRA,Liverpool,Premier League,2020,27.0,1992.0,33.0,3,2,3,0,0,3,4,75.0,1,0,0,0,2,5,26,7,GK,25-29,Goalkeeper,Brazil,South America
72,Alisson,BRA,Liverpool,Premier League,2020,27.0,1992.0,33.0,3,2,3,0,0,3,4,75.0,1,0,0,0,2,5,26,7,GK,25-29,Goalkeeper,Brazil,South America
72,Alisson,BRA,Liverpool,Premier League,2020,27.0,1992.0,33.0,3,2,3,0,0,3,4,75.0,1,0,0,0,2,5,26,7,GK,25-29,Goalkeeper,Brazil,South America
73,Saturnin Allagbé,BEN,Dijon,Ligue 1,2020,26.0,1993.0,12.0,0,0,0,0,0,0,1,0.0,1,0,0,0,0,0,9,3,GK,25-29,Goalkeeper,Benin,Africa
74,Allan,BRA,Everton,Premier League,2020,29.0,1991.0,22.8,80,45,39,37,4,28,95,29.5,67,31,12,19,19,99,25,1,MF,25-29,Midfielder,Brazil,South America
74,Allan,BRA,Everton,Premier League,2020,29.0,1991.0,22.8,80,45,39,37,4,28,95,29.5,67,31,12,19,19,99,25,1,MF,25-29,Midfielder,Brazil,South America
74,Allan,BRA,Everton,Premier League,2020,29.0,1991.0,22.8,80,45,39,37,4,28,95,29.5,67,31,12,19,19,99,25,1,MF,25-29,Midfielder,Brazil,South America
74,Allan,BRA,Everton,Premier League,2020,29.0,1991.0,22.8,80,45,39,37,4,28,95,29.5,67,31,12,19,19,99,25,1,MF,25-29,Midfielder,Brazil,South America
75,Dele Alli,ENG,Tottenham,Premier League,2020,24.0,1996.0,6.9,18,11,8,6,4,7,19,36.8,12,9,0,9,7,25,3,0,MF,20-24,Midfielder,England,Europe
76,Miguel Almirón,PAR,Newcastle Utd,Premier League,2020,26.0,1994.0,27.0,49,29,21,25,3,14,56,25.0,42,23,4,19,25,74,20,1,"MF,FW",25-29,Midfielder,Paraguay,South America
81,Steven Alzate,COL,Brighton,Premier League,2020,21.0,1998.0,10.0,17,8,10,4,3,6,15,40.0,9,8,1,7,8,25,10,0,MF,20-24,Midfielder,Colombia,South America
82,Ibrahim Amadou,FRA,Angers,Ligue 1,2020,27.0,1993.0,16.7,39,26,18,19,2,15,38,39.5,23,14,4,10,23,62,25,0,MF,25-29,Midfielder,France,Europe
83,Romain Amalfitano,FRA,Dijon,Ligue 1,2020,30.0,1989.0,1.3,4,2,3,1,0,1,3,33.3,2,2,1,1,1,5,1,0,"FW,DF",30-34,Forward,France,Europe
86,Jordan Amavi,FRA,Marseille,Ligue 1,2020,26.0,1994.0,9.0,11,9,9,1,1,9,12,75.0,3,12,2,10,27,38,33,1,DF,25-29,Defender,France,Europe
89,Nadiem Amiri,GER,Leverkusen,Bundesliga,2020,23.0,1996.0,21.0,12,7,4,8,0,7,33,21.2,26,18,3,15,12,24,7,0,MF,20-24,Midfielder,Germany,Europe
90,Ethan Ampadu,WAL,Sheffield Utd,Premier League,2020,19.0,2000.0,23.2,57,36,31,24,2,20,46,43.5,26,40,19,21,49,106,87,3,"DF,MF",Under 20,Defender,Wales,Europe
93,Joachim Andersen,DEN,Fulham,Premier League,2020,24.0,1996.0,30.3,33,19,18,11,4,15,28,53.6,13,24,13,11,44,77,151,1,DF,20-24,Defender,Denmark,Europe
94,Joachim Andersen,DEN,Lyon,Ligue 1,2020,24.0,1996.0,2.1,2,1,1,1,0,2,2,100.0,0,1,1,0,2,4,6,0,DF,20-24,Defender,Denmark,Europe
95,Djavan Anderson,NED,Lazio,Serie A,2020,25.0,1995.0,0.8,0,0,0,0,0,0,1,0.0,1,1,0,1,1,1,0,0,DF,25-29,Defender,Netherlands,Europe
97,Felipe Anderson,BRA,West Ham,Premier League,2020,27.0,1993.0,0.0,1,1,0,1,0,0,0,,0,0,0,0,0,1,0,0,"FW,MF",25-29,Forward,Brazil,South America
98,Sebastian Andersson,SWE,Köln,Bundesliga,2020,29.0,1991.0,12.5,3,2,0,3,0,1,8,12.5,7,10,3,7,2,5,9,0,FW,25-29,Forward,Sweden,Europe
100,Benjamin André,FRA,Lille,Ligue 1,2020,29.0,1990.0,32.1,114,68,47,61,6,53,122,43.4,69,39,10,29,76,190,49,0,MF,25-29,Midfielder,France,Europe
101,Marcos André,BRA,Valladolid,La Liga,2020,23.0,1996.0,13.1,8,2,2,2,4,0,8,0.0,8,15,2,13,2,10,9,0,FW,20-24,Forward,Brazil,South America
101,Marcos André,BRA,Valladolid,La Liga,2020,23.0,1996.0,13.1,8,2,2,2,4,0,8,0.0,8,15,2,13,2,10,9,0,FW,20-24,Forward,Brazil,South America
101,Marcos André,BRA,Valladolid,La Liga,2020,23.0,1996.0,13.1,8,2,2,2,4,0,8,0.0,8,15,2,13,2,10,9,0,FW,20-24,Forward,Brazil,South America
101,Marcos André,BRA,Valladolid,La Liga,2020,23.0,1996.0,13.1,8,2,2,2,4,0,8,0.0,8,15,2,13,2,10,9,0,FW,20-24,Forward,Brazil,South America
102,Robert Andrich,GER,Union Berlin,Bundesliga,2020,25.0,1994.0,28.1,51,24,22,27,2,24,53,45.3,29,40,6,34,51,102,31,2,MF,25-29,Midfielder,Germany,Europe
110,Cristian Ansaldi,ARG,Torino,Serie A,2020,33.0,1986.0,21.6,48,33,25,14,9,24,38,63.2,14,21,7,14,16,64,38,0,"DF,FW",30-34,Defender,Argentina,South America
111,Waldemar Anton,GER,Stuttgart,Bundesliga,2020,24.0,1996.0,30.1,31,20,17,14,0,12,31,38.7,19,28,18,10,47,78,114,0,DF,20-24,Defender,Germany,Europe
112,Michail Antonio,JAM,West Ham,Premier League,2020,30.0,1990.0,21.9,7,4,1,5,1,1,7,14.3,6,20,3,17,7,14,7,0,FW,30-34,Forward,Jamaica,North America
114,Valentin Antov,BUL,Bologna,Serie A,2020,19.0,2000.0,2.6,4,2,3,1,0,3,10,30.0,7,6,5,1,4,8,13,0,DF,Under 20,Defender,Bulgaria,Europe
115,Houssem Aouar,ALG,Lyon,Ligue 1,2020,22.0,1998.0,19.8,17,12,0,13,4,8,25,32.0,17,17,1,16,17,34,4,0,"MF,FW",20-24,Midfielder,Algeria,Africa
116,Adil Aouchiche,FRA,Saint-Étienne,Ligue 1,2020,18.0,2002.0,19.2,38,20,12,17,9,13,49,26.5,36,15,1,14,10,48,6,0,"MF,FW",Under 20,Midfielder,France,Europe
117,Dennis Appiah,FRA,Nantes,Ligue 1,2020,28.0,1992.0,17.3,55,34,33,15,7,32,59,54.2,27,23,6,17,25,80,43,0,DF,25-29,Defender,France,Europe
119,Mauro Arambarri,URU,Getafe,La Liga,2020,24.0,1995.0,33.1,64,39,22,35,7,23,80,28.8,57,40,5,35,42,106,28,0,MF,20-24,Midfielder,Uruguay,South America
120,Charles Aránguiz,CHI,Leverkusen,Bundesliga,2020,31.0,1989.0,18.5,41,23,16,21,4,17,43,39.5,26,32,4,28,33,74,17,0,MF,30-34,Midfielder,Chile,South America
121,Luiz Araújo,BRA,Lille,Ligue 1,2020,24.0,1996.0,16.6,38,25,12,18,8,8,28,28.6,20,23,1,22,11,49,3,0,MF,20-24,Midfielder,Brazil,South America
125,Alphonse Areola,FRA,Fulham,Premier League,2020,27.0,1993.0,36.0,1,0,1,0,0,1,5,20.0,4,0,0,0,1,2,13,3,GK,25-29,Goalkeeper,France,Europe
126,Santiago Arias,COL,Leverkusen,Bundesliga,2020,28.0,1992.0,1.0,2,1,0,1,1,1,1,100.0,0,0,0,0,1,3,4,0,DF,25-29,Defender,Colombia,South America
127,Karim Aribi,ALG,Nîmes,Ligue 1,2020,26.0,1994.0,3.3,2,2,0,1,1,0,5,0.0,5,1,0,1,0,2,3,0,FW,25-29,Forward,Algeria,Africa
129,Nicolò Armini,ITA,Lazio,Serie A,2020,19.0,2001.0,0.1,0,0,0,0,0,0,0,,0,0,0,0,0,0,0,0,DF,Under 20,Defender,Italy,Europe
130,Stuart Armstrong,SCO,Southampton,Premier League,2020,28.0,1992.0,30.7,60,41,19,32,9,27,75,36.0,48,26,1,25,24,84,19,0,MF,25-29,Midfielder,Scotland,Europe
131,Maximilian Arnold,GER,Wolfsburg,Bundesliga,2020,26.0,1994.0,28.7,47,32,20,26,1,18,49,36.7,31,24,3,21,49,96,57,0,MF,25-29,Midfielder,Germany,Europe
135,Tolgay Arslan,GER,Udinese,Serie A,2020,29.0,1990.0,20.2,52,32,24,24,4,25,54,46.3,29,22,2,20,22,74,15,1,MF,25-29,Midfielder,Germany,Europe
136,Kwadwo Asamoah,GHA,Cagliari,Serie A,2020,31.0,1988.0,2.5,4,3,2,2,0,2,3,66.7,1,5,1,4,4,8,2,1,"DF,MF",30-34,Defender,Ghana,Africa
137,Santiago Ascacíbar,ARG,Hertha BSC,Bundesliga,2020,23.0,1997.0,8.5,30,15,15,14,1,15,28,53.6,13,23,2,21,13,43,14,0,MF,20-24,Midfielder,Argentina,South America
142,Roger Assalé,CIV,Dijon,Ligue 1,2020,26.0,1993.0,9.2,10,8,3,5,2,4,12,33.3,8,7,3,4,2,12,2,0,"FW,MF",25-29,Forward,Ivory Coast,Africa
145,Pierre-Emerick Aubameyang,GAB,Arsenal,Premier League,2020,31.0,1989.0,25.9,12,8,7,4,1,3,20,15.0,17,18,0,18,7,19,17,0,FW,30-34,Forward,Gabon,Africa
146,Emil Audero,ITA,Sampdoria,Serie A,2020,23.0,1997.0,37.0,1,1,1,0,0,1,2,50.0,1,0,0,0,1,2,16,0,GK,20-24,Goalkeeper,Italy,Europe
147,Tommaso Augello,ITA,Sampdoria,Serie A,2020,25.0,1994.0,35.7,42,30,27,10,5,23,39,59.0,16,22,2,20,32,74,76,1,DF,25-29,Defender,Italy,Europe
148,Jean-Kévin Augustin,FRA,Nantes,Ligue 1,2020,23.0,1997.0,0.4,2,0,0,2,0,2,2,100.0,0,0,0,0,0,2,0,0,FW,20-24,Forward,France,Europe
150,Serge Aurier,CIV,Tottenham,Premier League,2020,27.0,1992.0,17.8,55,33,33,17,5,15,40,37.5,25,28,5,23,19,74,44,3,DF,25-29,Defender,Ivory Coast,Africa
151,Charlie Austin,ENG,West Brom,Premier League,2020,31.0,1989.0,1.5,4,2,1,2,1,1,3,33.3,2,0,0,0,3,7,4,0,"FW,MF",30-34,Forward,England,Europe
153,Taiwo Awoniyi,NGA,Union Berlin,Bundesliga,2020,22.0,1997.0,15.1,5,3,2,3,0,1,14,7.1,13,9,0,9,3,8,4,0,FW,20-24,Forward,Nigeria,Africa
155,Jordan Ayew,GHA,Crystal Palace,Premier League,2020,28.0,1991.0,23.3,38,26,8,16,14,16,44,36.4,28,28,2,26,16,54,12,0,"FW,MF",25-29,Forward,Ghana,Africa
157,Luke Ayling,ENG,Leeds United,Premier League,2020,28.0,1991.0,37.8,108,61,69,30,9,49,87,56.3,38,53,36,17,36,144,96,5,DF,25-29,Defender,England,Europe
158,Ramon Azeez,NGA,Granada,La Liga,2020,27.0,1992.0,1.1,1,1,0,1,0,0,0,,0,0,0,0,1,2,1,0,MF,25-29,Midfielder,Nigeria,Africa
161,Carlos Bacca,COL,Villarreal,La Liga,2020,33.0,1986.0,8.7,9,5,5,3,1,3,5,60.0,2,5,0,5,3,12,2,0,FW,30-34,Forward,Colombia,South America
163,Milan Badelj,CRO,Genoa,Serie A,2020,31.0,1989.0,26.8,56,27,27,22,7,26,84,31.0,58,51,10,41,87,143,45,1,MF,30-34,Midfielder,Croatia,Europe
165,Benoît Badiashile,FRA,Monaco,Ligue 1,2020,19.0,2001.0,31.9,24,17,15,9,0,13,28,46.4,15,21,12,9,58,82,102,4,DF,Under 20,Defender,France,Europe
169,Leon Bailey,JAM,Leverkusen,Bundesliga,2020,22.0,1997.0,23.8,14,8,3,7,4,4,15,26.7,11,13,0,13,9,23,3,0,"FW,MF",20-24,Forward,Jamaica,North America
170,Eric Bailly,CIV,Manchester Utd,Premier League,2020,26.0,1994.0,10.2,5,5,3,1,1,0,1,0.0,1,13,11,2,13,18,36,2,DF,25-29,Defender,Ivory Coast,Africa
171,Stefan Bajic,FRA,Saint-Étienne,Ligue 1,2020,18.0,2001.0,1.0,0,0,0,0,0,0,0,,0,0,0,0,0,0,1,0,GK,Under 20,Goalkeeper,France,Europe
173,Mitchel Bakker,NED,Paris S-G,Ligue 1,2020,20.0,2000.0,18.8,38,30,15,14,9,17,26,65.4,9,22,2,20,22,60,20,0,DF,20-24,Defender,Netherlands,Europe
174,Ridle Baku,GER,Wolfsburg,Bundesliga,2020,22.0,1998.0,29.8,50,31,20,20,10,22,53,41.5,31,54,4,50,40,90,33,1,"FW,DF",20-24,Forward,Germany,Europe
175,Ridle Baku,GER,Mainz 05,Bundesliga,2020,22.0,1998.0,2.0,4,2,3,1,0,2,6,33.3,4,3,1,2,3,7,6,0,DF,20-24,Defender,Germany,Europe
176,Dilane Bakwa,FRA,Bordeaux,Ligue 1,2020,17.0,2002.0,0.6,2,2,1,1,0,0,1,0.0,1,2,0,2,1,3,0,0,"FW,MF",Under 20,Forward,France,Europe
178,Keita Baldé,SEN,Sampdoria,Serie A,2020,25.0,1995.0,13.3,9,6,2,6,1,4,10,40.0,6,10,1,9,0,9,3,0,FW,25-29,Forward,Senegal,Africa
179,George Baldock,GRE,Sheffield Utd,Premier League,2020,27.0,1993.0,31.0,47,34,28,14,5,21,50,42.0,29,26,7,19,25,72,70,1,DF,25-29,Defender,Greece,Europe
180,Gareth Bale,WAL,Tottenham,Premier League,2020,31.0,1989.0,10.2,17,10,4,9,4,7,14,50.0,7,13,2,11,8,25,16,0,FW,30-34,Forward,Wales,Europe
182,Leonardo Balerdi,ARG,Marseille,Ligue 1,2020,21.0,1999.0,18.2,29,18,19,7,3,14,31,45.2,17,17,9,8,28,57,65,3,DF,20-24,Defender,Argentina,South America
183,Fodé Ballo-Touré,SEN,Monaco,Ligue 1,2020,23.0,1997.0,7.4,21,17,9,11,1,6,13,46.2,7,7,0,7,6,27,11,1,DF,20-24,Defender,Senegal,Africa
184,Botond Balogh,HUN,Parma,Serie A,2020,18.0,2002.0,1.8,9,7,9,0,0,2,5,40.0,3,4,3,1,2,11,8,0,DF,Under 20,Defender,Hungary,Europe
185,Abdoulaye Bamba,CIV,Angers,Ligue 1,2020,30.0,1990.0,15.0,27,17,19,7,1,19,28,67.9,9,7,1,6,19,46,34,0,DF,30-34,Defender,Ivory Coast,Africa
186,Jonathan Bamba,CIV,Lille,Ligue 1,2020,24.0,1996.0,33.2,45,23,15,19,11,24,84,28.6,60,24,2,22,24,69,15,0,MF,20-24,Midfielder,Ivory Coast,Africa
188,Patrick Bamford,ENG,Leeds United,Premier League,2020,26.0,1993.0,33.9,21,9,2,11,8,8,27,29.6,19,14,4,10,10,31,37,0,FW,25-29,Forward,England,Europe
189,Mattia Bani,ITA,Genoa,Serie A,2020,26.0,1993.0,10.2,10,5,5,5,0,5,12,41.7,7,16,11,5,27,37,44,0,DF,25-29,Defender,Italy,Europe
190,Mattia Bani,ITA,Parma,Serie A,2020,26.0,1993.0,12.7,20,11,15,4,1,4,8,50.0,4,10,6,4,33,53,50,0,DF,25-29,Defender,Italy,Europe
193,Federico Barba,ITA,Benevento,Serie A,2020,26.0,1993.0,29.5,31,16,22,8,1,21,35,60.0,14,39,18,21,48,79,94,4,DF,25-29,Defender,Italy,Europe
194,Danilo Barbosa,BRA,Nice,Ligue 1,2020,24.0,1996.0,2.8,6,3,5,1,0,4,6,66.7,2,2,1,1,2,8,11,2,DF,20-24,Defender,Brazil,South America
196,Melvin Bard,FRA,Lyon,Ligue 1,2020,19.0,2000.0,4.8,12,8,7,4,1,6,11,54.5,5,10,2,8,6,18,14,0,DF,Under 20,Defender,France,Europe
198,Phil Bardsley,SCO,Burnley,Premier League,2020,35.0,1985.0,3.0,6,5,4,2,0,3,6,50.0,3,3,1,2,6,12,12,0,DF,35-39,Defender,Scotland,Europe
199,Nicolò Barella,ITA,Inter,Serie A,2020,23.0,1997.0,32.2,58,31,23,29,6,23,72,31.9,49,29,4,25,26,84,14,0,MF,20-24,Midfielder,Italy,Europe
200,Philipp Bargfrede,GER,Werder Bremen,Bundesliga,2020,31.0,1989.0,0.3,0,0,0,0,0,0,0,,0,0,0,0,0,0,3,0,MF,30-34,Midfielder,Germany,Europe
202,Ross Barkley,ENG,Aston Villa,Premier League,2020,26.0,1993.0,17.0,6,2,2,4,0,3,15,20.0,12,9,1,8,5,11,6,1,MF,25-29,Midfielder,England,Europe
203,Ross Barkley,ENG,Chelsea,Premier League,2020,26.0,1993.0,0.5,0,0,0,0,0,0,0,,0,0,0,0,0,0,0,0,"FW,MF",25-29,Forward,England,Europe
204,Aymen Barkok,MAR,Eint Frankfurt,Bundesliga,2020,22.0,1998.0,10.9,29,15,11,9,9,10,31,32.3,21,15,1,14,10,39,9,1,"MF,DF",20-24,Midfielder,Morocco,Africa
205,Ashley Barnes,ENG,Burnley,Premier League,2020,30.0,1989.0,14.8,12,6,2,6,4,3,13,23.1,10,14,2,12,5,17,11,0,FW,30-34,Forward,England,Europe
206,Harvey Barnes,ENG,Leicester City,Premier League,2020,22.0,1997.0,21.6,19,9,11,3,5,5,22,22.7,17,16,3,13,8,27,11,0,"FW,MF",20-24,Forward,England,Europe
209,Antonio Barreca,ITA,Fiorentina,Serie A,2020,25.0,1995.0,0.9,1,0,0,1,0,1,1,100.0,0,0,0,0,0,1,1,0,DF,25-29,Defender,Italy,Europe
213,Musa Barrow,GAM,Bologna,Serie A,2020,21.0,1998.0,32.5,26,10,8,10,8,10,25,40.0,15,37,2,35,11,37,15,0,"FW,MF",20-24,Forward,Gambia,Africa
214,Kyle Bartley,ENG,West Brom,Premier League,2020,29.0,1991.0,28.7,27,16,14,10,3,11,23,47.8,12,50,35,15,38,65,159,1,DF,25-29,Defender,England,Europe
215,Paolo Bartolomei,ITA,Spezia,Serie A,2020,30.0,1989.0,3.6,6,2,3,1,2,4,7,57.1,3,1,0,1,1,7,2,0,MF,30-34,Midfielder,Italy,Europe
217,Daniele Baselli,ITA,Torino,Serie A,2020,28.0,1992.0,4.4,12,7,3,6,3,6,10,60.0,4,2,0,2,9,21,5,0,MF,25-29,Midfielder,Italy,Europe
218,Chris Basham,ENG,Sheffield Utd,Premier League,2020,32.0,1988.0,28.6,69,42,41,23,5,41,67,61.2,26,36,15,21,49,118,105,1,"DF,MF",30-34,Defender,England,Europe
219,Toma Bašić,CRO,Bordeaux,Ligue 1,2020,23.0,1996.0,28.9,33,22,15,16,2,16,58,27.6,42,21,5,16,32,65,42,1,MF,20-24,Midfielder,Croatia,Europe
221,Alessandro Bastoni,ITA,Inter,Serie A,2020,21.0,1999.0,32.5,36,22,13,21,2,17,27,63.0,10,34,16,18,40,76,75,0,DF,20-24,Defender,Italy,Europe
222,Simone Bastoni,ITA,Spezia,Serie A,2020,23.0,1996.0,16.9,50,29,26,22,2,27,52,51.9,25,19,1,18,16,66,31,0,DF,20-24,Defender,Italy,Europe
224,Michy Batshuayi,BEL,Crystal Palace,Premier League,2020,26.0,1993.0,8.1,5,3,1,2,2,1,9,11.1,8,5,1,4,4,9,5,0,FW,25-29,Forward,Belgium,Europe
225,Rodrigo Battaglia,ARG,Alavés,La Liga,2020,29.0,1991.0,27.7,38,16,21,14,3,16,50,32.0,34,30,14,16,29,67,40,1,MF,25-29,Midfielder,Argentina,South America
227,Oliver Baumann,GER,Hoffenheim,Bundesliga,2020,30.0,1990.0,31.0,0,0,0,0,0,0,1,0.0,1,0,0,0,2,2,14,0,GK,30-34,Goalkeeper,Germany,Europe
228,Julian Baumgartlinger,AUT,Leverkusen,Bundesliga,2020,32.0,1988.0,11.9,43,20,14,26,3,16,31,51.6,15,12,0,12,12,55,10,1,MF,30-34,Midfielder,Austria,Europe
229,Christoph Baumgartner,AUT,Hoffenheim,Bundesliga,2020,20.0,1999.0,26.3,44,31,13,24,7,14,51,27.5,37,40,8,32,24,68,24,0,"MF,FW",20-24,Midfielder,Austria,Europe
231,Paul Baysse,FRA,Bordeaux,Ligue 1,2020,32.0,1988.0,29.0,35,18,21,13,1,16,21,76.2,5,33,24,9,52,87,123,1,DF,30-34,Defender,France,Europe
232,Noah Joel Sarenren Bazee,NGA,Augsburg,Bundesliga,2020,23.0,1996.0,0.4,0,0,0,0,0,0,1,0.0,1,0,0,0,1,1,0,0,"FW,MF",20-24,Forward,Nigeria,Africa
235,Sheraldo Becker,SUR,Union Berlin,Bundesliga,2020,25.0,1995.0,12.3,5,4,2,2,1,3,5,60.0,2,4,0,4,6,11,7,0,"FW,MF",25-29,Forward,Suriname,South America
236,Timo Becker,GER,Schalke 04,Bundesliga,2020,23.0,1997.0,18.2,34,23,28,6,0,16,25,64.0,9,18,4,14,22,56,58,0,DF,20-24,Defender,Germany,Europe
238,Donny van de Beek,NED,Manchester Utd,Premier League,2020,23.0,1997.0,5.8,15,10,2,11,2,7,15,46.7,8,10,1,9,6,21,7,0,"MF,FW",20-24,Midfielder,Netherlands,Europe
239,Valon Behrami,SUI,Genoa,Serie A,2020,35.0,1985.0,9.9,21,9,9,10,2,9,26,34.6,17,13,5,8,9,30,13,0,MF,35-39,Midfielder,Switzerland,Europe
240,Brian Behrendt,GER,Arminia,Bundesliga,2020,28.0,1991.0,0.9,0,0,0,0,0,0,1,0.0,1,0,0,0,0,0,1,0,DF,25-29,Defender,Germany,Europe
241,Maximilian Beier,GER,Hoffenheim,Bundesliga,2020,17.0,2002.0,0.1,0,0,0,0,0,0,1,0.0,1,0,0,0,0,0,0,0,"FW,DF",Under 20,Forward,Germany,Europe
242,Ishak Belfodil,ALG,Hoffenheim,Bundesliga,2020,28.0,1992.0,6.6,3,2,0,0,3,0,2,0.0,2,1,0,1,1,4,3,0,"FW,MF",25-29,Forward,Algeria,Africa
244,Haris Belkebla,ALG,Brest,Ligue 1,2020,26.0,1994.0,30.3,69,39,32,28,9,31,66,47.0,35,26,5,21,57,126,34,0,MF,25-29,Midfielder,Algeria,Africa
245,Stefan Bell,GER,Mainz 05,Bundesliga,2020,28.0,1991.0,14.1,24,18,15,9,0,14,23,60.9,9,19,11,8,27,51,76,1,DF,25-29,Defender,Germany,Europe
246,Karim Bellarabi,GER,Leverkusen,Bundesliga,2020,30.0,1990.0,8.9,12,10,3,4,5,4,17,23.5,13,12,0,12,12,24,4,0,"FW,MF",30-34,Forward,Germany,Europe
247,Jean-Ricner Bellegarde,FRA,Strasbourg,Ligue 1,2020,22.0,1998.0,23.2,56,39,22,25,9,14,23,60.9,9,20,2,18,19,75,16,0,"MF,FW",20-24,Midfielder,France,Europe
249,Jude Bellingham,ENG,Dortmund,Bundesliga,2020,17.0,2003.0,18.9,49,31,11,29,9,19,46,41.3,27,37,5,32,24,73,13,0,MF,Under 20,Midfielder,England,Europe
252,Sami Ben Amar,MAR,Nîmes,Ligue 1,2020,22.0,1998.0,0.1,0,0,0,0,0,0,0,,0,1,0,1,0,0,0,0,MF,20-24,Midfielder,Morocco,Africa
253,Hatem Ben Arfa,FRA,Bordeaux,Ligue 1,2020,33.0,1987.0,18.9,11,7,1,7,3,2,9,22.2,7,3,0,3,2,13,0,0,"MF,FW",30-34,Midfielder,France,Europe
255,Wissam Ben Yedder,FRA,Monaco,Ligue 1,2020,29.0,1990.0,29.0,18,9,2,10,6,3,13,23.1,10,16,0,16,13,31,3,0,FW,25-29,Forward,France,Europe
256,Ahmad Benali,LBY,Crotone,Serie A,2020,28.0,1992.0,13.5,19,11,10,9,0,11,38,28.9,27,15,2,13,6,25,15,0,MF,25-29,Midfielder,Libya,Africa
257,Samy Benchamma,FRA,Montpellier,Ligue 1,2020,20.0,2000.0,0.5,1,1,1,0,0,0,0,,0,0,0,0,0,1,1,0,"DF,MF",20-24,Defender,France,Europe
258,Lars Bender,GER,Leverkusen,Bundesliga,2020,31.0,1989.0,10.4,19,13,12,6,1,9,21,42.9,12,19,5,14,16,35,19,0,DF,30-34,Defender,Germany,Europe
259,Sven Bender,GER,Leverkusen,Bundesliga,2020,31.0,1989.0,13.0,17,9,8,8,1,7,20,35.0,13,20,9,11,21,38,41,1,DF,30-34,Defender,Germany,Europe
260,Darío Benedetto,ARG,Marseille,Ligue 1,2020,30.0,1990.0,17.5,6,4,1,4,1,5,13,38.5,8,9,2,7,3,9,17,0,FW,30-34,Forward,Argentina,South America
261,László Bénes,SVK,Augsburg,Bundesliga,2020,22.0,1997.0,7.3,8,6,4,4,0,2,8,25.0,6,6,2,4,7,15,1,1,MF,20-24,Midfielder,Slovakia,Europe
262,László Bénes,SVK,Gladbach,Bundesliga,2020,22.0,1997.0,1.7,6,2,5,1,0,2,4,50.0,2,0,0,0,2,8,1,0,MF,20-24,Midfielder,Slovakia,Europe
264,Loris Benito,SUI,Bordeaux,Ligue 1,2020,28.0,1992.0,29.5,42,26,27,12,3,22,48,45.8,26,33,10,23,42,84,70,0,DF,25-29,Defender,Switzerland,Europe
266,Bilal Benkhedim,FRA,Saint-Étienne,Ligue 1,2020,19.0,2001.0,0.8,0,0,0,0,0,0,1,0.0,1,1,0,1,0,0,0,0,FW,Under 20,Forward,France,Europe
268,Ismaël Bennacer,ALG,Milan,Serie A,2020,22.0,1997.0,14.7,39,18,17,21,1,15,32,46.9,17,10,1,9,20,59,12,0,MF,20-24,Midfielder,Algeria,Africa
269,Saïd Benrahma,ALG,West Ham,Premier League,2020,24.0,1995.0,15.5,24,15,8,11,5,8,28,28.6,20,10,0,10,8,32,8,0,"FW,MF",20-24,Forward,Algeria,Africa
270,Yassine Benrahou,FRA,Nîmes,Ligue 1,2020,21.0,1999.0,13.8,16,9,8,6,2,7,25,28.0,18,9,0,9,4,20,5,1,MF,20-24,Midfielder,France,Europe
271,Ramy Bensebaini,ALG,Gladbach,Bundesliga,2020,25.0,1995.0,20.1,43,24,27,13,3,26,42,61.9,16,39,7,32,47,90,66,0,DF,25-29,Defender,Algeria,Africa
272,Josh Benson,ENG,Burnley,Premier League,2020,20.0,1999.0,2.9,5,1,3,0,2,1,6,16.7,5,3,0,3,3,8,2,0,MF,20-24,Midfielder,England,Europe
273,Nabil Bentaleb,ALG,Schalke 04,Bundesliga,2020,25.0,1994.0,6.1,14,8,7,6,1,4,15,26.7,11,5,2,3,6,20,8,0,MF,25-29,Midfielder,Algeria,Africa
274,Rodrigo Bentancur,URU,Juventus,Serie A,2020,23.0,1997.0,25.8,63,33,21,37,5,20,59,33.9,39,35,12,23,47,110,46,1,MF,20-24,Midfielder,Uruguay,South America
275,Christian Benteke,BEL,Crystal Palace,Premier League,2020,29.0,1990.0,20.2,15,7,1,7,7,2,9,22.2,7,17,6,11,4,19,39,0,FW,25-29,Forward,Belgium,Europe
276,Karim Benzema,FRA,Real Madrid,La Liga,2020,32.0,1987.0,32.2,8,6,4,2,2,5,15,33.3,10,9,2,7,8,16,24,0,FW,30-34,Forward,France,Europe
278,Alessandro Berardi,ITA,Hellas Verona,Serie A,2020,29.0,1991.0,0.3,0,0,0,0,0,0,0,,0,0,0,0,0,0,0,0,GK,25-29,Goalkeeper,Italy,Europe
279,Domenico Berardi,ITA,Sassuolo,Serie A,2020,25.0,1994.0,27.5,42,22,17,11,14,21,62,33.9,41,23,1,22,26,68,34,0,FW,25-29,Forward,Italy,Europe
280,Gaetano Berardi,SUI,Leeds United,Premier League,2020,31.0,1988.0,1.3,2,2,1,0,1,0,0,,0,2,1,1,1,3,2,0,DF,30-34,Defender,Switzerland,Europe
290,Federico Bernardeschi,ITA,Juventus,Serie A,2020,26.0,1994.0,10.8,9,4,3,5,1,4,20,20.0,16,6,2,4,14,23,7,1,"MF,DF",25-29,Midfielder,Italy,Europe
291,Bernardo,BRA,Brighton,Premier League,2020,25.0,1995.0,2.3,10,8,8,1,1,4,6,66.7,2,2,0,2,1,11,1,0,"DF,MF",25-29,Defender,Brazil,South America
291,Bernardo,BRA,Brighton,Premier League,2020,25.0,1995.0,2.3,10,8,8,1,1,4,6,66.7,2,2,0,2,1,11,1,0,"DF,MF",25-29,Defender,Brazil,South America
291,Bernardo,BRA,Brighton,Premier League,2020,25.0,1995.0,2.3,10,8,8,1,1,4,6,66.7,2,2,0,2,1,11,1,0,"DF,MF",25-29,Defender,Brazil,South America
291,Bernardo,BRA,Brighton,Premier League,2020,25.0,1995.0,2.3,10,8,8,1,1,4,6,66.7,2,2,0,2,1,11,1,0,"DF,MF",25-29,Defender,Brazil,South America
294,Dimitry Bertaud,COD,Montpellier,Ligue 1,2020,22.0,1998.0,8.3,0,0,0,0,0,0,0,,0,0,0,0,1,1,2,0,GK,20-24,Goalkeeper,DR Congo,Africa
296,Ryan Bertrand,ENG,Southampton,Premier League,2020,30.0,1989.0,28.9,60,32,26,27,7,30,48,62.5,18,19,1,18,30,90,41,1,DF,30-34,Defender,England,Europe
297,Daniel Bessa,ITA,Hellas Verona,Serie A,2020,27.0,1993.0,6.8,15,8,3,11,1,6,14,42.9,8,5,1,4,2,17,0,0,MF,25-29,Midfielder,Italy,Europe
299,Jordan Beyer,GER,Gladbach,Bundesliga,2020,20.0,2000.0,2.1,2,1,2,0,0,1,2,50.0,1,5,4,1,5,7,5,0,DF,20-24,Defender,Germany,Europe
304,El Bilal Touré,MLI,Reims,Ligue 1,2020,18.0,2001.0,13.8,22,12,3,16,3,8,18,44.4,10,8,3,5,6,28,10,1,FW,Under 20,Forward,Mali,Africa
305,Cristiano Biraghi,ITA,Fiorentina,Serie A,2020,27.0,1992.0,31.1,42,23,19,15,8,27,45,60.0,18,23,9,14,27,69,56,3,DF,25-29,Defender,Italy,Europe
307,Yves Bissouma,MLI,Brighton,Premier League,2020,23.0,1996.0,34.6,104,68,50,48,6,33,67,49.3,34,42,6,36,64,168,67,0,MF,20-24,Midfielder,Mali,Africa
308,Leonardo Bittencourt,GER,Werder Bremen,Bundesliga,2020,26.0,1993.0,16.8,58,32,24,28,6,16,51,31.4,35,29,2,27,13,71,10,0,"MF,FW",25-29,Midfielder,Germany,Europe
312,Ludovic Blas,FRA,Nantes,Ligue 1,2020,22.0,1997.0,31.0,58,30,18,37,3,23,54,42.6,31,33,4,29,21,79,19,0,"MF,FW",20-24,Midfielder,France,Europe
314,Jérôme Boateng,GER,Bayern Munich,Bundesliga,2020,31.0,1988.0,26.3,26,16,17,8,1,14,32,43.8,18,24,17,7,40,66,63,1,DF,30-34,Defender,Germany,Europe
315,Antonin Bobichon,FRA,Angers,Ligue 1,2020,24.0,1995.0,10.1,23,14,10,8,5,9,15,60.0,6,4,1,3,2,25,1,0,"MF,FW",20-24,Midfielder,France,Europe
316,Yann Bodiger,FRA,Cádiz,La Liga,2020,25.0,1995.0,2.8,2,2,1,1,0,1,6,16.7,5,7,3,4,8,10,4,0,MF,25-29,Midfielder,France,Europe
317,Jean-Paul Boëtius,NED,Mainz 05,Bundesliga,2020,26.0,1994.0,22.9,42,28,13,15,14,17,47,36.2,30,37,3,34,33,75,14,0,"MF,FW",25-29,Midfielder,Netherlands,Europe
318,Sacha Boey,FRA,Dijon,Ligue 1,2020,19.0,2000.0,20.7,54,40,30,23,1,27,55,49.1,28,25,5,20,41,95,62,0,DF,Under 20,Defender,France,Europe
319,Sacha Boey,FRA,Rennes,Ligue 1,2020,19.0,2000.0,1.4,3,3,2,1,0,3,4,75.0,1,0,0,0,2,5,2,0,DF,Under 20,Defender,France,Europe
321,Melayro Bogarde,NED,Hoffenheim,Bundesliga,2020,18.0,2002.0,3.1,7,3,3,3,1,5,9,55.6,4,0,0,0,5,12,1,0,"DF,MF",Under 20,Defender,Netherlands,Europe
322,Jayden Bogle,ENG,Sheffield Utd,Premier League,2020,20.0,2000.0,12.3,33,23,21,10,2,20,39,51.3,19,14,4,10,14,47,22,0,"DF,MF",20-24,Defender,England,Europe
323,Quentin Boisgard,FRA,Lorient,Ligue 1,2020,23.0,1997.0,14.6,24,17,3,15,6,11,24,45.8,13,17,2,15,15,39,1,0,"MF,FW",20-24,Midfielder,France,Europe
324,Willy Boly,CIV,Wolves,Premier League,2020,29.0,1991.0,20.9,33,20,26,7,0,13,24,54.2,11,18,12,6,32,65,84,1,DF,25-29,Defender,Ivory Coast,Africa
325,Giacomo Bonaventura,ITA,Fiorentina,Serie A,2020,30.0,1989.0,25.1,34,19,16,13,5,16,53,30.2,37,26,2,24,39,73,12,0,MF,30-34,Midfielder,Italy,Europe
326,Federico Bonazzoli,ITA,Torino,Serie A,2020,23.0,1997.0,6.3,6,4,0,4,2,2,13,15.4,11,3,0,3,2,8,3,0,FW,20-24,Forward,Italy,Europe
327,Federico Bonazzoli,ITA,Sampdoria,Serie A,2020,23.0,1997.0,1.5,0,0,0,0,0,0,0,,0,1,0,1,0,0,0,0,FW,20-24,Forward,Italy,Europe
328,Kevin Bonifazi,ITA,Udinese,Serie A,2020,24.0,1996.0,27.4,32,21,24,6,2,8,23,34.8,15,33,20,13,50,82,85,1,DF,20-24,Defender,Italy,Europe
330,Elias Bördner,GER,Eint Frankfurt,Bundesliga,2020,18.0,2002.0,1.0,1,0,1,0,0,1,1,100.0,0,0,0,0,2,3,1,0,GK,Under 20,Goalkeeper,Germany,Europe
331,Dennis Borkowski,GER,RB Leipzig,Bundesliga,2020,18.0,2002.0,0.1,0,0,0,0,0,0,0,,0,1,0,1,0,0,0,0,"MF,FW",Under 20,Midfielder,Germany,Europe
332,Sebastiaan Bornauw,BEL,Köln,Bundesliga,2020,21.0,1999.0,23.1,29,20,25,4,0,14,25,56.0,11,33,26,7,40,69,104,0,DF,20-24,Defender,Belgium,Europe
333,Sven Botman,NED,Lille,Ligue 1,2020,20.0,2000.0,36.8,31,21,18,12,1,14,26,53.8,12,31,21,10,57,88,126,2,DF,20-24,Defender,Netherlands,Europe
334,Denis Bouanga,GAB,Saint-Étienne,Ligue 1,2020,25.0,1994.0,30.2,52,28,22,24,6,16,58,27.6,42,32,3,29,20,72,36,0,"MF,FW",25-29,Midfielder,Gabon,Africa
335,Hicham Boudaoui,ALG,Nice,Ligue 1,2020,20.0,1999.0,19.3,52,35,20,24,8,26,68,38.2,42,14,4,10,23,75,26,1,MF,20-24,Midfielder,Algeria,Africa
336,Ryad Boudebouz,ALG,Saint-Étienne,Ligue 1,2020,30.0,1990.0,7.2,9,4,1,7,1,4,8,50.0,4,3,0,3,5,14,5,0,"MF,FW",30-34,Midfielder,Algeria,Africa
338,Nassim Boujellab,MAR,Schalke 04,Bundesliga,2020,21.0,1999.0,6.7,13,9,2,10,1,2,12,16.7,10,10,3,7,7,20,9,0,"MF,FW",20-24,Midfielder,Morocco,Africa
339,Farid Boulaya,ALG,Metz,Ligue 1,2020,27.0,1993.0,31.3,24,16,4,17,3,13,51,25.5,38,19,3,16,12,36,7,0,"MF,FW",25-29,Midfielder,Algeria,Africa
343,Benjamin Bourigeaud,FRA,Rennes,Ligue 1,2020,26.0,1994.0,28.4,40,23,17,16,7,21,71,29.6,50,37,1,36,19,59,25,0,"MF,FW",25-29,Midfielder,France,Europe
345,Jarrod Bowen,ENG,West Ham,Premier League,2020,23.0,1996.0,28.5,26,15,12,7,7,10,29,34.5,19,19,1,18,22,48,10,0,"FW,MF",20-24,Forward,England,Europe
347,John Boye,GHA,Metz,Ligue 1,2020,33.0,1987.0,33.8,58,34,43,13,2,31,54,57.4,23,36,20,16,80,138,146,1,DF,30-34,Defender,Ghana,Africa
348,Lucas Boyé,ARG,Elche,La Liga,2020,24.0,1996.0,29.9,47,31,13,27,7,10,49,20.4,39,37,2,35,19,66,21,0,FW,20-24,Forward,Argentina,South America
352,Domagoj Bradarić,CRO,Lille,Ligue 1,2020,20.0,1999.0,14.0,28,18,11,13,4,12,27,44.4,15,14,4,10,26,54,21,0,DF,20-24,Defender,Croatia,Europe
353,Robbie Brady,IRL,Burnley,Premier League,2020,28.0,1992.0,11.7,22,15,12,6,4,12,35,34.3,23,16,0,16,9,31,29,1,MF,25-29,Midfielder,Republic of Ireland,Europe
354,Martin Braithwaite,DEN,Barcelona,La Liga,2020,29.0,1991.0,13.1,8,4,2,3,3,1,6,16.7,5,2,0,2,6,14,7,0,FW,25-29,Forward,Denmark,Europe
355,Julian Brandt,GER,Dortmund,Bundesliga,2020,24.0,1996.0,16.6,27,14,13,9,5,12,43,27.9,31,25,1,24,17,44,7,1,"FW,MF",20-24,Forward,Germany,Europe
357,Lilian Brassier,FRA,Brest,Ligue 1,2020,20.0,1999.0,10.7,19,10,12,4,3,7,11,63.6,4,13,6,7,23,42,38,1,DF,20-24,Defender,France,Europe
359,Claudio Bravo,CHI,Betis,La Liga,2020,37.0,1983.0,20.0,0,0,0,0,0,0,1,0.0,1,0,0,0,0,0,11,0,GK,35-39,Goalkeeper,Chile,South America
360,Fabian Bredlow,GER,Stuttgart,Bundesliga,2020,25.0,1995.0,1.0,0,0,0,0,0,0,0,,0,0,0,0,0,0,0,0,GK,25-29,Goalkeeper,Germany,Europe
364,Rhian Brewster,ENG,Sheffield Utd,Premier League,2020,20.0,2000.0,12.5,8,5,1,4,3,1,13,7.7,12,15,2,13,5,13,5,0,"FW,MF",20-24,Forward,England,Europe
365,Anthony Briançon,FRA,Nîmes,Ligue 1,2020,25.0,1994.0,13.6,12,7,9,3,0,9,19,47.4,10,19,12,7,33,45,57,2,DF,25-29,Defender,France,Europe
366,Jimmy Briand,FRA,Bordeaux,Ligue 1,2020,34.0,1985.0,6.3,7,3,3,2,2,1,1,100.0,0,2,0,2,1,8,3,0,FW,30-34,Forward,France,Europe
369,Dylan Bronn,TUN,Metz,Ligue 1,2020,25.0,1995.0,37.9,57,37,38,19,0,24,44,54.5,20,31,14,17,44,101,112,0,DF,25-29,Defender,Tunisia,Africa
370,John Brooks,USA,Wolfsburg,Bundesliga,2020,27.0,1993.0,30.8,47,29,33,14,0,30,54,55.6,24,35,10,25,55,102,134,0,DF,25-29,Defender,United States,North America
371,Daniel Brosinski,GER,Mainz 05,Bundesliga,2020,32.0,1988.0,15.9,19,14,10,7,2,12,31,38.7,19,18,1,17,14,33,33,0,"DF,FW",30-34,Defender,Germany,Europe
372,Josh Brownhill,ENG,Burnley,Premier League,2020,24.0,1995.0,31.3,45,27,9,29,7,15,44,34.1,29,33,11,22,69,114,39,0,MF,20-24,Midfielder,England,Europe
374,Gastón Brugman,URU,Parma,Serie A,2020,27.0,1992.0,18.0,35,19,18,15,2,11,44,25.0,33,33,4,29,45,80,34,0,MF,25-29,Midfielder,Uruguay,South America
375,Juan Brunet,ARG,Granada,La Liga,2020,22.0,1998.0,0.3,0,0,0,0,0,0,0,,0,0,0,0,0,0,1,0,MF,20-24,Midfielder,Argentina,South America
376,Juan Brunetta,ARG,Parma,Serie A,2020,23.0,1997.0,5.3,2,2,0,2,0,1,6,16.7,5,5,0,5,1,3,2,0,"FW,MF",20-24,Forward,Argentina,South America
377,Cédric Brunner,SUI,Arminia,Bundesliga,2020,26.0,1994.0,29.5,42,22,24,15,3,27,40,67.5,13,30,10,20,42,84,96,0,DF,25-29,Defender,Switzerland,Europe
378,Jacob Bruun Larsen,DEN,Hoffenheim,Bundesliga,2020,21.0,1998.0,1.0,0,0,0,0,0,0,0,,0,0,0,0,0,0,0,0,"MF,FW",20-24,Midfielder,Denmark,Europe
379,Joe Bryan,ENG,Fulham,Premier League,2020,26.0,1993.0,7.4,15,8,7,5,3,7,12,58.3,5,8,2,6,14,29,16,0,"DF,MF",25-29,Defender,England,Europe
380,Kean Bryan,ENG,Sheffield Utd,Premier League,2020,23.0,1996.0,11.2,20,10,9,11,0,9,19,47.4,10,16,10,6,13,33,39,1,DF,20-24,Defender,England,Europe
382,Ante Budimir,CRO,Osasuna,La Liga,2020,29.0,1991.0,18.1,20,12,2,11,7,4,15,26.7,11,17,4,13,2,22,17,1,FW,25-29,Forward,Croatia,Europe
383,Gianluigi Buffon,ITA,Juventus,Serie A,2020,42.0,1978.0,8.0,0,0,0,0,0,0,0,,0,0,0,0,0,0,3,1,GK,Over 40,Goalkeeper,Italy,Europe
384,Marius Bülter,GER,Union Berlin,Bundesliga,2020,27.0,1993.0,10.9,15,8,6,6,3,5,17,29.4,12,17,2,15,12,27,11,0,"FW,MF",25-29,Forward,Germany,Europe
385,Alessandro Buongiorno,ITA,Torino,Serie A,2020,21.0,1999.0,9.5,12,5,8,4,0,7,12,58.3,5,15,9,6,11,23,44,1,DF,20-24,Defender,Italy,Europe
386,Esteban Burgos,ARG,Eibar,La Liga,2020,28.0,1992.0,12.3,7,6,4,3,0,1,5,20.0,4,8,7,1,23,30,54,2,DF,25-29,Defender,Argentina,South America
388,Jonathan Burkardt,GER,Mainz 05,Bundesliga,2020,20.0,2000.0,15.3,27,13,15,10,2,11,19,57.9,8,20,3,17,8,35,15,0,"FW,MF",20-24,Forward,Germany,Europe
389,Nishan Burkart,SUI,Freiburg,Bundesliga,2020,20.0,2000.0,0.2,0,0,0,0,0,0,1,0.0,1,0,0,0,0,0,0,0,MF,20-24,Midfielder,Switzerland,Europe
390,Oliver Burke,SCO,Sheffield Utd,Premier League,2020,23.0,1997.0,14.1,16,8,6,9,1,5,24,20.8,19,24,0,24,2,18,6,0,FW,20-24,Forward,Scotland,Europe
391,Roman Bürki,SUI,Dortmund,Bundesliga,2020,29.0,1990.0,18.5,0,0,0,0,0,0,0,,0,0,0,0,0,0,5,1,GK,25-29,Goalkeeper,Switzerland,Europe
392,Dan Burn,ENG,Brighton,Premier League,2020,28.0,1992.0,22.9,50,26,33,14,3,27,53,50.9,26,30,7,23,31,81,75,0,DF,25-29,Defender,England,Europe
398,David Button,ENG,West Brom,Premier League,2020,31.0,1989.0,1.0,0,0,0,0,0,0,0,,0,0,0,0,0,0,0,0,GK,30-34,Goalkeeper,England,Europe
402,Willy Caballero,ARG,Chelsea,Premier League,2020,38.0,1981.0,1.0,0,0,0,0,0,0,0,,0,0,0,0,0,0,0,0,GK,35-39,Goalkeeper,Argentina,South America
403,Jimmy Cabot,FRA,Angers,Ligue 1,2020,26.0,1994.0,10.5,26,13,8,14,4,11,36,30.6,25,8,0,8,12,38,6,0,"FW,MF",25-29,Forward,France,Europe
404,Martín Cáceres,URU,Fiorentina,Serie A,2020,33.0,1987.0,24.9,28,12,16,11,1,15,35,42.9,20,20,14,6,14,42,52,1,DF,30-34,Defender,Uruguay,South America
405,Anthony Caci,FRA,Strasbourg,Ligue 1,2020,23.0,1997.0,31.1,80,46,47,27,6,35,69,50.7,34,30,4,26,55,135,65,1,DF,20-24,Defender,France,Europe
406,Mathieu Cafaro,FRA,Reims,Ligue 1,2020,23.0,1997.0,23.0,40,17,15,19,6,13,43,30.2,30,11,0,11,17,57,12,0,"MF,FW",20-24,Midfielder,France,Europe
407,Gary Cahill,ENG,Crystal Palace,Premier League,2020,34.0,1985.0,20.0,13,9,10,3,0,7,11,63.6,4,27,22,5,13,26,88,0,DF,30-34,Defender,England,Europe
408,Yannick Cahuzac,FRA,Lens,Ligue 1,2020,35.0,1985.0,25.0,26,12,12,10,4,9,27,33.3,18,18,5,13,33,59,72,0,MF,35-39,Midfielder,France,Europe
409,Felipe Caicedo,ECU,Lazio,Serie A,2020,31.0,1988.0,10.3,10,7,4,4,2,1,8,12.5,7,7,0,7,4,14,2,0,FW,30-34,Forward,Ecuador,South America
410,Marc-Aurèle Caillard,FRA,Metz,Ligue 1,2020,26.0,1994.0,4.0,0,0,0,0,0,0,0,,0,0,0,0,0,0,2,0,GK,25-29,Goalkeeper,France,Europe
411,Tom Cairney,SCO,Fulham,Premier League,2020,29.0,1991.0,8.4,9,3,1,4,4,1,4,25.0,3,6,0,6,0,9,3,0,MF,25-29,Midfielder,Scotland,Europe
413,Arturo Calabresi,ITA,Bologna,Serie A,2020,24.0,1996.0,0.2,0,0,0,0,0,0,0,,0,0,0,0,0,0,2,0,"DF,FW",20-24,Defender,Italy,Europe
414,Arturo Calabresi,ITA,Cagliari,Serie A,2020,24.0,1996.0,0.2,0,0,0,0,0,0,1,0.0,1,0,0,0,0,0,0,0,DF,20-24,Defender,Italy,Europe
415,Davide Calabria,ITA,Milan,Serie A,2020,23.0,1996.0,29.4,101,64,61,32,8,54,90,60.0,36,42,9,33,37,138,82,1,DF,20-24,Defender,Italy,Europe
416,Riccardo Calafiori,ITA,Roma,Serie A,2020,18.0,2002.0,0.7,1,0,1,0,0,1,4,25.0,3,1,0,1,0,1,0,0,DF,Under 20,Defender,Italy,Europe
417,Mattia Caldara,ITA,Atalanta,Serie A,2020,26.0,1994.0,1.2,1,0,0,1,0,1,1,100.0,0,3,2,1,4,5,3,0,DF,25-29,Defender,Italy,Europe
418,Luca Caldirola,ITA,Benevento,Serie A,2020,29.0,1991.0,17.5,21,13,13,6,2,10,22,45.5,12,20,15,5,20,41,56,0,DF,25-29,Defender,Italy,Europe
420,Hakan Çalhanoğlu,TUR,Milan,Serie A,2020,26.0,1994.0,29.0,26,7,3,17,6,7,28,25.0,21,21,6,15,15,41,24,1,"MF,FW",25-29,Midfielder,Turkey,Asia
421,Kerim Calhanoglu,GER,Schalke 04,Bundesliga,2020,17.0,2002.0,3.3,3,3,1,1,1,0,3,0.0,3,4,0,4,7,10,6,0,DF,Under 20,Defender,Germany,Europe
422,Fabrizio Caligara,ITA,Cagliari,Serie A,2020,20.0,2000.0,2.0,6,4,2,2,2,6,9,66.7,3,9,2,7,3,9,3,0,"MF,FW",20-24,Midfielder,Italy,Europe
423,Daniel Caligiuri,ITA,Augsburg,Bundesliga,2020,32.0,1988.0,29.6,71,46,29,31,11,29,92,31.5,63,45,6,39,38,109,41,0,"MF,FW",30-34,Midfielder,Italy,Europe
425,Jonathan Calleri,ARG,Osasuna,La Liga,2020,26.0,1993.0,17.2,15,6,2,4,9,3,17,17.6,14,18,2,16,1,16,10,1,FW,25-29,Forward,Argentina,South America
426,Dominic Calvert-Lewin,ENG,Everton,Premier League,2020,23.0,1997.0,31.9,17,8,1,8,8,6,12,50.0,6,22,6,16,6,23,33,0,FW,20-24,Forward,England,Europe
429,Mahdi Camara,FRA,Saint-Étienne,Ligue 1,2020,22.0,1998.0,36.6,99,67,43,46,10,33,60,55.0,27,50,12,38,78,177,51,0,"MF,DF",20-24,Midfielder,France,Europe
430,Eduardo Camavinga,FRA,Rennes,Ligue 1,2020,17.0,2002.0,26.7,98,58,39,48,11,38,77,49.4,39,36,2,34,23,121,15,1,MF,Under 20,Midfielder,France,Europe
432,Emre Can,GER,Dortmund,Bundesliga,2020,26.0,1994.0,23.7,43,34,20,20,3,20,37,54.1,17,35,10,25,48,91,52,0,"DF,MF",25-29,Defender,Germany,Europe
434,João Cancelo,POR,Manchester City,Premier League,2020,26.0,1994.0,25.5,68,41,42,19,7,43,83,51.8,40,23,2,21,41,109,33,2,"DF,MF",25-29,Defender,Portugal,Europe
435,Antonio Candreva,ITA,Sampdoria,Serie A,2020,33.0,1987.0,27.8,28,19,17,9,2,21,53,39.6,32,24,3,21,9,37,27,1,MF,30-34,Midfielder,Italy,Europe
438,Pierrick Capelle,FRA,Angers,Ligue 1,2020,33.0,1987.0,22.8,53,28,24,17,12,31,79,39.2,48,25,1,24,47,100,32,0,"MF,DF",30-34,Midfielder,France,Europe
439,Étienne Capoue,FRA,Villarreal,La Liga,2020,32.0,1988.0,13.2,20,10,14,6,0,8,18,44.4,10,7,1,6,20,40,23,0,MF,30-34,Midfielder,France,Europe
440,Elio Capradossi,UGA,Spezia,Serie A,2020,24.0,1996.0,1.0,2,1,2,0,0,2,2,100.0,0,0,0,0,1,3,5,0,DF,20-24,Defender,Uganda,Africa
441,Gianluca Caprari,ITA,Benevento,Serie A,2020,27.0,1993.0,20.7,16,11,5,5,6,6,31,19.4,25,19,1,18,18,34,8,0,"MF,FW",25-29,Midfielder,Italy,Europe
442,Francesco Caputo,ITA,Sassuolo,Serie A,2020,32.0,1987.0,18.9,0,0,0,0,0,0,2,0.0,2,4,0,4,1,1,3,0,FW,30-34,Forward,Italy,Europe
443,Maxence Caqueret,FRA,Lyon,Ligue 1,2020,20.0,2000.0,19.6,72,45,17,39,16,35,106,33.0,71,35,3,32,23,95,5,2,MF,20-24,Midfielder,France,Europe
444,Andrea Carboni,ITA,Cagliari,Serie A,2020,19.0,2001.0,12.1,34,23,23,11,0,15,28,53.6,13,15,4,11,14,48,52,0,DF,Under 20,Defender,Italy,Europe
447,Irvin Cardona,FRA,Brest,Ligue 1,2020,22.0,1997.0,22.5,10,5,3,6,1,4,22,18.2,18,17,3,14,9,19,23,2,FW,20-24,Forward,France,Europe
452,Yannick Carrasco,BEL,Atlético Madrid,La Liga,2020,26.0,1993.0,24.2,27,15,14,6,7,15,34,44.1,19,24,0,24,17,44,16,1,"DF,MF",25-29,Defender,Belgium,Europe
454,Guido Carrillo,ARG,Elche,La Liga,2020,29.0,1991.0,11.1,9,8,1,7,1,2,8,25.0,6,2,1,1,4,13,14,0,FW,25-29,Forward,Argentina,South America
455,Andy Carroll,ENG,Newcastle Utd,Premier League,2020,31.0,1989.0,4.4,3,1,1,1,1,1,8,12.5,7,1,0,1,0,3,14,0,FW,30-34,Forward,England,Europe
456,Scott Carson,ENG,Manchester City,Premier League,2020,34.0,1985.0,1.0,0,0,0,0,0,0,0,,0,0,0,0,0,0,0,0,GK,30-34,Goalkeeper,England,Europe
459,William Carvalho,POR,Betis,La Liga,2020,28.0,1992.0,13.6,19,12,7,11,1,5,21,23.8,16,11,3,8,11,30,14,1,MF,25-29,Midfielder,Portugal,Europe
460,Casemiro,BRA,Real Madrid,La Liga,2020,28.0,1992.0,32.2,84,49,50,30,4,33,73,45.2,40,50,17,33,70,154,62,0,MF,25-29,Midfielder,Brazil,South America
463,Giuseppe Caso,ITA,Genoa,Serie A,2020,21.0,1998.0,0.6,0,0,0,0,0,0,0,,0,0,0,0,0,0,0,0,"DF,FW",20-24,Defender,Italy,Europe
465,Francesco Cassata,ITA,Genoa,Serie A,2020,23.0,1997.0,2.5,7,6,7,0,0,4,7,57.1,3,0,0,0,3,10,1,0,"DF,FW",20-24,Defender,Italy,Europe
466,Timothy Castagne,BEL,Leicester City,Premier League,2020,24.0,1995.0,26.1,52,32,29,18,5,24,44,54.5,20,29,5,24,29,81,62,1,DF,20-24,Defender,Belgium,Europe
467,Koen Casteels,BEL,Wolfsburg,Bundesliga,2020,28.0,1992.0,32.0,0,0,0,0,0,0,1,0.0,1,1,0,1,2,2,9,2,GK,25-29,Goalkeeper,Belgium,Europe
468,Jean-Charles Castelletto,CMR,Nantes,Ligue 1,2020,25.0,1995.0,21.6,32,18,20,11,1,18,31,58.1,13,25,19,6,42,74,79,0,DF,25-29,Defender,Cameroon,Africa
470,Gonzalo Castro,GER,Stuttgart,Bundesliga,2020,33.0,1987.0,19.2,21,7,6,9,6,8,23,34.8,15,16,3,13,8,29,12,0,MF,30-34,Midfielder,Germany,Europe
472,Gaetano Castrovilli,ITA,Fiorentina,Serie A,2020,23.0,1997.0,25.9,33,19,15,11,7,11,42,26.2,31,25,2,23,34,67,14,0,MF,20-24,Midfielder,Italy,Europe
473,Danilo Cataldi,ITA,Lazio,Serie A,2020,25.0,1994.0,6.3,7,2,1,5,1,4,18,22.2,14,3,1,2,9,16,7,0,MF,25-29,Midfielder,Italy,Europe
474,Ivan Cavaleiro,POR,Fulham,Premier League,2020,26.0,1993.0,27.5,23,14,9,11,3,12,34,35.3,22,25,1,24,19,42,14,0,FW,25-29,Forward,Portugal,Europe
475,Edinson Cavani,URU,Manchester Utd,Premier League,2020,33.0,1987.0,15.3,12,8,1,8,3,2,13,15.4,11,2,0,2,6,18,11,0,FW,30-34,Forward,Uruguay,South America
479,Zeki Çelik,TUR,Lille,Ligue 1,2020,23.0,1997.0,26.5,72,33,30,30,12,44,81,54.3,37,32,6,26,38,110,52,0,DF,20-24,Defender,Turkey,Asia
481,Fabien Centonze,FRA,Metz,Ligue 1,2020,24.0,1996.0,35.8,104,68,64,30,10,43,73,58.9,30,62,17,45,112,216,119,1,DF,20-24,Defender,France,Europe
482,Luca Ceppitelli,ITA,Cagliari,Serie A,2020,30.0,1989.0,16.3,25,19,13,10,2,14,26,53.8,12,23,12,11,25,50,58,1,DF,30-34,Defender,Italy,Europe
483,Alberto Cerri,ITA,Cagliari,Serie A,2020,24.0,1996.0,4.1,3,2,0,2,1,0,5,0.0,5,4,2,2,2,5,6,0,FW,20-24,Forward,Italy,Europe
487,Fouad Chafik,MAR,Dijon,Ligue 1,2020,33.0,1986.0,18.0,39,24,29,8,2,16,35,45.7,19,19,10,9,21,60,41,0,DF,30-34,Defender,Morocco,Africa
488,Mehdi Chahiri,MAR,Strasbourg,Ligue 1,2020,24.0,1996.0,8.9,18,8,7,5,6,8,20,40.0,12,9,0,9,6,24,5,0,"FW,MF",20-24,Forward,Morocco,Africa
491,Aníbal Chalá,ECU,Dijon,Ligue 1,2020,24.0,1996.0,8.3,10,7,6,3,1,6,12,50.0,6,5,3,2,14,24,15,1,DF,20-24,Defender,Ecuador,South America
492,Trevoh Chalobah,ENG,Lorient,Ligue 1,2020,21.0,1999.0,24.9,45,26,32,13,0,24,50,48.0,26,20,7,13,69,114,56,0,"DF,MF",20-24,Defender,England,Europe
493,Calum Chambers,ENG,Arsenal,Premier League,2020,25.0,1995.0,8.4,7,3,3,2,2,3,8,37.5,5,6,2,4,10,17,37,0,DF,25-29,Defender,England,Europe
494,Timothy Chandler,USA,Eint Frankfurt,Bundesliga,2020,30.0,1990.0,4.8,4,0,2,1,1,1,4,25.0,3,5,2,3,3,7,5,0,DF,30-34,Defender,United States,North America
496,Gaëtan Charbonnier,FRA,Brest,Ligue 1,2020,31.0,1988.0,17.4,24,15,6,11,7,12,32,37.5,20,15,1,14,9,33,19,0,"MF,FW",30-34,Midfielder,France,Europe
497,Brendan Chardonnet,FRA,Brest,Ligue 1,2020,25.0,1994.0,30.2,51,29,31,19,1,27,41,65.9,14,54,41,13,64,115,151,0,DF,25-29,Defender,France,Europe
498,Xavier Chavalerin,FRA,Reims,Ligue 1,2020,29.0,1991.0,28.3,92,50,47,38,7,26,74,35.1,48,43,9,34,43,135,29,1,MF,25-29,Midfielder,France,Europe
501,Rayan Cherki,FRA,Lyon,Ligue 1,2020,16.0,2003.0,7.8,5,3,0,3,2,1,11,9.1,10,3,0,3,4,9,0,0,"FW,MF",Under 20,Forward,France,Europe
502,Denis Cheryshev,RUS,Valencia,La Liga,2020,29.0,1990.0,12.2,19,15,6,7,6,6,26,23.1,20,15,1,14,12,31,15,0,MF,25-29,Midfielder,Russia,Europe
503,Giorgio Chiellini,ITA,Juventus,Serie A,2020,35.0,1984.0,15.4,12,9,9,3,0,5,11,45.5,6,18,13,5,27,39,56,0,DF,35-39,Defender,Italy,Europe
504,Federico Chiesa,ITA,Fiorentina,Serie A,2020,22.0,1997.0,2.7,6,2,2,2,2,3,8,37.5,5,3,1,2,1,7,3,0,DF,20-24,Defender,Italy,Europe
505,Federico Chiesa,ITA,Juventus,Serie A,2020,22.0,1997.0,24.6,47,26,21,14,12,19,50,38.0,31,23,1,22,12,59,16,0,"MF,DF",20-24,Midfielder,Italy,Europe
506,Ben Chilwell,ENG,Chelsea,Premier League,2020,23.0,1996.0,25.4,42,22,16,22,4,15,33,45.5,18,28,3,25,24,66,58,0,DF,20-24,Defender,England,Europe
509,Tahith Chong,NED,Werder Bremen,Bundesliga,2020,20.0,1999.0,4.3,11,6,1,9,1,4,8,50.0,4,4,0,4,5,16,1,0,"MF,FW",20-24,Midfielder,Netherlands,Europe
510,Joris Chotard,FRA,Montpellier,Ligue 1,2020,18.0,2001.0,12.9,12,8,5,6,1,6,31,19.4,25,12,3,9,11,23,15,0,MF,Under 20,Midfielder,France,Europe
511,Hamza Choudhury,ENG,Leicester City,Premier League,2020,22.0,1997.0,3.5,8,7,3,5,0,4,10,40.0,6,4,1,3,4,12,9,1,MF,20-24,Midfielder,England,Europe
513,Andreas Christensen,DEN,Chelsea,Premier League,2020,24.0,1996.0,15.2,11,6,8,3,0,0,8,0.0,8,19,14,5,20,31,51,1,DF,20-24,Defender,Denmark,Europe
515,Samuel Chukwueze,NGA,Villarreal,La Liga,2020,21.0,1999.0,15.2,12,7,4,4,4,3,17,17.6,14,8,0,8,10,22,3,0,"MF,FW",20-24,Midfielder,Nigeria,Africa
516,Darko Churlinov,MKD,Stuttgart,Bundesliga,2020,20.0,2000.0,2.4,2,2,2,0,0,1,3,33.3,2,5,1,4,0,2,2,0,"DF,MF",20-24,Defender,North Macedonia,Europe
518,Sébastien Cibois,FRA,Brest,Ligue 1,2020,22.0,1998.0,3.0,0,0,0,0,0,0,0,,0,0,0,0,0,0,0,1,GK,20-24,Goalkeeper,France,Europe
521,Luca Cigarini,ITA,Crotone,Serie A,2020,34.0,1986.0,10.3,26,14,11,12,3,12,28,42.9,16,10,1,9,12,38,9,0,MF,30-34,Midfielder,Italy,Europe
522,Jasper Cillessen,NED,Valencia,La Liga,2020,31.0,1989.0,10.0,0,0,0,0,0,0,0,,0,0,0,0,0,0,0,0,GK,30-34,Goalkeeper,Netherlands,Europe
525,Ciaran Clark,IRL,Newcastle Utd,Premier League,2020,30.0,1989.0,21.0,24,14,15,6,3,6,13,46.2,7,27,20,7,29,53,104,1,DF,30-34,Defender,Republic of Ireland,Europe
526,Alexis Claude-Maurice,FRA,Nice,Ligue 1,2020,22.0,1998.0,21.2,40,19,17,14,9,14,48,29.2,34,16,2,14,14,54,3,0,"MF,FW",20-24,Midfielder,France,Europe
527,Jonathan Clauss,FRA,Lens,Ligue 1,2020,27.0,1992.0,28.0,43,20,12,20,11,17,38,44.7,21,24,1,23,45,88,46,0,DF,25-29,Defender,France,Europe
529,Nathaniel Clyne,ENG,Crystal Palace,Premier League,2020,29.0,1991.0,12.7,17,10,8,8,1,9,16,56.3,7,7,2,5,18,35,25,1,DF,25-29,Defender,England,Europe
530,Conor Coady,ENG,Wolves,Premier League,2020,27.0,1993.0,36.7,35,23,25,10,0,19,35,54.3,16,40,32,8,27,62,134,2,DF,25-29,Defender,England,Europe
531,Marcus Coco,FRA,Nantes,Ligue 1,2020,24.0,1996.0,16.4,36,21,17,15,4,16,36,44.4,20,16,3,13,20,56,17,0,"MF,FW",20-24,Midfielder,France,Europe
533,Séamus Coleman,IRL,Everton,Premier League,2020,31.0,1988.0,17.9,39,26,21,14,4,21,30,70.0,9,22,6,16,13,52,37,2,"DF,MF",30-34,Defender,Republic of Ireland,Europe
536,Simone Colombi,ITA,Parma,Serie A,2020,29.0,1991.0,2.0,0,0,0,0,0,0,0,,0,0,0,0,0,0,2,0,GK,25-29,Goalkeeper,Italy,Europe
537,Lorenzo Colombo,ITA,Milan,Serie A,2020,18.0,2002.0,1.0,2,1,1,1,0,0,3,0.0,3,0,0,0,0,2,3,0,FW,Under 20,Forward,Italy,Europe
539,Kingsley Coman,FRA,Bayern Munich,Bundesliga,2020,24.0,1996.0,19.5,14,8,6,7,1,2,21,9.5,19,22,0,22,4,18,3,0,"FW,MF",20-24,Forward,France,Europe
540,Daniel Congré,FRA,Montpellier,Ligue 1,2020,35.0,1985.0,36.6,59,35,45,12,2,36,70,51.4,34,50,33,17,69,128,144,3,DF,35-39,Defender,France,Europe
541,Aaron Connolly,IRL,Brighton,Premier League,2020,20.0,2000.0,8.8,6,3,1,3,2,0,2,0.0,2,4,0,4,0,6,2,0,FW,20-24,Forward,Republic of Ireland,Europe
542,Andrea Consigli,ITA,Sassuolo,Serie A,2020,33.0,1987.0,37.0,2,2,2,0,0,2,2,100.0,0,0,0,0,0,2,14,4,GK,30-34,Goalkeeper,Italy,Europe
543,Andrea Conti,ITA,Milan,Serie A,2020,26.0,1994.0,0.3,1,1,1,0,0,0,1,0.0,1,0,0,0,1,2,0,0,DF,25-29,Defender,Italy,Europe
544,Andrea Conti,ITA,Parma,Serie A,2020,26.0,1994.0,9.0,21,10,16,4,1,13,26,50.0,13,13,4,9,16,37,23,0,DF,25-29,Defender,Italy,Europe
545,Liam Cooper,SCO,Leeds United,Premier League,2020,28.0,1991.0,24.3,68,45,39,27,2,37,59,62.7,22,39,32,7,61,129,70,1,DF,25-29,Defender,Scotland,Europe
546,Francis Coquelin,FRA,Villarreal,La Liga,2020,29.0,1991.0,8.2,19,14,4,12,3,8,19,42.1,11,8,2,6,21,40,11,1,MF,25-29,Midfielder,France,Europe
548,Sébastien Corchia,FRA,Nantes,Ligue 1,2020,29.0,1990.0,23.0,55,30,29,17,9,33,60,55.0,27,28,10,18,38,93,40,1,DF,25-29,Defender,France,Europe
549,Alex Cordaz,ITA,Crotone,Serie A,2020,37.0,1983.0,36.0,0,0,0,0,0,0,0,,0,0,0,0,1,1,7,2,GK,35-39,Goalkeeper,Italy,Europe
554,Jack Cork,ENG,Burnley,Premier League,2020,31.0,1989.0,15.0,26,10,5,17,4,11,31,35.5,20,15,4,11,16,42,20,0,MF,30-34,Midfielder,England,Europe
556,Maxwel Cornet,CIV,Lyon,Ligue 1,2020,23.0,1996.0,27.2,70,41,39,24,7,33,58,56.9,25,23,5,18,43,113,47,2,"DF,FW",20-24,Defender,Ivory Coast,Africa
557,Ángel Correa,ARG,Atlético Madrid,La Liga,2020,25.0,1995.0,26.6,38,21,10,23,5,15,45,33.3,30,18,1,17,22,60,16,0,"FW,MF",25-29,Forward,Argentina,South America
558,Joaquín Correa,ARG,Lazio,Serie A,2020,25.0,1994.0,21.5,21,12,6,11,4,7,25,28.0,18,14,0,14,7,28,12,0,FW,25-29,Forward,Argentina,South America
561,Thierry Correia,POR,Valencia,La Liga,2020,21.0,1999.0,23.7,47,27,32,10,5,21,43,48.8,22,24,6,18,42,89,63,1,DF,20-24,Defender,Portugal,Europe
562,Danny da Costa,GER,Mainz 05,Bundesliga,2020,27.0,1993.0,13.4,22,16,6,9,7,13,27,48.1,14,17,2,15,17,39,27,0,"DF,FW",25-29,Defender,Germany,Europe
563,Danny da Costa,GER,Eint Frankfurt,Bundesliga,2020,27.0,1993.0,1.2,0,0,0,0,0,0,1,0.0,1,3,1,2,0,0,4,0,DF,25-29,Defender,Germany,Europe
566,Douglas Costa,BRA,Juventus,Serie A,2020,29.0,1990.0,0.5,1,0,1,0,0,1,3,33.3,2,0,0,0,0,1,0,0,"MF,FW",25-29,Midfielder,Brazil,South America
567,Douglas Costa,BRA,Bayern Munich,Bundesliga,2020,29.0,1990.0,3.6,2,1,1,1,0,1,3,33.3,2,7,0,7,2,4,1,0,"FW,MF",25-29,Forward,Brazil,South America
568,Hélder Costa,ANG,Leeds United,Premier League,2020,26.0,1994.0,12.8,25,11,12,5,8,11,32,34.4,21,11,0,11,3,28,5,1,"MF,FW",25-29,Midfielder,Angola,Africa
572,Benoît Costil,FRA,Bordeaux,Ligue 1,2020,33.0,1987.0,38.0,1,1,1,0,0,1,3,33.3,2,1,0,1,1,2,17,0,GK,30-34,Goalkeeper,France,Europe
574,Kalifa Coulibaly,MLI,Nantes,Ligue 1,2020,28.0,1991.0,10.9,3,1,0,1,2,2,8,25.0,6,3,1,2,2,5,12,0,FW,25-29,Forward,Mali,Africa
575,Lassana Coulibaly,MLI,Angers,Ligue 1,2020,24.0,1996.0,18.7,78,41,33,34,11,39,75,52.0,36,29,4,25,33,111,17,0,MF,20-24,Midfielder,Mali,Africa
576,Mamadou Coulibaly,SEN,Udinese,Serie A,2020,21.0,1999.0,2.0,10,8,5,5,0,0,0,,0,2,0,2,1,11,0,0,MF,20-24,Midfielder,Senegal,Africa
576,Mamadou Coulibaly,SEN,Udinese,Serie A,2020,21.0,1999.0,2.0,10,8,5,5,0,0,0,,0,2,0,2,1,11,0,0,MF,20-24,Midfielder,Senegal,Africa
576,Mamadou Coulibaly,SEN,Udinese,Serie A,2020,21.0,1999.0,2.0,10,8,5,5,0,0,0,,0,2,0,2,1,11,0,0,MF,20-24,Midfielder,Senegal,Africa
576,Mamadou Coulibaly,SEN,Udinese,Serie A,2020,21.0,1999.0,2.0,10,8,5,5,0,0,0,,0,2,0,2,1,11,0,0,MF,20-24,Midfielder,Senegal,Africa
577,Senou Coulibaly,MLI,Dijon,Ligue 1,2020,25.0,1994.0,21.5,33,21,23,10,0,12,24,50.0,12,18,12,6,30,63,89,0,DF,25-29,Defender,Mali,Africa
578,Tanguy Coulibaly,FRA,Stuttgart,Bundesliga,2020,19.0,2001.0,16.7,26,15,10,7,9,11,23,47.8,12,20,0,20,10,36,11,0,"DF,FW",Under 20,Defender,France,Europe
579,Thibaut Courtois,BEL,Real Madrid,La Liga,2020,28.0,1992.0,38.0,0,0,0,0,0,0,1,0.0,1,1,0,1,1,1,17,2,GK,25-29,Goalkeeper,Belgium,Europe
580,Philippe Coutinho,BRA,Barcelona,La Liga,2020,28.0,1992.0,7.3,8,6,2,5,1,3,9,33.3,6,7,0,7,2,10,1,0,"MF,FW",25-29,Midfielder,Brazil,South America
581,Nicolas Cozza,FRA,Montpellier,Ligue 1,2020,21.0,1999.0,15.2,39,30,27,11,1,20,40,50.0,20,20,11,9,26,65,62,0,DF,20-24,Defender,France,Europe
582,Alessio Cragno,ITA,Cagliari,Serie A,2020,26.0,1994.0,34.0,0,0,0,0,0,0,1,0.0,1,0,0,0,1,1,10,0,GK,25-29,Goalkeeper,Italy,Europe
584,Aaron Cresswell,ENG,West Ham,Premier League,2020,30.0,1989.0,35.2,32,13,15,15,2,18,32,56.3,14,29,14,15,32,64,79,2,DF,30-34,Defender,England,Europe
585,Domenico Criscito,ITA,Genoa,Serie A,2020,33.0,1986.0,19.2,43,22,29,11,3,22,39,56.4,17,27,14,13,44,87,51,0,DF,30-34,Defender,Italy,Europe
586,Bryan Cristante,ITA,Roma,Serie A,2020,25.0,1995.0,23.9,27,20,10,14,3,10,28,35.7,18,21,7,14,40,67,61,1,"DF,MF",25-29,Defender,Italy,Europe
587,Giovanni Crociata,ITA,Crotone,Serie A,2020,22.0,1997.0,0.3,1,0,0,1,0,0,1,0.0,1,1,0,1,0,1,0,0,DF,20-24,Defender,Italy,Europe
589,Juan Cuadrado,COL,Juventus,Serie A,2020,32.0,1988.0,24.2,43,25,22,15,6,29,60,48.3,31,16,2,14,43,86,22,2,"DF,MF",30-34,Defender,Colombia,South America
590,Andrés Cubas,PAR,Nîmes,Ligue 1,2020,24.0,1996.0,24.9,80,47,30,44,6,33,74,44.6,41,37,10,27,50,130,29,3,MF,20-24,Midfielder,Paraguay,South America
596,Matheus Cunha,BRA,Hertha BSC,Bundesliga,2020,21.0,1999.0,23.9,36,16,10,19,7,13,49,26.5,36,29,2,27,31,67,9,0,"FW,MF",20-24,Forward,Brazil,South America
597,Giuseppe Cuomo,ITA,Crotone,Serie A,2020,22.0,1998.0,8.9,26,19,17,9,0,9,14,64.3,5,10,2,8,18,44,19,1,DF,20-24,Defender,Italy,Europe
598,Patrick Cutrone,ITA,Wolves,Premier League,2020,22.0,1998.0,0.3,0,0,0,0,0,0,0,,0,0,0,0,0,0,0,0,FW,20-24,Forward,Italy,Europe
599,Patrick Cutrone,ITA,Fiorentina,Serie A,2020,22.0,1998.0,2.2,4,3,1,2,1,1,2,50.0,1,1,0,1,1,5,0,0,FW,20-24,Forward,Italy,Europe
600,Patrick Cutrone,ITA,Valencia,La Liga,2020,22.0,1998.0,1.2,0,0,0,0,0,0,1,0.0,1,0,0,0,1,1,0,0,FW,20-24,Forward,Italy,Europe
601,Wylan Cyprien,FRA,Parma,Serie A,2020,25.0,1995.0,4.6,9,4,5,3,1,2,4,50.0,2,13,8,5,5,14,6,1,MF,25-29,Midfielder,France,Europe
602,Rafael Czichos,GER,Köln,Bundesliga,2020,30.0,1990.0,25.1,48,24,33,13,2,23,42,54.8,19,25,9,16,53,101,109,0,DF,30-34,Defender,Germany,Europe
604,Danilo D'Ambrosio,ITA,Inter,Serie A,2020,31.0,1988.0,7.8,15,9,6,7,2,6,15,40.0,9,9,7,2,4,19,15,0,DF,30-34,Defender,Italy,Europe
605,Damien Da Silva,FRA,Rennes,Ligue 1,2020,32.0,1988.0,29.6,22,13,13,8,1,12,18,66.7,6,17,13,4,44,66,99,1,DF,30-34,Defender,France,Europe
609,Finn Dahmen,GER,Mainz 05,Bundesliga,2020,22.0,1998.0,3.0,0,0,0,0,0,0,1,0.0,1,0,0,0,0,0,1,0,GK,20-24,Goalkeeper,Germany,Europe
610,Mahmoud Dahoud,GER,Dortmund,Bundesliga,2020,24.0,1996.0,14.0,30,18,9,20,1,14,38,36.8,24,23,5,18,18,48,11,1,MF,20-24,Midfielder,Germany,Europe
611,Leon Dajaku,GER,Union Berlin,Bundesliga,2020,19.0,2001.0,0.4,0,0,0,0,0,0,0,,0,0,0,0,0,0,0,0,FW,Under 20,Forward,Germany,Europe
613,Diogo Dalot,POR,Milan,Serie A,2020,21.0,1999.0,12.1,32,17,23,6,3,17,34,50.0,17,18,5,13,25,57,42,0,DF,20-24,Defender,Portugal,Europe
614,Mikkel Damsgaard,DEN,Sampdoria,Serie A,2020,20.0,2000.0,19.7,42,21,14,20,8,22,70,31.4,48,40,4,36,24,66,17,0,"MF,FW",20-24,Midfielder,Denmark,Europe
615,Flavius Daniliuc,AUT,Nice,Ligue 1,2020,19.0,2001.0,16.4,23,15,15,5,3,10,21,47.6,11,17,6,11,14,37,32,0,DF,Under 20,Defender,Austria,Europe
616,Danilo,BRA,Juventus,Serie A,2020,29.0,1991.0,32.4,62,31,37,16,9,35,66,53.0,31,32,12,20,66,128,68,2,"DF,MF",25-29,Defender,Brazil,South America
616,Danilo,BRA,Juventus,Serie A,2020,29.0,1991.0,32.4,62,31,37,16,9,35,66,53.0,31,32,12,20,66,128,68,2,"DF,MF",25-29,Defender,Brazil,South America
616,Danilo,BRA,Juventus,Serie A,2020,29.0,1991.0,32.4,62,31,37,16,9,35,66,53.0,31,32,12,20,66,128,68,2,"DF,MF",25-29,Defender,Brazil,South America
616,Danilo,BRA,Juventus,Serie A,2020,29.0,1991.0,32.4,62,31,37,16,9,35,66,53.0,31,32,12,20,66,128,68,2,"DF,MF",25-29,Defender,Brazil,South America
616,Danilo,BRA,Juventus,Serie A,2020,29.0,1991.0,32.4,62,31,37,16,9,35,66,53.0,31,32,12,20,66,128,68,2,"DF,MF",25-29,Defender,Brazil,South America
616,Danilo,BRA,Juventus,Serie A,2020,29.0,1991.0,32.4,62,31,37,16,9,35,66,53.0,31,32,12,20,66,128,68,2,"DF,MF",25-29,Defender,Brazil,South America
616,Danilo,BRA,Juventus,Serie A,2020,29.0,1991.0,32.4,62,31,37,16,9,35,66,53.0,31,32,12,20,66,128,68,2,"DF,MF",25-29,Defender,Brazil,South America
616,Danilo,BRA,Juventus,Serie A,2020,29.0,1991.0,32.4,62,31,37,16,9,35,66,53.0,31,32,12,20,66,128,68,2,"DF,MF",25-29,Defender,Brazil,South America
616,Danilo,BRA,Juventus,Serie A,2020,29.0,1991.0,32.4,62,31,37,16,9,35,66,53.0,31,32,12,20,66,128,68,2,"DF,MF",25-29,Defender,Brazil,South America
616,Danilo,BRA,Juventus,Serie A,2020,29.0,1991.0,32.4,62,31,37,16,9,35,66,53.0,31,32,12,20,66,128,68,2,"DF,MF",25-29,Defender,Brazil,South America
616,Danilo,BRA,Juventus,Serie A,2020,29.0,1991.0,32.4,62,31,37,16,9,35,66,53.0,31,32,12,20,66,128,68,2,"DF,MF",25-29,Defender,Brazil,South America
616,Danilo,BRA,Juventus,Serie A,2020,29.0,1991.0,32.4,62,31,37,16,9,35,66,53.0,31,32,12,20,66,128,68,2,"DF,MF",25-29,Defender,Brazil,South America
616,Danilo,BRA,Juventus,Serie A,2020,29.0,1991.0,32.4,62,31,37,16,9,35,66,53.0,31,32,12,20,66,128,68,2,"DF,MF",25-29,Defender,Brazil,South America
616,Danilo,BRA,Juventus,Serie A,2020,29.0,1991.0,32.4,62,31,37,16,9,35,66,53.0,31,32,12,20,66,128,68,2,"DF,MF",25-29,Defender,Brazil,South America
616,Danilo,BRA,Juventus,Serie A,2020,29.0,1991.0,32.4,62,31,37,16,9,35,66,53.0,31,32,12,20,66,128,68,2,"DF,MF",25-29,Defender,Brazil,South America
616,Danilo,BRA,Juventus,Serie A,2020,29.0,1991.0,32.4,62,31,37,16,9,35,66,53.0,31,32,12,20,66,128,68,2,"DF,MF",25-29,Defender,Brazil,South America
616,Danilo,BRA,Juventus,Serie A,2020,29.0,1991.0,32.4,62,31,37,16,9,35,66,53.0,31,32,12,20,66,128,68,2,"DF,MF",25-29,Defender,Brazil,South America
616,Danilo,BRA,Juventus,Serie A,2020,29.0,1991.0,32.4,62,31,37,16,9,35,66,53.0,31,32,12,20,66,128,68,2,"DF,MF",25-29,Defender,Brazil,South America
616,Danilo,BRA,Juventus,Serie A,2020,29.0,1991.0,32.4,62,31,37,16,9,35,66,53.0,31,32,12,20,66,128,68,2,"DF,MF",25-29,Defender,Brazil,South America
616,Danilo,BRA,Juventus,Serie A,2020,29.0,1991.0,32.4,62,31,37,16,9,35,66,53.0,31,32,12,20,66,128,68,2,"DF,MF",25-29,Defender,Brazil,South America
616,Danilo,BRA,Juventus,Serie A,2020,29.0,1991.0,32.4,62,31,37,16,9,35,66,53.0,31,32,12,20,66,128,68,2,"DF,MF",25-29,Defender,Brazil,South America
616,Danilo,BRA,Juventus,Serie A,2020,29.0,1991.0,32.4,62,31,37,16,9,35,66,53.0,31,32,12,20,66,128,68,2,"DF,MF",25-29,Defender,Brazil,South America
616,Danilo,BRA,Juventus,Serie A,2020,29.0,1991.0,32.4,62,31,37,16,9,35,66,53.0,31,32,12,20,66,128,68,2,"DF,MF",25-29,Defender,Brazil,South America
616,Danilo,BRA,Juventus,Serie A,2020,29.0,1991.0,32.4,62,31,37,16,9,35,66,53.0,31,32,12,20,66,128,68,2,"DF,MF",25-29,Defender,Brazil,South America
616,Danilo,BRA,Juventus,Serie A,2020,29.0,1991.0,32.4,62,31,37,16,9,35,66,53.0,31,32,12,20,66,128,68,2,"DF,MF",25-29,Defender,Brazil,South America
616,Danilo,BRA,Juventus,Serie A,2020,29.0,1991.0,32.4,62,31,37,16,9,35,66,53.0,31,32,12,20,66,128,68,2,"DF,MF",25-29,Defender,Brazil,South America
616,Danilo,BRA,Juventus,Serie A,2020,29.0,1991.0,32.4,62,31,37,16,9,35,66,53.0,31,32,12,20,66,128,68,2,"DF,MF",25-29,Defender,Brazil,South America
616,Danilo,BRA,Juventus,Serie A,2020,29.0,1991.0,32.4,62,31,37,16,9,35,66,53.0,31,32,12,20,66,128,68,2,"DF,MF",25-29,Defender,Brazil,South America
616,Danilo,BRA,Juventus,Serie A,2020,29.0,1991.0,32.4,62,31,37,16,9,35,66,53.0,31,32,12,20,66,128,68,2,"DF,MF",25-29,Defender,Brazil,South America
616,Danilo,BRA,Juventus,Serie A,2020,29.0,1991.0,32.4,62,31,37,16,9,35,66,53.0,31,32,12,20,66,128,68,2,"DF,MF",25-29,Defender,Brazil,South America
616,Danilo,BRA,Juventus,Serie A,2020,29.0,1991.0,32.4,62,31,37,16,9,35,66,53.0,31,32,12,20,66,128,68,2,"DF,MF",25-29,Defender,Brazil,South America
616,Danilo,BRA,Juventus,Serie A,2020,29.0,1991.0,32.4,62,31,37,16,9,35,66,53.0,31,32,12,20,66,128,68,2,"DF,MF",25-29,Defender,Brazil,South America
616,Danilo,BRA,Juventus,Serie A,2020,29.0,1991.0,32.4,62,31,37,16,9,35,66,53.0,31,32,12,20,66,128,68,2,"DF,MF",25-29,Defender,Brazil,South America
616,Danilo,BRA,Juventus,Serie A,2020,29.0,1991.0,32.4,62,31,37,16,9,35,66,53.0,31,32,12,20,66,128,68,2,"DF,MF",25-29,Defender,Brazil,South America
616,Danilo,BRA,Juventus,Serie A,2020,29.0,1991.0,32.4,62,31,37,16,9,35,66,53.0,31,32,12,20,66,128,68,2,"DF,MF",25-29,Defender,Brazil,South America
616,Danilo,BRA,Juventus,Serie A,2020,29.0,1991.0,32.4,62,31,37,16,9,35,66,53.0,31,32,12,20,66,128,68,2,"DF,MF",25-29,Defender,Brazil,South America
616,Danilo,BRA,Juventus,Serie A,2020,29.0,1991.0,32.4,62,31,37,16,9,35,66,53.0,31,32,12,20,66,128,68,2,"DF,MF",25-29,Defender,Brazil,South America
616,Danilo,BRA,Juventus,Serie A,2020,29.0,1991.0,32.4,62,31,37,16,9,35,66,53.0,31,32,12,20,66,128,68,2,"DF,MF",25-29,Defender,Brazil,South America
616,Danilo,BRA,Juventus,Serie A,2020,29.0,1991.0,32.4,62,31,37,16,9,35,66,53.0,31,32,12,20,66,128,68,2,"DF,MF",25-29,Defender,Brazil,South America
616,Danilo,BRA,Juventus,Serie A,2020,29.0,1991.0,32.4,62,31,37,16,9,35,66,53.0,31,32,12,20,66,128,68,2,"DF,MF",25-29,Defender,Brazil,South America
616,Danilo,BRA,Juventus,Serie A,2020,29.0,1991.0,32.4,62,31,37,16,9,35,66,53.0,31,32,12,20,66,128,68,2,"DF,MF",25-29,Defender,Brazil,South America
616,Danilo,BRA,Juventus,Serie A,2020,29.0,1991.0,32.4,62,31,37,16,9,35,66,53.0,31,32,12,20,66,128,68,2,"DF,MF",25-29,Defender,Brazil,South America
616,Danilo,BRA,Juventus,Serie A,2020,29.0,1991.0,32.4,62,31,37,16,9,35,66,53.0,31,32,12,20,66,128,68,2,"DF,MF",25-29,Defender,Brazil,South America
616,Danilo,BRA,Juventus,Serie A,2020,29.0,1991.0,32.4,62,31,37,16,9,35,66,53.0,31,32,12,20,66,128,68,2,"DF,MF",25-29,Defender,Brazil,South America
616,Danilo,BRA,Juventus,Serie A,2020,29.0,1991.0,32.4,62,31,37,16,9,35,66,53.0,31,32,12,20,66,128,68,2,"DF,MF",25-29,Defender,Brazil,South America
616,Danilo,BRA,Juventus,Serie A,2020,29.0,1991.0,32.4,62,31,37,16,9,35,66,53.0,31,32,12,20,66,128,68,2,"DF,MF",25-29,Defender,Brazil,South America
616,Danilo,BRA,Juventus,Serie A,2020,29.0,1991.0,32.4,62,31,37,16,9,35,66,53.0,31,32,12,20,66,128,68,2,"DF,MF",25-29,Defender,Brazil,South America
616,Danilo,BRA,Juventus,Serie A,2020,29.0,1991.0,32.4,62,31,37,16,9,35,66,53.0,31,32,12,20,66,128,68,2,"DF,MF",25-29,Defender,Brazil,South America
616,Danilo,BRA,Juventus,Serie A,2020,29.0,1991.0,32.4,62,31,37,16,9,35,66,53.0,31,32,12,20,66,128,68,2,"DF,MF",25-29,Defender,Brazil,South America
617,Scott Dann,ENG,Crystal Palace,Premier League,2020,33.0,1987.0,15.0,6,4,5,1,0,4,11,36.4,7,16,14,2,18,24,59,1,DF,30-34,Defender,England,Europe
619,Dante,BRA,Nice,Ligue 1,2020,36.0,1983.0,8.6,10,5,6,4,0,3,7,42.9,4,6,4,2,10,20,20,0,DF,35-39,Defender,Brazil,South America
620,Andrea Danzi,ITA,Hellas Verona,Serie A,2020,21.0,1999.0,1.2,0,0,0,0,0,0,1,0.0,1,0,0,0,3,3,1,0,DF,20-24,Defender,Italy,Europe
621,Ebrima Darboe,GAM,Roma,Serie A,2020,19.0,2001.0,3.6,5,2,3,1,1,3,10,30.0,7,3,0,3,8,13,0,1,MF,Under 20,Midfielder,Gambia,Africa
622,Márton Dárdai,HUN,Hertha BSC,Bundesliga,2020,18.0,2002.0,9.1,17,10,10,6,1,9,16,56.3,7,7,3,4,16,33,31,0,"DF,MF",Under 20,Defender,Hungary,Europe
624,Karl Darlow,WAL,Newcastle Utd,Premier League,2020,29.0,1990.0,25.0,0,0,0,0,0,0,0,,0,0,0,0,0,0,17,0,GK,25-29,Goalkeeper,Wales,Europe
625,Matteo Darmian,ITA,Parma,Serie A,2020,30.0,1989.0,2.3,6,5,3,3,0,4,7,57.1,3,2,0,2,6,12,7,0,DF,30-34,Defender,Italy,Europe
626,Matteo Darmian,ITA,Inter,Serie A,2020,30.0,1989.0,12.9,30,16,12,7,11,16,28,57.1,12,9,2,7,17,47,35,0,DF,30-34,Defender,Italy,Europe
627,Jonathan David,CAN,Lille,Ligue 1,2020,20.0,2000.0,26.2,17,10,5,5,7,9,24,37.5,15,19,1,18,3,20,9,0,FW,20-24,Forward,Canada,North America
628,Alphonso Davies,CAN,Bayern Munich,Bundesliga,2020,19.0,2000.0,19.6,39,27,16,17,6,28,40,70.0,12,21,1,20,28,67,33,1,DF,Under 20,Defender,Canada,North America
629,Ben Davies,WAL,Tottenham,Premier League,2020,27.0,1993.0,15.0,27,17,10,11,6,13,30,43.3,17,10,5,5,18,45,49,2,DF,25-29,Defender,Wales,Europe
629,Ben Davies,WAL,Tottenham,Premier League,2020,27.0,1993.0,15.0,27,17,10,11,6,13,30,43.3,17,10,5,5,18,45,49,2,DF,25-29,Defender,Wales,Europe
629,Ben Davies,WAL,Tottenham,Premier League,2020,27.0,1993.0,15.0,27,17,10,11,6,13,30,43.3,17,10,5,5,18,45,49,2,DF,25-29,Defender,Wales,Europe
629,Ben Davies,WAL,Tottenham,Premier League,2020,27.0,1993.0,15.0,27,17,10,11,6,13,30,43.3,17,10,5,5,18,45,49,2,DF,25-29,Defender,Wales,Europe
630,Tom Davies,ENG,Everton,Premier League,2020,22.0,1998.0,15.8,31,18,17,12,2,16,39,41.0,23,15,9,6,34,65,21,2,MF,20-24,Midfielder,England,Europe
630,Tom Davies,ENG,Everton,Premier League,2020,22.0,1998.0,15.8,31,18,17,12,2,16,39,41.0,23,15,9,6,34,65,21,2,MF,20-24,Midfielder,England,Europe
630,Tom Davies,ENG,Everton,Premier League,2020,22.0,1998.0,15.8,31,18,17,12,2,16,39,41.0,23,15,9,6,34,65,21,2,MF,20-24,Midfielder,England,Europe
630,Tom Davies,ENG,Everton,Premier League,2020,22.0,1998.0,15.8,31,18,17,12,2,16,39,41.0,23,15,9,6,34,65,21,2,MF,20-24,Midfielder,England,Europe
631,Keinan Davis,ENG,Aston Villa,Premier League,2020,22.0,1998.0,3.1,2,1,1,0,1,0,1,0.0,1,1,0,1,0,2,2,0,"FW,MF",20-24,Forward,England,Europe
632,Leif Davis,ENG,Leeds United,Premier League,2020,20.0,2000.0,0.4,0,0,0,0,0,0,3,0.0,3,1,0,1,1,1,0,0,DF,20-24,Defender,England,Europe
634,Craig Dawson,ENG,West Ham,Premier League,2020,30.0,1990.0,21.4,11,8,7,4,0,5,12,41.7,7,26,22,4,32,43,88,3,DF,30-34,Defender,England,Europe
635,Kevin De Bruyne,BEL,Manchester City,Premier League,2020,29.0,1991.0,22.2,34,21,6,18,10,13,48,27.1,35,26,1,25,9,43,10,0,MF,25-29,Midfielder,Belgium,Europe
636,Sebastien De Maio,FRA,Udinese,Serie A,2020,33.0,1987.0,9.5,15,10,6,9,0,4,5,80.0,1,16,9,7,18,33,41,0,DF,30-34,Defender,France,Europe
637,Rodrigo De Paul,ARG,Udinese,Serie A,2020,26.0,1994.0,35.6,41,24,17,22,2,15,60,25.0,45,32,1,31,17,58,20,1,MF,25-29,Midfielder,Argentina,South America
638,Mattia De Sciglio,ITA,Juventus,Serie A,2020,27.0,1992.0,0.3,0,0,0,0,0,0,0,,0,0,0,0,0,0,1,0,DF,25-29,Defender,Italy,Europe
639,Mattia De Sciglio,ITA,Lyon,Ligue 1,2020,27.0,1992.0,16.3,29,17,15,11,3,18,27,66.7,9,13,4,9,27,56,44,0,DF,25-29,Defender,Italy,Europe
640,Lorenzo De Silvestri,ITA,Bologna,Serie A,2020,32.0,1988.0,23.8,34,24,18,13,3,16,37,43.2,21,37,10,27,30,64,62,3,DF,30-34,Defender,Italy,Europe
641,Thibault De Smet,BEL,Reims,Ligue 1,2020,22.0,1998.0,5.5,11,6,8,3,0,6,15,40.0,9,8,1,7,6,17,16,0,DF,20-24,Defender,Belgium,Europe
642,Lucas Deaux,FRA,Nîmes,Ligue 1,2020,31.0,1988.0,19.5,47,32,20,22,5,16,49,32.7,33,20,3,17,20,67,30,4,"MF,DF",30-34,Midfielder,France,Europe
643,Mathieu Debuchy,FRA,Saint-Étienne,Ligue 1,2020,35.0,1985.0,23.4,58,33,37,17,4,40,62,64.5,22,27,9,18,45,103,61,0,DF,35-39,Defender,France,Europe
645,Alessandro Deiola,ITA,Spezia,Serie A,2020,24.0,1995.0,4.0,6,3,2,3,1,5,13,38.5,8,3,1,2,3,9,1,0,MF,20-24,Midfielder,Italy,Europe
646,Alessandro Deiola,ITA,Cagliari,Serie A,2020,24.0,1995.0,6.8,13,5,5,4,4,8,23,34.8,15,7,2,5,11,24,11,0,MF,20-24,Midfielder,Italy,Europe
647,Romain Del Castillo,FRA,Rennes,Ligue 1,2020,24.0,1996.0,7.2,30,11,5,14,11,5,25,20.0,20,6,0,6,3,33,4,1,"MF,FW",20-24,Midfielder,France,Europe
648,Lorenzo Del Pinto,ITA,Benevento,Serie A,2020,30.0,1990.0,0.1,0,0,0,0,0,0,2,0.0,2,0,0,0,0,0,0,0,MF,30-34,Midfielder,Italy,Europe
649,Thomas Delaine,FRA,Metz,Ligue 1,2020,28.0,1992.0,19.8,32,18,19,11,2,20,35,57.1,15,22,5,17,24,56,30,1,"DF,FW",25-29,Defender,France,Europe
651,Liam Delap,ENG,Manchester City,Premier League,2020,17.0,2003.0,0.4,0,0,0,0,0,0,0,,0,0,0,0,0,0,0,0,FW,Under 20,Forward,England,Europe
652,Jonathan Delaplace,FRA,Lorient,Ligue 1,2020,34.0,1986.0,10.1,8,5,5,1,2,7,13,53.8,6,12,5,7,17,25,19,1,DF,30-34,Defender,France,Europe
654,Cristian Dell'Orco,ITA,Spezia,Serie A,2020,26.0,1994.0,2.9,1,0,1,0,0,1,3,33.3,2,8,5,3,7,8,9,1,DF,25-29,Defender,Italy,Europe
655,Andy Delort,ALG,Montpellier,Ligue 1,2020,28.0,1991.0,27.6,12,7,1,9,2,8,18,44.4,10,11,1,10,4,16,34,0,FW,25-29,Forward,Algeria,Africa
656,Fabian Delph,ENG,Everton,Premier League,2020,30.0,1989.0,3.0,5,2,3,2,0,1,3,33.3,2,2,0,2,4,9,8,1,"MF,DF",30-34,Midfielder,England,Europe
657,Moussa Dembélé,FRA,Atlético Madrid,La Liga,2020,24.0,1996.0,1.1,0,0,0,0,0,0,1,0.0,1,0,0,0,1,1,0,0,FW,20-24,Forward,France,Europe
658,Moussa Dembélé,FRA,Lyon,Ligue 1,2020,24.0,1996.0,7.5,2,2,0,1,1,0,4,0.0,4,4,2,2,5,7,9,0,FW,20-24,Forward,France,Europe
659,Ousmane Dembélé,FRA,Barcelona,La Liga,2020,23.0,1997.0,19.7,14,9,4,9,1,6,17,35.3,11,10,0,10,9,23,3,1,FW,20-24,Forward,France,Europe
660,Merih Demiral,TUR,Juventus,Serie A,2020,22.0,1998.0,10.4,12,9,8,4,0,5,13,38.5,8,16,9,7,21,33,40,0,DF,20-24,Defender,Turkey,Asia
663,Diego Demme,GER,Napoli,Serie A,2020,28.0,1991.0,17.7,56,32,26,22,8,23,63,36.5,40,14,1,13,11,67,15,1,MF,25-29,Midfielder,Germany,Europe
664,Jason Denayer,BEL,Lyon,Ligue 1,2020,25.0,1995.0,29.0,25,16,16,9,0,6,13,46.2,7,36,25,11,27,52,91,1,DF,25-29,Defender,Belgium,Europe
667,Emmanuel Dennis,NGA,Köln,Bundesliga,2020,22.0,1997.0,5.3,13,7,6,5,2,1,6,16.7,5,6,0,6,0,13,0,1,FW,20-24,Forward,Nigeria,Africa
669,Fabio Depaoli,ITA,Benevento,Serie A,2020,23.0,1997.0,12.4,25,13,15,6,4,15,32,46.9,17,16,4,12,12,37,38,0,DF,20-24,Defender,Italy,Europe
670,Fabio Depaoli,ITA,Sampdoria,Serie A,2020,23.0,1997.0,0.9,1,0,0,1,0,0,2,0.0,2,0,0,0,1,2,1,0,MF,20-24,Midfielder,Italy,Europe
671,Fabio Depaoli,ITA,Atalanta,Serie A,2020,23.0,1997.0,2.1,3,2,0,1,2,1,2,50.0,1,4,0,4,3,6,2,0,DF,20-24,Defender,Italy,Europe
672,Clément Depres,FRA,Nîmes,Ligue 1,2020,25.0,1994.0,0.2,0,0,0,0,0,0,0,,0,0,0,0,0,0,0,0,FW,25-29,Forward,France,Europe
674,Kastriot Dermaku,ALB,Parma,Serie A,2020,28.0,1992.0,1.1,1,1,1,0,0,0,0,,0,2,1,1,2,3,8,0,DF,25-29,Defender,Albania,Europe
677,Mattia Destro,ITA,Genoa,Serie A,2020,29.0,1991.0,17.8,6,3,0,3,3,2,9,22.2,7,11,0,11,4,10,8,0,FW,25-29,Forward,Italy,Europe
679,Deyverson,BRA,Alavés,La Liga,2020,29.0,1991.0,9.7,6,4,3,1,2,2,13,15.4,11,9,0,9,9,15,13,0,FW,25-29,Forward,Brazil,South America
680,Jacopo Dezi,ITA,Parma,Serie A,2020,28.0,1992.0,0.9,4,3,0,2,2,3,6,50.0,3,2,0,2,0,4,0,0,"FW,MF",25-29,Forward,Italy,Europe
681,Samuel Di Carmine,ITA,Hellas Verona,Serie A,2020,31.0,1988.0,5.6,1,2,0,1,0,0,3,0.0,3,1,0,1,0,1,5,0,FW,30-34,Forward,Italy,Europe
682,Samuel Di Carmine,ITA,Crotone,Serie A,2020,31.0,1988.0,5.3,2,2,1,0,1,1,3,33.3,2,2,0,2,0,2,5,0,FW,30-34,Forward,Italy,Europe
683,Giovanni Di Lorenzo,ITA,Napoli,Serie A,2020,26.0,1993.0,36.0,79,50,54,21,4,43,75,57.3,32,37,13,24,35,114,64,1,DF,25-29,Defender,Italy,Europe
685,Alessandro Di Pardo,ITA,Juventus,Serie A,2020,21.0,1999.0,0.2,0,0,0,0,0,0,0,,0,1,1,0,0,0,0,0,"FW,DF",20-24,Forward,Italy,Europe
686,Giuseppe Di Serio,ITA,Benevento,Serie A,2020,19.0,2001.0,3.2,2,2,1,1,0,0,4,0.0,4,5,0,5,0,2,4,0,"FW,MF",Under 20,Forward,Italy,Europe
687,Boulaye Dia,SEN,Reims,Ligue 1,2020,23.0,1996.0,32.6,23,12,3,11,9,4,22,18.2,18,19,5,14,12,35,37,1,"FW,MF",20-24,Forward,Senegal,Africa
689,Moussa Diaby,FRA,Leverkusen,Bundesliga,2020,21.0,1999.0,26.5,10,6,4,5,1,6,20,30.0,14,11,0,11,12,22,5,0,"FW,MF",20-24,Forward,France,Europe
691,Mouctar Diakhaby,GUI,Valencia,La Liga,2020,23.0,1996.0,23.1,16,8,10,6,0,8,12,66.7,4,28,21,7,27,43,102,1,DF,20-24,Defender,Guinea,Africa
692,Abdou Diallo,SEN,Paris S-G,Ligue 1,2020,24.0,1996.0,16.6,16,11,9,5,2,8,13,61.5,5,15,8,7,25,41,36,0,DF,20-24,Defender,Senegal,Africa
693,Amad Diallo,CIV,Manchester Utd,Premier League,2020,18.0,2002.0,1.8,3,3,1,2,0,0,0,,0,2,1,1,0,3,1,0,FW,Under 20,Forward,Ivory Coast,Africa
694,Amad Diallo,CIV,Atalanta,Serie A,2020,18.0,2002.0,0.2,0,0,0,0,0,0,0,,0,0,0,0,0,0,0,0,MF,Under 20,Midfielder,Ivory Coast,Africa
695,Habib Diallo,SEN,Strasbourg,Ligue 1,2020,25.0,1995.0,25.8,11,6,3,6,2,7,18,38.9,11,12,2,10,13,24,12,0,FW,25-29,Forward,Senegal,Africa
696,Habib Diallo,SEN,Metz,Ligue 1,2020,25.0,1995.0,1.6,1,1,0,1,0,1,1,100.0,0,0,0,0,0,1,5,0,"FW,MF",25-29,Forward,Senegal,Africa
697,Ibrahima Diallo,FRA,Southampton,Premier League,2020,21.0,1999.0,11.3,29,16,11,17,1,9,16,56.3,7,10,1,9,10,39,12,2,MF,20-24,Midfielder,France,Europe
697,Ibrahima Diallo,FRA,Southampton,Premier League,2020,21.0,1999.0,11.3,29,16,11,17,1,9,16,56.3,7,10,1,9,10,39,12,2,MF,20-24,Midfielder,France,Europe
697,Ibrahima Diallo,FRA,Southampton,Premier League,2020,21.0,1999.0,11.3,29,16,11,17,1,9,16,56.3,7,10,1,9,10,39,12,2,MF,20-24,Midfielder,France,Europe
697,Ibrahima Diallo,FRA,Southampton,Premier League,2020,21.0,1999.0,11.3,29,16,11,17,1,9,16,56.3,7,10,1,9,10,39,12,2,MF,20-24,Midfielder,France,Europe
697,Ibrahima Diallo,FRA,Southampton,Premier League,2020,21.0,1999.0,11.3,29,16,11,17,1,9,16,56.3,7,10,1,9,10,39,12,2,MF,20-24,Midfielder,France,Europe
697,Ibrahima Diallo,FRA,Southampton,Premier League,2020,21.0,1999.0,11.3,29,16,11,17,1,9,16,56.3,7,10,1,9,10,39,12,2,MF,20-24,Midfielder,France,Europe
697,Ibrahima Diallo,FRA,Southampton,Premier League,2020,21.0,1999.0,11.3,29,16,11,17,1,9,16,56.3,7,10,1,9,10,39,12,2,MF,20-24,Midfielder,France,Europe
697,Ibrahima Diallo,FRA,Southampton,Premier League,2020,21.0,1999.0,11.3,29,16,11,17,1,9,16,56.3,7,10,1,9,10,39,12,2,MF,20-24,Midfielder,France,Europe
697,Ibrahima Diallo,FRA,Southampton,Premier League,2020,21.0,1999.0,11.3,29,16,11,17,1,9,16,56.3,7,10,1,9,10,39,12,2,MF,20-24,Midfielder,France,Europe
698,Ibrahima Diallo,FRA,Brest,Ligue 1,2020,21.0,1999.0,4.9,14,9,2,9,3,4,8,50.0,4,4,0,4,3,17,3,0,MF,20-24,Midfielder,France,Europe
698,Ibrahima Diallo,FRA,Brest,Ligue 1,2020,21.0,1999.0,4.9,14,9,2,9,3,4,8,50.0,4,4,0,4,3,17,3,0,MF,20-24,Midfielder,France,Europe
698,Ibrahima Diallo,FRA,Brest,Ligue 1,2020,21.0,1999.0,4.9,14,9,2,9,3,4,8,50.0,4,4,0,4,3,17,3,0,MF,20-24,Midfielder,France,Europe
698,Ibrahima Diallo,FRA,Brest,Ligue 1,2020,21.0,1999.0,4.9,14,9,2,9,3,4,8,50.0,4,4,0,4,3,17,3,0,MF,20-24,Midfielder,France,Europe
698,Ibrahima Diallo,FRA,Brest,Ligue 1,2020,21.0,1999.0,4.9,14,9,2,9,3,4,8,50.0,4,4,0,4,3,17,3,0,MF,20-24,Midfielder,France,Europe
698,Ibrahima Diallo,FRA,Brest,Ligue 1,2020,21.0,1999.0,4.9,14,9,2,9,3,4,8,50.0,4,4,0,4,3,17,3,0,MF,20-24,Midfielder,France,Europe
698,Ibrahima Diallo,FRA,Brest,Ligue 1,2020,21.0,1999.0,4.9,14,9,2,9,3,4,8,50.0,4,4,0,4,3,17,3,0,MF,20-24,Midfielder,France,Europe
698,Ibrahima Diallo,FRA,Brest,Ligue 1,2020,21.0,1999.0,4.9,14,9,2,9,3,4,8,50.0,4,4,0,4,3,17,3,0,MF,20-24,Midfielder,France,Europe
698,Ibrahima Diallo,FRA,Brest,Ligue 1,2020,21.0,1999.0,4.9,14,9,2,9,3,4,8,50.0,4,4,0,4,3,17,3,0,MF,20-24,Midfielder,France,Europe
699,Amadou Diambo,GHA,Benevento,Serie A,2020,19.0,2001.0,0.0,0,0,0,0,0,0,0,,0,0,0,0,0,0,0,0,FW,Under 20,Forward,Ghana,Africa
700,Grady Diangana,COD,West Brom,Premier League,2020,22.0,1998.0,13.7,35,19,19,9,7,19,43,44.2,24,16,2,14,16,51,9,0,"MF,FW",20-24,Midfielder,DR Congo,Africa
701,Stéphane Diarra,FRA,Lorient,Ligue 1,2020,21.0,1998.0,2.2,0,0,0,0,0,0,7,0.0,7,6,1,5,4,4,1,0,"MF,FW",20-24,Midfielder,France,Europe
702,Rúben Dias,POR,Manchester City,Premier League,2020,23.0,1997.0,31.6,24,13,13,8,3,4,16,25.0,12,31,23,8,35,59,92,0,DF,20-24,Defender,Portugal,Europe
703,Krépin Diatta,SEN,Monaco,Ligue 1,2020,21.0,1999.0,4.3,4,3,1,1,2,1,3,33.3,2,5,1,4,4,8,1,0,"MF,DF",20-24,Midfielder,Senegal,Africa
705,Brahim Díaz,MAR,Milan,Serie A,2020,20.0,1999.0,13.6,18,10,7,7,4,10,23,43.5,13,10,0,10,2,20,2,0,"MF,FW",20-24,Midfielder,Morocco,Africa
707,Daniel Didavi,GER,Stuttgart,Bundesliga,2020,30.0,1990.0,10.8,16,6,2,9,5,7,12,58.3,5,10,0,10,3,19,8,0,"MF,FW",30-34,Midfielder,Germany,Europe
709,Eric Dier,ENG,Tottenham,Premier League,2020,26.0,1994.0,28.0,23,14,13,10,0,11,18,61.1,7,37,31,6,23,46,123,3,DF,25-29,Defender,England,Europe
711,Lucas Digne,FRA,Everton,Premier League,2020,27.0,1993.0,29.8,63,38,40,16,7,29,54,53.7,25,42,4,38,31,94,87,0,"DF,MF",25-29,Defender,France,Europe
714,Federico Dimarco,ITA,Hellas Verona,Serie A,2020,22.0,1997.0,29.0,32,19,23,7,2,13,28,46.4,15,18,9,9,47,79,50,1,DF,20-24,Defender,Italy,Europe
715,Junior Dina Ebimbe,FRA,Dijon,Ligue 1,2020,19.0,2000.0,23.8,38,25,14,19,5,15,45,33.3,30,17,1,16,14,52,9,0,"FW,MF",Under 20,Forward,France,Europe
716,Tristan Dingomé,CMR,Reims,Ligue 1,2020,29.0,1991.0,0.2,0,0,0,0,0,0,1,0.0,1,0,0,0,0,0,0,0,MF,25-29,Midfielder,Cameroon,Africa
717,Eren Dinkçi,GER,Werder Bremen,Bundesliga,2020,18.0,2001.0,1.2,1,1,1,0,0,0,1,0.0,1,4,0,4,2,3,1,0,"MF,FW",Under 20,Midfielder,Germany,Europe
720,Issa Diop,FRA,West Ham,Premier League,2020,23.0,1997.0,15.3,20,14,12,8,0,7,18,38.9,11,32,22,10,22,42,59,0,DF,20-24,Defender,France,Europe
722,Sofiane Diop,FRA,Monaco,Ligue 1,2020,20.0,2000.0,22.5,49,34,17,25,7,18,53,34.0,35,25,1,24,31,80,15,0,"MF,FW",20-24,Midfielder,France,Europe
724,Yehvann Diouf,FRA,Reims,Ligue 1,2020,20.0,1999.0,1.5,0,0,0,0,0,0,0,,0,0,0,0,0,0,0,0,GK,20-24,Goalkeeper,France,Europe
725,Assane Dioussé,SEN,Saint-Étienne,Ligue 1,2020,22.0,1997.0,0.0,0,0,0,0,0,0,0,,0,0,0,0,0,0,0,0,DF,20-24,Defender,Senegal,Africa
726,Jonas Dirkner,GER,Hertha BSC,Bundesliga,2020,18.0,2002.0,0.2,0,0,0,0,0,0,0,,0,0,0,0,0,0,0,0,MF,Under 20,Midfielder,Germany,Europe
727,Axel Disasi,FRA,Monaco,Ligue 1,2020,22.0,1998.0,22.3,29,20,17,12,0,20,35,57.1,15,18,11,7,26,55,66,1,DF,20-24,Defender,France,Europe
731,Koffi Djidji,CIV,Crotone,Serie A,2020,27.0,1992.0,16.9,39,28,30,8,1,10,20,50.0,10,35,20,15,28,67,73,0,DF,25-29,Defender,Ivory Coast,Africa
733,Berat Djimsiti,ALB,Atalanta,Serie A,2020,27.0,1993.0,29.2,41,29,27,12,2,17,34,50.0,17,34,20,14,62,103,89,1,DF,25-29,Defender,Albania,Europe
735,Ritsu Doan,JPN,Arminia,Bundesliga,2020,22.0,1998.0,30.8,53,31,22,19,12,19,52,36.5,33,42,1,41,31,84,11,0,"MF,FW",20-24,Midfielder,Japan,Asia
737,Matt Doherty,IRL,Tottenham,Premier League,2020,28.0,1992.0,13.8,29,15,15,10,4,13,33,39.4,20,20,5,15,23,52,46,0,DF,25-29,Defender,Republic of Ireland,Europe
740,Keagan Dolly,RSA,Montpellier,Ligue 1,2020,27.0,1993.0,5.0,7,2,6,0,1,4,8,50.0,4,3,0,3,5,12,2,0,MF,25-29,Midfielder,South Africa,Africa
743,Nicolás Domínguez,ARG,Bologna,Serie A,2020,22.0,1998.0,13.9,48,28,26,17,5,15,37,40.5,22,26,7,19,24,72,20,0,MF,20-24,Midfielder,Argentina,South America
746,Anastasios Donis,GRE,Reims,Ligue 1,2020,23.0,1996.0,1.1,4,1,2,0,2,1,1,100.0,0,0,0,0,0,4,0,0,MF,20-24,Midfielder,Greece,Europe
747,Gianluigi Donnarumma,ITA,Milan,Serie A,2020,21.0,1999.0,37.0,0,0,0,0,0,0,1,0.0,1,1,0,1,1,1,23,2,GK,20-24,Goalkeeper,Italy,Europe
749,Abdoulaye Doucouré,MLI,Everton,Premier League,2020,27.0,1993.0,27.1,52,32,25,19,8,14,43,32.6,29,24,7,17,39,91,31,1,MF,25-29,Midfielder,Mali,Africa
750,Cheick Doucouré,MLI,Lens,Ligue 1,2020,20.0,2000.0,29.2,87,47,40,42,5,32,65,49.2,33,20,4,16,52,139,26,1,MF,20-24,Midfielder,Mali,Africa
755,Moussa Doumbia,MLI,Reims,Ligue 1,2020,25.0,1994.0,10.0,10,6,4,4,2,4,22,18.2,18,5,1,4,10,20,4,0,"MF,FW",25-29,Midfielder,Mali,Africa
763,Dominick Drexler,GER,Köln,Bundesliga,2020,30.0,1990.0,13.7,36,26,15,18,3,12,30,40.0,18,5,1,4,14,50,15,0,"MF,FW",30-34,Midfielder,Germany,Europe
764,Matthieu Dreyer,FRA,Lorient,Ligue 1,2020,31.0,1989.0,15.0,0,0,0,0,0,0,0,,0,0,0,0,0,0,4,2,GK,30-34,Goalkeeper,France,Europe
765,Domingos Duarte,POR,Granada,La Liga,2020,25.0,1995.0,26.3,32,20,18,12,2,14,21,66.7,7,29,20,9,29,61,86,0,DF,25-29,Defender,Portugal,Europe
767,Óscar Duarte,CRC,Levante,La Liga,2020,31.0,1989.0,22.9,22,13,17,5,0,10,18,55.6,8,23,15,8,36,58,97,1,DF,30-34,Defender,Costa Rica,North America
770,Martin Dúbravka,SVK,Newcastle Utd,Premier League,2020,31.0,1989.0,13.0,0,0,0,0,0,0,0,,0,0,0,0,0,0,3,0,GK,30-34,Goalkeeper,Slovakia,Europe
771,Ondrej Duda,SVK,Köln,Bundesliga,2020,25.0,1994.0,28.2,36,14,13,18,5,8,39,20.5,31,28,2,26,19,55,20,0,"FW,MF",25-29,Forward,Slovakia,Europe
774,Paul Dummett,WAL,Newcastle Utd,Premier League,2020,28.0,1991.0,13.9,16,7,11,5,0,13,21,61.9,8,12,7,5,16,32,74,0,DF,25-29,Defender,Wales,Europe
775,Alfred Duncan,GHA,Fiorentina,Serie A,2020,27.0,1993.0,1.8,3,0,1,1,1,0,2,0.0,2,2,0,2,2,5,0,0,MF,25-29,Midfielder,Ghana,Africa
776,Alfred Duncan,GHA,Cagliari,Serie A,2020,27.0,1993.0,11.9,18,10,8,9,1,4,21,19.0,17,8,0,8,16,34,8,1,MF,25-29,Midfielder,Ghana,Africa
777,Lewis Dunk,ENG,Brighton,Premier League,2020,28.0,1991.0,32.6,30,15,20,8,2,16,23,69.6,7,29,20,9,32,62,106,0,DF,25-29,Defender,England,Europe
778,Jimmy Dunne,IRL,Burnley,Premier League,2020,22.0,1997.0,3.0,3,3,2,1,0,1,2,50.0,1,3,2,1,6,9,16,1,DF,20-24,Defender,Republic of Ireland,Europe
779,Erik Durm,GER,Eint Frankfurt,Bundesliga,2020,28.0,1992.0,16.4,17,13,7,9,1,8,21,38.1,13,19,5,14,29,46,26,0,DF,25-29,Defender,Germany,Europe
782,Paulo Dybala,ARG,Juventus,Serie A,2020,26.0,1993.0,12.6,14,8,3,4,7,2,14,14.3,12,15,0,15,1,15,1,0,FW,25-29,Forward,Argentina,South America
785,Enzo Ebosse,CMR,Angers,Ligue 1,2020,21.0,1999.0,2.9,5,3,5,0,0,3,4,75.0,1,1,1,0,2,7,13,0,DF,20-24,Defender,Cameroon,Africa
786,Bruno Ecuele Manga,GAB,Dijon,Ligue 1,2020,32.0,1988.0,38.0,52,38,46,6,0,29,40,72.5,11,50,33,17,57,109,165,3,DF,30-34,Defender,Gabon,Africa
787,Simone Edera,ITA,Torino,Serie A,2020,23.0,1997.0,0.6,3,1,2,1,0,3,4,75.0,1,0,0,0,1,4,1,0,"DF,MF",20-24,Defender,Italy,Europe
788,Ederson,BRA,Manchester City,Premier League,2020,26.0,1993.0,36.0,3,1,3,0,0,3,4,75.0,1,0,0,0,0,3,11,4,GK,25-29,Goalkeeper,Brazil,South America
788,Ederson,BRA,Manchester City,Premier League,2020,26.0,1993.0,36.0,3,1,3,0,0,3,4,75.0,1,0,0,0,0,3,11,4,GK,25-29,Goalkeeper,Brazil,South America
788,Ederson,BRA,Manchester City,Premier League,2020,26.0,1993.0,36.0,3,1,3,0,0,3,4,75.0,1,0,0,0,0,3,11,4,GK,25-29,Goalkeeper,Brazil,South America
788,Ederson,BRA,Manchester City,Premier League,2020,26.0,1993.0,36.0,3,1,3,0,0,3,4,75.0,1,0,0,0,0,3,11,4,GK,25-29,Goalkeeper,Brazil,South America
789,Kyle Edwards,ENG,West Brom,Premier League,2020,22.0,1998.0,1.3,3,2,1,1,1,0,0,,0,2,0,2,1,4,0,0,"MF,FW",20-24,Midfielder,England,Europe
790,John Egan,IRL,Sheffield Utd,Premier League,2020,27.0,1992.0,29.2,41,21,29,12,0,22,39,56.4,17,43,31,12,41,82,131,0,DF,25-29,Defender,Republic of Ireland,Europe
791,Johannes Eggestein,GER,Werder Bremen,Bundesliga,2020,22.0,1998.0,0.4,0,0,0,0,0,0,1,0.0,1,0,0,0,1,1,2,0,"FW,MF",20-24,Forward,Germany,Europe
792,Maximilian Eggestein,GER,Werder Bremen,Bundesliga,2020,23.0,1996.0,32.7,57,42,22,29,6,21,46,45.7,25,30,5,25,43,100,36,0,MF,20-24,Midfielder,Germany,Europe
793,Lilian Egloff,GER,Stuttgart,Bundesliga,2020,17.0,2002.0,0.2,0,0,0,0,0,0,0,,0,0,0,0,0,0,0,0,MF,Under 20,Midfielder,Germany,Europe
794,Kingsley Ehizibue,NED,Köln,Bundesliga,2020,25.0,1995.0,12.6,32,19,22,9,1,10,17,58.8,7,19,5,14,18,50,42,0,DF,25-29,Defender,Netherlands,Europe
795,Albin Ekdal,SWE,Sampdoria,Serie A,2020,31.0,1989.0,25.5,56,29,21,32,3,23,65,35.4,42,31,12,19,49,105,35,0,MF,30-34,Midfielder,Sweden,Europe
800,Ahmed Elmohamady,EGY,Aston Villa,Premier League,2020,32.0,1987.0,9.3,17,13,12,4,1,9,14,64.3,5,6,3,3,17,34,26,0,DF,30-34,Defender,Egypt,Africa
801,Mohamed Elneny,EGY,Arsenal,Premier League,2020,28.0,1992.0,17.2,14,6,7,7,0,7,28,25.0,21,11,4,7,24,38,20,2,MF,25-29,Midfielder,Egypt,Africa
803,Nico Elvedi,SUI,Gladbach,Bundesliga,2020,23.0,1996.0,28.2,49,35,36,12,1,25,37,67.6,12,38,22,16,65,114,123,0,DF,20-24,Defender,Switzerland,Europe
804,Rodrigo Ely,BRA,Alavés,La Liga,2020,26.0,1993.0,5.2,5,2,3,2,0,3,4,75.0,1,2,1,1,7,12,23,1,DF,25-29,Defender,Brazil,South America
805,Breel Embolo,SUI,Gladbach,Bundesliga,2020,23.0,1997.0,16.0,15,10,1,13,1,0,6,0.0,6,16,1,15,8,23,8,0,"FW,MF",20-24,Forward,Switzerland,Europe
806,Emerson,BRA,Betis,La Liga,2020,21.0,1999.0,33.2,91,52,62,25,4,43,78,55.1,35,33,6,27,61,152,102,2,DF,20-24,Defender,Brazil,South America
808,Alan Empereur,BRA,Hellas Verona,Serie A,2020,26.0,1994.0,2.4,0,0,0,0,0,0,0,,0,1,1,0,6,6,7,1,DF,25-29,Defender,Brazil,South America
810,Keita Endo,JPN,Union Berlin,Bundesliga,2020,22.0,1997.0,5.1,8,3,1,5,2,3,9,33.3,6,5,2,3,6,14,4,0,"MF,FW",20-24,Midfielder,Japan,Asia
811,Wataru Endo,JPN,Stuttgart,Bundesliga,2020,27.0,1993.0,32.8,65,44,25,34,6,29,71,40.8,42,53,14,39,51,116,59,0,MF,25-29,Midfielder,Japan,Asia
813,Christian Eriksen,DEN,Inter,Serie A,2020,28.0,1992.0,15.4,12,6,6,4,2,7,20,35.0,13,16,1,15,9,21,13,1,MF,25-29,Midfielder,Denmark,Europe
815,Patrick Erras,GER,Werder Bremen,Bundesliga,2020,25.0,1995.0,0.3,0,0,0,0,0,0,1,0.0,1,0,0,0,0,0,0,0,"FW,MF",25-29,Forward,Germany,Europe
816,Gonzalo Escalante,ARG,Lazio,Serie A,2020,27.0,1993.0,8.1,26,13,11,14,1,8,28,28.6,20,10,3,7,19,45,13,0,MF,25-29,Midfielder,Argentina,South America
820,Alfonso Espino,URU,Cádiz,La Liga,2020,28.0,1992.0,28.9,92,48,63,28,1,43,85,50.6,42,30,5,25,41,133,74,0,DF,25-29,Defender,Uruguay,South America
822,Nahuel Estévez,ARG,Spezia,Serie A,2020,24.0,1995.0,19.6,13,5,4,6,3,5,32,15.6,27,23,5,18,20,33,22,1,MF,20-24,Midfielder,Argentina,South America
823,Pervis Estupiñán,ECU,Villarreal,La Liga,2020,22.0,1998.0,13.0,37,17,23,12,2,14,23,60.9,9,10,2,8,35,72,14,2,DF,20-24,Defender,Ecuador,South America
824,Yoann Etienne,FRA,Lorient,Ligue 1,2020,23.0,1997.0,1.0,2,0,1,1,0,1,1,100.0,0,1,0,1,1,3,2,0,DF,20-24,Defender,France,Europe
829,Eberechi Eze,ENG,Crystal Palace,Premier League,2020,22.0,1998.0,28.4,27,14,11,13,3,16,35,45.7,19,19,3,16,24,51,9,1,MF,20-24,Midfielder,England,Europe
832,Fabinho,BRA,Liverpool,Premier League,2020,26.0,1993.0,28.5,58,31,21,29,8,27,54,50.0,27,28,10,18,44,102,66,1,"DF,MF",25-29,Defender,Brazil,South America
832,Fabinho,BRA,Liverpool,Premier League,2020,26.0,1993.0,28.5,58,31,21,29,8,27,54,50.0,27,28,10,18,44,102,66,1,"DF,MF",25-29,Defender,Brazil,South America
832,Fabinho,BRA,Liverpool,Premier League,2020,26.0,1993.0,28.5,58,31,21,29,8,27,54,50.0,27,28,10,18,44,102,66,1,"DF,MF",25-29,Defender,Brazil,South America
832,Fabinho,BRA,Liverpool,Premier League,2020,26.0,1993.0,28.5,58,31,21,29,8,27,54,50.0,27,28,10,18,44,102,66,1,"DF,MF",25-29,Defender,Brazil,South America
832,Fabinho,BRA,Liverpool,Premier League,2020,26.0,1993.0,28.5,58,31,21,29,8,27,54,50.0,27,28,10,18,44,102,66,1,"DF,MF",25-29,Defender,Brazil,South America
832,Fabinho,BRA,Liverpool,Premier League,2020,26.0,1993.0,28.5,58,31,21,29,8,27,54,50.0,27,28,10,18,44,102,66,1,"DF,MF",25-29,Defender,Brazil,South America
832,Fabinho,BRA,Liverpool,Premier League,2020,26.0,1993.0,28.5,58,31,21,29,8,27,54,50.0,27,28,10,18,44,102,66,1,"DF,MF",25-29,Defender,Brazil,South America
832,Fabinho,BRA,Liverpool,Premier League,2020,26.0,1993.0,28.5,58,31,21,29,8,27,54,50.0,27,28,10,18,44,102,66,1,"DF,MF",25-29,Defender,Brazil,South America
832,Fabinho,BRA,Liverpool,Premier League,2020,26.0,1993.0,28.5,58,31,21,29,8,27,54,50.0,27,28,10,18,44,102,66,1,"DF,MF",25-29,Defender,Brazil,South America
832,Fabinho,BRA,Liverpool,Premier League,2020,26.0,1993.0,28.5,58,31,21,29,8,27,54,50.0,27,28,10,18,44,102,66,1,"DF,MF",25-29,Defender,Brazil,South America
832,Fabinho,BRA,Liverpool,Premier League,2020,26.0,1993.0,28.5,58,31,21,29,8,27,54,50.0,27,28,10,18,44,102,66,1,"DF,MF",25-29,Defender,Brazil,South America
832,Fabinho,BRA,Liverpool,Premier League,2020,26.0,1993.0,28.5,58,31,21,29,8,27,54,50.0,27,28,10,18,44,102,66,1,"DF,MF",25-29,Defender,Brazil,South America
832,Fabinho,BRA,Liverpool,Premier League,2020,26.0,1993.0,28.5,58,31,21,29,8,27,54,50.0,27,28,10,18,44,102,66,1,"DF,MF",25-29,Defender,Brazil,South America
832,Fabinho,BRA,Liverpool,Premier League,2020,26.0,1993.0,28.5,58,31,21,29,8,27,54,50.0,27,28,10,18,44,102,66,1,"DF,MF",25-29,Defender,Brazil,South America
832,Fabinho,BRA,Liverpool,Premier League,2020,26.0,1993.0,28.5,58,31,21,29,8,27,54,50.0,27,28,10,18,44,102,66,1,"DF,MF",25-29,Defender,Brazil,South America
832,Fabinho,BRA,Liverpool,Premier League,2020,26.0,1993.0,28.5,58,31,21,29,8,27,54,50.0,27,28,10,18,44,102,66,1,"DF,MF",25-29,Defender,Brazil,South America
832,Fabinho,BRA,Liverpool,Premier League,2020,26.0,1993.0,28.5,58,31,21,29,8,27,54,50.0,27,28,10,18,44,102,66,1,"DF,MF",25-29,Defender,Brazil,South America
832,Fabinho,BRA,Liverpool,Premier League,2020,26.0,1993.0,28.5,58,31,21,29,8,27,54,50.0,27,28,10,18,44,102,66,1,"DF,MF",25-29,Defender,Brazil,South America
832,Fabinho,BRA,Liverpool,Premier League,2020,26.0,1993.0,28.5,58,31,21,29,8,27,54,50.0,27,28,10,18,44,102,66,1,"DF,MF",25-29,Defender,Brazil,South America
832,Fabinho,BRA,Liverpool,Premier League,2020,26.0,1993.0,28.5,58,31,21,29,8,27,54,50.0,27,28,10,18,44,102,66,1,"DF,MF",25-29,Defender,Brazil,South America
832,Fabinho,BRA,Liverpool,Premier League,2020,26.0,1993.0,28.5,58,31,21,29,8,27,54,50.0,27,28,10,18,44,102,66,1,"DF,MF",25-29,Defender,Brazil,South America
832,Fabinho,BRA,Liverpool,Premier League,2020,26.0,1993.0,28.5,58,31,21,29,8,27,54,50.0,27,28,10,18,44,102,66,1,"DF,MF",25-29,Defender,Brazil,South America
832,Fabinho,BRA,Liverpool,Premier League,2020,26.0,1993.0,28.5,58,31,21,29,8,27,54,50.0,27,28,10,18,44,102,66,1,"DF,MF",25-29,Defender,Brazil,South America
832,Fabinho,BRA,Liverpool,Premier League,2020,26.0,1993.0,28.5,58,31,21,29,8,27,54,50.0,27,28,10,18,44,102,66,1,"DF,MF",25-29,Defender,Brazil,South America
832,Fabinho,BRA,Liverpool,Premier League,2020,26.0,1993.0,28.5,58,31,21,29,8,27,54,50.0,27,28,10,18,44,102,66,1,"DF,MF",25-29,Defender,Brazil,South America
833,Fábio,BRA,Nantes,Ligue 1,2020,30.0,1990.0,16.7,62,37,37,23,2,35,61,57.4,26,29,8,21,37,99,49,0,DF,30-34,Defender,Brazil,South America
837,Wout Faes,BEL,Reims,Ligue 1,2020,22.0,1998.0,32.2,35,22,26,9,0,20,39,51.3,19,40,31,9,68,103,144,1,DF,20-24,Defender,Belgium,Europe
838,Nicolò Fagioli,ITA,Juventus,Serie A,2020,19.0,2001.0,0.2,0,0,0,0,0,0,0,,0,0,0,0,0,0,1,0,MF,Under 20,Midfielder,Italy,Europe
839,Ralf Fährmann,GER,Schalke 04,Bundesliga,2020,31.0,1988.0,20.8,2,1,2,0,0,1,2,50.0,1,0,0,0,1,3,9,3,GK,30-34,Goalkeeper,Germany,Europe
840,Romain Faivre,FRA,Brest,Ligue 1,2020,22.0,1998.0,32.1,54,27,26,23,5,21,54,38.9,33,30,0,30,30,84,18,0,"MF,FW",20-24,Midfielder,France,Europe
843,Andri Fannar Baldursson,ISL,Bologna,Serie A,2020,18.0,2002.0,2.4,6,6,1,2,3,1,3,33.3,2,3,1,2,3,9,7,0,MF,Under 20,Midfielder,Iceland,Europe
844,Paolo Faragò,ITA,Bologna,Serie A,2020,27.0,1993.0,0.3,1,1,1,0,0,1,2,50.0,1,1,0,1,0,1,0,0,DF,25-29,Defender,Italy,Europe
845,Paolo Faragò,ITA,Cagliari,Serie A,2020,27.0,1993.0,4.1,13,9,10,3,0,9,20,45.0,11,3,2,1,6,19,15,0,DF,25-29,Defender,Italy,Europe
846,Davide Faraoni,ITA,Hellas Verona,Serie A,2020,28.0,1991.0,32.1,62,33,36,19,7,28,51,54.9,23,48,17,31,49,111,83,1,DF,25-29,Defender,Italy,Europe
848,Diego Farias,BRA,Spezia,Serie A,2020,30.0,1990.0,16.8,9,5,4,1,4,4,21,19.0,17,12,0,12,13,22,3,0,FW,30-34,Forward,Brazil,South America
850,Noah Fatar,FRA,Angers,Ligue 1,2020,18.0,2002.0,0.2,1,0,0,0,1,0,0,,0,0,0,0,0,1,0,0,"FW,MF",Under 20,Forward,France,Europe
852,Julien Faussurier,FRA,Brest,Ligue 1,2020,33.0,1987.0,10.6,16,11,6,8,2,11,25,44.0,14,12,4,8,9,25,10,0,DF,30-34,Defender,France,Europe
853,Andrea Favilli,ITA,Hellas Verona,Serie A,2020,23.0,1997.0,3.8,3,1,0,1,2,2,3,66.7,1,2,0,2,0,3,2,0,FW,20-24,Forward,Italy,Europe
854,Federico Fazio,ARG,Roma,Serie A,2020,33.0,1987.0,4.5,3,2,3,0,0,3,4,75.0,1,3,3,0,7,10,18,1,DF,30-34,Defender,Argentina,South America
855,Nabil Fekir,FRA,Betis,La Liga,2020,27.0,1993.0,29.1,45,23,9,22,14,7,43,16.3,36,31,2,29,8,53,2,0,"MF,FW",25-29,Midfielder,France,Europe
856,Felipe,BRA,Atlético Madrid,La Liga,2020,31.0,1989.0,22.9,29,17,19,10,0,18,23,78.3,5,30,15,15,36,65,128,2,DF,30-34,Defender,Brazil,South America
856,Felipe,BRA,Atlético Madrid,La Liga,2020,31.0,1989.0,22.9,29,17,19,10,0,18,23,78.3,5,30,15,15,36,65,128,2,DF,30-34,Defender,Brazil,South America
856,Felipe,BRA,Atlético Madrid,La Liga,2020,31.0,1989.0,22.9,29,17,19,10,0,18,23,78.3,5,30,15,15,36,65,128,2,DF,30-34,Defender,Brazil,South America
856,Felipe,BRA,Atlético Madrid,La Liga,2020,31.0,1989.0,22.9,29,17,19,10,0,18,23,78.3,5,30,15,15,36,65,128,2,DF,30-34,Defender,Brazil,South America
857,Luiz Felipe,ITA,Lazio,Serie A,2020,23.0,1997.0,10.1,32,20,19,11,2,16,24,66.7,8,20,9,11,21,53,29,1,DF,20-24,Defender,Italy,Europe
857,Luiz Felipe,ITA,Lazio,Serie A,2020,23.0,1997.0,10.1,32,20,19,11,2,16,24,66.7,8,20,9,11,21,53,29,1,DF,20-24,Defender,Italy,Europe
857,Luiz Felipe,ITA,Lazio,Serie A,2020,23.0,1997.0,10.1,32,20,19,11,2,16,24,66.7,8,20,9,11,21,53,29,1,DF,20-24,Defender,Italy,Europe
857,Luiz Felipe,ITA,Lazio,Serie A,2020,23.0,1997.0,10.1,32,20,19,11,2,16,24,66.7,8,20,9,11,21,53,29,1,DF,20-24,Defender,Italy,Europe
858,João Félix,POR,Atlético Madrid,La Liga,2020,20.0,1999.0,17.5,8,4,1,6,1,4,17,23.5,13,3,0,3,5,13,2,0,"FW,MF",20-24,Forward,Portugal,Europe
860,Zinedine Ferhat,ALG,Nîmes,Ligue 1,2020,27.0,1993.0,32.9,36,21,18,9,9,18,39,46.2,21,22,0,22,32,68,38,0,"FW,MF",25-29,Forward,Algeria,Africa
861,Bruno Fernandes,POR,Manchester Utd,Premier League,2020,25.0,1994.0,34.4,57,30,16,29,12,26,100,26.0,74,38,0,38,26,83,29,0,MF,25-29,Midfielder,Portugal,Europe
862,Edimilson Fernandes,SUI,Mainz 05,Bundesliga,2020,24.0,1996.0,9.3,8,4,4,4,0,4,7,57.1,3,12,4,8,29,37,25,0,"MF,FW",20-24,Midfielder,Switzerland,Europe
867,Augusto Fernández,ARG,Cádiz,La Liga,2020,34.0,1986.0,4.1,11,3,5,6,0,2,13,15.4,11,5,1,4,9,20,5,0,MF,30-34,Midfielder,Argentina,South America
870,Federico Fernández,ARG,Newcastle Utd,Premier League,2020,31.0,1989.0,23.1,29,22,23,5,1,17,21,81.0,4,41,31,10,17,46,147,0,DF,30-34,Defender,Argentina,South America
872,Fernandinho,BRA,Manchester City,Premier League,2020,35.0,1985.0,13.2,31,17,8,14,9,20,43,46.5,23,11,2,9,23,54,17,0,MF,35-39,Midfielder,Brazil,South America
872,Fernandinho,BRA,Manchester City,Premier League,2020,35.0,1985.0,13.2,31,17,8,14,9,20,43,46.5,23,11,2,9,23,54,17,0,MF,35-39,Midfielder,Brazil,South America
872,Fernandinho,BRA,Manchester City,Premier League,2020,35.0,1985.0,13.2,31,17,8,14,9,20,43,46.5,23,11,2,9,23,54,17,0,MF,35-39,Midfielder,Brazil,South America
872,Fernandinho,BRA,Manchester City,Premier League,2020,35.0,1985.0,13.2,31,17,8,14,9,20,43,46.5,23,11,2,9,23,54,17,0,MF,35-39,Midfielder,Brazil,South America
872,Fernandinho,BRA,Manchester City,Premier League,2020,35.0,1985.0,13.2,31,17,8,14,9,20,43,46.5,23,11,2,9,23,54,17,0,MF,35-39,Midfielder,Brazil,South America
872,Fernandinho,BRA,Manchester City,Premier League,2020,35.0,1985.0,13.2,31,17,8,14,9,20,43,46.5,23,11,2,9,23,54,17,0,MF,35-39,Midfielder,Brazil,South America
872,Fernandinho,BRA,Manchester City,Premier League,2020,35.0,1985.0,13.2,31,17,8,14,9,20,43,46.5,23,11,2,9,23,54,17,0,MF,35-39,Midfielder,Brazil,South America
872,Fernandinho,BRA,Manchester City,Premier League,2020,35.0,1985.0,13.2,31,17,8,14,9,20,43,46.5,23,11,2,9,23,54,17,0,MF,35-39,Midfielder,Brazil,South America
872,Fernandinho,BRA,Manchester City,Premier League,2020,35.0,1985.0,13.2,31,17,8,14,9,20,43,46.5,23,11,2,9,23,54,17,0,MF,35-39,Midfielder,Brazil,South America
872,Fernandinho,BRA,Manchester City,Premier League,2020,35.0,1985.0,13.2,31,17,8,14,9,20,43,46.5,23,11,2,9,23,54,17,0,MF,35-39,Midfielder,Brazil,South America
872,Fernandinho,BRA,Manchester City,Premier League,2020,35.0,1985.0,13.2,31,17,8,14,9,20,43,46.5,23,11,2,9,23,54,17,0,MF,35-39,Midfielder,Brazil,South America
872,Fernandinho,BRA,Manchester City,Premier League,2020,35.0,1985.0,13.2,31,17,8,14,9,20,43,46.5,23,11,2,9,23,54,17,0,MF,35-39,Midfielder,Brazil,South America
872,Fernandinho,BRA,Manchester City,Premier League,2020,35.0,1985.0,13.2,31,17,8,14,9,20,43,46.5,23,11,2,9,23,54,17,0,MF,35-39,Midfielder,Brazil,South America
872,Fernandinho,BRA,Manchester City,Premier League,2020,35.0,1985.0,13.2,31,17,8,14,9,20,43,46.5,23,11,2,9,23,54,17,0,MF,35-39,Midfielder,Brazil,South America
872,Fernandinho,BRA,Manchester City,Premier League,2020,35.0,1985.0,13.2,31,17,8,14,9,20,43,46.5,23,11,2,9,23,54,17,0,MF,35-39,Midfielder,Brazil,South America
872,Fernandinho,BRA,Manchester City,Premier League,2020,35.0,1985.0,13.2,31,17,8,14,9,20,43,46.5,23,11,2,9,23,54,17,0,MF,35-39,Midfielder,Brazil,South America
873,Fernando,BRA,Sevilla,La Liga,2020,33.0,1987.0,28.3,54,28,24,25,5,23,43,53.5,20,25,11,14,41,95,70,0,MF,30-34,Midfielder,Brazil,South America
873,Fernando,BRA,Sevilla,La Liga,2020,33.0,1987.0,28.3,54,28,24,25,5,23,43,53.5,20,25,11,14,41,95,70,0,MF,30-34,Midfielder,Brazil,South America
873,Fernando,BRA,Sevilla,La Liga,2020,33.0,1987.0,28.3,54,28,24,25,5,23,43,53.5,20,25,11,14,41,95,70,0,MF,30-34,Midfielder,Brazil,South America
873,Fernando,BRA,Sevilla,La Liga,2020,33.0,1987.0,28.3,54,28,24,25,5,23,43,53.5,20,25,11,14,41,95,70,0,MF,30-34,Midfielder,Brazil,South America
873,Fernando,BRA,Sevilla,La Liga,2020,33.0,1987.0,28.3,54,28,24,25,5,23,43,53.5,20,25,11,14,41,95,70,0,MF,30-34,Midfielder,Brazil,South America
873,Fernando,BRA,Sevilla,La Liga,2020,33.0,1987.0,28.3,54,28,24,25,5,23,43,53.5,20,25,11,14,41,95,70,0,MF,30-34,Midfielder,Brazil,South America
873,Fernando,BRA,Sevilla,La Liga,2020,33.0,1987.0,28.3,54,28,24,25,5,23,43,53.5,20,25,11,14,41,95,70,0,MF,30-34,Midfielder,Brazil,South America
873,Fernando,BRA,Sevilla,La Liga,2020,33.0,1987.0,28.3,54,28,24,25,5,23,43,53.5,20,25,11,14,41,95,70,0,MF,30-34,Midfielder,Brazil,South America
873,Fernando,BRA,Sevilla,La Liga,2020,33.0,1987.0,28.3,54,28,24,25,5,23,43,53.5,20,25,11,14,41,95,70,0,MF,30-34,Midfielder,Brazil,South America
873,Fernando,BRA,Sevilla,La Liga,2020,33.0,1987.0,28.3,54,28,24,25,5,23,43,53.5,20,25,11,14,41,95,70,0,MF,30-34,Midfielder,Brazil,South America
873,Fernando,BRA,Sevilla,La Liga,2020,33.0,1987.0,28.3,54,28,24,25,5,23,43,53.5,20,25,11,14,41,95,70,0,MF,30-34,Midfielder,Brazil,South America
873,Fernando,BRA,Sevilla,La Liga,2020,33.0,1987.0,28.3,54,28,24,25,5,23,43,53.5,20,25,11,14,41,95,70,0,MF,30-34,Midfielder,Brazil,South America
873,Fernando,BRA,Sevilla,La Liga,2020,33.0,1987.0,28.3,54,28,24,25,5,23,43,53.5,20,25,11,14,41,95,70,0,MF,30-34,Midfielder,Brazil,South America
873,Fernando,BRA,Sevilla,La Liga,2020,33.0,1987.0,28.3,54,28,24,25,5,23,43,53.5,20,25,11,14,41,95,70,0,MF,30-34,Midfielder,Brazil,South America
873,Fernando,BRA,Sevilla,La Liga,2020,33.0,1987.0,28.3,54,28,24,25,5,23,43,53.5,20,25,11,14,41,95,70,0,MF,30-34,Midfielder,Brazil,South America
873,Fernando,BRA,Sevilla,La Liga,2020,33.0,1987.0,28.3,54,28,24,25,5,23,43,53.5,20,25,11,14,41,95,70,0,MF,30-34,Midfielder,Brazil,South America
874,Alex Ferrari,ITA,Sampdoria,Serie A,2020,26.0,1994.0,9.8,27,15,16,9,2,15,24,62.5,9,18,6,12,23,50,26,0,DF,25-29,Defender,Italy,Europe
877,Facundo Ferreyra,ARG,Celta Vigo,La Liga,2020,29.0,1991.0,3.3,4,3,1,2,1,0,2,0.0,2,5,0,5,2,6,2,0,FW,25-29,Forward,Argentina,South America
878,Jordan Ferri,FRA,Montpellier,Ligue 1,2020,28.0,1992.0,28.6,58,40,34,22,2,31,103,30.1,72,30,5,25,8,66,18,1,MF,25-29,Midfielder,France,Europe
879,Marco Festa,ITA,Crotone,Serie A,2020,28.0,1992.0,1.0,0,0,0,0,0,0,0,,0,0,0,0,0,0,0,0,GK,25-29,Goalkeeper,Italy,Europe
881,Sam Field,ENG,West Brom,Premier League,2020,22.0,1998.0,0.7,5,5,3,2,0,0,0,,0,4,1,3,2,7,4,0,MF,20-24,Midfielder,England,Europe
883,Roberto Firmino,BRA,Liverpool,Premier League,2020,28.0,1991.0,31.5,33,15,3,17,13,6,32,18.8,26,42,5,37,11,44,12,0,FW,25-29,Forward,Brazil,South America
884,Junior Firpo,DOM,Barcelona,La Liga,2020,23.0,1996.0,3.2,1,1,1,0,0,0,1,0.0,1,5,3,2,4,5,7,0,"DF,MF",20-24,Defender,Dominican Republic,North America
886,John Fleck,SCO,Sheffield Utd,Premier League,2020,28.0,1991.0,28.6,51,33,28,18,5,26,83,31.3,57,26,4,22,28,79,12,1,MF,25-29,Midfielder,Scotland,Europe
887,Mark Flekken,NED,Freiburg,Bundesliga,2020,27.0,1993.0,3.0,0,0,0,0,0,0,0,,0,0,0,0,0,0,1,0,GK,25-29,Goalkeeper,Netherlands,Europe
888,Florian Flick,GER,Schalke 04,Bundesliga,2020,20.0,2000.0,4.0,10,7,4,6,0,7,16,43.8,9,4,3,1,7,17,5,1,MF,20-24,Midfielder,Germany,Europe
890,Alessandro Florenzi,ITA,Paris S-G,Ligue 1,2020,29.0,1991.0,17.1,24,16,9,9,6,12,29,41.4,17,7,1,6,17,41,25,0,DF,25-29,Defender,Italy,Europe
891,Kingsley Fobi,GHA,Granada,La Liga,2020,21.0,1998.0,0.5,0,0,0,0,0,0,0,,0,0,0,0,1,1,1,0,DF,20-24,Defender,Ghana,Africa
892,Phil Foden,ENG,Manchester City,Premier League,2020,20.0,2000.0,18.0,22,11,12,8,2,9,23,39.1,14,9,0,9,11,33,11,0,"FW,MF",20-24,Forward,England,Europe
893,Mamadou Fofana,MLI,Metz,Ligue 1,2020,22.0,1998.0,11.9,25,11,17,8,0,7,31,22.6,24,14,2,12,18,43,36,0,"MF,DF",20-24,Midfielder,Mali,Africa
894,Seko Fofana,CIV,Lens,Ligue 1,2020,25.0,1995.0,25.7,16,8,3,10,3,4,26,15.4,22,16,5,11,34,50,23,1,MF,25-29,Midfielder,Ivory Coast,Africa
895,Wesley Fofana,FRA,Leicester City,Premier League,2020,19.0,2000.0,25.1,51,37,27,22,2,31,46,67.4,15,28,16,12,61,112,94,0,DF,Under 20,Defender,France,Europe
896,Wesley Fofana,FRA,Saint-Étienne,Ligue 1,2020,19.0,2000.0,3.5,6,4,6,0,0,3,4,75.0,1,3,3,0,8,14,14,1,DF,Under 20,Defender,France,Europe
897,Youssouf Fofana,FRA,Monaco,Ligue 1,2020,21.0,1999.0,31.9,90,51,31,51,8,42,82,51.2,40,43,7,36,34,124,14,2,MF,20-24,Midfielder,France,Europe
900,Lamine Fomba,FRA,Nîmes,Ligue 1,2020,22.0,1998.0,24.2,66,36,30,25,11,30,65,46.2,35,48,19,29,59,125,39,2,MF,20-24,Midfielder,France,Europe
901,Thomas Fontaine,MAD,Lorient,Ligue 1,2020,29.0,1991.0,3.6,5,2,5,0,0,2,2,100.0,0,3,2,1,5,10,14,0,DF,25-29,Defender,Madagascar,Africa
904,Fernando Forestieri,ITA,Udinese,Serie A,2020,30.0,1990.0,6.1,9,7,4,4,1,3,7,42.9,4,7,0,7,2,11,0,0,"FW,MF",30-34,Forward,Italy,Europe
906,Emil Forsberg,SWE,RB Leipzig,Bundesliga,2020,28.0,1991.0,17.1,11,6,1,6,4,5,27,18.5,22,10,1,9,11,22,4,0,"FW,MF",25-29,Forward,Sweden,Europe
907,Fraser Forster,ENG,Southampton,Premier League,2020,32.0,1988.0,8.0,1,0,1,0,0,1,2,50.0,1,0,0,0,0,1,9,0,GK,30-34,Goalkeeper,England,Europe
908,Philipp Förster,GER,Stuttgart,Bundesliga,2020,25.0,1995.0,16.8,22,13,7,12,3,6,25,24.0,19,18,1,17,15,37,2,0,MF,25-29,Midfielder,Germany,Europe
909,Steven Fortes,CPV,Lens,Ligue 1,2020,28.0,1992.0,15.9,33,20,20,10,3,16,22,72.7,6,25,10,15,27,60,52,0,DF,25-29,Defender,Cape Verde,Africa
911,Timothy Fosu-Mensah,NED,Manchester Utd,Premier League,2020,22.0,1998.0,0.9,2,0,1,1,0,1,1,100.0,0,0,0,0,3,5,1,0,DF,20-24,Defender,Netherlands,Europe
912,Timothy Fosu-Mensah,NED,Leverkusen,Bundesliga,2020,22.0,1998.0,4.5,4,2,1,2,1,2,4,50.0,2,7,3,4,7,11,4,0,DF,20-24,Defender,Netherlands,Europe
914,Dimitri Foulquier,FRA,Granada,La Liga,2020,27.0,1993.0,29.6,35,21,20,12,3,15,26,57.7,11,24,7,17,26,61,60,0,DF,25-29,Defender,France,Europe
915,Juan Foyth,ARG,Villarreal,La Liga,2020,22.0,1998.0,13.0,40,22,22,14,4,12,29,41.4,17,21,6,15,19,59,24,1,"DF,MF",20-24,Defender,Argentina,South America
916,Gianluca Frabotta,ITA,Juventus,Serie A,2020,21.0,1999.0,7.7,7,4,5,0,2,5,12,41.7,7,9,1,8,14,21,15,0,"DF,MF",20-24,Defender,Italy,Europe
917,Raphael Framberger,GER,Augsburg,Bundesliga,2020,24.0,1995.0,17.1,42,23,26,11,5,19,25,76.0,6,24,2,22,36,78,62,1,DF,20-24,Defender,Germany,Europe
919,Ryan Fraser,SCO,Newcastle Utd,Premier League,2020,26.0,1994.0,10.3,4,1,3,1,0,2,5,40.0,3,1,0,1,6,10,7,0,"FW,MF",25-29,Forward,Scotland,Europe
921,Ryan Fredericks,ENG,West Ham,Premier League,2020,27.0,1992.0,6.3,9,5,5,4,0,3,7,42.9,4,6,2,4,11,20,20,0,"DF,FW",25-29,Defender,England,Europe
922,Remo Freuler,SUI,Atalanta,Serie A,2020,28.0,1992.0,30.1,63,39,17,38,8,32,76,42.1,44,52,4,48,39,102,27,2,MF,25-29,Midfielder,Switzerland,Europe
923,Marco Friedl,AUT,Werder Bremen,Bundesliga,2020,22.0,1998.0,30.9,50,34,31,17,2,30,62,48.4,32,38,17,21,55,105,118,1,DF,20-24,Defender,Austria,Europe
924,Marvin Friedrich,GER,Union Berlin,Bundesliga,2020,24.0,1995.0,34.0,47,29,35,11,1,18,32,56.3,14,38,18,20,52,99,109,0,DF,20-24,Defender,Germany,Europe
925,Jeremie Frimpong,NED,Leverkusen,Bundesliga,2020,19.0,2000.0,4.8,7,4,4,3,0,4,8,50.0,4,4,0,4,1,8,7,0,"DF,FW",Under 20,Defender,Netherlands,Europe
927,Christian Fuchs,AUT,Leicester City,Premier League,2020,34.0,1986.0,7.8,18,7,15,2,1,8,15,53.3,7,6,4,2,16,34,34,1,DF,30-34,Defender,Austria,Europe
928,Angelo Fulgini,FRA,Angers,Ligue 1,2020,23.0,1996.0,30.3,22,13,4,12,6,12,34,35.3,22,17,0,17,15,37,9,0,MF,20-24,Midfielder,France,Europe
929,Niclas Füllkrug,GER,Werder Bremen,Bundesliga,2020,27.0,1993.0,9.7,7,3,2,4,1,1,13,7.7,12,10,4,6,3,10,13,0,FW,25-29,Forward,Germany,Europe
930,Ramiro Funes Mori,ARG,Villarreal,La Liga,2020,29.0,1991.0,8.1,12,8,7,5,0,7,11,63.6,4,7,5,2,8,20,42,1,DF,25-29,Defender,Argentina,South America
931,Darnell Furlong,ENG,West Brom,Premier League,2020,24.0,1995.0,32.6,45,27,27,12,6,21,44,47.7,23,39,16,23,49,94,90,0,DF,20-24,Defender,England,Europe
932,Daniel Fuzato,BRA,Roma,Serie A,2020,23.0,1997.0,5.0,0,0,0,0,0,0,0,,0,1,0,1,0,0,1,1,GK,20-24,Goalkeeper,Brazil,South America
934,Matteo Gabbia,ITA,Milan,Serie A,2020,20.0,1999.0,6.2,9,5,3,6,0,2,2,100.0,0,8,6,2,3,12,21,0,DF,20-24,Defender,Italy,Europe
935,Manolo Gabbiadini,ITA,Sampdoria,Serie A,2020,28.0,1991.0,9.7,2,2,0,2,0,0,1,0.0,1,3,1,2,3,5,5,0,FW,25-29,Forward,Italy,Europe
937,Roberto Gagliardini,ITA,Inter,Serie A,2020,26.0,1994.0,13.7,30,17,17,8,5,5,28,17.9,23,15,3,12,19,49,16,0,MF,25-29,Midfielder,Italy,Europe
938,Riccardo Gagliolo,SWE,Parma,Serie A,2020,30.0,1990.0,21.7,45,18,35,8,2,28,45,62.2,17,34,7,27,36,81,64,1,DF,30-34,Defender,Sweden,Europe
940,Andrey Galabinov,BUL,Spezia,Serie A,2020,31.0,1988.0,4.8,2,1,1,1,0,1,3,33.3,2,2,0,2,0,2,5,0,FW,30-34,Forward,Bulgaria,Europe
942,Conor Gallagher,ENG,West Brom,Premier League,2020,20.0,2000.0,28.1,81,41,30,39,12,29,97,29.9,68,47,8,39,27,108,31,0,MF,20-24,Midfielder,England,Europe
944,Kévin Gameiro,FRA,Valencia,La Liga,2020,33.0,1987.0,12.0,7,4,3,2,2,3,11,27.3,8,10,0,10,0,7,3,0,FW,30-34,Forward,France,Europe
946,Ignatius Ganago,CMR,Lens,Ligue 1,2020,21.0,1999.0,14.5,4,3,0,2,2,3,12,25.0,9,7,1,6,6,10,3,0,FW,20-24,Forward,Cameroon,Africa
959,Manuel Gasparini,ITA,Udinese,Serie A,2020,18.0,2002.0,0.0,0,0,0,0,0,0,0,,0,0,0,0,0,0,0,0,GK,Under 20,Goalkeeper,Italy,Europe
961,Paulo Gazzaniga,ARG,Elche,La Liga,2020,28.0,1992.0,8.0,1,1,1,0,0,0,0,,0,0,0,0,1,2,4,0,GK,25-29,Goalkeeper,Argentina,South America
963,Yann Gboho,FRA,Rennes,Ligue 1,2020,19.0,2001.0,3.4,6,3,3,1,2,3,8,37.5,5,1,0,1,1,7,3,1,"MF,FW",Under 20,Midfielder,France,Europe
965,Christian Gebauer,AUT,Arminia,Bundesliga,2020,26.0,1993.0,7.6,9,4,2,5,2,4,11,36.4,7,4,1,3,6,15,14,0,"MF,FW",25-29,Midfielder,Austria,Europe
968,Dennis Geiger,GER,Hoffenheim,Bundesliga,2020,22.0,1998.0,7.3,13,10,3,8,2,5,8,62.5,3,10,0,10,3,16,0,0,MF,20-24,Midfielder,Germany,Europe
969,Christian Gentner,GER,Union Berlin,Bundesliga,2020,34.0,1985.0,11.5,17,8,9,5,3,5,18,27.8,13,13,1,12,17,34,16,0,MF,30-34,Midfielder,Germany,Europe
970,Yannick Gerhardt,GER,Wolfsburg,Bundesliga,2020,26.0,1994.0,21.5,52,32,14,32,6,21,52,40.4,31,34,4,30,21,73,30,0,"MF,FW",25-29,Midfielder,Germany,Europe
971,Valère Germain,FRA,Marseille,Ligue 1,2020,30.0,1990.0,9.5,8,6,2,4,2,3,11,27.3,8,7,2,5,11,19,22,0,"FW,MF",30-34,Forward,France,Europe
973,Willem Geubbels,FRA,Monaco,Ligue 1,2020,18.0,2001.0,3.3,12,8,5,7,0,5,13,38.5,8,9,0,9,3,15,5,0,"MF,FW",Under 20,Midfielder,France,Europe
974,Hamadi Al Ghaddioui,MAR,Stuttgart,Bundesliga,2020,29.0,1990.0,0.5,0,0,0,0,0,0,1,0.0,1,0,0,0,0,0,0,0,FW,25-29,Forward,Morocco,Africa
975,Anwar El Ghazi,NED,Aston Villa,Premier League,2020,25.0,1995.0,17.9,16,13,6,7,3,7,23,30.4,16,11,0,11,6,22,11,0,FW,25-29,Forward,Netherlands,Europe
976,Paolo Ghiglione,ITA,Genoa,Serie A,2020,23.0,1997.0,15.1,27,15,17,8,2,13,28,46.4,15,14,2,12,13,40,25,0,"DF,MF",20-24,Defender,Italy,Europe
978,Kieran Gibbs,ENG,West Brom,Premier League,2020,30.0,1989.0,9.0,15,11,11,3,1,8,10,80.0,2,8,6,2,16,31,30,1,DF,30-34,Defender,England,Europe
979,Morgan Gibbs-White,ENG,Wolves,Premier League,2020,20.0,2000.0,4.6,9,7,3,4,2,5,12,41.7,7,6,0,6,3,12,1,0,"MF,FW",20-24,Midfielder,England,Europe
980,Niko Gießelmann,GER,Union Berlin,Bundesliga,2020,28.0,1991.0,4.8,12,9,7,4,1,5,8,62.5,3,9,3,6,8,20,13,1,DF,25-29,Defender,Germany,Europe
985,Billy Gilmour,SCO,Chelsea,Premier League,2020,19.0,2001.0,2.9,4,2,1,2,1,2,7,28.6,5,3,2,1,3,7,1,0,MF,Under 20,Midfielder,Scotland,Europe
987,Daniel Ginczek,GER,Wolfsburg,Bundesliga,2020,29.0,1991.0,2.4,2,2,1,1,0,2,8,25.0,6,2,0,2,1,3,2,0,"FW,MF",25-29,Forward,Germany,Europe
988,Matthias Ginter,GER,Gladbach,Bundesliga,2020,26.0,1994.0,34.0,26,16,15,10,1,14,24,58.3,10,43,32,11,51,77,121,0,DF,25-29,Defender,Germany,Europe
989,Andrei Girotto,BRA,Nantes,Ligue 1,2020,28.0,1992.0,29.6,65,41,50,15,0,39,70,55.7,31,34,15,19,59,124,103,0,"DF,MF",25-29,Defender,Brazil,South America
990,Olivier Giroud,FRA,Chelsea,Premier League,2020,33.0,1986.0,8.3,4,2,0,1,3,1,7,14.3,6,4,1,3,5,9,10,0,FW,30-34,Forward,France,Europe
991,Robert Glatzel,GER,Mainz 05,Bundesliga,2020,26.0,1994.0,4.0,1,0,1,0,0,0,2,0.0,2,2,0,2,0,1,2,0,FW,25-29,Forward,Germany,Europe
993,Serge Gnabry,GER,Bayern Munich,Bundesliga,2020,25.0,1995.0,18.3,39,19,7,19,13,12,32,37.5,20,17,0,17,26,65,3,0,"FW,MF",25-29,Forward,Germany,Europe
994,Ben Godfrey,ENG,Everton,Premier League,2020,22.0,1998.0,29.8,55,33,37,15,3,27,41,65.9,14,56,37,19,33,88,120,0,DF,20-24,Defender,England,Europe
995,Diego Godín,URU,Cagliari,Serie A,2020,34.0,1986.0,27.9,60,32,51,9,0,24,39,61.5,15,41,24,17,56,116,117,0,DF,30-34,Defender,Uruguay,South America
996,Akaki Gogia,GER,Union Berlin,Bundesliga,2020,28.0,1992.0,1.6,1,0,0,1,0,0,2,0.0,2,0,0,0,1,2,0,0,"FW,MF",25-29,Forward,Germany,Europe
997,Amer Gojak,BIH,Torino,Serie A,2020,23.0,1997.0,5.3,1,0,1,0,0,1,7,14.3,6,5,0,5,3,4,1,0,"MF,FW",20-24,Midfielder,Bosnia and Herzegovina,Europe
998,Edoardo Goldaniga,ITA,Genoa,Serie A,2020,26.0,1993.0,20.6,28,18,21,7,0,14,23,60.9,9,17,7,10,38,66,62,1,DF,25-29,Defender,Italy,Europe
1000,Pierluigi Gollini,ITA,Atalanta,Serie A,2020,25.0,1995.0,24.0,1,0,1,0,0,1,2,50.0,1,1,0,1,1,2,11,0,GK,25-29,Goalkeeper,Italy,Europe
1001,Aleksandr Golovin,RUS,Monaco,Ligue 1,2020,24.0,1996.0,11.9,28,16,6,18,4,8,39,20.5,31,21,0,21,11,39,3,0,"MF,FW",20-24,Midfielder,Russia,Europe
1002,Tomislav Gomelt,CRO,Crotone,Serie A,2020,25.0,1995.0,0.2,1,1,0,1,0,0,0,,0,0,0,0,1,2,0,0,MF,25-29,Midfielder,Croatia,Europe
1003,André Gomes,POR,Everton,Premier League,2020,27.0,1993.0,17.4,35,23,16,16,3,17,58,29.3,41,19,1,18,10,45,12,1,MF,25-29,Midfielder,Portugal,Europe
1003,André Gomes,POR,Everton,Premier League,2020,27.0,1993.0,17.4,35,23,16,16,3,17,58,29.3,41,19,1,18,10,45,12,1,MF,25-29,Midfielder,Portugal,Europe
1003,André Gomes,POR,Everton,Premier League,2020,27.0,1993.0,17.4,35,23,16,16,3,17,58,29.3,41,19,1,18,10,45,12,1,MF,25-29,Midfielder,Portugal,Europe
1003,André Gomes,POR,Everton,Premier League,2020,27.0,1993.0,17.4,35,23,16,16,3,17,58,29.3,41,19,1,18,10,45,12,1,MF,25-29,Midfielder,Portugal,Europe
1006,Joe Gomez,ENG,Liverpool,Premier League,2020,23.0,1997.0,6.6,3,2,1,1,1,0,4,0.0,4,3,2,1,4,7,29,0,DF,20-24,Defender,England,Europe
1007,Maxi Gómez,URU,Valencia,La Liga,2020,23.0,1996.0,29.9,11,9,3,7,1,3,14,21.4,11,13,3,10,2,13,34,0,FW,20-24,Forward,Uruguay,South America
1009,Papu Gómez,ARG,Atalanta,Serie A,2020,32.0,1988.0,7.4,3,2,2,1,0,2,8,25.0,6,8,1,7,1,4,1,0,"MF,FW",30-34,Midfielder,Argentina,South America
1010,Papu Gómez,ARG,Sevilla,La Liga,2020,32.0,1988.0,10.2,9,6,2,4,3,2,12,16.7,10,13,2,11,7,16,6,0,"MF,FW",30-34,Midfielder,Argentina,South America
1013,Alfred Gomis,SEN,Dijon,Ligue 1,2020,26.0,1993.0,5.0,1,0,1,0,0,1,2,50.0,1,0,0,0,1,2,7,0,GK,25-29,Goalkeeper,Senegal,Africa
1014,Alfred Gomis,SEN,Rennes,Ligue 1,2020,26.0,1993.0,22.0,1,1,1,0,0,1,1,100.0,0,0,0,0,3,4,10,1,GK,25-29,Goalkeeper,Senegal,Africa
1015,Maxime Gonalons,FRA,Granada,La Liga,2020,31.0,1989.0,16.4,53,37,18,33,2,15,37,40.5,22,17,0,17,25,78,21,1,MF,30-34,Midfielder,France,Europe
1023,Anthony Gordon,ENG,Everton,Premier League,2020,19.0,2001.0,1.0,3,3,3,0,0,0,2,0.0,2,1,0,1,1,4,3,0,"FW,MF",Under 20,Forward,England,Europe
1024,Leon Goretzka,GER,Bayern Munich,Bundesliga,2020,25.0,1995.0,18.9,37,23,12,21,4,16,39,41.0,23,30,2,28,44,81,11,0,MF,25-29,Midfielder,Germany,Europe
1026,Robin Gosens,GER,Atalanta,Serie A,2020,26.0,1994.0,28.0,46,35,20,15,11,17,41,41.5,24,50,7,43,41,87,34,0,DF,25-29,Defender,Germany,Europe
1027,Amine Gouiri,ALG,Nice,Ligue 1,2020,20.0,2000.0,30.5,31,18,7,16,8,10,41,24.4,31,22,6,16,17,48,23,0,"FW,MF",20-24,Forward,Algeria,Africa
1028,Lucas Gourna-Douath,FRA,Saint-Étienne,Ligue 1,2020,16.0,2003.0,14.7,32,22,18,11,3,15,28,53.6,13,10,0,10,24,56,18,0,MF,Under 20,Midfielder,France,Europe
1029,Jeffrey Gouweleeuw,NED,Augsburg,Bundesliga,2020,29.0,1991.0,31.5,36,20,24,11,1,16,33,48.5,17,37,18,19,69,105,149,2,DF,25-29,Defender,Netherlands,Europe
1030,Jonathan Gradit,FRA,Lens,Ligue 1,2020,27.0,1992.0,31.4,60,39,26,28,6,22,38,57.9,16,37,19,18,56,116,81,1,DF,25-29,Defender,France,Europe
1031,Karlan Grant,ENG,West Brom,Premier League,2020,22.0,1997.0,12.5,5,3,3,2,0,2,4,50.0,2,7,0,7,5,10,17,0,"FW,MF",20-24,Forward,England,Europe
1032,Alberto Grassi,ITA,Parma,Serie A,2020,25.0,1995.0,13.1,30,11,14,13,3,8,29,27.6,21,22,9,13,26,56,32,0,"MF,DF",25-29,Midfielder,Italy,Europe
1034,Demarai Gray,JAM,Leicester City,Premier League,2020,24.0,1996.0,0.2,1,1,1,0,0,0,0,,0,0,0,0,0,1,0,0,FW,20-24,Forward,Jamaica,North America
1035,Demarai Gray,JAM,Leverkusen,Bundesliga,2020,24.0,1996.0,4.9,3,2,1,2,0,1,1,100.0,0,3,0,3,4,7,3,0,FW,20-24,Forward,Jamaica,North America
1037,Jack Grealish,ENG,Aston Villa,Premier League,2020,24.0,1995.0,24.3,31,14,8,16,7,15,24,62.5,9,20,3,17,12,43,5,3,"FW,MF",20-24,Forward,England,Europe
1038,Etienne Green,ENG,Saint-Étienne,Ligue 1,2020,20.0,2000.0,8.0,0,0,0,0,0,0,0,,0,0,0,0,0,0,3,0,GK,20-24,Goalkeeper,England,Europe
1039,Mason Greenwood,ENG,Manchester Utd,Premier League,2020,18.0,2001.0,20.2,13,10,6,4,3,5,22,22.7,17,9,0,9,5,18,1,0,FW,Under 20,Forward,England,Europe
1040,Michael Gregoritsch,AUT,Augsburg,Bundesliga,2020,26.0,1994.0,9.3,13,10,6,7,0,3,10,30.0,7,2,0,2,3,16,17,0,"FW,MF",25-29,Forward,Austria,Europe
1041,Clément Grenier,FRA,Rennes,Ligue 1,2020,29.0,1991.0,12.0,20,8,9,8,3,7,31,22.6,24,7,0,7,5,25,3,0,"MF,FW",25-29,Midfielder,France,Europe
1042,Sebastian Griesbeck,GER,Union Berlin,Bundesliga,2020,29.0,1990.0,9.9,20,9,8,11,1,8,19,42.1,11,13,3,10,5,25,8,0,MF,25-29,Midfielder,Germany,Europe
1043,Antoine Griezmann,FRA,Barcelona,La Liga,2020,29.0,1991.0,28.9,37,22,10,18,9,12,40,30.0,28,20,1,19,12,49,11,0,"FW,MF",25-29,Forward,France,Europe
1044,Vincenzo Grifo,ITA,Freiburg,Bundesliga,2020,27.0,1993.0,25.7,18,7,6,7,5,14,34,41.2,20,13,0,13,27,45,18,1,"MF,FW",25-29,Midfielder,Italy,Europe
1045,Lennart Grill,GER,Leverkusen,Bundesliga,2020,21.0,1999.0,4.0,0,0,0,0,0,0,0,,0,0,0,0,0,0,2,0,GK,20-24,Goalkeeper,Germany,Europe
1046,Florian Grillitsch,AUT,Hoffenheim,Bundesliga,2020,24.0,1995.0,20.9,37,21,21,13,3,19,52,36.5,33,38,7,31,51,88,47,1,"MF,DF",20-24,Midfielder,Austria,Europe
1047,Christian Groß,GER,Werder Bremen,Bundesliga,2020,31.0,1989.0,16.3,44,28,17,25,2,15,37,40.5,22,12,2,10,24,68,37,0,"MF,DF",30-34,Midfielder,Germany,Europe
1048,Pascal Groß,GER,Brighton,Premier League,2020,29.0,1991.0,27.6,45,24,24,15,6,24,53,45.3,29,25,4,21,23,68,18,1,"MF,DF",25-29,Midfielder,Germany,Europe
1050,Ilia Gruev,BUL,Werder Bremen,Bundesliga,2020,20.0,2000.0,0.0,0,0,0,0,0,0,0,,0,0,0,0,0,0,0,0,FW,20-24,Forward,Bulgaria,Europe
1051,Carlos Gruezo,ECU,Augsburg,Bundesliga,2020,25.0,1995.0,23.2,57,32,20,32,5,20,52,38.5,32,32,5,27,35,92,29,1,MF,25-29,Midfielder,Ecuador,South America
1053,Andrés Guardado,MEX,Betis,La Liga,2020,33.0,1986.0,14.6,25,12,10,11,4,10,25,40.0,15,13,3,10,18,43,19,0,MF,30-34,Midfielder,Mexico,North America
1056,Gonçalo Guedes,POR,Valencia,La Liga,2020,23.0,1996.0,25.4,18,12,8,7,3,10,45,22.2,35,24,1,23,8,26,7,0,"MF,FW",20-24,Midfielder,Portugal,Europe
1057,Mattéo Guendouzi,FRA,Hertha BSC,Bundesliga,2020,21.0,1999.0,20.2,24,13,10,12,2,9,25,36.0,16,15,4,11,21,45,24,1,MF,20-24,Midfielder,France,Europe
1058,Raphaël Guerreiro,POR,Dortmund,Bundesliga,2020,26.0,1993.0,24.6,30,13,14,8,8,16,31,51.6,15,21,4,17,28,58,31,1,DF,25-29,Defender,Portugal,Europe
1059,Evann Guessand,CIV,Nice,Ligue 1,2020,19.0,2001.0,0.3,0,0,0,0,0,0,1,0.0,1,1,1,0,1,1,1,0,FW,Under 20,Forward,Ivory Coast,Africa
1060,Kelyan Guessoum,FRA,Nîmes,Ligue 1,2020,21.0,1999.0,12.5,13,7,11,1,1,11,16,68.8,5,8,6,2,24,37,51,0,DF,20-24,Defender,France,Europe
1062,Lamine Gueye,SEN,Metz,Ligue 1,2020,22.0,1998.0,16.2,18,9,4,11,3,7,24,29.2,17,7,2,5,21,39,5,0,"FW,MF",20-24,Forward,Senegal,Africa
1063,Pape Gueye,SEN,Marseille,Ligue 1,2020,21.0,1999.0,22.9,49,21,25,19,5,15,45,33.3,30,25,6,19,47,96,34,0,MF,20-24,Midfielder,Senegal,Africa
1064,John Guidetti,SWE,Alavés,La Liga,2020,28.0,1992.0,2.3,2,2,0,2,0,0,2,0.0,2,0,0,0,1,3,2,0,FW,25-29,Forward,Sweden,Europe
1065,Josuha Guilavogui,FRA,Wolfsburg,Bundesliga,2020,29.0,1990.0,8.3,17,9,9,8,0,5,12,41.7,7,12,5,7,29,46,25,0,"MF,DF",25-29,Midfielder,France,Europe
1068,Bruno Guimarães,BRA,Lyon,Ligue 1,2020,22.0,1997.0,19.5,76,34,26,41,9,30,64,46.9,34,24,4,20,14,90,13,0,MF,20-24,Midfielder,Brazil,South America
1069,Serhou Guirassy,GUI,Rennes,Ligue 1,2020,24.0,1996.0,19.6,4,1,1,3,0,1,3,33.3,2,10,1,9,5,9,17,0,FW,20-24,Forward,Guinea,Africa
1070,Péter Gulácsi,HUN,RB Leipzig,Bundesliga,2020,30.0,1990.0,33.0,1,0,1,0,0,1,2,50.0,1,0,0,0,2,3,7,0,GK,30-34,Goalkeeper,Hungary,Europe
1071,Manuel Gulde,GER,Freiburg,Bundesliga,2020,29.0,1991.0,21.7,27,15,12,12,3,5,21,23.8,16,25,15,10,37,64,64,0,DF,25-29,Defender,Germany,Europe
1073,İlkay Gündoğan,GER,Manchester City,Premier League,2020,29.0,1990.0,22.5,25,15,8,12,5,10,39,25.6,29,13,4,9,20,45,9,0,MF,25-29,Midfielder,Germany,Europe
1074,Christian Günter,GER,Freiburg,Bundesliga,2020,27.0,1993.0,34.0,34,19,18,13,3,15,43,34.9,28,38,9,29,29,63,40,0,"DF,MF",25-29,Defender,Germany,Europe
1082,Emmanuel Gyasi,GHA,Spezia,Serie A,2020,26.0,1994.0,31.7,30,16,16,10,4,9,31,29.0,22,13,2,11,14,44,8,0,FW,25-29,Forward,Ghana,Africa
1084,Janik Haberer,GER,Freiburg,Bundesliga,2020,26.0,1994.0,5.4,7,4,4,3,0,3,15,20.0,12,4,1,3,7,14,9,0,"MF,FW",25-29,Midfielder,Germany,Europe
1085,Alexander Hack,GER,Mainz 05,Bundesliga,2020,26.0,1993.0,15.2,32,21,23,8,1,18,31,58.1,13,26,17,9,41,73,91,2,DF,25-29,Defender,Germany,Europe
1086,Antwoine Hackford,ENG,Sheffield Utd,Premier League,2020,16.0,2004.0,0.1,0,0,0,0,0,0,0,,0,0,0,0,0,0,0,0,DF,Under 20,Defender,England,Europe
1087,Munir El Haddadi,MAR,Sevilla,La Liga,2020,24.0,1995.0,9.4,12,8,5,5,2,2,12,16.7,10,6,0,6,5,17,6,0,FW,20-24,Forward,Morocco,Africa
1088,André Hahn,GER,Augsburg,Bundesliga,2020,29.0,1990.0,22.6,31,17,14,13,4,9,44,20.5,35,35,3,32,14,45,24,0,"FW,MF",25-29,Forward,Germany,Europe
1089,Amadou Haidara,MLI,RB Leipzig,Bundesliga,2020,22.0,1998.0,21.2,50,28,20,21,9,11,36,30.6,25,33,1,32,30,80,24,0,"MF,FW",20-24,Midfielder,Mali,Africa
1091,Achraf Hakimi,MAR,Inter,Serie A,2020,21.0,1998.0,29.6,53,32,23,19,11,23,48,47.9,25,31,1,30,22,75,23,1,DF,20-24,Defender,Morocco,Africa
1093,Marcel Halstenberg,GER,RB Leipzig,Bundesliga,2020,28.0,1991.0,18.3,29,18,20,8,1,19,41,46.3,22,15,3,12,16,45,35,0,DF,25-29,Defender,Germany,Europe
1094,Pierre-Yves Hamel,FRA,Lorient,Ligue 1,2020,26.0,1994.0,9.4,15,8,3,9,3,1,6,16.7,5,12,1,11,10,25,6,0,FW,25-29,Forward,France,Europe
1095,Romain Hamouma,FRA,Saint-Étienne,Ligue 1,2020,33.0,1987.0,19.7,12,7,5,6,1,4,24,16.7,20,17,1,16,7,19,11,0,"FW,MF",30-34,Forward,France,Europe
1098,Amine Harit,MAR,Schalke 04,Bundesliga,2020,23.0,1997.0,23.3,22,13,8,11,3,10,23,43.5,13,9,1,8,17,39,7,1,"MF,FW",20-24,Midfielder,Morocco,Africa
1099,Rekeem Harper,ENG,West Brom,Premier League,2020,20.0,2000.0,0.4,0,0,0,0,0,0,0,,0,2,0,2,1,1,0,0,MF,20-24,Midfielder,England,Europe
1100,Jack Harrison,ENG,Leeds United,Premier League,2020,23.0,1996.0,31.6,63,38,20,30,13,26,59,44.1,33,30,2,28,15,78,21,0,"MF,FW",20-24,Midfielder,England,Europe
1101,Marcel Hartel,GER,Arminia,Bundesliga,2020,24.0,1996.0,18.7,35,19,15,18,2,20,40,50.0,20,17,4,13,26,61,16,1,MF,20-24,Midfielder,Germany,Europe
1102,Makoto Hasebe,JPN,Eint Frankfurt,Bundesliga,2020,36.0,1984.0,25.4,43,29,21,20,2,25,51,49.0,26,31,12,19,31,74,68,2,"DF,MF",35-39,Defender,Japan,Asia
1103,Hans Hateboer,NED,Atalanta,Serie A,2020,26.0,1994.0,19.6,28,17,12,14,2,13,23,56.5,10,8,1,7,17,45,9,0,DF,25-29,Defender,Netherlands,Europe
1104,Kortney Hause,ENG,Aston Villa,Premier League,2020,25.0,1995.0,7.0,4,2,3,1,0,0,3,0.0,3,4,2,2,8,12,53,0,DF,25-29,Defender,England,Europe
1105,Kai Havertz,GER,Chelsea,Premier League,2020,21.0,1999.0,16.9,18,9,6,10,2,6,27,22.2,21,25,0,25,4,22,22,1,"MF,FW",20-24,Midfielder,Germany,Europe
1106,Isaac Hayden,ENG,Newcastle Utd,Premier League,2020,25.0,1995.0,21.6,52,29,23,22,7,14,35,40.0,21,32,9,23,43,95,47,0,"MF,DF",25-29,Midfielder,England,Europe
1107,Eden Hazard,BEL,Real Madrid,La Liga,2020,29.0,1991.0,5.9,3,2,1,2,0,0,3,0.0,3,3,0,3,3,6,0,0,"FW,MF",25-29,Forward,Belgium,Europe
1109,Jonas Hector,GER,Köln,Bundesliga,2020,30.0,1990.0,14.3,34,22,8,21,5,15,35,42.9,20,24,5,19,19,53,20,1,"MF,FW",30-34,Midfielder,Germany,Europe
1110,Michael Hector,JAM,Fulham,Premier League,2020,28.0,1992.0,2.9,3,2,1,2,0,1,6,16.7,5,4,2,2,0,3,6,0,DF,25-29,Defender,Jamaica,North America
1113,Dominique Heintz,GER,Freiburg,Bundesliga,2020,26.0,1993.0,15.2,22,11,19,3,0,10,19,52.6,9,10,8,2,35,57,49,0,DF,25-29,Defender,Germany,Europe
1114,Dean Henderson,ENG,Manchester Utd,Premier League,2020,23.0,1997.0,12.5,1,1,1,0,0,1,2,50.0,1,0,0,0,0,1,3,2,GK,20-24,Goalkeeper,England,Europe
1116,Jeff Hendrick,IRL,Newcastle Utd,Premier League,2020,28.0,1992.0,15.8,8,3,5,3,0,1,13,7.7,12,14,9,5,19,27,18,0,MF,25-29,Midfielder,Republic of Ireland,Europe
1117,Benjamin Henrichs,GER,RB Leipzig,Bundesliga,2020,23.0,1997.0,6.0,12,7,4,5,3,2,9,22.2,7,9,1,8,8,20,8,0,"DF,MF",20-24,Defender,Germany,Europe
1120,Luis Henrique,BRA,Marseille,Ligue 1,2020,18.0,2001.0,7.5,5,4,3,1,1,4,9,44.4,5,5,1,4,7,12,4,0,"FW,DF",Under 20,Forward,Brazil,South America
1120,Luis Henrique,BRA,Marseille,Ligue 1,2020,18.0,2001.0,7.5,5,4,3,1,1,4,9,44.4,5,5,1,4,7,12,4,0,"FW,DF",Under 20,Forward,Brazil,South America
1120,Luis Henrique,BRA,Marseille,Ligue 1,2020,18.0,2001.0,7.5,5,4,3,1,1,4,9,44.4,5,5,1,4,7,12,4,0,"FW,DF",Under 20,Forward,Brazil,South America
1120,Luis Henrique,BRA,Marseille,Ligue 1,2020,18.0,2001.0,7.5,5,4,3,1,1,4,9,44.4,5,5,1,4,7,12,4,0,"FW,DF",Under 20,Forward,Brazil,South America
1122,Jérôme Hergault,FRA,Lorient,Ligue 1,2020,34.0,1986.0,18.1,38,23,22,10,6,17,31,54.8,14,16,2,14,22,60,34,0,"DF,MF",30-34,Defender,France,Europe
1125,Lucas Hernández,FRA,Bayern Munich,Bundesliga,2020,24.0,1996.0,17.7,41,31,16,17,8,17,31,54.8,14,24,6,18,19,60,38,0,DF,20-24,Defender,France,Europe
1127,Theo Hernández,FRA,Milan,Serie A,2020,22.0,1997.0,32.6,48,29,22,21,5,19,38,50.0,19,29,6,23,34,82,64,5,DF,20-24,Defender,France,Europe
1128,Hernani,BRA,Parma,Serie A,2020,26.0,1994.0,24.3,51,25,21,27,3,29,66,43.9,37,35,4,31,31,82,40,1,MF,25-29,Midfielder,Brazil,South America
1130,Héctor Herrera,MEX,Atlético Madrid,La Liga,2020,30.0,1990.0,7.6,12,7,5,6,1,7,13,53.8,6,7,2,5,14,26,8,0,MF,30-34,Midfielder,Mexico,North America
1132,Yangel Herrera,VEN,Granada,La Liga,2020,22.0,1998.0,25.7,59,26,19,32,8,11,41,26.8,30,53,17,36,26,85,32,1,MF,20-24,Midfielder,Venezuela,South America
1133,Patrick Herrmann,GER,Gladbach,Bundesliga,2020,29.0,1991.0,9.7,9,6,4,3,2,2,14,14.3,12,16,0,16,10,19,8,0,"FW,MF",25-29,Forward,Germany,Europe
1137,Aaron Hickey,SCO,Bologna,Serie A,2020,18.0,2002.0,8.4,12,8,10,2,0,7,17,41.2,10,6,1,5,15,27,15,1,DF,Under 20,Defender,Scotland,Europe
1139,Martin Hinteregger,AUT,Eint Frankfurt,Bundesliga,2020,27.0,1992.0,28.1,77,49,53,22,2,37,63,58.7,26,31,12,19,44,121,92,0,DF,25-29,Defender,Austria,Europe
1140,Marwin Hitz,SUI,Dortmund,Bundesliga,2020,32.0,1987.0,15.5,1,1,1,0,0,1,1,100.0,0,0,0,0,0,1,7,1,GK,30-34,Goalkeeper,Switzerland,Europe
1142,Ki-Jana Hoever,NED,Wolves,Premier League,2020,18.0,2002.0,6.4,14,6,11,2,1,10,22,45.5,12,2,0,2,9,23,23,0,"DF,MF",Under 20,Defender,Netherlands,Europe
1143,Nicolas Höfler,GER,Freiburg,Bundesliga,2020,30.0,1990.0,30.3,54,28,16,31,7,23,59,39.0,36,34,10,24,66,120,41,2,MF,30-34,Midfielder,Germany,Europe
1144,Jonas Hofmann,GER,Gladbach,Bundesliga,2020,28.0,1992.0,20.2,26,20,12,12,2,10,53,18.9,43,27,2,25,27,53,9,0,"FW,MF",25-29,Forward,Germany,Europe
1144,Jonas Hofmann,GER,Gladbach,Bundesliga,2020,28.0,1992.0,20.2,26,20,12,12,2,10,53,18.9,43,27,2,25,27,53,9,0,"FW,MF",25-29,Forward,Germany,Europe
1144,Jonas Hofmann,GER,Gladbach,Bundesliga,2020,28.0,1992.0,20.2,26,20,12,12,2,10,53,18.9,43,27,2,25,27,53,9,0,"FW,MF",25-29,Forward,Germany,Europe
1144,Jonas Hofmann,GER,Gladbach,Bundesliga,2020,28.0,1992.0,20.2,26,20,12,12,2,10,53,18.9,43,27,2,25,27,53,9,0,"FW,MF",25-29,Forward,Germany,Europe
1145,Marco Höger,GER,Köln,Bundesliga,2020,30.0,1989.0,0.6,1,0,0,1,0,1,2,50.0,1,2,0,2,2,3,1,0,"DF,MF",30-34,Defender,Germany,Europe
1146,Rob Holding,ENG,Arsenal,Premier League,2020,24.0,1995.0,28.4,43,20,28,13,2,17,35,48.6,18,37,27,10,24,67,120,0,DF,20-24,Defender,England,Europe
1147,Lucas Höler,GER,Freiburg,Bundesliga,2020,26.0,1994.0,23.2,36,24,13,19,4,12,32,37.5,20,19,2,17,16,52,14,0,"FW,MF",25-29,Forward,Germany,Europe
1148,Mason Holgate,ENG,Everton,Premier League,2020,23.0,1996.0,25.4,56,36,31,18,7,20,50,40.0,30,37,13,24,35,91,90,3,DF,20-24,Defender,England,Europe
1150,Franck Honorat,FRA,Brest,Ligue 1,2020,23.0,1996.0,27.3,28,13,12,10,6,14,37,37.8,23,15,3,12,11,39,24,0,"MF,FW",20-24,Midfielder,France,Europe
1152,Jannes Horn,GER,Köln,Bundesliga,2020,23.0,1997.0,19.6,35,19,23,11,1,23,31,74.2,8,19,2,17,10,45,45,0,DF,20-24,Defender,Germany,Europe
1153,Timo Horn,GER,Köln,Bundesliga,2020,27.0,1993.0,33.4,1,0,1,0,0,1,4,25.0,3,1,0,1,0,1,11,2,GK,25-29,Goalkeeper,Germany,Europe
1154,Fraser Hornby,SCO,Reims,Ligue 1,2020,20.0,1999.0,0.4,0,0,0,0,0,0,0,,0,0,0,0,1,1,0,0,"FW,MF",20-24,Forward,Scotland,Europe
1155,Conor Hourihane,IRL,Aston Villa,Premier League,2020,29.0,1991.0,2.5,0,0,0,0,0,0,2,0.0,2,3,0,3,0,0,2,0,MF,25-29,Midfielder,Republic of Ireland,Europe
1158,Florian Hübner,GER,Union Berlin,Bundesliga,2020,29.0,1991.0,5.8,10,5,7,3,0,7,15,46.7,8,7,3,4,13,23,21,0,DF,25-29,Defender,Germany,Europe
1159,Callum Hudson-Odoi,ENG,Chelsea,Premier League,2020,19.0,2000.0,11.8,23,15,11,7,5,8,21,38.1,13,15,1,14,6,29,6,0,"FW,DF",Under 20,Forward,England,Europe
1161,Mats Hummels,GER,Dortmund,Bundesliga,2020,31.0,1988.0,31.3,58,40,34,18,6,26,42,61.9,16,31,22,9,73,131,122,2,DF,30-34,Defender,Germany,Europe
1162,Adrien Hunou,FRA,Rennes,Ligue 1,2020,26.0,1994.0,6.5,6,3,2,2,2,2,8,25.0,6,7,0,7,1,7,2,0,"FW,MF",25-29,Forward,France,Europe
1164,Elseid Hysaj,ALB,Napoli,Serie A,2020,26.0,1994.0,19.6,29,17,16,11,2,17,33,51.5,16,18,4,14,30,59,52,0,DF,25-29,Defender,Albania,Europe
1166,Simone Iacoponi,ITA,Parma,Serie A,2020,33.0,1987.0,13.3,22,12,16,5,1,13,26,50.0,13,9,4,5,11,33,42,1,DF,30-34,Defender,Italy,Europe
1167,Iago,BRA,Augsburg,Bundesliga,2020,23.0,1997.0,17.3,37,27,21,13,3,17,29,58.6,12,17,5,12,22,59,55,0,DF,20-24,Defender,Brazil,South America
1172,Zlatan Ibrahimović,SWE,Milan,Serie A,2020,38.0,1981.0,16.6,5,4,0,4,1,3,6,50.0,3,5,3,2,6,11,27,1,FW,35-39,Forward,Sweden,Europe
1176,Odion Ighalo,NGA,Manchester Utd,Premier League,2020,31.0,1989.0,0.1,0,0,0,0,0,0,1,0.0,1,0,0,0,0,0,0,0,FW,30-34,Forward,Nigeria,Africa
1179,Igor,BRA,Fiorentina,Serie A,2020,22.0,1998.0,13.0,15,9,9,6,0,7,12,58.3,5,17,9,8,23,38,34,0,DF,20-24,Defender,Brazil,South America
1179,Igor,BRA,Fiorentina,Serie A,2020,22.0,1998.0,13.0,15,9,9,6,0,7,12,58.3,5,17,9,8,23,38,34,0,DF,20-24,Defender,Brazil,South America
1179,Igor,BRA,Fiorentina,Serie A,2020,22.0,1998.0,13.0,15,9,9,6,0,7,12,58.3,5,17,9,8,23,38,34,0,DF,20-24,Defender,Brazil,South America
1179,Igor,BRA,Fiorentina,Serie A,2020,22.0,1998.0,13.0,15,9,9,6,0,7,12,58.3,5,17,9,8,23,38,34,0,DF,20-24,Defender,Brazil,South America
1180,Kelechi Iheanacho,NGA,Leicester City,Premier League,2020,23.0,1996.0,16.2,12,5,2,4,6,4,17,23.5,13,14,0,14,2,14,1,1,FW,20-24,Forward,Nigeria,Africa
1186,Stefan Ilsanker,AUT,Eint Frankfurt,Bundesliga,2020,31.0,1989.0,17.5,33,20,17,15,1,21,42,50.0,21,30,8,22,30,63,51,2,"MF,DF",30-34,Midfielder,Austria,Europe
1188,Riccardo Improta,ITA,Benevento,Serie A,2020,26.0,1993.0,25.9,39,23,25,8,6,21,45,46.7,24,23,4,19,28,67,47,0,"DF,MF",25-29,Defender,Italy,Europe
1189,Roberto Inglese,ITA,Parma,Serie A,2020,28.0,1991.0,6.4,5,2,1,2,2,2,11,18.2,9,10,0,10,0,5,3,0,FW,25-29,Forward,Italy,Europe
1190,Danny Ings,ENG,Southampton,Premier League,2020,28.0,1992.0,24.1,22,13,3,16,3,12,28,42.9,16,39,2,37,3,25,27,1,FW,25-29,Forward,England,Europe
1192,Lorenzo Insigne,ITA,Napoli,Serie A,2020,29.0,1991.0,31.8,26,18,8,12,6,13,72,18.1,59,30,1,29,37,63,6,1,FW,25-29,Forward,Italy,Europe
1193,Roberto Insigne,ITA,Benevento,Serie A,2020,26.0,1994.0,17.8,16,10,8,3,5,7,27,25.9,20,10,0,10,7,23,9,0,"MF,FW",25-29,Midfielder,Italy,Europe
1195,Takashi Inui,JPN,Eibar,La Liga,2020,32.0,1988.0,20.2,13,8,6,3,4,3,12,25.0,9,19,0,19,12,25,7,0,"MF,FW",30-34,Midfielder,Japan,Asia
1197,Alexander Isak,SWE,Real Sociedad,La Liga,2020,20.0,1999.0,26.0,9,5,0,3,6,3,8,37.5,5,17,1,16,3,12,7,0,FW,20-24,Forward,Sweden,Europe
1199,Ardian Ismajli,ALB,Spezia,Serie A,2020,23.0,1996.0,14.4,19,9,10,8,1,8,13,61.5,5,10,7,3,23,42,52,1,DF,20-24,Defender,Albania,Europe
1202,Alex Iwobi,NGA,Everton,Premier League,2020,24.0,1996.0,17.1,27,10,10,14,3,13,25,52.0,12,20,1,19,16,43,14,0,"FW,MF",20-24,Forward,Nigeria,Africa
1205,Armando Izzo,ITA,Torino,Serie A,2020,28.0,1992.0,22.3,30,16,13,13,4,13,33,39.4,20,22,9,13,53,83,62,0,DF,25-29,Defender,Italy,Europe
1206,Phil Jagielka,ENG,Sheffield Utd,Premier League,2020,37.0,1982.0,5.8,5,4,4,0,1,2,7,28.6,5,11,5,6,10,15,26,2,DF,35-39,Defender,England,Europe
1208,Mato Jajalo,BIH,Udinese,Serie A,2020,32.0,1988.0,0.4,1,1,1,0,0,1,1,100.0,0,1,0,1,2,3,0,0,MF,30-34,Midfielder,Bosnia and Herzegovina,Europe
1210,Daniel James,WAL,Manchester Utd,Premier League,2020,22.0,1997.0,10.1,15,9,4,7,4,3,18,16.7,15,10,1,9,0,15,6,0,FW,20-24,Forward,Wales,Europe
1211,Reece James,ENG,Chelsea,Premier League,2020,20.0,1999.0,26.4,55,35,24,22,9,21,44,47.7,23,36,7,29,17,72,52,0,DF,20-24,Defender,England,Europe
1211,Reece James,ENG,Chelsea,Premier League,2020,20.0,1999.0,26.4,55,35,24,22,9,21,44,47.7,23,36,7,29,17,72,52,0,DF,20-24,Defender,England,Europe
1211,Reece James,ENG,Chelsea,Premier League,2020,20.0,1999.0,26.4,55,35,24,22,9,21,44,47.7,23,36,7,29,17,72,52,0,DF,20-24,Defender,England,Europe
1211,Reece James,ENG,Chelsea,Premier League,2020,20.0,1999.0,26.4,55,35,24,22,9,21,44,47.7,23,36,7,29,17,72,52,0,DF,20-24,Defender,England,Europe
1213,Saidy Janko,GAM,Valladolid,La Liga,2020,24.0,1995.0,13.6,19,10,12,5,2,8,14,57.1,6,9,1,8,18,37,47,0,DF,20-24,Defender,Gambia,Africa
1215,Tony Jantschke,GER,Gladbach,Bundesliga,2020,30.0,1990.0,3.0,2,2,1,1,0,1,3,33.3,2,6,4,2,4,6,7,0,DF,30-34,Defender,Germany,Europe
1216,Adnan Januzaj,BEL,Real Sociedad,La Liga,2020,25.0,1995.0,11.3,9,8,0,6,3,3,8,37.5,5,7,2,5,3,12,4,0,"FW,MF",25-29,Forward,Belgium,Europe
1220,Corentin Jean,FRA,Lens,Ligue 1,2020,25.0,1995.0,6.4,4,3,1,1,2,0,5,0.0,5,4,0,4,2,6,2,0,"FW,MF",25-29,Forward,France,Europe
1223,Fredrik Jensen,FIN,Augsburg,Bundesliga,2020,22.0,1997.0,4.2,3,2,1,2,0,3,6,50.0,3,4,1,3,2,5,6,0,"FW,MF",20-24,Forward,Finland,Europe
1225,Gabriel Jesus,BRA,Manchester City,Premier League,2020,23.0,1997.0,22.9,17,6,5,5,7,11,28,39.3,17,16,0,16,15,32,5,0,FW,20-24,Forward,Brazil,South America
1226,Juan Jesus,BRA,Roma,Serie A,2020,29.0,1991.0,1.7,3,1,2,1,0,2,4,50.0,2,1,0,1,2,5,5,0,DF,25-29,Defender,Brazil,South America
1227,Raúl Jiménez,MEX,Wolves,Premier League,2020,29.0,1991.0,9.1,3,2,1,2,0,0,7,0.0,7,2,0,2,8,11,12,0,FW,25-29,Forward,Mexico,North America
1230,Joelinton,BRA,Newcastle Utd,Premier League,2020,23.0,1996.0,22.0,33,21,7,21,5,14,37,37.8,23,30,2,28,9,42,24,0,"FW,MF",20-24,Forward,Brazil,South America
1231,Marco John,GER,Hoffenheim,Bundesliga,2020,18.0,2002.0,11.1,21,15,9,5,7,10,22,45.5,12,18,1,17,16,37,21,0,DF,Under 20,Defender,Germany,Europe
1232,Ben Johnson,ENG,West Ham,Premier League,2020,20.0,2000.0,5.8,11,5,5,3,3,7,9,77.8,2,5,1,4,11,22,9,0,"DF,FW",20-24,Defender,England,Europe
1233,Sam Johnstone,ENG,West Brom,Premier League,2020,27.0,1993.0,37.0,0,0,0,0,0,0,0,,0,0,0,0,2,2,15,2,GK,25-29,Goalkeeper,England,Europe
1234,Curtis Jones,ENG,Liverpool,Premier League,2020,19.0,2001.0,13.1,16,6,6,7,3,12,25,48.0,13,13,0,13,19,35,11,1,MF,Under 20,Midfielder,England,Europe
1235,Frenkie de Jong,NED,Barcelona,La Liga,2020,23.0,1997.0,35.0,44,27,21,19,4,15,35,42.9,20,20,4,16,38,82,29,2,"MF,DF",20-24,Midfielder,Netherlands,Europe
1239,Jorginho,ITA,Chelsea,Premier League,2020,28.0,1991.0,22.3,57,30,22,31,4,31,76,40.8,45,33,5,28,40,97,21,3,MF,25-29,Midfielder,Italy,Europe
1239,Jorginho,ITA,Chelsea,Premier League,2020,28.0,1991.0,22.3,57,30,22,31,4,31,76,40.8,45,33,5,28,40,97,21,3,MF,25-29,Midfielder,Italy,Europe
1239,Jorginho,ITA,Chelsea,Premier League,2020,28.0,1991.0,22.3,57,30,22,31,4,31,76,40.8,45,33,5,28,40,97,21,3,MF,25-29,Midfielder,Italy,Europe
1239,Jorginho,ITA,Chelsea,Premier League,2020,28.0,1991.0,22.3,57,30,22,31,4,31,76,40.8,45,33,5,28,40,97,21,3,MF,25-29,Midfielder,Italy,Europe
1239,Jorginho,ITA,Chelsea,Premier League,2020,28.0,1991.0,22.3,57,30,22,31,4,31,76,40.8,45,33,5,28,40,97,21,3,MF,25-29,Midfielder,Italy,Europe
1239,Jorginho,ITA,Chelsea,Premier League,2020,28.0,1991.0,22.3,57,30,22,31,4,31,76,40.8,45,33,5,28,40,97,21,3,MF,25-29,Midfielder,Italy,Europe
1239,Jorginho,ITA,Chelsea,Premier League,2020,28.0,1991.0,22.3,57,30,22,31,4,31,76,40.8,45,33,5,28,40,97,21,3,MF,25-29,Midfielder,Italy,Europe
1239,Jorginho,ITA,Chelsea,Premier League,2020,28.0,1991.0,22.3,57,30,22,31,4,31,76,40.8,45,33,5,28,40,97,21,3,MF,25-29,Midfielder,Italy,Europe
1239,Jorginho,ITA,Chelsea,Premier League,2020,28.0,1991.0,22.3,57,30,22,31,4,31,76,40.8,45,33,5,28,40,97,21,3,MF,25-29,Midfielder,Italy,Europe
1239,Jorginho,ITA,Chelsea,Premier League,2020,28.0,1991.0,22.3,57,30,22,31,4,31,76,40.8,45,33,5,28,40,97,21,3,MF,25-29,Midfielder,Italy,Europe
1239,Jorginho,ITA,Chelsea,Premier League,2020,28.0,1991.0,22.3,57,30,22,31,4,31,76,40.8,45,33,5,28,40,97,21,3,MF,25-29,Midfielder,Italy,Europe
1239,Jorginho,ITA,Chelsea,Premier League,2020,28.0,1991.0,22.3,57,30,22,31,4,31,76,40.8,45,33,5,28,40,97,21,3,MF,25-29,Midfielder,Italy,Europe
1239,Jorginho,ITA,Chelsea,Premier League,2020,28.0,1991.0,22.3,57,30,22,31,4,31,76,40.8,45,33,5,28,40,97,21,3,MF,25-29,Midfielder,Italy,Europe
1239,Jorginho,ITA,Chelsea,Premier League,2020,28.0,1991.0,22.3,57,30,22,31,4,31,76,40.8,45,33,5,28,40,97,21,3,MF,25-29,Midfielder,Italy,Europe
1239,Jorginho,ITA,Chelsea,Premier League,2020,28.0,1991.0,22.3,57,30,22,31,4,31,76,40.8,45,33,5,28,40,97,21,3,MF,25-29,Midfielder,Italy,Europe
1239,Jorginho,ITA,Chelsea,Premier League,2020,28.0,1991.0,22.3,57,30,22,31,4,31,76,40.8,45,33,5,28,40,97,21,3,MF,25-29,Midfielder,Italy,Europe
1241,Willian José,BRA,Wolves,Premier League,2020,28.0,1991.0,12.3,2,1,1,1,0,1,4,25.0,3,6,1,5,1,3,12,0,FW,25-29,Forward,Brazil,South America
1242,Willian José,BRA,Real Sociedad,La Liga,2020,28.0,1991.0,7.7,3,1,0,3,0,1,3,33.3,2,3,1,2,0,3,8,0,FW,25-29,Forward,Brazil,South America
1247,Diogo Jota,POR,Liverpool,Premier League,2020,23.0,1996.0,12.4,12,6,4,7,1,2,29,6.9,27,9,0,9,5,17,3,0,FW,20-24,Forward,Portugal,Europe
1254,James Justin,ENG,Leicester City,Premier League,2020,22.0,1998.0,23.0,61,37,38,18,5,20,41,48.8,21,36,10,26,30,91,58,1,DF,20-24,Defender,England,Europe
1257,Ozan Kabak,TUR,Liverpool,Premier League,2020,20.0,2000.0,8.9,19,10,11,4,4,6,9,66.7,3,2,2,0,12,31,28,1,DF,20-24,Defender,Turkey,Asia
1258,Ozan Kabak,TUR,Schalke 04,Bundesliga,2020,20.0,2000.0,13.8,17,9,11,5,1,6,13,46.2,7,20,11,9,13,30,57,0,DF,20-24,Defender,Turkey,Asia
1259,Abdoul Kader Bamba,FRA,Nantes,Ligue 1,2020,26.0,1994.0,10.2,18,3,7,8,3,11,18,61.1,7,10,0,10,7,25,4,1,"FW,MF",25-29,Forward,France,Europe
1261,Tino Kadewere,ZIM,Lyon,Ligue 1,2020,24.0,1996.0,22.3,35,22,12,16,7,17,49,34.7,32,16,3,13,21,56,31,0,FW,20-24,Forward,Zimbabwe,Africa
1263,Florian Kainz,AUT,Köln,Bundesliga,2020,27.0,1992.0,5.0,4,2,0,4,0,2,8,25.0,6,7,0,7,3,7,3,0,"MF,FW",25-29,Midfielder,Austria,Europe
1264,Gaël Kakuta,COD,Lens,Ligue 1,2020,29.0,1991.0,26.6,38,23,10,18,10,8,44,18.2,36,24,3,21,17,55,4,0,"MF,FW",25-29,Midfielder,DR Congo,Africa
1265,Sasa Kalajdzic,AUT,Stuttgart,Bundesliga,2020,23.0,1997.0,23.7,16,12,4,5,7,2,17,11.8,15,10,1,9,9,25,21,0,FW,20-24,Forward,Austria,Europe
1266,Arnaud Kalimuendo,FRA,Paris S-G,Ligue 1,2020,18.0,2002.0,0.8,0,0,0,0,0,0,0,,0,0,0,0,0,0,0,0,FW,Under 20,Forward,France,Europe
1267,Arnaud Kalimuendo,FRA,Lens,Ligue 1,2020,18.0,2002.0,13.5,8,2,2,2,4,1,7,14.3,6,11,0,11,2,10,2,0,"FW,MF",Under 20,Forward,France,Europe
1269,Yayah Kallon,SLE,Genoa,Serie A,2020,19.0,2001.0,0.5,0,0,0,0,0,0,0,,0,0,0,0,0,0,0,0,FW,Under 20,Forward,Sierra Leone,Africa
1270,Samuel Kalu,NGA,Bordeaux,Ligue 1,2020,22.0,1997.0,10.7,21,12,11,8,2,4,13,30.8,9,14,0,14,9,30,2,0,"FW,MF",20-24,Forward,Nigeria,Africa
1271,Pierre Kalulu,FRA,Milan,Serie A,2020,20.0,2000.0,8.1,18,14,11,6,1,10,14,71.4,4,9,3,6,19,37,20,0,DF,20-24,Defender,France,Europe
1272,Daichi Kamada,JPN,Eint Frankfurt,Bundesliga,2020,23.0,1996.0,26.2,48,28,21,16,11,16,49,32.7,33,18,1,17,14,62,22,0,MF,20-24,Midfielder,Japan,Asia
1275,Bingourou Kamara,SEN,Strasbourg,Ligue 1,2020,23.0,1996.0,8.0,1,1,1,0,0,1,3,33.3,2,0,0,0,1,2,2,1,GK,20-24,Goalkeeper,Senegal,Africa
1276,Boubacar Kamara,FRA,Marseille,Ligue 1,2020,20.0,1999.0,32.2,88,51,31,49,8,40,74,54.1,34,36,13,23,34,122,51,0,MF,20-24,Midfielder,France,Europe
1277,Hassane Kamara,CIV,Nice,Ligue 1,2020,26.0,1994.0,32.9,65,39,40,16,9,27,49,55.1,22,39,12,27,55,120,61,1,"DF,FW",25-29,Defender,Ivory Coast,Africa
1280,Harry Kane,ENG,Tottenham,Premier League,2020,27.0,1993.0,34.2,22,12,1,17,4,8,26,30.8,18,28,11,17,11,33,40,0,FW,25-29,Forward,England,Europe
1283,N'Golo Kanté,FRA,Chelsea,Premier League,2020,29.0,1991.0,23.8,79,42,39,35,5,27,56,48.2,29,42,4,38,59,138,34,0,MF,25-29,Midfielder,France,Europe
1284,Jimmy Kaparos,GER,Schalke 04,Bundesliga,2020,18.0,2001.0,0.2,0,0,0,0,0,0,1,0.0,1,0,0,0,0,0,0,0,MF,Under 20,Midfielder,Germany,Europe
1285,Yann Karamoh,FRA,Parma,Serie A,2020,22.0,1998.0,14.4,27,17,8,12,7,11,31,35.5,20,6,0,6,4,31,11,0,"FW,MF",20-24,Forward,France,Europe
1288,Augustus Kargbo,SLE,Crotone,Serie A,2020,20.0,1999.0,0.4,0,0,0,0,0,0,0,,0,0,0,0,0,0,0,0,FW,20-24,Forward,Sierra Leone,Africa
1289,Loris Karius,GER,Union Berlin,Bundesliga,2020,27.0,1993.0,3.2,0,0,0,0,0,0,0,,0,0,0,0,0,0,2,0,GK,25-29,Goalkeeper,Germany,Europe
1292,Noah Katterbach,GER,Köln,Bundesliga,2020,19.0,2001.0,12.3,18,11,11,6,1,13,21,61.9,8,7,3,4,23,41,22,0,"DF,MF",Under 20,Defender,Germany,Europe
1293,Eiji Kawashima,JPN,Strasbourg,Ligue 1,2020,37.0,1983.0,24.0,1,0,1,0,0,1,1,100.0,0,0,0,0,0,1,4,2,GK,35-39,Goalkeeper,Japan,Asia
1294,Moise Kean,ITA,Everton,Premier League,2020,20.0,2000.0,0.2,0,0,0,0,0,0,0,,0,0,0,0,0,0,0,0,"FW,MF",20-24,Forward,Italy,Europe
1295,Moise Kean,ITA,Paris S-G,Ligue 1,2020,20.0,2000.0,18.9,11,8,2,6,3,3,12,25.0,9,7,1,6,8,19,10,0,FW,20-24,Forward,Italy,Europe
1296,Michael Keane,ENG,Everton,Premier League,2020,27.0,1993.0,33.2,28,15,20,8,0,14,31,45.2,17,46,33,13,51,79,161,0,DF,25-29,Defender,England,Europe
1297,Neeskens Kebano,COD,Fulham,Premier League,2020,28.0,1992.0,1.3,0,0,0,0,0,0,1,0.0,1,3,0,3,0,0,0,0,"FW,MF",25-29,Forward,DR Congo,Africa
1298,Thilo Kehrer,GER,Paris S-G,Ligue 1,2020,23.0,1996.0,18.0,31,26,17,11,3,10,26,38.5,16,16,4,12,15,46,37,1,DF,20-24,Defender,Germany,Europe
1300,Naby Keïta,GUI,Liverpool,Premier League,2020,25.0,1995.0,5.8,11,5,1,8,2,7,17,41.2,10,10,0,10,9,20,6,0,MF,25-29,Midfielder,Guinea,Africa
1301,Yannik Keitel,GER,Freiburg,Bundesliga,2020,20.0,2000.0,5.5,12,8,7,4,1,7,9,77.8,2,9,3,6,10,22,8,0,MF,20-24,Midfielder,Germany,Europe
1302,Caoimhín Kelleher,IRL,Liverpool,Premier League,2020,21.0,1998.0,2.0,0,0,0,0,0,0,0,,0,0,0,0,0,0,2,0,GK,20-24,Goalkeeper,Republic of Ireland,Europe
1303,Stephane Keller,CMR,Alavés,La Liga,2020,18.0,2001.0,0.2,1,0,1,0,0,1,1,100.0,0,0,0,0,0,1,0,0,DF,Under 20,Defender,Cameroon,Africa
1304,Martin Kelly,ENG,Crystal Palace,Premier League,2020,30.0,1990.0,0.0,1,0,1,0,0,1,1,100.0,0,0,0,0,0,1,0,0,DF,30-34,Defender,England,Europe
1306,Kenedy,BRA,Granada,La Liga,2020,24.0,1996.0,16.3,22,12,10,7,5,5,25,20.0,20,21,4,17,26,48,15,1,"FW,MF",20-24,Forward,Brazil,South America
1307,Jonjoe Kenny,ENG,Everton,Premier League,2020,23.0,1997.0,0.9,2,1,1,0,1,2,2,100.0,0,0,0,0,1,3,3,0,DF,20-24,Defender,England,Europe
1308,Franck Kessié,CIV,Milan,Serie A,2020,23.0,1996.0,35.8,53,30,28,19,6,20,38,52.6,18,47,15,32,46,99,51,0,MF,20-24,Midfielder,Ivory Coast,Africa
1310,Omar Khailoti,ITA,Bologna,Serie A,2020,18.0,2001.0,0.3,0,0,0,0,0,0,0,,0,2,0,2,1,1,0,0,DF,Under 20,Defender,Italy,Europe
1311,Saîf-Eddine Khaoui,TUN,Marseille,Ligue 1,2020,25.0,1995.0,6.7,19,11,7,6,6,7,16,43.8,9,8,0,8,12,31,1,0,"FW,DF",25-29,Forward,Tunisia,Africa
1312,Wahbi Khazri,TUN,Saint-Étienne,Ligue 1,2020,29.0,1991.0,13.1,24,15,12,7,5,12,24,50.0,12,10,1,9,4,28,11,0,FW,25-29,Forward,Tunisia,Africa
1313,Rani Khedira,GER,Augsburg,Bundesliga,2020,26.0,1994.0,20.2,29,10,13,15,1,10,20,50.0,10,14,5,9,31,60,47,0,MF,25-29,Midfielder,Germany,Europe
1314,Sami Khedira,GER,Hertha BSC,Bundesliga,2020,33.0,1987.0,4.4,11,6,3,7,1,6,12,50.0,6,4,0,4,9,20,7,0,MF,30-34,Midfielder,Germany,Europe
1316,Luca Kilian,GER,Mainz 05,Bundesliga,2020,20.0,1999.0,4.2,14,7,10,4,0,9,17,52.9,8,3,1,2,13,27,12,0,DF,20-24,Defender,Germany,Europe
1318,Joshua Kimmich,GER,Bayern Munich,Bundesliga,2020,25.0,1995.0,24.4,40,28,16,19,5,10,53,18.9,43,25,5,20,36,76,19,0,MF,25-29,Midfielder,Germany,Europe
1319,Presnel Kimpembe,FRA,Paris S-G,Ligue 1,2020,24.0,1995.0,25.6,46,28,23,19,4,24,34,70.6,10,19,11,8,30,76,61,4,DF,20-24,Defender,France,Europe
1321,Simon Kjær,DEN,Milan,Serie A,2020,31.0,1989.0,26.6,45,26,23,20,2,18,30,60.0,12,42,26,16,42,87,125,0,DF,30-34,Defender,Denmark,Europe
1323,Felix Klaus,GER,Wolfsburg,Bundesliga,2020,27.0,1992.0,1.5,7,4,3,4,0,4,5,80.0,1,4,0,4,2,9,4,0,"DF,MF",25-29,Defender,Germany,Europe
1325,Ragnar Klavan,EST,Cagliari,Serie A,2020,34.0,1985.0,8.6,15,9,9,5,1,7,11,63.6,4,9,4,5,8,23,34,0,DF,30-34,Defender,Estonia,Europe
1326,Philipp Klement,GER,Stuttgart,Bundesliga,2020,27.0,1992.0,4.7,7,3,6,0,1,3,7,42.9,4,9,2,7,6,13,7,0,"MF,FW",25-29,Midfielder,Germany,Europe
1328,Mateo Klimowicz,GER,Stuttgart,Bundesliga,2020,20.0,2000.0,13.3,20,15,6,10,4,5,18,27.8,13,5,1,4,2,22,2,0,"MF,FW",20-24,Midfielder,Germany,Europe
1329,Fabian Klos,GER,Arminia,Bundesliga,2020,32.0,1987.0,30.1,24,13,9,11,4,7,26,26.9,19,20,6,14,4,28,29,0,FW,30-34,Forward,Germany,Europe
1330,Lukas Klostermann,GER,RB Leipzig,Bundesliga,2020,24.0,1996.0,16.1,23,19,8,12,3,11,18,61.1,7,16,6,10,18,41,44,1,DF,20-24,Defender,Germany,Europe
1331,Justin Kluivert,NED,Roma,Serie A,2020,21.0,1999.0,0.2,0,0,0,0,0,0,0,,0,0,0,0,0,0,0,0,MF,20-24,Midfielder,Netherlands,Europe
1332,Justin Kluivert,NED,RB Leipzig,Bundesliga,2020,21.0,1999.0,9.0,2,1,1,1,0,0,2,0.0,2,4,0,4,5,7,3,0,"FW,MF",20-24,Forward,Netherlands,Europe
1333,Lukas Klünter,GER,Hertha BSC,Bundesliga,2020,24.0,1996.0,11.0,10,5,6,4,0,5,10,50.0,5,3,1,2,11,21,29,1,DF,20-24,Defender,Germany,Europe
1334,Ansgar Knauff,GER,Dortmund,Bundesliga,2020,18.0,2002.0,0.8,0,0,0,0,0,0,1,0.0,1,3,1,2,0,0,0,0,"MF,FW",Under 20,Midfielder,Germany,Europe
1335,Robin Knoche,GER,Union Berlin,Bundesliga,2020,28.0,1992.0,33.8,44,29,30,12,2,23,39,59.0,16,43,27,16,49,93,118,2,DF,25-29,Defender,Germany,Europe
1336,Gregor Kobel,SUI,Stuttgart,Bundesliga,2020,22.0,1997.0,33.0,2,2,2,0,0,2,2,100.0,0,0,0,0,2,4,8,1,GK,20-24,Goalkeeper,Switzerland,Europe
1337,Robin Koch,GER,Leeds United,Premier League,2020,24.0,1996.0,12.6,27,16,17,10,0,10,19,52.6,9,18,12,6,27,54,34,2,"DF,MF",20-24,Defender,Germany,Europe
1338,Giorgi Kochorashvili,GEO,Levante,La Liga,2020,21.0,1999.0,0.3,1,0,1,0,0,0,0,,0,0,0,0,0,1,0,0,MF,20-24,Midfielder,Georgia,Asia
1341,Dominik Kohr,GER,Mainz 05,Bundesliga,2020,26.0,1994.0,14.1,47,31,14,26,7,20,39,51.3,19,18,5,13,27,74,15,0,MF,25-29,Midfielder,Germany,Europe
1342,Dominik Kohr,GER,Eint Frankfurt,Bundesliga,2020,26.0,1994.0,2.9,11,7,0,7,4,4,9,44.4,5,5,1,4,9,20,9,0,"MF,DF",25-29,Midfielder,Germany,Europe
1345,Aleksandr Kokorin,RUS,Fiorentina,Serie A,2020,29.0,1991.0,1.0,1,0,0,1,0,0,1,0.0,1,1,0,1,0,1,0,0,"FW,MF",25-29,Forward,Russia,Europe
1349,Randal Kolo Muani,FRA,Nantes,Ligue 1,2020,21.0,1998.0,33.7,22,14,1,13,8,7,27,25.9,20,15,2,13,8,30,26,0,FW,20-24,Forward,France,Europe
1350,Timothée Kolodziejczak,FRA,Saint-Étienne,Ligue 1,2020,28.0,1991.0,22.6,28,15,23,5,0,19,27,70.4,8,24,15,9,36,64,80,1,DF,25-29,Defender,France,Europe
1351,Ghislain Konan,CIV,Reims,Ligue 1,2020,24.0,1995.0,29.0,57,32,35,17,5,32,56,57.1,24,25,11,14,30,87,67,0,DF,20-24,Defender,Ivory Coast,Africa
1352,Ibrahima Konaté,FRA,RB Leipzig,Bundesliga,2020,21.0,1999.0,7.7,6,4,2,3,1,2,8,25.0,6,6,3,3,8,14,24,0,DF,20-24,Defender,France,Europe
1354,Geoffrey Kondogbia,CTA,Valencia,La Liga,2020,27.0,1993.0,4.9,16,9,9,4,3,7,19,36.8,12,6,1,5,8,24,8,0,MF,25-29,Midfielder,Central African Republic,Africa
1355,Geoffrey Kondogbia,CTA,Atlético Madrid,La Liga,2020,27.0,1993.0,6.8,30,20,12,16,2,11,20,55.0,9,11,5,6,11,41,8,1,MF,25-29,Midfielder,Central African Republic,Africa
1356,Lamine Koné,CIV,Strasbourg,Ligue 1,2020,31.0,1989.0,11.6,9,6,5,4,0,5,8,62.5,3,4,3,1,15,24,36,0,DF,30-34,Defender,Ivory Coast,Africa
1360,Ezri Konsa,ENG,Aston Villa,Premier League,2020,22.0,1997.0,35.5,25,13,18,6,1,9,13,69.2,4,53,47,6,29,54,162,1,DF,20-24,Defender,England,Europe
1361,Laurent Koscielny,FRA,Bordeaux,Ligue 1,2020,34.0,1985.0,24.6,29,17,18,11,0,16,24,66.7,8,44,34,10,54,83,115,1,DF,30-34,Defender,France,Europe
1363,Márk Kosznovszky,HUN,Parma,Serie A,2020,18.0,2002.0,1.0,2,2,1,1,0,1,4,25.0,3,2,0,2,1,3,1,0,MF,Under 20,Midfielder,Hungary,Europe
1364,Christian Kouamé,CIV,Fiorentina,Serie A,2020,22.0,1997.0,11.1,9,4,2,4,3,4,12,33.3,8,9,1,8,5,14,4,0,FW,20-24,Forward,Ivory Coast,Africa
1365,Kalidou Koulibaly,SEN,Napoli,Serie A,2020,29.0,1991.0,24.5,36,24,25,7,4,19,32,59.4,13,46,26,20,29,65,64,2,DF,25-29,Defender,Senegal,Africa
1366,Jules Koundé,FRA,Sevilla,La Liga,2020,21.0,1998.0,33.1,27,15,14,11,2,10,24,41.7,14,24,16,8,40,67,104,0,DF,20-24,Defender,France,Europe
1368,Cheikhou Kouyaté,SEN,Crystal Palace,Premier League,2020,30.0,1989.0,34.7,58,37,44,12,2,25,43,58.1,18,42,26,16,32,90,125,2,DF,30-34,Defender,Senegal,Africa
1370,Viktor Kovalenko,UKR,Atalanta,Serie A,2020,24.0,1996.0,0.0,0,0,0,0,0,0,0,,0,0,0,0,0,0,1,0,FW,20-24,Forward,Ukraine,Europe
1371,Emil Krafth,SWE,Newcastle Utd,Premier League,2020,25.0,1994.0,14.3,19,8,9,9,1,12,25,48.0,13,15,9,6,15,34,52,2,DF,25-29,Defender,Sweden,Europe
1373,Christoph Kramer,GER,Gladbach,Bundesliga,2020,29.0,1991.0,22.6,55,37,22,28,5,28,58,48.3,30,32,11,21,34,89,39,0,MF,25-29,Midfielder,Germany,Europe
1374,Jean-Philippe Krasso,CIV,Saint-Étienne,Ligue 1,2020,23.0,1997.0,2.5,5,3,1,4,0,2,4,50.0,2,5,0,5,1,6,3,0,FW,20-24,Forward,Ivory Coast,Africa
1375,Toni Kroos,GER,Real Madrid,La Liga,2020,30.0,1990.0,23.5,42,22,15,15,12,11,44,25.0,33,26,6,20,15,57,10,3,MF,30-34,Midfielder,Germany,Europe
1378,Max Kruse,GER,Union Berlin,Bundesliga,2020,32.0,1988.0,18.1,7,3,1,5,1,2,9,22.2,7,11,0,11,3,10,3,0,"FW,MF",30-34,Forward,Germany,Europe
1379,Lukas Kübler,GER,Freiburg,Bundesliga,2020,27.0,1992.0,9.8,15,8,9,5,1,9,14,64.3,5,9,3,6,21,36,31,0,"DF,MF",25-29,Defender,Germany,Europe
1380,Takefusa Kubo,JPN,Villarreal,La Liga,2020,19.0,2001.0,3.3,1,1,0,0,1,1,5,20.0,4,2,0,2,1,2,2,0,"MF,FW",Under 20,Midfielder,Japan,Asia
1381,Takefusa Kubo,JPN,Getafe,La Liga,2020,19.0,2001.0,8.9,7,4,2,3,2,1,14,7.1,13,14,0,14,14,21,4,0,"MF,FW",Under 20,Midfielder,Japan,Asia
1382,Juraj Kucka,SVK,Parma,Serie A,2020,33.0,1987.0,25.9,67,36,21,37,9,26,74,35.1,48,25,3,22,28,95,25,0,"MF,FW",30-34,Midfielder,Slovakia,Europe
1384,Dejan Kulusevski,SWE,Juventus,Serie A,2020,20.0,2000.0,21.4,33,19,12,10,11,14,43,32.6,29,22,0,22,9,42,2,1,"MF,FW",20-24,Midfielder,Sweden,Europe
1385,Marash Kumbulla,ALB,Roma,Serie A,2020,20.0,2000.0,15.1,16,11,8,7,1,5,17,29.4,12,12,5,7,24,40,38,1,DF,20-24,Defender,Albania,Europe
1387,Fabian Kunze,GER,Arminia,Bundesliga,2020,22.0,1998.0,14.1,38,26,19,15,4,19,42,45.2,23,19,3,16,18,56,22,1,MF,20-24,Midfielder,Germany,Europe
1394,Antonino La Gumina,ITA,Sampdoria,Serie A,2020,24.0,1996.0,3.8,3,2,0,1,2,0,3,0.0,3,5,1,4,3,6,5,0,FW,20-24,Forward,Italy,Europe
1395,Gaëtan Laborde,FRA,Montpellier,Ligue 1,2020,26.0,1994.0,36.2,43,22,21,17,5,16,60,26.7,44,29,3,26,16,59,25,1,"FW,MF",25-29,Forward,France,Europe
1396,Alexandre Lacazette,FRA,Arsenal,Premier League,2020,29.0,1991.0,21.4,18,10,4,11,3,4,22,18.2,18,20,1,19,12,30,13,0,FW,25-29,Forward,France,Europe
1398,Maxence Lacroix,FRA,Wolfsburg,Bundesliga,2020,20.0,2000.0,28.8,49,29,37,12,0,24,45,53.3,21,51,21,30,65,114,140,1,DF,20-24,Defender,France,Europe
1399,Alban Lafont,FRA,Nantes,Ligue 1,2020,21.0,1999.0,38.0,1,0,1,0,0,1,1,100.0,0,1,0,1,0,1,14,0,GK,20-24,Goalkeeper,France,Europe
1401,Konrad Laimer,AUT,RB Leipzig,Bundesliga,2020,23.0,1997.0,0.9,2,0,0,1,1,0,4,0.0,4,2,0,2,1,3,0,0,"DF,MF",20-24,Defender,Austria,Europe
1402,Stefan Lainer,AUT,Gladbach,Bundesliga,2020,27.0,1992.0,30.8,62,37,30,22,10,27,60,45.0,33,34,5,29,35,97,85,1,DF,25-29,Defender,Austria,Europe
1404,Kenny Lala,MAD,Strasbourg,Ligue 1,2020,28.0,1991.0,20.4,22,13,13,8,1,11,22,50.0,11,12,6,6,23,45,33,1,DF,25-29,Defender,Madagascar,Africa
1405,Adam Lallana,ENG,Brighton,Premier League,2020,32.0,1988.0,17.7,28,13,11,13,4,8,39,20.5,31,18,3,15,15,43,13,0,"MF,FW",30-34,Midfielder,England,Europe
1408,Tariq Lamptey,GHA,Brighton,Premier League,2020,19.0,2000.0,9.8,17,9,7,6,4,6,13,46.2,7,8,1,7,19,36,12,1,"DF,MF",Under 20,Defender,Ghana,Africa
1411,Manuel Lanzini,ARG,West Ham,Premier League,2020,27.0,1993.0,6.3,9,2,3,4,2,3,10,30.0,7,9,0,9,7,16,5,0,"MF,FW",25-29,Midfielder,Argentina,South America
1412,Gianluca Lapadula,PER,Benevento,Serie A,2020,30.0,1990.0,28.5,22,12,3,13,6,6,25,24.0,19,18,3,15,5,27,16,0,FW,30-34,Forward,Peru,South America
1414,Julien Laporte,FRA,Lorient,Ligue 1,2020,26.0,1993.0,29.5,65,39,48,16,1,42,74,56.8,32,34,23,11,65,130,125,0,DF,25-29,Defender,France,Europe
1416,Gautier Larsonneur,FRA,Brest,Ligue 1,2020,23.0,1997.0,35.0,1,1,1,0,0,1,1,100.0,0,2,0,2,0,1,16,3,GK,20-24,Goalkeeper,France,Europe
1419,Jamaal Lascelles,ENG,Newcastle Utd,Premier League,2020,26.0,1993.0,18.1,14,7,5,9,0,3,6,50.0,3,27,17,10,12,26,86,0,DF,25-29,Defender,England,Europe
1420,Paul Lasne,FRA,Brest,Ligue 1,2020,31.0,1989.0,18.7,46,26,25,19,2,17,40,42.5,23,25,5,20,47,93,17,2,MF,30-34,Midfielder,France,Europe
1422,Danny Latza,GER,Mainz 05,Bundesliga,2020,30.0,1989.0,20.0,43,26,12,19,12,23,70,32.9,47,39,3,36,27,70,23,0,MF,30-34,Midfielder,Germany,Europe
1424,Vincent Laurini,FRA,Parma,Serie A,2020,31.0,1989.0,9.7,16,11,8,6,2,7,9,77.8,2,8,4,4,17,33,22,1,DF,30-34,Defender,France,Europe
1426,Wesley Lautoa,NCL,Dijon,Ligue 1,2020,32.0,1987.0,17.9,36,20,20,13,3,11,37,29.7,26,17,8,9,29,65,33,1,"MF,DF",30-34,Midfielder,New Caledonia,Oceania
1427,Valentino Lazaro,AUT,Gladbach,Bundesliga,2020,24.0,1996.0,13.8,17,11,7,5,5,12,19,63.2,7,18,1,17,15,32,20,0,"DF,FW",20-24,Defender,Austria,Europe
1429,Manuel Lazzari,ITA,Lazio,Serie A,2020,26.0,1993.0,29.0,24,14,15,4,5,14,39,35.9,25,22,3,19,18,42,28,0,DF,25-29,Defender,Italy,Europe
1430,Jérémy Le Douaron,FRA,Brest,Ligue 1,2020,22.0,1998.0,9.1,15,10,9,4,2,7,21,33.3,14,14,1,13,8,23,11,0,"FW,MF",20-24,Forward,France,Europe
1431,Enzo Le Fée,FRA,Lorient,Ligue 1,2020,20.0,2000.0,20.2,51,28,23,23,5,27,73,37.0,46,30,6,24,25,76,10,0,MF,20-24,Midfielder,France,Europe
1432,Vincent Le Goff,FRA,Lorient,Ligue 1,2020,30.0,1989.0,25.6,42,29,16,24,2,18,49,36.7,31,27,5,22,44,86,44,0,DF,30-34,Defender,France,Europe
1433,Maxime Le Marchand,FRA,Fulham,Premier League,2020,30.0,1989.0,1.4,2,2,2,0,0,2,2,100.0,0,0,0,0,0,2,3,0,DF,30-34,Defender,France,Europe
1437,Rafael Leão,POR,Milan,Serie A,2020,21.0,1999.0,21.4,13,6,4,7,2,6,15,40.0,9,17,0,17,4,17,14,1,FW,20-24,Forward,Portugal,Europe
1438,Jean-Louis Leca,FRA,Lens,Ligue 1,2020,34.0,1985.0,36.8,3,2,3,0,0,3,5,60.0,2,0,0,0,1,4,14,4,GK,30-34,Goalkeeper,France,Europe
1439,Mathew Leckie,AUS,Hertha BSC,Bundesliga,2020,29.0,1991.0,5.6,12,3,5,5,2,4,11,36.4,7,8,0,8,13,25,9,0,"FW,DF",25-29,Forward,Australia,Oceania
1440,Benjamin Lecomte,FRA,Monaco,Ligue 1,2020,29.0,1991.0,28.0,0,0,0,0,0,0,2,0.0,2,1,0,1,2,2,20,1,GK,25-29,Goalkeeper,France,Europe
1442,Pierre Lees-Melou,FRA,Nice,Ligue 1,2020,27.0,1993.0,22.9,67,39,33,31,3,25,83,30.1,58,50,14,36,29,96,31,1,MF,25-29,Midfielder,France,Europe
1443,Lucas Leiva,BRA,Lazio,Serie A,2020,33.0,1987.0,23.7,68,32,38,28,2,30,86,34.9,56,21,0,21,57,125,21,0,MF,30-34,Midfielder,Brazil,South America
1444,Florian Lejeune,FRA,Alavés,La Liga,2020,29.0,1991.0,33.5,43,32,36,7,0,21,35,60.0,14,38,24,14,51,94,149,1,DF,25-29,Defender,France,Europe
1446,Thomas Lemar,FRA,Atlético Madrid,La Liga,2020,24.0,1995.0,15.2,30,17,9,17,4,11,24,45.8,13,22,1,21,11,41,10,0,MF,20-24,Midfielder,France,Europe
1448,Fabien Lemoine,FRA,Lorient,Ligue 1,2020,33.0,1987.0,21.5,74,45,39,33,2,36,89,40.4,53,25,1,24,27,101,35,0,MF,30-34,Midfielder,France,Europe
1449,Clément Lenglet,FRA,Barcelona,La Liga,2020,25.0,1995.0,27.5,36,21,23,10,3,19,28,67.9,9,26,12,14,33,69,71,1,DF,25-29,Defender,France,Europe
1450,Bernd Leno,GER,Arsenal,Premier League,2020,28.0,1992.0,34.8,1,0,1,0,0,1,1,100.0,0,1,0,1,0,1,11,2,GK,25-29,Goalkeeper,Germany,Europe
1451,Christopher Lenz,GER,Union Berlin,Bundesliga,2020,25.0,1994.0,25.0,74,41,39,30,5,35,71,49.3,36,34,5,29,35,109,50,0,"DF,FW",25-29,Defender,Germany,Europe
1455,Mehdi Léris,ALG,Sampdoria,Serie A,2020,22.0,1998.0,4.3,11,5,6,4,1,6,16,37.5,10,12,2,10,12,23,15,0,"DF,MF",20-24,Defender,Algeria,Africa
1457,Karlo Letica,CRO,Sampdoria,Serie A,2020,23.0,1997.0,1.0,0,0,0,0,0,0,0,,0,0,0,0,0,0,2,0,GK,20-24,Goalkeeper,Croatia,Europe
1458,Gaetano Letizia,ITA,Benevento,Serie A,2020,30.0,1990.0,17.4,36,25,19,13,4,17,36,47.2,19,15,3,12,20,56,42,1,DF,30-34,Defender,Italy,Europe
1463,Dimitri Liénard,FRA,Strasbourg,Ligue 1,2020,32.0,1988.0,20.3,39,27,17,19,3,24,55,43.6,31,23,1,22,18,57,10,0,MF,30-34,Midfielder,France,Europe
1464,Philipp Lienhart,AUT,Freiburg,Bundesliga,2020,24.0,1996.0,33.3,21,13,12,7,2,9,20,45.0,11,30,21,9,42,63,100,0,DF,20-24,Defender,Austria,Europe
1465,Matthijs de Ligt,NED,Juventus,Serie A,2020,20.0,1999.0,24.7,37,19,20,16,1,18,28,64.3,10,42,21,21,31,68,64,0,DF,20-24,Defender,Netherlands,Europe
1466,Isaac Lihadji,FRA,Lille,Ligue 1,2020,18.0,2002.0,2.2,11,4,2,6,3,4,5,80.0,1,5,1,4,1,12,0,1,"MF,FW",Under 20,Midfielder,France,Europe
1468,Victor Lindelöf,SWE,Manchester Utd,Premier League,2020,26.0,1994.0,28.7,22,10,12,10,0,12,24,50.0,12,22,14,8,30,52,95,1,DF,25-29,Defender,Sweden,Europe
1470,Jesse Lingard,ENG,West Ham,Premier League,2020,27.0,1992.0,15.8,12,6,4,8,0,5,14,35.7,9,7,1,6,4,16,0,0,"MF,FW",25-29,Midfielder,England,Europe
1473,Jake Livermore,ENG,West Brom,Premier League,2020,30.0,1989.0,13.8,33,18,14,16,3,14,31,45.2,17,21,6,15,16,49,26,0,MF,30-34,Midfielder,England,Europe
1479,Hugo Lloris,FRA,Tottenham,Premier League,2020,33.0,1986.0,38.0,0,0,0,0,0,0,1,0.0,1,0,0,0,0,0,10,1,GK,30-34,Goalkeeper,France,Europe
1480,Giovani Lo Celso,ARG,Tottenham,Premier League,2020,24.0,1996.0,10.5,28,22,12,11,5,10,29,34.5,19,12,1,11,7,35,5,0,MF,20-24,Midfielder,Argentina,South America
1481,Stanislav Lobotka,SVK,Napoli,Serie A,2020,25.0,1994.0,1.7,1,1,0,1,0,0,1,0.0,1,1,1,0,0,1,1,1,MF,25-29,Midfielder,Slovakia,Europe
1482,Manuel Locatelli,ITA,Sassuolo,Serie A,2020,22.0,1998.0,32.0,81,47,43,28,10,29,56,51.8,27,35,15,20,51,132,65,1,MF,20-24,Midfielder,Italy,Europe
1483,Renan Lodi,BRA,Atlético Madrid,La Liga,2020,22.0,1998.0,12.5,30,17,13,12,5,17,26,65.4,9,15,0,15,16,46,18,0,"DF,FW",20-24,Defender,Brazil,South America
1484,Ruben Loftus-Cheek,ENG,Chelsea,Premier League,2020,24.0,1996.0,0.7,0,0,0,0,0,0,0,,0,0,0,0,0,0,0,0,FW,20-24,Forward,England,Europe
1485,Ruben Loftus-Cheek,ENG,Fulham,Premier League,2020,24.0,1996.0,21.2,25,14,7,15,3,7,23,30.4,16,20,2,18,7,32,18,0,"MF,FW",20-24,Midfielder,England,Europe
1487,Kevin Long,IRL,Burnley,Premier League,2020,29.0,1990.0,7.1,11,6,9,2,0,7,9,77.8,2,11,7,4,6,17,24,0,DF,25-29,Defender,Republic of Ireland,Europe
1488,Shane Long,IRL,Southampton,Premier League,2020,33.0,1987.0,2.3,2,1,0,0,2,2,3,66.7,1,0,0,0,3,5,1,0,FW,30-34,Forward,Republic of Ireland,Europe
1490,Sean Longstaff,ENG,Newcastle Utd,Premier League,2020,22.0,1997.0,15.7,31,14,13,15,3,18,42,42.9,24,26,5,21,19,50,14,2,MF,20-24,Midfielder,England,Europe
1491,Ademola Lookman,NGA,Fulham,Premier League,2020,22.0,1997.0,30.5,35,11,18,9,8,13,44,29.5,31,31,1,30,20,55,9,0,"FW,MF",20-24,Forward,Nigeria,Africa
1492,Anthony Lopes,POR,Lyon,Ligue 1,2020,29.0,1990.0,38.0,1,1,1,0,0,1,2,50.0,1,1,0,1,1,2,20,1,GK,25-29,Goalkeeper,Portugal,Europe
1506,Matteo Lovato,ITA,Hellas Verona,Serie A,2020,20.0,2000.0,15.4,21,12,14,5,2,10,21,47.6,11,20,10,10,37,58,48,1,DF,20-24,Defender,Italy,Europe
1507,Max Lowe,ENG,Sheffield Utd,Premier League,2020,23.0,1997.0,6.1,26,11,18,6,2,9,21,42.9,12,12,4,8,5,31,11,0,DF,20-24,Defender,England,Europe
1508,Eduard Löwen,GER,Hertha BSC,Bundesliga,2020,23.0,1997.0,0.9,5,1,3,1,1,2,5,40.0,3,1,0,1,1,6,1,0,"MF,DF",20-24,Midfielder,Germany,Europe
1509,Matthew Lowton,ENG,Burnley,Premier League,2020,31.0,1989.0,34.0,54,32,31,22,1,32,73,43.8,41,36,13,23,56,110,91,1,DF,30-34,Defender,England,Europe
1511,Hirving Lozano,MEX,Napoli,Serie A,2020,25.0,1995.0,21.8,29,18,10,13,6,10,36,27.8,26,37,1,36,18,47,14,0,FW,25-29,Forward,Mexico,North America
1513,Jean Lucas,BRA,Lyon,Ligue 1,2020,22.0,1998.0,1.9,3,2,2,1,0,1,4,25.0,3,3,1,2,2,5,1,0,MF,20-24,Midfielder,Brazil,South America
1514,Jean Lucas,BRA,Brest,Ligue 1,2020,22.0,1998.0,11.2,19,13,10,9,0,8,29,27.6,21,7,0,7,8,27,10,1,"MF,FW",20-24,Midfielder,Brazil,South America
1515,Anderson Lucoqui,ANG,Arminia,Bundesliga,2020,23.0,1997.0,17.8,40,25,23,17,0,20,40,50.0,20,30,7,23,27,67,53,0,DF,20-24,Defender,Angola,Africa
1516,Jeison Lucumí,COL,Elche,La Liga,2020,25.0,1995.0,0.5,1,1,0,1,0,0,0,,0,1,0,1,0,1,0,0,MF,25-29,Midfielder,Colombia,South America
1521,José Luis Palomino,ARG,Atalanta,Serie A,2020,30.0,1990.0,27.0,67,33,41,19,7,24,48,50.0,24,30,16,14,79,146,60,2,DF,30-34,Defender,Argentina,South America
1524,David Luiz,BRA,Arsenal,Premier League,2020,33.0,1987.0,15.5,12,9,5,7,0,4,4,100.0,0,16,9,7,16,28,50,2,DF,30-34,Defender,Brazil,South America
1525,Douglas Luiz,BRA,Aston Villa,Premier League,2020,22.0,1998.0,30.9,49,18,22,26,1,20,58,34.5,38,52,17,35,43,92,44,2,MF,20-24,Midfielder,Brazil,South America
1526,Romelu Lukaku,BEL,Inter,Serie A,2020,27.0,1993.0,32.0,11,1,1,6,4,6,14,42.9,8,11,1,10,3,14,34,0,FW,25-29,Forward,Belgium,Europe
1531,Sebastiano Luperto,ITA,Crotone,Serie A,2020,23.0,1996.0,20.9,38,20,28,8,2,16,27,59.3,11,17,7,10,27,65,74,1,DF,20-24,Defender,Italy,Europe
1532,Andreas Luthe,GER,Union Berlin,Bundesliga,2020,33.0,1987.0,30.8,1,1,1,0,0,1,3,33.3,2,1,0,1,0,1,8,3,GK,30-34,Goalkeeper,Germany,Europe
1533,Lyanco,BRA,Torino,Serie A,2020,23.0,1997.0,21.8,21,14,13,6,2,8,14,57.1,6,36,26,10,46,67,76,0,DF,20-24,Defender,Brazil,South America
1536,Alexis Mac Allister,ARG,Brighton,Premier League,2020,21.0,1998.0,12.4,26,12,6,16,4,11,38,28.9,27,25,4,21,9,35,4,0,"MF,FW",20-24,Midfielder,Argentina,South America
1537,Darwin Machís,VEN,Granada,La Liga,2020,27.0,1993.0,22.5,30,17,12,10,8,6,19,31.6,13,21,2,19,22,52,13,0,"FW,MF",25-29,Forward,Venezuela,South America
1538,Tim Maciejewski,GER,Union Berlin,Bundesliga,2020,19.0,2001.0,0.1,0,0,0,0,0,0,0,,0,0,0,0,0,0,0,0,FW,Under 20,Forward,Germany,Europe
1541,James Maddison,ENG,Leicester City,Premier League,2020,23.0,1996.0,23.3,32,16,5,16,11,14,41,34.1,27,14,1,13,9,41,5,0,MF,20-24,Midfielder,England,Europe
1544,Gabriel Magalhães,BRA,Arsenal,Premier League,2020,22.0,1997.0,22.2,25,15,19,5,1,13,19,68.4,6,27,19,8,26,51,74,2,DF,20-24,Defender,Brazil,South America
1545,Lisandro Magallán,ARG,Crotone,Serie A,2020,26.0,1993.0,24.2,54,31,28,24,2,17,42,40.5,25,29,15,14,44,98,78,1,DF,25-29,Defender,Argentina,South America
1546,Christian Maggio,ITA,Benevento,Serie A,2020,38.0,1982.0,3.3,9,4,2,7,0,3,9,33.3,6,4,1,3,2,11,6,0,DF,35-39,Defender,Italy,Europe
1547,Giulio Maggiore,ITA,Spezia,Serie A,2020,22.0,1998.0,24.6,61,36,26,28,7,21,53,39.6,32,33,6,27,19,80,25,1,MF,20-24,Midfielder,Italy,Europe
1548,Francesco Magnanelli,ITA,Sassuolo,Serie A,2020,35.0,1984.0,4.9,7,5,2,5,0,3,10,30.0,7,6,2,4,13,20,10,0,MF,35-39,Midfielder,Italy,Europe
1549,Giangiacomo Magnani,ITA,Hellas Verona,Serie A,2020,24.0,1995.0,16.8,26,15,14,9,3,9,16,56.3,7,25,16,9,44,70,105,1,DF,20-24,Defender,Italy,Europe
1550,Hugo Magnetti,FRA,Brest,Ligue 1,2020,22.0,1998.0,6.7,24,12,10,13,1,20,40,50.0,20,6,1,5,14,38,8,0,MF,20-24,Midfielder,France,Europe
1551,Harry Maguire,ENG,Manchester Utd,Premier League,2020,27.0,1993.0,33.9,29,17,19,10,0,18,29,62.1,11,28,23,5,60,89,122,4,DF,25-29,Defender,England,Europe
1552,Abdallahi Mahmoud,MTN,Alavés,La Liga,2020,20.0,2000.0,0.7,2,2,1,1,0,0,1,0.0,1,0,0,0,1,3,0,0,MF,20-24,Midfielder,Mauritania,Africa
1554,Riyad Mahrez,ALG,Manchester City,Premier League,2020,29.0,1991.0,21.7,20,5,2,10,8,6,30,20.0,24,19,0,19,8,28,4,0,FW,25-29,Forward,Algeria,Africa
1555,Arne Maier,GER,Arminia,Bundesliga,2020,21.0,1999.0,11.5,13,9,5,7,1,4,11,36.4,7,10,3,7,8,21,11,1,MF,20-24,Midfielder,Germany,Europe
1556,Arne Maier,GER,Hertha BSC,Bundesliga,2020,21.0,1999.0,0.3,1,1,0,1,0,0,1,0.0,1,0,0,0,0,1,0,0,MF,20-24,Midfielder,Germany,Europe
1557,Habib Maïga,CIV,Metz,Ligue 1,2020,24.0,1996.0,29.9,81,52,36,40,5,42,85,49.4,43,37,6,31,49,130,36,0,MF,20-24,Midfielder,Ivory Coast,Africa
1558,Mike Maignan,FRA,Lille,Ligue 1,2020,25.0,1995.0,38.0,0,0,0,0,0,0,0,,0,0,0,0,0,0,7,2,GK,25-29,Goalkeeper,France,Europe
1559,Ainsley Maitland-Niles,ENG,Arsenal,Premier League,2020,22.0,1997.0,5.4,11,7,6,5,0,8,12,66.7,4,12,2,10,14,25,7,1,"MF,DF",20-24,Midfielder,England,Europe
1560,Ainsley Maitland-Niles,ENG,West Brom,Premier League,2020,22.0,1997.0,13.7,22,10,7,8,7,9,28,32.1,19,12,1,11,17,39,24,0,MF,20-24,Midfielder,England,Europe
1561,Josh Maja,NGA,Fulham,Premier League,2020,21.0,1998.0,9.0,7,4,0,3,4,4,10,40.0,6,3,1,2,4,11,1,0,FW,20-24,Forward,Nigeria,Africa
1562,Josh Maja,NGA,Bordeaux,Ligue 1,2020,21.0,1998.0,8.9,8,2,3,3,2,3,14,21.4,11,3,0,3,6,14,9,0,FW,20-24,Forward,Nigeria,Africa
1566,Jean-Victor Makengo,FRA,Udinese,Serie A,2020,22.0,1998.0,5.8,8,7,5,3,0,3,13,23.1,10,7,1,6,5,13,7,0,MF,20-24,Midfielder,France,Europe
1572,Daniel Maldini,ITA,Milan,Serie A,2020,18.0,2001.0,0.3,1,0,0,1,0,0,2,0.0,2,0,0,0,0,1,0,0,"FW,DF",Under 20,Forward,Italy,Europe
1573,Ruslan Malinovskyi,UKR,Atalanta,Serie A,2020,27.0,1993.0,20.8,19,8,2,13,4,8,23,34.8,15,16,1,15,2,21,4,0,"MF,FW",25-29,Midfielder,Ukraine,Europe
1577,Dennis Man,ROU,Parma,Serie A,2020,21.0,1998.0,7.8,12,6,6,4,2,6,21,28.6,15,5,0,5,2,14,6,0,"FW,MF",20-24,Forward,Romania,Europe
1579,Vincent Manceau,FRA,Angers,Ligue 1,2020,31.0,1989.0,25.7,42,27,23,17,2,30,63,47.6,33,23,2,21,35,77,61,0,DF,30-34,Defender,France,Europe
1580,Gianluca Mancini,ITA,Roma,Serie A,2020,24.0,1996.0,31.7,50,29,29,19,2,18,31,58.1,13,38,18,20,72,122,77,3,DF,20-24,Defender,Italy,Europe
1581,Steve Mandanda,FRA,Marseille,Ligue 1,2020,35.0,1985.0,37.0,0,0,0,0,0,0,1,0.0,1,0,0,0,2,2,8,6,GK,35-39,Goalkeeper,France,Europe
1582,Reinildo Mandava,MOZ,Lille,Ligue 1,2020,26.0,1994.0,24.2,79,43,39,32,8,35,58,60.3,23,26,3,23,45,124,53,0,DF,25-29,Defender,Mozambique,Africa
1583,Aïssa Mandi,ALG,Betis,La Liga,2020,28.0,1991.0,26.6,30,17,20,10,0,10,16,62.5,6,21,13,8,39,69,90,0,DF,25-29,Defender,Algeria,Africa
1584,Rolando Mandragora,ITA,Udinese,Serie A,2020,23.0,1997.0,4.4,8,5,3,4,1,3,10,30.0,7,10,3,7,6,14,5,0,MF,20-24,Midfielder,Italy,Europe
1585,Rolando Mandragora,ITA,Torino,Serie A,2020,23.0,1997.0,16.9,19,4,4,9,6,7,30,23.3,23,19,6,13,20,39,19,0,MF,20-24,Midfielder,Italy,Europe
1587,Sadio Mané,SEN,Liverpool,Premier League,2020,28.0,1992.0,31.2,48,30,6,22,20,12,33,36.4,21,30,0,30,15,63,11,0,FW,25-29,Forward,Senegal,Africa
1590,Orel Mangala,BEL,Stuttgart,Bundesliga,2020,22.0,1998.0,23.4,27,15,13,11,3,17,28,60.7,11,27,10,17,26,53,30,0,MF,20-24,Midfielder,Belgium,Europe
1591,Thomas Mangani,FRA,Angers,Ligue 1,2020,33.0,1987.0,29.9,54,37,25,26,3,30,90,33.3,60,31,8,23,38,92,39,0,MF,30-34,Midfielder,France,Europe
1592,Vito Mannone,ITA,Monaco,Ligue 1,2020,32.0,1988.0,9.0,0,0,0,0,0,0,0,,0,0,0,0,0,0,3,1,GK,30-34,Goalkeeper,Italy,Europe
1597,Faitout Maouassa,FRA,Rennes,Ligue 1,2020,22.0,1998.0,13.0,20,11,10,8,2,11,19,57.9,8,9,1,8,17,37,36,0,DF,20-24,Defender,France,Europe
1601,Marcelo,BRA,Real Madrid,La Liga,2020,32.0,1988.0,11.7,25,21,11,6,8,11,24,45.8,13,13,1,12,10,35,15,0,"DF,MF",30-34,Defender,Brazil,South America
1601,Marcelo,BRA,Real Madrid,La Liga,2020,32.0,1988.0,11.7,25,21,11,6,8,11,24,45.8,13,13,1,12,10,35,15,0,"DF,MF",30-34,Defender,Brazil,South America
1601,Marcelo,BRA,Real Madrid,La Liga,2020,32.0,1988.0,11.7,25,21,11,6,8,11,24,45.8,13,13,1,12,10,35,15,0,"DF,MF",30-34,Defender,Brazil,South America
1601,Marcelo,BRA,Real Madrid,La Liga,2020,32.0,1988.0,11.7,25,21,11,6,8,11,24,45.8,13,13,1,12,10,35,15,0,"DF,MF",30-34,Defender,Brazil,South America
1601,Marcelo,BRA,Real Madrid,La Liga,2020,32.0,1988.0,11.7,25,21,11,6,8,11,24,45.8,13,13,1,12,10,35,15,0,"DF,MF",30-34,Defender,Brazil,South America
1601,Marcelo,BRA,Real Madrid,La Liga,2020,32.0,1988.0,11.7,25,21,11,6,8,11,24,45.8,13,13,1,12,10,35,15,0,"DF,MF",30-34,Defender,Brazil,South America
1601,Marcelo,BRA,Real Madrid,La Liga,2020,32.0,1988.0,11.7,25,21,11,6,8,11,24,45.8,13,13,1,12,10,35,15,0,"DF,MF",30-34,Defender,Brazil,South America
1601,Marcelo,BRA,Real Madrid,La Liga,2020,32.0,1988.0,11.7,25,21,11,6,8,11,24,45.8,13,13,1,12,10,35,15,0,"DF,MF",30-34,Defender,Brazil,South America
1601,Marcelo,BRA,Real Madrid,La Liga,2020,32.0,1988.0,11.7,25,21,11,6,8,11,24,45.8,13,13,1,12,10,35,15,0,"DF,MF",30-34,Defender,Brazil,South America
1602,Marcelo,BRA,Lyon,Ligue 1,2020,33.0,1987.0,32.3,44,29,30,12,2,26,37,70.3,11,35,25,10,49,93,122,2,DF,30-34,Defender,Brazil,South America
1602,Marcelo,BRA,Lyon,Ligue 1,2020,33.0,1987.0,32.3,44,29,30,12,2,26,37,70.3,11,35,25,10,49,93,122,2,DF,30-34,Defender,Brazil,South America
1602,Marcelo,BRA,Lyon,Ligue 1,2020,33.0,1987.0,32.3,44,29,30,12,2,26,37,70.3,11,35,25,10,49,93,122,2,DF,30-34,Defender,Brazil,South America
1602,Marcelo,BRA,Lyon,Ligue 1,2020,33.0,1987.0,32.3,44,29,30,12,2,26,37,70.3,11,35,25,10,49,93,122,2,DF,30-34,Defender,Brazil,South America
1602,Marcelo,BRA,Lyon,Ligue 1,2020,33.0,1987.0,32.3,44,29,30,12,2,26,37,70.3,11,35,25,10,49,93,122,2,DF,30-34,Defender,Brazil,South America
1602,Marcelo,BRA,Lyon,Ligue 1,2020,33.0,1987.0,32.3,44,29,30,12,2,26,37,70.3,11,35,25,10,49,93,122,2,DF,30-34,Defender,Brazil,South America
1602,Marcelo,BRA,Lyon,Ligue 1,2020,33.0,1987.0,32.3,44,29,30,12,2,26,37,70.3,11,35,25,10,49,93,122,2,DF,30-34,Defender,Brazil,South America
1602,Marcelo,BRA,Lyon,Ligue 1,2020,33.0,1987.0,32.3,44,29,30,12,2,26,37,70.3,11,35,25,10,49,93,122,2,DF,30-34,Defender,Brazil,South America
1602,Marcelo,BRA,Lyon,Ligue 1,2020,33.0,1987.0,32.3,44,29,30,12,2,26,37,70.3,11,35,25,10,49,93,122,2,DF,30-34,Defender,Brazil,South America
1603,Solly March,ENG,Brighton,Premier League,2020,26.0,1994.0,18.6,49,23,24,15,10,18,34,52.9,16,30,5,25,22,71,30,0,"DF,MF",25-29,Defender,England,Europe
1604,Federico Marchetti,ITA,Genoa,Serie A,2020,37.0,1983.0,3.7,1,0,1,0,0,1,1,100.0,0,0,0,0,0,1,2,1,GK,35-39,Goalkeeper,Italy,Europe
1605,Riccardo Marchizza,ITA,Spezia,Serie A,2020,22.0,1998.0,17.3,20,11,12,5,3,12,21,57.1,9,13,4,9,11,31,27,0,DF,20-24,Defender,Italy,Europe
1606,Gian Marco Ferrari,ITA,Sassuolo,Serie A,2020,28.0,1992.0,33.5,32,20,15,14,3,10,23,43.5,13,46,37,9,50,82,100,1,DF,25-29,Defender,Italy,Europe
1607,Iván Marcone,ARG,Elche,La Liga,2020,30.0,1990.0,29.4,64,41,42,17,5,35,84,41.7,49,27,8,19,36,100,33,3,MF,30-34,Midfielder,Argentina,South America
1609,Dario Maresic,AUT,Reims,Ligue 1,2020,20.0,1999.0,5.7,12,7,8,4,0,8,14,57.1,6,7,2,5,10,22,17,1,DF,20-24,Defender,Austria,Europe
1612,José María Giménez,URU,Atlético Madrid,La Liga,2020,25.0,1995.0,19.6,20,7,14,5,1,12,17,70.6,5,17,11,6,21,41,65,0,DF,25-29,Defender,Uruguay,South America
1614,Jordan Marié,FRA,Dijon,Ligue 1,2020,28.0,1991.0,15.9,34,17,9,23,2,23,56,41.1,33,14,5,9,23,57,12,2,MF,25-29,Midfielder,France,Europe
1617,Răzvan Marin,ROU,Cagliari,Serie A,2020,24.0,1996.0,32.9,54,33,26,22,6,27,53,50.9,26,29,10,19,29,83,15,0,MF,20-24,Midfielder,Romania,Europe
1618,Guillermo Maripán,CHI,Monaco,Ligue 1,2020,26.0,1994.0,23.2,26,11,17,9,0,15,27,55.6,12,18,11,7,27,53,66,1,DF,25-29,Defender,Chile,South America
1619,Marlon,BRA,Sassuolo,Serie A,2020,24.0,1995.0,19.4,19,13,13,6,0,13,18,72.2,5,23,17,6,27,46,44,2,DF,20-24,Defender,Brazil,South America
1619,Marlon,BRA,Sassuolo,Serie A,2020,24.0,1995.0,19.4,19,13,13,6,0,13,18,72.2,5,23,17,6,27,46,44,2,DF,20-24,Defender,Brazil,South America
1619,Marlon,BRA,Sassuolo,Serie A,2020,24.0,1995.0,19.4,19,13,13,6,0,13,18,72.2,5,23,17,6,27,46,44,2,DF,20-24,Defender,Brazil,South America
1619,Marlon,BRA,Sassuolo,Serie A,2020,24.0,1995.0,19.4,19,13,13,6,0,13,18,72.2,5,23,17,6,27,46,44,2,DF,20-24,Defender,Brazil,South America
1619,Marlon,BRA,Sassuolo,Serie A,2020,24.0,1995.0,19.4,19,13,13,6,0,13,18,72.2,5,23,17,6,27,46,44,2,DF,20-24,Defender,Brazil,South America
1619,Marlon,BRA,Sassuolo,Serie A,2020,24.0,1995.0,19.4,19,13,13,6,0,13,18,72.2,5,23,17,6,27,46,44,2,DF,20-24,Defender,Brazil,South America
1619,Marlon,BRA,Sassuolo,Serie A,2020,24.0,1995.0,19.4,19,13,13,6,0,13,18,72.2,5,23,17,6,27,46,44,2,DF,20-24,Defender,Brazil,South America
1619,Marlon,BRA,Sassuolo,Serie A,2020,24.0,1995.0,19.4,19,13,13,6,0,13,18,72.2,5,23,17,6,27,46,44,2,DF,20-24,Defender,Brazil,South America
1619,Marlon,BRA,Sassuolo,Serie A,2020,24.0,1995.0,19.4,19,13,13,6,0,13,18,72.2,5,23,17,6,27,46,44,2,DF,20-24,Defender,Brazil,South America
1620,Omar Marmoush,EGY,Wolfsburg,Bundesliga,2020,21.0,1999.0,0.0,0,0,0,0,0,0,0,,0,0,0,0,0,0,0,0,FW,20-24,Forward,Egypt,Africa
1621,Marquinhos,BRA,Paris S-G,Ligue 1,2020,26.0,1994.0,23.6,27,21,14,10,3,15,26,57.7,11,21,9,12,27,54,75,2,DF,25-29,Defender,Brazil,South America
1621,Marquinhos,BRA,Paris S-G,Ligue 1,2020,26.0,1994.0,23.6,27,21,14,10,3,15,26,57.7,11,21,9,12,27,54,75,2,DF,25-29,Defender,Brazil,South America
1621,Marquinhos,BRA,Paris S-G,Ligue 1,2020,26.0,1994.0,23.6,27,21,14,10,3,15,26,57.7,11,21,9,12,27,54,75,2,DF,25-29,Defender,Brazil,South America
1621,Marquinhos,BRA,Paris S-G,Ligue 1,2020,26.0,1994.0,23.6,27,21,14,10,3,15,26,57.7,11,21,9,12,27,54,75,2,DF,25-29,Defender,Brazil,South America
1621,Marquinhos,BRA,Paris S-G,Ligue 1,2020,26.0,1994.0,23.6,27,21,14,10,3,15,26,57.7,11,21,9,12,27,54,75,2,DF,25-29,Defender,Brazil,South America
1621,Marquinhos,BRA,Paris S-G,Ligue 1,2020,26.0,1994.0,23.6,27,21,14,10,3,15,26,57.7,11,21,9,12,27,54,75,2,DF,25-29,Defender,Brazil,South America
1621,Marquinhos,BRA,Paris S-G,Ligue 1,2020,26.0,1994.0,23.6,27,21,14,10,3,15,26,57.7,11,21,9,12,27,54,75,2,DF,25-29,Defender,Brazil,South America
1621,Marquinhos,BRA,Paris S-G,Ligue 1,2020,26.0,1994.0,23.6,27,21,14,10,3,15,26,57.7,11,21,9,12,27,54,75,2,DF,25-29,Defender,Brazil,South America
1621,Marquinhos,BRA,Paris S-G,Ligue 1,2020,26.0,1994.0,23.6,27,21,14,10,3,15,26,57.7,11,21,9,12,27,54,75,2,DF,25-29,Defender,Brazil,South America
1622,Luca Marrone,ITA,Crotone,Serie A,2020,30.0,1990.0,17.6,25,18,16,9,0,13,21,61.9,8,22,11,11,26,51,56,1,DF,30-34,Defender,Italy,Europe
1628,Jonas Martin,FRA,Rennes,Ligue 1,2020,30.0,1990.0,5.4,11,9,5,4,2,5,14,35.7,9,11,2,9,13,24,2,1,MF,30-34,Midfielder,France,Europe
1629,Gabriel Martinelli,BRA,Arsenal,Premier League,2020,19.0,2001.0,6.5,7,1,2,3,2,4,10,40.0,6,6,0,6,8,15,4,0,FW,Under 20,Forward,Brazil,South America
1630,Emiliano Martínez,ARG,Aston Villa,Premier League,2020,27.0,1992.0,38.0,3,3,3,0,0,3,4,75.0,1,0,0,0,2,5,10,2,GK,25-29,Goalkeeper,Argentina,South America
1630,Emiliano Martínez,ARG,Aston Villa,Premier League,2020,27.0,1992.0,38.0,3,3,3,0,0,3,4,75.0,1,0,0,0,2,5,10,2,GK,25-29,Goalkeeper,Argentina,South America
1630,Emiliano Martínez,ARG,Aston Villa,Premier League,2020,27.0,1992.0,38.0,3,3,3,0,0,3,4,75.0,1,0,0,0,2,5,10,2,GK,25-29,Goalkeeper,Argentina,South America
1630,Emiliano Martínez,ARG,Aston Villa,Premier League,2020,27.0,1992.0,38.0,3,3,3,0,0,3,4,75.0,1,0,0,0,2,5,10,2,GK,25-29,Goalkeeper,Argentina,South America
1635,Lautaro Martínez,ARG,Inter,Serie A,2020,22.0,1997.0,28.5,25,12,5,11,9,7,24,29.2,17,31,1,30,27,52,16,0,FW,20-24,Forward,Argentina,South America
1637,Lucas Martínez Quarta,ARG,Fiorentina,Serie A,2020,24.0,1996.0,16.5,32,20,17,11,4,18,41,43.9,23,27,9,18,39,71,48,0,DF,20-24,Defender,Argentina,South America
1640,Sylvain Marveaux,FRA,Lorient,Ligue 1,2020,34.0,1986.0,2.2,6,3,1,4,1,3,3,100.0,0,2,0,2,1,7,2,0,"MF,FW",30-34,Midfielder,France,Europe
1642,Omar Mascarell,EQG,Schalke 04,Bundesliga,2020,27.0,1993.0,19.6,41,24,15,19,7,21,54,38.9,33,40,14,26,37,78,32,1,MF,25-29,Midfielder,Equatorial Guinea,Africa
1643,Andrea Masiello,ITA,Genoa,Serie A,2020,34.0,1986.0,28.5,38,22,29,6,3,23,48,47.9,25,32,13,19,53,91,107,3,DF,30-34,Defender,Italy,Europe
1645,Roberto Massimo,GER,Stuttgart,Bundesliga,2020,19.0,2000.0,8.4,21,11,13,5,3,11,24,45.8,13,5,1,4,11,32,13,0,"DF,FW",Under 20,Defender,Germany,Europe
1646,Giuseppe Mastinu,ITA,Spezia,Serie A,2020,28.0,1991.0,0.4,1,1,0,0,1,1,1,100.0,0,1,0,1,0,1,0,0,FW,25-29,Forward,Italy,Europe
1651,Eliot Matazo,BEL,Monaco,Ligue 1,2020,18.0,2002.0,3.5,11,5,6,5,0,3,7,42.9,4,1,0,1,1,12,2,0,MF,Under 20,Midfielder,Belgium,Europe
1652,Jean-Philippe Mateta,FRA,Crystal Palace,Premier League,2020,23.0,1997.0,2.5,1,1,0,1,0,1,3,33.3,2,1,0,1,0,1,2,0,FW,20-24,Forward,France,Europe
1653,Jean-Philippe Mateta,FRA,Mainz 05,Bundesliga,2020,23.0,1997.0,11.1,6,3,1,3,2,0,3,0.0,3,3,1,2,4,10,6,0,FW,20-24,Forward,France,Europe
1657,Ryder Matos,BRA,Udinese,Serie A,2020,27.0,1993.0,0.1,0,0,0,0,0,0,0,,0,0,0,0,0,0,0,0,MF,25-29,Midfielder,Brazil,South America
1658,Henning Matriciani,GER,Schalke 04,Bundesliga,2020,20.0,2000.0,0.3,1,1,1,0,0,1,1,100.0,0,1,0,1,0,1,1,0,DF,20-24,Defender,Germany,Europe
1659,Chrislain Matsima,FRA,Monaco,Ligue 1,2020,18.0,2002.0,3.9,5,4,3,2,0,4,7,57.1,3,3,0,3,4,9,12,0,"DF,FW",Under 20,Defender,France,Europe
1661,Neal Maupay,FRA,Brighton,Premier League,2020,23.0,1996.0,27.9,20,8,9,7,4,4,24,16.7,20,20,0,20,13,33,6,0,"FW,MF",20-24,Forward,France,Europe
1662,Tony Mauricio,FRA,Lens,Ligue 1,2020,26.0,1994.0,5.6,19,12,7,8,4,11,17,64.7,6,8,1,7,3,22,4,0,MF,25-29,Midfielder,France,Europe
1663,Stephy Mavididi,ENG,Montpellier,Ligue 1,2020,22.0,1998.0,22.6,18,5,7,10,1,8,23,34.8,15,12,0,12,14,32,6,0,"FW,MF",20-24,Forward,England,Europe
1664,Konstantinos Mavropanos,GRE,Stuttgart,Bundesliga,2020,22.0,1997.0,16.3,42,29,29,12,1,27,46,58.7,19,25,10,15,59,101,66,1,DF,20-24,Defender,Greece,Europe
1669,Antonio Mazzotta,ITA,Crotone,Serie A,2020,30.0,1989.0,0.6,1,1,0,1,0,0,0,,0,0,0,0,0,1,1,0,DF,30-34,Defender,Italy,Europe
1671,Kylian Mbappé,FRA,Paris S-G,Ligue 1,2020,21.0,1998.0,26.4,4,2,0,1,3,2,9,22.2,7,7,1,6,3,7,4,1,FW,20-24,Forward,France,Europe
1672,Ibrahima Mbaye,SEN,Bologna,Serie A,2020,25.0,1994.0,4.8,6,5,5,1,0,3,5,60.0,2,5,3,2,1,7,10,0,DF,25-29,Defender,Senegal,Africa
1675,James McArthur,SCO,Crystal Palace,Premier League,2020,32.0,1987.0,16.3,57,32,25,27,5,15,39,38.5,24,28,3,25,23,80,31,0,MF,30-34,Midfielder,Scotland,Europe
1677,Alex McCarthy,ENG,Southampton,Premier League,2020,30.0,1989.0,30.0,1,0,1,0,0,1,4,25.0,3,0,0,0,0,1,11,1,GK,30-34,Goalkeeper,England,Europe
1679,John McGinn,SCO,Aston Villa,Premier League,2020,25.0,1994.0,37.0,61,37,23,31,7,27,84,32.1,57,38,6,32,43,104,23,2,MF,25-29,Midfielder,Scotland,Europe
1680,David McGoldrick,IRL,Sheffield Utd,Premier League,2020,32.0,1987.0,26.6,33,21,8,15,10,13,31,41.9,18,19,3,16,2,35,25,0,"FW,MF",30-34,Forward,Republic of Ireland,Europe
1681,Weston McKennie,USA,Juventus,Serie A,2020,21.0,1998.0,18.9,34,19,9,20,5,12,33,36.4,21,21,3,18,28,62,26,0,MF,20-24,Midfielder,United States,North America
1682,Dwight McNeil,ENG,Burnley,Premier League,2020,20.0,1999.0,34.1,47,24,24,18,5,18,56,32.1,38,44,6,38,32,79,32,1,MF,20-24,Midfielder,England,Europe
1683,Scott McTominay,SCO,Manchester Utd,Premier League,2020,23.0,1996.0,23.7,51,24,23,25,3,23,36,63.9,13,35,10,25,29,80,46,0,MF,20-24,Midfielder,Scotland,Europe
1684,Gary Medel,CHI,Bologna,Serie A,2020,32.0,1987.0,5.7,12,9,6,5,1,4,10,40.0,6,8,6,2,7,19,10,0,"DF,MF",30-34,Defender,Chile,South America
1685,Facundo Medina,ARG,Lens,Ligue 1,2020,21.0,1999.0,22.3,39,22,22,15,2,24,38,63.2,14,25,9,16,39,78,51,3,DF,20-24,Defender,Argentina,South America
1686,Nathan de Medina,BEL,Arminia,Bundesliga,2020,22.0,1997.0,7.1,16,10,9,6,1,3,10,30.0,7,12,2,10,11,27,22,0,DF,20-24,Defender,Belgium,Europe
1687,Ben Mee,ENG,Burnley,Premier League,2020,30.0,1989.0,29.9,32,15,16,14,2,14,29,48.3,15,54,45,9,43,75,148,2,DF,30-34,Defender,England,Europe
1688,Joshua Mees,GER,Union Berlin,Bundesliga,2020,24.0,1996.0,0.1,0,0,0,0,0,0,0,,0,0,0,0,0,0,0,0,FW,20-24,Forward,Germany,Europe
1693,Farid El Melali,ALG,Angers,Ligue 1,2020,23.0,1997.0,4.6,9,5,5,4,0,2,13,15.4,11,12,0,12,6,15,2,0,"FW,MF",20-24,Forward,Algeria,Africa
1694,Filippo Melegoni,ITA,Genoa,Serie A,2020,21.0,1999.0,4.3,7,6,2,5,0,3,6,50.0,3,5,0,5,5,12,8,0,"MF,DF",20-24,Midfielder,Italy,Europe
1697,Arthur Melo,BRA,Juventus,Serie A,2020,23.0,1996.0,12.9,17,9,7,10,0,12,31,38.7,19,6,1,5,18,35,9,1,MF,20-24,Midfielder,Brazil,South America
1699,Houboulang Mendes,GNB,Lorient,Ligue 1,2020,22.0,1998.0,14.4,28,19,19,5,4,16,28,57.1,12,14,2,12,14,42,35,0,DF,20-24,Defender,Guinea-Bissau,Africa
1701,Thiago Mendes,BRA,Lyon,Ligue 1,2020,28.0,1992.0,24.9,37,22,13,20,4,18,38,47.4,20,33,7,26,39,76,21,2,MF,25-29,Midfielder,Brazil,South America
1706,Benjamin Mendy,FRA,Manchester City,Premier League,2020,26.0,1994.0,10.6,13,9,1,8,4,5,21,23.8,16,12,5,7,5,18,14,1,DF,25-29,Defender,France,Europe
1707,Edouard Mendy,SEN,Chelsea,Premier League,2020,28.0,1992.0,30.5,0,0,0,0,0,0,1,0.0,1,0,0,0,1,1,9,3,GK,25-29,Goalkeeper,Senegal,Africa
1708,Edouard Mendy,SEN,Rennes,Ligue 1,2020,28.0,1992.0,1.0,0,0,0,0,0,0,0,,0,0,0,0,0,0,0,0,GK,25-29,Goalkeeper,Senegal,Africa
1709,Ferland Mendy,FRA,Real Madrid,La Liga,2020,25.0,1995.0,24.5,26,16,17,6,3,12,24,50.0,12,16,4,12,26,52,32,1,DF,25-29,Defender,France,Europe
1710,Nampalys Mendy,SEN,Leicester City,Premier League,2020,28.0,1992.0,16.2,26,17,18,6,2,7,20,35.0,13,12,1,11,14,40,8,0,MF,25-29,Midfielder,Senegal,Africa
1714,Alex Meret,ITA,Napoli,Serie A,2020,23.0,1997.0,22.0,0,0,0,0,0,0,1,0.0,1,0,0,0,0,0,5,0,GK,20-24,Goalkeeper,Italy,Europe
1720,Illan Meslier,FRA,Leeds United,Premier League,2020,20.0,2000.0,35.0,0,0,0,0,0,0,1,0.0,1,0,0,0,0,0,17,8,GK,20-24,Goalkeeper,France,Europe
1721,Lionel Messi,ARG,Barcelona,La Liga,2020,33.0,1987.0,33.6,18,10,3,9,6,6,17,35.3,11,12,0,12,6,24,0,2,"FW,MF",30-34,Forward,Argentina,South America
1722,Junior Messias,BRA,Crotone,Serie A,2020,29.0,1991.0,35.7,60,35,26,24,10,22,70,31.4,48,32,12,20,35,95,40,0,"MF,FW",25-29,Midfielder,Brazil,South America
1723,Thomas Meunier,BEL,Dortmund,Bundesliga,2020,28.0,1991.0,16.4,30,21,19,6,5,20,29,69.0,9,16,6,10,18,48,29,2,DF,25-29,Defender,Belgium,Europe
1728,Jonas Michelbrink,GER,Hertha BSC,Bundesliga,2020,19.0,2001.0,0.4,0,0,0,0,0,0,0,,0,0,0,0,0,0,0,0,MF,Under 20,Midfielder,Germany,Europe
1738,Éder Militão,BRA,Real Madrid,La Liga,2020,22.0,1998.0,12.6,20,8,13,6,1,8,14,57.1,6,19,6,13,19,39,42,0,DF,20-24,Defender,Brazil,South America
1743,Vincenzo Millico,ITA,Torino,Serie A,2020,19.0,2000.0,0.2,0,0,0,0,0,0,0,,0,0,0,0,0,0,0,0,"FW,MF",Under 20,Forward,Italy,Europe
1744,Enzo Millot,FRA,Monaco,Ligue 1,2020,18.0,2002.0,0.5,2,0,0,1,1,1,1,100.0,0,0,0,0,2,4,0,0,MF,Under 20,Midfielder,France,Europe
1745,James Milner,ENG,Liverpool,Premier League,2020,34.0,1986.0,11.9,26,19,9,14,3,11,33,33.3,22,30,3,27,14,40,16,1,"MF,DF",30-34,Midfielder,England,Europe
1747,Yerry Mina,COL,Everton,Premier League,2020,25.0,1994.0,21.5,21,14,17,4,0,8,12,66.7,4,30,23,7,24,45,110,1,DF,25-29,Defender,Colombia,South America
1748,Takumi Minamino,JPN,Southampton,Premier League,2020,25.0,1995.0,7.9,7,3,2,5,0,2,19,10.5,17,13,1,12,4,11,9,0,MF,25-29,Midfielder,Japan,Asia
1749,Takumi Minamino,JPN,Liverpool,Premier League,2020,25.0,1995.0,3.3,4,3,1,2,1,0,12,0.0,12,1,0,1,2,6,3,0,"MF,FW",25-29,Midfielder,Japan,Asia
1750,Tyrone Mings,ENG,Aston Villa,Premier League,2020,27.0,1993.0,35.5,32,16,23,7,2,16,24,66.7,8,59,40,19,41,73,172,3,DF,25-29,Defender,England,Europe
1756,Antonio Mirante,ITA,Roma,Serie A,2020,37.0,1983.0,12.8,0,0,0,0,0,0,1,0.0,1,1,0,1,0,0,7,2,GK,35-39,Goalkeeper,Italy,Europe
1757,Tyrick Mitchell,ENG,Crystal Palace,Premier League,2020,20.0,1999.0,19.0,64,35,48,9,7,23,40,57.5,17,29,10,19,21,85,62,1,DF,20-24,Defender,England,Europe
1760,Maximilian Mittelstädt,GER,Hertha BSC,Bundesliga,2020,23.0,1997.0,20.0,66,39,42,21,3,35,72,48.6,37,34,5,29,55,121,61,1,"DF,FW",20-24,Defender,Germany,Europe
1761,Henrikh Mkhitaryan,ARM,Roma,Serie A,2020,31.0,1989.0,30.5,58,24,13,27,18,13,62,21.0,49,34,0,34,39,97,10,0,"MF,FW",30-34,Midfielder,Armenia,Asia
1763,Anthony Modeste,FRA,Saint-Étienne,Ligue 1,2020,32.0,1988.0,3.3,2,1,0,2,0,1,4,25.0,3,3,1,2,0,2,3,0,"FW,MF",30-34,Forward,France,Europe
1764,Anthony Modeste,FRA,Köln,Bundesliga,2020,32.0,1988.0,2.5,2,0,0,2,0,0,1,0.0,1,0,0,0,0,2,2,0,FW,30-34,Forward,France,Europe
1766,Terem Moffi,NGA,Lorient,Ligue 1,2020,21.0,1999.0,23.0,13,8,0,8,5,4,19,21.1,15,5,2,3,4,17,8,0,FW,20-24,Forward,Nigeria,Africa
1768,Niklas Moisander,FIN,Werder Bremen,Bundesliga,2020,34.0,1985.0,13.6,14,11,11,3,0,8,14,57.1,6,15,8,7,22,36,61,0,DF,30-34,Defender,Finland,Europe
1770,Johan Mojica,COL,Atalanta,Serie A,2020,27.0,1992.0,3.3,4,4,3,1,0,2,3,66.7,1,3,0,3,7,11,6,0,DF,25-29,Defender,Colombia,South America
1771,Johan Mojica,COL,Elche,La Liga,2020,27.0,1992.0,13.4,21,10,15,5,1,8,18,44.4,10,15,4,11,15,36,27,0,DF,25-29,Defender,Colombia,South America
1774,Nahuel Molina,ARG,Udinese,Serie A,2020,22.0,1998.0,20.3,27,18,13,10,4,16,42,38.1,26,26,4,22,21,48,49,1,DF,20-24,Defender,Argentina,South America
1775,Salvatore Molina,ITA,Crotone,Serie A,2020,28.0,1992.0,25.7,39,22,18,14,7,29,45,64.4,16,30,8,22,17,56,41,0,"MF,DF",25-29,Midfielder,Italy,Europe
1777,Florent Mollet,FRA,Montpellier,Ligue 1,2020,28.0,1991.0,26.2,20,15,7,11,2,12,47,25.5,35,18,4,14,32,52,9,1,MF,25-29,Midfielder,France,Europe
1778,Jayson Molumby,IRL,Brighton,Premier League,2020,20.0,1999.0,0.0,0,0,0,0,0,0,0,,0,0,0,0,0,0,0,0,MF,20-24,Midfielder,Republic of Ireland,Europe
1781,Gabriele Moncini,ITA,Benevento,Serie A,2020,24.0,1996.0,4.0,2,1,2,0,0,0,1,0.0,1,2,0,2,2,4,4,0,"FW,MF",20-24,Forward,Italy,Europe
1782,Thomas Monconduit,FRA,Lorient,Ligue 1,2020,29.0,1991.0,12.8,28,15,9,16,3,15,41,36.6,26,10,3,7,13,41,21,1,MF,25-29,Midfielder,France,Europe
1783,Kévin Monnet-Paquet,FRA,Saint-Étienne,Ligue 1,2020,31.0,1988.0,6.3,11,7,7,2,2,5,10,50.0,5,5,0,5,6,17,7,0,"MF,FW",30-34,Midfielder,France,Europe
1786,Lorenzo Montipò,ITA,Benevento,Serie A,2020,24.0,1996.0,37.0,0,0,0,0,0,0,0,,0,1,0,1,0,0,16,3,GK,20-24,Goalkeeper,Italy,Europe
1790,Luca Mora,ITA,Spezia,Serie A,2020,32.0,1988.0,1.3,3,1,1,2,0,2,4,50.0,2,2,1,1,0,3,2,0,MF,30-34,Midfielder,Italy,Europe
1791,Wesley Moraes,BRA,Aston Villa,Premier League,2020,23.0,1996.0,0.2,0,0,0,0,0,0,1,0.0,1,0,0,0,0,0,0,0,FW,20-24,Forward,Brazil,South America
1795,Jérémy Morel,MAD,Lorient,Ligue 1,2020,36.0,1984.0,27.7,31,19,21,10,0,20,39,51.3,19,26,11,15,44,75,81,1,DF,35-39,Defender,Madagascar,Africa
1801,Wes Morgan,JAM,Leicester City,Premier League,2020,36.0,1984.0,0.2,0,0,0,0,0,0,0,,0,0,0,0,0,0,1,0,DF,35-39,Defender,Jamaica,North America
1802,Ilaix Moriba,GUI,Barcelona,La Liga,2020,17.0,2003.0,6.0,14,6,5,7,2,5,10,50.0,5,16,1,15,5,19,4,1,MF,Under 20,Midfielder,Guinea,Africa
1807,Youssoufa Moukoko,GER,Dortmund,Bundesliga,2020,15.0,2004.0,4.7,3,2,1,1,1,0,0,,0,3,0,3,0,3,2,0,"FW,MF",Under 20,Forward,Germany,Europe
1809,Jessy Moulin,FRA,Saint-Étienne,Ligue 1,2020,34.0,1986.0,29.0,2,1,2,0,0,2,3,66.7,1,0,0,0,2,4,9,2,GK,30-34,Goalkeeper,France,Europe
1810,Steve Mounié,BEN,Brest,Ligue 1,2020,25.0,1994.0,29.8,15,11,3,11,1,3,28,10.7,25,18,3,15,12,27,40,0,FW,25-29,Forward,Benin,Africa
1811,Mason Mount,ENG,Chelsea,Premier League,2020,21.0,1999.0,32.1,75,35,22,38,15,25,69,36.2,44,40,2,38,31,106,14,0,MF,20-24,Midfielder,England,Europe
1812,Lucas Moura,BRA,Tottenham,Premier League,2020,27.0,1992.0,15.7,32,16,12,16,4,8,29,27.6,21,12,0,12,18,50,10,0,"FW,MF",25-29,Forward,Brazil,South America
1813,Lys Mousset,FRA,Sheffield Utd,Premier League,2020,24.0,1996.0,3.3,1,0,0,0,1,0,2,0.0,2,1,0,1,0,1,1,1,"FW,MF",20-24,Forward,France,Europe
1814,João Moutinho,POR,Wolves,Premier League,2020,33.0,1986.0,28.1,75,40,34,35,6,35,91,38.5,56,18,3,15,47,122,28,0,MF,30-34,Midfielder,Portugal,Europe
1814,João Moutinho,POR,Wolves,Premier League,2020,33.0,1986.0,28.1,75,40,34,35,6,35,91,38.5,56,18,3,15,47,122,28,0,MF,30-34,Midfielder,Portugal,Europe
1814,João Moutinho,POR,Wolves,Premier League,2020,33.0,1986.0,28.1,75,40,34,35,6,35,91,38.5,56,18,3,15,47,122,28,0,MF,30-34,Midfielder,Portugal,Europe
1814,João Moutinho,POR,Wolves,Premier League,2020,33.0,1986.0,28.1,75,40,34,35,6,35,91,38.5,56,18,3,15,47,122,28,0,MF,30-34,Midfielder,Portugal,Europe
1818,Nordi Mukiele,FRA,RB Leipzig,Bundesliga,2020,22.0,1997.0,18.6,44,30,14,28,2,21,37,56.8,16,33,1,32,23,67,33,2,DF,20-24,Defender,France,Europe
1820,Florian Müller,GER,Freiburg,Bundesliga,2020,22.0,1997.0,31.0,0,0,0,0,0,0,3,0.0,3,1,0,1,2,2,10,1,GK,20-24,Goalkeeper,Germany,Europe
1821,Sebastian Müller,GER,Arminia,Bundesliga,2020,19.0,2001.0,0.0,0,0,0,0,0,0,0,,0,0,0,0,0,0,0,0,"MF,DF",Under 20,Midfielder,Germany,Europe
1822,Thomas Müller,GER,Bayern Munich,Bundesliga,2020,30.0,1989.0,29.7,49,22,11,23,15,24,73,32.9,49,43,3,40,21,70,18,1,MF,30-34,Midfielder,Germany,Europe
1824,Marshall Munetsi,ZIM,Reims,Ligue 1,2020,24.0,1996.0,21.4,35,19,19,14,2,21,41,51.2,20,33,25,8,57,92,85,3,"MF,DF",20-24,Midfielder,Zimbabwe,Africa
1828,Luis Muriel,COL,Atalanta,Serie A,2020,29.0,1991.0,16.0,20,9,4,8,8,9,26,34.6,17,17,0,17,7,27,4,0,FW,25-29,Forward,Colombia,South America
1829,Jeison Murillo,COL,Celta Vigo,La Liga,2020,28.0,1992.0,30.0,45,21,35,9,1,24,44,54.5,20,29,17,12,36,81,100,2,DF,25-29,Defender,Colombia,South America
1831,Jacob Murphy,ENG,Newcastle Utd,Premier League,2020,25.0,1995.0,18.1,39,24,25,12,2,24,49,49.0,25,27,3,24,14,53,29,0,"DF,MF",25-29,Defender,England,Europe
1832,Nicola Murru,ITA,Torino,Serie A,2020,25.0,1994.0,6.3,9,6,1,5,3,3,5,60.0,2,11,1,10,12,21,24,0,DF,25-29,Defender,Italy,Europe
1834,Mateo Musacchio,ARG,Lazio,Serie A,2020,29.0,1990.0,2.5,1,1,1,0,0,0,0,,0,5,2,3,2,3,5,0,DF,25-29,Defender,Argentina,South America
1835,Mateo Musacchio,ARG,Milan,Serie A,2020,29.0,1990.0,0.4,2,1,2,0,0,2,3,66.7,1,1,0,1,3,5,0,0,DF,25-29,Defender,Argentina,South America
1836,Yunus Musah,USA,Valencia,La Liga,2020,17.0,2002.0,17.0,21,18,12,3,6,8,24,33.3,16,20,0,20,15,36,12,1,MF,Under 20,Midfielder,United States,North America
1837,Jamal Musiala,GER,Bayern Munich,Bundesliga,2020,17.0,2003.0,9.8,20,12,5,7,8,7,22,31.8,15,17,2,15,14,34,3,0,"FW,MF",Under 20,Forward,Germany,Europe
1838,Juan Musso,ARG,Udinese,Serie A,2020,26.0,1994.0,35.0,1,1,1,0,0,1,1,100.0,0,0,0,0,1,2,8,1,GK,25-29,Goalkeeper,Argentina,South America
1839,Shkodran Mustafi,GER,Arsenal,Premier League,2020,28.0,1992.0,0.5,1,1,1,0,0,1,1,100.0,0,1,0,1,0,1,3,0,DF,25-29,Defender,Germany,Europe
1840,Shkodran Mustafi,GER,Schalke 04,Bundesliga,2020,28.0,1992.0,11.5,16,5,15,1,0,3,12,25.0,9,20,15,5,32,48,76,1,DF,25-29,Defender,Germany,Europe
1842,Phillipp Mwene,AUT,Mainz 05,Bundesliga,2020,26.0,1994.0,18.6,36,23,21,11,4,19,38,50.0,19,26,3,23,24,60,33,0,"DF,MF",25-29,Defender,Austria,Europe
1845,Kévin N'Doram,FRA,Metz,Ligue 1,2020,24.0,1996.0,3.4,3,2,0,3,0,1,3,33.3,2,0,0,0,6,9,2,0,MF,20-24,Midfielder,France,Europe
1849,Yuto Nagatomo,JPN,Marseille,Ligue 1,2020,33.0,1986.0,17.7,23,16,12,8,3,9,18,50.0,9,14,3,11,29,52,43,0,DF,30-34,Defender,Japan,Asia
1853,Marvelous Nakamba,ZIM,Aston Villa,Premier League,2020,26.0,1994.0,8.3,22,14,10,11,1,7,12,58.3,5,16,5,11,17,39,9,1,MF,25-29,Midfielder,Zimbabwe,Africa
1854,Nahitan Nández,URU,Cagliari,Serie A,2020,24.0,1995.0,30.4,56,28,23,23,10,25,68,36.8,43,26,4,22,23,79,49,0,"MF,DF",20-24,Midfielder,Uruguay,South America
1861,Keylor Navas,CRC,Paris S-G,Ligue 1,2020,33.0,1986.0,28.0,0,0,0,0,0,0,0,,0,0,0,0,0,0,10,0,GK,30-34,Goalkeeper,Costa Rica,North America
1863,Papa Ndiaga Yade,MTN,Metz,Ligue 1,2020,20.0,2000.0,11.1,15,8,9,2,4,7,20,35.0,13,9,0,9,4,19,6,0,"FW,MF",20-24,Forward,Mauritania,Africa
1865,Wilfred Ndidi,NGA,Leicester City,Premier League,2020,23.0,1996.0,24.2,96,63,45,44,7,26,66,39.4,40,38,11,27,61,157,55,0,"MF,DF",20-24,Midfielder,Nigeria,Africa
1866,Bridge Ndilu,FRA,Nantes,Ligue 1,2020,20.0,2000.0,0.5,0,0,0,0,0,0,2,0.0,2,2,0,2,0,0,0,0,"FW,MF",20-24,Forward,France,Europe
1868,Dan Ndoye,SUI,Nice,Ligue 1,2020,19.0,2000.0,6.1,7,6,3,4,0,1,8,12.5,7,4,0,4,7,14,4,0,"FW,MF",Under 20,Forward,Switzerland,Europe
1869,Paul Nebel,GER,Mainz 05,Bundesliga,2020,17.0,2002.0,0.6,1,1,0,1,0,0,1,0.0,1,0,0,0,2,3,0,0,"MF,FW",Under 20,Midfielder,Germany,Europe
1871,Reiss Nelson,ENG,Arsenal,Premier League,2020,20.0,1999.0,0.8,1,0,0,0,1,0,0,,0,0,0,0,1,2,1,0,"FW,MF",20-24,Forward,England,Europe
1872,Ilija Nestorovski,MKD,Udinese,Serie A,2020,30.0,1990.0,7.8,6,4,2,3,1,2,13,15.4,11,5,0,5,1,7,7,0,"FW,MF",30-34,Forward,North Macedonia,Europe
1873,Neto,BRA,Barcelona,La Liga,2020,31.0,1989.0,7.0,0,0,0,0,0,0,1,0.0,1,0,0,0,0,0,3,1,GK,30-34,Goalkeeper,Brazil,South America
1873,Neto,BRA,Barcelona,La Liga,2020,31.0,1989.0,7.0,0,0,0,0,0,0,1,0.0,1,0,0,0,0,0,3,1,GK,30-34,Goalkeeper,Brazil,South America
1873,Neto,BRA,Barcelona,La Liga,2020,31.0,1989.0,7.0,0,0,0,0,0,0,1,0.0,1,0,0,0,0,0,3,1,GK,30-34,Goalkeeper,Brazil,South America
1873,Neto,BRA,Barcelona,La Liga,2020,31.0,1989.0,7.0,0,0,0,0,0,0,1,0.0,1,0,0,0,0,0,3,1,GK,30-34,Goalkeeper,Brazil,South America
1873,Neto,BRA,Barcelona,La Liga,2020,31.0,1989.0,7.0,0,0,0,0,0,0,1,0.0,1,0,0,0,0,0,3,1,GK,30-34,Goalkeeper,Brazil,South America
1873,Neto,BRA,Barcelona,La Liga,2020,31.0,1989.0,7.0,0,0,0,0,0,0,1,0.0,1,0,0,0,0,0,3,1,GK,30-34,Goalkeeper,Brazil,South America
1873,Neto,BRA,Barcelona,La Liga,2020,31.0,1989.0,7.0,0,0,0,0,0,0,1,0.0,1,0,0,0,0,0,3,1,GK,30-34,Goalkeeper,Brazil,South America
1873,Neto,BRA,Barcelona,La Liga,2020,31.0,1989.0,7.0,0,0,0,0,0,0,1,0.0,1,0,0,0,0,0,3,1,GK,30-34,Goalkeeper,Brazil,South America
1873,Neto,BRA,Barcelona,La Liga,2020,31.0,1989.0,7.0,0,0,0,0,0,0,1,0.0,1,0,0,0,0,0,3,1,GK,30-34,Goalkeeper,Brazil,South America
1874,Pedro Neto,POR,Wolves,Premier League,2020,20.0,2000.0,28.3,16,9,4,6,6,6,28,21.4,22,18,2,16,31,47,8,0,"FW,MF",20-24,Forward,Portugal,Europe
1875,Luca Netz,GER,Hertha BSC,Bundesliga,2020,17.0,2003.0,3.4,14,8,12,2,0,6,17,35.3,11,3,0,3,6,20,8,0,"DF,FW",Under 20,Defender,Germany,Europe
1876,Manuel Neuer,GER,Bayern Munich,Bundesliga,2020,34.0,1986.0,33.0,0,0,0,0,0,0,1,0.0,1,0,0,0,2,2,12,3,GK,30-34,Goalkeeper,Germany,Europe
1877,Florian Neuhaus,GER,Gladbach,Bundesliga,2020,23.0,1997.0,29.1,48,28,19,26,3,19,63,30.2,44,35,7,28,50,98,20,1,MF,20-24,Midfielder,Germany,Europe
1879,Rúben Neves,POR,Wolves,Premier League,2020,23.0,1997.0,29.7,86,46,42,38,6,36,88,40.9,52,55,11,44,65,151,46,2,MF,20-24,Midfielder,Portugal,Europe
1880,Neymar,BRA,Paris S-G,Ligue 1,2020,28.0,1992.0,15.7,14,11,1,6,7,8,37,21.6,29,8,0,8,9,23,0,0,"MF,FW",25-29,Midfielder,Brazil,South America
1881,Yvan Neyou,CMR,Saint-Étienne,Ligue 1,2020,23.0,1997.0,27.1,58,31,24,33,1,25,60,41.7,35,34,5,29,31,89,13,1,MF,20-24,Midfielder,Cameroon,Africa
1882,Jessic Ngankam,GER,Hertha BSC,Bundesliga,2020,20.0,2000.0,3.3,5,2,1,2,2,1,3,33.3,2,6,1,5,0,5,1,0,FW,20-24,Forward,Germany,Europe
1884,Ahmad Ngouyamsa,CHA,Dijon,Ligue 1,2020,19.0,2000.0,1.7,6,4,5,1,0,4,8,50.0,4,2,1,1,2,8,8,0,DF,Under 20,Defender,Chad,Africa
1885,Opa Nguette,SEN,Metz,Ligue 1,2020,26.0,1994.0,12.6,15,8,2,8,5,3,10,30.0,7,14,2,12,1,16,1,0,"FW,MF",25-29,Forward,Senegal,Africa
1887,Ibrahima Niane,SEN,Metz,Ligue 1,2020,21.0,1999.0,7.4,1,1,0,0,1,1,2,50.0,1,3,0,3,0,1,8,0,FW,20-24,Forward,Senegal,Africa
1890,Tanguy Nianzou,FRA,Bayern Munich,Bundesliga,2020,18.0,2002.0,1.3,3,1,3,0,0,1,1,100.0,0,0,0,0,3,6,1,0,"DF,FW",Under 20,Defender,France,Europe
1891,Florian Niederlechner,GER,Augsburg,Bundesliga,2020,29.0,1990.0,19.3,7,5,1,4,2,0,10,0.0,10,8,3,5,10,17,18,0,FW,25-29,Forward,Germany,Europe
1894,Joakim Nilsson,SWE,Arminia,Bundesliga,2020,26.0,1994.0,24.0,36,24,23,12,1,14,23,60.9,9,29,22,7,39,75,111,0,DF,25-29,Defender,Sweden,Europe
1895,Casimir Ninga,CHA,Angers,Ligue 1,2020,27.0,1993.0,0.3,0,0,0,0,0,0,0,,0,0,0,0,0,0,1,0,FW,25-29,Forward,Chad,Africa
1898,Eddie Nketiah,ENG,Arsenal,Premier League,2020,21.0,1999.0,4.7,3,1,0,2,1,0,2,0.0,2,6,0,6,0,3,5,0,FW,20-24,Forward,England,Europe
1900,Niels Nkounkou,FRA,Everton,Premier League,2020,19.0,2000.0,0.9,4,3,1,2,1,3,8,37.5,5,4,0,4,0,4,4,0,"DF,FW",Under 20,Defender,France,Europe
1901,Christopher Nkunku,FRA,RB Leipzig,Bundesliga,2020,22.0,1997.0,21.0,16,11,3,7,6,8,18,44.4,10,27,1,26,9,25,14,0,"FW,MF",20-24,Forward,France,Europe
1902,Dan Nlundulu,ENG,Southampton,Premier League,2020,21.0,1999.0,1.2,0,0,0,0,0,0,1,0.0,1,2,0,2,0,0,2,0,"FW,MF",20-24,Forward,England,Europe
1903,Mark Noble,ENG,West Ham,Premier League,2020,33.0,1987.0,7.9,8,4,2,5,1,4,14,28.6,10,7,3,4,13,21,3,0,MF,30-34,Midfielder,England,Europe
1905,Arnaud Nordin,FRA,Saint-Étienne,Ligue 1,2020,22.0,1998.0,19.7,14,8,5,5,4,6,21,28.6,15,13,2,11,9,23,10,0,"MF,FW",20-24,Midfielder,France,Europe
1907,Will Norris,ENG,Burnley,Premier League,2020,26.0,1993.0,2.0,0,0,0,0,0,0,0,,0,0,0,0,0,0,0,0,GK,25-29,Goalkeeper,England,Europe
1910,Alexander Nübel,GER,Bayern Munich,Bundesliga,2020,23.0,1996.0,1.0,0,0,0,0,0,0,0,,0,0,0,0,0,0,1,0,GK,20-24,Goalkeeper,Germany,Europe
1917,Allan Nyom,CMR,Getafe,La Liga,2020,32.0,1988.0,25.8,38,23,14,19,5,15,30,50.0,15,16,2,14,22,60,42,0,"MF,DF",30-34,Midfielder,Cameroon,Africa
1918,M'Bala Nzola,ANG,Spezia,Serie A,2020,23.0,1996.0,21.1,12,5,2,6,4,4,7,57.1,3,15,1,14,3,15,20,0,FW,20-24,Forward,Angola,Africa
1920,Jack O'Connell,ENG,Sheffield Utd,Premier League,2020,26.0,1994.0,2.0,3,1,1,1,1,0,1,0.0,1,4,3,1,2,5,7,0,DF,25-29,Defender,England,Europe
1921,Dara O'Shea,IRL,West Brom,Premier League,2020,21.0,1999.0,23.4,45,25,30,13,2,21,45,46.7,24,32,17,15,45,90,108,0,DF,20-24,Defender,Republic of Ireland,Europe
1922,Michael Obafemi,IRL,Southampton,Premier League,2020,20.0,2000.0,0.7,1,0,0,1,0,0,1,0.0,1,1,0,1,0,1,0,0,FW,20-24,Forward,Republic of Ireland,Europe
1923,Pedro Obiang,EQG,Sassuolo,Serie A,2020,28.0,1992.0,16.3,35,22,17,15,3,12,35,34.3,23,26,7,19,22,57,27,0,MF,25-29,Midfielder,Equatorial Guinea,Africa
1925,Lucas Ocampos,ARG,Sevilla,La Liga,2020,26.0,1994.0,29.2,36,24,12,16,8,13,37,35.1,24,33,1,32,19,55,30,1,FW,25-29,Forward,Argentina,South America
1926,Bastian Oczipka,GER,Schalke 04,Bundesliga,2020,31.0,1989.0,21.4,33,20,22,10,1,7,21,33.3,14,22,4,18,24,57,41,0,"DF,FW",30-34,Defender,Germany,Europe
1930,Angelo Ogbonna,ITA,West Ham,Premier League,2020,32.0,1988.0,27.7,26,13,20,5,1,9,17,52.9,8,25,11,14,30,56,119,0,DF,30-34,Defender,Italy,Europe
1933,Masaya Okugawa,JPN,Arminia,Bundesliga,2020,24.0,1996.0,10.2,17,8,5,11,1,6,14,42.9,8,17,2,15,8,25,5,0,MF,20-24,Midfielder,Japan,Asia
1936,Christian Oliva,URU,Cagliari,Serie A,2020,24.0,1996.0,4.3,10,4,6,3,1,6,17,35.3,11,11,1,10,8,18,7,0,MF,20-24,Midfielder,Uruguay,South America
1937,Christian Oliva,URU,Valencia,La Liga,2020,24.0,1996.0,2.2,2,0,1,1,0,1,6,16.7,5,1,0,1,6,8,0,0,MF,20-24,Midfielder,Uruguay,South America
1940,Mathías Olivera,URU,Getafe,La Liga,2020,22.0,1997.0,29.0,61,33,31,21,9,32,56,57.1,24,33,3,30,31,92,55,0,DF,20-24,Defender,Uruguay,South America
1941,Maximiliano Olivera,URU,Fiorentina,Serie A,2020,28.0,1992.0,1.0,2,0,1,1,0,1,1,100.0,0,3,1,2,0,2,8,0,DF,25-29,Defender,Uruguay,South America
1943,Robin Olsen,SWE,Everton,Premier League,2020,30.0,1990.0,7.0,0,0,0,0,0,0,0,,0,0,0,0,0,0,4,1,GK,30-34,Goalkeeper,Sweden,Europe
1944,Jonas Omlin,SUI,Montpellier,Ligue 1,2020,26.0,1994.0,29.7,1,1,1,0,0,1,4,25.0,3,0,0,0,0,1,9,1,GK,25-29,Goalkeeper,Switzerland,Europe
1945,Jérôme Onguéné,CMR,Genoa,Serie A,2020,22.0,1997.0,2.0,2,1,2,0,0,2,7,28.6,5,2,0,2,2,4,8,0,DF,20-24,Defender,Cameroon,Africa
1946,Karim Onisiwo,AUT,Mainz 05,Bundesliga,2020,28.0,1992.0,20.5,31,20,7,15,9,14,23,60.9,9,20,1,19,5,36,12,0,"FW,MF",25-29,Forward,Austria,Europe
1947,Josh Onomah,ENG,Fulham,Premier League,2020,23.0,1997.0,4.2,11,8,1,6,4,0,5,0.0,5,4,2,2,2,13,1,0,MF,20-24,Midfielder,England,Europe
1951,Fabián Orellana,CHI,Valladolid,La Liga,2020,34.0,1986.0,23.8,33,19,12,14,7,12,55,21.8,43,18,0,18,15,48,9,0,"MF,FW",30-34,Midfielder,Chile,South America
1952,Divock Origi,BEL,Liverpool,Premier League,2020,25.0,1995.0,2.1,3,2,0,2,1,1,3,33.3,2,5,1,4,1,4,2,0,FW,25-29,Forward,Belgium,Europe
1953,Riccardo Orsolini,ITA,Bologna,Serie A,2020,23.0,1997.0,19.5,37,18,13,12,12,16,39,41.0,23,22,3,19,10,47,22,0,"FW,MF",20-24,Forward,Italy,Europe
1954,Stefan Ortega,GER,Arminia,Bundesliga,2020,27.0,1992.0,34.0,2,1,2,0,0,2,6,33.3,4,0,0,0,0,2,12,3,GK,25-29,Goalkeeper,Germany,Europe
1955,Yuya Osako,JPN,Werder Bremen,Bundesliga,2020,30.0,1990.0,8.5,12,8,2,5,5,2,9,22.2,7,6,1,5,5,17,7,0,"MF,FW",30-34,Midfielder,Japan,Asia
1956,Ben Osborn,ENG,Sheffield Utd,Premier League,2020,25.0,1994.0,17.8,33,18,15,10,8,13,40,32.5,27,20,3,17,12,45,17,0,"MF,DF",25-29,Midfielder,England,Europe
1958,Yordan Osorio,VEN,Parma,Serie A,2020,26.0,1994.0,20.1,22,14,13,9,0,9,24,37.5,15,30,18,12,53,75,77,1,DF,25-29,Defender,Venezuela,South America
1959,David Ospina,COL,Napoli,Serie A,2020,31.0,1988.0,16.0,0,0,0,0,0,0,0,,0,0,0,0,0,0,4,0,GK,30-34,Goalkeeper,Colombia,South America
1961,Otávio,BRA,Bordeaux,Ligue 1,2020,26.0,1994.0,17.3,54,31,33,19,2,26,55,47.3,29,20,5,15,26,80,36,0,MF,25-29,Midfielder,Brazil,South America
1961,Otávio,BRA,Bordeaux,Ligue 1,2020,26.0,1994.0,17.3,54,31,33,19,2,26,55,47.3,29,20,5,15,26,80,36,0,MF,25-29,Midfielder,Brazil,South America
1961,Otávio,BRA,Bordeaux,Ligue 1,2020,26.0,1994.0,17.3,54,31,33,19,2,26,55,47.3,29,20,5,15,26,80,36,0,MF,25-29,Midfielder,Brazil,South America
1961,Otávio,BRA,Bordeaux,Ligue 1,2020,26.0,1994.0,17.3,54,31,33,19,2,26,55,47.3,29,20,5,15,26,80,36,0,MF,25-29,Midfielder,Brazil,South America
1961,Otávio,BRA,Bordeaux,Ligue 1,2020,26.0,1994.0,17.3,54,31,33,19,2,26,55,47.3,29,20,5,15,26,80,36,0,MF,25-29,Midfielder,Brazil,South America
1961,Otávio,BRA,Bordeaux,Ligue 1,2020,26.0,1994.0,17.3,54,31,33,19,2,26,55,47.3,29,20,5,15,26,80,36,0,MF,25-29,Midfielder,Brazil,South America
1961,Otávio,BRA,Bordeaux,Ligue 1,2020,26.0,1994.0,17.3,54,31,33,19,2,26,55,47.3,29,20,5,15,26,80,36,0,MF,25-29,Midfielder,Brazil,South America
1961,Otávio,BRA,Bordeaux,Ligue 1,2020,26.0,1994.0,17.3,54,31,33,19,2,26,55,47.3,29,20,5,15,26,80,36,0,MF,25-29,Midfielder,Brazil,South America
1961,Otávio,BRA,Bordeaux,Ligue 1,2020,26.0,1994.0,17.3,54,31,33,19,2,26,55,47.3,29,20,5,15,26,80,36,0,MF,25-29,Midfielder,Brazil,South America
1962,Paulo Otávio,BRA,Wolfsburg,Bundesliga,2020,25.0,1994.0,19.3,60,40,32,22,6,34,62,54.8,28,51,7,44,42,102,59,0,DF,25-29,Defender,Brazil,South America
1964,Alexandre Oukidja,ALG,Metz,Ligue 1,2020,32.0,1988.0,34.0,0,0,0,0,0,0,1,0.0,1,1,0,1,0,0,17,3,GK,30-34,Goalkeeper,Algeria,Africa
1965,Zinédine Ould Khaled,FRA,Angers,Ligue 1,2020,20.0,2000.0,0.4,0,0,0,0,0,0,0,,0,0,0,0,1,1,0,0,MF,20-24,Midfielder,France,Europe
1966,Adam Ounas,ALG,Crotone,Serie A,2020,23.0,1996.0,13.3,9,4,4,4,1,0,7,0.0,7,12,1,11,3,12,4,0,"FW,MF",20-24,Forward,Algeria,Africa
1967,Adam Ounas,ALG,Cagliari,Serie A,2020,23.0,1996.0,3.4,3,2,3,0,0,0,11,0.0,11,5,0,5,3,6,0,0,"MF,FW",20-24,Midfielder,Algeria,Africa
1969,Reece Oxford,ENG,Augsburg,Bundesliga,2020,21.0,1998.0,15.1,26,18,15,11,0,10,17,58.8,7,28,22,6,29,55,89,0,DF,20-24,Defender,England,Europe
1972,Ambroise Oyongo,CMR,Montpellier,Ligue 1,2020,29.0,1991.0,6.2,13,6,10,3,0,9,15,60.0,6,3,2,1,8,21,26,1,DF,25-29,Defender,Cameroon,Africa
1973,Salih Özcan,TUR,Köln,Bundesliga,2020,22.0,1998.0,15.2,21,13,11,10,0,12,33,36.4,21,11,2,9,20,41,14,1,MF,20-24,Midfielder,Turkey,Asia
1978,Gonçalo Paciência,POR,Schalke 04,Bundesliga,2020,25.0,1994.0,8.3,8,3,4,1,3,4,16,25.0,12,4,1,3,1,9,3,0,FW,25-29,Forward,Portugal,Europe
1979,Daniele Padelli,ITA,Inter,Serie A,2020,34.0,1985.0,0.5,0,0,0,0,0,0,0,,0,0,0,0,0,0,0,0,GK,30-34,Goalkeeper,Italy,Europe
1981,Vincent Pajot,FRA,Metz,Ligue 1,2020,29.0,1990.0,10.2,35,20,19,11,5,10,18,55.6,8,9,2,7,42,77,11,0,MF,25-29,Midfielder,France,Europe
1982,Rodrigo Palacio,ARG,Bologna,Serie A,2020,38.0,1982.0,27.8,13,6,2,3,8,1,15,6.7,14,18,0,18,7,20,29,0,FW,35-39,Forward,Argentina,South America
1983,Exequiel Palacios,ARG,Leverkusen,Bundesliga,2020,21.0,1998.0,6.4,31,17,12,16,3,17,30,56.7,13,13,0,13,12,43,7,0,MF,20-24,Midfielder,Argentina,South America
1984,Helibelton Palacios,COL,Elche,La Liga,2020,27.0,1993.0,8.3,20,10,16,3,1,8,13,61.5,5,9,1,8,5,25,21,0,DF,25-29,Defender,Colombia,South America
1986,Alberto Paleari,ITA,Genoa,Serie A,2020,27.0,1992.0,2.3,0,0,0,0,0,0,0,,0,0,0,0,0,0,1,0,GK,25-29,Goalkeeper,Italy,Europe
1987,Nicolas Pallois,FRA,Nantes,Ligue 1,2020,32.0,1987.0,30.8,58,36,42,14,2,38,72,52.8,34,44,20,24,37,95,155,1,DF,30-34,Defender,France,Europe
1989,Antonio Palumbo,ITA,Sampdoria,Serie A,2020,23.0,1996.0,0.1,0,0,0,0,0,0,1,0.0,1,0,0,0,0,0,0,0,MF,20-24,Midfielder,Italy,Europe
1991,Goran Pandev,MKD,Genoa,Serie A,2020,37.0,1983.0,15.6,9,5,1,6,2,4,10,40.0,6,6,0,6,2,11,7,1,"FW,MF",35-39,Forward,North Macedonia,Europe
1995,Lucas Paquetá,BRA,Lyon,Ligue 1,2020,22.0,1997.0,25.3,70,36,30,28,12,23,66,34.8,43,28,3,25,20,90,16,1,MF,20-24,Midfielder,Brazil,South America
1996,Gaëtan Paquiez,FRA,Nîmes,Ligue 1,2020,26.0,1994.0,11.6,21,12,12,7,2,12,29,41.4,17,10,3,7,16,37,28,0,DF,25-29,Defender,France,Europe
1998,Leandro Paredes,ARG,Paris S-G,Ligue 1,2020,26.0,1994.0,14.5,30,18,12,15,3,19,39,48.7,20,17,5,12,17,47,13,1,MF,25-29,Midfielder,Argentina,South America
2000,Vittorio Parigini,ITA,Genoa,Serie A,2020,24.0,1996.0,0.6,5,2,4,0,1,0,1,0.0,1,0,0,0,0,5,0,0,"MF,DF",20-24,Midfielder,Italy,Europe
2001,Marco Parolo,ITA,Lazio,Serie A,2020,35.0,1985.0,7.3,21,8,8,11,2,8,20,40.0,12,20,6,14,14,35,31,0,"DF,MF",35-39,Defender,Italy,Europe
2002,Thomas Partey,GHA,Arsenal,Premier League,2020,27.0,1993.0,17.0,44,21,16,24,4,24,56,42.9,32,17,5,12,23,67,18,0,MF,25-29,Midfielder,Ghana,Africa
2003,Thomas Partey,GHA,Atlético Madrid,La Liga,2020,27.0,1993.0,2.2,7,4,4,3,0,5,8,62.5,3,4,1,3,2,9,1,0,MF,25-29,Midfielder,Ghana,Africa
2005,Felix Passlack,GER,Dortmund,Bundesliga,2020,22.0,1998.0,4.0,9,6,4,2,3,4,8,50.0,4,11,1,10,3,12,2,0,DF,20-24,Defender,Germany,Europe
2006,Christian Pastina,ITA,Benevento,Serie A,2020,19.0,2001.0,1.3,0,0,0,0,0,0,1,0.0,1,1,0,1,1,1,8,0,DF,Under 20,Defender,Italy,Europe
2007,Javier Pastore,ARG,Roma,Serie A,2020,31.0,1989.0,0.9,2,2,2,0,0,2,2,100.0,0,0,0,0,0,2,0,0,"MF,FW",30-34,Midfielder,Argentina,South America
2009,Rui Patrício,POR,Wolves,Premier League,2020,32.0,1988.0,37.0,0,0,0,0,0,0,1,0.0,1,0,0,0,1,1,3,3,GK,30-34,Goalkeeper,Portugal,Europe
2010,Paulinho,BRA,Leverkusen,Bundesliga,2020,20.0,2000.0,0.7,0,0,0,0,0,0,0,,0,0,0,0,0,0,0,0,FW,20-24,Forward,Brazil,South America
2010,Paulinho,BRA,Leverkusen,Bundesliga,2020,20.0,2000.0,0.7,0,0,0,0,0,0,0,,0,0,0,0,0,0,0,0,FW,20-24,Forward,Brazil,South America
2010,Paulinho,BRA,Leverkusen,Bundesliga,2020,20.0,2000.0,0.7,0,0,0,0,0,0,0,,0,0,0,0,0,0,0,0,FW,20-24,Forward,Brazil,South America
2010,Paulinho,BRA,Leverkusen,Bundesliga,2020,20.0,2000.0,0.7,0,0,0,0,0,0,0,,0,0,0,0,0,0,0,0,FW,20-24,Forward,Brazil,South America
2010,Paulinho,BRA,Leverkusen,Bundesliga,2020,20.0,2000.0,0.7,0,0,0,0,0,0,0,,0,0,0,0,0,0,0,0,FW,20-24,Forward,Brazil,South America
2010,Paulinho,BRA,Leverkusen,Bundesliga,2020,20.0,2000.0,0.7,0,0,0,0,0,0,0,,0,0,0,0,0,0,0,0,FW,20-24,Forward,Brazil,South America
2010,Paulinho,BRA,Leverkusen,Bundesliga,2020,20.0,2000.0,0.7,0,0,0,0,0,0,0,,0,0,0,0,0,0,0,0,FW,20-24,Forward,Brazil,South America
2010,Paulinho,BRA,Leverkusen,Bundesliga,2020,20.0,2000.0,0.7,0,0,0,0,0,0,0,,0,0,0,0,0,0,0,0,FW,20-24,Forward,Brazil,South America
2010,Paulinho,BRA,Leverkusen,Bundesliga,2020,20.0,2000.0,0.7,0,0,0,0,0,0,0,,0,0,0,0,0,0,0,0,FW,20-24,Forward,Brazil,South America
2010,Paulinho,BRA,Leverkusen,Bundesliga,2020,20.0,2000.0,0.7,0,0,0,0,0,0,0,,0,0,0,0,0,0,0,0,FW,20-24,Forward,Brazil,South America
2010,Paulinho,BRA,Leverkusen,Bundesliga,2020,20.0,2000.0,0.7,0,0,0,0,0,0,0,,0,0,0,0,0,0,0,0,FW,20-24,Forward,Brazil,South America
2010,Paulinho,BRA,Leverkusen,Bundesliga,2020,20.0,2000.0,0.7,0,0,0,0,0,0,0,,0,0,0,0,0,0,0,0,FW,20-24,Forward,Brazil,South America
2010,Paulinho,BRA,Leverkusen,Bundesliga,2020,20.0,2000.0,0.7,0,0,0,0,0,0,0,,0,0,0,0,0,0,0,0,FW,20-24,Forward,Brazil,South America
2010,Paulinho,BRA,Leverkusen,Bundesliga,2020,20.0,2000.0,0.7,0,0,0,0,0,0,0,,0,0,0,0,0,0,0,0,FW,20-24,Forward,Brazil,South America
2010,Paulinho,BRA,Leverkusen,Bundesliga,2020,20.0,2000.0,0.7,0,0,0,0,0,0,0,,0,0,0,0,0,0,0,0,FW,20-24,Forward,Brazil,South America
2010,Paulinho,BRA,Leverkusen,Bundesliga,2020,20.0,2000.0,0.7,0,0,0,0,0,0,0,,0,0,0,0,0,0,0,0,FW,20-24,Forward,Brazil,South America
2010,Paulinho,BRA,Leverkusen,Bundesliga,2020,20.0,2000.0,0.7,0,0,0,0,0,0,0,,0,0,0,0,0,0,0,0,FW,20-24,Forward,Brazil,South America
2010,Paulinho,BRA,Leverkusen,Bundesliga,2020,20.0,2000.0,0.7,0,0,0,0,0,0,0,,0,0,0,0,0,0,0,0,FW,20-24,Forward,Brazil,South America
2010,Paulinho,BRA,Leverkusen,Bundesliga,2020,20.0,2000.0,0.7,0,0,0,0,0,0,0,,0,0,0,0,0,0,0,0,FW,20-24,Forward,Brazil,South America
2010,Paulinho,BRA,Leverkusen,Bundesliga,2020,20.0,2000.0,0.7,0,0,0,0,0,0,0,,0,0,0,0,0,0,0,0,FW,20-24,Forward,Brazil,South America
2010,Paulinho,BRA,Leverkusen,Bundesliga,2020,20.0,2000.0,0.7,0,0,0,0,0,0,0,,0,0,0,0,0,0,0,0,FW,20-24,Forward,Brazil,South America
2010,Paulinho,BRA,Leverkusen,Bundesliga,2020,20.0,2000.0,0.7,0,0,0,0,0,0,0,,0,0,0,0,0,0,0,0,FW,20-24,Forward,Brazil,South America
2010,Paulinho,BRA,Leverkusen,Bundesliga,2020,20.0,2000.0,0.7,0,0,0,0,0,0,0,,0,0,0,0,0,0,0,0,FW,20-24,Forward,Brazil,South America
2010,Paulinho,BRA,Leverkusen,Bundesliga,2020,20.0,2000.0,0.7,0,0,0,0,0,0,0,,0,0,0,0,0,0,0,0,FW,20-24,Forward,Brazil,South America
2010,Paulinho,BRA,Leverkusen,Bundesliga,2020,20.0,2000.0,0.7,0,0,0,0,0,0,0,,0,0,0,0,0,0,0,0,FW,20-24,Forward,Brazil,South America
2010,Paulinho,BRA,Leverkusen,Bundesliga,2020,20.0,2000.0,0.7,0,0,0,0,0,0,0,,0,0,0,0,0,0,0,0,FW,20-24,Forward,Brazil,South America
2010,Paulinho,BRA,Leverkusen,Bundesliga,2020,20.0,2000.0,0.7,0,0,0,0,0,0,0,,0,0,0,0,0,0,0,0,FW,20-24,Forward,Brazil,South America
2010,Paulinho,BRA,Leverkusen,Bundesliga,2020,20.0,2000.0,0.7,0,0,0,0,0,0,0,,0,0,0,0,0,0,0,0,FW,20-24,Forward,Brazil,South America
2010,Paulinho,BRA,Leverkusen,Bundesliga,2020,20.0,2000.0,0.7,0,0,0,0,0,0,0,,0,0,0,0,0,0,0,0,FW,20-24,Forward,Brazil,South America
2010,Paulinho,BRA,Leverkusen,Bundesliga,2020,20.0,2000.0,0.7,0,0,0,0,0,0,0,,0,0,0,0,0,0,0,0,FW,20-24,Forward,Brazil,South America
2010,Paulinho,BRA,Leverkusen,Bundesliga,2020,20.0,2000.0,0.7,0,0,0,0,0,0,0,,0,0,0,0,0,0,0,0,FW,20-24,Forward,Brazil,South America
2010,Paulinho,BRA,Leverkusen,Bundesliga,2020,20.0,2000.0,0.7,0,0,0,0,0,0,0,,0,0,0,0,0,0,0,0,FW,20-24,Forward,Brazil,South America
2010,Paulinho,BRA,Leverkusen,Bundesliga,2020,20.0,2000.0,0.7,0,0,0,0,0,0,0,,0,0,0,0,0,0,0,0,FW,20-24,Forward,Brazil,South America
2010,Paulinho,BRA,Leverkusen,Bundesliga,2020,20.0,2000.0,0.7,0,0,0,0,0,0,0,,0,0,0,0,0,0,0,0,FW,20-24,Forward,Brazil,South America
2010,Paulinho,BRA,Leverkusen,Bundesliga,2020,20.0,2000.0,0.7,0,0,0,0,0,0,0,,0,0,0,0,0,0,0,0,FW,20-24,Forward,Brazil,South America
2010,Paulinho,BRA,Leverkusen,Bundesliga,2020,20.0,2000.0,0.7,0,0,0,0,0,0,0,,0,0,0,0,0,0,0,0,FW,20-24,Forward,Brazil,South America
2010,Paulinho,BRA,Leverkusen,Bundesliga,2020,20.0,2000.0,0.7,0,0,0,0,0,0,0,,0,0,0,0,0,0,0,0,FW,20-24,Forward,Brazil,South America
2010,Paulinho,BRA,Leverkusen,Bundesliga,2020,20.0,2000.0,0.7,0,0,0,0,0,0,0,,0,0,0,0,0,0,0,0,FW,20-24,Forward,Brazil,South America
2010,Paulinho,BRA,Leverkusen,Bundesliga,2020,20.0,2000.0,0.7,0,0,0,0,0,0,0,,0,0,0,0,0,0,0,0,FW,20-24,Forward,Brazil,South America
2010,Paulinho,BRA,Leverkusen,Bundesliga,2020,20.0,2000.0,0.7,0,0,0,0,0,0,0,,0,0,0,0,0,0,0,0,FW,20-24,Forward,Brazil,South America
2010,Paulinho,BRA,Leverkusen,Bundesliga,2020,20.0,2000.0,0.7,0,0,0,0,0,0,0,,0,0,0,0,0,0,0,0,FW,20-24,Forward,Brazil,South America
2010,Paulinho,BRA,Leverkusen,Bundesliga,2020,20.0,2000.0,0.7,0,0,0,0,0,0,0,,0,0,0,0,0,0,0,0,FW,20-24,Forward,Brazil,South America
2010,Paulinho,BRA,Leverkusen,Bundesliga,2020,20.0,2000.0,0.7,0,0,0,0,0,0,0,,0,0,0,0,0,0,0,0,FW,20-24,Forward,Brazil,South America
2010,Paulinho,BRA,Leverkusen,Bundesliga,2020,20.0,2000.0,0.7,0,0,0,0,0,0,0,,0,0,0,0,0,0,0,0,FW,20-24,Forward,Brazil,South America
2010,Paulinho,BRA,Leverkusen,Bundesliga,2020,20.0,2000.0,0.7,0,0,0,0,0,0,0,,0,0,0,0,0,0,0,0,FW,20-24,Forward,Brazil,South America
2010,Paulinho,BRA,Leverkusen,Bundesliga,2020,20.0,2000.0,0.7,0,0,0,0,0,0,0,,0,0,0,0,0,0,0,0,FW,20-24,Forward,Brazil,South America
2010,Paulinho,BRA,Leverkusen,Bundesliga,2020,20.0,2000.0,0.7,0,0,0,0,0,0,0,,0,0,0,0,0,0,0,0,FW,20-24,Forward,Brazil,South America
2010,Paulinho,BRA,Leverkusen,Bundesliga,2020,20.0,2000.0,0.7,0,0,0,0,0,0,0,,0,0,0,0,0,0,0,0,FW,20-24,Forward,Brazil,South America
2010,Paulinho,BRA,Leverkusen,Bundesliga,2020,20.0,2000.0,0.7,0,0,0,0,0,0,0,,0,0,0,0,0,0,0,0,FW,20-24,Forward,Brazil,South America
2010,Paulinho,BRA,Leverkusen,Bundesliga,2020,20.0,2000.0,0.7,0,0,0,0,0,0,0,,0,0,0,0,0,0,0,0,FW,20-24,Forward,Brazil,South America
2010,Paulinho,BRA,Leverkusen,Bundesliga,2020,20.0,2000.0,0.7,0,0,0,0,0,0,0,,0,0,0,0,0,0,0,0,FW,20-24,Forward,Brazil,South America
2010,Paulinho,BRA,Leverkusen,Bundesliga,2020,20.0,2000.0,0.7,0,0,0,0,0,0,0,,0,0,0,0,0,0,0,0,FW,20-24,Forward,Brazil,South America
2010,Paulinho,BRA,Leverkusen,Bundesliga,2020,20.0,2000.0,0.7,0,0,0,0,0,0,0,,0,0,0,0,0,0,0,0,FW,20-24,Forward,Brazil,South America
2010,Paulinho,BRA,Leverkusen,Bundesliga,2020,20.0,2000.0,0.7,0,0,0,0,0,0,0,,0,0,0,0,0,0,0,0,FW,20-24,Forward,Brazil,South America
2010,Paulinho,BRA,Leverkusen,Bundesliga,2020,20.0,2000.0,0.7,0,0,0,0,0,0,0,,0,0,0,0,0,0,0,0,FW,20-24,Forward,Brazil,South America
2010,Paulinho,BRA,Leverkusen,Bundesliga,2020,20.0,2000.0,0.7,0,0,0,0,0,0,0,,0,0,0,0,0,0,0,0,FW,20-24,Forward,Brazil,South America
2010,Paulinho,BRA,Leverkusen,Bundesliga,2020,20.0,2000.0,0.7,0,0,0,0,0,0,0,,0,0,0,0,0,0,0,0,FW,20-24,Forward,Brazil,South America
2010,Paulinho,BRA,Leverkusen,Bundesliga,2020,20.0,2000.0,0.7,0,0,0,0,0,0,0,,0,0,0,0,0,0,0,0,FW,20-24,Forward,Brazil,South America
2010,Paulinho,BRA,Leverkusen,Bundesliga,2020,20.0,2000.0,0.7,0,0,0,0,0,0,0,,0,0,0,0,0,0,0,0,FW,20-24,Forward,Brazil,South America
2010,Paulinho,BRA,Leverkusen,Bundesliga,2020,20.0,2000.0,0.7,0,0,0,0,0,0,0,,0,0,0,0,0,0,0,0,FW,20-24,Forward,Brazil,South America
2010,Paulinho,BRA,Leverkusen,Bundesliga,2020,20.0,2000.0,0.7,0,0,0,0,0,0,0,,0,0,0,0,0,0,0,0,FW,20-24,Forward,Brazil,South America
2010,Paulinho,BRA,Leverkusen,Bundesliga,2020,20.0,2000.0,0.7,0,0,0,0,0,0,0,,0,0,0,0,0,0,0,0,FW,20-24,Forward,Brazil,South America
2010,Paulinho,BRA,Leverkusen,Bundesliga,2020,20.0,2000.0,0.7,0,0,0,0,0,0,0,,0,0,0,0,0,0,0,0,FW,20-24,Forward,Brazil,South America
2010,Paulinho,BRA,Leverkusen,Bundesliga,2020,20.0,2000.0,0.7,0,0,0,0,0,0,0,,0,0,0,0,0,0,0,0,FW,20-24,Forward,Brazil,South America
2010,Paulinho,BRA,Leverkusen,Bundesliga,2020,20.0,2000.0,0.7,0,0,0,0,0,0,0,,0,0,0,0,0,0,0,0,FW,20-24,Forward,Brazil,South America
2010,Paulinho,BRA,Leverkusen,Bundesliga,2020,20.0,2000.0,0.7,0,0,0,0,0,0,0,,0,0,0,0,0,0,0,0,FW,20-24,Forward,Brazil,South America
2010,Paulinho,BRA,Leverkusen,Bundesliga,2020,20.0,2000.0,0.7,0,0,0,0,0,0,0,,0,0,0,0,0,0,0,0,FW,20-24,Forward,Brazil,South America
2010,Paulinho,BRA,Leverkusen,Bundesliga,2020,20.0,2000.0,0.7,0,0,0,0,0,0,0,,0,0,0,0,0,0,0,0,FW,20-24,Forward,Brazil,South America
2010,Paulinho,BRA,Leverkusen,Bundesliga,2020,20.0,2000.0,0.7,0,0,0,0,0,0,0,,0,0,0,0,0,0,0,0,FW,20-24,Forward,Brazil,South America
2010,Paulinho,BRA,Leverkusen,Bundesliga,2020,20.0,2000.0,0.7,0,0,0,0,0,0,0,,0,0,0,0,0,0,0,0,FW,20-24,Forward,Brazil,South America
2010,Paulinho,BRA,Leverkusen,Bundesliga,2020,20.0,2000.0,0.7,0,0,0,0,0,0,0,,0,0,0,0,0,0,0,0,FW,20-24,Forward,Brazil,South America
2010,Paulinho,BRA,Leverkusen,Bundesliga,2020,20.0,2000.0,0.7,0,0,0,0,0,0,0,,0,0,0,0,0,0,0,0,FW,20-24,Forward,Brazil,South America
2010,Paulinho,BRA,Leverkusen,Bundesliga,2020,20.0,2000.0,0.7,0,0,0,0,0,0,0,,0,0,0,0,0,0,0,0,FW,20-24,Forward,Brazil,South America
2010,Paulinho,BRA,Leverkusen,Bundesliga,2020,20.0,2000.0,0.7,0,0,0,0,0,0,0,,0,0,0,0,0,0,0,0,FW,20-24,Forward,Brazil,South America
2010,Paulinho,BRA,Leverkusen,Bundesliga,2020,20.0,2000.0,0.7,0,0,0,0,0,0,0,,0,0,0,0,0,0,0,0,FW,20-24,Forward,Brazil,South America
2010,Paulinho,BRA,Leverkusen,Bundesliga,2020,20.0,2000.0,0.7,0,0,0,0,0,0,0,,0,0,0,0,0,0,0,0,FW,20-24,Forward,Brazil,South America
2010,Paulinho,BRA,Leverkusen,Bundesliga,2020,20.0,2000.0,0.7,0,0,0,0,0,0,0,,0,0,0,0,0,0,0,0,FW,20-24,Forward,Brazil,South America
2010,Paulinho,BRA,Leverkusen,Bundesliga,2020,20.0,2000.0,0.7,0,0,0,0,0,0,0,,0,0,0,0,0,0,0,0,FW,20-24,Forward,Brazil,South America
2010,Paulinho,BRA,Leverkusen,Bundesliga,2020,20.0,2000.0,0.7,0,0,0,0,0,0,0,,0,0,0,0,0,0,0,0,FW,20-24,Forward,Brazil,South America
2010,Paulinho,BRA,Leverkusen,Bundesliga,2020,20.0,2000.0,0.7,0,0,0,0,0,0,0,,0,0,0,0,0,0,0,0,FW,20-24,Forward,Brazil,South America
2010,Paulinho,BRA,Leverkusen,Bundesliga,2020,20.0,2000.0,0.7,0,0,0,0,0,0,0,,0,0,0,0,0,0,0,0,FW,20-24,Forward,Brazil,South America
2010,Paulinho,BRA,Leverkusen,Bundesliga,2020,20.0,2000.0,0.7,0,0,0,0,0,0,0,,0,0,0,0,0,0,0,0,FW,20-24,Forward,Brazil,South America
2010,Paulinho,BRA,Leverkusen,Bundesliga,2020,20.0,2000.0,0.7,0,0,0,0,0,0,0,,0,0,0,0,0,0,0,0,FW,20-24,Forward,Brazil,South America
2010,Paulinho,BRA,Leverkusen,Bundesliga,2020,20.0,2000.0,0.7,0,0,0,0,0,0,0,,0,0,0,0,0,0,0,0,FW,20-24,Forward,Brazil,South America
2010,Paulinho,BRA,Leverkusen,Bundesliga,2020,20.0,2000.0,0.7,0,0,0,0,0,0,0,,0,0,0,0,0,0,0,0,FW,20-24,Forward,Brazil,South America
2010,Paulinho,BRA,Leverkusen,Bundesliga,2020,20.0,2000.0,0.7,0,0,0,0,0,0,0,,0,0,0,0,0,0,0,0,FW,20-24,Forward,Brazil,South America
2010,Paulinho,BRA,Leverkusen,Bundesliga,2020,20.0,2000.0,0.7,0,0,0,0,0,0,0,,0,0,0,0,0,0,0,0,FW,20-24,Forward,Brazil,South America
2010,Paulinho,BRA,Leverkusen,Bundesliga,2020,20.0,2000.0,0.7,0,0,0,0,0,0,0,,0,0,0,0,0,0,0,0,FW,20-24,Forward,Brazil,South America
2010,Paulinho,BRA,Leverkusen,Bundesliga,2020,20.0,2000.0,0.7,0,0,0,0,0,0,0,,0,0,0,0,0,0,0,0,FW,20-24,Forward,Brazil,South America
2010,Paulinho,BRA,Leverkusen,Bundesliga,2020,20.0,2000.0,0.7,0,0,0,0,0,0,0,,0,0,0,0,0,0,0,0,FW,20-24,Forward,Brazil,South America
2010,Paulinho,BRA,Leverkusen,Bundesliga,2020,20.0,2000.0,0.7,0,0,0,0,0,0,0,,0,0,0,0,0,0,0,0,FW,20-24,Forward,Brazil,South America
2010,Paulinho,BRA,Leverkusen,Bundesliga,2020,20.0,2000.0,0.7,0,0,0,0,0,0,0,,0,0,0,0,0,0,0,0,FW,20-24,Forward,Brazil,South America
2010,Paulinho,BRA,Leverkusen,Bundesliga,2020,20.0,2000.0,0.7,0,0,0,0,0,0,0,,0,0,0,0,0,0,0,0,FW,20-24,Forward,Brazil,South America
2010,Paulinho,BRA,Leverkusen,Bundesliga,2020,20.0,2000.0,0.7,0,0,0,0,0,0,0,,0,0,0,0,0,0,0,0,FW,20-24,Forward,Brazil,South America
2010,Paulinho,BRA,Leverkusen,Bundesliga,2020,20.0,2000.0,0.7,0,0,0,0,0,0,0,,0,0,0,0,0,0,0,0,FW,20-24,Forward,Brazil,South America
2010,Paulinho,BRA,Leverkusen,Bundesliga,2020,20.0,2000.0,0.7,0,0,0,0,0,0,0,,0,0,0,0,0,0,0,0,FW,20-24,Forward,Brazil,South America
2010,Paulinho,BRA,Leverkusen,Bundesliga,2020,20.0,2000.0,0.7,0,0,0,0,0,0,0,,0,0,0,0,0,0,0,0,FW,20-24,Forward,Brazil,South America
2010,Paulinho,BRA,Leverkusen,Bundesliga,2020,20.0,2000.0,0.7,0,0,0,0,0,0,0,,0,0,0,0,0,0,0,0,FW,20-24,Forward,Brazil,South America
2010,Paulinho,BRA,Leverkusen,Bundesliga,2020,20.0,2000.0,0.7,0,0,0,0,0,0,0,,0,0,0,0,0,0,0,0,FW,20-24,Forward,Brazil,South America
2010,Paulinho,BRA,Leverkusen,Bundesliga,2020,20.0,2000.0,0.7,0,0,0,0,0,0,0,,0,0,0,0,0,0,0,0,FW,20-24,Forward,Brazil,South America
2010,Paulinho,BRA,Leverkusen,Bundesliga,2020,20.0,2000.0,0.7,0,0,0,0,0,0,0,,0,0,0,0,0,0,0,0,FW,20-24,Forward,Brazil,South America
2010,Paulinho,BRA,Leverkusen,Bundesliga,2020,20.0,2000.0,0.7,0,0,0,0,0,0,0,,0,0,0,0,0,0,0,0,FW,20-24,Forward,Brazil,South America
2010,Paulinho,BRA,Leverkusen,Bundesliga,2020,20.0,2000.0,0.7,0,0,0,0,0,0,0,,0,0,0,0,0,0,0,0,FW,20-24,Forward,Brazil,South America
2010,Paulinho,BRA,Leverkusen,Bundesliga,2020,20.0,2000.0,0.7,0,0,0,0,0,0,0,,0,0,0,0,0,0,0,0,FW,20-24,Forward,Brazil,South America
2010,Paulinho,BRA,Leverkusen,Bundesliga,2020,20.0,2000.0,0.7,0,0,0,0,0,0,0,,0,0,0,0,0,0,0,0,FW,20-24,Forward,Brazil,South America
2010,Paulinho,BRA,Leverkusen,Bundesliga,2020,20.0,2000.0,0.7,0,0,0,0,0,0,0,,0,0,0,0,0,0,0,0,FW,20-24,Forward,Brazil,South America
2010,Paulinho,BRA,Leverkusen,Bundesliga,2020,20.0,2000.0,0.7,0,0,0,0,0,0,0,,0,0,0,0,0,0,0,0,FW,20-24,Forward,Brazil,South America
2010,Paulinho,BRA,Leverkusen,Bundesliga,2020,20.0,2000.0,0.7,0,0,0,0,0,0,0,,0,0,0,0,0,0,0,0,FW,20-24,Forward,Brazil,South America
2010,Paulinho,BRA,Leverkusen,Bundesliga,2020,20.0,2000.0,0.7,0,0,0,0,0,0,0,,0,0,0,0,0,0,0,0,FW,20-24,Forward,Brazil,South America
2010,Paulinho,BRA,Leverkusen,Bundesliga,2020,20.0,2000.0,0.7,0,0,0,0,0,0,0,,0,0,0,0,0,0,0,0,FW,20-24,Forward,Brazil,South America
2010,Paulinho,BRA,Leverkusen,Bundesliga,2020,20.0,2000.0,0.7,0,0,0,0,0,0,0,,0,0,0,0,0,0,0,0,FW,20-24,Forward,Brazil,South America
2010,Paulinho,BRA,Leverkusen,Bundesliga,2020,20.0,2000.0,0.7,0,0,0,0,0,0,0,,0,0,0,0,0,0,0,0,FW,20-24,Forward,Brazil,South America
2010,Paulinho,BRA,Leverkusen,Bundesliga,2020,20.0,2000.0,0.7,0,0,0,0,0,0,0,,0,0,0,0,0,0,0,0,FW,20-24,Forward,Brazil,South America
2010,Paulinho,BRA,Leverkusen,Bundesliga,2020,20.0,2000.0,0.7,0,0,0,0,0,0,0,,0,0,0,0,0,0,0,0,FW,20-24,Forward,Brazil,South America
2010,Paulinho,BRA,Leverkusen,Bundesliga,2020,20.0,2000.0,0.7,0,0,0,0,0,0,0,,0,0,0,0,0,0,0,0,FW,20-24,Forward,Brazil,South America
2010,Paulinho,BRA,Leverkusen,Bundesliga,2020,20.0,2000.0,0.7,0,0,0,0,0,0,0,,0,0,0,0,0,0,0,0,FW,20-24,Forward,Brazil,South America
2010,Paulinho,BRA,Leverkusen,Bundesliga,2020,20.0,2000.0,0.7,0,0,0,0,0,0,0,,0,0,0,0,0,0,0,0,FW,20-24,Forward,Brazil,South America
2010,Paulinho,BRA,Leverkusen,Bundesliga,2020,20.0,2000.0,0.7,0,0,0,0,0,0,0,,0,0,0,0,0,0,0,0,FW,20-24,Forward,Brazil,South America
2010,Paulinho,BRA,Leverkusen,Bundesliga,2020,20.0,2000.0,0.7,0,0,0,0,0,0,0,,0,0,0,0,0,0,0,0,FW,20-24,Forward,Brazil,South America
2010,Paulinho,BRA,Leverkusen,Bundesliga,2020,20.0,2000.0,0.7,0,0,0,0,0,0,0,,0,0,0,0,0,0,0,0,FW,20-24,Forward,Brazil,South America
2010,Paulinho,BRA,Leverkusen,Bundesliga,2020,20.0,2000.0,0.7,0,0,0,0,0,0,0,,0,0,0,0,0,0,0,0,FW,20-24,Forward,Brazil,South America
2010,Paulinho,BRA,Leverkusen,Bundesliga,2020,20.0,2000.0,0.7,0,0,0,0,0,0,0,,0,0,0,0,0,0,0,0,FW,20-24,Forward,Brazil,South America
2010,Paulinho,BRA,Leverkusen,Bundesliga,2020,20.0,2000.0,0.7,0,0,0,0,0,0,0,,0,0,0,0,0,0,0,0,FW,20-24,Forward,Brazil,South America
2010,Paulinho,BRA,Leverkusen,Bundesliga,2020,20.0,2000.0,0.7,0,0,0,0,0,0,0,,0,0,0,0,0,0,0,0,FW,20-24,Forward,Brazil,South America
2010,Paulinho,BRA,Leverkusen,Bundesliga,2020,20.0,2000.0,0.7,0,0,0,0,0,0,0,,0,0,0,0,0,0,0,0,FW,20-24,Forward,Brazil,South America
2010,Paulinho,BRA,Leverkusen,Bundesliga,2020,20.0,2000.0,0.7,0,0,0,0,0,0,0,,0,0,0,0,0,0,0,0,FW,20-24,Forward,Brazil,South America
2010,Paulinho,BRA,Leverkusen,Bundesliga,2020,20.0,2000.0,0.7,0,0,0,0,0,0,0,,0,0,0,0,0,0,0,0,FW,20-24,Forward,Brazil,South America
2010,Paulinho,BRA,Leverkusen,Bundesliga,2020,20.0,2000.0,0.7,0,0,0,0,0,0,0,,0,0,0,0,0,0,0,0,FW,20-24,Forward,Brazil,South America
2010,Paulinho,BRA,Leverkusen,Bundesliga,2020,20.0,2000.0,0.7,0,0,0,0,0,0,0,,0,0,0,0,0,0,0,0,FW,20-24,Forward,Brazil,South America
2010,Paulinho,BRA,Leverkusen,Bundesliga,2020,20.0,2000.0,0.7,0,0,0,0,0,0,0,,0,0,0,0,0,0,0,0,FW,20-24,Forward,Brazil,South America
2010,Paulinho,BRA,Leverkusen,Bundesliga,2020,20.0,2000.0,0.7,0,0,0,0,0,0,0,,0,0,0,0,0,0,0,0,FW,20-24,Forward,Brazil,South America
2010,Paulinho,BRA,Leverkusen,Bundesliga,2020,20.0,2000.0,0.7,0,0,0,0,0,0,0,,0,0,0,0,0,0,0,0,FW,20-24,Forward,Brazil,South America
2010,Paulinho,BRA,Leverkusen,Bundesliga,2020,20.0,2000.0,0.7,0,0,0,0,0,0,0,,0,0,0,0,0,0,0,0,FW,20-24,Forward,Brazil,South America
2010,Paulinho,BRA,Leverkusen,Bundesliga,2020,20.0,2000.0,0.7,0,0,0,0,0,0,0,,0,0,0,0,0,0,0,0,FW,20-24,Forward,Brazil,South America
2010,Paulinho,BRA,Leverkusen,Bundesliga,2020,20.0,2000.0,0.7,0,0,0,0,0,0,0,,0,0,0,0,0,0,0,0,FW,20-24,Forward,Brazil,South America
2010,Paulinho,BRA,Leverkusen,Bundesliga,2020,20.0,2000.0,0.7,0,0,0,0,0,0,0,,0,0,0,0,0,0,0,0,FW,20-24,Forward,Brazil,South America
2010,Paulinho,BRA,Leverkusen,Bundesliga,2020,20.0,2000.0,0.7,0,0,0,0,0,0,0,,0,0,0,0,0,0,0,0,FW,20-24,Forward,Brazil,South America
2010,Paulinho,BRA,Leverkusen,Bundesliga,2020,20.0,2000.0,0.7,0,0,0,0,0,0,0,,0,0,0,0,0,0,0,0,FW,20-24,Forward,Brazil,South America
2010,Paulinho,BRA,Leverkusen,Bundesliga,2020,20.0,2000.0,0.7,0,0,0,0,0,0,0,,0,0,0,0,0,0,0,0,FW,20-24,Forward,Brazil,South America
2010,Paulinho,BRA,Leverkusen,Bundesliga,2020,20.0,2000.0,0.7,0,0,0,0,0,0,0,,0,0,0,0,0,0,0,0,FW,20-24,Forward,Brazil,South America
2010,Paulinho,BRA,Leverkusen,Bundesliga,2020,20.0,2000.0,0.7,0,0,0,0,0,0,0,,0,0,0,0,0,0,0,0,FW,20-24,Forward,Brazil,South America
2010,Paulinho,BRA,Leverkusen,Bundesliga,2020,20.0,2000.0,0.7,0,0,0,0,0,0,0,,0,0,0,0,0,0,0,0,FW,20-24,Forward,Brazil,South America
2010,Paulinho,BRA,Leverkusen,Bundesliga,2020,20.0,2000.0,0.7,0,0,0,0,0,0,0,,0,0,0,0,0,0,0,0,FW,20-24,Forward,Brazil,South America
2010,Paulinho,BRA,Leverkusen,Bundesliga,2020,20.0,2000.0,0.7,0,0,0,0,0,0,0,,0,0,0,0,0,0,0,0,FW,20-24,Forward,Brazil,South America
2010,Paulinho,BRA,Leverkusen,Bundesliga,2020,20.0,2000.0,0.7,0,0,0,0,0,0,0,,0,0,0,0,0,0,0,0,FW,20-24,Forward,Brazil,South America
2010,Paulinho,BRA,Leverkusen,Bundesliga,2020,20.0,2000.0,0.7,0,0,0,0,0,0,0,,0,0,0,0,0,0,0,0,FW,20-24,Forward,Brazil,South America
2010,Paulinho,BRA,Leverkusen,Bundesliga,2020,20.0,2000.0,0.7,0,0,0,0,0,0,0,,0,0,0,0,0,0,0,0,FW,20-24,Forward,Brazil,South America
2010,Paulinho,BRA,Leverkusen,Bundesliga,2020,20.0,2000.0,0.7,0,0,0,0,0,0,0,,0,0,0,0,0,0,0,0,FW,20-24,Forward,Brazil,South America
2010,Paulinho,BRA,Leverkusen,Bundesliga,2020,20.0,2000.0,0.7,0,0,0,0,0,0,0,,0,0,0,0,0,0,0,0,FW,20-24,Forward,Brazil,South America
2010,Paulinho,BRA,Leverkusen,Bundesliga,2020,20.0,2000.0,0.7,0,0,0,0,0,0,0,,0,0,0,0,0,0,0,0,FW,20-24,Forward,Brazil,South America
2010,Paulinho,BRA,Leverkusen,Bundesliga,2020,20.0,2000.0,0.7,0,0,0,0,0,0,0,,0,0,0,0,0,0,0,0,FW,20-24,Forward,Brazil,South America
2010,Paulinho,BRA,Leverkusen,Bundesliga,2020,20.0,2000.0,0.7,0,0,0,0,0,0,0,,0,0,0,0,0,0,0,0,FW,20-24,Forward,Brazil,South America
2010,Paulinho,BRA,Leverkusen,Bundesliga,2020,20.0,2000.0,0.7,0,0,0,0,0,0,0,,0,0,0,0,0,0,0,0,FW,20-24,Forward,Brazil,South America
2010,Paulinho,BRA,Leverkusen,Bundesliga,2020,20.0,2000.0,0.7,0,0,0,0,0,0,0,,0,0,0,0,0,0,0,0,FW,20-24,Forward,Brazil,South America
2010,Paulinho,BRA,Leverkusen,Bundesliga,2020,20.0,2000.0,0.7,0,0,0,0,0,0,0,,0,0,0,0,0,0,0,0,FW,20-24,Forward,Brazil,South America
2010,Paulinho,BRA,Leverkusen,Bundesliga,2020,20.0,2000.0,0.7,0,0,0,0,0,0,0,,0,0,0,0,0,0,0,0,FW,20-24,Forward,Brazil,South America
2010,Paulinho,BRA,Leverkusen,Bundesliga,2020,20.0,2000.0,0.7,0,0,0,0,0,0,0,,0,0,0,0,0,0,0,0,FW,20-24,Forward,Brazil,South America
2010,Paulinho,BRA,Leverkusen,Bundesliga,2020,20.0,2000.0,0.7,0,0,0,0,0,0,0,,0,0,0,0,0,0,0,0,FW,20-24,Forward,Brazil,South America
2010,Paulinho,BRA,Leverkusen,Bundesliga,2020,20.0,2000.0,0.7,0,0,0,0,0,0,0,,0,0,0,0,0,0,0,0,FW,20-24,Forward,Brazil,South America
2010,Paulinho,BRA,Leverkusen,Bundesliga,2020,20.0,2000.0,0.7,0,0,0,0,0,0,0,,0,0,0,0,0,0,0,0,FW,20-24,Forward,Brazil,South America
2010,Paulinho,BRA,Leverkusen,Bundesliga,2020,20.0,2000.0,0.7,0,0,0,0,0,0,0,,0,0,0,0,0,0,0,0,FW,20-24,Forward,Brazil,South America
2010,Paulinho,BRA,Leverkusen,Bundesliga,2020,20.0,2000.0,0.7,0,0,0,0,0,0,0,,0,0,0,0,0,0,0,0,FW,20-24,Forward,Brazil,South America
2010,Paulinho,BRA,Leverkusen,Bundesliga,2020,20.0,2000.0,0.7,0,0,0,0,0,0,0,,0,0,0,0,0,0,0,0,FW,20-24,Forward,Brazil,South America
2010,Paulinho,BRA,Leverkusen,Bundesliga,2020,20.0,2000.0,0.7,0,0,0,0,0,0,0,,0,0,0,0,0,0,0,0,FW,20-24,Forward,Brazil,South America
2010,Paulinho,BRA,Leverkusen,Bundesliga,2020,20.0,2000.0,0.7,0,0,0,0,0,0,0,,0,0,0,0,0,0,0,0,FW,20-24,Forward,Brazil,South America
2010,Paulinho,BRA,Leverkusen,Bundesliga,2020,20.0,2000.0,0.7,0,0,0,0,0,0,0,,0,0,0,0,0,0,0,0,FW,20-24,Forward,Brazil,South America
2010,Paulinho,BRA,Leverkusen,Bundesliga,2020,20.0,2000.0,0.7,0,0,0,0,0,0,0,,0,0,0,0,0,0,0,0,FW,20-24,Forward,Brazil,South America
2010,Paulinho,BRA,Leverkusen,Bundesliga,2020,20.0,2000.0,0.7,0,0,0,0,0,0,0,,0,0,0,0,0,0,0,0,FW,20-24,Forward,Brazil,South America
2010,Paulinho,BRA,Leverkusen,Bundesliga,2020,20.0,2000.0,0.7,0,0,0,0,0,0,0,,0,0,0,0,0,0,0,0,FW,20-24,Forward,Brazil,South America
2012,Benjamin Pavard,FRA,Bayern Munich,Bundesliga,2020,24.0,1996.0,21.6,44,27,20,16,8,23,40,57.5,17,29,5,24,48,92,31,1,DF,20-24,Defender,France,Europe
2017,Leonardo Pavoletti,ITA,Cagliari,Serie A,2020,31.0,1988.0,17.6,7,3,2,5,0,1,20,5.0,19,4,2,2,4,11,32,0,FW,30-34,Forward,Italy,Europe
2018,Dimitri Payet,FRA,Marseille,Ligue 1,2020,33.0,1987.0,26.9,27,17,4,16,7,17,40,42.5,23,19,2,17,8,35,10,0,"FW,MF",30-34,Forward,France,Europe
2019,Nehuén Paz,ARG,Bologna,Serie A,2020,27.0,1993.0,4.0,9,4,4,5,0,6,7,85.7,1,4,2,2,11,20,16,0,DF,25-29,Defender,Argentina,South America
2021,Mads Pedersen,DEN,Augsburg,Bundesliga,2020,23.0,1996.0,9.9,25,16,20,3,2,10,22,45.5,12,13,3,10,15,40,32,0,DF,20-24,Defender,Denmark,Europe
2021,Mads Pedersen,DEN,Augsburg,Bundesliga,2020,23.0,1996.0,9.9,25,16,20,3,2,10,22,45.5,12,13,3,10,15,40,32,0,DF,20-24,Defender,Denmark,Europe
2021,Mads Pedersen,DEN,Augsburg,Bundesliga,2020,23.0,1996.0,9.9,25,16,20,3,2,10,22,45.5,12,13,3,10,15,40,32,0,DF,20-24,Defender,Denmark,Europe
2021,Mads Pedersen,DEN,Augsburg,Bundesliga,2020,23.0,1996.0,9.9,25,16,20,3,2,10,22,45.5,12,13,3,10,15,40,32,0,DF,20-24,Defender,Denmark,Europe
2025,João Pedro,ITA,Cagliari,Serie A,2020,28.0,1992.0,36.1,13,6,2,6,5,2,27,7.4,25,32,6,26,13,26,28,0,"FW,MF",25-29,Forward,Italy,Europe
2025,João Pedro,ITA,Cagliari,Serie A,2020,28.0,1992.0,36.1,13,6,2,6,5,2,27,7.4,25,32,6,26,13,26,28,0,"FW,MF",25-29,Forward,Italy,Europe
2025,João Pedro,ITA,Cagliari,Serie A,2020,28.0,1992.0,36.1,13,6,2,6,5,2,27,7.4,25,32,6,26,13,26,28,0,"FW,MF",25-29,Forward,Italy,Europe
2025,João Pedro,ITA,Cagliari,Serie A,2020,28.0,1992.0,36.1,13,6,2,6,5,2,27,7.4,25,32,6,26,13,26,28,0,"FW,MF",25-29,Forward,Italy,Europe
2025,João Pedro,ITA,Cagliari,Serie A,2020,28.0,1992.0,36.1,13,6,2,6,5,2,27,7.4,25,32,6,26,13,26,28,0,"FW,MF",25-29,Forward,Italy,Europe
2025,João Pedro,ITA,Cagliari,Serie A,2020,28.0,1992.0,36.1,13,6,2,6,5,2,27,7.4,25,32,6,26,13,26,28,0,"FW,MF",25-29,Forward,Italy,Europe
2025,João Pedro,ITA,Cagliari,Serie A,2020,28.0,1992.0,36.1,13,6,2,6,5,2,27,7.4,25,32,6,26,13,26,28,0,"FW,MF",25-29,Forward,Italy,Europe
2025,João Pedro,ITA,Cagliari,Serie A,2020,28.0,1992.0,36.1,13,6,2,6,5,2,27,7.4,25,32,6,26,13,26,28,0,"FW,MF",25-29,Forward,Italy,Europe
2025,João Pedro,ITA,Cagliari,Serie A,2020,28.0,1992.0,36.1,13,6,2,6,5,2,27,7.4,25,32,6,26,13,26,28,0,"FW,MF",25-29,Forward,Italy,Europe
2025,João Pedro,ITA,Cagliari,Serie A,2020,28.0,1992.0,36.1,13,6,2,6,5,2,27,7.4,25,32,6,26,13,26,28,0,"FW,MF",25-29,Forward,Italy,Europe
2025,João Pedro,ITA,Cagliari,Serie A,2020,28.0,1992.0,36.1,13,6,2,6,5,2,27,7.4,25,32,6,26,13,26,28,0,"FW,MF",25-29,Forward,Italy,Europe
2025,João Pedro,ITA,Cagliari,Serie A,2020,28.0,1992.0,36.1,13,6,2,6,5,2,27,7.4,25,32,6,26,13,26,28,0,"FW,MF",25-29,Forward,Italy,Europe
2025,João Pedro,ITA,Cagliari,Serie A,2020,28.0,1992.0,36.1,13,6,2,6,5,2,27,7.4,25,32,6,26,13,26,28,0,"FW,MF",25-29,Forward,Italy,Europe
2025,João Pedro,ITA,Cagliari,Serie A,2020,28.0,1992.0,36.1,13,6,2,6,5,2,27,7.4,25,32,6,26,13,26,28,0,"FW,MF",25-29,Forward,Italy,Europe
2025,João Pedro,ITA,Cagliari,Serie A,2020,28.0,1992.0,36.1,13,6,2,6,5,2,27,7.4,25,32,6,26,13,26,28,0,"FW,MF",25-29,Forward,Italy,Europe
2025,João Pedro,ITA,Cagliari,Serie A,2020,28.0,1992.0,36.1,13,6,2,6,5,2,27,7.4,25,32,6,26,13,26,28,0,"FW,MF",25-29,Forward,Italy,Europe
2025,João Pedro,ITA,Cagliari,Serie A,2020,28.0,1992.0,36.1,13,6,2,6,5,2,27,7.4,25,32,6,26,13,26,28,0,"FW,MF",25-29,Forward,Italy,Europe
2025,João Pedro,ITA,Cagliari,Serie A,2020,28.0,1992.0,36.1,13,6,2,6,5,2,27,7.4,25,32,6,26,13,26,28,0,"FW,MF",25-29,Forward,Italy,Europe
2025,João Pedro,ITA,Cagliari,Serie A,2020,28.0,1992.0,36.1,13,6,2,6,5,2,27,7.4,25,32,6,26,13,26,28,0,"FW,MF",25-29,Forward,Italy,Europe
2025,João Pedro,ITA,Cagliari,Serie A,2020,28.0,1992.0,36.1,13,6,2,6,5,2,27,7.4,25,32,6,26,13,26,28,0,"FW,MF",25-29,Forward,Italy,Europe
2025,João Pedro,ITA,Cagliari,Serie A,2020,28.0,1992.0,36.1,13,6,2,6,5,2,27,7.4,25,32,6,26,13,26,28,0,"FW,MF",25-29,Forward,Italy,Europe
2025,João Pedro,ITA,Cagliari,Serie A,2020,28.0,1992.0,36.1,13,6,2,6,5,2,27,7.4,25,32,6,26,13,26,28,0,"FW,MF",25-29,Forward,Italy,Europe
2025,João Pedro,ITA,Cagliari,Serie A,2020,28.0,1992.0,36.1,13,6,2,6,5,2,27,7.4,25,32,6,26,13,26,28,0,"FW,MF",25-29,Forward,Italy,Europe
2025,João Pedro,ITA,Cagliari,Serie A,2020,28.0,1992.0,36.1,13,6,2,6,5,2,27,7.4,25,32,6,26,13,26,28,0,"FW,MF",25-29,Forward,Italy,Europe
2025,João Pedro,ITA,Cagliari,Serie A,2020,28.0,1992.0,36.1,13,6,2,6,5,2,27,7.4,25,32,6,26,13,26,28,0,"FW,MF",25-29,Forward,Italy,Europe
2025,João Pedro,ITA,Cagliari,Serie A,2020,28.0,1992.0,36.1,13,6,2,6,5,2,27,7.4,25,32,6,26,13,26,28,0,"FW,MF",25-29,Forward,Italy,Europe
2025,João Pedro,ITA,Cagliari,Serie A,2020,28.0,1992.0,36.1,13,6,2,6,5,2,27,7.4,25,32,6,26,13,26,28,0,"FW,MF",25-29,Forward,Italy,Europe
2025,João Pedro,ITA,Cagliari,Serie A,2020,28.0,1992.0,36.1,13,6,2,6,5,2,27,7.4,25,32,6,26,13,26,28,0,"FW,MF",25-29,Forward,Italy,Europe
2025,João Pedro,ITA,Cagliari,Serie A,2020,28.0,1992.0,36.1,13,6,2,6,5,2,27,7.4,25,32,6,26,13,26,28,0,"FW,MF",25-29,Forward,Italy,Europe
2025,João Pedro,ITA,Cagliari,Serie A,2020,28.0,1992.0,36.1,13,6,2,6,5,2,27,7.4,25,32,6,26,13,26,28,0,"FW,MF",25-29,Forward,Italy,Europe
2025,João Pedro,ITA,Cagliari,Serie A,2020,28.0,1992.0,36.1,13,6,2,6,5,2,27,7.4,25,32,6,26,13,26,28,0,"FW,MF",25-29,Forward,Italy,Europe
2025,João Pedro,ITA,Cagliari,Serie A,2020,28.0,1992.0,36.1,13,6,2,6,5,2,27,7.4,25,32,6,26,13,26,28,0,"FW,MF",25-29,Forward,Italy,Europe
2025,João Pedro,ITA,Cagliari,Serie A,2020,28.0,1992.0,36.1,13,6,2,6,5,2,27,7.4,25,32,6,26,13,26,28,0,"FW,MF",25-29,Forward,Italy,Europe
2025,João Pedro,ITA,Cagliari,Serie A,2020,28.0,1992.0,36.1,13,6,2,6,5,2,27,7.4,25,32,6,26,13,26,28,0,"FW,MF",25-29,Forward,Italy,Europe
2025,João Pedro,ITA,Cagliari,Serie A,2020,28.0,1992.0,36.1,13,6,2,6,5,2,27,7.4,25,32,6,26,13,26,28,0,"FW,MF",25-29,Forward,Italy,Europe
2025,João Pedro,ITA,Cagliari,Serie A,2020,28.0,1992.0,36.1,13,6,2,6,5,2,27,7.4,25,32,6,26,13,26,28,0,"FW,MF",25-29,Forward,Italy,Europe
2025,João Pedro,ITA,Cagliari,Serie A,2020,28.0,1992.0,36.1,13,6,2,6,5,2,27,7.4,25,32,6,26,13,26,28,0,"FW,MF",25-29,Forward,Italy,Europe
2025,João Pedro,ITA,Cagliari,Serie A,2020,28.0,1992.0,36.1,13,6,2,6,5,2,27,7.4,25,32,6,26,13,26,28,0,"FW,MF",25-29,Forward,Italy,Europe
2025,João Pedro,ITA,Cagliari,Serie A,2020,28.0,1992.0,36.1,13,6,2,6,5,2,27,7.4,25,32,6,26,13,26,28,0,"FW,MF",25-29,Forward,Italy,Europe
2025,João Pedro,ITA,Cagliari,Serie A,2020,28.0,1992.0,36.1,13,6,2,6,5,2,27,7.4,25,32,6,26,13,26,28,0,"FW,MF",25-29,Forward,Italy,Europe
2025,João Pedro,ITA,Cagliari,Serie A,2020,28.0,1992.0,36.1,13,6,2,6,5,2,27,7.4,25,32,6,26,13,26,28,0,"FW,MF",25-29,Forward,Italy,Europe
2025,João Pedro,ITA,Cagliari,Serie A,2020,28.0,1992.0,36.1,13,6,2,6,5,2,27,7.4,25,32,6,26,13,26,28,0,"FW,MF",25-29,Forward,Italy,Europe
2025,João Pedro,ITA,Cagliari,Serie A,2020,28.0,1992.0,36.1,13,6,2,6,5,2,27,7.4,25,32,6,26,13,26,28,0,"FW,MF",25-29,Forward,Italy,Europe
2025,João Pedro,ITA,Cagliari,Serie A,2020,28.0,1992.0,36.1,13,6,2,6,5,2,27,7.4,25,32,6,26,13,26,28,0,"FW,MF",25-29,Forward,Italy,Europe
2025,João Pedro,ITA,Cagliari,Serie A,2020,28.0,1992.0,36.1,13,6,2,6,5,2,27,7.4,25,32,6,26,13,26,28,0,"FW,MF",25-29,Forward,Italy,Europe
2025,João Pedro,ITA,Cagliari,Serie A,2020,28.0,1992.0,36.1,13,6,2,6,5,2,27,7.4,25,32,6,26,13,26,28,0,"FW,MF",25-29,Forward,Italy,Europe
2025,João Pedro,ITA,Cagliari,Serie A,2020,28.0,1992.0,36.1,13,6,2,6,5,2,27,7.4,25,32,6,26,13,26,28,0,"FW,MF",25-29,Forward,Italy,Europe
2025,João Pedro,ITA,Cagliari,Serie A,2020,28.0,1992.0,36.1,13,6,2,6,5,2,27,7.4,25,32,6,26,13,26,28,0,"FW,MF",25-29,Forward,Italy,Europe
2025,João Pedro,ITA,Cagliari,Serie A,2020,28.0,1992.0,36.1,13,6,2,6,5,2,27,7.4,25,32,6,26,13,26,28,0,"FW,MF",25-29,Forward,Italy,Europe
2025,João Pedro,ITA,Cagliari,Serie A,2020,28.0,1992.0,36.1,13,6,2,6,5,2,27,7.4,25,32,6,26,13,26,28,0,"FW,MF",25-29,Forward,Italy,Europe
2025,João Pedro,ITA,Cagliari,Serie A,2020,28.0,1992.0,36.1,13,6,2,6,5,2,27,7.4,25,32,6,26,13,26,28,0,"FW,MF",25-29,Forward,Italy,Europe
2025,João Pedro,ITA,Cagliari,Serie A,2020,28.0,1992.0,36.1,13,6,2,6,5,2,27,7.4,25,32,6,26,13,26,28,0,"FW,MF",25-29,Forward,Italy,Europe
2025,João Pedro,ITA,Cagliari,Serie A,2020,28.0,1992.0,36.1,13,6,2,6,5,2,27,7.4,25,32,6,26,13,26,28,0,"FW,MF",25-29,Forward,Italy,Europe
2025,João Pedro,ITA,Cagliari,Serie A,2020,28.0,1992.0,36.1,13,6,2,6,5,2,27,7.4,25,32,6,26,13,26,28,0,"FW,MF",25-29,Forward,Italy,Europe
2025,João Pedro,ITA,Cagliari,Serie A,2020,28.0,1992.0,36.1,13,6,2,6,5,2,27,7.4,25,32,6,26,13,26,28,0,"FW,MF",25-29,Forward,Italy,Europe
2025,João Pedro,ITA,Cagliari,Serie A,2020,28.0,1992.0,36.1,13,6,2,6,5,2,27,7.4,25,32,6,26,13,26,28,0,"FW,MF",25-29,Forward,Italy,Europe
2025,João Pedro,ITA,Cagliari,Serie A,2020,28.0,1992.0,36.1,13,6,2,6,5,2,27,7.4,25,32,6,26,13,26,28,0,"FW,MF",25-29,Forward,Italy,Europe
2025,João Pedro,ITA,Cagliari,Serie A,2020,28.0,1992.0,36.1,13,6,2,6,5,2,27,7.4,25,32,6,26,13,26,28,0,"FW,MF",25-29,Forward,Italy,Europe
2025,João Pedro,ITA,Cagliari,Serie A,2020,28.0,1992.0,36.1,13,6,2,6,5,2,27,7.4,25,32,6,26,13,26,28,0,"FW,MF",25-29,Forward,Italy,Europe
2025,João Pedro,ITA,Cagliari,Serie A,2020,28.0,1992.0,36.1,13,6,2,6,5,2,27,7.4,25,32,6,26,13,26,28,0,"FW,MF",25-29,Forward,Italy,Europe
2025,João Pedro,ITA,Cagliari,Serie A,2020,28.0,1992.0,36.1,13,6,2,6,5,2,27,7.4,25,32,6,26,13,26,28,0,"FW,MF",25-29,Forward,Italy,Europe
2025,João Pedro,ITA,Cagliari,Serie A,2020,28.0,1992.0,36.1,13,6,2,6,5,2,27,7.4,25,32,6,26,13,26,28,0,"FW,MF",25-29,Forward,Italy,Europe
2025,João Pedro,ITA,Cagliari,Serie A,2020,28.0,1992.0,36.1,13,6,2,6,5,2,27,7.4,25,32,6,26,13,26,28,0,"FW,MF",25-29,Forward,Italy,Europe
2025,João Pedro,ITA,Cagliari,Serie A,2020,28.0,1992.0,36.1,13,6,2,6,5,2,27,7.4,25,32,6,26,13,26,28,0,"FW,MF",25-29,Forward,Italy,Europe
2025,João Pedro,ITA,Cagliari,Serie A,2020,28.0,1992.0,36.1,13,6,2,6,5,2,27,7.4,25,32,6,26,13,26,28,0,"FW,MF",25-29,Forward,Italy,Europe
2025,João Pedro,ITA,Cagliari,Serie A,2020,28.0,1992.0,36.1,13,6,2,6,5,2,27,7.4,25,32,6,26,13,26,28,0,"FW,MF",25-29,Forward,Italy,Europe
2025,João Pedro,ITA,Cagliari,Serie A,2020,28.0,1992.0,36.1,13,6,2,6,5,2,27,7.4,25,32,6,26,13,26,28,0,"FW,MF",25-29,Forward,Italy,Europe
2025,João Pedro,ITA,Cagliari,Serie A,2020,28.0,1992.0,36.1,13,6,2,6,5,2,27,7.4,25,32,6,26,13,26,28,0,"FW,MF",25-29,Forward,Italy,Europe
2025,João Pedro,ITA,Cagliari,Serie A,2020,28.0,1992.0,36.1,13,6,2,6,5,2,27,7.4,25,32,6,26,13,26,28,0,"FW,MF",25-29,Forward,Italy,Europe
2025,João Pedro,ITA,Cagliari,Serie A,2020,28.0,1992.0,36.1,13,6,2,6,5,2,27,7.4,25,32,6,26,13,26,28,0,"FW,MF",25-29,Forward,Italy,Europe
2025,João Pedro,ITA,Cagliari,Serie A,2020,28.0,1992.0,36.1,13,6,2,6,5,2,27,7.4,25,32,6,26,13,26,28,0,"FW,MF",25-29,Forward,Italy,Europe
2025,João Pedro,ITA,Cagliari,Serie A,2020,28.0,1992.0,36.1,13,6,2,6,5,2,27,7.4,25,32,6,26,13,26,28,0,"FW,MF",25-29,Forward,Italy,Europe
2025,João Pedro,ITA,Cagliari,Serie A,2020,28.0,1992.0,36.1,13,6,2,6,5,2,27,7.4,25,32,6,26,13,26,28,0,"FW,MF",25-29,Forward,Italy,Europe
2025,João Pedro,ITA,Cagliari,Serie A,2020,28.0,1992.0,36.1,13,6,2,6,5,2,27,7.4,25,32,6,26,13,26,28,0,"FW,MF",25-29,Forward,Italy,Europe
2025,João Pedro,ITA,Cagliari,Serie A,2020,28.0,1992.0,36.1,13,6,2,6,5,2,27,7.4,25,32,6,26,13,26,28,0,"FW,MF",25-29,Forward,Italy,Europe
2025,João Pedro,ITA,Cagliari,Serie A,2020,28.0,1992.0,36.1,13,6,2,6,5,2,27,7.4,25,32,6,26,13,26,28,0,"FW,MF",25-29,Forward,Italy,Europe
2025,João Pedro,ITA,Cagliari,Serie A,2020,28.0,1992.0,36.1,13,6,2,6,5,2,27,7.4,25,32,6,26,13,26,28,0,"FW,MF",25-29,Forward,Italy,Europe
2025,João Pedro,ITA,Cagliari,Serie A,2020,28.0,1992.0,36.1,13,6,2,6,5,2,27,7.4,25,32,6,26,13,26,28,0,"FW,MF",25-29,Forward,Italy,Europe
2025,João Pedro,ITA,Cagliari,Serie A,2020,28.0,1992.0,36.1,13,6,2,6,5,2,27,7.4,25,32,6,26,13,26,28,0,"FW,MF",25-29,Forward,Italy,Europe
2025,João Pedro,ITA,Cagliari,Serie A,2020,28.0,1992.0,36.1,13,6,2,6,5,2,27,7.4,25,32,6,26,13,26,28,0,"FW,MF",25-29,Forward,Italy,Europe
2025,João Pedro,ITA,Cagliari,Serie A,2020,28.0,1992.0,36.1,13,6,2,6,5,2,27,7.4,25,32,6,26,13,26,28,0,"FW,MF",25-29,Forward,Italy,Europe
2026,Gianluca Pegolo,ITA,Sassuolo,Serie A,2020,39.0,1981.0,1.0,0,0,0,0,0,0,0,,0,0,0,0,0,0,1,0,GK,35-39,Goalkeeper,Italy,Europe
2028,Yohann Pelé,FRA,Marseille,Ligue 1,2020,37.0,1982.0,1.0,0,0,0,0,0,0,0,,0,0,0,0,0,0,0,0,GK,35-39,Goalkeeper,France,Europe
2029,Graziano Pellè,ITA,Parma,Serie A,2020,35.0,1985.0,6.8,2,2,0,1,1,1,8,12.5,7,3,0,3,2,4,8,0,FW,35-39,Forward,Italy,Europe
2030,Pietro Pellegri,ITA,Monaco,Ligue 1,2020,19.0,2001.0,2.6,2,1,0,2,0,0,0,,0,1,0,1,0,2,0,0,"FW,MF",Under 20,Forward,Italy,Europe
2031,Lorenzo Pellegrini,ITA,Roma,Serie A,2020,24.0,1996.0,28.9,40,24,13,20,7,21,60,35.0,39,37,2,35,42,82,23,1,MF,20-24,Midfielder,Italy,Europe
2032,Luca Pellegrini,ITA,Genoa,Serie A,2020,21.0,1999.0,7.1,9,6,6,2,1,4,10,40.0,6,11,2,9,8,17,13,1,"DF,MF",20-24,Defender,Italy,Europe
2034,Andy Pelmard,FRA,Nice,Ligue 1,2020,20.0,2000.0,13.4,18,12,12,5,1,9,12,75.0,3,11,3,8,20,38,35,0,DF,20-24,Defender,France,Europe
2035,Lee Peltier,ENG,West Brom,Premier League,2020,33.0,1986.0,2.5,9,4,8,1,0,4,4,100.0,0,1,1,0,1,10,11,0,DF,30-34,Defender,England,Europe
2036,Federico Peluso,ITA,Sassuolo,Serie A,2020,36.0,1984.0,2.3,1,1,1,0,0,1,2,50.0,1,2,2,0,3,4,12,0,DF,35-39,Defender,Italy,Europe
2040,Nicolas Pépé,CIV,Arsenal,Premier League,2020,25.0,1995.0,18.0,20,15,8,6,6,8,23,34.8,15,16,1,15,12,32,19,0,FW,25-29,Forward,Ivory Coast,Africa
2042,Andreas Pereira,BRA,Lazio,Serie A,2020,24.0,1996.0,6.0,5,0,1,3,1,2,12,16.7,10,6,0,6,1,6,4,0,"FW,MF",20-24,Forward,Brazil,South America
2043,Danilo Pereira,POR,Paris S-G,Ligue 1,2020,28.0,1991.0,15.9,21,11,6,11,4,6,14,42.9,8,14,6,8,29,50,33,4,"MF,DF",25-29,Midfielder,Portugal,Europe
2044,Mathias Pereira Lage,POR,Angers,Ligue 1,2020,23.0,1996.0,16.3,29,17,12,15,2,10,40,25.0,30,21,4,17,15,44,16,0,"FW,MF",20-24,Forward,Portugal,Europe
2045,Matheus Pereira,BRA,West Brom,Premier League,2020,24.0,1996.0,28.6,26,15,14,10,2,12,54,22.2,42,18,0,18,29,55,16,0,"MF,FW",20-24,Midfielder,Brazil,South America
2045,Matheus Pereira,BRA,West Brom,Premier League,2020,24.0,1996.0,28.6,26,15,14,10,2,12,54,22.2,42,18,0,18,29,55,16,0,"MF,FW",20-24,Midfielder,Brazil,South America
2045,Matheus Pereira,BRA,West Brom,Premier League,2020,24.0,1996.0,28.6,26,15,14,10,2,12,54,22.2,42,18,0,18,29,55,16,0,"MF,FW",20-24,Midfielder,Brazil,South America
2045,Matheus Pereira,BRA,West Brom,Premier League,2020,24.0,1996.0,28.6,26,15,14,10,2,12,54,22.2,42,18,0,18,29,55,16,0,"MF,FW",20-24,Midfielder,Brazil,South America
2045,Matheus Pereira,BRA,West Brom,Premier League,2020,24.0,1996.0,28.6,26,15,14,10,2,12,54,22.2,42,18,0,18,29,55,16,0,"MF,FW",20-24,Midfielder,Brazil,South America
2045,Matheus Pereira,BRA,West Brom,Premier League,2020,24.0,1996.0,28.6,26,15,14,10,2,12,54,22.2,42,18,0,18,29,55,16,0,"MF,FW",20-24,Midfielder,Brazil,South America
2045,Matheus Pereira,BRA,West Brom,Premier League,2020,24.0,1996.0,28.6,26,15,14,10,2,12,54,22.2,42,18,0,18,29,55,16,0,"MF,FW",20-24,Midfielder,Brazil,South America
2045,Matheus Pereira,BRA,West Brom,Premier League,2020,24.0,1996.0,28.6,26,15,14,10,2,12,54,22.2,42,18,0,18,29,55,16,0,"MF,FW",20-24,Midfielder,Brazil,South America
2045,Matheus Pereira,BRA,West Brom,Premier League,2020,24.0,1996.0,28.6,26,15,14,10,2,12,54,22.2,42,18,0,18,29,55,16,0,"MF,FW",20-24,Midfielder,Brazil,South America
2046,Pedro Pereira,POR,Crotone,Serie A,2020,22.0,1998.0,28.3,50,32,29,17,4,21,40,52.5,19,33,11,22,19,69,61,0,DF,20-24,Defender,Portugal,Europe
2046,Pedro Pereira,POR,Crotone,Serie A,2020,22.0,1998.0,28.3,50,32,29,17,4,21,40,52.5,19,33,11,22,19,69,61,0,DF,20-24,Defender,Portugal,Europe
2046,Pedro Pereira,POR,Crotone,Serie A,2020,22.0,1998.0,28.3,50,32,29,17,4,21,40,52.5,19,33,11,22,19,69,61,0,DF,20-24,Defender,Portugal,Europe
2046,Pedro Pereira,POR,Crotone,Serie A,2020,22.0,1998.0,28.3,50,32,29,17,4,21,40,52.5,19,33,11,22,19,69,61,0,DF,20-24,Defender,Portugal,Europe
2047,Ricardo Pereira,POR,Leicester City,Premier League,2020,26.0,1993.0,10.7,31,22,16,8,7,14,35,40.0,21,24,1,23,15,46,23,0,"DF,FW",25-29,Defender,Portugal,Europe
2048,Gastón Pereiro,URU,Cagliari,Serie A,2020,25.0,1995.0,3.0,3,1,2,1,0,1,2,50.0,1,2,0,2,1,4,2,1,"MF,DF",25-29,Midfielder,Uruguay,South America
24,Adrián,ESP,Liverpool,Premier League,2020,33.0,1987.0,3.0,0,0,0,0,0,0,0,,0,0,0,0,0,0,3,1,GK,30-34,Goalkeeper,Spain,Europe
53,Jordi Alba,ESP,Barcelona,La Liga,2020,31.0,1989.0,33.6,45,30,22,16,7,24,52,46.2,28,21,2,19,49,94,48,0,"DF,FW",30-34,Defender,Spain,Europe
54,Luis Alberto,ESP,Lazio,Serie A,2020,27.0,1992.0,29.1,43,24,15,19,9,15,73,20.5,58,41,2,39,13,56,11,1,MF,25-29,Midfielder,Spain,Europe
55,Raúl Albiol,ESP,Villarreal,La Liga,2020,34.0,1985.0,34.6,22,15,19,3,0,13,18,72.2,5,32,22,10,22,44,146,2,DF,30-34,Defender,Spain,Europe
57,Paco Alcácer,ESP,Villarreal,La Liga,2020,26.0,1993.0,17.2,6,3,1,2,3,3,7,42.9,4,8,0,8,9,15,6,0,FW,25-29,Forward,Spain,Europe
58,Pedro Alcalá,ESP,Cádiz,La Liga,2020,31.0,1989.0,10.1,8,4,6,2,0,3,5,60.0,2,19,13,6,16,24,50,0,DF,30-34,Defender,Spain,Europe
59,Thiago Alcántara,ESP,Liverpool,Premier League,2020,29.0,1991.0,20.6,61,36,20,30,11,17,49,34.7,32,26,0,26,30,91,14,0,MF,25-29,Midfielder,Spain,Europe
60,Rubén Alcaraz,ESP,Valladolid,La Liga,2020,29.0,1991.0,24.1,54,29,32,21,1,30,80,37.5,50,35,8,27,31,85,28,0,MF,25-29,Midfielder,Spain,Europe
63,Iván Alejo,ESP,Cádiz,La Liga,2020,25.0,1995.0,9.2,14,10,8,4,2,4,23,17.4,19,14,1,13,3,17,10,0,"MF,FW",25-29,Midfielder,Spain,Europe
64,Carles Aleñá,ESP,Barcelona,La Liga,2020,22.0,1998.0,0.5,1,0,1,0,0,0,0,,0,0,0,0,0,1,0,0,MF,20-24,Midfielder,Spain,Europe
65,Carles Aleñá,ESP,Getafe,La Liga,2020,22.0,1998.0,15.2,15,10,3,9,3,7,25,28.0,18,14,1,13,2,17,2,0,"MF,FW",20-24,Midfielder,Spain,Europe
77,Marcos Alonso,ESP,Chelsea,Premier League,2020,29.0,1990.0,10.7,13,3,6,4,3,7,14,50.0,7,12,1,11,12,25,30,0,DF,25-29,Defender,Spain,Europe
78,Sergio Álvarez,ESP,Eibar,La Liga,2020,28.0,1992.0,17.4,42,25,13,26,3,8,22,36.4,14,22,5,17,22,64,24,2,"MF,DF",25-29,Midfielder,Spain,Europe
78,Sergio Álvarez,ESP,Eibar,La Liga,2020,28.0,1992.0,17.4,42,25,13,26,3,8,22,36.4,14,22,5,17,22,64,24,2,"MF,DF",25-29,Midfielder,Spain,Europe
78,Sergio Álvarez,ESP,Eibar,La Liga,2020,28.0,1992.0,17.4,42,25,13,26,3,8,22,36.4,14,22,5,17,22,64,24,2,"MF,DF",25-29,Midfielder,Spain,Europe
78,Sergio Álvarez,ESP,Eibar,La Liga,2020,28.0,1992.0,17.4,42,25,13,26,3,8,22,36.4,14,22,5,17,22,64,24,2,"MF,DF",25-29,Midfielder,Spain,Europe
79,Yeray Álvarez,ESP,Athletic Club,La Liga,2020,25.0,1995.0,21.6,19,12,11,8,0,9,21,42.9,12,12,5,7,53,72,73,0,DF,25-29,Defender,Spain,Europe
92,Jon Ander Garrido,ESP,Cádiz,La Liga,2020,30.0,1989.0,8.9,18,10,8,7,3,10,26,38.5,16,12,4,8,14,32,13,0,MF,30-34,Midfielder,Spain,Europe
105,José Ángel,ESP,Eibar,La Liga,2020,30.0,1989.0,10.0,15,8,9,4,2,8,12,66.7,4,7,0,7,13,28,17,1,DF,30-34,Defender,Spain,Europe
107,Angeliño,ESP,RB Leipzig,Bundesliga,2020,23.0,1997.0,24.0,31,19,10,18,3,13,24,54.2,11,22,1,21,30,61,40,0,"DF,FW",20-24,Defender,Spain,Europe
118,Aritz Arambarri,ESP,Real Sociedad,La Liga,2020,22.0,1998.0,0.3,1,1,0,1,0,1,2,50.0,1,0,0,0,0,1,0,0,DF,20-24,Defender,Spain,Europe
124,Anaitz Arbilla,ESP,Eibar,La Liga,2020,33.0,1987.0,31.2,45,26,31,11,3,27,54,50.0,27,36,11,25,69,114,73,1,DF,30-34,Defender,Spain,Europe
133,Sergio Arribas,ESP,Real Madrid,La Liga,2020,18.0,2001.0,1.5,3,1,2,1,0,1,3,33.3,2,2,0,2,4,7,2,0,"MF,FW",Under 20,Midfielder,Spain,Europe
133,Sergio Arribas,ESP,Real Madrid,La Liga,2020,18.0,2001.0,1.5,3,1,2,1,0,1,3,33.3,2,2,0,2,4,7,2,0,"MF,FW",Under 20,Midfielder,Spain,Europe
133,Sergio Arribas,ESP,Real Madrid,La Liga,2020,18.0,2001.0,1.5,3,1,2,1,0,1,3,33.3,2,2,0,2,4,7,2,0,"MF,FW",Under 20,Midfielder,Spain,Europe
133,Sergio Arribas,ESP,Real Madrid,La Liga,2020,18.0,2001.0,1.5,3,1,2,1,0,1,3,33.3,2,2,0,2,4,7,2,0,"MF,FW",Under 20,Midfielder,Spain,Europe
134,Kepa Arrizabalaga,ESP,Chelsea,Premier League,2020,25.0,1994.0,6.5,0,0,0,0,0,0,1,0.0,1,0,0,0,0,0,0,3,GK,25-29,Goalkeeper,Spain,Europe
138,Sergio Asenjo,ESP,Villarreal,La Liga,2020,31.0,1989.0,36.0,0,0,0,0,0,0,1,0.0,1,0,0,0,0,0,13,2,GK,30-34,Goalkeeper,Spain,Europe
139,Marco Asensio,ESP,Real Madrid,La Liga,2020,24.0,1996.0,20.8,12,6,7,4,1,3,24,12.5,21,15,0,15,11,23,10,0,"FW,MF",20-24,Forward,Spain,Europe
140,Kristoffer Askildsen,NOR,Sampdoria,Serie A,2020,19.0,2001.0,1.1,0,0,0,0,0,0,0,,0,2,0,2,3,3,3,0,MF,Under 20,Midfielder,Norway,Europe
141,Iago Aspas,ESP,Celta Vigo,La Liga,2020,32.0,1987.0,31.8,11,3,2,7,2,2,23,8.7,21,25,2,23,16,27,21,0,FW,30-34,Forward,Spain,Europe
159,César Azpilicueta,ESP,Chelsea,Premier League,2020,30.0,1989.0,24.3,53,28,22,24,7,19,37,51.4,18,30,5,25,28,81,62,2,DF,30-34,Defender,Spain,Europe
164,Édgar Badía,ESP,Elche,La Liga,2020,28.0,1992.0,30.0,1,0,1,0,0,1,3,33.3,2,0,0,0,0,1,17,3,GK,25-29,Goalkeeper,Spain,Europe
181,Mikel Balenziaga,ESP,Athletic Club,La Liga,2020,32.0,1988.0,18.8,26,15,11,12,3,9,18,50.0,9,22,7,15,7,33,46,0,DF,30-34,Defender,Spain,Europe
201,Kike Barja,ESP,Osasuna,La Liga,2020,23.0,1997.0,15.9,10,5,6,1,3,5,24,20.8,19,10,1,9,16,26,8,0,"MF,FW",20-24,Midfielder,Spain,Europe
207,Marc Baró,ESP,Cádiz,La Liga,2020,20.0,1999.0,1.0,2,1,2,0,0,0,2,0.0,2,1,0,1,2,4,2,1,DF,20-24,Defender,Spain,Europe
208,Antonio Barragán,ESP,Elche,La Liga,2020,33.0,1987.0,24.8,28,14,21,5,2,12,21,57.1,9,22,8,14,33,61,67,1,DF,30-34,Defender,Spain,Europe
211,Ander Barrenetxea,ESP,Real Sociedad,La Liga,2020,18.0,2001.0,14.5,29,19,5,18,6,9,24,37.5,15,20,0,20,6,35,8,0,"MF,FW",Under 20,Midfielder,Spain,Europe
216,Marc Bartra,ESP,Betis,La Liga,2020,29.0,1991.0,18.8,27,16,18,8,1,12,22,54.5,10,19,5,14,40,67,74,3,DF,25-29,Defender,Spain,Europe
230,Jon Bautista,ESP,Real Sociedad,La Liga,2020,25.0,1995.0,4.1,5,3,0,2,3,0,3,0.0,3,3,1,2,2,7,4,0,FW,25-29,Forward,Spain,Europe
233,Ihlas Bebou,TOG,Hoffenheim,Bundesliga,2020,26.0,1994.0,24.4,24,9,5,10,9,8,14,57.1,6,18,4,14,17,41,16,0,"FW,MF",25-29,Forward,Togo,Africa
237,Jan Bednarek,POL,Southampton,Premier League,2020,24.0,1996.0,34.4,37,19,25,11,1,25,49,51.0,24,44,27,17,84,121,132,0,DF,20-24,Defender,Poland,Europe
248,Héctor Bellerín,ESP,Arsenal,Premier League,2020,25.0,1995.0,23.2,29,19,14,12,3,12,41,29.3,29,26,8,18,33,62,33,0,"DF,MF",25-29,Defender,Spain,Europe
251,Fran Beltrán,ESP,Celta Vigo,La Liga,2020,21.0,1999.0,15.5,30,22,15,12,3,8,24,33.3,16,14,1,13,16,46,24,0,"MF,FW",20-24,Midfielder,Spain,Europe
265,Sergio Benito,ESP,Valladolid,La Liga,2020,21.0,1999.0,0.0,0,0,0,0,0,0,0,,0,0,0,0,0,0,0,0,FW,20-24,Forward,Spain,Europe
281,Yuri Berchiche,ESP,Athletic Club,La Liga,2020,30.0,1990.0,18.7,24,19,14,5,5,10,24,41.7,14,14,0,14,11,35,29,0,DF,30-34,Defender,Spain,Europe
282,Álex Berenguer,ESP,Torino,Serie A,2020,25.0,1995.0,1.5,2,0,0,0,2,2,5,40.0,3,2,0,2,0,2,1,0,MF,25-29,Midfielder,Spain,Europe
283,Álex Berenguer,ESP,Athletic Club,La Liga,2020,25.0,1995.0,25.3,47,31,21,20,6,9,51,17.6,42,48,3,45,18,65,27,0,"MF,FW",25-29,Midfielder,Spain,Europe
284,Bartosz Bereszyński,POL,Sampdoria,Serie A,2020,28.0,1992.0,29.0,66,44,37,22,7,41,73,56.2,32,40,20,20,42,108,88,0,DF,25-29,Defender,Poland,Europe
286,Sander Berge,NOR,Sheffield Utd,Premier League,2020,22.0,1998.0,12.4,16,7,8,5,3,7,15,46.7,8,11,2,9,4,20,18,0,MF,20-24,Midfielder,Norway,Europe
293,Juan Bernat,ESP,Paris S-G,Ligue 1,2020,27.0,1993.0,2.2,5,3,0,4,1,3,5,60.0,2,4,0,4,1,6,6,0,DF,25-29,Defender,Spain,Europe
303,Pedro Bigas,ESP,Eibar,La Liga,2020,29.0,1990.0,17.0,11,9,7,4,0,7,14,50.0,7,12,6,6,23,34,54,0,DF,25-29,Defender,Spain,Europe
310,Antonio Blanco,ESP,Real Madrid,La Liga,2020,20.0,2000.0,2.4,7,2,4,2,1,3,7,42.9,4,6,2,4,3,10,5,0,"MF,FW",20-24,Midfielder,Spain,Europe
311,Rubén Blanco,ESP,Celta Vigo,La Liga,2020,25.0,1995.0,18.2,0,0,0,0,0,0,0,,0,0,0,0,0,0,7,3,GK,25-29,Goalkeeper,Spain,Europe
341,Ismaël Boura,COM,Lens,Ligue 1,2020,19.0,2000.0,9.2,11,7,8,2,1,3,9,33.3,6,7,2,5,21,32,12,0,DF,Under 20,Defender,Comoros,Africa
358,Álvaro Bravo,ESP,Granada,La Liga,2020,22.0,1998.0,0.2,1,1,1,0,0,1,2,50.0,1,0,0,0,1,2,0,0,MF,20-24,Midfielder,Spain,Europe
387,Burgui,ESP,Alavés,La Liga,2020,26.0,1993.0,0.2,3,1,2,1,0,1,1,100.0,0,0,0,0,0,3,0,0,MF,25-29,Midfielder,Spain,Europe
396,Sergio Busquets,ESP,Barcelona,La Liga,2020,32.0,1988.0,28.0,63,35,21,29,13,27,76,35.5,49,27,4,23,53,116,18,2,MF,30-34,Midfielder,Spain,Europe
424,José Callejón,ESP,Fiorentina,Serie A,2020,33.0,1987.0,7.4,10,7,0,6,4,5,9,55.6,4,4,1,3,4,14,5,0,"FW,MF",30-34,Forward,Spain,Europe
427,Dani Calvo,ESP,Elche,La Liga,2020,26.0,1994.0,19.8,20,13,13,7,0,7,10,70.0,3,18,12,6,11,31,71,0,DF,25-29,Defender,Spain,Europe
431,José Campaña,ESP,Levante,La Liga,2020,27.0,1993.0,8.3,14,6,3,6,5,5,14,35.7,9,2,0,2,13,27,4,0,MF,25-29,Midfielder,Spain,Europe
433,Sergio Canales,ESP,Betis,La Liga,2020,29.0,1991.0,27.8,16,9,9,6,1,3,21,14.3,18,18,0,18,13,29,5,0,"MF,FW",25-29,Midfielder,Spain,Europe
437,Ander Capa,ESP,Athletic Club,La Liga,2020,28.0,1992.0,23.7,37,18,22,13,2,18,37,48.6,19,21,8,13,25,62,57,0,DF,25-29,Defender,Spain,Europe
448,Marc Cardona,ESP,Osasuna,La Liga,2020,25.0,1995.0,0.6,1,0,1,0,0,1,1,100.0,0,0,0,0,0,1,0,0,"FW,DF",25-29,Forward,Spain,Europe
450,Juan Carlos,ESP,Huesca,La Liga,2020,29.0,1991.0,3.2,5,3,4,1,0,2,15,13.3,13,7,0,7,1,6,1,0,"MF,FW",25-29,Midfielder,Spain,Europe
450,Juan Carlos,ESP,Huesca,La Liga,2020,29.0,1991.0,3.2,5,3,4,1,0,2,15,13.3,13,7,0,7,1,6,1,0,"MF,FW",25-29,Midfielder,Spain,Europe
450,Juan Carlos,ESP,Huesca,La Liga,2020,29.0,1991.0,3.2,5,3,4,1,0,2,15,13.3,13,7,0,7,1,6,1,0,"MF,FW",25-29,Midfielder,Spain,Europe
450,Juan Carlos,ESP,Huesca,La Liga,2020,29.0,1991.0,3.2,5,3,4,1,0,2,15,13.3,13,7,0,7,1,6,1,0,"MF,FW",25-29,Midfielder,Spain,Europe
453,Sergio Carreira,ESP,Celta Vigo,La Liga,2020,19.0,2000.0,2.9,3,0,2,1,0,1,1,100.0,0,2,0,2,1,4,7,0,DF,Under 20,Defender,Spain,Europe
461,Matty Cash,POL,Aston Villa,Premier League,2020,22.0,1997.0,26.4,71,40,43,22,6,41,74,55.4,33,50,11,39,60,131,95,0,DF,20-24,Defender,Poland,Europe
462,Kiko Casilla,ESP,Leeds United,Premier League,2020,33.0,1986.0,3.0,0,0,0,0,0,0,0,,0,0,0,0,0,0,0,0,GK,30-34,Goalkeeper,Spain,Europe
469,Samu Castillejo,ESP,Milan,Serie A,2020,25.0,1995.0,13.1,24,12,9,14,1,14,40,35.0,26,21,0,21,6,30,9,0,FW,25-29,Forward,Spain,Europe
476,Dani Ceballos,ESP,Arsenal,Premier League,2020,23.0,1996.0,17.9,37,22,20,11,6,21,51,41.2,30,23,6,17,35,72,14,1,MF,20-24,Midfielder,Spain,Europe
508,Pedro Chirivella,ESP,Nantes,Ligue 1,2020,23.0,1997.0,25.3,26,8,7,13,6,14,49,28.6,35,23,4,19,41,67,19,0,MF,20-24,Midfielder,Spain,Europe
517,Víctor Chust,ESP,Real Madrid,La Liga,2020,20.0,2000.0,1.1,1,1,0,1,0,0,2,0.0,2,2,2,0,1,2,5,0,DF,20-24,Defender,Spain,Europe
520,Alberto Cifuentes,ESP,Cádiz,La Liga,2020,41.0,1979.0,2.0,0,0,0,0,0,0,0,,0,0,0,0,0,0,0,0,GK,Over 40,Goalkeeper,Spain,Europe
528,Carlos Clerc,ESP,Levante,La Liga,2020,28.0,1992.0,30.9,56,29,33,16,7,22,39,56.4,17,26,4,22,37,93,55,1,DF,25-29,Defender,Spain,Europe
532,Coke,ESP,Levante,La Liga,2020,33.0,1987.0,9.3,24,10,14,7,3,14,27,51.9,13,13,1,12,14,38,27,0,DF,30-34,Defender,Spain,Europe
559,Rober Correa,ESP,Eibar,La Liga,2020,27.0,1992.0,12.6,16,9,8,6,2,8,12,66.7,4,9,1,8,20,36,31,0,DF,25-29,Defender,Spain,Europe
565,Diego Costa,ESP,Atlético Madrid,La Liga,2020,31.0,1988.0,2.3,1,0,1,0,0,1,3,33.3,2,0,0,0,0,1,2,0,FW,30-34,Forward,Spain,Europe
565,Diego Costa,ESP,Atlético Madrid,La Liga,2020,31.0,1988.0,2.3,1,0,1,0,0,1,3,33.3,2,0,0,0,0,1,2,0,FW,30-34,Forward,Spain,Europe
565,Diego Costa,ESP,Atlético Madrid,La Liga,2020,31.0,1988.0,2.3,1,0,1,0,0,1,3,33.3,2,0,0,0,0,1,2,0,FW,30-34,Forward,Spain,Europe
565,Diego Costa,ESP,Atlético Madrid,La Liga,2020,31.0,1988.0,2.3,1,0,1,0,0,1,3,33.3,2,0,0,0,0,1,2,0,FW,30-34,Forward,Spain,Europe
569,Jaume Costa,ESP,Villarreal,La Liga,2020,32.0,1988.0,3.9,10,6,4,6,0,7,9,77.8,2,7,1,6,6,16,8,0,"DF,MF",30-34,Defender,Spain,Europe
573,Vladimír Coufal,CZE,West Ham,Premier League,2020,27.0,1992.0,33.9,73,36,50,15,8,52,89,58.4,37,41,7,34,41,114,102,1,DF,25-29,Defender,Czech Republic,Europe
593,Marc Cucurella,ESP,Getafe,La Liga,2020,22.0,1998.0,36.0,64,51,19,40,5,25,66,37.9,41,45,4,41,40,104,27,0,MF,20-24,Midfielder,Spain,Europe
612,Stuart Dallas,NIR,Leeds United,Premier League,2020,29.0,1991.0,37.9,74,45,46,22,6,30,88,34.1,58,41,3,38,44,118,52,1,"MF,DF",25-29,Midfielder,Northern Ireland,Europe
633,Paweł Dawidowicz,POL,Hellas Verona,Serie A,2020,25.0,1995.0,20.7,42,28,30,10,2,14,24,58.3,10,28,19,9,27,69,62,1,DF,25-29,Defender,Poland,Europe
678,Gerard Deulofeu,ESP,Udinese,Serie A,2020,26.0,1994.0,6.6,2,2,1,1,0,2,12,16.7,10,2,0,2,3,5,0,0,"FW,MF",25-29,Forward,Spain,Europe
706,Víctor Díaz,ESP,Granada,La Liga,2020,32.0,1988.0,9.2,21,10,13,6,2,10,19,52.6,9,14,8,6,16,37,39,0,DF,30-34,Defender,Spain,Europe
729,Djené,TOG,Getafe,La Liga,2020,28.0,1991.0,32.7,61,39,31,26,4,26,34,76.5,8,24,11,13,42,103,96,0,DF,25-29,Defender,Togo,Africa
741,Jaume Doménech,ESP,Valencia,La Liga,2020,29.0,1990.0,28.0,1,1,1,0,0,1,2,50.0,1,1,0,1,0,1,16,2,GK,25-29,Goalkeeper,Spain,Europe
768,Rubén Duarte,ESP,Alavés,La Liga,2020,24.0,1995.0,28.3,55,30,28,21,6,23,52,44.2,29,44,6,38,66,121,72,0,DF,20-24,Defender,Spain,Europe
780,Hugo Duro,ESP,Real Madrid,La Liga,2020,20.0,1999.0,0.6,0,0,0,0,0,0,0,,0,1,0,1,0,0,0,0,FW,20-24,Forward,Spain,Europe
802,Aritz Elustondo,ESP,Real Sociedad,La Liga,2020,26.0,1994.0,20.9,30,16,21,7,2,18,22,81.8,4,12,5,7,15,45,63,0,DF,25-29,Defender,Spain,Europe
812,Sergi Enrich,ESP,Eibar,La Liga,2020,30.0,1990.0,15.6,21,15,6,7,8,9,22,40.9,13,11,0,11,6,27,5,0,FW,30-34,Forward,Spain,Europe
817,Aarón Escandell,ESP,Granada,La Liga,2020,24.0,1995.0,5.0,1,1,1,0,0,1,1,100.0,0,0,0,0,0,1,6,0,GK,20-24,Goalkeeper,Spain,Europe
818,Dani Escriche,ESP,Huesca,La Liga,2020,22.0,1998.0,9.5,9,7,5,2,2,3,10,30.0,7,11,0,11,8,17,5,0,"FW,MF",20-24,Forward,Spain,Europe
819,Sergio Escudero,ESP,Sevilla,La Liga,2020,30.0,1989.0,6.3,12,8,6,5,1,6,12,50.0,6,5,2,3,9,21,7,0,DF,30-34,Defender,Spain,Europe
821,Vicente Esquerdo,ESP,Valencia,La Liga,2020,21.0,1999.0,2.6,7,4,5,2,0,4,6,66.7,2,4,2,2,8,15,1,0,MF,20-24,Midfielder,Spain,Europe
826,Jonny Evans,NIR,Leicester City,Premier League,2020,32.0,1988.0,27.5,25,12,22,2,1,14,20,70.0,6,8,3,5,46,71,98,1,DF,30-34,Defender,Northern Ireland,Europe
827,Edu Expósito,ESP,Eibar,La Liga,2020,23.0,1996.0,27.3,51,30,16,31,4,20,66,30.3,46,25,4,21,22,73,17,0,MF,20-24,Midfielder,Spain,Europe
830,Jokin Ezkieta,ESP,Athletic Club,La Liga,2020,23.0,1996.0,1.0,0,0,0,0,0,0,0,,0,0,0,0,0,0,0,0,GK,20-24,Goalkeeper,Spain,Europe
834,Cesc Fàbregas,ESP,Monaco,Ligue 1,2020,33.0,1987.0,9.7,20,12,6,9,5,9,22,40.9,13,11,1,10,13,33,3,0,"MF,FW",30-34,Midfielder,Spain,Europe
841,Fali,ESP,Cádiz,La Liga,2020,26.0,1993.0,29.3,42,25,24,15,3,16,37,43.2,21,28,15,13,32,74,119,0,"DF,MF",25-29,Defender,Spain,Europe
842,Iago Falque,ESP,Benevento,Serie A,2020,30.0,1990.0,4.0,4,2,2,2,0,1,6,16.7,5,4,1,3,0,4,1,0,"MF,FW",30-34,Midfielder,Spain,Europe
851,Ansu Fati,ESP,Barcelona,La Liga,2020,17.0,2002.0,4.8,9,4,2,4,3,2,10,20.0,8,4,0,4,3,12,1,0,FW,Under 20,Forward,Spain,Europe
863,Aitor Fernández,ESP,Levante,La Liga,2020,29.0,1991.0,29.0,0,0,0,0,0,0,0,,0,0,0,0,2,2,17,1,GK,25-29,Goalkeeper,Spain,Europe
863,Aitor Fernández,ESP,Levante,La Liga,2020,29.0,1991.0,29.0,0,0,0,0,0,0,0,,0,0,0,0,2,2,17,1,GK,25-29,Goalkeeper,Spain,Europe
863,Aitor Fernández,ESP,Levante,La Liga,2020,29.0,1991.0,29.0,0,0,0,0,0,0,0,,0,0,0,0,2,2,17,1,GK,25-29,Goalkeeper,Spain,Europe
863,Aitor Fernández,ESP,Levante,La Liga,2020,29.0,1991.0,29.0,0,0,0,0,0,0,0,,0,0,0,0,2,2,17,1,GK,25-29,Goalkeeper,Spain,Europe
864,Álex Fernández,ESP,Cádiz,La Liga,2020,27.0,1992.0,21.6,19,9,8,8,3,8,30,26.7,22,14,1,13,22,41,15,0,MF,25-29,Midfielder,Spain,Europe
865,Álvaro Fernández,ESP,Huesca,La Liga,2020,22.0,1998.0,22.0,1,1,0,1,0,1,3,33.3,2,0,0,0,2,3,7,0,GK,20-24,Goalkeeper,Spain,Europe
865,Álvaro Fernández,ESP,Huesca,La Liga,2020,22.0,1998.0,22.0,1,1,0,1,0,1,3,33.3,2,0,0,0,2,3,7,0,GK,20-24,Goalkeeper,Spain,Europe
865,Álvaro Fernández,ESP,Huesca,La Liga,2020,22.0,1998.0,22.0,1,1,0,1,0,1,3,33.3,2,0,0,0,2,3,7,0,GK,20-24,Goalkeeper,Spain,Europe
865,Álvaro Fernández,ESP,Huesca,La Liga,2020,22.0,1998.0,22.0,1,1,0,1,0,1,3,33.3,2,0,0,0,2,3,7,0,GK,20-24,Goalkeeper,Spain,Europe
866,Andrés Fernández,ESP,Huesca,La Liga,2020,33.0,1986.0,16.0,0,0,0,0,0,0,0,,0,0,0,0,0,0,3,2,GK,30-34,Goalkeeper,Spain,Europe
868,Carlos Fernández,ESP,Sevilla,La Liga,2020,24.0,1996.0,1.6,1,0,1,0,0,0,2,0.0,2,3,1,2,1,2,0,0,FW,20-24,Forward,Spain,Europe
869,Carlos Fernández,ESP,Real Sociedad,La Liga,2020,24.0,1996.0,4.3,3,2,0,2,1,1,8,12.5,7,6,1,5,0,3,6,0,"FW,MF",20-24,Forward,Spain,Europe
875,David Ferreiro,ESP,Huesca,La Liga,2020,32.0,1988.0,28.1,25,12,12,8,5,8,49,16.3,41,21,1,20,25,50,15,0,"MF,FW",30-34,Midfielder,Spain,Europe
880,Fidel,ESP,Elche,La Liga,2020,30.0,1989.0,26.6,46,30,28,15,3,25,64,39.1,39,22,2,20,16,62,14,0,"MF,DF",30-34,Midfielder,Spain,Europe
899,Ramón Folch,ESP,Elche,La Liga,2020,30.0,1989.0,0.0,0,0,0,0,0,0,0,,0,0,0,0,0,0,0,0,MF,30-34,Midfielder,Spain,Europe
905,Pablo Fornals,ESP,West Ham,Premier League,2020,24.0,1996.0,28.6,44,26,14,24,6,11,73,15.1,62,43,1,42,36,80,9,0,"FW,MF",20-24,Forward,Spain,Europe
926,Jorge de Frutos,ESP,Levante,La Liga,2020,23.0,1997.0,24.3,48,24,21,21,6,11,41,26.8,30,25,2,23,16,64,18,0,MF,20-24,Midfielder,Spain,Europe
941,Javi Galán,ESP,Huesca,La Liga,2020,25.0,1994.0,34.1,88,54,47,35,6,46,72,63.9,26,30,4,26,39,127,61,0,DF,25-29,Defender,Spain,Europe
943,Enric Gallego,ESP,Osasuna,La Liga,2020,33.0,1986.0,9.0,6,3,2,2,2,2,14,14.3,12,5,1,4,1,7,9,0,FW,30-34,Forward,Spain,Europe
947,Aleix García,ESP,Eibar,La Liga,2020,23.0,1997.0,4.9,5,4,2,2,1,1,10,10.0,9,5,0,5,8,13,2,0,MF,20-24,Midfielder,Spain,Europe
948,Borja García,ESP,Huesca,La Liga,2020,29.0,1990.0,12.4,13,7,4,6,3,6,12,50.0,6,12,0,12,10,23,4,1,"MF,FW",25-29,Midfielder,Spain,Europe
950,David García,ESP,Osasuna,La Liga,2020,26.0,1994.0,35.0,26,17,13,13,0,13,24,54.2,11,36,19,17,59,85,171,0,DF,25-29,Defender,Spain,Europe
950,David García,ESP,Osasuna,La Liga,2020,26.0,1994.0,35.0,26,17,13,13,0,13,24,54.2,11,36,19,17,59,85,171,0,DF,25-29,Defender,Spain,Europe
950,David García,ESP,Osasuna,La Liga,2020,26.0,1994.0,35.0,26,17,13,13,0,13,24,54.2,11,36,19,17,59,85,171,0,DF,25-29,Defender,Spain,Europe
950,David García,ESP,Osasuna,La Liga,2020,26.0,1994.0,35.0,26,17,13,13,0,13,24,54.2,11,36,19,17,59,85,171,0,DF,25-29,Defender,Spain,Europe
951,Eric García,ESP,Manchester City,Premier League,2020,19.0,2001.0,4.3,8,7,5,3,0,5,7,71.4,2,4,1,3,4,12,10,0,DF,Under 20,Defender,Spain,Europe
952,Manu García,ESP,Alavés,La Liga,2020,34.0,1986.0,12.5,24,13,10,13,1,8,35,22.9,27,16,1,15,12,36,21,0,MF,30-34,Midfielder,Spain,Europe
952,Manu García,ESP,Alavés,La Liga,2020,34.0,1986.0,12.5,24,13,10,13,1,8,35,22.9,27,16,1,15,12,36,21,0,MF,30-34,Midfielder,Spain,Europe
952,Manu García,ESP,Alavés,La Liga,2020,34.0,1986.0,12.5,24,13,10,13,1,8,35,22.9,27,16,1,15,12,36,21,0,MF,30-34,Midfielder,Spain,Europe
952,Manu García,ESP,Alavés,La Liga,2020,34.0,1986.0,12.5,24,13,10,13,1,8,35,22.9,27,16,1,15,12,36,21,0,MF,30-34,Midfielder,Spain,Europe
953,Raúl García,ESP,Valladolid,La Liga,2020,31.0,1989.0,5.6,10,8,5,5,0,6,20,30.0,14,5,1,4,9,19,10,0,"DF,MF",30-34,Defender,Spain,Europe
953,Raúl García,ESP,Valladolid,La Liga,2020,31.0,1989.0,5.6,10,8,5,5,0,6,20,30.0,14,5,1,4,9,19,10,0,"DF,MF",30-34,Defender,Spain,Europe
953,Raúl García,ESP,Valladolid,La Liga,2020,31.0,1989.0,5.6,10,8,5,5,0,6,20,30.0,14,5,1,4,9,19,10,0,"DF,MF",30-34,Defender,Spain,Europe
953,Raúl García,ESP,Valladolid,La Liga,2020,31.0,1989.0,5.6,10,8,5,5,0,6,20,30.0,14,5,1,4,9,19,10,0,"DF,MF",30-34,Defender,Spain,Europe
954,Raúl García,ESP,Athletic Club,La Liga,2020,34.0,1986.0,19.4,34,19,9,19,6,7,22,31.8,15,30,1,29,15,49,20,0,"FW,MF",30-34,Forward,Spain,Europe
954,Raúl García,ESP,Athletic Club,La Liga,2020,34.0,1986.0,19.4,34,19,9,19,6,7,22,31.8,15,30,1,29,15,49,20,0,"FW,MF",30-34,Forward,Spain,Europe
954,Raúl García,ESP,Athletic Club,La Liga,2020,34.0,1986.0,19.4,34,19,9,19,6,7,22,31.8,15,30,1,29,15,49,20,0,"FW,MF",30-34,Forward,Spain,Europe
954,Raúl García,ESP,Athletic Club,La Liga,2020,34.0,1986.0,19.4,34,19,9,19,6,7,22,31.8,15,30,1,29,15,49,20,0,"FW,MF",30-34,Forward,Spain,Europe
955,Rubén García,ESP,Osasuna,La Liga,2020,27.0,1993.0,30.2,50,29,21,22,7,14,45,31.1,31,28,2,26,29,79,20,0,"MF,FW",25-29,Midfielder,Spain,Europe
955,Rubén García,ESP,Osasuna,La Liga,2020,27.0,1993.0,30.2,50,29,21,22,7,14,45,31.1,31,28,2,26,29,79,20,0,"MF,FW",25-29,Midfielder,Spain,Europe
955,Rubén García,ESP,Osasuna,La Liga,2020,27.0,1993.0,30.2,50,29,21,22,7,14,45,31.1,31,28,2,26,29,79,20,0,"MF,FW",25-29,Midfielder,Spain,Europe
955,Rubén García,ESP,Osasuna,La Liga,2020,27.0,1993.0,30.2,50,29,21,22,7,14,45,31.1,31,28,2,26,29,79,20,0,"MF,FW",25-29,Midfielder,Spain,Europe
956,Sergi García,ESP,Alavés,La Liga,2020,21.0,1999.0,0.2,1,1,0,1,0,0,1,0.0,1,0,0,0,0,1,0,0,MF,20-24,Midfielder,Spain,Europe
957,Unai García,ESP,Osasuna,La Liga,2020,28.0,1992.0,13.8,19,9,14,4,1,9,15,60.0,6,16,8,8,14,33,40,0,DF,25-29,Defender,Spain,Europe
958,Mario Gaspar,ESP,Villarreal,La Liga,2020,29.0,1990.0,20.6,55,34,22,24,9,21,40,52.5,19,26,4,22,30,85,47,1,DF,25-29,Defender,Spain,Europe
964,David de Gea,ESP,Manchester Utd,Premier League,2020,29.0,1990.0,25.5,0,0,0,0,0,0,0,,0,0,0,0,0,0,8,3,GK,25-29,Goalkeeper,Spain,Europe
966,Theodor Gebre Selassie,CZE,Werder Bremen,Bundesliga,2020,33.0,1986.0,33.7,61,35,39,17,5,28,64,43.8,36,33,11,22,58,119,98,1,DF,30-34,Defender,Czech Republic,Europe
982,Bryan Gil,ESP,Sevilla,La Liga,2020,19.0,2001.0,0.1,1,1,0,1,0,0,0,,0,0,0,0,0,1,0,0,FW,Under 20,Forward,Spain,Europe
983,Bryan Gil,ESP,Eibar,La Liga,2020,19.0,2001.0,25.2,28,18,12,11,5,6,23,26.1,17,20,0,20,17,45,6,0,"MF,FW",Under 20,Midfielder,Spain,Europe
984,David Gil,ESP,Cádiz,La Liga,2020,26.0,1994.0,4.0,0,0,0,0,0,0,1,0.0,1,0,0,0,0,0,2,0,GK,25-29,Goalkeeper,Spain,Europe
986,Álvaro Giménez,ESP,Cádiz,La Liga,2020,29.0,1991.0,4.5,4,2,2,2,0,0,3,0.0,3,2,0,2,2,6,3,0,FW,25-29,Forward,Spain,Europe
992,Kamil Glik,POL,Benevento,Serie A,2020,32.0,1988.0,35.6,44,24,33,10,1,25,53,47.2,28,37,31,6,62,106,153,0,DF,30-34,Defender,Poland,Europe
1004,Dani Gómez,ESP,Levante,La Liga,2020,22.0,1998.0,18.5,4,3,2,1,1,0,11,0.0,11,3,0,3,2,6,4,0,FW,20-24,Forward,Spain,Europe
1005,Ibai Gómez,ESP,Athletic Club,La Liga,2020,30.0,1989.0,4.7,6,4,2,3,1,4,7,57.1,3,3,0,3,2,8,4,0,MF,30-34,Midfielder,Spain,Europe
1008,Moi Gómez,ESP,Villarreal,La Liga,2020,26.0,1994.0,28.5,21,12,6,8,7,14,35,40.0,21,20,3,17,11,32,16,0,"MF,FW",25-29,Midfielder,Spain,Europe
1011,Sergi Gómez,ESP,Sevilla,La Liga,2020,28.0,1992.0,8.0,4,3,2,2,0,1,1,100.0,0,5,4,1,6,10,34,0,DF,25-29,Defender,Spain,Europe
1012,Sergio Gómez,ESP,Huesca,La Liga,2020,19.0,2000.0,8.8,29,10,17,9,3,11,22,50.0,11,15,0,15,14,43,9,0,"MF,FW",Under 20,Midfielder,Spain,Europe
1017,Álvaro González,ESP,Marseille,Ligue 1,2020,30.0,1990.0,31.5,26,17,20,6,0,19,31,61.3,12,30,18,12,33,59,119,1,DF,30-34,Defender,Spain,Europe
1017,Álvaro González,ESP,Marseille,Ligue 1,2020,30.0,1990.0,31.5,26,17,20,6,0,19,31,61.3,12,30,18,12,33,59,119,1,DF,30-34,Defender,Spain,Europe
1017,Álvaro González,ESP,Marseille,Ligue 1,2020,30.0,1990.0,31.5,26,17,20,6,0,19,31,61.3,12,30,18,12,33,59,119,1,DF,30-34,Defender,Spain,Europe
1017,Álvaro González,ESP,Marseille,Ligue 1,2020,30.0,1990.0,31.5,26,17,20,6,0,19,31,61.3,12,30,18,12,33,59,119,1,DF,30-34,Defender,Spain,Europe
1018,Bruno González,ESP,Valladolid,La Liga,2020,30.0,1990.0,25.1,26,17,18,8,0,17,31,54.8,14,22,14,8,37,63,112,1,DF,30-34,Defender,Spain,Europe
1019,Diego González,ESP,Elche,La Liga,2020,25.0,1995.0,14.2,11,7,7,3,1,5,11,45.5,6,16,9,7,20,31,49,1,DF,25-29,Defender,Spain,Europe
1019,Diego González,ESP,Elche,La Liga,2020,25.0,1995.0,14.2,11,7,7,3,1,5,11,45.5,6,16,9,7,20,31,49,1,DF,25-29,Defender,Spain,Europe
1019,Diego González,ESP,Elche,La Liga,2020,25.0,1995.0,14.2,11,7,7,3,1,5,11,45.5,6,16,9,7,20,31,49,1,DF,25-29,Defender,Spain,Europe
1019,Diego González,ESP,Elche,La Liga,2020,25.0,1995.0,14.2,11,7,7,3,1,5,11,45.5,6,16,9,7,20,31,49,1,DF,25-29,Defender,Spain,Europe
1021,Sergio González,ESP,Cádiz,La Liga,2020,23.0,1997.0,1.0,1,0,0,1,0,1,2,50.0,1,0,0,0,2,3,0,0,"MF,DF",20-24,Midfielder,Spain,Europe
1021,Sergio González,ESP,Cádiz,La Liga,2020,23.0,1997.0,1.0,1,0,0,1,0,1,2,50.0,1,0,0,0,2,3,0,0,"MF,DF",20-24,Midfielder,Spain,Europe
1021,Sergio González,ESP,Cádiz,La Liga,2020,23.0,1997.0,1.0,1,0,0,1,0,1,2,50.0,1,0,0,0,2,3,0,0,"MF,DF",20-24,Midfielder,Spain,Europe
1021,Sergio González,ESP,Cádiz,La Liga,2020,23.0,1997.0,1.0,1,0,0,1,0,1,2,50.0,1,0,0,0,2,3,0,0,"MF,DF",20-24,Midfielder,Spain,Europe
1025,Andoni Gorosabel,ESP,Real Sociedad,La Liga,2020,23.0,1996.0,26.5,76,43,45,20,11,27,64,42.2,37,25,4,21,23,99,42,0,DF,20-24,Defender,Spain,Europe
1049,Kamil Grosicki,POL,West Brom,Premier League,2020,32.0,1988.0,1.6,2,1,2,0,0,2,8,25.0,6,1,0,1,2,4,1,0,"MF,FW",30-34,Midfielder,Poland,Europe
1052,Vicente Guaita,ESP,Crystal Palace,Premier League,2020,33.0,1987.0,37.0,1,1,1,0,0,1,1,100.0,0,0,0,0,1,2,11,1,GK,30-34,Goalkeeper,Spain,Europe
1054,Sergi Guardiola,ESP,Valladolid,La Liga,2020,29.0,1991.0,19.9,11,5,1,5,5,2,27,7.4,25,12,1,11,7,18,16,3,FW,25-29,Forward,Spain,Europe
1055,Nemanja Gudelj,SRB,Sevilla,La Liga,2020,28.0,1991.0,11.6,23,12,16,5,2,4,10,40.0,6,10,6,4,24,47,24,2,"MF,DF",25-29,Midfielder,Serbia,Europe
1061,Ander Guevara,ESP,Real Sociedad,La Liga,2020,23.0,1997.0,23.1,35,23,15,16,4,15,30,50.0,15,19,5,14,25,60,35,1,MF,20-24,Midfielder,Spain,Europe
1067,Hugo Guillamón,ESP,Valencia,La Liga,2020,20.0,2000.0,22.1,23,13,17,6,0,8,20,40.0,12,19,14,5,27,50,102,3,DF,20-24,Defender,Spain,Europe
1072,Robert Gumny,POL,Augsburg,Bundesliga,2020,22.0,1998.0,15.3,24,15,12,9,3,15,23,65.2,8,12,2,10,18,42,31,0,DF,20-24,Defender,Poland,Europe
1076,Jon Guridi,ESP,Real Sociedad,La Liga,2020,25.0,1995.0,9.2,19,9,10,6,3,8,22,36.4,14,8,1,7,10,29,9,0,MF,25-29,Midfielder,Spain,Europe
1078,Raúl Guti,ESP,Elche,La Liga,2020,23.0,1996.0,31.8,48,28,21,22,5,16,52,30.8,36,25,3,22,49,97,25,0,MF,20-24,Midfielder,Spain,Europe
1080,Miguel Gutiérrez,ESP,Real Madrid,La Liga,2020,19.0,2001.0,3.5,4,0,0,3,1,1,7,14.3,6,3,0,3,5,9,5,0,DF,Under 20,Defender,Spain,Europe
1083,Erling Haaland,NOR,Dortmund,Bundesliga,2020,20.0,2000.0,26.7,7,2,1,3,3,1,4,25.0,3,19,4,15,4,11,16,0,FW,20-24,Forward,Norway,Europe
1123,Mario Hermoso,ESP,Atlético Madrid,La Liga,2020,25.0,1995.0,28.6,55,31,40,11,4,37,61,60.7,24,23,10,13,36,91,73,0,DF,25-29,Defender,Spain,Europe
1124,Aridane Hernández,ESP,Osasuna,La Liga,2020,31.0,1989.0,22.5,20,11,13,6,1,7,12,58.3,5,22,19,3,34,54,127,1,DF,30-34,Defender,Spain,Europe
1126,Pablo Hernández,ESP,Leeds United,Premier League,2020,35.0,1985.0,4.7,5,3,2,1,2,5,16,31.3,11,2,0,2,0,5,0,1,MF,35-39,Midfielder,Spain,Europe
1126,Pablo Hernández,ESP,Leeds United,Premier League,2020,35.0,1985.0,4.7,5,3,2,1,2,5,16,31.3,11,2,0,2,0,5,0,1,MF,35-39,Midfielder,Spain,Europe
1126,Pablo Hernández,ESP,Leeds United,Premier League,2020,35.0,1985.0,4.7,5,3,2,1,2,5,16,31.3,11,2,0,2,0,5,0,1,MF,35-39,Midfielder,Spain,Europe
1126,Pablo Hernández,ESP,Leeds United,Premier League,2020,35.0,1985.0,4.7,5,3,2,1,2,5,16,31.3,11,2,0,2,0,5,0,1,MF,35-39,Midfielder,Spain,Europe
1129,Ander Herrera,ESP,Paris S-G,Ligue 1,2020,30.0,1989.0,20.6,53,35,17,26,10,30,77,39.0,47,31,5,26,31,84,22,1,MF,30-34,Midfielder,Spain,Europe
1131,Sergio Herrera,ESP,Osasuna,La Liga,2020,27.0,1993.0,32.9,0,0,0,0,0,0,2,0.0,2,0,0,0,3,3,29,3,GK,25-29,Goalkeeper,Spain,Europe
1134,Pablo Hervías,ESP,Valladolid,La Liga,2020,27.0,1993.0,13.4,19,12,7,9,3,9,26,34.6,17,6,0,6,11,30,8,0,"DF,MF",25-29,Defender,Spain,Europe
1178,Borja Iglesias,ESP,Betis,La Liga,2020,27.0,1993.0,15.7,1,1,0,0,1,1,8,12.5,7,7,2,5,3,4,9,0,FW,25-29,Forward,Spain,Europe
1183,Ivan Ilić,SRB,Hellas Verona,Serie A,2020,19.0,2001.0,20.4,26,14,11,11,4,7,21,33.3,14,17,5,12,27,53,26,0,MF,Under 20,Midfielder,Serbia,Europe
1185,Asier Illarramendi,ESP,Real Sociedad,La Liga,2020,30.0,1990.0,3.7,5,2,1,4,0,1,5,20.0,4,2,0,2,5,10,7,0,MF,30-34,Midfielder,Spain,Europe
1194,Pablo Insua,ESP,Huesca,La Liga,2020,26.0,1993.0,17.6,37,18,26,9,2,14,31,45.2,17,14,8,6,24,61,68,0,DF,25-29,Defender,Spain,Europe
1198,Isco,ESP,Real Madrid,La Liga,2020,28.0,1992.0,10.1,13,9,5,5,3,2,14,14.3,12,7,1,6,2,15,2,0,MF,25-29,Midfielder,Spain,Europe
1203,Jairo Izquierdo,ESP,Cádiz,La Liga,2020,26.0,1993.0,14.2,21,13,13,8,0,12,31,38.7,19,7,1,6,14,35,12,0,"MF,DF",25-29,Midfielder,Spain,Europe
1214,Jakub Jankto,CZE,Sampdoria,Serie A,2020,24.0,1996.0,26.8,28,17,14,7,7,11,35,31.4,24,16,1,15,24,52,34,0,MF,20-24,Midfielder,Czech Republic,Europe
1217,Rune Jarstein,NOR,Hertha BSC,Bundesliga,2020,35.0,1984.0,8.0,0,0,0,0,0,0,0,,0,0,0,0,0,0,7,1,GK,35-39,Goalkeeper,Norway,Europe
1224,Jesé,ESP,Paris S-G,Ligue 1,2020,27.0,1993.0,0.3,0,0,0,0,0,0,1,0.0,1,0,0,0,0,0,0,0,FW,25-29,Forward,Spain,Europe
1228,Joaquín,ESP,Betis,La Liga,2020,39.0,1981.0,14.3,9,3,1,5,3,4,12,33.3,8,8,0,8,17,26,11,0,"FW,MF",35-39,Forward,Spain,Europe
1237,Jony,ESP,Osasuna,La Liga,2020,29.0,1991.0,9.7,7,3,1,2,4,5,20,25.0,15,5,0,5,14,21,3,0,"MF,FW",25-29,Midfielder,Spain,Europe
1238,Joan Jordán,ESP,Sevilla,La Liga,2020,26.0,1994.0,26.7,52,28,17,29,6,17,76,22.4,59,22,3,19,27,79,25,0,MF,25-29,Midfielder,Spain,Europe
1240,Josan,ESP,Elche,La Liga,2020,30.0,1989.0,21.4,34,18,23,11,0,13,39,33.3,26,24,1,23,21,55,26,1,"MF,DF",30-34,Midfielder,Spain,Europe
1243,Joselu,ESP,Alavés,La Liga,2020,30.0,1990.0,33.6,27,14,6,15,6,8,28,28.6,20,26,3,23,15,42,58,1,FW,30-34,Forward,Spain,Europe
1244,Josema,ESP,Elche,La Liga,2020,24.0,1996.0,21.8,43,28,33,10,0,10,18,55.6,8,17,7,10,37,80,92,0,DF,20-24,Defender,Spain,Europe
1249,Luka Jović,SRB,Real Madrid,La Liga,2020,22.0,1997.0,1.7,0,0,0,0,0,0,0,,0,0,0,0,0,0,0,0,FW,20-24,Forward,Serbia,Europe
1250,Luka Jović,SRB,Eint Frankfurt,Bundesliga,2020,22.0,1997.0,9.9,2,0,0,2,0,0,4,0.0,4,3,0,3,1,3,7,0,FW,20-24,Forward,Serbia,Europe
1251,Juanmi,ESP,Betis,La Liga,2020,27.0,1993.0,6.7,13,9,3,5,5,4,18,22.2,14,4,0,4,2,15,4,0,"FW,MF",25-29,Forward,Spain,Europe
1279,Kevin Kampl,SVN,RB Leipzig,Bundesliga,2020,29.0,1990.0,21.5,38,26,9,24,5,18,35,51.4,17,20,2,18,29,67,14,0,MF,25-29,Midfielder,Slovenia,Europe
1320,Joshua King,NOR,Everton,Premier League,2020,28.0,1992.0,1.6,4,1,2,1,1,0,0,,0,3,0,3,1,5,1,0,"MF,FW",25-29,Midfielder,Norway,Europe
1327,Mateusz Klich,POL,Leeds United,Premier League,2020,30.0,1990.0,26.6,38,20,14,20,4,14,61,23.0,47,13,4,9,11,49,16,0,MF,30-34,Midfielder,Poland,Europe
1344,Koke,ESP,Atlético Madrid,La Liga,2020,28.0,1992.0,33.6,64,42,22,31,11,28,98,28.6,70,35,6,29,36,100,40,0,MF,25-29,Midfielder,Spain,Europe
1346,Aleksandar Kolarov,SRB,Inter,Serie A,2020,34.0,1985.0,4.3,4,4,0,4,0,1,2,50.0,1,2,0,2,7,11,8,0,DF,30-34,Defender,Serbia,Europe
1400,Víctor Laguardia,ESP,Alavés,La Liga,2020,30.0,1989.0,29.2,20,12,13,6,1,14,31,45.2,17,25,13,12,37,57,104,0,DF,30-34,Defender,Spain,Europe
1413,Aymeric Laporte,ESP,Manchester City,Premier League,2020,26.0,1994.0,14.9,13,6,10,3,0,7,11,63.6,4,12,7,5,11,24,28,0,DF,25-29,Defender,Spain,Europe
1421,Toni Lato,ESP,Valencia,La Liga,2020,22.0,1997.0,8.1,13,6,7,3,3,6,13,46.2,7,12,1,11,10,23,21,0,DF,20-24,Defender,Spain,Europe
1428,Darko Lazović,SRB,Hellas Verona,Serie A,2020,29.0,1990.0,27.8,29,17,8,17,4,20,42,47.6,22,17,7,10,20,49,29,0,"DF,MF",25-29,Defender,Serbia,Europe
1434,Robin Le Normand,ESP,Real Sociedad,La Liga,2020,23.0,1996.0,30.5,34,20,25,8,1,9,19,47.4,10,35,24,11,36,70,87,1,DF,20-24,Defender,Spain,Europe
1445,Iñigo Lekue,ESP,Athletic Club,La Liga,2020,27.0,1993.0,7.2,9,7,6,3,0,3,8,37.5,5,8,1,7,4,13,24,0,DF,25-29,Defender,Spain,Europe
1452,Pedro León,ESP,Eibar,La Liga,2020,33.0,1986.0,10.4,9,8,3,3,3,3,17,17.6,14,11,0,11,7,16,2,0,"MF,FW",30-34,Midfielder,Spain,Europe
1453,Sergio León,ESP,Levante,La Liga,2020,31.0,1989.0,8.3,6,2,0,4,2,2,8,25.0,6,4,0,4,3,9,2,0,FW,30-34,Forward,Spain,Europe
1459,Robert Lewandowski,POL,Bayern Munich,Bundesliga,2020,31.0,1988.0,27.3,15,9,0,7,8,2,13,15.4,11,9,1,8,3,18,11,0,FW,30-34,Forward,Poland,Europe
1460,Jamal Lewis,NIR,Newcastle Utd,Premier League,2020,22.0,1998.0,20.4,37,20,23,13,1,16,38,42.1,22,21,7,14,11,48,44,1,DF,20-24,Defender,Northern Ireland,Europe
1469,Karol Linetty,POL,Torino,Serie A,2020,25.0,1995.0,20.4,38,28,13,19,6,16,45,35.6,29,19,5,14,15,53,7,0,MF,25-29,Midfielder,Poland,Europe
1471,Pol Lirola,ESP,Fiorentina,Serie A,2020,22.0,1997.0,5.5,13,8,8,2,3,6,12,50.0,6,6,3,3,6,19,9,0,"DF,FW",20-24,Defender,Spain,Europe
1472,Pol Lirola,ESP,Marseille,Ligue 1,2020,22.0,1997.0,17.3,28,16,11,15,2,16,28,57.1,12,18,5,13,25,53,26,0,"DF,FW",20-24,Defender,Spain,Europe
1474,Diego Llorente,ESP,Leeds United,Premier League,2020,26.0,1993.0,13.4,34,21,21,13,0,19,32,59.4,13,18,13,5,20,54,40,2,DF,25-29,Defender,Spain,Europe
1474,Diego Llorente,ESP,Leeds United,Premier League,2020,26.0,1993.0,13.4,34,21,21,13,0,19,32,59.4,13,18,13,5,20,54,40,2,DF,25-29,Defender,Spain,Europe
1474,Diego Llorente,ESP,Leeds United,Premier League,2020,26.0,1993.0,13.4,34,21,21,13,0,19,32,59.4,13,18,13,5,20,54,40,2,DF,25-29,Defender,Spain,Europe
1474,Diego Llorente,ESP,Leeds United,Premier League,2020,26.0,1993.0,13.4,34,21,21,13,0,19,32,59.4,13,18,13,5,20,54,40,2,DF,25-29,Defender,Spain,Europe
1475,Diego Llorente,ESP,Real Sociedad,La Liga,2020,26.0,1993.0,1.0,1,0,1,0,0,1,2,50.0,1,1,1,0,2,3,5,0,DF,25-29,Defender,Spain,Europe
1475,Diego Llorente,ESP,Real Sociedad,La Liga,2020,26.0,1993.0,1.0,1,0,1,0,0,1,2,50.0,1,1,1,0,2,3,5,0,DF,25-29,Defender,Spain,Europe
1475,Diego Llorente,ESP,Real Sociedad,La Liga,2020,26.0,1993.0,1.0,1,0,1,0,0,1,2,50.0,1,1,1,0,2,3,5,0,DF,25-29,Defender,Spain,Europe
1475,Diego Llorente,ESP,Real Sociedad,La Liga,2020,26.0,1993.0,1.0,1,0,1,0,0,1,2,50.0,1,1,1,0,2,3,5,0,DF,25-29,Defender,Spain,Europe
1476,Fernando Llorente,ESP,Udinese,Serie A,2020,35.0,1985.0,7.9,4,1,2,2,0,2,5,40.0,3,3,0,3,2,6,17,0,FW,35-39,Forward,Spain,Europe
1477,Fernando Llorente,ESP,Napoli,Serie A,2020,35.0,1985.0,0.6,0,0,0,0,0,0,0,,0,0,0,0,0,0,0,0,"FW,MF",35-39,Forward,Spain,Europe
1478,Marcos Llorente,ESP,Atlético Madrid,La Liga,2020,25.0,1995.0,32.8,71,42,21,40,10,26,62,41.9,36,40,3,37,29,100,28,0,"MF,FW",25-29,Midfielder,Spain,Europe
1494,Adrián López,ESP,Osasuna,La Liga,2020,32.0,1988.0,5.3,3,3,0,1,2,1,5,20.0,4,3,0,3,0,3,3,0,"FW,MF",30-34,Forward,Spain,Europe
1494,Adrián López,ESP,Osasuna,La Liga,2020,32.0,1988.0,5.3,3,3,0,1,2,1,5,20.0,4,3,0,3,0,3,3,0,"FW,MF",30-34,Forward,Spain,Europe
1494,Adrián López,ESP,Osasuna,La Liga,2020,32.0,1988.0,5.3,3,3,0,1,2,1,5,20.0,4,3,0,3,0,3,3,0,"FW,MF",30-34,Forward,Spain,Europe
1494,Adrián López,ESP,Osasuna,La Liga,2020,32.0,1988.0,5.3,3,3,0,1,2,1,5,20.0,4,3,0,3,0,3,3,0,"FW,MF",30-34,Forward,Spain,Europe
1495,Javi López,ESP,Alavés,La Liga,2020,18.0,2002.0,2.8,5,5,3,2,0,2,3,66.7,1,2,0,2,3,8,3,1,"DF,MF",Under 20,Defender,Spain,Europe
1495,Javi López,ESP,Alavés,La Liga,2020,18.0,2002.0,2.8,5,5,3,2,0,2,3,66.7,1,2,0,2,3,8,3,1,"DF,MF",Under 20,Defender,Spain,Europe
1495,Javi López,ESP,Alavés,La Liga,2020,18.0,2002.0,2.8,5,5,3,2,0,2,3,66.7,1,2,0,2,3,8,3,1,"DF,MF",Under 20,Defender,Spain,Europe
1495,Javi López,ESP,Alavés,La Liga,2020,18.0,2002.0,2.8,5,5,3,2,0,2,3,66.7,1,2,0,2,3,8,3,1,"DF,MF",Under 20,Defender,Spain,Europe
1499,Pau López,ESP,Roma,Serie A,2020,25.0,1994.0,20.2,2,0,2,0,0,2,2,100.0,0,1,0,1,0,2,7,4,GK,25-29,Goalkeeper,Spain,Europe
1500,Roberto López,ESP,Real Sociedad,La Liga,2020,20.0,2000.0,5.6,5,1,1,2,2,2,5,40.0,3,2,0,2,4,9,6,0,"MF,FW",20-24,Midfielder,Spain,Europe
1501,Unai López,ESP,Athletic Club,La Liga,2020,24.0,1995.0,15.8,27,17,13,13,1,10,29,34.5,19,20,5,15,18,45,9,1,MF,20-24,Midfielder,Spain,Europe
1520,José Luis Morales,ESP,Levante,La Liga,2020,33.0,1987.0,27.1,18,10,7,9,2,8,36,22.2,28,17,0,17,11,29,11,0,"MF,FW",30-34,Midfielder,Spain,Europe
1528,Saša Lukić,SRB,Torino,Serie A,2020,23.0,1996.0,23.4,32,13,11,18,3,15,50,30.0,35,23,5,18,17,49,17,0,MF,20-24,Midfielder,Serbia,Europe
1543,Pablo Maffeo,ESP,Huesca,La Liga,2020,23.0,1997.0,21.8,26,17,21,4,1,12,26,46.2,14,18,6,12,35,61,27,0,DF,20-24,Defender,Spain,Europe
1568,Nikola Maksimović,SRB,Napoli,Serie A,2020,28.0,1991.0,13.4,18,9,11,6,1,9,18,50.0,9,15,6,9,21,39,49,3,DF,25-29,Defender,Serbia,Europe
1594,Javier Manquillo,ESP,Newcastle Utd,Premier League,2020,26.0,1994.0,9.2,24,14,8,14,2,11,17,64.7,6,8,1,7,9,33,15,1,DF,25-29,Defender,Spain,Europe
1608,Óscar de Marcos,ESP,Athletic Club,La Liga,2020,31.0,1989.0,16.9,28,17,12,10,6,10,25,40.0,15,12,1,11,12,40,38,0,"DF,MF",30-34,Defender,Spain,Europe
1610,José Mari,ESP,Cádiz,La Liga,2020,32.0,1987.0,16.1,32,17,13,18,1,14,31,45.2,17,16,7,9,27,59,33,1,MF,30-34,Midfielder,Spain,Europe
1611,Pablo Marí,ESP,Arsenal,Premier League,2020,26.0,1993.0,10.0,15,9,12,3,0,5,10,50.0,5,8,7,1,9,24,30,2,DF,25-29,Defender,Spain,Europe
1623,Roger Martí,ESP,Levante,La Liga,2020,29.0,1991.0,24.4,11,7,5,4,2,6,23,26.1,17,10,3,7,4,15,6,0,FW,25-29,Forward,Spain,Europe
1625,Aarón Martín,ESP,Celta Vigo,La Liga,2020,23.0,1997.0,17.1,34,20,15,16,3,10,33,30.3,23,15,4,11,13,47,37,0,DF,20-24,Defender,Spain,Europe
1626,Aarón Martín,ESP,Mainz 05,Bundesliga,2020,23.0,1997.0,2.9,3,2,2,1,0,2,4,50.0,2,1,0,1,2,5,2,0,"DF,FW",20-24,Defender,Spain,Europe
1627,Álex Martín,ESP,Cádiz,La Liga,2020,22.0,1998.0,1.1,2,0,1,1,0,2,4,50.0,2,1,1,0,0,2,6,0,DF,20-24,Defender,Spain,Europe
1631,Iñigo Martínez,ESP,Athletic Club,La Liga,2020,29.0,1991.0,28.0,22,15,16,6,0,9,27,33.3,18,17,7,10,28,50,96,0,DF,25-29,Defender,Spain,Europe
1632,Javi Martínez,ESP,Osasuna,La Liga,2020,20.0,1999.0,5.1,9,4,1,6,2,5,12,41.7,7,9,0,9,5,14,4,0,"MF,FW",20-24,Midfielder,Spain,Europe
1632,Javi Martínez,ESP,Osasuna,La Liga,2020,20.0,1999.0,5.1,9,4,1,6,2,5,12,41.7,7,9,0,9,5,14,4,0,"MF,FW",20-24,Midfielder,Spain,Europe
1632,Javi Martínez,ESP,Osasuna,La Liga,2020,20.0,1999.0,5.1,9,4,1,6,2,5,12,41.7,7,9,0,9,5,14,4,0,"MF,FW",20-24,Midfielder,Spain,Europe
1632,Javi Martínez,ESP,Osasuna,La Liga,2020,20.0,1999.0,5.1,9,4,1,6,2,5,12,41.7,7,9,0,9,5,14,4,0,"MF,FW",20-24,Midfielder,Spain,Europe
1633,Javi Martínez,ESP,Bayern Munich,Bundesliga,2020,31.0,1988.0,5.2,10,5,4,4,2,7,9,77.8,2,8,4,4,13,23,19,0,"DF,MF",30-34,Defender,Spain,Europe
1633,Javi Martínez,ESP,Bayern Munich,Bundesliga,2020,31.0,1988.0,5.2,10,5,4,4,2,7,9,77.8,2,8,4,4,13,23,19,0,"DF,MF",30-34,Defender,Spain,Europe
1633,Javi Martínez,ESP,Bayern Munich,Bundesliga,2020,31.0,1988.0,5.2,10,5,4,4,2,7,9,77.8,2,8,4,4,13,23,19,0,"DF,MF",30-34,Defender,Spain,Europe
1633,Javi Martínez,ESP,Bayern Munich,Bundesliga,2020,31.0,1988.0,5.2,10,5,4,4,2,7,9,77.8,2,8,4,4,13,23,19,0,"DF,MF",30-34,Defender,Spain,Europe
1644,Jordi Masip,ESP,Valladolid,La Liga,2020,31.0,1989.0,25.0,0,0,0,0,0,0,2,0.0,2,2,0,2,2,2,8,1,GK,30-34,Goalkeeper,Spain,Europe
1648,Jaime Mata,ESP,Getafe,La Liga,2020,31.0,1988.0,22.6,12,7,1,3,8,3,18,16.7,15,13,2,11,6,18,16,0,FW,30-34,Forward,Spain,Europe
1666,Borja Mayoral,ESP,Roma,Serie A,2020,23.0,1997.0,17.2,3,2,0,0,3,1,10,10.0,9,5,0,5,0,3,5,2,FW,20-24,Forward,Spain,Europe
1667,Borja Mayoral,ESP,Real Madrid,La Liga,2020,23.0,1997.0,0.3,0,0,0,0,0,0,1,0.0,1,0,0,0,0,0,0,0,FW,20-24,Forward,Spain,Europe
1695,Gonzalo Melero,ESP,Levante,La Liga,2020,26.0,1994.0,20.6,24,15,11,6,7,10,39,25.6,29,14,5,9,18,42,22,1,"MF,FW",25-29,Midfielder,Spain,Europe
1702,Brais Méndez,ESP,Celta Vigo,La Liga,2020,23.0,1997.0,29.7,59,31,23,27,9,16,65,24.6,49,27,2,25,32,91,34,0,"MF,FW",20-24,Midfielder,Spain,Europe
1713,Jorge Meré,ESP,Köln,Bundesliga,2020,23.0,1997.0,14.4,13,6,9,3,1,6,13,46.2,7,14,11,3,15,28,63,0,DF,20-24,Defender,Spain,Europe
1715,Mikel Merino,ESP,Real Sociedad,La Liga,2020,24.0,1996.0,23.9,61,36,14,36,11,18,45,40.0,27,36,8,28,32,93,26,0,MF,20-24,Midfielder,Spain,Europe
1716,Martín Merquelanz,ESP,Real Sociedad,La Liga,2020,25.0,1995.0,6.1,9,3,3,2,4,2,7,28.6,5,7,1,6,3,12,4,0,"MF,FW",25-29,Midfielder,Spain,Europe
1719,Roque Mesa,ESP,Valladolid,La Liga,2020,31.0,1989.0,19.6,46,29,18,24,4,20,47,42.6,27,11,2,9,14,60,23,1,MF,30-34,Midfielder,Spain,Europe
1734,Nikola Milenković,SRB,Fiorentina,Serie A,2020,22.0,1997.0,33.7,49,29,33,14,2,21,33,63.6,12,42,33,9,44,93,122,1,DF,20-24,Defender,Serbia,Europe
1735,Arkadiusz Milik,POL,Marseille,Ligue 1,2020,26.0,1994.0,13.6,14,9,0,7,7,2,12,16.7,10,5,1,4,2,16,9,0,FW,25-29,Forward,Poland,Europe
1736,Sergej Milinković-Savić,SRB,Lazio,Serie A,2020,25.0,1995.0,30.5,59,40,20,30,9,27,84,32.1,57,52,12,40,33,92,47,0,MF,25-29,Midfielder,Serbia,Europe
1737,Vanja Milinković-Savić,SRB,Torino,Serie A,2020,23.0,1997.0,5.0,1,1,1,0,0,1,1,100.0,0,0,0,0,0,1,1,3,GK,20-24,Goalkeeper,Serbia,Europe
1740,Luis Milla,ESP,Granada,La Liga,2020,25.0,1994.0,13.9,22,11,11,10,1,6,28,21.4,22,10,0,10,24,46,16,1,MF,25-29,Midfielder,Spain,Europe
1741,Pere Milla,ESP,Elche,La Liga,2020,27.0,1992.0,22.0,24,17,12,10,2,8,37,21.6,29,17,5,12,13,37,17,1,"FW,MF",25-29,Forward,Spain,Europe
1746,Santi Mina,ESP,Celta Vigo,La Liga,2020,24.0,1995.0,26.8,31,13,9,12,10,6,37,16.2,31,15,3,12,6,37,17,0,FW,20-24,Forward,Spain,Europe
1751,Óscar Mingueza,ESP,Barcelona,La Liga,2020,21.0,1999.0,21.1,52,33,28,17,7,30,53,56.6,23,19,6,13,20,72,48,2,DF,20-24,Defender,Spain,Europe
1752,Rafa Mir,ESP,Huesca,La Liga,2020,23.0,1997.0,32.0,15,9,4,4,7,7,22,31.8,15,14,2,12,15,30,25,0,FW,20-24,Forward,Spain,Europe
1753,Jorge Miramón,ESP,Levante,La Liga,2020,31.0,1989.0,19.2,32,22,26,6,0,21,35,60.0,14,22,2,20,27,59,54,0,DF,30-34,Defender,Spain,Europe
1755,Juan Miranda,ESP,Betis,La Liga,2020,20.0,2000.0,18.4,27,11,16,9,2,16,32,50.0,16,18,2,16,29,56,58,1,DF,20-24,Defender,Spain,Europe
1758,Aleksandar Mitrović,SRB,Fulham,Premier League,2020,25.0,1994.0,15.6,7,4,0,3,4,2,8,25.0,6,12,3,9,3,10,8,0,FW,25-29,Forward,Serbia,Europe
1772,Guillem Molina,ESP,Valencia,La Liga,2020,20.0,2000.0,1.7,1,0,1,0,0,0,5,0.0,5,1,1,0,4,5,5,0,DF,20-24,Defender,Spain,Europe
1773,Jorge Molina,ESP,Granada,La Liga,2020,38.0,1982.0,17.9,11,4,3,5,3,8,22,36.4,14,5,1,4,3,14,19,0,FW,35-39,Forward,Spain,Europe
1780,Jon Moncayola,ESP,Osasuna,La Liga,2020,22.0,1998.0,29.6,61,36,27,23,11,24,67,35.8,43,27,9,18,23,84,38,0,MF,20-24,Midfielder,Spain,Europe
1784,Nacho Monreal,ESP,Real Sociedad,La Liga,2020,34.0,1986.0,23.1,31,19,17,11,3,7,20,35.0,13,14,3,11,31,62,43,0,DF,30-34,Defender,Spain,Europe
1787,Ángel Montoro,ESP,Granada,La Liga,2020,32.0,1988.0,15.1,15,9,7,7,1,4,16,25.0,12,13,3,10,22,37,21,0,MF,30-34,Midfielder,Spain,Europe
1794,Jon Morcillo,ESP,Athletic Club,La Liga,2020,21.0,1998.0,15.1,16,9,3,6,7,7,30,23.3,23,9,0,9,15,31,11,0,"MF,FW",20-24,Midfielder,Spain,Europe
1796,Alberto Moreno,ESP,Villarreal,La Liga,2020,28.0,1992.0,2.1,7,4,7,0,0,2,5,40.0,3,2,1,1,3,10,2,0,DF,25-29,Defender,Spain,Europe
1796,Alberto Moreno,ESP,Villarreal,La Liga,2020,28.0,1992.0,2.1,7,4,7,0,0,2,5,40.0,3,2,1,1,3,10,2,0,DF,25-29,Defender,Spain,Europe
1796,Alberto Moreno,ESP,Villarreal,La Liga,2020,28.0,1992.0,2.1,7,4,7,0,0,2,5,40.0,3,2,1,1,3,10,2,0,DF,25-29,Defender,Spain,Europe
1796,Alberto Moreno,ESP,Villarreal,La Liga,2020,28.0,1992.0,2.1,7,4,7,0,0,2,5,40.0,3,2,1,1,3,10,2,0,DF,25-29,Defender,Spain,Europe
1797,Álex Moreno,ESP,Betis,La Liga,2020,27.0,1993.0,19.8,42,26,25,12,5,20,43,46.5,23,18,4,14,35,77,48,0,DF,25-29,Defender,Spain,Europe
1798,Gerard Moreno,ESP,Villarreal,La Liga,2020,28.0,1992.0,29.7,24,15,8,10,6,7,34,20.6,27,17,4,13,15,39,26,0,FW,25-29,Forward,Spain,Europe
1799,Tete Morente,ESP,Elche,La Liga,2020,23.0,1996.0,22.4,31,17,17,9,5,9,39,23.1,30,20,0,20,13,44,28,0,"MF,FW",20-24,Midfielder,Spain,Europe
1800,Mateu Morey,ESP,Dortmund,Bundesliga,2020,20.0,2000.0,9.2,13,7,4,7,2,9,12,75.0,3,6,1,5,18,31,7,1,DF,20-24,Defender,Spain,Europe
1805,Pedro Mosquera,ESP,Huesca,La Liga,2020,32.0,1988.0,22.8,38,18,19,18,1,13,53,24.5,40,23,6,17,31,69,38,1,MF,30-34,Midfielder,Spain,Europe
1817,Javi Moyano,ESP,Valladolid,La Liga,2020,34.0,1986.0,1.1,0,0,0,0,0,0,0,,0,2,0,2,0,0,2,0,DF,30-34,Defender,Spain,Europe
1825,Iker Muniain,ESP,Athletic Club,La Liga,2020,27.0,1992.0,21.6,20,7,4,10,6,6,24,25.0,18,15,0,15,11,31,4,0,"MF,FW",25-29,Midfielder,Spain,Europe
1826,Aihen Muñoz,ESP,Real Sociedad,La Liga,2020,22.0,1997.0,13.4,23,16,15,5,3,11,19,57.9,8,12,2,10,10,33,31,0,DF,20-24,Defender,Spain,Europe
1827,Joaquín Muñoz,ESP,Huesca,La Liga,2020,21.0,1999.0,0.5,0,0,0,0,0,0,2,0.0,2,0,0,0,1,1,0,0,FW,20-24,Forward,Spain,Europe
1857,Matija Nastasić,SRB,Schalke 04,Bundesliga,2020,27.0,1993.0,13.6,11,7,9,2,0,9,16,56.3,7,22,18,4,26,37,51,1,DF,25-29,Defender,Serbia,Europe
1860,Jesús Navas,ESP,Sevilla,La Liga,2020,34.0,1985.0,31.4,27,21,15,11,1,15,22,68.2,7,10,3,7,37,64,62,1,DF,30-34,Defender,Spain,Europe
1862,Raúl Navas,ESP,Osasuna,La Liga,2020,32.0,1988.0,1.9,6,3,5,1,0,4,6,66.7,2,0,0,0,3,9,13,0,DF,30-34,Defender,Spain,Europe
1870,Álvaro Negredo,ESP,Cádiz,La Liga,2020,34.0,1985.0,24.4,11,5,3,4,4,5,11,45.5,6,7,2,5,3,14,19,0,FW,30-34,Forward,Spain,Europe
1878,Carlos Neva,ESP,Granada,La Liga,2020,24.0,1996.0,20.0,12,6,6,6,0,6,11,54.5,5,16,4,12,27,39,58,0,DF,20-24,Defender,Spain,Europe
1893,Saúl Ñíguez,ESP,Atlético Madrid,La Liga,2020,25.0,1994.0,22.6,57,34,27,23,7,30,59,50.8,29,35,2,33,19,76,43,0,"MF,DF",25-29,Midfielder,Spain,Europe
1896,Nino,ESP,Elche,La Liga,2020,40.0,1980.0,3.2,0,0,0,0,0,0,1,0.0,1,1,0,1,0,0,0,0,"FW,MF",Over 40,Forward,Spain,Europe
1896,Nino,ESP,Elche,La Liga,2020,40.0,1980.0,3.2,0,0,0,0,0,0,1,0.0,1,1,0,1,0,0,0,0,"FW,MF",Over 40,Forward,Spain,Europe
1896,Nino,ESP,Elche,La Liga,2020,40.0,1980.0,3.2,0,0,0,0,0,0,1,0.0,1,1,0,1,0,0,0,0,"FW,MF",Over 40,Forward,Spain,Europe
1896,Nino,ESP,Elche,La Liga,2020,40.0,1980.0,3.2,0,0,0,0,0,0,1,0.0,1,1,0,1,0,0,0,0,"FW,MF",Over 40,Forward,Spain,Europe
1904,Nolito,ESP,Celta Vigo,La Liga,2020,33.0,1986.0,28.9,70,36,30,30,10,32,92,34.8,60,46,2,44,22,92,19,0,"MF,FW",30-34,Midfielder,Spain,Europe
1908,Oliver Norwood,NIR,Sheffield Utd,Premier League,2020,29.0,1991.0,24.7,49,22,16,28,5,21,72,29.2,51,29,12,17,36,85,51,1,MF,25-29,Midfielder,Northern Ireland,Europe
1912,Unai Núñez,ESP,Athletic Club,La Liga,2020,23.0,1997.0,23.4,23,12,16,7,0,10,15,66.7,5,19,14,5,32,55,110,0,DF,20-24,Defender,Spain,Europe
1924,Jan Oblak,SVN,Atlético Madrid,La Liga,2020,27.0,1993.0,38.0,0,0,0,0,0,0,0,,0,0,0,0,0,0,6,2,GK,25-29,Goalkeeper,Slovenia,Europe
1929,Álvaro Odriozola,ESP,Real Madrid,La Liga,2020,24.0,1995.0,9.2,14,7,5,8,1,3,5,60.0,2,6,3,3,6,20,12,1,DF,20-24,Defender,Spain,Europe
1938,Kiko Olivas,ESP,Valladolid,La Liga,2020,31.0,1988.0,2.0,3,2,2,1,0,3,5,60.0,2,2,2,0,7,10,3,0,DF,30-34,Defender,Spain,Europe
1942,Dani Olmo,ESP,RB Leipzig,Bundesliga,2020,22.0,1998.0,24.4,23,14,6,13,4,4,23,17.4,19,15,0,15,13,36,21,0,MF,20-24,Midfielder,Spain,Europe
1971,Mikel Oyarzabal,ESP,Real Sociedad,La Liga,2020,23.0,1997.0,26.8,30,17,14,12,4,10,31,32.3,21,30,5,25,15,45,17,0,"FW,MF",20-24,Forward,Spain,Europe
1976,Fernando Pacheco,ESP,Alavés,La Liga,2020,28.0,1992.0,37.2,2,0,2,0,0,2,4,50.0,2,0,0,0,2,4,19,0,GK,25-29,Goalkeeper,Spain,Europe
1976,Fernando Pacheco,ESP,Alavés,La Liga,2020,28.0,1992.0,37.2,2,0,2,0,0,2,4,50.0,2,0,0,0,2,4,19,0,GK,25-29,Goalkeeper,Spain,Europe
1976,Fernando Pacheco,ESP,Alavés,La Liga,2020,28.0,1992.0,37.2,2,0,2,0,0,2,4,50.0,2,0,0,0,2,4,19,0,GK,25-29,Goalkeeper,Spain,Europe
1976,Fernando Pacheco,ESP,Alavés,La Liga,2020,28.0,1992.0,37.2,2,0,2,0,0,2,4,50.0,2,0,0,0,2,4,19,0,GK,25-29,Goalkeeper,Spain,Europe
1977,Jon Pacheco,ESP,Real Sociedad,La Liga,2020,19.0,2001.0,0.4,0,0,0,0,0,0,0,,0,0,0,0,1,1,0,0,DF,Under 20,Defender,Spain,Europe
1990,Martin Palumbo,NOR,Udinese,Serie A,2020,18.0,2002.0,0.7,0,0,0,0,0,0,0,,0,5,0,5,1,1,0,0,MF,Under 20,Midfielder,Norway,Europe
2008,Patric,ESP,Lazio,Serie A,2020,27.0,1993.0,17.7,30,16,15,11,4,13,24,54.2,11,13,3,10,18,48,51,1,DF,25-29,Defender,Spain,Europe
2016,Strahinja Pavlović,SRB,Monaco,Ligue 1,2020,19.0,2001.0,0.0,0,0,0,0,0,0,0,,0,0,0,0,0,0,0,0,DF,Under 20,Defender,Serbia,Europe
2022,Alfonso Pedraza,ESP,Villarreal,La Liga,2020,24.0,1996.0,23.3,35,19,16,11,8,11,31,35.5,20,21,5,16,34,69,47,1,DF,20-24,Defender,Spain,Europe
2023,Pedri,ESP,Barcelona,La Liga,2020,17.0,2002.0,26.8,44,27,16,16,12,17,71,23.9,54,46,1,45,33,77,7,0,MF,Under 20,Midfielder,Spain,Europe
2024,Pedro,ESP,Roma,Serie A,2020,33.0,1987.0,17.7,22,14,6,11,5,7,35,20.0,28,10,0,10,9,31,2,1,"MF,FW",30-34,Midfielder,Spain,Europe
2024,Pedro,ESP,Roma,Serie A,2020,33.0,1987.0,17.7,22,14,6,11,5,7,35,20.0,28,10,0,10,9,31,2,1,"MF,FW",30-34,Midfielder,Spain,Europe
2024,Pedro,ESP,Roma,Serie A,2020,33.0,1987.0,17.7,22,14,6,11,5,7,35,20.0,28,10,0,10,9,31,2,1,"MF,FW",30-34,Midfielder,Spain,Europe
2024,Pedro,ESP,Roma,Serie A,2020,33.0,1987.0,17.7,22,14,6,11,5,7,35,20.0,28,10,0,10,9,31,2,1,"MF,FW",30-34,Midfielder,Spain,Europe
2024,Pedro,ESP,Roma,Serie A,2020,33.0,1987.0,17.7,22,14,6,11,5,7,35,20.0,28,10,0,10,9,31,2,1,"MF,FW",30-34,Midfielder,Spain,Europe
2024,Pedro,ESP,Roma,Serie A,2020,33.0,1987.0,17.7,22,14,6,11,5,7,35,20.0,28,10,0,10,9,31,2,1,"MF,FW",30-34,Midfielder,Spain,Europe
2024,Pedro,ESP,Roma,Serie A,2020,33.0,1987.0,17.7,22,14,6,11,5,7,35,20.0,28,10,0,10,9,31,2,1,"MF,FW",30-34,Midfielder,Spain,Europe
2024,Pedro,ESP,Roma,Serie A,2020,33.0,1987.0,17.7,22,14,6,11,5,7,35,20.0,28,10,0,10,9,31,2,1,"MF,FW",30-34,Midfielder,Spain,Europe
2024,Pedro,ESP,Roma,Serie A,2020,33.0,1987.0,17.7,22,14,6,11,5,7,35,20.0,28,10,0,10,9,31,2,1,"MF,FW",30-34,Midfielder,Spain,Europe
2024,Pedro,ESP,Roma,Serie A,2020,33.0,1987.0,17.7,22,14,6,11,5,7,35,20.0,28,10,0,10,9,31,2,1,"MF,FW",30-34,Midfielder,Spain,Europe
2024,Pedro,ESP,Roma,Serie A,2020,33.0,1987.0,17.7,22,14,6,11,5,7,35,20.0,28,10,0,10,9,31,2,1,"MF,FW",30-34,Midfielder,Spain,Europe
2024,Pedro,ESP,Roma,Serie A,2020,33.0,1987.0,17.7,22,14,6,11,5,7,35,20.0,28,10,0,10,9,31,2,1,"MF,FW",30-34,Midfielder,Spain,Europe
2024,Pedro,ESP,Roma,Serie A,2020,33.0,1987.0,17.7,22,14,6,11,5,7,35,20.0,28,10,0,10,9,31,2,1,"MF,FW",30-34,Midfielder,Spain,Europe
2024,Pedro,ESP,Roma,Serie A,2020,33.0,1987.0,17.7,22,14,6,11,5,7,35,20.0,28,10,0,10,9,31,2,1,"MF,FW",30-34,Midfielder,Spain,Europe
2024,Pedro,ESP,Roma,Serie A,2020,33.0,1987.0,17.7,22,14,6,11,5,7,35,20.0,28,10,0,10,9,31,2,1,"MF,FW",30-34,Midfielder,Spain,Europe
2024,Pedro,ESP,Roma,Serie A,2020,33.0,1987.0,17.7,22,14,6,11,5,7,35,20.0,28,10,0,10,9,31,2,1,"MF,FW",30-34,Midfielder,Spain,Europe
2038,Rubén Peña,ESP,Villarreal,La Liga,2020,29.0,1991.0,12.4,25,14,8,15,2,19,33,57.6,14,20,1,19,13,38,19,0,DF,25-29,Defender,Spain,Europe
2041,Alberto Perea,ESP,Cádiz,La Liga,2020,29.0,1990.0,17.2,28,17,12,10,6,9,35,25.7,26,26,1,25,21,49,9,0,MF,25-29,Midfielder,Spain,Europe
2058,Manuel Perez,FRA,Lens,Ligue 1,2020,29.0,1991.0,1.4,1,0,1,0,0,0,8,0.0,8,2,0,2,2,3,2,0,"MF,FW",25-29,Midfielder,France,Europe
2060,Mattia Perin,ITA,Genoa,Serie A,2020,27.0,1992.0,32.0,0,0,0,0,0,0,0,,0,0,0,0,1,1,6,0,GK,25-29,Goalkeeper,Italy,Europe
2062,Romain Perraud,FRA,Brest,Ligue 1,2020,22.0,1997.0,34.9,60,34,42,16,2,24,45,53.3,21,36,3,33,45,105,76,0,DF,20-24,Defender,France,Europe
2064,Pavao Pervan,AUT,Wolfsburg,Bundesliga,2020,32.0,1987.0,2.0,0,0,0,0,0,0,0,,0,0,0,0,0,0,1,0,GK,30-34,Goalkeeper,Austria,Europe
2065,Matteo Pessina,ITA,Atalanta,Serie A,2020,23.0,1997.0,18.3,14,7,4,6,4,7,24,29.2,17,17,2,15,17,31,7,1,MF,20-24,Midfielder,Italy,Europe
2066,Andrea Petagna,ITA,Napoli,Serie A,2020,25.0,1995.0,10.7,2,0,0,2,0,2,7,28.6,5,4,0,4,1,3,7,0,FW,25-29,Forward,Italy,Europe
2067,Nils Petersen,GER,Freiburg,Bundesliga,2020,31.0,1988.0,14.5,11,7,2,6,3,3,21,14.3,18,25,1,24,9,20,28,0,FW,30-34,Forward,Germany,Europe
2068,Lukas Petkov,BUL,Augsburg,Bundesliga,2020,19.0,2000.0,0.0,0,0,0,0,0,0,0,,0,0,0,0,0,0,0,0,MF,Under 20,Midfielder,Bulgaria,Europe
2069,Jacopo Petriccione,ITA,Crotone,Serie A,2020,25.0,1995.0,10.6,14,8,6,7,1,9,24,37.5,15,11,2,9,8,22,11,0,MF,25-29,Midfielder,Italy,Europe
2071,Germán Pezzella,ARG,Fiorentina,Serie A,2020,29.0,1991.0,30.5,34,20,22,12,0,18,32,56.3,14,26,14,12,36,70,109,1,DF,25-29,Defender,Argentina,South America
2072,Giuseppe Pezzella,ITA,Parma,Serie A,2020,22.0,1997.0,20.3,34,19,23,9,2,22,41,53.7,19,22,9,13,12,46,52,3,DF,20-24,Defender,Italy,Europe
2073,Maximilian Philipp,GER,Wolfsburg,Bundesliga,2020,26.0,1994.0,12.3,15,6,3,6,6,5,21,23.8,16,17,0,17,6,21,3,0,MF,25-29,Midfielder,Germany,Europe
2074,Rayan Philippe,FRA,Dijon,Ligue 1,2020,19.0,2000.0,1.0,3,1,1,1,1,2,2,100.0,0,0,0,0,0,3,0,0,FW,Under 20,Forward,France,Europe
2075,Romain Philippoteaux,FRA,Nîmes,Ligue 1,2020,32.0,1988.0,2.4,1,1,1,0,0,1,5,20.0,4,2,0,2,2,3,1,0,"FW,MF",30-34,Forward,France,Europe
2076,Romain Philippoteaux,FRA,Brest,Ligue 1,2020,32.0,1988.0,6.5,11,6,6,3,2,6,9,66.7,3,4,0,4,10,21,2,0,"MF,FW",30-34,Midfielder,France,Europe
2077,Kalvin Phillips,ENG,Leeds United,Premier League,2020,24.0,1995.0,27.0,74,38,38,29,7,26,62,41.9,36,49,14,35,45,119,53,3,MF,20-24,Midfielder,England,Europe
2078,Matt Phillips,SCO,West Brom,Premier League,2020,29.0,1991.0,20.3,15,8,4,11,0,7,23,30.4,16,32,4,28,10,25,32,1,MF,25-29,Midfielder,Scotland,Europe
2079,Nathaniel Phillips,ENG,Liverpool,Premier League,2020,23.0,1997.0,16.2,22,14,15,7,0,11,24,45.8,13,17,14,3,20,42,81,0,DF,20-24,Defender,England,Europe
2082,Pablo Piatti,ARG,Elche,La Liga,2020,31.0,1989.0,4.0,8,6,3,3,2,3,12,25.0,9,5,0,5,2,10,1,0,"MF,FW",30-34,Midfielder,Argentina,South America
2083,Cristiano Piccini,ITA,Atalanta,Serie A,2020,27.0,1992.0,0.7,1,1,1,0,0,0,1,0.0,1,1,0,1,0,1,0,0,DF,25-29,Defender,Italy,Europe
2084,Cristiano Piccini,ITA,Valencia,La Liga,2020,27.0,1992.0,0.7,1,1,1,0,0,1,2,50.0,1,0,0,0,0,1,3,0,DF,25-29,Defender,Italy,Europe
2085,Roberto Piccoli,ITA,Spezia,Serie A,2020,19.0,2001.0,7.8,7,3,0,4,3,2,4,50.0,2,4,0,4,2,9,5,0,FW,Under 20,Forward,Italy,Europe
2086,Jordan Pickford,ENG,Everton,Premier League,2020,26.0,1994.0,30.5,0,0,0,0,0,0,2,0.0,2,2,0,2,3,3,16,4,GK,25-29,Goalkeeper,England,Europe
2087,Jérémy Pied,FRA,Lille,Ligue 1,2020,31.0,1989.0,3.5,7,0,3,3,1,4,9,44.4,5,3,1,2,6,13,8,0,DF,30-34,Defender,France,Europe
2088,Amos Pieper,GER,Arminia,Bundesliga,2020,22.0,1998.0,29.8,58,32,39,17,2,20,33,60.6,13,48,35,13,66,124,160,3,DF,20-24,Defender,Germany,Europe
2089,Ronaël Pierre-Gabriel,FRA,Brest,Ligue 1,2020,22.0,1998.0,25.6,60,40,42,16,2,35,52,67.3,17,17,7,10,30,90,57,0,DF,20-24,Defender,France,Europe
2090,Erik Pieters,NED,Burnley,Premier League,2020,31.0,1988.0,14.1,30,21,18,9,3,19,39,48.7,20,30,9,21,12,42,34,0,"DF,MF",30-34,Defender,Netherlands,Europe
2092,Andrea Pinamonti,ITA,Inter,Serie A,2020,21.0,1999.0,1.9,0,0,0,0,0,0,0,,0,1,0,1,1,1,2,0,FW,20-24,Forward,Italy,Europe
2094,Carlo Pinsoglio,ITA,Juventus,Serie A,2020,30.0,1990.0,0.3,0,0,0,0,0,0,0,,0,0,0,0,0,0,0,0,GK,30-34,Goalkeeper,Italy,Europe
2096,Fabio Pisacane,ITA,Cagliari,Serie A,2020,34.0,1986.0,2.5,3,2,2,1,0,3,7,42.9,4,8,5,3,1,4,9,1,DF,30-34,Defender,Italy,Europe
2098,Marko Pjaca,CRO,Genoa,Serie A,2020,25.0,1995.0,15.8,13,6,6,3,4,4,16,25.0,12,7,2,5,7,20,12,0,"FW,MF",25-29,Forward,Croatia,Europe
2101,Marvin Plattenhardt,GER,Hertha BSC,Bundesliga,2020,28.0,1992.0,11.9,15,10,6,7,2,5,9,55.6,4,9,1,8,1,16,19,1,DF,25-29,Defender,Germany,Europe
2102,Alassane Pléa,FRA,Gladbach,Bundesliga,2020,27.0,1993.0,20.0,19,9,4,10,5,5,20,25.0,15,1,0,1,5,24,7,0,FW,25-29,Forward,France,Europe
2104,Tommaso Pobega,ITA,Spezia,Serie A,2020,21.0,1999.0,13.7,24,13,7,13,4,11,31,35.5,20,10,2,8,9,33,22,0,MF,20-24,Midfielder,Italy,Europe
2106,Paul Pogba,FRA,Manchester Utd,Premier League,2020,27.0,1993.0,21.1,36,26,15,16,5,11,33,33.3,22,24,2,22,26,62,37,0,"MF,FW",25-29,Midfielder,France,Europe
2107,Joel Pohjanpalo,FIN,Union Berlin,Bundesliga,2020,25.0,1994.0,9.5,5,1,0,3,2,1,6,16.7,5,1,0,1,1,6,12,0,FW,25-29,Forward,Finland,Europe
2108,Joel Pohjanpalo,FIN,Leverkusen,Bundesliga,2020,25.0,1994.0,0.1,0,0,0,0,0,0,0,,0,0,0,0,0,0,0,0,MF,25-29,Midfielder,Finland,Europe
2110,Matteo Politano,ITA,Napoli,Serie A,2020,26.0,1993.0,21.2,24,16,13,9,2,11,47,23.4,36,14,1,13,14,38,18,0,"FW,MF",25-29,Forward,Italy,Europe
2112,Marin Pongračić,CRO,Wolfsburg,Bundesliga,2020,22.0,1997.0,6.4,13,9,9,3,1,6,8,75.0,2,12,5,7,11,24,27,0,DF,20-24,Defender,Croatia,Europe
2114,Nick Pope,ENG,Burnley,Premier League,2020,28.0,1992.0,32.0,1,1,1,0,0,0,1,0.0,1,0,0,0,2,3,29,2,GK,25-29,Goalkeeper,England,Europe
2115,Manolo Portanova,ITA,Genoa,Serie A,2020,20.0,2000.0,0.7,3,3,1,1,1,0,2,0.0,2,3,1,2,1,4,2,0,"MF,FW",20-24,Midfielder,Italy,Europe
2116,Manolo Portanova,ITA,Juventus,Serie A,2020,20.0,2000.0,0.8,2,0,2,0,0,0,2,0.0,2,4,1,3,0,2,1,0,MF,20-24,Midfielder,Italy,Europe
2119,Stefan Posch,AUT,Hoffenheim,Bundesliga,2020,23.0,1997.0,23.5,52,24,29,17,6,27,47,57.4,20,27,8,19,37,89,73,1,DF,20-24,Defender,Austria,Europe
2121,Yussuf Poulsen,DEN,RB Leipzig,Bundesliga,2020,26.0,1994.0,15.0,10,6,1,6,3,1,17,5.9,16,16,0,16,6,16,13,0,FW,25-29,Forward,Denmark,Europe
2122,Maxime Poundjé,FRA,Bordeaux,Ligue 1,2020,27.0,1992.0,5.5,10,7,9,1,0,2,6,33.3,4,7,3,4,11,21,5,0,DF,25-29,Defender,France,Europe
2124,Ian Poveda,ENG,Leeds United,Premier League,2020,20.0,2000.0,3.9,5,4,3,0,2,1,7,14.3,6,5,1,4,1,6,2,0,MF,20-24,Midfielder,England,Europe
2128,Nicolas de Préville,FRA,Bordeaux,Ligue 1,2020,29.0,1991.0,17.9,19,14,7,6,6,9,42,21.4,33,15,0,15,13,32,7,0,"FW,MF",25-29,Forward,France,Europe
2129,Manuel Prietl,AUT,Arminia,Bundesliga,2020,28.0,1991.0,28.0,65,44,33,28,4,12,73,16.4,61,34,7,27,45,110,24,0,MF,25-29,Midfielder,Austria,Europe
2130,Grischa Prömel,GER,Union Berlin,Bundesliga,2020,25.0,1995.0,20.2,39,23,14,23,2,18,34,52.9,16,20,2,18,24,63,22,0,MF,25-29,Midfielder,Germany,Europe
2132,Ivan Provedel,ITA,Spezia,Serie A,2020,26.0,1994.0,29.0,2,0,2,0,0,2,6,33.3,4,0,0,0,2,4,20,1,GK,25-29,Goalkeeper,Italy,Europe
2135,Erick Pulgar,CHI,Fiorentina,Serie A,2020,26.0,1994.0,22.2,41,18,17,23,1,22,49,44.9,27,24,10,14,41,82,45,1,MF,25-29,Midfielder,Chile,South America
2137,Christian Pulisic,USA,Chelsea,Premier League,2020,21.0,1998.0,19.3,19,11,8,10,1,8,21,38.1,13,25,2,23,12,31,9,0,"FW,MF",20-24,Forward,United States,North America
2138,Ignacio Pussetto,ARG,Udinese,Serie A,2020,24.0,1995.0,8.4,16,8,5,6,5,6,17,35.3,11,14,0,14,13,29,6,0,FW,20-24,Forward,Argentina,South America
2139,Fabio Quagliarella,ITA,Sampdoria,Serie A,2020,37.0,1983.0,24.5,12,8,4,4,4,2,19,10.5,17,14,1,13,7,19,10,0,FW,35-39,Forward,Italy,Europe
2141,Domingos Quina,POR,Granada,La Liga,2020,20.0,1999.0,3.8,5,5,1,3,1,3,6,50.0,3,8,0,8,2,7,0,0,MF,20-24,Midfielder,Portugal,Europe
2145,Simone Rabbi,ITA,Bologna,Serie A,2020,18.0,2001.0,0.4,0,0,0,0,0,0,1,0.0,1,0,0,0,0,0,0,0,"FW,DF",Under 20,Forward,Italy,Europe
2146,Adrien Rabiot,FRA,Juventus,Serie A,2020,25.0,1995.0,25.7,72,42,24,41,7,28,60,46.7,32,32,11,21,43,115,29,1,MF,25-29,Midfielder,France,Europe
2148,Anthony Racioppi,SUI,Dijon,Ligue 1,2020,21.0,1998.0,21.0,0,0,0,0,0,0,2,0.0,2,0,0,0,2,2,12,4,GK,20-24,Goalkeeper,Switzerland,Europe
2156,Rafael,BRA,Spezia,Serie A,2020,38.0,1982.0,2.3,0,0,0,0,0,0,0,,0,0,0,0,0,0,0,0,GK,35-39,Goalkeeper,Brazil,South America
2156,Rafael,BRA,Spezia,Serie A,2020,38.0,1982.0,2.3,0,0,0,0,0,0,0,,0,0,0,0,0,0,0,0,GK,35-39,Goalkeeper,Brazil,South America
2156,Rafael,BRA,Spezia,Serie A,2020,38.0,1982.0,2.3,0,0,0,0,0,0,0,,0,0,0,0,0,0,0,0,GK,35-39,Goalkeeper,Brazil,South America
2156,Rafael,BRA,Spezia,Serie A,2020,38.0,1982.0,2.3,0,0,0,0,0,0,0,,0,0,0,0,0,0,0,0,GK,35-39,Goalkeeper,Brazil,South America
2157,Rafinha,BRA,Paris S-G,Ligue 1,2020,27.0,1993.0,15.1,54,26,18,28,8,28,49,57.1,21,18,3,15,13,67,6,0,"MF,FW",25-29,Midfielder,Brazil,South America
2157,Rafinha,BRA,Paris S-G,Ligue 1,2020,27.0,1993.0,15.1,54,26,18,28,8,28,49,57.1,21,18,3,15,13,67,6,0,"MF,FW",25-29,Midfielder,Brazil,South America
2157,Rafinha,BRA,Paris S-G,Ligue 1,2020,27.0,1993.0,15.1,54,26,18,28,8,28,49,57.1,21,18,3,15,13,67,6,0,"MF,FW",25-29,Midfielder,Brazil,South America
2157,Rafinha,BRA,Paris S-G,Ligue 1,2020,27.0,1993.0,15.1,54,26,18,28,8,28,49,57.1,21,18,3,15,13,67,6,0,"MF,FW",25-29,Midfielder,Brazil,South America
2157,Rafinha,BRA,Paris S-G,Ligue 1,2020,27.0,1993.0,15.1,54,26,18,28,8,28,49,57.1,21,18,3,15,13,67,6,0,"MF,FW",25-29,Midfielder,Brazil,South America
2157,Rafinha,BRA,Paris S-G,Ligue 1,2020,27.0,1993.0,15.1,54,26,18,28,8,28,49,57.1,21,18,3,15,13,67,6,0,"MF,FW",25-29,Midfielder,Brazil,South America
2157,Rafinha,BRA,Paris S-G,Ligue 1,2020,27.0,1993.0,15.1,54,26,18,28,8,28,49,57.1,21,18,3,15,13,67,6,0,"MF,FW",25-29,Midfielder,Brazil,South America
2157,Rafinha,BRA,Paris S-G,Ligue 1,2020,27.0,1993.0,15.1,54,26,18,28,8,28,49,57.1,21,18,3,15,13,67,6,0,"MF,FW",25-29,Midfielder,Brazil,South America
2157,Rafinha,BRA,Paris S-G,Ligue 1,2020,27.0,1993.0,15.1,54,26,18,28,8,28,49,57.1,21,18,3,15,13,67,6,0,"MF,FW",25-29,Midfielder,Brazil,South America
2157,Rafinha,BRA,Paris S-G,Ligue 1,2020,27.0,1993.0,15.1,54,26,18,28,8,28,49,57.1,21,18,3,15,13,67,6,0,"MF,FW",25-29,Midfielder,Brazil,South America
2157,Rafinha,BRA,Paris S-G,Ligue 1,2020,27.0,1993.0,15.1,54,26,18,28,8,28,49,57.1,21,18,3,15,13,67,6,0,"MF,FW",25-29,Midfielder,Brazil,South America
2157,Rafinha,BRA,Paris S-G,Ligue 1,2020,27.0,1993.0,15.1,54,26,18,28,8,28,49,57.1,21,18,3,15,13,67,6,0,"MF,FW",25-29,Midfielder,Brazil,South America
2157,Rafinha,BRA,Paris S-G,Ligue 1,2020,27.0,1993.0,15.1,54,26,18,28,8,28,49,57.1,21,18,3,15,13,67,6,0,"MF,FW",25-29,Midfielder,Brazil,South America
2157,Rafinha,BRA,Paris S-G,Ligue 1,2020,27.0,1993.0,15.1,54,26,18,28,8,28,49,57.1,21,18,3,15,13,67,6,0,"MF,FW",25-29,Midfielder,Brazil,South America
2157,Rafinha,BRA,Paris S-G,Ligue 1,2020,27.0,1993.0,15.1,54,26,18,28,8,28,49,57.1,21,18,3,15,13,67,6,0,"MF,FW",25-29,Midfielder,Brazil,South America
2157,Rafinha,BRA,Paris S-G,Ligue 1,2020,27.0,1993.0,15.1,54,26,18,28,8,28,49,57.1,21,18,3,15,13,67,6,0,"MF,FW",25-29,Midfielder,Brazil,South America
2163,Gastón Ramírez,URU,Sampdoria,Serie A,2020,29.0,1990.0,10.8,31,15,10,17,4,8,27,29.6,19,19,3,16,4,35,13,0,"FW,MF",25-29,Forward,Uruguay,South America
2166,Aaron Ramsdale,ENG,Sheffield Utd,Premier League,2020,22.0,1998.0,38.0,1,1,1,0,0,1,1,100.0,0,0,0,0,2,3,22,6,GK,20-24,Goalkeeper,England,Europe
2167,Aaron Ramsey,WAL,Juventus,Serie A,2020,29.0,1990.0,12.1,22,14,8,13,1,8,25,32.0,17,13,2,11,7,29,8,2,MF,25-29,Midfielder,Wales,Europe
2167,Aaron Ramsey,WAL,Juventus,Serie A,2020,29.0,1990.0,12.1,22,14,8,13,1,8,25,32.0,17,13,2,11,7,29,8,2,MF,25-29,Midfielder,Wales,Europe
2167,Aaron Ramsey,WAL,Juventus,Serie A,2020,29.0,1990.0,12.1,22,14,8,13,1,8,25,32.0,17,13,2,11,7,29,8,2,MF,25-29,Midfielder,Wales,Europe
2167,Aaron Ramsey,WAL,Juventus,Serie A,2020,29.0,1990.0,12.1,22,14,8,13,1,8,25,32.0,17,13,2,11,7,29,8,2,MF,25-29,Midfielder,Wales,Europe
2168,Jacob Ramsey,ENG,Aston Villa,Premier League,2020,19.0,2001.0,7.0,10,5,3,4,3,2,12,16.7,10,13,6,7,4,14,5,0,MF,Under 20,Midfielder,England,Europe
2170,Darren Randolph,IRL,West Ham,Premier League,2020,33.0,1987.0,3.0,0,0,0,0,0,0,0,,0,0,0,0,0,0,1,0,GK,30-34,Goalkeeper,Republic of Ireland,Europe
2171,Andrea Ranocchia,ITA,Inter,Serie A,2020,32.0,1988.0,7.8,13,10,6,6,1,7,8,87.5,1,5,3,2,12,25,19,0,DF,30-34,Defender,Italy,Europe
2172,Raphinha,BRA,Leeds United,Premier League,2020,23.0,1996.0,26.2,34,17,13,16,5,12,58,20.7,46,31,1,30,29,63,27,0,"MF,FW",20-24,Midfielder,Brazil,South America
2173,Raphinha,BRA,Rennes,Ligue 1,2020,23.0,1996.0,4.5,5,2,1,3,1,1,4,25.0,3,5,0,5,3,8,4,0,"FW,MF",20-24,Forward,Brazil,South America
2174,Marcus Rashford,ENG,Manchester Utd,Premier League,2020,22.0,1997.0,32.4,18,9,2,8,8,7,27,25.9,20,22,2,20,8,26,10,0,FW,20-24,Forward,England,Europe
2176,Giacomo Raspadori,ITA,Sassuolo,Serie A,2020,20.0,2000.0,13.7,5,3,1,1,3,0,4,0.0,4,13,5,8,2,7,9,0,"FW,MF",20-24,Forward,Italy,Europe
2177,Federico Ravaglia,ITA,Bologna,Serie A,2020,20.0,1999.0,4.0,0,0,0,0,0,0,1,0.0,1,0,0,0,0,0,2,0,GK,20-24,Goalkeeper,Italy,Europe
2178,Tim Ream,USA,Fulham,Premier League,2020,32.0,1987.0,7.0,12,5,9,3,0,8,11,72.7,3,8,5,3,6,18,26,1,DF,30-34,Defender,United States,North America
2179,Ante Rebić,CRO,Milan,Serie A,2020,26.0,1993.0,19.7,26,9,4,8,14,8,37,21.6,29,21,1,20,7,33,17,0,FW,25-29,Forward,Croatia,Europe
2183,Nathan Redmond,ENG,Southampton,Premier League,2020,26.0,1994.0,19.3,30,17,14,12,4,8,24,33.3,16,24,2,22,11,41,9,0,"MF,FW",25-29,Midfielder,England,Europe
2184,Harrison Reed,ENG,Fulham,Premier League,2020,25.0,1995.0,25.0,63,38,28,28,7,29,73,39.7,44,34,11,23,50,113,31,1,MF,25-29,Midfielder,England,Europe
2185,Vasco Regini,ITA,Sampdoria,Serie A,2020,29.0,1990.0,1.0,2,2,2,0,0,2,2,100.0,0,1,1,0,1,3,5,0,DF,25-29,Defender,Italy,Europe
2189,Jeff Reine-Adélaïde,FRA,Nice,Ligue 1,2020,22.0,1998.0,11.8,7,4,1,4,2,2,9,22.2,7,10,1,9,4,11,6,0,"MF,FW",20-24,Midfielder,France,Europe
2190,Jeff Reine-Adélaïde,FRA,Lyon,Ligue 1,2020,22.0,1998.0,0.3,0,0,0,0,0,0,0,,0,0,0,0,0,0,0,0,FW,20-24,Forward,France,Europe
2191,Reinier,BRA,Dortmund,Bundesliga,2020,18.0,2002.0,2.9,9,4,6,1,2,2,4,50.0,2,4,1,3,2,11,0,0,"MF,FW",Under 20,Midfielder,Brazil,South America
2193,Rocco Reitz,GER,Gladbach,Bundesliga,2020,18.0,2002.0,0.7,3,2,0,3,0,2,2,100.0,0,3,1,2,1,4,1,0,MF,Under 20,Midfielder,Germany,Europe
2194,Karim Rekik,NED,Sevilla,La Liga,2020,25.0,1994.0,7.3,7,5,2,5,0,1,4,25.0,3,8,3,5,6,13,17,0,DF,25-29,Defender,Netherlands,Europe
2197,Marco Reus,GER,Dortmund,Bundesliga,2020,31.0,1989.0,25.3,33,16,9,16,8,9,33,27.3,24,22,2,20,14,47,13,0,"MF,FW",30-34,Midfielder,Germany,Europe
2201,Baptiste Reynet,FRA,Nîmes,Ligue 1,2020,29.0,1990.0,38.0,2,1,2,0,0,2,4,50.0,2,1,0,1,1,3,9,2,GK,25-29,Goalkeeper,France,Europe
2203,Franck Ribéry,FRA,Fiorentina,Serie A,2020,37.0,1983.0,23.9,24,11,4,9,11,5,29,17.2,24,11,2,9,3,27,1,0,FW,35-39,Forward,France,Europe
2204,Federico Ricci,ITA,Sassuolo,Serie A,2020,26.0,1994.0,0.0,0,0,0,0,0,0,0,,0,0,0,0,0,0,0,0,FW,25-29,Forward,Italy,Europe
2205,Giacomo Ricci,ITA,Parma,Serie A,2020,23.0,1996.0,0.7,3,1,1,2,0,0,0,,0,2,2,0,1,4,4,0,DF,20-24,Defender,Italy,Europe
2207,Declan Rice,ENG,West Ham,Premier League,2020,21.0,1999.0,32.0,59,35,33,25,1,21,51,41.2,30,39,11,28,59,118,41,0,MF,20-24,Midfielder,England,Europe
2208,Chris Richards,USA,Hoffenheim,Bundesliga,2020,20.0,2000.0,10.5,19,8,12,6,1,10,16,62.5,6,13,4,9,21,40,40,1,DF,20-24,Defender,United States,North America
2209,Chris Richards,USA,Bayern Munich,Bundesliga,2020,20.0,2000.0,1.0,0,0,0,0,0,0,0,,0,0,0,0,1,1,1,0,DF,20-24,Defender,United States,North America
2211,Richarlison,BRA,Everton,Premier League,2020,23.0,1997.0,31.8,50,32,21,22,7,16,51,31.4,35,28,3,25,14,64,36,1,FW,20-24,Forward,Brazil,South America
2212,Marco Richter,GER,Augsburg,Bundesliga,2020,22.0,1997.0,15.7,17,9,3,12,2,7,23,30.4,16,10,0,10,6,23,9,0,"FW,MF",20-24,Forward,Germany,Europe
2217,Tomás Rincón,VEN,Torino,Serie A,2020,32.0,1988.0,31.6,68,38,27,33,8,36,71,50.7,35,32,7,25,31,99,44,0,MF,30-34,Midfielder,Venezuela,South America
2219,Renaud Ripart,FRA,Nîmes,Ligue 1,2020,27.0,1993.0,33.9,52,30,25,19,8,26,84,31.0,58,58,12,46,36,88,53,0,"MF,FW",25-29,Midfielder,France,Europe
2220,Andrea Rispoli,ITA,Crotone,Serie A,2020,31.0,1988.0,7.2,6,3,2,3,1,2,7,28.6,5,12,3,9,5,11,15,1,DF,30-34,Defender,Italy,Europe
2222,Matt Ritchie,SCO,Newcastle Utd,Premier League,2020,30.0,1989.0,15.0,10,3,5,3,2,3,17,17.6,14,17,2,15,12,22,47,0,"DF,MF",30-34,Defender,Scotland,Europe
2223,Maxence Rivera,FRA,Saint-Étienne,Ligue 1,2020,18.0,2002.0,2.7,12,10,6,4,2,4,10,40.0,6,5,0,5,1,13,0,0,"MF,FW",Under 20,Midfielder,France,Europe
2224,Emmanuel Rivière,FRA,Crotone,Serie A,2020,30.0,1990.0,7.1,2,1,2,0,0,0,3,0.0,3,5,1,4,1,3,0,0,FW,30-34,Forward,France,Europe
2228,Tyler Roberts,WAL,Leeds United,Premier League,2020,21.0,1999.0,14.9,15,13,1,11,3,5,22,22.7,17,17,2,15,9,24,12,0,"MF,FW",20-24,Midfielder,Wales,Europe
2229,Andrew Robertson,SCO,Liverpool,Premier League,2020,26.0,1994.0,37.6,46,34,23,18,5,28,57,49.1,29,39,9,30,21,67,79,1,DF,25-29,Defender,Scotland,Europe
2230,Antonee Robinson,USA,Fulham,Premier League,2020,22.0,1997.0,24.0,45,28,24,16,5,27,44,61.4,17,21,4,17,37,82,68,0,DF,20-24,Defender,United States,North America
2231,Callum Robinson,IRL,West Brom,Premier League,2020,25.0,1995.0,17.3,7,5,5,1,1,3,19,15.8,16,9,0,9,7,14,8,0,"FW,MF",25-29,Forward,Republic of Ireland,Europe
2232,Jack Robinson,ENG,Sheffield Utd,Premier League,2020,26.0,1993.0,9.7,14,6,8,5,1,6,11,54.5,5,10,4,6,9,23,42,0,DF,25-29,Defender,England,Europe
2234,Hal Robson-Kanu,WAL,West Brom,Premier League,2020,31.0,1989.0,6.2,2,1,1,0,1,0,1,0.0,1,2,0,2,2,4,7,0,FW,30-34,Forward,Wales,Europe
2236,Christopher Rocchia,FRA,Marseille,Ligue 1,2020,22.0,1998.0,0.2,1,0,1,0,0,0,2,0.0,2,0,0,0,0,1,1,0,"DF,FW",20-24,Defender,France,Europe
2238,Marek Rodák,SVK,Fulham,Premier League,2020,23.0,1996.0,2.0,0,0,0,0,0,0,0,,0,0,0,0,0,0,0,0,GK,20-24,Goalkeeper,Slovakia,Europe
2239,Sebastian Rode,GER,Eint Frankfurt,Bundesliga,2020,29.0,1990.0,18.1,44,25,21,16,7,14,46,30.4,32,30,3,27,47,91,18,0,MF,25-29,Midfielder,Germany,Europe
2240,Joe Rodon,WAL,Tottenham,Premier League,2020,22.0,1997.0,8.1,14,9,11,2,1,3,4,75.0,1,10,8,2,21,35,36,2,DF,20-24,Defender,Wales,Europe
2247,Guido Rodríguez,ARG,Betis,La Liga,2020,26.0,1994.0,31.8,98,56,52,40,6,40,85,47.1,45,52,14,38,68,166,58,2,MF,25-29,Midfielder,Argentina,South America
2251,Ricardo Rodríguez,SUI,Torino,Serie A,2020,27.0,1992.0,13.8,21,14,11,8,2,13,22,59.1,9,16,5,11,20,41,43,0,DF,25-29,Defender,Switzerland,Europe
2253,Rodrygo,BRA,Real Madrid,La Liga,2020,19.0,2001.0,10.9,15,6,10,4,1,2,17,11.8,15,15,0,15,7,22,4,0,FW,Under 20,Forward,Brazil,South America
2254,Marko Rog,CRO,Cagliari,Serie A,2020,25.0,1995.0,12.9,40,24,15,22,3,16,37,43.2,21,17,6,11,19,59,15,0,MF,25-29,Midfielder,Croatia,Europe
2255,Rogério,BRA,Sassuolo,Serie A,2020,22.0,1998.0,20.9,26,13,19,5,2,19,27,70.4,8,26,5,21,31,57,53,0,DF,20-24,Defender,Brazil,South America
2255,Rogério,BRA,Sassuolo,Serie A,2020,22.0,1998.0,20.9,26,13,19,5,2,19,27,70.4,8,26,5,21,31,57,53,0,DF,20-24,Defender,Brazil,South America
2255,Rogério,BRA,Sassuolo,Serie A,2020,22.0,1998.0,20.9,26,13,19,5,2,19,27,70.4,8,26,5,21,31,57,53,0,DF,20-24,Defender,Brazil,South America
2255,Rogério,BRA,Sassuolo,Serie A,2020,22.0,1998.0,20.9,26,13,19,5,2,19,27,70.4,8,26,5,21,31,57,53,0,DF,20-24,Defender,Brazil,South America
2,Max Aarons,ENG,Norwich City,Premier League,2019,19.0,2000.0,36.0,48,30,33,9,6,18,36,50.0,18,46,29,17,37,85,97,1,DF,Under 20,Defender,England,Europe
3,Yunis Abdelhamid,MAR,Reims,Ligue 1,2019,31.0,1987.0,28.0,46,33,29,15,2,17,30,56.7,13,26,14,12,47,93,99,1,DF,30-34,Defender,Morocco,Africa
4,Suleiman Abdullahi,NGA,Union Berlin,Bundesliga,2019,22.0,1996.0,1.7,0,0,0,0,0,0,3,0.0,3,2,1,1,1,1,1,0,"FW,MF",20-24,Forward,Nigeria,Africa
6,Charles Abi,FRA,Saint-Étienne,Ligue 1,2019,19.0,2000.0,6.9,9,9,2,5,2,2,7,28.6,5,2,0,2,4,13,4,0,FW,Under 20,Forward,France,Europe
7,David Abraham,ARG,Eint Frankfurt,Bundesliga,2019,33.0,1986.0,18.8,21,14,16,4,1,15,32,46.9,17,27,11,16,25,46,61,1,DF,30-34,Defender,Argentina,South America
8,Tammy Abraham,ENG,Chelsea,Premier League,2019,21.0,1997.0,24.6,8,4,2,5,1,3,14,21.4,11,20,2,18,6,14,27,0,FW,20-24,Forward,England,Europe
9,Amir Abrashi,ALB,Freiburg,Bundesliga,2019,29.0,1990.0,7.4,16,8,7,8,1,10,19,52.6,9,18,3,15,7,23,16,2,MF,25-29,Midfielder,Albania,Europe
10,Francesco Acerbi,ITA,Lazio,Serie A,2019,31.0,1988.0,35.1,59,29,42,12,5,14,20,70.0,6,40,27,13,42,101,109,1,DF,30-34,Defender,Italy,Europe
12,Tyler Adams,USA,RB Leipzig,Bundesliga,2019,20.0,1999.0,10.6,22,15,13,8,1,12,25,48.0,13,16,1,15,14,36,14,0,"MF,DF",20-24,Midfielder,United States,North America
13,Sargis Adamyan,ARM,Hoffenheim,Bundesliga,2019,26.0,1993.0,8.3,11,7,3,6,2,3,21,14.3,18,8,1,7,2,13,4,0,"FW,MF",25-29,Forward,Armenia,Asia
16,Claud Adjapong,ITA,Hellas Verona,Serie A,2019,21.0,1998.0,2.6,5,3,4,1,0,2,3,66.7,1,4,3,1,3,8,7,0,DF,20-24,Defender,Italy,Europe
17,Amine Adli,MAR,Toulouse,Ligue 1,2019,19.0,2000.0,0.5,0,0,0,0,0,0,1,0.0,1,0,0,0,1,1,0,0,"MF,FW",Under 20,Midfielder,Morocco,Africa
18,Yacine Adli,FRA,Bordeaux,Ligue 1,2019,19.0,2000.0,11.3,22,14,4,15,3,11,34,32.4,23,10,0,10,8,30,3,0,MF,Under 20,Midfielder,France,Europe
24,Kevin Agudelo,COL,Fiorentina,Serie A,2019,20.0,1998.0,0.7,2,1,0,1,1,0,1,0.0,1,1,0,1,1,3,0,0,"MF,FW",20-24,Midfielder,Colombia,South America
25,Kevin Agudelo,COL,Genoa,Serie A,2019,20.0,1998.0,7.4,23,14,9,12,2,10,20,50.0,10,12,1,11,6,29,2,0,"MF,FW",20-24,Midfielder,Colombia,South America
26,Nayef Aguerd,MAR,Dijon,Ligue 1,2019,23.0,1996.0,10.6,13,9,7,5,1,8,12,66.7,4,11,11,0,18,31,54,0,DF,20-24,Defender,Morocco,Africa
27,Sergio Agüero,ARG,Manchester City,Premier League,2019,31.0,1988.0,16.1,7,4,0,4,3,1,8,12.5,7,9,1,8,3,10,2,0,FW,30-34,Forward,Argentina,South America
28,Ruben Aguilar,FRA,Monaco,Ligue 1,2019,26.0,1993.0,11.9,36,22,19,15,2,19,28,67.9,9,6,2,4,11,47,21,0,DF,25-29,Defender,France,Europe
30,Jean-Eudes Aholou,CIV,Saint-Étienne,Ligue 1,2019,25.0,1994.0,7.0,16,12,2,11,3,3,9,33.3,6,6,1,5,15,31,10,0,MF,25-29,Midfielder,Ivory Coast,Africa
31,Joseph Aidoo,GHA,Celta Vigo,La Liga,2019,23.0,1995.0,27.8,43,27,30,11,2,13,27,48.1,14,31,14,17,45,88,124,3,DF,20-24,Defender,Ghana,Africa
32,Ola Aina,NGA,Torino,Serie A,2019,22.0,1996.0,23.1,45,24,23,18,4,17,37,45.9,20,24,6,18,41,86,61,0,DF,20-24,Defender,Nigeria,Africa
34,Rayan Aït-Nouri,ALG,Angers,Ligue 1,2019,18.0,2001.0,14.2,29,22,14,8,7,10,21,47.6,11,14,1,13,18,47,33,0,DF,Under 20,Defender,Algeria,Africa
36,Ludovic Ajorque,FRA,Strasbourg,Ligue 1,2019,25.0,1994.0,22.9,15,10,2,10,3,2,13,15.4,11,11,0,11,2,17,20,0,FW,25-29,Forward,France,Europe
37,Manuel Akanji,SUI,Dortmund,Bundesliga,2019,24.0,1995.0,25.7,38,21,23,14,1,12,20,60.0,8,20,11,9,30,68,61,2,DF,20-24,Defender,Switzerland,Europe
38,Marley Aké,FRA,Marseille,Ligue 1,2019,18.0,2001.0,1.1,2,2,1,1,0,1,3,33.3,2,0,0,0,1,3,1,0,"FW,MF",Under 20,Forward,France,Europe
39,Nathan Aké,NED,Bournemouth,Premier League,2019,24.0,1995.0,27.8,31,21,23,8,0,14,23,60.9,9,40,29,11,36,67,152,0,DF,20-24,Defender,Netherlands,Europe
40,Chadrac Akolo,COD,Amiens,Ligue 1,2019,24.0,1995.0,6.0,16,8,8,6,2,5,12,41.7,7,6,1,5,5,21,5,0,"FW,MF",20-24,Forward,DR Congo,Africa
41,Kevin Akpoguma,NGA,Hoffenheim,Bundesliga,2019,24.0,1995.0,12.7,24,16,20,4,0,13,24,54.2,11,21,11,10,13,37,48,0,DF,20-24,Defender,Nigeria,Africa
42,David Alaba,AUT,Bayern Munich,Bundesliga,2019,27.0,1992.0,27.8,30,17,14,15,1,16,25,64.0,9,19,10,9,29,59,40,0,DF,25-29,Defender,Austria,Europe
43,Sofiane Alakouch,MAR,Nîmes,Ligue 1,2019,21.0,1998.0,15.6,45,26,25,13,7,25,48,52.1,23,13,2,11,23,68,39,3,DF,20-24,Defender,Morocco,Africa
44,Lucas Alario,ARG,Leverkusen,Bundesliga,2019,26.0,1992.0,13.0,6,3,0,4,2,1,8,12.5,7,12,2,10,1,7,9,0,FW,25-29,Forward,Argentina,South America
48,Marc Albrighton,ENG,Leicester City,Premier League,2019,29.0,1989.0,9.6,24,17,10,13,1,9,30,30.0,21,19,2,17,10,34,8,0,"MF,DF",25-29,Midfielder,England,Europe
59,Trent Alexander-Arnold,ENG,Liverpool,Premier League,2019,20.0,1998.0,35.3,55,34,35,17,3,36,78,46.2,42,27,9,18,45,100,84,3,DF,20-24,Defender,England,Europe
60,Enrico Alfonso,ITA,Brescia,Serie A,2019,31.0,1988.0,3.1,0,0,0,0,0,0,0,,0,0,0,0,0,0,2,0,GK,30-34,Goalkeeper,Italy,Europe
61,Rachid Alioui,MAR,Angers,Ligue 1,2019,27.0,1992.0,17.4,8,5,0,7,1,2,13,15.4,11,3,0,3,2,10,9,0,FW,25-29,Forward,Morocco,Africa
62,Alisson,BRA,Liverpool,Premier League,2019,26.0,1992.0,28.3,0,0,0,0,0,0,2,0.0,2,0,0,0,1,1,13,3,GK,25-29,Goalkeeper,Brazil,South America
62,Alisson,BRA,Liverpool,Premier League,2019,26.0,1992.0,28.3,0,0,0,0,0,0,2,0.0,2,0,0,0,1,1,13,3,GK,25-29,Goalkeeper,Brazil,South America
62,Alisson,BRA,Liverpool,Premier League,2019,26.0,1992.0,28.3,0,0,0,0,0,0,2,0.0,2,0,0,0,1,1,13,3,GK,25-29,Goalkeeper,Brazil,South America
62,Alisson,BRA,Liverpool,Premier League,2019,26.0,1992.0,28.3,0,0,0,0,0,0,2,0.0,2,0,0,0,1,1,13,3,GK,25-29,Goalkeeper,Brazil,South America
63,Allan,BRA,Napoli,Serie A,2019,28.0,1991.0,14.2,50,27,20,21,9,18,54,33.3,36,19,3,16,16,66,11,1,MF,25-29,Midfielder,Brazil,South America
63,Allan,BRA,Napoli,Serie A,2019,28.0,1991.0,14.2,50,27,20,21,9,18,54,33.3,36,19,3,16,16,66,11,1,MF,25-29,Midfielder,Brazil,South America
63,Allan,BRA,Napoli,Serie A,2019,28.0,1991.0,14.2,50,27,20,21,9,18,54,33.3,36,19,3,16,16,66,11,1,MF,25-29,Midfielder,Brazil,South America
63,Allan,BRA,Napoli,Serie A,2019,28.0,1991.0,14.2,50,27,20,21,9,18,54,33.3,36,19,3,16,16,66,11,1,MF,25-29,Midfielder,Brazil,South America
64,Dele Alli,ENG,Tottenham,Premier League,2019,23.0,1996.0,20.5,34,16,11,20,3,13,37,35.1,24,35,3,32,17,51,17,2,"MF,FW",20-24,Midfielder,England,Europe
65,Miguel Almirón,PAR,Newcastle Utd,Premier League,2019,25.0,1994.0,33.6,60,39,32,20,8,19,52,36.5,33,25,1,24,31,91,25,0,"MF,FW",25-29,Midfielder,Paraguay,South America
72,Steven Alzate,COL,Brighton,Premier League,2019,20.0,1998.0,13.2,33,19,20,11,2,17,27,63.0,10,18,3,15,14,47,13,0,"MF,DF",20-24,Midfielder,Colombia,South America
73,Ibrahim Amadou,FRA,Norwich City,Premier League,2019,26.0,1993.0,8.4,18,11,9,8,1,3,11,27.3,8,8,5,3,16,34,55,1,"DF,MF",25-29,Defender,France,Europe
74,Ibrahim Amadou,FRA,Leganés,La Liga,2019,26.0,1993.0,8.6,16,9,5,9,2,4,11,36.4,7,5,0,5,12,28,6,0,MF,25-29,Midfielder,France,Europe
75,Romain Amalfitano,FRA,Dijon,Ligue 1,2019,29.0,1989.0,18.8,43,27,18,21,4,21,61,34.4,40,23,9,14,36,79,14,2,MF,25-29,Midfielder,France,Europe
77,Jordan Amavi,FRA,Marseille,Ligue 1,2019,25.0,1994.0,24.0,55,29,31,19,5,31,64,48.4,33,27,6,21,56,111,97,0,DF,25-29,Defender,France,Europe
79,Kelvin Amian,FRA,Toulouse,Ligue 1,2019,21.0,1998.0,18.1,27,21,21,5,1,14,25,56.0,11,14,7,7,18,45,56,0,DF,20-24,Defender,France,Europe
80,Nadiem Amiri,GER,Leverkusen,Bundesliga,2019,22.0,1996.0,20.6,26,16,7,15,4,16,34,47.1,18,12,2,10,14,40,8,1,"MF,FW",20-24,Midfielder,Germany,Europe
81,Ethan Ampadu,WAL,RB Leipzig,Bundesliga,2019,18.0,2000.0,0.9,5,4,3,2,0,1,1,100.0,0,3,1,2,1,6,3,0,DF,Under 20,Defender,Wales,Europe
84,Joachim Andersen,DEN,Lyon,Ligue 1,2019,23.0,1996.0,17.0,17,9,15,2,0,7,19,36.8,12,16,12,4,10,27,74,2,DF,20-24,Defender,Denmark,Europe
85,Djavan Anderson,NED,Lazio,Serie A,2019,24.0,1995.0,1.9,0,0,0,0,0,0,0,,0,1,0,1,3,3,3,0,"FW,DF",20-24,Forward,Netherlands,Europe
86,Felipe Anderson,BRA,West Ham,Premier League,2019,26.0,1993.0,16.6,46,32,20,21,5,11,47,23.4,36,19,1,18,22,68,11,0,"MF,FW",25-29,Midfielder,Brazil,South America
87,Sebastian Andersson,SWE,Union Berlin,Bundesliga,2019,28.0,1991.0,29.8,20,10,0,12,8,4,19,21.1,15,19,3,16,5,25,36,0,FW,25-29,Forward,Sweden,Europe
88,Florin Andone,ROU,Brighton,Premier League,2019,26.0,1993.0,0.8,1,1,0,1,0,1,1,100.0,0,1,1,0,0,1,1,0,FW,25-29,Forward,Romania,Europe
89,Benjamin André,FRA,Lille,Ligue 1,2019,28.0,1990.0,22.8,72,44,31,35,6,29,74,39.2,45,32,9,23,59,131,40,1,MF,25-29,Midfielder,France,Europe
90,Lorenzo Andrenacci,ITA,Brescia,Serie A,2019,24.0,1995.0,5.9,1,0,1,0,0,1,3,33.3,2,0,0,0,0,1,0,0,GK,20-24,Goalkeeper,Italy,Europe
91,Robert Andrich,GER,Union Berlin,Bundesliga,2019,24.0,1994.0,28.6,52,27,28,18,6,19,60,31.7,41,27,7,20,47,99,36,0,MF,20-24,Midfielder,Germany,Europe
100,Cristian Ansaldi,ARG,Torino,Serie A,2019,32.0,1986.0,19.6,37,25,24,7,6,19,34,55.9,15,23,3,20,14,51,20,4,"DF,MF",30-34,Defender,Argentina,South America
102,Michail Antonio,JAM,West Ham,Premier League,2019,29.0,1990.0,19.6,13,9,5,4,4,4,14,28.6,10,17,2,15,9,22,5,0,FW,25-29,Forward,Jamaica,North America
104,Mirko Antonucci,ITA,Roma,Serie A,2019,20.0,1999.0,0.9,4,3,1,0,3,3,3,100.0,0,2,0,2,2,6,1,0,"FW,MF",20-24,Forward,Italy,Europe
106,Christopher Antwi-Adjei,GHA,Paderborn 07,Bundesliga,2019,25.0,1994.0,27.4,25,16,13,9,3,9,33,27.3,24,29,2,27,15,40,14,0,"MF,FW",25-29,Midfielder,Ghana,Africa
107,Anuar,MAR,Valladolid,La Liga,2019,24.0,1995.0,2.1,4,2,1,2,1,2,6,33.3,4,7,3,4,5,9,0,0,"MF,FW",20-24,Midfielder,Morocco,Africa
108,Houssem Aouar,ALG,Lyon,Ligue 1,2019,21.0,1998.0,21.7,28,12,6,18,4,10,35,28.6,25,15,1,14,13,41,11,0,"MF,FW",20-24,Midfielder,Algeria,Africa
109,Adil Aouchiche,FRA,Paris S-G,Ligue 1,2019,17.0,2002.0,0.7,3,2,1,2,0,2,4,50.0,2,3,0,3,0,3,0,0,MF,Under 20,Midfielder,France,Europe
110,Dennis Appiah,FRA,Nantes,Ligue 1,2019,27.0,1992.0,17.8,58,35,32,20,6,28,52,53.8,24,9,3,6,23,81,34,0,DF,25-29,Defender,France,Europe
111,Mauro Arambarri,URU,Getafe,La Liga,2019,23.0,1995.0,34.1,72,33,24,40,8,31,69,44.9,38,52,5,47,43,115,40,2,MF,20-24,Midfielder,Uruguay,South America
112,Guilherme Arana,BRA,Atalanta,Serie A,2019,22.0,1997.0,0.9,4,4,1,3,0,3,5,60.0,2,0,0,0,2,6,0,0,DF,20-24,Defender,Brazil,South America
113,Charles Aránguiz,CHI,Leverkusen,Bundesliga,2019,30.0,1989.0,23.5,56,37,19,29,8,27,74,36.5,47,27,6,21,22,78,21,1,MF,30-34,Midfielder,Chile,South America
114,Luiz Araújo,BRA,Lille,Ligue 1,2019,23.0,1996.0,9.2,20,11,3,8,9,5,31,16.1,26,14,0,14,4,24,6,0,"FW,MF",20-24,Forward,Brazil,South America
118,Alphonse Areola,FRA,Real Madrid,La Liga,2019,26.0,1993.0,4.0,0,0,0,0,0,0,0,,0,0,0,0,0,0,0,0,GK,25-29,Goalkeeper,France,Europe
119,Alphonse Areola,FRA,Paris S-G,Ligue 1,2019,26.0,1993.0,3.0,0,0,0,0,0,0,0,,0,0,0,0,0,0,1,1,GK,25-29,Goalkeeper,France,Europe
120,Santiago Arias,COL,Atlético Madrid,La Liga,2019,27.0,1992.0,12.0,36,24,20,12,4,10,18,55.6,8,12,7,5,19,55,20,1,DF,25-29,Defender,Colombia,South America
121,Nicolò Armini,ITA,Lazio,Serie A,2019,18.0,2001.0,0.0,1,1,1,0,0,1,1,100.0,0,0,0,0,0,1,1,0,DF,Under 20,Defender,Italy,Europe
122,Stuart Armstrong,SCO,Southampton,Premier League,2019,27.0,1992.0,19.1,32,19,19,11,2,9,38,23.7,29,22,4,18,11,43,23,1,MF,25-29,Midfielder,Scotland,Europe
125,Maximilian Arnold,GER,Wolfsburg,Bundesliga,2019,25.0,1994.0,31.3,42,24,15,23,4,16,62,25.8,46,25,6,19,25,67,35,0,MF,25-29,Midfielder,Germany,Europe
127,Kwadwo Asamoah,GHA,Inter,Serie A,2019,30.0,1988.0,7.1,10,8,4,5,1,6,14,42.9,8,8,1,7,9,19,13,0,"DF,FW",30-34,Defender,Ghana,Africa
128,Santiago Ascacíbar,ARG,Hertha BSC,Bundesliga,2019,22.0,1997.0,7.0,26,13,15,11,0,11,28,39.3,17,13,2,11,16,42,13,0,MF,20-24,Midfielder,Argentina,South America
133,Roger Assalé,CIV,Leganés,La Liga,2019,25.0,1993.0,5.9,3,2,1,0,2,1,9,11.1,8,8,0,8,0,3,1,0,"FW,MF",25-29,Forward,Ivory Coast,Africa
137,Pierre-Emerick Aubameyang,GAB,Arsenal,Premier League,2019,30.0,1989.0,34.8,31,19,10,12,9,12,51,23.5,39,39,1,38,14,45,16,0,FW,30-34,Forward,Gabon,Africa
138,Emil Audero,ITA,Sampdoria,Serie A,2019,22.0,1997.0,36.0,1,1,1,0,0,1,3,33.3,2,0,0,0,0,1,21,1,GK,20-24,Goalkeeper,Italy,Europe
139,Tommaso Augello,ITA,Sampdoria,Serie A,2019,24.0,1994.0,12.6,14,9,6,3,5,5,7,71.4,2,8,0,8,15,29,21,1,DF,20-24,Defender,Italy,Europe
140,Jean-Kévin Augustin,FRA,Monaco,Ligue 1,2019,22.0,1997.0,3.0,3,0,1,2,0,1,6,16.7,5,2,0,2,3,6,0,0,FW,20-24,Forward,France,Europe
142,Serge Aurier,CIV,Tottenham,Premier League,2019,26.0,1992.0,30.0,93,69,58,27,8,39,69,56.5,30,38,6,32,47,140,98,2,DF,25-29,Defender,Ivory Coast,Africa
143,Mathias Autret,FRA,Brest,Ligue 1,2019,28.0,1991.0,13.6,23,17,5,11,7,8,25,32.0,17,14,1,13,10,33,3,0,"MF,FW",25-29,Midfielder,France,Europe
147,Taiwo Awoniyi,NGA,Mainz 05,Bundesliga,2019,21.0,1997.0,5.4,2,0,0,2,0,0,4,0.0,4,4,2,2,2,4,3,0,"FW,MF",20-24,Forward,Nigeria,Africa
148,Florian Ayé,FRA,Brescia,Serie A,2019,22.0,1997.0,15.3,17,9,9,5,3,6,13,46.2,7,17,2,15,4,21,18,1,"FW,MF",20-24,Forward,France,Europe
149,Jordan Ayew,GHA,Crystal Palace,Premier League,2019,27.0,1991.0,35.0,48,30,10,22,16,17,49,34.7,32,29,4,25,15,63,21,0,FW,25-29,Forward,Ghana,Africa
151,Ramon Azeez,NGA,Granada,La Liga,2019,26.0,1992.0,15.1,11,8,2,8,1,7,19,36.8,12,8,2,6,19,30,11,1,MF,25-29,Midfielder,Nigeria,Africa
154,Iddrisu Baba,GHA,Mallorca,La Liga,2019,23.0,1996.0,32.3,59,37,26,29,4,20,70,28.6,50,31,8,23,39,98,42,0,MF,20-24,Midfielder,Ghana,Africa
156,Carlos Bacca,COL,Villarreal,La Liga,2019,32.0,1986.0,7.6,5,1,1,2,2,2,6,33.3,4,4,0,4,0,5,7,0,FW,30-34,Forward,Colombia,South America
157,Milan Badelj,CRO,Fiorentina,Serie A,2019,30.0,1989.0,17.6,29,17,10,16,3,15,50,30.0,35,21,3,18,45,74,34,1,MF,30-34,Midfielder,Croatia,Europe
158,Matthias Bader,GER,Köln,Bundesliga,2019,22.0,1997.0,0.1,1,1,1,0,0,1,2,50.0,1,0,0,0,0,1,1,0,DF,20-24,Defender,Germany,Europe
159,Benoît Badiashile,FRA,Monaco,Ligue 1,2019,18.0,2001.0,15.7,18,12,12,5,1,6,12,50.0,6,20,11,9,27,45,57,1,DF,Under 20,Defender,France,Europe
160,Bastian Badu,FRA,Montpellier,Ligue 1,2019,19.0,2000.0,0.1,0,0,0,0,0,0,0,,0,0,0,0,0,0,0,0,FW,Under 20,Forward,France,Europe
163,Daniel Baier,GER,Augsburg,Bundesliga,2019,35.0,1984.0,21.6,33,17,14,14,5,15,43,34.9,28,19,7,12,58,91,27,0,MF,35-39,Midfielder,Germany,Europe
164,Leon Bailey,JAM,Leverkusen,Bundesliga,2019,21.0,1997.0,12.1,6,3,1,5,0,6,16,37.5,10,9,0,9,8,14,3,0,"FW,MF",20-24,Forward,Jamaica,North America
165,Eric Bailly,CIV,Manchester Utd,Premier League,2019,25.0,1994.0,1.7,0,0,0,0,0,0,1,0.0,1,3,3,0,4,4,7,1,DF,25-29,Defender,Ivory Coast,Africa
167,Leighton Baines,ENG,Everton,Premier League,2019,34.0,1984.0,4.5,10,6,6,2,2,8,10,80.0,2,5,2,3,5,15,14,0,DF,30-34,Defender,England,Europe
168,Stefan Bajic,FRA,Saint-Étienne,Ligue 1,2019,17.0,2001.0,1.0,0,0,0,0,0,0,0,,0,1,0,1,0,0,2,0,GK,Under 20,Goalkeeper,France,Europe
170,Lewis Baker,ENG,Düsseldorf,Bundesliga,2019,24.0,1995.0,6.1,8,5,6,2,0,2,10,20.0,8,5,2,3,2,10,5,0,MF,20-24,Midfielder,England,Europe
171,Mitchel Bakker,NED,Paris S-G,Ligue 1,2019,19.0,2000.0,1.0,2,2,1,1,0,1,1,100.0,0,0,0,0,0,2,2,0,DF,Under 20,Defender,Netherlands,Europe
172,Ridle Baku,GER,Mainz 05,Bundesliga,2019,21.0,1998.0,26.1,54,31,25,22,7,26,53,49.1,27,45,7,38,42,96,57,0,"DF,MF",20-24,Defender,Germany,Europe
174,Keita Baldé,SEN,Monaco,Ligue 1,2019,24.0,1995.0,9.5,6,5,1,1,4,3,9,33.3,6,4,1,3,2,8,7,1,"FW,MF",20-24,Forward,Senegal,Africa
175,George Baldock,GRE,Sheffield Utd,Premier League,2019,26.0,1993.0,38.0,62,43,35,17,10,27,47,57.4,20,26,3,23,34,96,83,3,DF,25-29,Defender,Greece,Europe
176,Gareth Bale,WAL,Real Madrid,La Liga,2019,30.0,1989.0,12.1,9,5,5,2,2,3,14,21.4,11,8,2,6,6,15,9,0,"FW,MF",30-34,Forward,Wales,Europe
178,Leonardo Balerdi,ARG,Dortmund,Bundesliga,2019,20.0,1999.0,1.5,2,1,1,1,0,2,2,100.0,0,0,0,0,4,6,3,0,"DF,MF",20-24,Defender,Argentina,South America
180,Fodé Ballo-Touré,SEN,Monaco,Ligue 1,2019,22.0,1997.0,18.7,36,25,21,11,4,17,32,53.1,15,10,1,9,24,60,45,0,DF,20-24,Defender,Senegal,Africa
181,Florent Balmont,FRA,Dijon,Ligue 1,2019,39.0,1980.0,4.5,12,6,5,7,0,7,12,58.3,5,6,0,6,1,13,3,0,MF,35-39,Midfielder,France,Europe
182,Mario Balotelli,ITA,Brescia,Serie A,2019,28.0,1990.0,15.6,2,2,0,2,0,0,2,0.0,2,1,1,0,8,10,22,0,FW,25-29,Forward,Italy,Europe
183,Abdoulaye Bamba,CIV,Angers,Ligue 1,2019,29.0,1990.0,6.2,10,7,7,1,2,8,15,53.3,7,4,1,3,4,14,18,0,DF,25-29,Defender,Ivory Coast,Africa
184,Jonathan Bamba,CIV,Lille,Ligue 1,2019,23.0,1996.0,21.5,12,6,5,5,2,7,29,24.1,22,19,3,16,16,28,8,2,"FW,MF",20-24,Forward,Ivory Coast,Africa
185,Éver Banega,ARG,Sevilla,La Liga,2019,31.0,1988.0,27.5,43,28,16,18,9,21,70,30.0,49,19,1,18,15,58,5,0,MF,30-34,Midfielder,Argentina,South America
186,Mattia Bani,ITA,Bologna,Serie A,2019,25.0,1993.0,24.5,47,28,27,19,1,25,36,69.4,11,29,15,14,52,99,92,2,DF,25-29,Defender,Italy,Europe
189,Federico Barba,ITA,Valladolid,La Liga,2019,25.0,1993.0,5.0,12,6,10,2,0,7,9,77.8,2,5,2,3,8,20,12,0,DF,25-29,Defender,Italy,Europe
190,Danilo Barbosa,BRA,Nice,Ligue 1,2019,23.0,1996.0,12.5,28,21,17,9,2,13,29,44.8,16,21,6,15,20,48,38,0,"DF,MF",20-24,Defender,Brazil,South America
193,Phil Bardsley,SCO,Burnley,Premier League,2019,34.0,1985.0,21.0,49,36,16,24,9,24,37,64.9,13,24,11,13,30,79,73,0,DF,30-34,Defender,Scotland,Europe
194,Nicolò Barella,ITA,Inter,Serie A,2019,22.0,1997.0,22.4,36,21,14,15,7,8,37,21.6,29,20,5,15,14,50,14,0,MF,20-24,Midfielder,Italy,Europe
195,Philipp Bargfrede,GER,Werder Bremen,Bundesliga,2019,30.0,1989.0,6.5,15,12,8,5,2,6,23,26.1,17,8,2,6,16,31,15,0,MF,30-34,Midfielder,Germany,Europe
196,Antonino Barillà,ITA,Parma,Serie A,2019,31.0,1988.0,18.8,43,31,22,19,2,16,45,35.6,29,26,8,18,17,60,32,0,MF,30-34,Midfielder,Italy,Europe
198,Ross Barkley,ENG,Chelsea,Premier League,2019,25.0,1993.0,12.3,16,9,6,6,4,5,18,27.8,13,7,2,5,7,23,7,0,MF,25-29,Midfielder,England,Europe
199,Aymen Barkok,MAR,Düsseldorf,Bundesliga,2019,21.0,1998.0,0.9,1,1,0,0,1,0,2,0.0,2,2,0,2,3,4,1,0,"FW,MF",20-24,Forward,Morocco,Africa
200,Ashley Barnes,ENG,Burnley,Premier League,2019,29.0,1989.0,15.0,10,5,3,5,2,3,9,33.3,6,7,2,5,6,16,9,0,FW,25-29,Forward,England,Europe
201,Harvey Barnes,ENG,Leicester City,Premier League,2019,21.0,1997.0,23.1,16,11,7,7,2,5,23,21.7,18,13,3,10,8,24,6,1,"MF,FW",20-24,Midfielder,England,Europe
203,Antonio Barreca,ITA,Genoa,Serie A,2019,24.0,1995.0,12.2,10,7,5,3,2,4,5,80.0,1,12,7,5,1,11,22,0,"DF,FW",20-24,Defender,Italy,Europe
207,Musa Barrow,GAM,Bologna,Serie A,2019,20.0,1998.0,15.0,20,13,11,7,2,6,20,30.0,14,15,0,15,5,25,11,0,"FW,MF",20-24,Forward,Gambia,Africa
208,Musa Barrow,GAM,Atalanta,Serie A,2019,20.0,1998.0,2.1,1,1,0,0,1,1,4,25.0,3,4,0,4,0,1,1,0,"FW,MF",20-24,Forward,Gambia,Africa
209,Fin Bartels,GER,Werder Bremen,Bundesliga,2019,32.0,1987.0,3.8,9,5,4,4,1,3,12,25.0,9,3,1,2,1,10,1,0,"MF,FW",30-34,Midfielder,Germany,Europe
211,Daniele Baselli,ITA,Torino,Serie A,2019,27.0,1992.0,14.2,43,23,17,19,7,13,40,32.5,27,20,4,16,25,68,25,0,MF,25-29,Midfielder,Italy,Europe
212,Chris Basham,ENG,Sheffield Utd,Premier League,2019,31.0,1988.0,36.0,85,48,58,20,7,48,81,59.3,33,38,15,23,77,162,173,1,DF,30-34,Defender,England,Europe
213,Toma Bašić,CRO,Bordeaux,Ligue 1,2019,22.0,1996.0,11.0,26,22,9,16,1,12,27,44.4,15,14,2,12,9,35,12,1,MF,20-24,Midfielder,Croatia,Europe
214,Thomas Basila,FRA,Nantes,Ligue 1,2019,20.0,1999.0,4.6,6,3,2,4,0,4,4,100.0,0,0,0,0,4,10,14,0,DF,20-24,Defender,France,Europe
218,Alessandro Bastoni,ITA,Inter,Serie A,2019,20.0,1999.0,21.3,32,17,14,11,7,15,24,62.5,9,18,9,9,26,58,54,0,DF,20-24,Defender,Italy,Europe
221,Michy Batshuayi,BEL,Chelsea,Premier League,2019,25.0,1993.0,2.7,4,1,2,2,0,0,5,0.0,5,1,1,0,0,4,1,0,FW,25-29,Forward,Belgium,Europe
223,Oliver Baumann,GER,Hoffenheim,Bundesliga,2019,29.0,1990.0,30.0,0,0,0,0,0,0,0,,0,1,0,1,3,3,15,0,GK,25-29,Goalkeeper,Germany,Europe
224,Julian Baumgartlinger,AUT,Leverkusen,Bundesliga,2019,31.0,1988.0,19.9,42,21,15,21,6,18,42,42.9,24,37,4,33,20,62,16,1,MF,30-34,Midfielder,Austria,Europe
225,Christoph Baumgartner,AUT,Hoffenheim,Bundesliga,2019,19.0,1999.0,16.6,32,17,15,16,1,10,37,27.0,27,25,1,24,8,40,13,0,"MF,FW",Under 20,Midfielder,Austria,Europe
226,Noah Joel Sarenren Bazee,NGA,Augsburg,Bundesliga,2019,22.0,1996.0,4.2,4,3,0,4,0,1,4,25.0,3,2,1,1,5,9,4,0,FW,20-24,Forward,Nigeria,Africa
229,Sheraldo Becker,SUR,Union Berlin,Bundesliga,2019,24.0,1995.0,6.0,2,1,2,0,0,1,3,33.3,2,1,0,1,0,2,1,0,"MF,FW",20-24,Midfielder,Suriname,South America
230,Timo Becker,GER,Schalke 04,Bundesliga,2019,22.0,1997.0,3.7,10,9,3,6,1,5,9,55.6,4,6,1,5,3,13,8,0,"DF,MF",20-24,Defender,Germany,Europe
233,Valon Behrami,SUI,Genoa,Serie A,2019,34.0,1985.0,12.3,34,26,13,17,4,8,32,25.0,24,25,10,15,9,43,16,0,MF,30-34,Midfielder,Switzerland,Europe
235,Gaëtan Belaud,FRA,Brest,Ligue 1,2019,32.0,1986.0,6.4,13,7,10,2,1,4,8,50.0,4,8,3,5,15,28,15,0,DF,30-34,Defender,France,Europe
236,Ishak Belfodil,ALG,Hoffenheim,Bundesliga,2019,27.0,1992.0,3.0,0,0,0,0,0,0,1,0.0,1,0,0,0,0,0,2,0,"FW,MF",25-29,Forward,Algeria,Africa
237,Haris Belkebla,ALG,Brest,Ligue 1,2019,25.0,1994.0,20.2,44,24,17,17,10,10,28,35.7,18,25,5,20,53,97,21,2,MF,25-29,Midfielder,Algeria,Africa
238,Raoul Bellanova,ITA,Atalanta,Serie A,2019,19.0,2000.0,0.2,0,0,0,0,0,0,0,,0,0,0,0,0,0,0,0,DF,Under 20,Defender,Italy,Europe
239,Raoul Bellanova,ITA,Bordeaux,Ligue 1,2019,19.0,2000.0,0.7,1,1,1,0,0,0,1,0.0,1,0,0,0,0,1,0,0,DF,Under 20,Defender,Italy,Europe
240,Karim Bellarabi,GER,Leverkusen,Bundesliga,2019,29.0,1990.0,15.8,19,11,9,7,3,9,28,32.1,19,16,0,16,10,29,4,0,"FW,DF",25-29,Forward,Germany,Europe
241,Jean-Ricner Bellegarde,FRA,Strasbourg,Ligue 1,2019,21.0,1998.0,16.6,40,27,18,19,3,13,21,61.9,8,16,3,13,22,62,6,0,MF,20-24,Midfielder,France,Europe
245,Sami Ben Amar,MAR,Nîmes,Ligue 1,2019,21.0,1998.0,0.2,1,1,0,0,1,1,1,100.0,0,1,0,1,1,2,0,0,FW,20-24,Forward,Morocco,Africa
246,Hatem Ben Arfa,FRA,Valladolid,La Liga,2019,32.0,1987.0,1.8,0,0,0,0,0,0,4,0.0,4,1,0,1,0,0,0,0,"MF,FW",30-34,Midfielder,France,Europe
247,Wissam Ben Yedder,FRA,Monaco,Ligue 1,2019,28.0,1990.0,24.0,22,16,2,12,8,8,19,42.1,11,12,0,12,4,26,1,0,FW,25-29,Forward,France,Europe
248,Marco Benassi,ITA,Fiorentina,Serie A,2019,24.0,1994.0,10.9,18,12,9,5,4,10,24,41.7,14,11,1,10,4,22,9,0,MF,20-24,Midfielder,Italy,Europe
250,Lars Bender,GER,Leverkusen,Bundesliga,2019,30.0,1989.0,15.3,42,26,17,20,5,19,38,50.0,19,32,6,26,24,66,30,0,"DF,MF",30-34,Defender,Germany,Europe
251,Sven Bender,GER,Leverkusen,Bundesliga,2019,30.0,1989.0,30.3,53,34,29,17,7,23,48,47.9,25,42,13,29,67,120,88,2,DF,30-34,Defender,Germany,Europe
252,Darío Benedetto,ARG,Marseille,Ligue 1,2019,29.0,1990.0,23.3,12,9,0,9,3,3,18,16.7,15,15,2,13,3,15,23,1,FW,25-29,Forward,Argentina,South America
253,László Bénes,SVK,Gladbach,Bundesliga,2019,21.0,1997.0,10.0,15,8,3,5,7,6,19,31.6,13,6,2,4,8,23,3,1,MF,20-24,Midfielder,Slovakia,Europe
255,Loris Benito,SUI,Bordeaux,Ligue 1,2019,27.0,1992.0,21.1,40,25,23,11,6,16,43,37.2,27,14,5,9,29,69,58,1,DF,25-29,Defender,Switzerland,Europe
257,Ismaël Bennacer,ALG,Milan,Serie A,2019,21.0,1997.0,27.6,67,47,21,34,12,29,73,39.7,44,25,7,18,54,121,15,2,MF,20-24,Midfielder,Algeria,Africa
258,Ryan Bennett,ENG,Wolves,Premier League,2019,29.0,1990.0,6.7,4,2,4,0,0,2,6,33.3,4,14,8,6,9,13,29,0,DF,25-29,Defender,England,Europe
259,Ryan Bennett,ENG,Leicester City,Premier League,2019,29.0,1990.0,3.7,5,4,3,2,0,4,6,66.7,2,3,1,2,7,12,8,0,DF,25-29,Defender,England,Europe
260,Keanan Bennetts,ENG,Gladbach,Bundesliga,2019,20.0,1999.0,0.0,0,0,0,0,0,0,1,0.0,1,0,0,0,0,0,0,0,MF,20-24,Midfielder,England,Europe
261,Yassine Benrahou,FRA,Bordeaux,Ligue 1,2019,20.0,1999.0,1.9,3,0,1,1,1,2,5,40.0,3,1,0,1,2,5,1,0,"FW,MF",20-24,Forward,France,Europe
262,Yassine Benrahou,FRA,Nîmes,Ligue 1,2019,20.0,1999.0,8.5,13,8,3,3,7,5,16,31.3,11,1,0,1,2,15,0,0,"MF,FW",20-24,Midfielder,France,Europe
263,Ramy Bensebaini,ALG,Gladbach,Bundesliga,2019,24.0,1995.0,16.1,33,17,17,12,4,18,31,58.1,13,24,4,20,38,71,49,0,DF,20-24,Defender,Algeria,Africa
264,Nabil Bentaleb,ALG,Newcastle Utd,Premier League,2019,24.0,1994.0,8.3,23,13,14,9,0,7,25,28.0,18,9,2,7,19,42,9,1,MF,20-24,Midfielder,Algeria,Africa
265,Rodrigo Bentancur,URU,Juventus,Serie A,2019,22.0,1997.0,24.4,58,32,27,18,13,31,66,47.0,35,44,9,35,32,90,34,1,MF,20-24,Midfielder,Uruguay,South America
266,Christian Benteke,BEL,Crystal Palace,Premier League,2019,28.0,1990.0,14.0,9,5,1,6,2,0,10,0.0,10,11,4,7,4,13,28,1,FW,25-29,Forward,Belgium,Europe
267,Romario Benzar,ROU,Lecce,Serie A,2019,27.0,1992.0,1.1,2,2,1,1,0,2,3,66.7,1,1,0,1,0,2,2,0,DF,25-29,Defender,Romania,Europe
268,Karim Benzema,FRA,Real Madrid,La Liga,2019,31.0,1987.0,34.9,18,8,3,11,4,2,16,12.5,14,16,4,12,7,25,30,1,FW,30-34,Forward,France,Europe
270,Domenico Berardi,ITA,Sassuolo,Serie A,2019,24.0,1994.0,27.7,32,16,19,8,5,13,59,22.0,46,31,3,28,33,65,27,0,FW,20-24,Forward,Italy,Europe
279,Etrit Berisha,ALB,SPAL,Serie A,2019,30.0,1989.0,26.0,3,2,3,0,0,2,3,66.7,1,0,0,0,1,4,9,0,GK,30-34,Goalkeeper,Albania,Europe
284,Federico Bernardeschi,ITA,Juventus,Serie A,2019,25.0,1994.0,17.5,13,5,4,5,4,5,25,20.0,20,11,0,11,13,26,12,1,"MF,FW",25-29,Midfielder,Italy,Europe
285,Bernardo,BRA,Brighton,Premier League,2019,24.0,1995.0,7.5,27,16,12,9,6,13,17,76.5,4,7,3,4,6,33,24,0,"DF,MF",20-24,Defender,Brazil,South America
285,Bernardo,BRA,Brighton,Premier League,2019,24.0,1995.0,7.5,27,16,12,9,6,13,17,76.5,4,7,3,4,6,33,24,0,"DF,MF",20-24,Defender,Brazil,South America
285,Bernardo,BRA,Brighton,Premier League,2019,24.0,1995.0,7.5,27,16,12,9,6,13,17,76.5,4,7,3,4,6,33,24,0,"DF,MF",20-24,Defender,Brazil,South America
285,Bernardo,BRA,Brighton,Premier League,2019,24.0,1995.0,7.5,27,16,12,9,6,13,17,76.5,4,7,3,4,6,33,24,0,"DF,MF",20-24,Defender,Brazil,South America
288,Dimitry Bertaud,COD,Montpellier,Ligue 1,2019,21.0,1998.0,2.2,0,0,0,0,0,0,0,,0,0,0,0,0,0,0,0,GK,20-24,Goalkeeper,DR Congo,Africa
290,Ryan Bertrand,ENG,Southampton,Premier League,2019,29.0,1989.0,30.5,47,29,22,15,10,26,58,44.8,32,27,12,15,37,84,31,1,DF,25-29,Defender,England,Europe
292,Jordan Beyer,GER,Gladbach,Bundesliga,2019,19.0,2000.0,1.2,3,1,3,0,0,0,1,0.0,1,4,2,2,1,4,4,0,DF,Under 20,Defender,Germany,Europe
296,El Bilal Touré,MLI,Reims,Ligue 1,2019,17.0,2001.0,5.0,3,3,1,0,2,0,0,,0,6,0,6,1,4,1,0,FW,Under 20,Forward,Mali,Africa
297,Philip Billing,DEN,Bournemouth,Premier League,2019,23.0,1996.0,28.1,72,46,30,37,5,17,65,26.2,48,59,16,43,66,138,97,1,MF,20-24,Midfielder,Denmark,Europe
298,Cristiano Biraghi,ITA,Inter,Serie A,2019,26.0,1992.0,17.5,22,6,10,8,4,10,24,41.7,14,21,7,14,13,35,41,0,DF,25-29,Defender,Italy,Europe
301,Dimitri Bisoli,ITA,Brescia,Serie A,2019,25.0,1994.0,23.9,64,35,34,20,10,30,49,61.2,19,41,7,34,25,89,49,0,MF,25-29,Midfielder,Italy,Europe
302,Yves Bissouma,MLI,Brighton,Premier League,2019,22.0,1996.0,14.0,49,38,24,22,3,17,40,42.5,23,18,2,16,21,70,23,0,MF,20-24,Midfielder,Mali,Africa
303,Leonardo Bittencourt,GER,Hoffenheim,Bundesliga,2019,25.0,1993.0,0.0,1,1,0,0,1,0,0,,0,0,0,0,0,1,0,0,MF,25-29,Midfielder,Germany,Europe
304,Leonardo Bittencourt,GER,Werder Bremen,Bundesliga,2019,25.0,1993.0,21.0,52,28,23,18,11,9,51,17.6,42,20,3,17,12,64,14,0,"FW,MF",25-29,Forward,Germany,Europe
307,Ludovic Blas,FRA,Nantes,Ligue 1,2019,21.0,1997.0,20.5,26,18,7,15,4,5,26,19.2,21,17,1,16,14,40,11,0,"FW,MF",20-24,Forward,France,Europe
308,Pablo de Blasis,ARG,Eibar,La Liga,2019,31.0,1988.0,17.8,41,32,22,13,6,30,63,47.6,33,13,0,13,24,65,21,0,"DF,MF",30-34,Defender,Argentina,South America
310,Alexis Blin,FRA,Amiens,Ligue 1,2019,22.0,1996.0,20.5,39,25,18,15,6,20,61,32.8,41,25,6,19,16,55,49,0,MF,20-24,Midfielder,France,Europe
311,Jérôme Boateng,GER,Bayern Munich,Bundesliga,2019,30.0,1988.0,20.0,21,14,9,12,0,11,22,50.0,11,15,11,4,33,54,58,1,DF,30-34,Defender,Germany,Europe
312,Kevin-Prince Boateng,GHA,Fiorentina,Serie A,2019,32.0,1987.0,6.7,3,1,0,2,1,2,8,25.0,6,3,0,3,1,4,7,0,FW,30-34,Forward,Ghana,Africa
313,Antonin Bobichon,FRA,Nîmes,Ligue 1,2019,23.0,1995.0,2.0,4,3,1,3,0,3,3,100.0,0,1,0,1,1,5,0,0,MF,20-24,Midfielder,France,Europe
314,Antonin Bobichon,FRA,Angers,Ligue 1,2019,23.0,1995.0,7.2,9,4,4,5,0,2,19,10.5,17,7,0,7,7,16,4,0,MF,20-24,Midfielder,France,Europe
315,Salvatore Bocchetti,ITA,Hellas Verona,Serie A,2019,32.0,1986.0,3.4,5,3,3,2,0,2,3,66.7,1,2,2,0,17,22,23,0,DF,30-34,Defender,Italy,Europe
316,Mathieu Bodmer,FRA,Amiens,Ligue 1,2019,36.0,1982.0,1.0,0,0,0,0,0,0,1,0.0,1,1,1,0,1,1,1,0,"MF,FW",35-39,Midfielder,France,Europe
317,Adam Bodzek,GER,Düsseldorf,Bundesliga,2019,33.0,1985.0,22.4,42,26,21,20,1,14,46,30.4,32,34,11,23,25,67,39,0,MF,30-34,Midfielder,Germany,Europe
318,Jean-Paul Boëtius,NED,Mainz 05,Bundesliga,2019,25.0,1994.0,25.2,63,33,21,31,11,20,57,35.1,37,38,1,37,26,89,6,0,MF,25-29,Midfielder,Netherlands,Europe
319,Sacha Boey,FRA,Rennes,Ligue 1,2019,18.0,2000.0,1.9,6,4,3,1,2,4,8,50.0,4,0,0,0,2,8,5,0,DF,Under 20,Defender,France,Europe
322,Quentin Boisgard,FRA,Toulouse,Ligue 1,2019,22.0,1997.0,12.7,31,19,10,14,7,14,35,40.0,21,11,0,11,12,43,4,1,"MF,FW",20-24,Midfielder,France,Europe
323,Willy Boly,CIV,Wolves,Premier League,2019,28.0,1991.0,22.0,57,33,36,21,0,25,43,58.1,18,28,11,17,39,96,108,3,DF,25-29,Defender,Ivory Coast,Africa
324,Giacomo Bonaventura,ITA,Milan,Serie A,2019,29.0,1989.0,14.9,16,9,5,6,5,5,17,29.4,12,8,3,5,7,23,10,0,"MF,FW",25-29,Midfielder,Italy,Europe
325,Federico Bonazzoli,ITA,Sampdoria,Serie A,2019,22.0,1997.0,8.3,7,5,1,4,2,0,7,0.0,7,3,0,3,5,12,2,0,FW,20-24,Forward,Italy,Europe
326,Gaëtan Bong,CMR,Brighton,Premier League,2019,31.0,1988.0,0.7,1,0,0,0,1,0,0,,0,1,1,0,0,1,0,0,"DF,MF",30-34,Defender,Cameroon,Africa
327,Kevin Bonifazi,ITA,Torino,Serie A,2019,23.0,1996.0,2.7,9,8,6,3,0,5,6,83.3,1,3,2,1,5,14,10,0,DF,20-24,Defender,Italy,Europe
328,Kevin Bonifazi,ITA,SPAL,Serie A,2019,23.0,1996.0,13.2,16,9,15,1,0,9,18,50.0,9,20,12,8,35,51,50,2,DF,20-24,Defender,Italy,Europe
329,Federico Bonini,ITA,Bologna,Serie A,2019,17.0,2001.0,0.1,0,0,0,0,0,0,0,,0,0,0,0,0,0,0,0,DF,Under 20,Defender,Italy,Europe
334,Robin Bormuth,GER,Düsseldorf,Bundesliga,2019,23.0,1995.0,2.0,2,1,2,0,0,2,3,66.7,1,6,5,1,0,2,12,0,DF,20-24,Defender,Germany,Europe
335,Sebastiaan Bornauw,BEL,Köln,Bundesliga,2019,20.0,1999.0,27.2,37,24,24,12,1,20,39,51.3,19,32,12,20,42,79,99,0,DF,20-24,Defender,Belgium,Europe
336,Brandon Borrello,AUS,Freiburg,Bundesliga,2019,24.0,1995.0,3.3,10,4,6,4,0,4,10,40.0,6,7,1,6,1,11,1,0,"MF,FW",20-24,Midfielder,Australia,Oceania
338,Denis Bouanga,GAB,Saint-Étienne,Ligue 1,2019,24.0,1994.0,22.7,45,34,10,25,10,20,55,36.4,35,30,0,30,10,55,15,0,"FW,MF",20-24,Forward,Gabon,Africa
339,Hicham Boudaoui,ALG,Nice,Ligue 1,2019,19.0,1999.0,5.4,20,10,6,11,3,9,23,39.1,14,10,3,7,13,33,7,0,"MF,FW",Under 20,Midfielder,Algeria,Africa
340,Ryad Boudebouz,ALG,Saint-Étienne,Ligue 1,2019,29.0,1990.0,17.7,25,16,9,14,2,8,25,32.0,17,14,1,13,7,32,5,0,"MF,FW",25-29,Midfielder,Algeria,Africa
342,Nassim Boujellab,MAR,Schalke 04,Bundesliga,2019,20.0,1999.0,4.7,12,10,5,4,3,5,14,35.7,9,8,1,7,7,19,5,0,"MF,FW",20-24,Midfielder,Morocco,Africa
343,Farid Boulaya,ALG,Metz,Ligue 1,2019,26.0,1993.0,9.1,14,10,7,4,3,7,19,36.8,12,5,0,5,6,20,3,0,FW,25-29,Forward,Algeria,Africa
346,Benjamin Bourigeaud,FRA,Rennes,Ligue 1,2019,25.0,1994.0,21.1,40,12,18,20,2,17,68,25.0,51,38,7,31,20,60,25,0,MF,25-29,Midfielder,France,Europe
348,Jarrod Bowen,ENG,West Ham,Premier League,2019,22.0,1996.0,10.2,19,15,7,9,3,4,17,23.5,13,6,0,6,16,35,8,0,"FW,MF",20-24,Forward,England,Europe
350,John Boye,GHA,Metz,Ligue 1,2019,32.0,1987.0,23.5,30,19,25,5,0,19,32,59.4,13,31,18,13,31,61,116,0,DF,30-34,Defender,Ghana,Africa
352,Domagoj Bradarić,CRO,Lille,Ligue 1,2019,19.0,1999.0,15.8,28,11,9,17,2,12,27,44.4,15,16,3,13,22,50,28,0,DF,Under 20,Defender,Croatia,Europe
354,Robbie Brady,IRL,Burnley,Premier League,2019,27.0,1992.0,5.0,11,9,5,4,2,3,10,30.0,7,10,2,8,5,16,8,0,MF,25-29,Midfielder,Republic of Ireland,Europe
355,Martin Braithwaite,DEN,Barcelona,La Liga,2019,28.0,1991.0,4.5,2,2,2,0,0,0,8,0.0,8,3,0,3,1,3,1,0,"FW,MF",25-29,Forward,Denmark,Europe
356,Martin Braithwaite,DEN,Leganés,La Liga,2019,28.0,1991.0,21.5,13,7,4,5,4,4,12,33.3,8,10,2,8,4,17,9,0,"FW,MF",25-29,Forward,Denmark,Europe
357,Federico Brancolini,ITA,Fiorentina,Serie A,2019,18.0,2001.0,0.1,0,0,0,0,0,0,0,,0,0,0,0,0,0,0,0,GK,Under 20,Goalkeeper,Italy,Europe
359,Julian Brandt,GER,Dortmund,Bundesliga,2019,23.0,1996.0,24.5,48,33,15,21,12,25,55,45.5,30,35,2,33,16,64,10,1,"MF,FW",20-24,Midfielder,Germany,Europe
362,Claudio Bravo,CHI,Manchester City,Premier League,2019,36.0,1983.0,3.9,0,0,0,0,0,0,0,,0,0,0,0,0,0,1,1,GK,35-39,Goalkeeper,Chile,South America
365,Marco Brescianini,ITA,Milan,Serie A,2019,19.0,2000.0,0.3,1,1,1,0,0,0,0,,0,0,0,0,2,3,0,0,MF,Under 20,Midfielder,Italy,Europe
366,Anthony Briançon,FRA,Nîmes,Ligue 1,2019,24.0,1994.0,19.3,29,19,20,9,0,17,34,50.0,17,22,16,6,39,68,80,0,DF,20-24,Defender,France,Europe
367,Jimmy Briand,FRA,Bordeaux,Ligue 1,2019,33.0,1985.0,16.9,12,8,5,4,3,3,13,23.1,10,8,4,4,6,18,12,0,FW,30-34,Forward,France,Europe
370,Dylan Bronn,TUN,Metz,Ligue 1,2019,24.0,1995.0,9.0,7,5,6,1,0,4,7,57.1,3,11,9,2,6,13,42,0,DF,20-24,Defender,Tunisia,Africa
371,David Brooks,WAL,Bournemouth,Premier League,2019,22.0,1997.0,5.6,5,5,1,2,2,2,14,14.3,12,5,1,4,2,7,1,0,"MF,FW",20-24,Midfielder,Wales,Europe
372,John Brooks,USA,Wolfsburg,Bundesliga,2019,26.0,1993.0,24.7,38,27,27,9,2,24,49,49.0,25,31,12,19,41,79,93,0,DF,25-29,Defender,United States,North America
373,Daniel Brosinski,GER,Mainz 05,Bundesliga,2019,31.0,1988.0,19.0,40,27,13,23,4,15,34,44.1,19,16,2,14,14,54,58,0,DF,30-34,Defender,Germany,Europe
374,Josh Brownhill,ENG,Burnley,Premier League,2019,23.0,1995.0,8.9,14,8,5,7,2,5,13,38.5,8,9,4,5,14,28,18,0,MF,20-24,Midfielder,England,Europe
376,Gastón Brugman,URU,Parma,Serie A,2019,26.0,1992.0,16.2,47,24,25,15,7,19,46,41.3,27,33,15,18,27,74,19,2,MF,25-29,Midfielder,Uruguay,South America
379,Jacob Bruun Larsen,DEN,Hoffenheim,Bundesliga,2019,20.0,1998.0,4.3,3,2,3,0,0,3,8,37.5,5,3,0,3,3,6,1,0,"FW,MF",20-24,Forward,Denmark,Europe
380,Jacob Bruun Larsen,DEN,Dortmund,Bundesliga,2019,20.0,1998.0,0.8,0,0,0,0,0,0,0,,0,0,0,0,0,0,0,0,FW,20-24,Forward,Denmark,Europe
382,Ante Budimir,CRO,Mallorca,La Liga,2019,28.0,1991.0,30.7,31,15,4,22,5,7,29,24.1,22,21,4,17,8,39,29,0,FW,25-29,Forward,Croatia,Europe
384,Gianluigi Buffon,ITA,Juventus,Serie A,2019,41.0,1978.0,9.0,0,0,0,0,0,0,0,,0,0,0,0,0,0,3,1,GK,Over 40,Goalkeeper,Italy,Europe
385,Marius Bülter,GER,Union Berlin,Bundesliga,2019,26.0,1993.0,25.8,38,22,19,13,6,17,54,31.5,37,37,3,34,11,49,20,1,"MF,FW",25-29,Midfielder,Germany,Europe
386,Esteban Burgos,ARG,Eibar,La Liga,2019,27.0,1992.0,12.4,11,9,9,2,0,5,9,55.6,4,11,6,5,17,28,66,2,DF,25-29,Defender,Argentina,South America
387,Guido Burgstaller,AUT,Schalke 04,Bundesliga,2019,30.0,1989.0,13.7,7,3,0,5,2,4,15,26.7,11,12,3,9,4,11,10,0,FW,30-34,Forward,Austria,Europe
389,Jonathan Burkardt,GER,Mainz 05,Bundesliga,2019,19.0,2000.0,2.8,9,4,2,5,2,3,8,37.5,5,6,1,5,0,9,1,0,"FW,MF",Under 20,Forward,Germany,Europe
390,Oliver Burke,SCO,Alavés,La Liga,2019,22.0,1997.0,15.9,19,14,8,9,2,10,23,43.5,13,24,0,24,8,27,16,0,"MF,FW",20-24,Midfielder,Scotland,Europe
391,Roman Bürki,SUI,Dortmund,Bundesliga,2019,28.0,1990.0,30.8,2,2,2,0,0,2,3,66.7,1,1,0,1,2,4,13,1,GK,25-29,Goalkeeper,Switzerland,Europe
392,Dan Burn,ENG,Brighton,Premier League,2019,27.0,1992.0,32.0,67,42,35,27,5,25,53,47.2,28,44,20,24,42,109,130,0,DF,25-29,Defender,England,Europe
396,Ludovic Butelle,FRA,Angers,Ligue 1,2019,36.0,1983.0,26.0,1,1,1,0,0,1,2,50.0,1,1,0,1,0,1,10,4,GK,35-39,Goalkeeper,France,Europe
398,Sam Byram,ENG,Norwich City,Premier League,2019,25.0,1993.0,14.4,40,22,24,11,5,18,37,48.6,19,16,8,8,26,66,73,0,DF,25-29,Defender,England,Europe
401,Willy Caballero,ARG,Chelsea,Premier League,2019,37.0,1981.0,5.0,0,0,0,0,0,0,0,,0,0,0,0,0,0,3,0,GK,35-39,Goalkeeper,Argentina,South America
402,Yohan Cabaye,FRA,Saint-Étienne,Ligue 1,2019,33.0,1986.0,9.5,29,18,11,14,4,14,25,56.0,11,10,0,10,22,51,7,1,MF,30-34,Midfielder,France,Europe
405,Leandro Cabrera,URU,Getafe,La Liga,2019,28.0,1991.0,17.0,10,6,5,5,0,5,12,41.7,7,10,4,6,21,31,66,0,DF,25-29,Defender,Uruguay,South America
406,Leandro Cabrera,URU,Espanyol,La Liga,2019,28.0,1991.0,17.0,27,11,17,9,1,17,28,60.7,11,19,12,7,21,48,78,1,DF,25-29,Defender,Uruguay,South America
407,Fabrizio Cacciatore,ITA,Cagliari,Serie A,2019,32.0,1986.0,12.8,14,4,9,4,1,6,9,66.7,3,10,6,4,16,30,44,0,DF,30-34,Defender,Italy,Europe
408,Martín Cáceres,URU,Fiorentina,Serie A,2019,32.0,1987.0,26.2,47,31,34,11,2,16,34,47.1,18,29,13,16,31,78,74,2,DF,30-34,Defender,Uruguay,South America
409,Anthony Caci,FRA,Strasbourg,Ligue 1,2019,22.0,1997.0,7.7,29,17,19,9,1,8,17,47.1,9,15,5,10,19,48,15,1,DF,20-24,Defender,France,Europe
411,Mathieu Cafaro,FRA,Reims,Ligue 1,2019,22.0,1997.0,10.3,12,6,5,5,2,6,17,35.3,11,13,0,13,2,14,0,0,"FW,MF",20-24,Forward,France,Europe
412,Jonathan Cafu,BRA,Bordeaux,Ligue 1,2019,28.0,1991.0,2.2,7,3,4,3,0,4,7,57.1,3,1,0,1,1,8,3,0,DF,25-29,Defender,Brazil,South America
413,Gary Cahill,ENG,Crystal Palace,Premier League,2019,33.0,1985.0,24.1,15,8,11,4,0,7,15,46.7,8,34,25,9,18,33,114,1,DF,30-34,Defender,England,Europe
414,Felipe Caicedo,ECU,Lazio,Serie A,2019,30.0,1988.0,15.6,17,10,4,7,6,2,11,18.2,9,9,1,8,4,21,2,0,FW,30-34,Forward,Ecuador,South America
415,Arturo Calabresi,ITA,Amiens,Ligue 1,2019,23.0,1996.0,20.9,53,33,29,20,4,33,75,44.0,42,24,11,13,29,82,60,0,DF,20-24,Defender,Italy,Europe
416,Davide Calabria,ITA,Milan,Serie A,2019,22.0,1996.0,18.0,52,33,28,22,2,17,41,41.5,24,23,5,18,21,73,47,1,DF,20-24,Defender,Italy,Europe
418,Mattia Caldara,ITA,Atalanta,Serie A,2019,25.0,1994.0,10.7,21,11,12,8,1,5,11,45.5,6,9,5,4,30,51,22,1,DF,25-29,Defender,Italy,Europe
419,Marco Calderoni,ITA,Lecce,Serie A,2019,30.0,1989.0,22.9,38,25,22,13,3,20,39,51.3,19,27,10,17,37,75,54,1,DF,30-34,Defender,Italy,Europe
422,Hakan Çalhanoğlu,TUR,Milan,Serie A,2019,25.0,1994.0,30.0,42,21,15,21,6,12,35,34.3,23,26,2,24,26,68,26,1,"MF,FW",25-29,Midfielder,Turkey,Asia
423,Daniel Caligiuri,ITA,Schalke 04,Bundesliga,2019,31.0,1988.0,25.5,58,37,18,25,15,27,74,36.5,47,67,6,61,25,83,39,0,"MF,FW",30-34,Midfielder,Italy,Europe
425,Jonathan Calleri,ARG,Espanyol,La Liga,2019,25.0,1993.0,20.1,12,8,6,4,2,3,24,12.5,21,11,3,8,7,19,22,0,FW,25-29,Forward,Argentina,South America
426,Dominic Calvert-Lewin,ENG,Everton,Premier League,2019,22.0,1997.0,29.2,7,5,1,4,2,1,10,10.0,9,15,2,13,6,13,36,0,FW,20-24,Forward,England,Europe
427,Mahdi Camara,FRA,Saint-Étienne,Ligue 1,2019,21.0,1998.0,10.0,33,20,12,16,5,18,32,56.3,14,20,2,18,18,51,5,0,MF,20-24,Midfielder,France,Europe
428,Souleymane Camara,SEN,Montpellier,Ligue 1,2019,36.0,1982.0,1.8,0,0,0,0,0,0,2,0.0,2,0,0,0,0,0,1,0,FW,35-39,Forward,Senegal,Africa
431,Eduardo Camavinga,FRA,Rennes,Ligue 1,2019,16.0,2002.0,23.4,105,64,45,56,4,48,96,50.0,48,26,8,18,34,139,35,0,MF,Under 20,Midfielder,France,Europe
436,Emre Can,GER,Juventus,Serie A,2019,25.0,1994.0,3.2,10,7,5,3,2,3,10,30.0,7,4,0,4,2,12,3,0,MF,25-29,Midfielder,Germany,Europe
437,Emre Can,GER,Dortmund,Bundesliga,2019,25.0,1994.0,10.6,19,12,11,7,1,5,12,41.7,7,14,6,8,19,38,15,0,"MF,DF",25-29,Midfielder,Germany,Europe
439,João Cancelo,POR,Manchester City,Premier League,2019,25.0,1994.0,13.4,40,24,21,12,7,24,40,60.0,16,9,2,7,21,61,18,0,DF,25-29,Defender,Portugal,Europe
440,Antonio Candreva,ITA,Inter,Serie A,2019,32.0,1987.0,22.1,11,6,9,1,1,7,29,24.1,22,26,10,16,14,25,33,1,DF,30-34,Defender,Italy,Europe
444,Pierrick Capelle,FRA,Angers,Ligue 1,2019,32.0,1987.0,19.4,42,32,18,16,8,16,48,33.3,32,17,3,14,21,63,28,0,"MF,DF",30-34,Midfielder,France,Europe
445,Étienne Capoue,FRA,Watford,Premier League,2019,31.0,1988.0,29.2,75,40,38,30,7,37,85,43.5,48,30,11,19,68,143,61,0,MF,30-34,Midfielder,France,Europe
446,Gianluca Caprari,ITA,Sampdoria,Serie A,2019,26.0,1993.0,7.4,9,7,1,6,2,4,13,30.8,9,5,0,5,7,16,1,0,"FW,MF",25-29,Forward,Italy,Europe
447,Gianluca Caprari,ITA,Parma,Serie A,2019,26.0,1993.0,6.5,1,1,0,1,0,0,5,0.0,5,7,2,5,4,5,2,0,"FW,MF",25-29,Forward,Italy,Europe
448,Francesco Caputo,ITA,Sassuolo,Serie A,2019,31.0,1987.0,32.6,7,4,3,2,2,3,11,27.3,8,15,0,15,1,8,8,0,FW,30-34,Forward,Italy,Europe
449,Maxence Caqueret,FRA,Lyon,Ligue 1,2019,19.0,2000.0,6.3,24,15,10,13,1,11,25,44.0,14,14,2,12,9,33,6,1,MF,Under 20,Midfielder,France,Europe
451,Irvin Cardona,FRA,Brest,Ligue 1,2019,21.0,1997.0,16.1,13,8,5,6,2,9,32,28.1,23,8,0,8,1,14,7,0,"FW,MF",20-24,Forward,France,Europe
455,Yannick Carrasco,BEL,Atlético Madrid,La Liga,2019,25.0,1993.0,7.0,11,7,4,4,3,7,21,33.3,14,9,0,9,5,16,2,0,"MF,FW",25-29,Midfielder,Belgium,Europe
456,Daniel Carriço,POR,Sevilla,La Liga,2019,30.0,1988.0,9.4,8,2,4,3,1,1,6,16.7,5,4,3,1,8,16,23,0,DF,30-34,Defender,Portugal,Europe
457,Guido Carrillo,ARG,Leganés,La Liga,2019,28.0,1991.0,13.5,13,10,3,6,4,2,14,14.3,12,9,1,8,3,16,22,0,FW,25-29,Forward,Argentina,South America
458,Andy Carroll,ENG,Newcastle Utd,Premier League,2019,30.0,1989.0,7.0,5,3,3,2,0,2,8,25.0,6,2,1,1,2,7,24,1,FW,30-34,Forward,England,Europe
460,Matis Carvalho,POR,Montpellier,Ligue 1,2019,20.0,1999.0,0.8,0,0,0,0,0,0,1,0.0,1,0,0,0,0,0,1,0,GK,20-24,Goalkeeper,Portugal,Europe
461,William Carvalho,POR,Betis,La Liga,2019,27.0,1992.0,9.9,7,4,4,2,1,4,14,28.6,10,7,5,2,4,11,8,1,MF,25-29,Midfielder,Portugal,Europe
462,Casemiro,BRA,Real Madrid,La Liga,2019,27.0,1992.0,34.3,96,60,43,45,8,39,99,39.4,60,53,10,43,68,164,72,0,MF,25-29,Midfielder,Brazil,South America
464,Francesco Cassata,ITA,Genoa,Serie A,2019,22.0,1997.0,16.2,20,10,12,5,3,9,30,30.0,21,12,2,10,11,31,11,0,MF,20-24,Midfielder,Italy,Europe
465,Timothy Castagne,BEL,Atalanta,Serie A,2019,23.0,1995.0,19.7,31,20,9,16,6,13,25,52.0,12,34,5,29,17,48,23,0,DF,20-24,Defender,Belgium,Europe
466,Koen Casteels,BEL,Wolfsburg,Bundesliga,2019,27.0,1992.0,26.0,0,0,0,0,0,0,0,,0,0,0,0,0,0,9,1,GK,25-29,Goalkeeper,Belgium,Europe
467,Jean-Charles Castelletto,CMR,Brest,Ligue 1,2019,24.0,1995.0,20.4,18,9,13,5,0,9,18,50.0,9,20,16,4,33,51,87,1,DF,20-24,Defender,Cameroon,Africa
472,Gaetano Castrovilli,ITA,Fiorentina,Serie A,2019,22.0,1997.0,29.7,59,31,25,23,11,18,53,34.0,35,29,2,27,15,74,31,1,MF,20-24,Midfielder,Italy,Europe
473,Danilo Cataldi,ITA,Lazio,Serie A,2019,24.0,1994.0,6.6,17,11,10,5,2,10,20,50.0,10,7,1,6,13,30,10,0,MF,20-24,Midfielder,Italy,Europe
475,Edinson Cavani,URU,Paris S-G,Ligue 1,2019,32.0,1987.0,6.7,5,1,0,2,3,0,3,0.0,3,7,0,7,1,6,2,0,FW,30-34,Forward,Uruguay,South America
480,Zeki Çelik,TUR,Lille,Ligue 1,2019,22.0,1997.0,23.0,53,28,18,28,7,27,60,45.0,33,24,4,20,26,79,39,0,DF,20-24,Defender,Turkey,Asia
481,Fabien Centonze,FRA,Metz,Ligue 1,2019,23.0,1996.0,28.0,76,49,53,22,1,34,57,59.6,23,30,11,19,59,135,98,0,DF,20-24,Defender,France,Europe
482,Luca Ceppitelli,ITA,Cagliari,Serie A,2019,29.0,1989.0,13.8,22,15,16,6,0,6,11,54.5,5,23,17,6,23,45,66,2,DF,25-29,Defender,Italy,Europe
483,Alberto Cerri,ITA,SPAL,Serie A,2019,23.0,1996.0,4.7,2,1,0,2,0,1,3,33.3,2,1,0,1,0,2,3,0,FW,20-24,Forward,Italy,Europe
484,Alberto Cerri,ITA,Cagliari,Serie A,2019,23.0,1996.0,2.7,3,1,1,0,2,2,6,33.3,4,1,0,1,2,5,4,0,FW,20-24,Forward,Italy,Europe
486,Florian Chabrolle,FRA,Marseille,Ligue 1,2019,21.0,1998.0,0.2,0,0,0,0,0,0,0,,0,0,0,0,0,0,0,0,MF,20-24,Midfielder,France,Europe
487,Fouad Chafik,MAR,Dijon,Ligue 1,2019,32.0,1986.0,17.0,32,21,22,7,3,17,36,47.2,19,12,5,7,26,58,36,0,DF,30-34,Defender,Morocco,Africa
489,Nathaniel Chalobah,ENG,Watford,Premier League,2019,24.0,1994.0,10.3,30,11,13,13,4,12,27,44.4,15,10,4,6,18,48,20,0,MF,20-24,Midfielder,England,Europe
490,Calum Chambers,ENG,Arsenal,Premier League,2019,24.0,1995.0,12.2,26,10,12,8,6,11,16,68.8,5,13,7,6,16,42,43,1,DF,20-24,Defender,England,Europe
491,Jhon Chancellor,VEN,Brescia,Serie A,2019,27.0,1992.0,24.9,30,14,22,8,0,11,22,50.0,11,34,29,5,34,64,145,3,DF,25-29,Defender,Venezuela,South America
492,Timothy Chandler,USA,Eint Frankfurt,Bundesliga,2019,29.0,1990.0,13.6,22,10,9,8,5,9,16,56.3,7,9,4,5,13,35,21,0,"DF,MF",25-29,Defender,United States,North America
494,Gaëtan Charbonnier,FRA,Brest,Ligue 1,2019,30.0,1988.0,22.9,36,16,11,11,14,10,35,28.6,25,19,6,13,7,43,33,1,"FW,MF",30-34,Forward,France,Europe
495,Brendan Chardonnet,FRA,Brest,Ligue 1,2019,24.0,1994.0,9.1,12,6,10,2,0,7,12,58.3,5,8,5,3,15,27,50,0,DF,20-24,Defender,France,Europe
496,Charles,BRA,Eibar,La Liga,2019,35.0,1984.0,14.5,10,5,0,6,4,4,22,18.2,18,7,2,5,7,17,6,0,FW,35-39,Forward,Brazil,South America
496,Charles,BRA,Eibar,La Liga,2019,35.0,1984.0,14.5,10,5,0,6,4,4,22,18.2,18,7,2,5,7,17,6,0,FW,35-39,Forward,Brazil,South America
496,Charles,BRA,Eibar,La Liga,2019,35.0,1984.0,14.5,10,5,0,6,4,4,22,18.2,18,7,2,5,7,17,6,0,FW,35-39,Forward,Brazil,South America
496,Charles,BRA,Eibar,La Liga,2019,35.0,1984.0,14.5,10,5,0,6,4,4,22,18.2,18,7,2,5,7,17,6,0,FW,35-39,Forward,Brazil,South America
496,Charles,BRA,Eibar,La Liga,2019,35.0,1984.0,14.5,10,5,0,6,4,4,22,18.2,18,7,2,5,7,17,6,0,FW,35-39,Forward,Brazil,South America
496,Charles,BRA,Eibar,La Liga,2019,35.0,1984.0,14.5,10,5,0,6,4,4,22,18.2,18,7,2,5,7,17,6,0,FW,35-39,Forward,Brazil,South America
496,Charles,BRA,Eibar,La Liga,2019,35.0,1984.0,14.5,10,5,0,6,4,4,22,18.2,18,7,2,5,7,17,6,0,FW,35-39,Forward,Brazil,South America
496,Charles,BRA,Eibar,La Liga,2019,35.0,1984.0,14.5,10,5,0,6,4,4,22,18.2,18,7,2,5,7,17,6,0,FW,35-39,Forward,Brazil,South America
496,Charles,BRA,Eibar,La Liga,2019,35.0,1984.0,14.5,10,5,0,6,4,4,22,18.2,18,7,2,5,7,17,6,0,FW,35-39,Forward,Brazil,South America
496,Charles,BRA,Eibar,La Liga,2019,35.0,1984.0,14.5,10,5,0,6,4,4,22,18.2,18,7,2,5,7,17,6,0,FW,35-39,Forward,Brazil,South America
496,Charles,BRA,Eibar,La Liga,2019,35.0,1984.0,14.5,10,5,0,6,4,4,22,18.2,18,7,2,5,7,17,6,0,FW,35-39,Forward,Brazil,South America
496,Charles,BRA,Eibar,La Liga,2019,35.0,1984.0,14.5,10,5,0,6,4,4,22,18.2,18,7,2,5,7,17,6,0,FW,35-39,Forward,Brazil,South America
496,Charles,BRA,Eibar,La Liga,2019,35.0,1984.0,14.5,10,5,0,6,4,4,22,18.2,18,7,2,5,7,17,6,0,FW,35-39,Forward,Brazil,South America
496,Charles,BRA,Eibar,La Liga,2019,35.0,1984.0,14.5,10,5,0,6,4,4,22,18.2,18,7,2,5,7,17,6,0,FW,35-39,Forward,Brazil,South America
496,Charles,BRA,Eibar,La Liga,2019,35.0,1984.0,14.5,10,5,0,6,4,4,22,18.2,18,7,2,5,7,17,6,0,FW,35-39,Forward,Brazil,South America
496,Charles,BRA,Eibar,La Liga,2019,35.0,1984.0,14.5,10,5,0,6,4,4,22,18.2,18,7,2,5,7,17,6,0,FW,35-39,Forward,Brazil,South America
497,Xavier Chavalerin,FRA,Reims,Ligue 1,2019,28.0,1991.0,23.9,71,52,29,33,9,19,49,38.8,30,23,8,15,36,107,36,0,MF,25-29,Midfielder,France,Europe
498,Pablo Chavarría,ARG,Mallorca,La Liga,2019,31.0,1988.0,2.3,1,1,0,1,0,0,4,0.0,4,1,1,0,1,2,2,0,"FW,MF",30-34,Forward,Argentina,South America
502,Rayan Cherki,FRA,Lyon,Ligue 1,2019,15.0,2003.0,1.6,3,2,0,1,2,3,4,75.0,1,3,0,3,0,3,0,0,"MF,FW",Under 20,Midfielder,France,Europe
503,Denis Cheryshev,RUS,Valencia,La Liga,2019,28.0,1990.0,10.3,16,9,5,4,7,3,17,17.6,14,15,1,14,7,23,10,0,"MF,FW",25-29,Midfielder,Russia,Europe
504,Giorgio Chiellini,ITA,Juventus,Serie A,2019,34.0,1984.0,2.2,3,0,3,0,0,1,1,100.0,0,2,2,0,1,4,9,0,DF,30-34,Defender,Italy,Europe
505,Federico Chiesa,ITA,Fiorentina,Serie A,2019,21.0,1997.0,29.3,38,22,13,15,10,10,52,19.2,42,19,0,19,6,44,6,0,"FW,DF",20-24,Forward,Italy,Europe
506,Ben Chilwell,ENG,Leicester City,Premier League,2019,22.0,1996.0,26.4,43,26,28,13,2,23,52,44.2,29,30,6,24,28,71,68,2,DF,20-24,Defender,England,Europe
508,Tahith Chong,NED,Manchester Utd,Premier League,2019,19.0,1999.0,0.4,0,0,0,0,0,0,0,,0,0,0,0,0,0,0,0,"FW,DF",Under 20,Forward,Netherlands,Europe
509,Joris Chotard,FRA,Montpellier,Ligue 1,2019,17.0,2001.0,13.9,30,18,13,17,0,15,35,42.9,20,12,5,7,20,50,12,1,MF,Under 20,Midfielder,France,Europe
510,Hamza Choudhury,ENG,Leicester City,Premier League,2019,21.0,1997.0,9.9,17,8,7,8,2,3,25,12.0,22,15,6,9,24,41,13,0,MF,20-24,Midfielder,England,Europe
512,Andreas Christensen,DEN,Chelsea,Premier League,2019,23.0,1996.0,19.5,38,21,25,12,1,15,21,71.4,6,12,8,4,29,67,56,0,DF,20-24,Defender,Denmark,Europe
513,Samuel Chukwueze,NGA,Villarreal,La Liga,2019,20.0,1999.0,22.8,23,14,12,6,5,13,30,43.3,17,15,1,14,10,33,14,1,"FW,MF",20-24,Forward,Nigeria,Africa
514,Darko Churlinov,MKD,Köln,Bundesliga,2019,19.0,2000.0,0.2,1,1,1,0,0,1,2,50.0,1,0,0,0,1,2,0,0,MF,Under 20,Midfielder,North Macedonia,Europe
516,Luca Cigarini,ITA,Cagliari,Serie A,2019,33.0,1986.0,17.8,37,20,23,13,1,16,40,40.0,24,28,10,18,20,57,29,0,MF,30-34,Midfielder,Italy,Europe
518,Jasper Cillessen,NED,Valencia,La Liga,2019,30.0,1989.0,23.3,0,0,0,0,0,0,1,0.0,1,0,0,0,3,3,3,1,GK,30-34,Goalkeeper,Netherlands,Europe
520,Ibrahim Cissé,CIV,Nice,Ligue 1,2019,20.0,1999.0,0.6,1,1,1,0,0,0,0,,0,0,0,0,0,1,6,0,DF,20-24,Defender,Ivory Coast,Africa
520,Ibrahim Cissé,CIV,Nice,Ligue 1,2019,20.0,1999.0,0.6,1,1,1,0,0,0,0,,0,0,0,0,0,1,6,0,DF,20-24,Defender,Ivory Coast,Africa
520,Ibrahim Cissé,CIV,Nice,Ligue 1,2019,20.0,1999.0,0.6,1,1,1,0,0,0,0,,0,0,0,0,0,1,6,0,DF,20-24,Defender,Ivory Coast,Africa
520,Ibrahim Cissé,CIV,Nice,Ligue 1,2019,20.0,1999.0,0.6,1,1,1,0,0,0,0,,0,0,0,0,0,1,6,0,DF,20-24,Defender,Ivory Coast,Africa
521,Ibrahim Cissé,SEN,Angers,Ligue 1,2019,23.0,1996.0,0.7,2,1,0,2,0,0,0,,0,0,0,0,0,2,2,0,DF,20-24,Defender,Senegal,Africa
521,Ibrahim Cissé,SEN,Angers,Ligue 1,2019,23.0,1996.0,0.7,2,1,0,2,0,0,0,,0,0,0,0,0,2,2,0,DF,20-24,Defender,Senegal,Africa
521,Ibrahim Cissé,SEN,Angers,Ligue 1,2019,23.0,1996.0,0.7,2,1,0,2,0,0,0,,0,0,0,0,0,2,2,0,DF,20-24,Defender,Senegal,Africa
521,Ibrahim Cissé,SEN,Angers,Ligue 1,2019,23.0,1996.0,0.7,2,1,0,2,0,0,0,,0,0,0,0,0,2,2,0,DF,20-24,Defender,Senegal,Africa
522,Andrea Cistana,ITA,Brescia,Serie A,2019,22.0,1997.0,20.4,20,8,13,7,0,6,17,35.3,11,38,34,4,33,53,96,1,DF,20-24,Defender,Italy,Europe
523,Ciaran Clark,IRL,Newcastle Utd,Premier League,2019,29.0,1989.0,13.2,20,12,18,2,0,9,15,60.0,6,18,14,4,11,31,82,0,DF,25-29,Defender,Republic of Ireland,Europe
524,Leon Clarke,ENG,Sheffield Utd,Premier League,2019,34.0,1985.0,0.4,0,0,0,0,0,0,0,,0,0,0,0,0,0,2,0,"FW,MF",30-34,Forward,England,Europe
525,Alexis Claude-Maurice,FRA,Nice,Ligue 1,2019,21.0,1998.0,18.1,26,16,8,11,7,13,35,37.1,22,20,4,16,11,37,4,0,"FW,MF",20-24,Forward,France,Europe
526,Christian Clemens,GER,Köln,Bundesliga,2019,27.0,1991.0,0.2,0,0,0,0,0,0,0,,0,1,1,0,0,0,0,0,FW,25-29,Forward,Germany,Europe
531,Tom Cleverley,ENG,Watford,Premier League,2019,29.0,1989.0,10.8,28,15,8,14,6,9,36,25.0,27,13,1,12,10,38,15,0,MF,25-29,Midfielder,England,Europe
532,Conor Coady,ENG,Wolves,Premier League,2019,26.0,1993.0,38.0,36,23,30,6,0,15,30,50.0,15,22,15,7,28,64,119,2,DF,25-29,Defender,England,Europe
533,Marcus Coco,FRA,Nantes,Ligue 1,2019,23.0,1996.0,0.2,1,0,1,0,0,1,1,100.0,0,0,0,0,0,1,0,0,FW,20-24,Forward,France,Europe
534,Renaud Cohade,FRA,Metz,Ligue 1,2019,34.0,1984.0,8.5,28,20,11,12,5,12,28,42.9,16,14,3,11,8,36,6,0,MF,30-34,Midfielder,France,Europe
536,Séamus Coleman,IRL,Everton,Premier League,2019,30.0,1988.0,20.4,42,31,24,14,4,19,25,76.0,6,21,9,12,24,66,43,1,DF,30-34,Defender,Republic of Ireland,Europe
540,Jamilu Collins,NGA,Paderborn 07,Bundesliga,2019,24.0,1994.0,29.6,69,43,44,21,4,37,62,59.7,25,53,19,34,70,139,91,1,DF,20-24,Defender,Nigeria,Africa
541,Simone Colombi,ITA,Parma,Serie A,2019,28.0,1991.0,4.0,0,0,0,0,0,0,0,,0,0,0,0,0,0,1,0,GK,25-29,Goalkeeper,Italy,Europe
544,Kingsley Coman,FRA,Bayern Munich,Bundesliga,2019,23.0,1996.0,16.7,19,11,6,7,6,12,27,44.4,15,9,0,9,4,23,3,0,"FW,MF",20-24,Forward,France,Europe
545,Daniel Congré,FRA,Montpellier,Ligue 1,2019,34.0,1985.0,21.6,37,27,20,16,1,18,38,47.4,20,8,7,1,47,84,66,1,DF,30-34,Defender,France,Europe
546,Aaron Connolly,IRL,Brighton,Premier League,2019,19.0,2000.0,14.0,7,6,1,4,2,3,10,30.0,7,11,0,11,0,7,3,0,FW,Under 20,Forward,Republic of Ireland,Europe
547,Andrea Consigli,ITA,Sassuolo,Serie A,2019,32.0,1987.0,31.0,0,0,0,0,0,0,1,0.0,1,0,0,0,4,4,19,2,GK,30-34,Goalkeeper,Italy,Europe
548,Andrea Conti,ITA,Milan,Serie A,2019,25.0,1994.0,19.2,41,25,23,15,3,21,49,42.9,28,21,8,13,43,84,42,1,DF,25-29,Defender,Italy,Europe
549,Lewis Cook,ENG,Bournemouth,Premier League,2019,22.0,1997.0,15.0,27,14,15,9,3,10,47,21.3,37,17,5,12,17,44,17,1,"MF,FW",20-24,Midfielder,England,Europe
550,Steve Cook,ENG,Bournemouth,Premier League,2019,28.0,1991.0,27.0,22,11,18,4,0,8,20,40.0,12,32,23,9,44,66,153,1,DF,25-29,Defender,England,Europe
551,Francis Coquelin,FRA,Valencia,La Liga,2019,28.0,1991.0,21.2,37,21,25,11,1,16,38,42.1,22,19,9,10,38,75,25,0,MF,25-29,Midfielder,France,Europe
552,Gabriele Corbo,ITA,Bologna,Serie A,2019,19.0,2000.0,1.4,1,1,1,0,0,0,3,0.0,3,2,2,0,4,5,5,0,DF,Under 20,Defender,Italy,Europe
553,Sébastien Corchia,FRA,Espanyol,La Liga,2019,28.0,1990.0,3.0,2,1,2,0,0,2,4,50.0,2,5,2,3,5,7,8,0,DF,25-29,Defender,France,Europe
557,Benjamin Corgnet,FRA,Strasbourg,Ligue 1,2019,32.0,1987.0,2.9,1,1,1,0,0,1,3,33.3,2,2,0,2,2,3,3,0,"MF,FW",30-34,Midfielder,France,Europe
558,Jack Cork,ENG,Burnley,Premier League,2019,30.0,1989.0,29.0,35,24,10,20,5,12,62,19.4,50,34,12,22,28,63,49,0,MF,30-34,Midfielder,England,Europe
560,Maxwel Cornet,CIV,Lyon,Ligue 1,2019,22.0,1996.0,14.8,30,19,18,8,4,13,23,56.5,10,16,1,15,21,51,19,1,"FW,DF",20-24,Forward,Ivory Coast,Africa
562,Ángel Correa,ARG,Atlético Madrid,La Liga,2019,24.0,1995.0,22.9,25,9,7,9,9,9,36,25.0,27,23,5,18,14,39,21,0,"MF,FW",20-24,Midfielder,Argentina,South America
563,Joaquín Correa,ARG,Lazio,Serie A,2019,24.0,1994.0,22.2,13,7,3,7,3,5,24,20.8,19,5,1,4,7,20,10,0,FW,20-24,Forward,Argentina,South America
566,Thierry Correia,POR,Valencia,La Liga,2019,20.0,1999.0,2.9,8,3,5,3,0,1,2,50.0,1,5,0,5,2,10,10,0,DF,20-24,Defender,Portugal,Europe
568,Danny da Costa,GER,Eint Frankfurt,Bundesliga,2019,26.0,1993.0,15.4,26,17,14,8,4,6,16,37.5,10,16,1,15,15,41,26,0,"DF,FW",25-29,Defender,Germany,Europe
570,Douglas Costa,BRA,Juventus,Serie A,2019,28.0,1990.0,8.9,2,1,1,1,0,1,12,8.3,11,7,0,7,5,7,5,0,"FW,MF",25-29,Forward,Brazil,South America
575,Benoît Costil,FRA,Bordeaux,Ligue 1,2019,32.0,1987.0,28.0,0,0,0,0,0,0,3,0.0,3,0,0,0,2,2,9,0,GK,30-34,Goalkeeper,France,Europe
576,Kalifa Coulibaly,MLI,Nantes,Ligue 1,2019,27.0,1991.0,18.0,11,7,0,5,6,3,5,60.0,2,3,1,2,6,17,32,0,FW,25-29,Forward,Mali,Africa
577,Senou Coulibaly,MLI,Dijon,Ligue 1,2019,24.0,1994.0,7.4,14,7,11,3,0,2,4,50.0,2,11,10,1,10,24,44,1,DF,20-24,Defender,Mali,Africa
578,Yoann Court,FRA,Brest,Ligue 1,2019,29.0,1990.0,16.3,48,26,28,17,3,20,64,31.3,44,21,0,21,15,63,14,0,"FW,MF",25-29,Forward,France,Europe
579,Thibaut Courtois,BEL,Real Madrid,La Liga,2019,27.0,1992.0,34.0,0,0,0,0,0,0,2,0.0,2,0,0,0,2,2,18,2,GK,25-29,Goalkeeper,Belgium,Europe
580,Philippe Coutinho,BRA,Bayern Munich,Bundesliga,2019,27.0,1992.0,15.7,21,15,1,13,7,2,13,15.4,11,9,2,7,6,27,0,0,"MF,FW",25-29,Midfielder,Brazil,South America
581,Nicolas Cozza,FRA,Montpellier,Ligue 1,2019,20.0,1999.0,6.2,5,5,3,2,0,2,3,66.7,1,8,6,2,9,14,18,0,DF,20-24,Defender,France,Europe
582,Alessio Cragno,ITA,Cagliari,Serie A,2019,25.0,1994.0,16.0,0,0,0,0,0,0,0,,0,0,0,0,0,0,10,0,GK,25-29,Goalkeeper,Italy,Europe
583,Aaron Cresswell,ENG,West Ham,Premier League,2019,29.0,1989.0,30.3,43,26,21,18,4,23,46,50.0,23,33,10,23,35,78,75,2,DF,25-29,Defender,England,Europe
584,Domenico Criscito,ITA,Genoa,Serie A,2019,32.0,1986.0,22.8,53,33,34,12,7,24,56,42.9,32,25,13,12,53,106,81,1,DF,30-34,Defender,Italy,Europe
585,Bryan Cristante,ITA,Roma,Serie A,2019,24.0,1995.0,18.0,25,15,6,14,5,8,27,29.6,19,13,4,9,22,47,23,0,MF,20-24,Midfielder,Italy,Europe
586,Sebastián Cristóforo,URU,Fiorentina,Serie A,2019,25.0,1993.0,1.0,5,5,2,2,1,1,5,20.0,4,2,1,1,1,6,0,0,MF,25-29,Midfielder,Uruguay,South America
587,Sebastián Cristóforo,URU,Eibar,La Liga,2019,25.0,1993.0,9.7,35,19,11,14,10,13,32,40.6,19,25,3,22,8,43,2,0,MF,25-29,Midfielder,Uruguay,South America
588,Juan Cuadrado,COL,Juventus,Serie A,2019,31.0,1988.0,29.5,67,43,32,28,7,35,62,56.5,27,22,8,14,35,102,47,0,"DF,FW",30-34,Defender,Colombia,South America
594,Matheus Cunha,BRA,Hertha BSC,Bundesliga,2019,20.0,1999.0,8.3,10,5,6,4,0,4,11,36.4,7,11,1,10,10,20,1,0,"FW,MF",20-24,Forward,Brazil,South America
595,Matheus Cunha,BRA,RB Leipzig,Bundesliga,2019,20.0,1999.0,3.1,6,2,0,1,5,0,2,0.0,2,5,1,4,1,7,0,0,"FW,MF",20-24,Forward,Brazil,South America
596,Felipe Curcio,BRA,Brescia,Serie A,2019,25.0,1993.0,0.1,0,0,0,0,0,0,0,,0,0,0,0,0,0,0,0,DF,25-29,Defender,Brazil,South America
597,Patrick Cutrone,ITA,Wolves,Premier League,2019,21.0,1998.0,3.3,4,2,2,1,1,1,5,20.0,4,1,1,0,2,6,1,0,FW,20-24,Forward,Italy,Europe
598,Patrick Cutrone,ITA,Fiorentina,Serie A,2019,21.0,1998.0,9.3,4,2,2,1,1,1,15,6.7,14,6,1,5,2,6,6,0,FW,20-24,Forward,Italy,Europe
599,Wylan Cyprien,FRA,Nice,Ligue 1,2019,24.0,1995.0,19.7,17,11,5,12,0,7,27,25.9,20,8,2,6,19,36,16,3,MF,20-24,Midfielder,France,Europe
600,Rafael Czichos,GER,Köln,Bundesliga,2019,29.0,1990.0,24.5,43,34,26,16,1,22,45,48.9,23,24,13,11,35,78,110,1,DF,25-29,Defender,Germany,Europe
602,Marco D'Alessandro,ITA,SPAL,Serie A,2019,28.0,1991.0,8.7,11,8,5,3,3,5,8,62.5,3,11,0,11,5,16,6,0,"MF,DF",25-29,Midfielder,Italy,Europe
603,Danilo D'Ambrosio,ITA,Inter,Serie A,2019,30.0,1988.0,15.6,30,16,16,12,2,16,33,48.5,17,15,4,11,14,44,25,0,DF,30-34,Defender,Italy,Europe
604,Felice D'Amico,ITA,Sampdoria,Serie A,2019,18.0,2000.0,0.0,1,1,0,0,1,0,0,,0,0,0,0,0,1,0,0,MF,Under 20,Midfielder,Italy,Europe
606,Jacopo Da Riva,ITA,Atalanta,Serie A,2019,18.0,2000.0,0.0,0,0,0,0,0,0,0,,0,0,0,0,0,0,0,0,MF,Under 20,Midfielder,Italy,Europe
607,Damien Da Silva,FRA,Rennes,Ligue 1,2019,31.0,1988.0,24.9,27,14,20,5,2,10,19,52.6,9,21,13,8,26,53,143,1,DF,30-34,Defender,France,Europe
612,Mahmoud Dahoud,GER,Dortmund,Bundesliga,2019,23.0,1996.0,6.2,10,6,4,4,2,6,18,33.3,12,8,2,6,8,18,4,0,MF,20-24,Midfielder,Germany,Europe
613,Leon Dajaku,GER,Bayern Munich,Bundesliga,2019,18.0,2001.0,0.1,0,0,0,0,0,0,1,0.0,1,0,0,0,0,0,0,0,"DF,MF",Under 20,Defender,Germany,Europe
616,Diogo Dalot,POR,Manchester Utd,Premier League,2019,20.0,1999.0,0.7,3,2,3,0,0,3,4,75.0,1,1,0,1,2,5,1,0,"DF,MF",20-24,Defender,Portugal,Europe
617,Charlie Daniels,ENG,Bournemouth,Premier League,2019,32.0,1986.0,1.4,1,1,0,1,0,0,1,0.0,1,2,0,2,1,2,5,1,DF,30-34,Defender,England,Europe
618,Danilo,BRA,Juventus,Serie A,2019,28.0,1991.0,16.0,30,20,16,12,2,18,30,60.0,12,12,3,9,26,56,44,0,DF,25-29,Defender,Brazil,South America
618,Danilo,BRA,Juventus,Serie A,2019,28.0,1991.0,16.0,30,20,16,12,2,18,30,60.0,12,12,3,9,26,56,44,0,DF,25-29,Defender,Brazil,South America
618,Danilo,BRA,Juventus,Serie A,2019,28.0,1991.0,16.0,30,20,16,12,2,18,30,60.0,12,12,3,9,26,56,44,0,DF,25-29,Defender,Brazil,South America
618,Danilo,BRA,Juventus,Serie A,2019,28.0,1991.0,16.0,30,20,16,12,2,18,30,60.0,12,12,3,9,26,56,44,0,DF,25-29,Defender,Brazil,South America
618,Danilo,BRA,Juventus,Serie A,2019,28.0,1991.0,16.0,30,20,16,12,2,18,30,60.0,12,12,3,9,26,56,44,0,DF,25-29,Defender,Brazil,South America
618,Danilo,BRA,Juventus,Serie A,2019,28.0,1991.0,16.0,30,20,16,12,2,18,30,60.0,12,12,3,9,26,56,44,0,DF,25-29,Defender,Brazil,South America
618,Danilo,BRA,Juventus,Serie A,2019,28.0,1991.0,16.0,30,20,16,12,2,18,30,60.0,12,12,3,9,26,56,44,0,DF,25-29,Defender,Brazil,South America
618,Danilo,BRA,Juventus,Serie A,2019,28.0,1991.0,16.0,30,20,16,12,2,18,30,60.0,12,12,3,9,26,56,44,0,DF,25-29,Defender,Brazil,South America
618,Danilo,BRA,Juventus,Serie A,2019,28.0,1991.0,16.0,30,20,16,12,2,18,30,60.0,12,12,3,9,26,56,44,0,DF,25-29,Defender,Brazil,South America
618,Danilo,BRA,Juventus,Serie A,2019,28.0,1991.0,16.0,30,20,16,12,2,18,30,60.0,12,12,3,9,26,56,44,0,DF,25-29,Defender,Brazil,South America
618,Danilo,BRA,Juventus,Serie A,2019,28.0,1991.0,16.0,30,20,16,12,2,18,30,60.0,12,12,3,9,26,56,44,0,DF,25-29,Defender,Brazil,South America
618,Danilo,BRA,Juventus,Serie A,2019,28.0,1991.0,16.0,30,20,16,12,2,18,30,60.0,12,12,3,9,26,56,44,0,DF,25-29,Defender,Brazil,South America
618,Danilo,BRA,Juventus,Serie A,2019,28.0,1991.0,16.0,30,20,16,12,2,18,30,60.0,12,12,3,9,26,56,44,0,DF,25-29,Defender,Brazil,South America
618,Danilo,BRA,Juventus,Serie A,2019,28.0,1991.0,16.0,30,20,16,12,2,18,30,60.0,12,12,3,9,26,56,44,0,DF,25-29,Defender,Brazil,South America
618,Danilo,BRA,Juventus,Serie A,2019,28.0,1991.0,16.0,30,20,16,12,2,18,30,60.0,12,12,3,9,26,56,44,0,DF,25-29,Defender,Brazil,South America
618,Danilo,BRA,Juventus,Serie A,2019,28.0,1991.0,16.0,30,20,16,12,2,18,30,60.0,12,12,3,9,26,56,44,0,DF,25-29,Defender,Brazil,South America
618,Danilo,BRA,Juventus,Serie A,2019,28.0,1991.0,16.0,30,20,16,12,2,18,30,60.0,12,12,3,9,26,56,44,0,DF,25-29,Defender,Brazil,South America
618,Danilo,BRA,Juventus,Serie A,2019,28.0,1991.0,16.0,30,20,16,12,2,18,30,60.0,12,12,3,9,26,56,44,0,DF,25-29,Defender,Brazil,South America
618,Danilo,BRA,Juventus,Serie A,2019,28.0,1991.0,16.0,30,20,16,12,2,18,30,60.0,12,12,3,9,26,56,44,0,DF,25-29,Defender,Brazil,South America
618,Danilo,BRA,Juventus,Serie A,2019,28.0,1991.0,16.0,30,20,16,12,2,18,30,60.0,12,12,3,9,26,56,44,0,DF,25-29,Defender,Brazil,South America
618,Danilo,BRA,Juventus,Serie A,2019,28.0,1991.0,16.0,30,20,16,12,2,18,30,60.0,12,12,3,9,26,56,44,0,DF,25-29,Defender,Brazil,South America
618,Danilo,BRA,Juventus,Serie A,2019,28.0,1991.0,16.0,30,20,16,12,2,18,30,60.0,12,12,3,9,26,56,44,0,DF,25-29,Defender,Brazil,South America
618,Danilo,BRA,Juventus,Serie A,2019,28.0,1991.0,16.0,30,20,16,12,2,18,30,60.0,12,12,3,9,26,56,44,0,DF,25-29,Defender,Brazil,South America
618,Danilo,BRA,Juventus,Serie A,2019,28.0,1991.0,16.0,30,20,16,12,2,18,30,60.0,12,12,3,9,26,56,44,0,DF,25-29,Defender,Brazil,South America
618,Danilo,BRA,Juventus,Serie A,2019,28.0,1991.0,16.0,30,20,16,12,2,18,30,60.0,12,12,3,9,26,56,44,0,DF,25-29,Defender,Brazil,South America
618,Danilo,BRA,Juventus,Serie A,2019,28.0,1991.0,16.0,30,20,16,12,2,18,30,60.0,12,12,3,9,26,56,44,0,DF,25-29,Defender,Brazil,South America
618,Danilo,BRA,Juventus,Serie A,2019,28.0,1991.0,16.0,30,20,16,12,2,18,30,60.0,12,12,3,9,26,56,44,0,DF,25-29,Defender,Brazil,South America
618,Danilo,BRA,Juventus,Serie A,2019,28.0,1991.0,16.0,30,20,16,12,2,18,30,60.0,12,12,3,9,26,56,44,0,DF,25-29,Defender,Brazil,South America
618,Danilo,BRA,Juventus,Serie A,2019,28.0,1991.0,16.0,30,20,16,12,2,18,30,60.0,12,12,3,9,26,56,44,0,DF,25-29,Defender,Brazil,South America
618,Danilo,BRA,Juventus,Serie A,2019,28.0,1991.0,16.0,30,20,16,12,2,18,30,60.0,12,12,3,9,26,56,44,0,DF,25-29,Defender,Brazil,South America
618,Danilo,BRA,Juventus,Serie A,2019,28.0,1991.0,16.0,30,20,16,12,2,18,30,60.0,12,12,3,9,26,56,44,0,DF,25-29,Defender,Brazil,South America
618,Danilo,BRA,Juventus,Serie A,2019,28.0,1991.0,16.0,30,20,16,12,2,18,30,60.0,12,12,3,9,26,56,44,0,DF,25-29,Defender,Brazil,South America
618,Danilo,BRA,Juventus,Serie A,2019,28.0,1991.0,16.0,30,20,16,12,2,18,30,60.0,12,12,3,9,26,56,44,0,DF,25-29,Defender,Brazil,South America
618,Danilo,BRA,Juventus,Serie A,2019,28.0,1991.0,16.0,30,20,16,12,2,18,30,60.0,12,12,3,9,26,56,44,0,DF,25-29,Defender,Brazil,South America
618,Danilo,BRA,Juventus,Serie A,2019,28.0,1991.0,16.0,30,20,16,12,2,18,30,60.0,12,12,3,9,26,56,44,0,DF,25-29,Defender,Brazil,South America
618,Danilo,BRA,Juventus,Serie A,2019,28.0,1991.0,16.0,30,20,16,12,2,18,30,60.0,12,12,3,9,26,56,44,0,DF,25-29,Defender,Brazil,South America
618,Danilo,BRA,Juventus,Serie A,2019,28.0,1991.0,16.0,30,20,16,12,2,18,30,60.0,12,12,3,9,26,56,44,0,DF,25-29,Defender,Brazil,South America
618,Danilo,BRA,Juventus,Serie A,2019,28.0,1991.0,16.0,30,20,16,12,2,18,30,60.0,12,12,3,9,26,56,44,0,DF,25-29,Defender,Brazil,South America
618,Danilo,BRA,Juventus,Serie A,2019,28.0,1991.0,16.0,30,20,16,12,2,18,30,60.0,12,12,3,9,26,56,44,0,DF,25-29,Defender,Brazil,South America
618,Danilo,BRA,Juventus,Serie A,2019,28.0,1991.0,16.0,30,20,16,12,2,18,30,60.0,12,12,3,9,26,56,44,0,DF,25-29,Defender,Brazil,South America
618,Danilo,BRA,Juventus,Serie A,2019,28.0,1991.0,16.0,30,20,16,12,2,18,30,60.0,12,12,3,9,26,56,44,0,DF,25-29,Defender,Brazil,South America
618,Danilo,BRA,Juventus,Serie A,2019,28.0,1991.0,16.0,30,20,16,12,2,18,30,60.0,12,12,3,9,26,56,44,0,DF,25-29,Defender,Brazil,South America
618,Danilo,BRA,Juventus,Serie A,2019,28.0,1991.0,16.0,30,20,16,12,2,18,30,60.0,12,12,3,9,26,56,44,0,DF,25-29,Defender,Brazil,South America
618,Danilo,BRA,Juventus,Serie A,2019,28.0,1991.0,16.0,30,20,16,12,2,18,30,60.0,12,12,3,9,26,56,44,0,DF,25-29,Defender,Brazil,South America
618,Danilo,BRA,Juventus,Serie A,2019,28.0,1991.0,16.0,30,20,16,12,2,18,30,60.0,12,12,3,9,26,56,44,0,DF,25-29,Defender,Brazil,South America
618,Danilo,BRA,Juventus,Serie A,2019,28.0,1991.0,16.0,30,20,16,12,2,18,30,60.0,12,12,3,9,26,56,44,0,DF,25-29,Defender,Brazil,South America
618,Danilo,BRA,Juventus,Serie A,2019,28.0,1991.0,16.0,30,20,16,12,2,18,30,60.0,12,12,3,9,26,56,44,0,DF,25-29,Defender,Brazil,South America
618,Danilo,BRA,Juventus,Serie A,2019,28.0,1991.0,16.0,30,20,16,12,2,18,30,60.0,12,12,3,9,26,56,44,0,DF,25-29,Defender,Brazil,South America
618,Danilo,BRA,Juventus,Serie A,2019,28.0,1991.0,16.0,30,20,16,12,2,18,30,60.0,12,12,3,9,26,56,44,0,DF,25-29,Defender,Brazil,South America
619,Arnaut Danjuma,NED,Bournemouth,Premier League,2019,22.0,1997.0,7.0,4,2,3,1,0,1,4,25.0,3,2,0,2,8,12,4,1,MF,20-24,Midfielder,Netherlands,Europe
620,Scott Dann,ENG,Crystal Palace,Premier League,2019,32.0,1987.0,14.1,8,4,7,1,0,8,14,57.1,6,9,7,2,14,22,67,0,DF,30-34,Defender,England,Europe
621,Kevin Danso,AUT,Southampton,Premier League,2019,20.0,1998.0,3.1,6,4,3,3,0,4,7,57.1,3,7,3,4,2,8,7,0,DF,20-24,Defender,Austria,Europe
622,Dante,BRA,Nice,Ligue 1,2019,35.0,1983.0,21.0,34,21,24,10,0,17,25,68.0,8,27,16,11,26,60,79,0,DF,35-39,Defender,Brazil,South America
623,Andrea Danzi,ITA,Hellas Verona,Serie A,2019,20.0,1999.0,0.0,0,0,0,0,0,0,0,,0,0,0,0,0,0,0,0,MF,20-24,Midfielder,Italy,Europe
626,Matteo Darmian,ITA,Parma,Serie A,2019,29.0,1989.0,29.8,81,42,48,30,3,40,83,48.2,43,38,16,22,25,106,78,1,DF,25-29,Defender,Italy,Europe
627,Alphonso Davies,CAN,Bayern Munich,Bundesliga,2019,18.0,2000.0,24.8,70,43,35,24,11,38,58,65.5,20,35,6,29,31,101,51,0,DF,Under 20,Defender,Canada,North America
628,Ben Davies,WAL,Tottenham,Premier League,2019,26.0,1993.0,15.9,28,15,13,11,4,7,21,33.3,14,28,12,16,22,50,47,0,DF,25-29,Defender,Wales,Europe
628,Ben Davies,WAL,Tottenham,Premier League,2019,26.0,1993.0,15.9,28,15,13,11,4,7,21,33.3,14,28,12,16,22,50,47,0,DF,25-29,Defender,Wales,Europe
628,Ben Davies,WAL,Tottenham,Premier League,2019,26.0,1993.0,15.9,28,15,13,11,4,7,21,33.3,14,28,12,16,22,50,47,0,DF,25-29,Defender,Wales,Europe
628,Ben Davies,WAL,Tottenham,Premier League,2019,26.0,1993.0,15.9,28,15,13,11,4,7,21,33.3,14,28,12,16,22,50,47,0,DF,25-29,Defender,Wales,Europe
629,Tom Davies,ENG,Everton,Premier League,2019,21.0,1998.0,22.5,38,17,12,22,4,17,55,30.9,38,12,4,8,35,73,28,0,MF,20-24,Midfielder,England,Europe
629,Tom Davies,ENG,Everton,Premier League,2019,21.0,1998.0,22.5,38,17,12,22,4,17,55,30.9,38,12,4,8,35,73,28,0,MF,20-24,Midfielder,England,Europe
629,Tom Davies,ENG,Everton,Premier League,2019,21.0,1998.0,22.5,38,17,12,22,4,17,55,30.9,38,12,4,8,35,73,28,0,MF,20-24,Midfielder,England,Europe
629,Tom Davies,ENG,Everton,Premier League,2019,21.0,1998.0,22.5,38,17,12,22,4,17,55,30.9,38,12,4,8,35,73,28,0,MF,20-24,Midfielder,England,Europe
630,Keinan Davis,ENG,Aston Villa,Premier League,2019,21.0,1998.0,6.1,1,1,0,1,0,0,3,0.0,3,4,0,4,0,1,3,0,FW,20-24,Forward,England,Europe
632,Craig Dawson,ENG,Watford,Premier League,2019,29.0,1990.0,26.2,29,18,16,13,0,17,31,54.8,14,41,32,9,34,63,116,0,DF,25-29,Defender,England,Europe
633,Kevin De Bruyne,BEL,Manchester City,Premier League,2019,28.0,1991.0,31.0,45,24,8,20,17,18,66,27.3,48,26,4,22,18,63,24,2,MF,25-29,Midfielder,Belgium,Europe
634,Sebastien De Maio,FRA,Udinese,Serie A,2019,32.0,1987.0,16.7,18,11,11,7,0,7,11,63.6,4,28,20,8,32,50,86,2,DF,30-34,Defender,France,Europe
635,Rodrigo De Paul,ARG,Udinese,Serie A,2019,25.0,1994.0,31.4,61,31,31,26,4,27,65,41.5,38,38,3,35,29,90,8,1,MF,25-29,Midfielder,Argentina,South America
636,Mattia De Sciglio,ITA,Juventus,Serie A,2019,26.0,1992.0,5.2,10,8,6,4,0,6,14,42.9,8,5,2,3,8,18,18,1,DF,25-29,Defender,Italy,Europe
637,Lorenzo De Silvestri,ITA,Torino,Serie A,2019,31.0,1988.0,24.9,15,8,4,7,4,11,27,40.7,16,20,7,13,19,34,72,0,DF,30-34,Defender,Italy,Europe
638,Lucas Deaux,FRA,Nîmes,Ligue 1,2019,30.0,1988.0,14.8,49,26,16,29,4,16,45,35.6,29,20,4,16,15,64,19,0,MF,30-34,Midfielder,France,Europe
639,Mathieu Debuchy,FRA,Saint-Étienne,Ligue 1,2019,34.0,1985.0,19.7,44,26,22,15,7,24,47,51.1,23,21,11,10,43,87,59,0,DF,30-34,Defender,France,Europe
640,Troy Deeney,ENG,Watford,Premier League,2019,31.0,1988.0,24.7,19,12,6,10,3,6,29,20.7,23,13,1,12,11,30,27,0,FW,30-34,Forward,England,Europe
642,Alessandro Deiola,ITA,Cagliari,Serie A,2019,23.0,1995.0,0.0,0,0,0,0,0,0,0,,0,0,0,0,1,1,0,0,MF,20-24,Midfielder,Italy,Europe
643,Alessandro Deiola,ITA,Lecce,Serie A,2019,23.0,1995.0,8.0,16,9,9,7,0,9,24,37.5,15,12,4,8,8,24,14,1,MF,20-24,Midfielder,Italy,Europe
644,Romain Del Castillo,FRA,Rennes,Ligue 1,2019,23.0,1996.0,13.8,20,14,5,11,4,6,27,22.2,21,12,2,10,7,27,7,0,"FW,MF",20-24,Forward,France,Europe
645,Thomas Delaine,FRA,Metz,Ligue 1,2019,27.0,1992.0,13.9,25,16,18,6,1,12,21,57.1,9,17,1,16,15,40,28,0,DF,25-29,Defender,France,Europe
647,Paul Delecroix,FRA,Metz,Ligue 1,2019,30.0,1988.0,1.5,0,0,0,0,0,0,0,,0,0,0,0,0,0,0,0,GK,30-34,Goalkeeper,France,Europe
648,Cristian Dell'Orco,ITA,Lecce,Serie A,2019,25.0,1994.0,11.2,22,12,14,7,1,8,14,57.1,6,11,7,4,16,38,33,0,DF,25-29,Defender,Italy,Europe
649,Andy Delort,ALG,Montpellier,Ligue 1,2019,27.0,1991.0,25.3,28,18,11,9,8,7,27,25.9,20,21,6,15,3,31,10,0,FW,25-29,Forward,Algeria,Africa
650,Fabian Delph,ENG,Everton,Premier League,2019,29.0,1989.0,13.2,26,12,10,13,3,9,22,40.9,13,12,3,9,15,41,19,1,MF,25-29,Midfielder,England,Europe
651,Moussa Dembélé,FRA,Lyon,Ligue 1,2019,23.0,1996.0,24.3,12,7,2,5,5,4,14,28.6,10,14,3,11,5,17,31,0,FW,20-24,Forward,France,Europe
652,Ousmane Dembélé,FRA,Barcelona,La Liga,2019,22.0,1997.0,4.0,2,2,1,1,0,2,5,40.0,3,4,0,4,0,2,0,1,FW,20-24,Forward,France,Europe
653,Merih Demiral,TUR,Juventus,Serie A,2019,21.0,1998.0,4.6,8,7,5,3,0,1,3,33.3,2,4,3,1,4,12,16,1,DF,20-24,Defender,Turkey,Asia
655,Diego Demme,GER,Napoli,Serie A,2019,27.0,1991.0,10.0,18,8,14,3,1,8,23,34.8,15,9,1,8,8,26,9,0,MF,25-29,Midfielder,Germany,Europe
656,Diego Demme,GER,RB Leipzig,Bundesliga,2019,27.0,1991.0,13.5,41,18,17,19,5,17,42,40.5,25,14,2,12,15,56,14,0,MF,25-29,Midfielder,Germany,Europe
657,Jason Denayer,BEL,Lyon,Ligue 1,2019,24.0,1995.0,23.7,17,13,12,5,0,10,14,71.4,4,32,29,3,20,37,83,0,DF,20-24,Defender,Belgium,Europe
661,Fabio Depaoli,ITA,Sampdoria,Serie A,2019,22.0,1997.0,20.6,41,28,26,10,5,17,31,54.8,14,29,3,26,16,57,39,0,"MF,DF",20-24,Midfielder,Italy,Europe
662,Kastriot Dermaku,ALB,Parma,Serie A,2019,27.0,1992.0,11.4,13,5,10,3,0,3,5,60.0,2,20,16,4,12,25,61,1,DF,25-29,Defender,Albania,Europe
663,Daniele Dessena,ITA,Brescia,Serie A,2019,32.0,1987.0,20.8,21,11,5,14,2,6,25,24.0,19,11,1,10,11,32,21,0,MF,30-34,Midfielder,Italy,Europe
664,Mattia Destro,ITA,Bologna,Serie A,2019,28.0,1991.0,2.1,3,2,1,2,0,1,3,33.3,2,1,0,1,0,3,0,0,FW,25-29,Forward,Italy,Europe
665,Mattia Destro,ITA,Genoa,Serie A,2019,28.0,1991.0,1.7,0,0,0,0,0,0,0,,0,0,0,0,0,0,1,0,"FW,MF",25-29,Forward,Italy,Europe
667,Deyverson,BRA,Getafe,La Liga,2019,28.0,1991.0,2.3,0,0,0,0,0,0,1,0.0,1,2,1,1,0,0,5,0,FW,25-29,Forward,Brazil,South America
668,Samuel Di Carmine,ITA,Hellas Verona,Serie A,2019,30.0,1988.0,14.4,2,1,0,0,2,0,8,0.0,8,3,0,3,1,3,10,0,"FW,MF",30-34,Forward,Italy,Europe
669,Federico Di Francesco,ITA,SPAL,Serie A,2019,25.0,1994.0,12.0,11,5,2,6,3,3,15,20.0,12,9,1,8,3,14,2,1,FW,25-29,Forward,Italy,Europe
670,Giovanni Di Lorenzo,ITA,Napoli,Serie A,2019,25.0,1993.0,33.0,59,35,27,19,13,32,61,52.5,29,27,11,16,28,87,54,0,DF,25-29,Defender,Italy,Europe
672,Boulaye Dia,SEN,Reims,Ligue 1,2019,22.0,1996.0,20.1,15,9,7,6,2,3,10,30.0,7,9,2,7,7,22,16,0,FW,20-24,Forward,Senegal,Africa
674,Moussa Diaby,FRA,Leverkusen,Bundesliga,2019,20.0,1999.0,19.7,10,8,3,7,0,5,15,33.3,10,6,0,6,9,19,4,0,"FW,MF",20-24,Forward,France,Europe
675,Mouctar Diakhaby,GUI,Valencia,La Liga,2019,22.0,1996.0,16.0,11,8,7,3,1,5,8,62.5,3,17,15,2,11,22,73,0,DF,20-24,Defender,Guinea,Africa
676,Bafodé Diakité,FRA,Toulouse,Ligue 1,2019,18.0,2001.0,15.2,23,19,15,8,0,7,13,53.8,6,18,9,9,20,43,75,0,DF,Under 20,Defender,France,Europe
677,Abdou Diallo,SEN,Paris S-G,Ligue 1,2019,23.0,1996.0,13.3,20,11,9,10,1,8,14,57.1,6,9,5,4,10,30,32,0,DF,20-24,Defender,Senegal,Africa
679,Habib Diallo,SEN,Metz,Ligue 1,2019,24.0,1995.0,24.4,2,1,0,2,0,0,6,0.0,6,6,5,1,4,6,43,0,FW,20-24,Forward,Senegal,Africa
680,Ibrahima Diallo,FRA,Brest,Ligue 1,2019,20.0,1999.0,17.3,38,24,15,22,1,12,29,41.4,17,9,2,7,23,61,16,3,MF,20-24,Midfielder,France,Europe
680,Ibrahima Diallo,FRA,Brest,Ligue 1,2019,20.0,1999.0,17.3,38,24,15,22,1,12,29,41.4,17,9,2,7,23,61,16,3,MF,20-24,Midfielder,France,Europe
680,Ibrahima Diallo,FRA,Brest,Ligue 1,2019,20.0,1999.0,17.3,38,24,15,22,1,12,29,41.4,17,9,2,7,23,61,16,3,MF,20-24,Midfielder,France,Europe
680,Ibrahima Diallo,FRA,Brest,Ligue 1,2019,20.0,1999.0,17.3,38,24,15,22,1,12,29,41.4,17,9,2,7,23,61,16,3,MF,20-24,Midfielder,France,Europe
680,Ibrahima Diallo,FRA,Brest,Ligue 1,2019,20.0,1999.0,17.3,38,24,15,22,1,12,29,41.4,17,9,2,7,23,61,16,3,MF,20-24,Midfielder,France,Europe
680,Ibrahima Diallo,FRA,Brest,Ligue 1,2019,20.0,1999.0,17.3,38,24,15,22,1,12,29,41.4,17,9,2,7,23,61,16,3,MF,20-24,Midfielder,France,Europe
680,Ibrahima Diallo,FRA,Brest,Ligue 1,2019,20.0,1999.0,17.3,38,24,15,22,1,12,29,41.4,17,9,2,7,23,61,16,3,MF,20-24,Midfielder,France,Europe
680,Ibrahima Diallo,FRA,Brest,Ligue 1,2019,20.0,1999.0,17.3,38,24,15,22,1,12,29,41.4,17,9,2,7,23,61,16,3,MF,20-24,Midfielder,France,Europe
680,Ibrahima Diallo,FRA,Brest,Ligue 1,2019,20.0,1999.0,17.3,38,24,15,22,1,12,29,41.4,17,9,2,7,23,61,16,3,MF,20-24,Midfielder,France,Europe
681,Moussa Diarra,MLI,Toulouse,Ligue 1,2019,18.0,2000.0,1.0,3,3,2,1,0,1,1,100.0,0,0,0,0,3,6,2,0,DF,Under 20,Defender,Mali,Africa
682,Lucas Dias,FRA,Nîmes,Ligue 1,2019,20.0,1999.0,3.5,1,1,1,0,0,1,1,100.0,0,0,0,0,0,1,2,0,GK,20-24,Goalkeeper,France,Europe
684,Brahim Díaz,MAR,Real Madrid,La Liga,2019,19.0,1999.0,0.7,1,0,0,1,0,0,2,0.0,2,2,0,2,0,1,0,0,FW,Under 20,Forward,Morocco,Africa
686,Bakaye Dibassy,MLI,Amiens,Ligue 1,2019,29.0,1989.0,20.8,26,14,17,8,1,15,20,75.0,5,29,18,11,37,63,78,2,DF,25-29,Defender,Mali,Africa
687,Eric Dier,ENG,Tottenham,Premier League,2019,25.0,1994.0,14.9,21,12,10,10,1,10,20,50.0,10,14,9,5,21,42,65,0,"DF,MF",25-29,Defender,England,Europe
688,Lucas Digne,FRA,Everton,Premier League,2019,26.0,1993.0,33.7,73,49,49,19,5,33,68,48.5,35,39,10,29,42,115,108,0,DF,25-29,Defender,France,Europe
691,Federico Dimarco,ITA,Hellas Verona,Serie A,2019,21.0,1997.0,5.8,11,5,4,4,3,6,10,60.0,4,3,2,1,4,15,11,0,DF,20-24,Defender,Italy,Europe
692,Federico Dimarco,ITA,Inter,Serie A,2019,21.0,1997.0,0.3,1,0,0,1,0,0,0,,0,0,0,0,1,2,1,0,DF,20-24,Defender,Italy,Europe
693,Tristan Dingomé,CMR,Reims,Ligue 1,2019,28.0,1991.0,9.9,10,4,3,6,1,2,12,16.7,10,6,0,6,6,16,1,0,MF,25-29,Midfielder,Cameroon,Africa
695,Issa Diop,FRA,West Ham,Premier League,2019,22.0,1997.0,30.7,27,15,18,9,0,16,25,64.0,9,37,21,16,47,74,166,2,DF,20-24,Defender,France,Europe
697,Assane Dioussé,SEN,Saint-Étienne,Ligue 1,2019,21.0,1997.0,1.3,1,1,0,1,0,0,3,0.0,3,0,0,0,0,1,2,0,MF,20-24,Midfielder,Senegal,Africa
698,Axel Disasi,FRA,Reims,Ligue 1,2019,21.0,1998.0,27.0,32,21,18,13,1,17,27,63.0,10,29,24,5,26,58,97,0,DF,20-24,Defender,France,Europe
702,Koffi Djidji,CIV,Torino,Serie A,2019,26.0,1992.0,9.5,27,12,19,8,0,8,18,44.4,10,28,23,5,15,42,53,1,DF,25-29,Defender,Ivory Coast,Africa
704,Berat Djimsiti,ALB,Atalanta,Serie A,2019,26.0,1993.0,30.9,42,23,17,23,2,22,39,56.4,17,21,14,7,49,91,92,0,DF,25-29,Defender,Albania,Europe
707,Matt Doherty,IRL,Wolves,Premier League,2019,27.0,1992.0,31.5,55,29,34,17,4,27,41,65.9,14,34,4,30,40,95,52,1,"MF,DF",25-29,Midfielder,Republic of Ireland,Europe
709,Keagan Dolly,RSA,Montpellier,Ligue 1,2019,26.0,1993.0,1.6,6,3,1,3,2,2,5,40.0,3,1,0,1,1,7,0,0,MF,25-29,Midfielder,South Africa,Africa
711,Nicolás Domínguez,ARG,Bologna,Serie A,2019,21.0,1998.0,7.8,21,14,15,5,1,7,18,38.9,11,12,2,10,12,33,7,0,MF,20-24,Midfielder,Argentina,South America
712,Giulio Donati,ITA,Lecce,Serie A,2019,29.0,1990.0,19.6,32,21,22,8,2,15,28,53.6,13,19,10,9,25,57,42,0,DF,25-29,Defender,Italy,Europe
714,Anastasios Donis,GRE,Reims,Ligue 1,2019,22.0,1996.0,6.8,3,2,2,1,0,1,9,11.1,8,2,0,2,1,4,3,0,FW,20-24,Forward,Greece,Europe
715,Alfredo Donnarumma,ITA,Brescia,Serie A,2019,28.0,1990.0,18.7,17,9,3,9,5,6,18,33.3,12,7,0,7,5,22,1,0,FW,25-29,Forward,Italy,Europe
716,Gianluigi Donnarumma,ITA,Milan,Serie A,2019,20.0,1999.0,35.6,1,0,1,0,0,1,2,50.0,1,0,0,0,3,4,25,7,GK,20-24,Goalkeeper,Italy,Europe
719,Abdoulaye Doucouré,MLI,Watford,Premier League,2019,26.0,1993.0,35.1,64,30,29,29,6,16,57,28.1,41,46,8,38,31,95,32,0,MF,25-29,Midfielder,Mali,Africa
720,Mamadou Doucouré,FRA,Gladbach,Bundesliga,2019,21.0,1998.0,0.0,0,0,0,0,0,0,0,,0,0,0,0,0,0,0,0,MF,20-24,Midfielder,France,Europe
721,Moussa Doumbia,MLI,Reims,Ligue 1,2019,24.0,1994.0,19.1,16,8,5,6,5,7,24,29.2,17,14,1,13,9,25,5,0,"FW,MF",20-24,Forward,Mali,Africa
729,Dominick Drexler,GER,Köln,Bundesliga,2019,29.0,1990.0,17.6,34,25,12,19,3,8,32,25.0,24,11,5,6,26,60,11,0,"MF,FW",25-29,Midfielder,Germany,Europe
730,Danny Drinkwater,ENG,Aston Villa,Premier League,2019,29.0,1990.0,2.9,5,3,3,2,0,2,18,11.1,16,5,0,5,5,10,5,1,MF,25-29,Midfielder,England,Europe
731,Danny Drinkwater,ENG,Burnley,Premier League,2019,29.0,1990.0,0.6,2,1,1,1,0,0,1,0.0,1,0,0,0,1,3,0,0,MF,25-29,Midfielder,England,Europe
733,Domingos Duarte,POR,Granada,La Liga,2019,24.0,1995.0,34.3,30,19,24,5,1,11,20,55.0,9,34,24,10,34,64,153,1,DF,20-24,Defender,Portugal,Europe
735,Óscar Duarte,CRC,Levante,La Liga,2019,30.0,1989.0,5.4,12,3,11,1,0,3,4,75.0,1,7,6,1,6,18,29,0,DF,30-34,Defender,Costa Rica,North America
737,Edgaras Dubickas,LTU,Lecce,Serie A,2019,21.0,1998.0,0.0,0,0,0,0,0,0,0,,0,0,0,0,0,0,0,0,DF,20-24,Defender,Lithuania,Europe
739,Martin Dúbravka,SVK,Newcastle Utd,Premier League,2019,30.0,1989.0,38.0,1,1,1,0,0,1,2,50.0,1,2,0,2,1,2,17,5,GK,30-34,Goalkeeper,Slovakia,Europe
740,Ondrej Duda,SVK,Norwich City,Premier League,2019,24.0,1994.0,8.0,18,11,9,6,3,7,16,43.8,9,10,2,8,6,24,8,0,MF,20-24,Midfielder,Slovakia,Europe
741,Ondrej Duda,SVK,Hertha BSC,Bundesliga,2019,24.0,1994.0,5.0,6,4,1,2,3,1,10,10.0,9,3,1,2,5,11,5,0,MF,20-24,Midfielder,Slovakia,Europe
742,Shane Duffy,IRL,Brighton,Premier League,2019,27.0,1992.0,13.8,18,9,14,4,0,6,17,35.3,11,13,7,6,21,39,72,0,DF,25-29,Defender,Republic of Ireland,Europe
744,Paul Dummett,WAL,Newcastle Utd,Premier League,2019,27.0,1991.0,13.6,27,17,19,7,1,21,27,77.8,6,23,9,14,23,50,69,0,DF,25-29,Defender,Wales,Europe
745,Alfred Duncan,GHA,Fiorentina,Serie A,2019,26.0,1993.0,9.9,12,9,11,1,0,2,19,10.5,17,4,0,4,5,17,12,0,MF,25-29,Midfielder,Ghana,Africa
746,Alfred Duncan,GHA,Sassuolo,Serie A,2019,26.0,1993.0,9.4,19,12,8,7,4,6,16,37.5,10,7,0,7,9,28,13,0,MF,25-29,Midfielder,Ghana,Africa
747,Lewis Dunk,ENG,Brighton,Premier League,2019,27.0,1991.0,35.9,40,24,23,17,0,15,34,44.1,19,55,33,22,55,95,125,2,DF,25-29,Defender,England,Europe
748,Erik Durm,GER,Eint Frankfurt,Bundesliga,2019,27.0,1992.0,5.7,13,6,9,2,2,9,17,52.9,8,11,2,9,3,16,11,0,"DF,FW",25-29,Defender,Germany,Europe
752,Paulo Dybala,ARG,Juventus,Serie A,2019,25.0,1993.0,23.9,19,10,6,9,4,9,39,23.1,30,15,0,15,13,32,3,0,"FW,MF",25-29,Forward,Argentina,South America
755,Bruno Ecuele Manga,GAB,Dijon,Ligue 1,2019,31.0,1988.0,28.0,22,15,17,5,0,9,20,45.0,11,34,23,11,37,59,112,2,DF,30-34,Defender,Gabon,Africa
756,Simone Edera,ITA,Torino,Serie A,2019,22.0,1997.0,4.4,13,5,3,7,3,2,12,16.7,10,1,0,1,1,14,3,0,"MF,FW",20-24,Midfielder,Italy,Europe
757,Ederson,BRA,Manchester City,Premier League,2019,25.0,1993.0,34.1,2,2,2,0,0,2,5,40.0,3,0,0,0,3,5,16,6,GK,25-29,Goalkeeper,Brazil,South America
757,Ederson,BRA,Manchester City,Premier League,2019,25.0,1993.0,34.1,2,2,2,0,0,2,5,40.0,3,0,0,0,3,5,16,6,GK,25-29,Goalkeeper,Brazil,South America
757,Ederson,BRA,Manchester City,Premier League,2019,25.0,1993.0,34.1,2,2,2,0,0,2,5,40.0,3,0,0,0,3,5,16,6,GK,25-29,Goalkeeper,Brazil,South America
757,Ederson,BRA,Manchester City,Premier League,2019,25.0,1993.0,34.1,2,2,2,0,0,2,5,40.0,3,0,0,0,3,5,16,6,GK,25-29,Goalkeeper,Brazil,South America
758,John Egan,IRL,Sheffield Utd,Premier League,2019,26.0,1992.0,35.4,44,27,34,10,0,25,45,55.6,20,39,27,12,58,102,171,4,DF,25-29,Defender,Republic of Ireland,Europe
759,Johannes Eggestein,GER,Werder Bremen,Bundesliga,2019,21.0,1998.0,5.7,8,6,2,2,4,3,12,25.0,9,6,0,6,2,10,4,0,"MF,FW",20-24,Midfielder,Germany,Europe
760,Maximilian Eggestein,GER,Werder Bremen,Bundesliga,2019,22.0,1996.0,31.7,40,28,20,18,2,15,43,34.9,28,37,8,29,36,76,57,0,MF,20-24,Midfielder,Germany,Europe
761,Kingsley Ehizibue,NED,Köln,Bundesliga,2019,24.0,1995.0,25.9,79,53,44,30,5,33,53,62.3,20,28,8,20,39,118,79,1,DF,20-24,Defender,Netherlands,Europe
762,Albin Ekdal,SWE,Sampdoria,Serie A,2019,30.0,1989.0,26.5,51,25,18,31,2,24,68,35.3,44,35,14,21,33,84,46,1,MF,30-34,Midfielder,Sweden,Europe
763,Harvey Elliott,ENG,Liverpool,Premier League,2019,16.0,2003.0,0.1,0,0,0,0,0,0,0,,0,0,0,0,0,0,0,0,DF,Under 20,Defender,England,Europe
766,Ahmed Elmohamady,EGY,Aston Villa,Premier League,2019,31.0,1987.0,11.5,19,9,10,7,2,10,21,47.6,11,11,5,6,13,32,25,1,DF,30-34,Defender,Egypt,Africa
768,Nico Elvedi,SUI,Gladbach,Bundesliga,2019,22.0,1996.0,29.1,45,27,37,8,0,19,38,50.0,19,32,15,17,62,107,112,0,DF,20-24,Defender,Switzerland,Europe
769,Rodrigo Ely,BRA,Alavés,La Liga,2019,25.0,1993.0,23.6,22,13,15,7,0,13,29,44.8,16,23,19,4,32,54,116,0,DF,25-29,Defender,Brazil,South America
771,Breel Embolo,SUI,Gladbach,Bundesliga,2019,22.0,1997.0,17.2,22,11,2,15,5,4,15,26.7,11,12,1,11,8,30,5,0,"FW,MF",20-24,Forward,Switzerland,Europe
772,Emerson,BRA,Betis,La Liga,2019,20.0,1999.0,31.5,74,46,49,19,6,36,79,45.6,43,30,9,21,31,105,57,1,DF,20-24,Defender,Brazil,South America
774,Alan Empereur,BRA,Hellas Verona,Serie A,2019,25.0,1994.0,9.5,16,8,11,4,1,6,10,60.0,4,19,12,7,22,38,36,0,DF,25-29,Defender,Brazil,South America
780,Christian Eriksen,DEN,Tottenham,Premier League,2019,27.0,1992.0,12.2,19,9,10,8,1,7,24,29.2,17,10,1,9,12,31,16,0,"MF,FW",25-29,Midfielder,Denmark,Europe
781,Christian Eriksen,DEN,Inter,Serie A,2019,27.0,1992.0,7.8,11,6,2,8,1,5,20,25.0,15,3,0,3,0,11,0,0,MF,25-29,Midfielder,Denmark,Europe
782,Gonzalo Escalante,ARG,Eibar,La Liga,2019,26.0,1993.0,18.6,41,22,15,17,9,24,41,58.5,17,22,4,18,29,70,14,0,MF,25-29,Midfielder,Argentina,South America
785,Bernardo Espinosa,COL,Espanyol,La Liga,2019,30.0,1989.0,25.1,24,16,18,4,2,16,28,57.1,12,19,11,8,24,48,108,2,DF,30-34,Defender,Colombia,South America
786,Sebastiano Esposito,ITA,Inter,Serie A,2019,17.0,2002.0,2.2,3,2,0,2,1,0,5,0.0,5,3,0,3,3,6,1,0,FW,Under 20,Forward,Italy,Europe
788,Alexander Esswein,GER,Hertha BSC,Bundesliga,2019,29.0,1990.0,2.4,6,4,4,2,0,3,8,37.5,5,8,1,7,7,13,7,1,"FW,MF",25-29,Forward,Germany,Europe
789,Pervis Estupiñán,ECU,Osasuna,La Liga,2019,21.0,1998.0,33.1,84,45,53,27,4,42,77,54.5,35,30,7,23,58,142,61,6,DF,20-24,Defender,Ecuador,South America
799,Fabinho,BRA,Liverpool,Premier League,2019,25.0,1993.0,23.1,62,35,20,35,7,26,67,38.8,41,25,2,23,34,96,19,1,MF,25-29,Midfielder,Brazil,South America
799,Fabinho,BRA,Liverpool,Premier League,2019,25.0,1993.0,23.1,62,35,20,35,7,26,67,38.8,41,25,2,23,34,96,19,1,MF,25-29,Midfielder,Brazil,South America
799,Fabinho,BRA,Liverpool,Premier League,2019,25.0,1993.0,23.1,62,35,20,35,7,26,67,38.8,41,25,2,23,34,96,19,1,MF,25-29,Midfielder,Brazil,South America
799,Fabinho,BRA,Liverpool,Premier League,2019,25.0,1993.0,23.1,62,35,20,35,7,26,67,38.8,41,25,2,23,34,96,19,1,MF,25-29,Midfielder,Brazil,South America
799,Fabinho,BRA,Liverpool,Premier League,2019,25.0,1993.0,23.1,62,35,20,35,7,26,67,38.8,41,25,2,23,34,96,19,1,MF,25-29,Midfielder,Brazil,South America
799,Fabinho,BRA,Liverpool,Premier League,2019,25.0,1993.0,23.1,62,35,20,35,7,26,67,38.8,41,25,2,23,34,96,19,1,MF,25-29,Midfielder,Brazil,South America
799,Fabinho,BRA,Liverpool,Premier League,2019,25.0,1993.0,23.1,62,35,20,35,7,26,67,38.8,41,25,2,23,34,96,19,1,MF,25-29,Midfielder,Brazil,South America
799,Fabinho,BRA,Liverpool,Premier League,2019,25.0,1993.0,23.1,62,35,20,35,7,26,67,38.8,41,25,2,23,34,96,19,1,MF,25-29,Midfielder,Brazil,South America
799,Fabinho,BRA,Liverpool,Premier League,2019,25.0,1993.0,23.1,62,35,20,35,7,26,67,38.8,41,25,2,23,34,96,19,1,MF,25-29,Midfielder,Brazil,South America
799,Fabinho,BRA,Liverpool,Premier League,2019,25.0,1993.0,23.1,62,35,20,35,7,26,67,38.8,41,25,2,23,34,96,19,1,MF,25-29,Midfielder,Brazil,South America
799,Fabinho,BRA,Liverpool,Premier League,2019,25.0,1993.0,23.1,62,35,20,35,7,26,67,38.8,41,25,2,23,34,96,19,1,MF,25-29,Midfielder,Brazil,South America
799,Fabinho,BRA,Liverpool,Premier League,2019,25.0,1993.0,23.1,62,35,20,35,7,26,67,38.8,41,25,2,23,34,96,19,1,MF,25-29,Midfielder,Brazil,South America
799,Fabinho,BRA,Liverpool,Premier League,2019,25.0,1993.0,23.1,62,35,20,35,7,26,67,38.8,41,25,2,23,34,96,19,1,MF,25-29,Midfielder,Brazil,South America
799,Fabinho,BRA,Liverpool,Premier League,2019,25.0,1993.0,23.1,62,35,20,35,7,26,67,38.8,41,25,2,23,34,96,19,1,MF,25-29,Midfielder,Brazil,South America
799,Fabinho,BRA,Liverpool,Premier League,2019,25.0,1993.0,23.1,62,35,20,35,7,26,67,38.8,41,25,2,23,34,96,19,1,MF,25-29,Midfielder,Brazil,South America
799,Fabinho,BRA,Liverpool,Premier League,2019,25.0,1993.0,23.1,62,35,20,35,7,26,67,38.8,41,25,2,23,34,96,19,1,MF,25-29,Midfielder,Brazil,South America
799,Fabinho,BRA,Liverpool,Premier League,2019,25.0,1993.0,23.1,62,35,20,35,7,26,67,38.8,41,25,2,23,34,96,19,1,MF,25-29,Midfielder,Brazil,South America
799,Fabinho,BRA,Liverpool,Premier League,2019,25.0,1993.0,23.1,62,35,20,35,7,26,67,38.8,41,25,2,23,34,96,19,1,MF,25-29,Midfielder,Brazil,South America
799,Fabinho,BRA,Liverpool,Premier League,2019,25.0,1993.0,23.1,62,35,20,35,7,26,67,38.8,41,25,2,23,34,96,19,1,MF,25-29,Midfielder,Brazil,South America
799,Fabinho,BRA,Liverpool,Premier League,2019,25.0,1993.0,23.1,62,35,20,35,7,26,67,38.8,41,25,2,23,34,96,19,1,MF,25-29,Midfielder,Brazil,South America
799,Fabinho,BRA,Liverpool,Premier League,2019,25.0,1993.0,23.1,62,35,20,35,7,26,67,38.8,41,25,2,23,34,96,19,1,MF,25-29,Midfielder,Brazil,South America
799,Fabinho,BRA,Liverpool,Premier League,2019,25.0,1993.0,23.1,62,35,20,35,7,26,67,38.8,41,25,2,23,34,96,19,1,MF,25-29,Midfielder,Brazil,South America
799,Fabinho,BRA,Liverpool,Premier League,2019,25.0,1993.0,23.1,62,35,20,35,7,26,67,38.8,41,25,2,23,34,96,19,1,MF,25-29,Midfielder,Brazil,South America
799,Fabinho,BRA,Liverpool,Premier League,2019,25.0,1993.0,23.1,62,35,20,35,7,26,67,38.8,41,25,2,23,34,96,19,1,MF,25-29,Midfielder,Brazil,South America
799,Fabinho,BRA,Liverpool,Premier League,2019,25.0,1993.0,23.1,62,35,20,35,7,26,67,38.8,41,25,2,23,34,96,19,1,MF,25-29,Midfielder,Brazil,South America
800,Fábio,BRA,Nantes,Ligue 1,2019,29.0,1990.0,9.3,38,22,18,20,0,25,35,71.4,10,10,5,5,18,56,19,0,DF,25-29,Defender,Brazil,South America
803,Ralf Fährmann,GER,Norwich City,Premier League,2019,30.0,1988.0,0.2,0,0,0,0,0,0,0,,0,0,0,0,0,0,0,0,GK,30-34,Goalkeeper,Germany,Europe
805,Luca Falbo,ITA,Lazio,Serie A,2019,19.0,2000.0,0.0,0,0,0,0,0,0,0,,0,0,0,0,0,0,0,0,DF,Under 20,Defender,Italy,Europe
806,Filippo Falco,ITA,Lecce,Serie A,2019,27.0,1992.0,22.4,13,7,4,5,4,5,18,27.8,13,11,1,10,2,15,1,0,"FW,MF",25-29,Forward,Italy,Europe
808,Wladimiro Falcone,ITA,Sampdoria,Serie A,2019,24.0,1995.0,2.0,0,0,0,0,0,0,0,,0,0,0,0,0,0,0,0,GK,20-24,Goalkeeper,Italy,Europe
814,Paolo Faragò,ITA,Cagliari,Serie A,2019,26.0,1993.0,14.9,41,28,21,15,5,23,46,50.0,23,18,9,9,10,51,58,0,"DF,MF",25-29,Defender,Italy,Europe
815,Davide Faraoni,ITA,Hellas Verona,Serie A,2019,27.0,1991.0,35.9,67,37,43,19,5,30,67,44.8,37,50,15,35,36,103,115,0,DF,25-29,Defender,Italy,Europe
817,Diego Farias,BRA,Lecce,Serie A,2019,29.0,1990.0,9.2,9,6,3,5,1,5,18,27.8,13,7,0,7,4,13,4,0,"MF,FW",25-29,Midfielder,Brazil,South America
819,Julien Faussurier,FRA,Brest,Ligue 1,2019,32.0,1987.0,22.0,36,22,23,13,0,21,53,39.6,32,22,7,15,33,69,46,1,DF,30-34,Defender,France,Europe
820,Andrea Favilli,ITA,Genoa,Serie A,2019,22.0,1997.0,7.3,8,7,2,3,3,4,11,36.4,7,5,1,4,0,8,7,0,FW,20-24,Forward,Italy,Europe
821,Federico Fazio,ARG,Roma,Serie A,2019,32.0,1987.0,13.5,19,11,12,6,1,6,11,54.5,5,8,6,2,19,38,52,0,DF,30-34,Defender,Argentina,South America
825,Nabil Fekir,FRA,Betis,La Liga,2019,26.0,1993.0,29.3,41,26,14,19,8,12,37,32.4,25,27,3,24,10,51,3,0,"MF,FW",25-29,Midfielder,France,Europe
826,Felipe,BRA,Atlético Madrid,La Liga,2019,30.0,1989.0,23.4,27,19,21,6,0,14,24,58.3,10,18,13,5,40,67,130,0,DF,30-34,Defender,Brazil,South America
826,Felipe,BRA,Atlético Madrid,La Liga,2019,30.0,1989.0,23.4,27,19,21,6,0,14,24,58.3,10,18,13,5,40,67,130,0,DF,30-34,Defender,Brazil,South America
826,Felipe,BRA,Atlético Madrid,La Liga,2019,30.0,1989.0,23.4,27,19,21,6,0,14,24,58.3,10,18,13,5,40,67,130,0,DF,30-34,Defender,Brazil,South America
826,Felipe,BRA,Atlético Madrid,La Liga,2019,30.0,1989.0,23.4,27,19,21,6,0,14,24,58.3,10,18,13,5,40,67,130,0,DF,30-34,Defender,Brazil,South America
827,Luiz Felipe,ITA,Lazio,Serie A,2019,22.0,1997.0,22.5,42,24,24,15,3,19,32,59.4,13,39,30,9,41,83,69,2,DF,20-24,Defender,Italy,Europe
827,Luiz Felipe,ITA,Lazio,Serie A,2019,22.0,1997.0,22.5,42,24,24,15,3,19,32,59.4,13,39,30,9,41,83,69,2,DF,20-24,Defender,Italy,Europe
827,Luiz Felipe,ITA,Lazio,Serie A,2019,22.0,1997.0,22.5,42,24,24,15,3,19,32,59.4,13,39,30,9,41,83,69,2,DF,20-24,Defender,Italy,Europe
827,Luiz Felipe,ITA,Lazio,Serie A,2019,22.0,1997.0,22.5,42,24,24,15,3,19,32,59.4,13,39,30,9,41,83,69,2,DF,20-24,Defender,Italy,Europe
828,Lucas Felippe,BRA,Hellas Verona,Serie A,2019,19.0,2000.0,0.3,1,1,1,0,0,1,1,100.0,0,0,0,0,0,1,0,0,"MF,DF",Under 20,Midfielder,Brazil,South America
829,João Félix,POR,Atlético Madrid,La Liga,2019,19.0,1999.0,19.4,9,3,3,3,3,4,14,28.6,10,4,0,4,10,19,4,1,"FW,MF",Under 20,Forward,Portugal,Europe
832,Zinedine Ferhat,ALG,Nîmes,Ligue 1,2019,26.0,1993.0,25.0,26,16,5,16,5,15,46,32.6,31,15,3,12,16,42,18,0,"FW,MF",25-29,Forward,Algeria,Africa
833,Bruno Fernandes,POR,Manchester Utd,Premier League,2019,24.0,1994.0,13.2,22,12,9,9,4,5,38,13.2,33,6,0,6,11,33,16,0,MF,20-24,Midfielder,Portugal,Europe
834,Edimilson Fernandes,SUI,Mainz 05,Bundesliga,2019,23.0,1996.0,16.5,33,20,12,15,6,15,33,45.5,18,17,9,8,32,65,47,1,"MF,DF",20-24,Midfielder,Switzerland,Europe
836,Gelson Fernandes,SUI,Eint Frankfurt,Bundesliga,2019,32.0,1986.0,8.6,30,18,13,17,0,7,21,33.3,14,11,3,8,16,46,9,2,MF,30-34,Midfielder,Switzerland,Europe
837,Matheus Fernandes,BRA,Valladolid,La Liga,2019,21.0,1998.0,1.8,6,2,2,2,2,3,5,60.0,2,4,0,4,2,8,2,0,"MF,FW",20-24,Midfielder,Brazil,South America
841,Federico Fernández,ARG,Newcastle Utd,Premier League,2019,30.0,1989.0,29.1,42,25,30,10,2,23,46,50.0,23,41,28,13,24,66,190,2,DF,30-34,Defender,Argentina,South America
842,Gabriel Fernández,URU,Celta Vigo,La Liga,2019,25.0,1994.0,6.2,1,0,0,1,0,1,3,33.3,2,5,1,4,2,3,2,0,"FW,MF",25-29,Forward,Uruguay,South America
844,Fernandinho,BRA,Manchester City,Premier League,2019,34.0,1985.0,26.6,50,35,32,16,2,29,48,60.4,19,28,16,12,25,75,82,0,DF,30-34,Defender,Brazil,South America
844,Fernandinho,BRA,Manchester City,Premier League,2019,34.0,1985.0,26.6,50,35,32,16,2,29,48,60.4,19,28,16,12,25,75,82,0,DF,30-34,Defender,Brazil,South America
844,Fernandinho,BRA,Manchester City,Premier League,2019,34.0,1985.0,26.6,50,35,32,16,2,29,48,60.4,19,28,16,12,25,75,82,0,DF,30-34,Defender,Brazil,South America
844,Fernandinho,BRA,Manchester City,Premier League,2019,34.0,1985.0,26.6,50,35,32,16,2,29,48,60.4,19,28,16,12,25,75,82,0,DF,30-34,Defender,Brazil,South America
844,Fernandinho,BRA,Manchester City,Premier League,2019,34.0,1985.0,26.6,50,35,32,16,2,29,48,60.4,19,28,16,12,25,75,82,0,DF,30-34,Defender,Brazil,South America
844,Fernandinho,BRA,Manchester City,Premier League,2019,34.0,1985.0,26.6,50,35,32,16,2,29,48,60.4,19,28,16,12,25,75,82,0,DF,30-34,Defender,Brazil,South America
844,Fernandinho,BRA,Manchester City,Premier League,2019,34.0,1985.0,26.6,50,35,32,16,2,29,48,60.4,19,28,16,12,25,75,82,0,DF,30-34,Defender,Brazil,South America
844,Fernandinho,BRA,Manchester City,Premier League,2019,34.0,1985.0,26.6,50,35,32,16,2,29,48,60.4,19,28,16,12,25,75,82,0,DF,30-34,Defender,Brazil,South America
844,Fernandinho,BRA,Manchester City,Premier League,2019,34.0,1985.0,26.6,50,35,32,16,2,29,48,60.4,19,28,16,12,25,75,82,0,DF,30-34,Defender,Brazil,South America
844,Fernandinho,BRA,Manchester City,Premier League,2019,34.0,1985.0,26.6,50,35,32,16,2,29,48,60.4,19,28,16,12,25,75,82,0,DF,30-34,Defender,Brazil,South America
844,Fernandinho,BRA,Manchester City,Premier League,2019,34.0,1985.0,26.6,50,35,32,16,2,29,48,60.4,19,28,16,12,25,75,82,0,DF,30-34,Defender,Brazil,South America
844,Fernandinho,BRA,Manchester City,Premier League,2019,34.0,1985.0,26.6,50,35,32,16,2,29,48,60.4,19,28,16,12,25,75,82,0,DF,30-34,Defender,Brazil,South America
844,Fernandinho,BRA,Manchester City,Premier League,2019,34.0,1985.0,26.6,50,35,32,16,2,29,48,60.4,19,28,16,12,25,75,82,0,DF,30-34,Defender,Brazil,South America
844,Fernandinho,BRA,Manchester City,Premier League,2019,34.0,1985.0,26.6,50,35,32,16,2,29,48,60.4,19,28,16,12,25,75,82,0,DF,30-34,Defender,Brazil,South America
844,Fernandinho,BRA,Manchester City,Premier League,2019,34.0,1985.0,26.6,50,35,32,16,2,29,48,60.4,19,28,16,12,25,75,82,0,DF,30-34,Defender,Brazil,South America
844,Fernandinho,BRA,Manchester City,Premier League,2019,34.0,1985.0,26.6,50,35,32,16,2,29,48,60.4,19,28,16,12,25,75,82,0,DF,30-34,Defender,Brazil,South America
845,Fernando,BRA,Sevilla,La Liga,2019,32.0,1987.0,29.5,62,33,37,24,1,34,58,58.6,24,38,15,23,67,129,73,1,MF,30-34,Midfielder,Brazil,South America
845,Fernando,BRA,Sevilla,La Liga,2019,32.0,1987.0,29.5,62,33,37,24,1,34,58,58.6,24,38,15,23,67,129,73,1,MF,30-34,Midfielder,Brazil,South America
845,Fernando,BRA,Sevilla,La Liga,2019,32.0,1987.0,29.5,62,33,37,24,1,34,58,58.6,24,38,15,23,67,129,73,1,MF,30-34,Midfielder,Brazil,South America
845,Fernando,BRA,Sevilla,La Liga,2019,32.0,1987.0,29.5,62,33,37,24,1,34,58,58.6,24,38,15,23,67,129,73,1,MF,30-34,Midfielder,Brazil,South America
845,Fernando,BRA,Sevilla,La Liga,2019,32.0,1987.0,29.5,62,33,37,24,1,34,58,58.6,24,38,15,23,67,129,73,1,MF,30-34,Midfielder,Brazil,South America
845,Fernando,BRA,Sevilla,La Liga,2019,32.0,1987.0,29.5,62,33,37,24,1,34,58,58.6,24,38,15,23,67,129,73,1,MF,30-34,Midfielder,Brazil,South America
845,Fernando,BRA,Sevilla,La Liga,2019,32.0,1987.0,29.5,62,33,37,24,1,34,58,58.6,24,38,15,23,67,129,73,1,MF,30-34,Midfielder,Brazil,South America
845,Fernando,BRA,Sevilla,La Liga,2019,32.0,1987.0,29.5,62,33,37,24,1,34,58,58.6,24,38,15,23,67,129,73,1,MF,30-34,Midfielder,Brazil,South America
845,Fernando,BRA,Sevilla,La Liga,2019,32.0,1987.0,29.5,62,33,37,24,1,34,58,58.6,24,38,15,23,67,129,73,1,MF,30-34,Midfielder,Brazil,South America
845,Fernando,BRA,Sevilla,La Liga,2019,32.0,1987.0,29.5,62,33,37,24,1,34,58,58.6,24,38,15,23,67,129,73,1,MF,30-34,Midfielder,Brazil,South America
845,Fernando,BRA,Sevilla,La Liga,2019,32.0,1987.0,29.5,62,33,37,24,1,34,58,58.6,24,38,15,23,67,129,73,1,MF,30-34,Midfielder,Brazil,South America
845,Fernando,BRA,Sevilla,La Liga,2019,32.0,1987.0,29.5,62,33,37,24,1,34,58,58.6,24,38,15,23,67,129,73,1,MF,30-34,Midfielder,Brazil,South America
845,Fernando,BRA,Sevilla,La Liga,2019,32.0,1987.0,29.5,62,33,37,24,1,34,58,58.6,24,38,15,23,67,129,73,1,MF,30-34,Midfielder,Brazil,South America
845,Fernando,BRA,Sevilla,La Liga,2019,32.0,1987.0,29.5,62,33,37,24,1,34,58,58.6,24,38,15,23,67,129,73,1,MF,30-34,Midfielder,Brazil,South America
845,Fernando,BRA,Sevilla,La Liga,2019,32.0,1987.0,29.5,62,33,37,24,1,34,58,58.6,24,38,15,23,67,129,73,1,MF,30-34,Midfielder,Brazil,South America
845,Fernando,BRA,Sevilla,La Liga,2019,32.0,1987.0,29.5,62,33,37,24,1,34,58,58.6,24,38,15,23,67,129,73,1,MF,30-34,Midfielder,Brazil,South America
847,Alex Ferrari,ITA,Sampdoria,Serie A,2019,25.0,1994.0,11.2,18,13,13,5,0,7,12,58.3,5,13,8,5,12,30,31,0,DF,25-29,Defender,Italy,Europe
848,Facundo Ferreyra,ARG,Espanyol,La Liga,2019,28.0,1991.0,6.4,9,4,4,5,0,3,10,30.0,7,4,0,4,2,11,5,0,"FW,MF",25-29,Forward,Argentina,South America
849,Jordan Ferri,FRA,Montpellier,Ligue 1,2019,27.0,1992.0,12.8,22,13,7,12,3,13,44,29.5,31,9,0,9,10,32,10,0,MF,25-29,Midfielder,France,Europe
850,Oliver Fink,GER,Düsseldorf,Bundesliga,2019,37.0,1982.0,7.5,21,12,7,11,3,5,16,31.3,11,12,1,11,15,36,7,0,"MF,FW",35-39,Midfielder,Germany,Europe
852,Roberto Firmino,BRA,Liverpool,Premier League,2019,27.0,1991.0,33.2,37,19,8,14,15,10,43,23.3,33,34,3,31,7,44,11,1,FW,25-29,Forward,Brazil,South America
853,Junior Firpo,DOM,Barcelona,La Liga,2019,22.0,1996.0,11.3,23,15,12,8,3,11,17,64.7,6,15,3,12,17,40,12,1,DF,20-24,Defender,Dominican Republic,North America
854,John Fleck,SCO,Sheffield Utd,Premier League,2019,27.0,1991.0,28.0,36,25,13,14,9,22,64,34.4,42,25,3,22,24,60,26,0,MF,25-29,Midfielder,Scotland,Europe
855,Mark Flekken,NED,Freiburg,Bundesliga,2019,26.0,1993.0,10.0,0,0,0,0,0,0,1,0.0,1,0,0,0,0,0,2,2,GK,25-29,Goalkeeper,Netherlands,Europe
856,Sergio Floccari,ITA,SPAL,Serie A,2019,37.0,1981.0,10.5,8,3,3,1,4,0,13,0.0,13,9,1,8,5,13,1,0,FW,35-39,Forward,Italy,Europe
857,Alessandro Florenzi,ITA,Roma,Serie A,2019,28.0,1991.0,11.1,14,11,8,4,2,7,20,35.0,13,9,3,6,16,30,19,0,"DF,FW",25-29,Defender,Italy,Europe
858,Alessandro Florenzi,ITA,Valencia,La Liga,2019,28.0,1991.0,8.4,13,9,9,4,0,8,18,44.4,10,11,1,10,14,27,21,0,DF,25-29,Defender,Italy,Europe
859,Phil Foden,ENG,Manchester City,Premier League,2019,19.0,2000.0,10.0,14,10,4,6,4,6,19,31.6,13,5,0,5,6,20,2,0,"FW,MF",Under 20,Forward,England,Europe
860,Mamadou Fofana,MLI,Metz,Ligue 1,2019,21.0,1998.0,17.6,57,35,38,15,4,21,41,51.2,20,22,10,12,22,79,61,1,"DF,MF",20-24,Defender,Mali,Africa
861,Seko Fofana,CIV,Udinese,Serie A,2019,24.0,1995.0,25.0,17,12,8,8,1,9,35,25.7,26,20,1,19,17,34,19,0,MF,20-24,Midfielder,Ivory Coast,Africa
862,Wesley Fofana,FRA,Saint-Étienne,Ligue 1,2019,18.0,2000.0,13.5,25,15,16,9,0,12,18,66.7,6,10,5,5,36,61,55,4,DF,Under 20,Defender,France,Europe
863,Youssouf Fofana,FRA,Strasbourg,Ligue 1,2019,20.0,1999.0,11.2,25,17,10,12,3,13,30,43.3,17,11,0,11,14,39,7,0,MF,20-24,Midfielder,France,Europe
864,Youssouf Fofana,FRA,Monaco,Ligue 1,2019,20.0,1999.0,6.8,16,9,6,10,0,8,15,53.3,7,12,2,10,8,24,9,0,MF,20-24,Midfielder,France,Europe
866,Lamine Fomba,FRA,Nîmes,Ligue 1,2019,21.0,1998.0,15.3,65,31,20,37,8,21,43,48.8,22,29,4,25,25,90,11,1,MF,20-24,Midfielder,France,Europe
869,Emil Forsberg,SWE,RB Leipzig,Bundesliga,2019,27.0,1991.0,12.7,16,10,5,8,3,6,26,23.1,20,15,0,15,5,21,3,0,MF,25-29,Midfielder,Sweden,Europe
871,Ben Foster,ENG,Watford,Premier League,2019,36.0,1983.0,38.0,1,0,1,0,0,1,3,33.3,2,1,0,1,0,1,16,2,GK,35-39,Goalkeeper,England,Europe
872,Lyle Foster,RSA,Monaco,Ligue 1,2019,18.0,2000.0,0.7,0,0,0,0,0,0,1,0.0,1,0,0,0,0,0,1,0,FW,Under 20,Forward,South Africa,Africa
873,Timothy Fosu-Mensah,NED,Manchester Utd,Premier League,2019,21.0,1998.0,1.5,1,1,0,1,0,1,4,25.0,3,0,0,0,4,5,1,0,DF,20-24,Defender,Netherlands,Europe
874,Dimitri Foulquier,FRA,Watford,Premier League,2019,26.0,1993.0,0.7,1,0,1,0,0,0,0,,0,1,0,1,2,3,2,0,"DF,MF",25-29,Defender,France,Europe
875,Dimitri Foulquier,FRA,Granada,La Liga,2019,26.0,1993.0,12.4,25,11,13,9,3,11,20,55.0,9,8,3,5,16,41,32,0,"DF,MF",25-29,Defender,France,Europe
876,Juan Foyth,ARG,Tottenham,Premier League,2019,21.0,1998.0,0.8,7,3,5,2,0,3,4,75.0,1,1,0,1,1,8,3,1,DF,20-24,Defender,Argentina,South America
877,Gianluca Frabotta,ITA,Juventus,Serie A,2019,20.0,1999.0,1.0,3,1,0,2,1,2,2,100.0,0,2,0,2,1,4,2,0,DF,20-24,Defender,Italy,Europe
878,Raphael Framberger,GER,Augsburg,Bundesliga,2019,23.0,1995.0,13.1,43,25,23,16,4,21,29,72.4,8,23,9,14,20,63,26,0,DF,20-24,Defender,Germany,Europe
879,Simon Francis,ENG,Bournemouth,Premier League,2019,34.0,1985.0,10.8,13,9,11,2,0,11,21,52.4,10,17,12,5,20,33,71,0,DF,30-34,Defender,England,Europe
880,Mike Frantz,GER,Freiburg,Bundesliga,2019,32.0,1986.0,3.9,4,2,1,3,0,2,9,22.2,7,5,3,2,1,5,4,0,MF,30-34,Midfielder,Germany,Europe
881,Ryan Fraser,SCO,Bournemouth,Premier League,2019,25.0,1994.0,23.0,12,6,5,5,2,7,22,31.8,15,15,3,12,15,27,24,0,"MF,FW",25-29,Midfielder,Scotland,Europe
883,Ryan Fredericks,ENG,West Ham,Premier League,2019,26.0,1992.0,24.9,82,56,59,18,5,41,64,64.1,23,20,10,10,24,106,73,1,DF,25-29,Defender,England,Europe
884,Kieron Freeman,WAL,Sheffield Utd,Premier League,2019,27.0,1992.0,0.1,0,0,0,0,0,0,0,,0,0,0,0,0,0,0,0,FW,25-29,Forward,Wales,Europe
885,Luke Freeman,ENG,Sheffield Utd,Premier League,2019,27.0,1992.0,4.1,6,4,2,2,2,2,8,25.0,6,1,0,1,10,16,6,0,MF,25-29,Midfielder,England,Europe
886,Remo Freuler,SUI,Atalanta,Serie A,2019,27.0,1992.0,26.0,51,30,18,25,8,22,63,34.9,41,41,6,35,28,79,26,0,MF,25-29,Midfielder,Switzerland,Europe
887,Marco Friedl,AUT,Werder Bremen,Bundesliga,2019,21.0,1998.0,24.3,61,39,42,15,4,29,54,53.7,25,29,9,20,34,95,78,0,"DF,MF",20-24,Defender,Austria,Europe
888,Marvin Friedrich,GER,Union Berlin,Bundesliga,2019,23.0,1995.0,31.0,45,31,30,14,1,12,37,32.4,25,46,24,22,42,87,110,0,DF,20-24,Defender,Germany,Europe
891,Christian Fuchs,AUT,Leicester City,Premier League,2019,33.0,1986.0,8.6,14,9,8,6,0,8,19,42.1,11,8,3,5,17,31,33,1,DF,30-34,Defender,Austria,Europe
892,Angelo Fulgini,FRA,Angers,Ligue 1,2019,22.0,1996.0,17.5,28,18,8,15,5,12,23,52.2,11,6,1,5,19,47,10,0,MF,20-24,Midfielder,France,Europe
893,Niclas Füllkrug,GER,Werder Bremen,Bundesliga,2019,26.0,1993.0,4.5,2,2,1,1,0,1,3,33.3,2,3,0,3,3,5,6,0,FW,25-29,Forward,Germany,Europe
894,Ramiro Funes Mori,ARG,Villarreal,La Liga,2019,28.0,1991.0,5.0,5,2,2,3,0,0,2,0.0,2,8,2,6,3,8,9,1,DF,25-29,Defender,Argentina,South America
895,Daniel Fuzato,BRA,Roma,Serie A,2019,22.0,1997.0,1.0,0,0,0,0,0,0,0,,0,0,0,0,0,0,0,0,GK,20-24,Goalkeeper,Brazil,South America
896,Matteo Gabbia,ITA,Milan,Serie A,2019,19.0,1999.0,7.6,7,5,5,2,0,5,8,62.5,3,6,6,0,9,16,21,0,DF,Under 20,Defender,Italy,Europe
897,Manolo Gabbiadini,ITA,Sampdoria,Serie A,2019,27.0,1991.0,22.6,9,7,2,3,4,1,7,14.3,6,12,0,12,10,19,11,0,FW,25-29,Forward,Italy,Europe
898,Gabriel,BRA,Lecce,Serie A,2019,26.0,1992.0,33.3,2,1,2,0,0,2,3,66.7,1,0,0,0,0,2,11,10,GK,25-29,Goalkeeper,Brazil,South America
898,Gabriel,BRA,Lecce,Serie A,2019,26.0,1992.0,33.3,2,1,2,0,0,2,3,66.7,1,0,0,0,0,2,11,10,GK,25-29,Goalkeeper,Brazil,South America
898,Gabriel,BRA,Lecce,Serie A,2019,26.0,1992.0,33.3,2,1,2,0,0,2,3,66.7,1,0,0,0,0,2,11,10,GK,25-29,Goalkeeper,Brazil,South America
898,Gabriel,BRA,Lecce,Serie A,2019,26.0,1992.0,33.3,2,1,2,0,0,2,3,66.7,1,0,0,0,0,2,11,10,GK,25-29,Goalkeeper,Brazil,South America
901,Luca Gagliano,ITA,Cagliari,Serie A,2019,19.0,2000.0,0.6,0,0,0,0,0,0,0,,0,0,0,0,1,1,0,0,FW,Under 20,Forward,Italy,Europe
902,Roberto Gagliardini,ITA,Inter,Serie A,2019,25.0,1994.0,20.0,38,19,12,18,8,14,41,34.1,27,28,8,20,30,68,20,1,MF,25-29,Midfielder,Italy,Europe
903,Riccardo Gagliolo,SWE,Parma,Serie A,2019,29.0,1990.0,28.9,57,32,37,12,8,30,60,50.0,30,35,18,17,53,110,100,0,DF,25-29,Defender,Sweden,Europe
905,Marvin Gakpa,FRA,Metz,Ligue 1,2019,25.0,1993.0,5.2,10,6,3,4,3,4,8,50.0,4,3,0,3,5,15,1,0,"MF,FW",25-29,Midfielder,France,Europe
908,Kévin Gameiro,FRA,Valencia,La Liga,2019,32.0,1987.0,17.6,17,9,7,6,4,5,21,23.8,16,10,1,9,5,22,5,0,FW,30-34,Forward,France,Europe
911,Ignatius Ganago,CMR,Nice,Ligue 1,2019,20.0,1999.0,13.8,10,6,4,3,3,3,18,16.7,15,8,1,7,4,14,13,0,"FW,MF",20-24,Forward,Cameroon,Africa
912,Ezequiel Garay,ARG,Valencia,La Liga,2019,32.0,1986.0,16.0,12,8,9,2,1,7,11,63.6,4,19,17,2,14,26,71,0,DF,30-34,Defender,Argentina,South America
924,James Garner,ENG,Manchester Utd,Premier League,2019,18.0,2001.0,0.1,0,0,0,0,0,0,1,0.0,1,0,0,0,0,0,1,0,MF,Under 20,Midfielder,England,Europe
927,Daniele Gastaldello,ITA,Brescia,Serie A,2019,36.0,1983.0,4.3,8,5,5,3,0,2,3,66.7,1,6,3,3,5,13,29,1,DF,35-39,Defender,Italy,Europe
929,Paulo Gazzaniga,ARG,Tottenham,Premier League,2019,27.0,1992.0,17.9,0,0,0,0,0,0,0,,0,0,0,0,1,1,4,1,GK,25-29,Goalkeeper,Argentina,South America
931,Yann Gboho,FRA,Rennes,Ligue 1,2019,18.0,2001.0,2.5,2,2,1,0,1,0,2,0.0,2,1,0,1,1,3,0,0,FW,Under 20,Forward,France,Europe
934,Dennis Geiger,GER,Hoffenheim,Bundesliga,2019,21.0,1998.0,12.6,12,5,4,6,2,2,16,12.5,14,9,2,7,6,18,4,0,MF,20-24,Midfielder,Germany,Europe
936,Christian Gentner,GER,Union Berlin,Bundesliga,2019,33.0,1985.0,27.1,53,28,16,32,5,22,73,30.1,51,46,8,38,54,107,50,0,MF,30-34,Midfielder,Germany,Europe
937,Yannick Gerhardt,GER,Wolfsburg,Bundesliga,2019,25.0,1994.0,9.2,28,18,7,15,6,8,21,38.1,13,11,3,8,12,40,9,0,MF,25-29,Midfielder,Germany,Europe
938,Valère Germain,FRA,Marseille,Ligue 1,2019,29.0,1990.0,15.0,22,12,6,11,5,6,31,19.4,25,16,3,13,8,30,26,0,FW,25-29,Forward,France,Europe
940,Anwar El Ghazi,NED,Aston Villa,Premier League,2019,24.0,1995.0,22.8,20,11,12,5,3,8,26,30.8,18,10,1,9,13,33,16,1,"FW,MF",20-24,Forward,Netherlands,Europe
943,Paolo Ghiglione,ITA,Genoa,Serie A,2019,22.0,1997.0,19.1,31,16,15,13,3,18,35,51.4,17,17,2,15,9,40,42,1,"DF,FW",20-24,Defender,Italy,Europe
944,Andrea Ghion,ITA,Sassuolo,Serie A,2019,19.0,2000.0,0.5,3,1,1,2,0,1,1,100.0,0,0,0,0,0,3,0,0,"FW,MF",Under 20,Forward,Italy,Europe
945,Saman Ghoddos,IRN,Amiens,Ligue 1,2019,25.0,1993.0,2.6,2,2,0,1,1,1,2,50.0,1,5,0,5,2,4,3,0,FW,25-29,Forward,Iran,Asia
947,Morgan Gibbs-White,ENG,Wolves,Premier League,2019,19.0,2000.0,1.4,0,0,0,0,0,0,0,,0,0,0,0,2,2,0,0,"MF,FW",Under 20,Midfielder,England,Europe
948,Niko Gießelmann,GER,Düsseldorf,Bundesliga,2019,27.0,1991.0,22.9,46,31,31,11,4,22,45,48.9,23,23,6,17,27,73,55,1,DF,25-29,Defender,Germany,Europe
952,Billy Gilmour,SCO,Chelsea,Premier League,2019,18.0,2001.0,2.2,5,2,3,2,0,2,4,50.0,2,2,0,2,3,8,3,1,MF,Under 20,Midfielder,Scotland,Europe
953,Daniel Ginczek,GER,Wolfsburg,Bundesliga,2019,28.0,1991.0,8.5,4,3,3,1,0,1,11,9.1,10,3,1,2,1,5,3,0,FW,25-29,Forward,Germany,Europe
954,Matthias Ginter,GER,Gladbach,Bundesliga,2019,25.0,1994.0,30.9,34,20,19,14,1,17,31,54.8,14,27,22,5,34,68,125,3,DF,25-29,Defender,Germany,Europe
955,Andrei Girotto,BRA,Nantes,Ligue 1,2019,27.0,1992.0,24.2,76,53,45,29,2,39,71,54.9,32,32,17,15,34,110,111,1,DF,25-29,Defender,Brazil,South America
956,Olivier Giroud,FRA,Chelsea,Premier League,2019,32.0,1986.0,11.0,8,3,2,5,1,1,11,9.1,10,14,1,13,2,10,13,0,FW,30-34,Forward,France,Europe
957,Klaus Gjasula,ALB,Paderborn 07,Bundesliga,2019,29.0,1989.0,25.3,69,39,30,35,4,30,61,49.2,31,33,6,27,32,101,50,2,MF,25-29,Midfielder,Albania,Europe
959,Serge Gnabry,GER,Bayern Munich,Bundesliga,2019,24.0,1995.0,24.4,36,16,4,19,13,9,29,31.0,20,17,0,17,16,52,2,1,"FW,MF",20-24,Forward,Germany,Europe
960,Joris Gnagnon,FRA,Rennes,Ligue 1,2019,22.0,1997.0,14.2,16,13,14,2,0,10,11,90.9,1,21,17,4,18,34,61,0,DF,20-24,Defender,France,Europe
961,Eddy Gnahoré,FRA,Amiens,Ligue 1,2019,25.0,1993.0,12.6,24,12,7,15,2,8,28,28.6,20,25,4,21,9,33,25,0,MF,25-29,Midfielder,France,Europe
962,Ben Godfrey,ENG,Norwich City,Premier League,2019,21.0,1998.0,29.4,22,14,18,3,1,10,18,55.6,8,41,37,4,25,47,152,3,DF,20-24,Defender,England,Europe
963,Diego Godín,URU,Inter,Serie A,2019,33.0,1986.0,18.1,38,29,19,16,3,18,32,56.3,14,17,7,10,45,83,60,1,DF,30-34,Defender,Uruguay,South America
964,Akaki Gogia,GER,Union Berlin,Bundesliga,2019,27.0,1992.0,1.3,2,1,0,0,2,0,2,0.0,2,2,2,0,0,2,0,0,"MF,FW",25-29,Midfielder,Germany,Europe
965,Mauro Goicoechea,URU,Toulouse,Ligue 1,2019,31.0,1988.0,2.0,0,0,0,0,0,0,0,,0,0,0,0,0,0,1,2,GK,30-34,Goalkeeper,Uruguay,South America
966,Edoardo Goldaniga,ITA,Genoa,Serie A,2019,25.0,1993.0,8.7,4,3,3,1,0,2,5,40.0,3,11,6,5,18,22,25,1,DF,25-29,Defender,Italy,Europe
967,Benjamin Goller,GER,Werder Bremen,Bundesliga,2019,20.0,1999.0,3.2,8,3,3,4,1,3,10,30.0,7,3,0,3,1,9,1,0,"FW,MF",20-24,Forward,Germany,Europe
968,Pierluigi Gollini,ITA,Atalanta,Serie A,2019,24.0,1995.0,32.0,0,0,0,0,0,0,2,0.0,2,0,0,0,0,0,13,2,GK,20-24,Goalkeeper,Italy,Europe
969,Aleksandr Golovin,RUS,Monaco,Ligue 1,2019,23.0,1996.0,22.9,49,27,17,26,6,14,69,20.3,55,28,0,28,31,80,22,0,MF,20-24,Midfielder,Russia,Europe
970,André Gomes,POR,Everton,Premier League,2019,26.0,1993.0,16.2,22,15,7,11,4,8,62,12.9,54,20,3,17,7,29,7,0,MF,25-29,Midfielder,Portugal,Europe
970,André Gomes,POR,Everton,Premier League,2019,26.0,1993.0,16.2,22,15,7,11,4,8,62,12.9,54,20,3,17,7,29,7,0,MF,25-29,Midfielder,Portugal,Europe
970,André Gomes,POR,Everton,Premier League,2019,26.0,1993.0,16.2,22,15,7,11,4,8,62,12.9,54,20,3,17,7,29,7,0,MF,25-29,Midfielder,Portugal,Europe
970,André Gomes,POR,Everton,Premier League,2019,26.0,1993.0,16.2,22,15,7,11,4,8,62,12.9,54,20,3,17,7,29,7,0,MF,25-29,Midfielder,Portugal,Europe
971,Angel Gomes,ENG,Manchester Utd,Premier League,2019,18.0,2000.0,0.2,0,0,0,0,0,0,0,,0,1,0,1,0,0,0,0,MF,Under 20,Midfielder,England,Europe
973,Joe Gomez,ENG,Liverpool,Premier League,2019,22.0,1997.0,22.3,23,16,17,6,0,9,20,45.0,11,15,8,7,38,61,64,2,DF,20-24,Defender,England,Europe
974,Maxi Gómez,URU,Valencia,La Liga,2019,22.0,1996.0,23.8,9,7,1,6,2,4,8,50.0,4,8,1,7,5,14,14,0,FW,20-24,Forward,Uruguay,South America
976,Papu Gómez,ARG,Atalanta,Serie A,2019,31.0,1988.0,31.6,27,13,5,13,9,13,45,28.9,32,24,0,24,17,44,6,1,"MF,FW",30-34,Midfielder,Argentina,South America
979,Alfred Gomis,SEN,Dijon,Ligue 1,2019,25.0,1993.0,18.0,1,0,1,0,0,1,2,50.0,1,2,0,2,0,1,14,2,GK,25-29,Goalkeeper,Senegal,Africa
980,Maxime Gonalons,FRA,Granada,La Liga,2019,30.0,1989.0,16.7,62,38,25,35,2,22,54,40.7,32,27,3,24,20,82,20,1,MF,30-34,Midfielder,France,Europe
982,Jérôme Gondorf,GER,Freiburg,Bundesliga,2019,31.0,1988.0,1.3,9,6,7,1,1,3,6,50.0,3,3,2,1,0,9,2,0,MF,30-34,Midfielder,Germany,Europe
988,Anthony Gordon,ENG,Everton,Premier League,2019,18.0,2001.0,4.9,11,7,5,6,0,5,15,33.3,10,6,2,4,8,19,4,0,"MF,FW",Under 20,Midfielder,England,Europe
989,Leon Goretzka,GER,Bayern Munich,Bundesliga,2019,24.0,1995.0,16.8,28,15,7,18,3,10,32,31.3,22,18,2,16,24,52,8,0,MF,20-24,Midfielder,Germany,Europe
991,Robin Gosens,GER,Atalanta,Serie A,2019,25.0,1994.0,29.1,53,27,19,26,8,23,51,45.1,28,38,10,28,39,92,40,0,DF,25-29,Defender,Germany,Europe
992,Dan Gosling,ENG,Bournemouth,Premier League,2019,29.0,1990.0,14.0,26,10,14,9,3,6,27,22.2,21,31,11,20,20,46,26,0,MF,25-29,Midfielder,England,Europe
993,Mario Götze,GER,Dortmund,Bundesliga,2019,27.0,1992.0,5.8,10,7,0,6,4,3,12,25.0,9,3,0,3,2,12,1,0,FW,25-29,Forward,Germany,Europe
995,Amine Gouiri,ALG,Lyon,Ligue 1,2019,19.0,2000.0,0.0,0,0,0,0,0,0,0,,0,0,0,0,0,0,0,0,FW,Under 20,Forward,Algeria,Africa
996,Jeffrey Gouweleeuw,NED,Augsburg,Bundesliga,2019,28.0,1991.0,18.3,28,16,22,5,1,12,21,57.1,9,15,8,7,37,65,97,0,DF,25-29,Defender,Netherlands,Europe
998,Samuel Grandsir,FRA,Brest,Ligue 1,2019,22.0,1996.0,16.6,34,22,13,16,5,11,30,36.7,19,9,0,9,14,48,5,0,"FW,MF",20-24,Forward,France,Europe
1000,Alberto Grassi,ITA,Parma,Serie A,2019,24.0,1995.0,7.1,10,4,7,3,0,5,13,38.5,8,5,2,3,19,29,9,1,MF,20-24,Midfielder,Italy,Europe
1002,Demarai Gray,JAM,Leicester City,Premier League,2019,23.0,1996.0,6.9,12,6,6,6,0,6,12,50.0,6,7,0,7,5,17,4,0,"MF,FW",20-24,Midfielder,Jamaica,North America
1003,Jack Grealish,ENG,Aston Villa,Premier League,2019,23.0,1995.0,35.9,29,19,12,12,5,13,34,38.2,21,33,12,21,22,51,22,1,"FW,MF",20-24,Forward,England,Europe
1004,Mason Greenwood,ENG,Manchester Utd,Premier League,2019,17.0,2001.0,14.7,17,11,5,6,6,5,20,25.0,15,9,0,9,6,23,6,1,FW,Under 20,Forward,England,Europe
1005,Michael Gregoritsch,AUT,Augsburg,Bundesliga,2019,25.0,1994.0,3.4,2,2,0,2,0,0,4,0.0,4,4,1,3,3,5,7,0,"MF,FW",25-29,Midfielder,Austria,Europe
1006,Michael Gregoritsch,AUT,Schalke 04,Bundesliga,2019,25.0,1994.0,9.2,8,5,0,6,2,0,9,0.0,9,9,1,8,2,10,10,0,FW,25-29,Forward,Austria,Europe
1007,Clément Grenier,FRA,Rennes,Ligue 1,2019,28.0,1991.0,9.3,21,12,6,15,0,11,40,27.5,29,7,2,5,7,28,16,0,MF,25-29,Midfielder,France,Europe
1008,Antoine Griezmann,FRA,Barcelona,La Liga,2019,28.0,1991.0,28.3,33,18,12,11,10,9,34,26.5,25,22,3,19,12,45,20,1,FW,25-29,Forward,France,Europe
1009,Vincenzo Grifo,ITA,Hoffenheim,Bundesliga,2019,26.0,1993.0,0.2,0,0,0,0,0,0,0,,0,0,0,0,0,0,0,0,MF,25-29,Midfielder,Italy,Europe
1010,Vincenzo Grifo,ITA,Freiburg,Bundesliga,2019,26.0,1993.0,18.0,15,10,9,3,3,6,25,24.0,19,13,1,12,14,29,18,1,"MF,FW",25-29,Midfielder,Italy,Europe
1011,Florian Grillitsch,AUT,Hoffenheim,Bundesliga,2019,23.0,1995.0,26.8,59,29,34,24,1,29,61,47.5,32,33,6,27,49,108,41,1,"MF,DF",20-24,Midfielder,Austria,Europe
1012,Jérémy Grimm,FRA,Strasbourg,Ligue 1,2019,32.0,1987.0,0.0,0,0,0,0,0,0,0,,0,0,0,0,0,0,0,0,MF,30-34,Midfielder,France,Europe
1013,Christian Groß,GER,Werder Bremen,Bundesliga,2019,30.0,1989.0,9.7,23,17,16,5,2,9,16,56.3,7,13,7,6,14,37,50,1,"DF,MF",30-34,Defender,Germany,Europe
1014,Pascal Groß,GER,Brighton,Premier League,2019,28.0,1991.0,20.0,36,13,8,21,7,14,39,35.9,25,25,3,22,9,45,7,0,"MF,FW",25-29,Midfielder,Germany,Europe
1015,Carlos Gruezo,ECU,Augsburg,Bundesliga,2019,24.0,1995.0,9.8,28,12,12,15,1,5,24,20.8,19,5,0,5,6,34,5,0,MF,20-24,Midfielder,Ecuador,South America
1018,Andrés Guardado,MEX,Betis,La Liga,2019,32.0,1986.0,22.7,30,14,15,11,4,15,41,36.6,26,15,4,11,18,48,22,1,MF,30-34,Midfielder,Mexico,North America
1021,Gonçalo Guedes,POR,Valencia,La Liga,2019,22.0,1996.0,14.1,19,11,11,7,1,9,32,28.1,23,10,1,9,7,26,1,0,"MF,FW",20-24,Midfielder,Portugal,Europe
1022,Mattéo Guendouzi,FRA,Arsenal,Premier League,2019,20.0,1999.0,19.4,31,16,14,13,4,14,43,32.6,29,21,7,14,29,60,38,2,MF,20-24,Midfielder,France,Europe
1023,Raphaël Guerreiro,POR,Dortmund,Bundesliga,2019,25.0,1993.0,25.9,44,24,18,21,5,20,32,62.5,12,27,3,24,42,86,26,0,"DF,MF",25-29,Defender,Portugal,Europe
1027,John Guidetti,SWE,Alavés,La Liga,2019,27.0,1992.0,1.1,2,1,0,1,1,0,0,,0,1,0,1,0,2,0,0,"FW,MF",25-29,Forward,Sweden,Europe
1028,Josuha Guilavogui,FRA,Wolfsburg,Bundesliga,2019,28.0,1990.0,22.9,41,26,17,23,1,10,30,33.3,20,35,9,26,45,86,64,2,"MF,DF",25-29,Midfielder,France,Europe
1031,Bruno Guimarães,BRA,Lyon,Ligue 1,2019,21.0,1997.0,3.0,12,7,5,6,1,5,10,50.0,5,1,0,1,4,16,1,0,MF,20-24,Midfielder,Brazil,South America
1032,Serhou Guirassy,GUI,Amiens,Ligue 1,2019,23.0,1996.0,21.3,7,3,1,4,2,2,7,28.6,5,13,6,7,4,11,21,0,FW,20-24,Forward,Guinea,Africa
1034,Péter Gulácsi,HUN,RB Leipzig,Bundesliga,2019,29.0,1990.0,32.0,0,0,0,0,0,0,0,,0,0,0,0,1,1,18,6,GK,25-29,Goalkeeper,Hungary,Europe
1035,Manuel Gulde,GER,Freiburg,Bundesliga,2019,28.0,1991.0,15.2,28,16,17,9,2,15,24,62.5,9,23,13,10,22,50,80,1,DF,25-29,Defender,Germany,Europe
1037,İlkay Gündoğan,GER,Manchester City,Premier League,2019,28.0,1990.0,22.4,27,16,9,11,7,9,41,22.0,32,17,5,12,31,58,13,0,MF,25-29,Midfielder,Germany,Europe
1038,Angus Gunn,SCO,Southampton,Premier League,2019,23.0,1996.0,10.0,1,1,1,0,0,1,3,33.3,2,0,0,0,0,1,1,0,GK,20-24,Goalkeeper,Scotland,Europe
1039,Christian Günter,GER,Freiburg,Bundesliga,2019,26.0,1993.0,33.7,25,11,17,7,1,12,35,34.3,23,29,13,16,14,39,40,0,DF,25-29,Defender,Germany,Europe
1041,Régis Gurtner,FRA,Amiens,Ligue 1,2019,32.0,1986.0,28.0,1,1,1,0,0,1,2,50.0,1,0,0,0,0,1,10,4,GK,30-34,Goalkeeper,France,Europe
1045,Janik Haberer,GER,Freiburg,Bundesliga,2019,25.0,1994.0,19.1,26,18,8,14,4,12,45,26.7,33,25,4,21,25,51,23,0,"MF,FW",25-29,Midfielder,Germany,Europe
1046,Alexander Hack,GER,Mainz 05,Bundesliga,2019,25.0,1993.0,8.9,26,10,19,6,1,16,27,59.3,11,20,9,11,23,49,60,1,DF,25-29,Defender,Germany,Europe
1047,Munir El Haddadi,MAR,Sevilla,La Liga,2019,23.0,1995.0,13.9,19,17,6,11,2,4,21,19.0,17,8,0,8,7,26,8,0,FW,20-24,Forward,Morocco,Africa
1048,André Hahn,GER,Augsburg,Bundesliga,2019,28.0,1990.0,7.8,15,9,7,5,3,5,21,23.8,16,23,5,18,13,28,14,0,"FW,MF",25-29,Forward,Germany,Europe
1049,Amadou Haidara,MLI,RB Leipzig,Bundesliga,2019,21.0,1998.0,8.4,26,16,7,17,2,10,24,41.7,14,14,2,12,8,34,10,1,MF,20-24,Midfielder,Mali,Africa
1050,Achraf Hakimi,MAR,Dortmund,Bundesliga,2019,20.0,1998.0,30.2,60,41,38,14,8,27,64,42.2,37,26,2,24,30,90,27,2,"DF,MF",20-24,Defender,Morocco,Africa
1052,Marcel Halstenberg,GER,RB Leipzig,Bundesliga,2019,27.0,1991.0,28.0,46,31,27,17,2,28,58,48.3,30,37,11,26,46,92,72,2,DF,25-29,Defender,Germany,Europe
1053,Romain Hamouma,FRA,Saint-Étienne,Ligue 1,2019,32.0,1987.0,9.6,12,9,1,5,6,2,12,16.7,10,12,0,12,0,12,4,0,"FW,MF",30-34,Forward,France,Europe
1055,Grant Hanley,SCO,Norwich City,Premier League,2019,27.0,1991.0,14.0,24,15,17,7,0,8,14,57.1,6,25,18,7,31,55,77,1,DF,25-29,Defender,Scotland,Europe
1057,Amine Harit,MAR,Schalke 04,Bundesliga,2019,22.0,1997.0,23.4,16,7,8,5,3,6,25,24.0,19,13,0,13,7,23,2,1,"MF,FW",20-24,Midfielder,Morocco,Africa
1058,Martin Harnik,AUT,Werder Bremen,Bundesliga,2019,32.0,1987.0,0.1,0,0,0,0,0,0,0,,0,0,0,0,0,0,0,0,"MF,FW",30-34,Midfielder,Austria,Europe
1059,Makoto Hasebe,JPN,Eint Frankfurt,Bundesliga,2019,35.0,1984.0,21.9,28,20,16,9,3,18,39,46.2,21,38,10,28,26,54,38,0,"DF,MF",35-39,Defender,Japan,Asia
1060,Hans Hateboer,NED,Atalanta,Serie A,2019,25.0,1994.0,26.2,36,23,20,9,7,18,38,47.4,20,22,7,15,10,46,32,1,DF,25-29,Defender,Netherlands,Europe
1061,Kortney Hause,ENG,Aston Villa,Premier League,2019,24.0,1995.0,17.2,21,9,15,5,1,8,15,53.3,7,27,19,8,20,41,98,4,DF,20-24,Defender,England,Europe
1062,Kai Havertz,GER,Leverkusen,Bundesliga,2019,20.0,1999.0,27.3,21,15,5,10,6,6,39,15.4,33,22,0,22,2,23,22,0,"MF,FW",20-24,Midfielder,Germany,Europe
1063,Isaac Hayden,ENG,Newcastle Utd,Premier League,2019,24.0,1995.0,24.7,55,27,33,17,5,20,50,40.0,30,24,7,17,38,93,38,0,MF,20-24,Midfielder,England,Europe
1064,Eden Hazard,BEL,Real Madrid,La Liga,2019,28.0,1991.0,12.0,7,3,2,3,2,3,15,20.0,12,5,0,5,6,13,0,0,"FW,MF",25-29,Forward,Belgium,Europe
1066,Tom Heaton,ENG,Aston Villa,Premier League,2019,33.0,1986.0,19.9,3,2,3,0,0,3,4,75.0,1,0,0,0,0,3,6,0,GK,30-34,Goalkeeper,England,Europe
1067,Jonas Hector,GER,Köln,Bundesliga,2019,29.0,1990.0,27.0,76,49,37,34,5,24,75,32.0,51,44,10,34,46,122,38,1,"MF,DF",25-29,Midfielder,Germany,Europe
1068,Dominique Heintz,GER,Freiburg,Bundesliga,2019,25.0,1993.0,27.0,47,30,40,6,1,17,43,39.5,26,38,25,13,41,88,131,1,DF,25-29,Defender,Germany,Europe
1069,Dean Henderson,ENG,Sheffield Utd,Premier League,2019,22.0,1997.0,36.0,0,0,0,0,0,0,0,,0,0,0,0,1,1,13,1,GK,20-24,Goalkeeper,England,Europe
1071,Liam Henderson,SCO,Hellas Verona,Serie A,2019,23.0,1996.0,2.2,3,2,0,3,0,2,3,66.7,1,1,0,1,0,3,4,0,MF,20-24,Midfielder,Scotland,Europe
1072,Jeff Hendrick,IRL,Burnley,Premier League,2019,27.0,1992.0,21.5,18,10,7,8,3,7,27,25.9,20,21,8,13,20,38,20,0,MF,25-29,Midfielder,Republic of Ireland,Europe
1073,Wayne Hennessey,WAL,Crystal Palace,Premier League,2019,32.0,1987.0,3.0,0,0,0,0,0,0,0,,0,0,0,0,1,1,3,1,GK,30-34,Goalkeeper,Wales,Europe
1074,Rouwen Hennings,GER,Düsseldorf,Bundesliga,2019,31.0,1987.0,27.3,11,5,2,7,2,3,18,16.7,15,12,0,12,2,13,33,0,FW,30-34,Forward,Germany,Europe
1075,Benjamin Henrichs,GER,Monaco,Ligue 1,2019,22.0,1997.0,9.9,26,20,16,9,1,14,33,42.4,19,19,4,15,14,40,18,0,"DF,MF",20-24,Defender,Germany,Europe
1083,Lucas Hernández,FRA,Bayern Munich,Bundesliga,2019,23.0,1996.0,10.2,18,9,13,3,2,9,15,60.0,6,6,1,5,15,33,17,0,DF,20-24,Defender,France,Europe
1085,Theo Hernández,FRA,Milan,Serie A,2019,21.0,1997.0,31.3,56,39,32,18,6,33,53,62.3,20,34,6,28,43,99,62,2,DF,20-24,Defender,France,Europe
1086,Hernani,BRA,Parma,Serie A,2019,25.0,1994.0,26.9,61,31,25,31,5,30,112,26.8,82,53,11,42,50,111,51,1,MF,25-29,Midfielder,Brazil,South America
1088,Héctor Herrera,MEX,Atlético Madrid,La Liga,2019,29.0,1990.0,12.5,31,21,9,18,4,13,32,40.6,19,16,7,9,17,48,13,2,MF,25-29,Midfielder,Mexico,North America
1090,Yangel Herrera,VEN,Granada,La Liga,2019,21.0,1998.0,26.3,88,49,25,53,10,36,80,45.0,44,38,9,29,34,122,28,0,MF,20-24,Midfielder,Venezuela,South America
1092,Patrick Herrmann,GER,Gladbach,Bundesliga,2019,28.0,1991.0,16.1,24,11,8,10,6,5,16,31.3,11,21,4,17,11,35,8,0,"FW,MF",25-29,Forward,Germany,Europe
1095,Gonzalo Higuaín,ARG,Juventus,Serie A,2019,31.0,1987.0,20.7,13,7,2,6,5,4,31,12.9,27,12,0,12,6,19,14,0,FW,30-34,Forward,Argentina,South America
1097,Martin Hinteregger,AUT,Eint Frankfurt,Bundesliga,2019,26.0,1992.0,30.2,66,51,33,30,3,28,57,49.1,29,41,21,20,36,102,96,0,DF,25-29,Defender,Austria,Europe
1098,George Hirst,ENG,Leicester City,Premier League,2019,20.0,1999.0,0.1,0,0,0,0,0,0,0,,0,0,0,0,0,0,0,0,"MF,DF",20-24,Midfielder,England,Europe
1099,Marwin Hitz,SUI,Dortmund,Bundesliga,2019,31.0,1987.0,3.2,0,0,0,0,0,0,0,,0,0,0,0,0,0,0,0,GK,30-34,Goalkeeper,Switzerland,Europe
1101,Nicolas Höfler,GER,Freiburg,Bundesliga,2019,29.0,1990.0,30.9,65,40,31,28,6,22,64,34.4,42,58,18,40,71,136,59,3,MF,25-29,Midfielder,Germany,Europe
1102,Jonas Hofmann,GER,Gladbach,Bundesliga,2019,27.0,1992.0,18.1,43,27,22,12,9,22,76,28.9,54,28,3,25,18,61,14,0,"MF,FW",25-29,Midfielder,Germany,Europe
1102,Jonas Hofmann,GER,Gladbach,Bundesliga,2019,27.0,1992.0,18.1,43,27,22,12,9,22,76,28.9,54,28,3,25,18,61,14,0,"MF,FW",25-29,Midfielder,Germany,Europe
1102,Jonas Hofmann,GER,Gladbach,Bundesliga,2019,27.0,1992.0,18.1,43,27,22,12,9,22,76,28.9,54,28,3,25,18,61,14,0,"MF,FW",25-29,Midfielder,Germany,Europe
1102,Jonas Hofmann,GER,Gladbach,Bundesliga,2019,27.0,1992.0,18.1,43,27,22,12,9,22,76,28.9,54,28,3,25,18,61,14,0,"MF,FW",25-29,Midfielder,Germany,Europe
1103,Jonas Hofmann,GER,Schalke 04,Bundesliga,2019,22.0,1997.0,0.0,0,0,0,0,0,0,0,,0,0,0,0,0,0,2,0,MF,20-24,Midfielder,Germany,Europe
1103,Jonas Hofmann,GER,Schalke 04,Bundesliga,2019,22.0,1997.0,0.0,0,0,0,0,0,0,0,,0,0,0,0,0,0,2,0,MF,20-24,Midfielder,Germany,Europe
1103,Jonas Hofmann,GER,Schalke 04,Bundesliga,2019,22.0,1997.0,0.0,0,0,0,0,0,0,0,,0,0,0,0,0,0,2,0,MF,20-24,Midfielder,Germany,Europe
1103,Jonas Hofmann,GER,Schalke 04,Bundesliga,2019,22.0,1997.0,0.0,0,0,0,0,0,0,0,,0,0,0,0,0,0,2,0,MF,20-24,Midfielder,Germany,Europe
1104,Marco Höger,GER,Köln,Bundesliga,2019,29.0,1989.0,7.5,10,6,4,5,1,6,16,37.5,10,14,4,10,6,16,15,0,MF,25-29,Midfielder,Germany,Europe
1105,Rob Holding,ENG,Arsenal,Premier League,2019,23.0,1995.0,6.5,4,2,3,1,0,1,3,33.3,2,10,6,4,5,9,45,1,DF,20-24,Defender,England,Europe
1107,Lucas Höler,GER,Freiburg,Bundesliga,2019,25.0,1994.0,27.6,35,15,11,16,8,11,46,23.9,35,30,9,21,12,47,38,0,"FW,MF",25-29,Forward,Germany,Europe
1108,Mason Holgate,ENG,Everton,Premier League,2019,22.0,1996.0,22.8,44,26,30,13,1,21,31,67.7,10,26,13,13,34,78,97,0,DF,20-24,Defender,England,Europe
1110,Gerrit Holtmann,PHI,Paderborn 07,Bundesliga,2019,24.0,1995.0,11.8,24,14,14,6,4,15,37,40.5,22,21,1,20,6,30,8,0,"MF,DF",20-24,Midfielder,Philippines,Asia
1112,Franck Honorat,FRA,Saint-Étienne,Ligue 1,2019,22.0,1996.0,9.4,16,11,7,8,1,8,23,34.8,15,12,1,11,5,21,13,1,"FW,DF",20-24,Forward,France,Europe
1113,Luca Horn,GER,Wolfsburg,Bundesliga,2019,20.0,1998.0,0.1,0,0,0,0,0,0,0,,0,0,0,0,0,0,0,0,DF,20-24,Defender,Germany,Europe
1114,Timo Horn,GER,Köln,Bundesliga,2019,26.0,1993.0,34.0,0,0,0,0,0,0,5,0.0,5,0,0,0,2,2,15,1,GK,25-29,Goalkeeper,Germany,Europe
1115,Krisztofer Horváth,HUN,SPAL,Serie A,2019,17.0,2002.0,0.5,1,1,0,1,0,0,0,,0,0,0,0,0,1,0,0,"FW,DF",Under 20,Forward,Hungary,Europe
1116,Conor Hourihane,IRL,Aston Villa,Premier League,2019,28.0,1991.0,17.0,16,10,4,8,4,10,25,40.0,15,19,4,15,9,25,31,0,MF,25-29,Midfielder,Republic of Ireland,Europe
1118,Benjamin Hübner,GER,Hoffenheim,Bundesliga,2019,30.0,1989.0,23.0,42,26,33,9,0,23,45,51.1,22,18,13,5,30,72,98,2,DF,30-34,Defender,Germany,Europe
1119,Florian Hübner,GER,Union Berlin,Bundesliga,2019,28.0,1991.0,9.4,16,14,12,4,0,7,17,41.2,10,11,7,4,16,32,39,0,DF,25-29,Defender,Germany,Europe
1120,Callum Hudson-Odoi,ENG,Chelsea,Premier League,2019,18.0,2000.0,9.6,10,4,4,5,1,1,7,14.3,6,9,0,9,5,15,4,1,"FW,MF",Under 20,Forward,England,Europe
1121,Will Hughes,ENG,Watford,Premier League,2019,24.0,1995.0,25.0,75,47,24,41,10,25,67,37.3,42,48,8,40,37,112,28,0,MF,20-24,Midfielder,England,Europe
1122,Mats Hummels,GER,Dortmund,Bundesliga,2019,30.0,1988.0,28.7,57,30,30,26,1,20,38,52.6,18,41,18,23,59,116,110,1,DF,30-34,Defender,Germany,Europe
1123,Uwe Hünemeier,GER,Paderborn 07,Bundesliga,2019,33.0,1986.0,13.4,20,15,9,11,0,10,20,50.0,10,22,12,10,24,44,63,0,DF,30-34,Defender,Germany,Europe
1124,Adrien Hunou,FRA,Rennes,Ligue 1,2019,25.0,1994.0,13.4,21,18,5,11,5,4,21,19.0,17,16,1,15,5,26,5,0,"FW,MF",25-29,Forward,France,Europe
1125,Jannik Huth,GER,Paderborn 07,Bundesliga,2019,25.0,1994.0,6.0,0,0,0,0,0,0,1,0.0,1,0,0,0,0,0,2,0,GK,25-29,Goalkeeper,Germany,Europe
1126,Elseid Hysaj,ALB,Napoli,Serie A,2019,25.0,1994.0,16.5,18,9,13,4,1,12,26,46.2,14,16,3,13,24,42,26,0,DF,25-29,Defender,Albania,Europe
1129,Simone Iacoponi,ITA,Parma,Serie A,2019,32.0,1987.0,33.9,49,25,36,12,1,26,42,61.9,16,37,29,8,35,84,140,2,DF,30-34,Defender,Italy,Europe
1130,Iago,BRA,Augsburg,Bundesliga,2019,22.0,1997.0,7.5,19,12,12,7,0,9,18,50.0,9,6,2,4,14,33,27,0,"DF,MF",20-24,Defender,Brazil,South America
1133,Jordon Ibe,ENG,Bournemouth,Premier League,2019,23.0,1995.0,0.6,2,2,2,0,0,1,1,100.0,0,0,0,0,0,2,1,0,DF,20-24,Defender,England,Europe
1137,Zlatan Ibrahimović,SWE,Milan,Serie A,2019,37.0,1981.0,15.1,5,1,0,2,3,1,13,7.7,12,4,3,1,5,10,21,0,FW,35-39,Forward,Sweden,Europe
1140,Odion Ighalo,NGA,Manchester Utd,Premier League,2019,30.0,1989.0,1.1,2,2,0,2,0,1,3,33.3,2,1,1,0,0,2,0,0,FW,30-34,Forward,Nigeria,Africa
1142,Igor,BRA,SPAL,Serie A,2019,21.0,1998.0,14.9,24,16,13,10,1,14,20,70.0,6,17,9,8,24,48,37,1,DF,20-24,Defender,Brazil,South America
1142,Igor,BRA,SPAL,Serie A,2019,21.0,1998.0,14.9,24,16,13,10,1,14,20,70.0,6,17,9,8,24,48,37,1,DF,20-24,Defender,Brazil,South America
1142,Igor,BRA,SPAL,Serie A,2019,21.0,1998.0,14.9,24,16,13,10,1,14,20,70.0,6,17,9,8,24,48,37,1,DF,20-24,Defender,Brazil,South America
1142,Igor,BRA,SPAL,Serie A,2019,21.0,1998.0,14.9,24,16,13,10,1,14,20,70.0,6,17,9,8,24,48,37,1,DF,20-24,Defender,Brazil,South America
1143,Igor,BRA,Fiorentina,Serie A,2019,21.0,1998.0,6.8,12,10,8,2,2,6,7,85.7,1,10,4,6,7,19,16,0,DF,20-24,Defender,Brazil,South America
1143,Igor,BRA,Fiorentina,Serie A,2019,21.0,1998.0,6.8,12,10,8,2,2,6,7,85.7,1,10,4,6,7,19,16,0,DF,20-24,Defender,Brazil,South America
1143,Igor,BRA,Fiorentina,Serie A,2019,21.0,1998.0,6.8,12,10,8,2,2,6,7,85.7,1,10,4,6,7,19,16,0,DF,20-24,Defender,Brazil,South America
1143,Igor,BRA,Fiorentina,Serie A,2019,21.0,1998.0,6.8,12,10,8,2,2,6,7,85.7,1,10,4,6,7,19,16,0,DF,20-24,Defender,Brazil,South America
1144,Kelechi Iheanacho,NGA,Leicester City,Premier League,2019,22.0,1996.0,10.7,3,1,1,2,0,1,9,11.1,8,8,1,7,3,6,8,0,FW,20-24,Forward,Nigeria,Africa
1145,Luc Ihorst,GER,Werder Bremen,Bundesliga,2019,19.0,2000.0,0.1,1,1,0,0,1,0,0,,0,1,0,1,0,1,0,0,FW,Under 20,Forward,Germany,Europe
1150,Stefan Ilsanker,AUT,RB Leipzig,Bundesliga,2019,30.0,1989.0,4.6,3,1,3,0,0,3,6,50.0,3,6,3,3,7,10,21,0,DF,30-34,Defender,Austria,Europe
1151,Stefan Ilsanker,AUT,Eint Frankfurt,Bundesliga,2019,30.0,1989.0,9.3,23,15,16,7,0,10,23,43.5,13,8,1,7,19,42,26,0,"DF,MF",30-34,Defender,Austria,Europe
1154,Roberto Inglese,ITA,Parma,Serie A,2019,27.0,1991.0,8.5,9,6,2,2,5,2,10,20.0,8,8,2,6,2,11,1,0,FW,25-29,Forward,Italy,Europe
1155,Danny Ings,ENG,Southampton,Premier League,2019,27.0,1992.0,31.2,42,25,16,16,10,13,67,19.4,54,62,4,58,9,51,30,1,FW,25-29,Forward,England,Europe
1157,Lorenzo Insigne,ITA,Napoli,Serie A,2019,28.0,1991.0,31.2,21,15,6,8,7,6,35,17.1,29,13,0,13,30,51,4,1,"FW,MF",25-29,Forward,Italy,Europe
1158,Takashi Inui,JPN,Eibar,La Liga,2019,31.0,1988.0,21.8,20,10,7,8,5,11,34,32.4,23,23,4,19,18,38,12,0,"MF,FW",30-34,Midfielder,Japan,Asia
1160,Alexander Isak,SWE,Real Sociedad,La Liga,2019,19.0,1999.0,16.7,7,2,0,3,4,1,8,12.5,7,8,0,8,3,10,6,0,FW,Under 20,Forward,Sweden,Europe
1167,Alex Iwobi,NGA,Everton,Premier League,2019,23.0,1996.0,17.7,25,17,8,15,2,12,33,36.4,21,18,2,16,14,39,10,1,"MF,FW",20-24,Midfielder,Nigeria,Africa
1168,Armando Izzo,ITA,Torino,Serie A,2019,27.0,1992.0,29.8,42,24,24,14,4,17,35,48.6,18,44,29,15,71,113,121,1,DF,25-29,Defender,Italy,Europe
1170,Phil Jagielka,ENG,Sheffield Utd,Premier League,2019,36.0,1982.0,2.7,5,4,3,2,0,1,3,33.3,2,5,5,0,4,9,19,0,DF,35-39,Defender,England,Europe
1173,Mato Jajalo,BIH,Udinese,Serie A,2019,31.0,1988.0,18.3,44,19,19,22,3,14,38,36.8,24,20,7,13,19,63,19,2,MF,30-34,Midfielder,Bosnia and Herzegovina,Europe
1175,Christophe Jallet,FRA,Amiens,Ligue 1,2019,35.0,1983.0,9.5,24,16,14,8,2,14,37,37.8,23,8,2,6,18,42,29,0,DF,35-39,Defender,France,Europe
1176,Daniel James,WAL,Manchester Utd,Premier League,2019,21.0,1997.0,25.4,20,10,5,10,5,7,45,15.6,38,23,4,19,7,27,12,0,FW,20-24,Forward,Wales,Europe
1177,Matty James,ENG,Leicester City,Premier League,2019,28.0,1991.0,0.1,0,0,0,0,0,0,0,,0,0,0,0,0,0,0,0,MF,25-29,Midfielder,England,Europe
1178,Reece James,ENG,Chelsea,Premier League,2019,19.0,1999.0,16.8,36,23,18,14,4,11,29,37.9,18,19,8,11,22,58,28,0,DF,Under 20,Defender,England,Europe
1178,Reece James,ENG,Chelsea,Premier League,2019,19.0,1999.0,16.8,36,23,18,14,4,11,29,37.9,18,19,8,11,22,58,28,0,DF,Under 20,Defender,England,Europe
1178,Reece James,ENG,Chelsea,Premier League,2019,19.0,1999.0,16.8,36,23,18,14,4,11,29,37.9,18,19,8,11,22,58,28,0,DF,Under 20,Defender,England,Europe
1178,Reece James,ENG,Chelsea,Premier League,2019,19.0,1999.0,16.8,36,23,18,14,4,11,29,37.9,18,19,8,11,22,58,28,0,DF,Under 20,Defender,England,Europe
1183,Tony Jantschke,GER,Gladbach,Bundesliga,2019,29.0,1990.0,11.2,33,21,23,10,0,15,24,62.5,9,20,11,9,27,60,48,0,DF,25-29,Defender,Germany,Europe
1184,Adnan Januzaj,BEL,Real Sociedad,La Liga,2019,24.0,1995.0,13.0,8,7,3,2,3,3,16,18.8,13,9,1,8,7,15,2,0,"FW,MF",20-24,Forward,Belgium,Europe
1188,Corentin Jean,FRA,Toulouse,Ligue 1,2019,24.0,1995.0,0.1,0,0,0,0,0,0,0,,0,0,0,0,0,0,1,0,DF,20-24,Defender,France,Europe
1189,Benjamin Jeannot,FRA,Dijon,Ligue 1,2019,27.0,1992.0,1.9,2,1,0,1,1,0,4,0.0,4,2,0,2,2,4,4,0,"MF,FW",25-29,Midfielder,France,Europe
1191,Jemerson,BRA,Monaco,Ligue 1,2019,26.0,1992.0,11.7,28,17,13,14,1,10,21,47.6,11,8,3,5,16,44,24,0,"DF,MF",25-29,Defender,Brazil,South America
1192,Fredrik Jensen,FIN,Augsburg,Bundesliga,2019,21.0,1997.0,5.1,3,1,2,1,0,2,7,28.6,5,7,1,6,1,4,3,0,"MF,FW",20-24,Midfielder,Finland,Europe
1194,Gabriel Jesus,BRA,Manchester City,Premier League,2019,22.0,1997.0,22.6,17,10,4,5,8,7,25,28.0,18,26,1,25,11,28,6,0,FW,20-24,Forward,Brazil,South America
1195,Juan Jesus,BRA,Roma,Serie A,2019,28.0,1991.0,1.5,2,1,2,0,0,0,3,0.0,3,1,0,1,1,3,7,0,DF,25-29,Defender,Brazil,South America
1196,Raúl Jiménez,MEX,Wolves,Premier League,2019,28.0,1991.0,36.0,20,12,6,10,4,3,31,9.7,28,26,0,26,16,36,34,1,FW,25-29,Forward,Mexico,North America
1197,João Pedro,BRA,Watford,Premier League,2019,17.0,2001.0,0.3,0,0,0,0,0,0,0,,0,0,0,0,0,0,0,0,"FW,MF",Under 20,Forward,Brazil,South America
1197,João Pedro,BRA,Watford,Premier League,2019,17.0,2001.0,0.3,0,0,0,0,0,0,0,,0,0,0,0,0,0,0,0,"FW,MF",Under 20,Forward,Brazil,South America
1197,João Pedro,BRA,Watford,Premier League,2019,17.0,2001.0,0.3,0,0,0,0,0,0,0,,0,0,0,0,0,0,0,0,"FW,MF",Under 20,Forward,Brazil,South America
1197,João Pedro,BRA,Watford,Premier League,2019,17.0,2001.0,0.3,0,0,0,0,0,0,0,,0,0,0,0,0,0,0,0,"FW,MF",Under 20,Forward,Brazil,South America
1197,João Pedro,BRA,Watford,Premier League,2019,17.0,2001.0,0.3,0,0,0,0,0,0,0,,0,0,0,0,0,0,0,0,"FW,MF",Under 20,Forward,Brazil,South America
1197,João Pedro,BRA,Watford,Premier League,2019,17.0,2001.0,0.3,0,0,0,0,0,0,0,,0,0,0,0,0,0,0,0,"FW,MF",Under 20,Forward,Brazil,South America
1197,João Pedro,BRA,Watford,Premier League,2019,17.0,2001.0,0.3,0,0,0,0,0,0,0,,0,0,0,0,0,0,0,0,"FW,MF",Under 20,Forward,Brazil,South America
1197,João Pedro,BRA,Watford,Premier League,2019,17.0,2001.0,0.3,0,0,0,0,0,0,0,,0,0,0,0,0,0,0,0,"FW,MF",Under 20,Forward,Brazil,South America
1197,João Pedro,BRA,Watford,Premier League,2019,17.0,2001.0,0.3,0,0,0,0,0,0,0,,0,0,0,0,0,0,0,0,"FW,MF",Under 20,Forward,Brazil,South America
1197,João Pedro,BRA,Watford,Premier League,2019,17.0,2001.0,0.3,0,0,0,0,0,0,0,,0,0,0,0,0,0,0,0,"FW,MF",Under 20,Forward,Brazil,South America
1197,João Pedro,BRA,Watford,Premier League,2019,17.0,2001.0,0.3,0,0,0,0,0,0,0,,0,0,0,0,0,0,0,0,"FW,MF",Under 20,Forward,Brazil,South America
1197,João Pedro,BRA,Watford,Premier League,2019,17.0,2001.0,0.3,0,0,0,0,0,0,0,,0,0,0,0,0,0,0,0,"FW,MF",Under 20,Forward,Brazil,South America
1197,João Pedro,BRA,Watford,Premier League,2019,17.0,2001.0,0.3,0,0,0,0,0,0,0,,0,0,0,0,0,0,0,0,"FW,MF",Under 20,Forward,Brazil,South America
1197,João Pedro,BRA,Watford,Premier League,2019,17.0,2001.0,0.3,0,0,0,0,0,0,0,,0,0,0,0,0,0,0,0,"FW,MF",Under 20,Forward,Brazil,South America
1197,João Pedro,BRA,Watford,Premier League,2019,17.0,2001.0,0.3,0,0,0,0,0,0,0,,0,0,0,0,0,0,0,0,"FW,MF",Under 20,Forward,Brazil,South America
1197,João Pedro,BRA,Watford,Premier League,2019,17.0,2001.0,0.3,0,0,0,0,0,0,0,,0,0,0,0,0,0,0,0,"FW,MF",Under 20,Forward,Brazil,South America
1197,João Pedro,BRA,Watford,Premier League,2019,17.0,2001.0,0.3,0,0,0,0,0,0,0,,0,0,0,0,0,0,0,0,"FW,MF",Under 20,Forward,Brazil,South America
1197,João Pedro,BRA,Watford,Premier League,2019,17.0,2001.0,0.3,0,0,0,0,0,0,0,,0,0,0,0,0,0,0,0,"FW,MF",Under 20,Forward,Brazil,South America
1197,João Pedro,BRA,Watford,Premier League,2019,17.0,2001.0,0.3,0,0,0,0,0,0,0,,0,0,0,0,0,0,0,0,"FW,MF",Under 20,Forward,Brazil,South America
1197,João Pedro,BRA,Watford,Premier League,2019,17.0,2001.0,0.3,0,0,0,0,0,0,0,,0,0,0,0,0,0,0,0,"FW,MF",Under 20,Forward,Brazil,South America
1197,João Pedro,BRA,Watford,Premier League,2019,17.0,2001.0,0.3,0,0,0,0,0,0,0,,0,0,0,0,0,0,0,0,"FW,MF",Under 20,Forward,Brazil,South America
1197,João Pedro,BRA,Watford,Premier League,2019,17.0,2001.0,0.3,0,0,0,0,0,0,0,,0,0,0,0,0,0,0,0,"FW,MF",Under 20,Forward,Brazil,South America
1197,João Pedro,BRA,Watford,Premier League,2019,17.0,2001.0,0.3,0,0,0,0,0,0,0,,0,0,0,0,0,0,0,0,"FW,MF",Under 20,Forward,Brazil,South America
1197,João Pedro,BRA,Watford,Premier League,2019,17.0,2001.0,0.3,0,0,0,0,0,0,0,,0,0,0,0,0,0,0,0,"FW,MF",Under 20,Forward,Brazil,South America
1197,João Pedro,BRA,Watford,Premier League,2019,17.0,2001.0,0.3,0,0,0,0,0,0,0,,0,0,0,0,0,0,0,0,"FW,MF",Under 20,Forward,Brazil,South America
1197,João Pedro,BRA,Watford,Premier League,2019,17.0,2001.0,0.3,0,0,0,0,0,0,0,,0,0,0,0,0,0,0,0,"FW,MF",Under 20,Forward,Brazil,South America
1197,João Pedro,BRA,Watford,Premier League,2019,17.0,2001.0,0.3,0,0,0,0,0,0,0,,0,0,0,0,0,0,0,0,"FW,MF",Under 20,Forward,Brazil,South America
1197,João Pedro,BRA,Watford,Premier League,2019,17.0,2001.0,0.3,0,0,0,0,0,0,0,,0,0,0,0,0,0,0,0,"FW,MF",Under 20,Forward,Brazil,South America
1197,João Pedro,BRA,Watford,Premier League,2019,17.0,2001.0,0.3,0,0,0,0,0,0,0,,0,0,0,0,0,0,0,0,"FW,MF",Under 20,Forward,Brazil,South America
1197,João Pedro,BRA,Watford,Premier League,2019,17.0,2001.0,0.3,0,0,0,0,0,0,0,,0,0,0,0,0,0,0,0,"FW,MF",Under 20,Forward,Brazil,South America
1197,João Pedro,BRA,Watford,Premier League,2019,17.0,2001.0,0.3,0,0,0,0,0,0,0,,0,0,0,0,0,0,0,0,"FW,MF",Under 20,Forward,Brazil,South America
1197,João Pedro,BRA,Watford,Premier League,2019,17.0,2001.0,0.3,0,0,0,0,0,0,0,,0,0,0,0,0,0,0,0,"FW,MF",Under 20,Forward,Brazil,South America
1197,João Pedro,BRA,Watford,Premier League,2019,17.0,2001.0,0.3,0,0,0,0,0,0,0,,0,0,0,0,0,0,0,0,"FW,MF",Under 20,Forward,Brazil,South America
1197,João Pedro,BRA,Watford,Premier League,2019,17.0,2001.0,0.3,0,0,0,0,0,0,0,,0,0,0,0,0,0,0,0,"FW,MF",Under 20,Forward,Brazil,South America
1197,João Pedro,BRA,Watford,Premier League,2019,17.0,2001.0,0.3,0,0,0,0,0,0,0,,0,0,0,0,0,0,0,0,"FW,MF",Under 20,Forward,Brazil,South America
1197,João Pedro,BRA,Watford,Premier League,2019,17.0,2001.0,0.3,0,0,0,0,0,0,0,,0,0,0,0,0,0,0,0,"FW,MF",Under 20,Forward,Brazil,South America
1197,João Pedro,BRA,Watford,Premier League,2019,17.0,2001.0,0.3,0,0,0,0,0,0,0,,0,0,0,0,0,0,0,0,"FW,MF",Under 20,Forward,Brazil,South America
1197,João Pedro,BRA,Watford,Premier League,2019,17.0,2001.0,0.3,0,0,0,0,0,0,0,,0,0,0,0,0,0,0,0,"FW,MF",Under 20,Forward,Brazil,South America
1197,João Pedro,BRA,Watford,Premier League,2019,17.0,2001.0,0.3,0,0,0,0,0,0,0,,0,0,0,0,0,0,0,0,"FW,MF",Under 20,Forward,Brazil,South America
1197,João Pedro,BRA,Watford,Premier League,2019,17.0,2001.0,0.3,0,0,0,0,0,0,0,,0,0,0,0,0,0,0,0,"FW,MF",Under 20,Forward,Brazil,South America
1197,João Pedro,BRA,Watford,Premier League,2019,17.0,2001.0,0.3,0,0,0,0,0,0,0,,0,0,0,0,0,0,0,0,"FW,MF",Under 20,Forward,Brazil,South America
1197,João Pedro,BRA,Watford,Premier League,2019,17.0,2001.0,0.3,0,0,0,0,0,0,0,,0,0,0,0,0,0,0,0,"FW,MF",Under 20,Forward,Brazil,South America
1197,João Pedro,BRA,Watford,Premier League,2019,17.0,2001.0,0.3,0,0,0,0,0,0,0,,0,0,0,0,0,0,0,0,"FW,MF",Under 20,Forward,Brazil,South America
1197,João Pedro,BRA,Watford,Premier League,2019,17.0,2001.0,0.3,0,0,0,0,0,0,0,,0,0,0,0,0,0,0,0,"FW,MF",Under 20,Forward,Brazil,South America
1197,João Pedro,BRA,Watford,Premier League,2019,17.0,2001.0,0.3,0,0,0,0,0,0,0,,0,0,0,0,0,0,0,0,"FW,MF",Under 20,Forward,Brazil,South America
1197,João Pedro,BRA,Watford,Premier League,2019,17.0,2001.0,0.3,0,0,0,0,0,0,0,,0,0,0,0,0,0,0,0,"FW,MF",Under 20,Forward,Brazil,South America
1197,João Pedro,BRA,Watford,Premier League,2019,17.0,2001.0,0.3,0,0,0,0,0,0,0,,0,0,0,0,0,0,0,0,"FW,MF",Under 20,Forward,Brazil,South America
1197,João Pedro,BRA,Watford,Premier League,2019,17.0,2001.0,0.3,0,0,0,0,0,0,0,,0,0,0,0,0,0,0,0,"FW,MF",Under 20,Forward,Brazil,South America
1197,João Pedro,BRA,Watford,Premier League,2019,17.0,2001.0,0.3,0,0,0,0,0,0,0,,0,0,0,0,0,0,0,0,"FW,MF",Under 20,Forward,Brazil,South America
1197,João Pedro,BRA,Watford,Premier League,2019,17.0,2001.0,0.3,0,0,0,0,0,0,0,,0,0,0,0,0,0,0,0,"FW,MF",Under 20,Forward,Brazil,South America
1197,João Pedro,BRA,Watford,Premier League,2019,17.0,2001.0,0.3,0,0,0,0,0,0,0,,0,0,0,0,0,0,0,0,"FW,MF",Under 20,Forward,Brazil,South America
1197,João Pedro,BRA,Watford,Premier League,2019,17.0,2001.0,0.3,0,0,0,0,0,0,0,,0,0,0,0,0,0,0,0,"FW,MF",Under 20,Forward,Brazil,South America
1197,João Pedro,BRA,Watford,Premier League,2019,17.0,2001.0,0.3,0,0,0,0,0,0,0,,0,0,0,0,0,0,0,0,"FW,MF",Under 20,Forward,Brazil,South America
1197,João Pedro,BRA,Watford,Premier League,2019,17.0,2001.0,0.3,0,0,0,0,0,0,0,,0,0,0,0,0,0,0,0,"FW,MF",Under 20,Forward,Brazil,South America
1197,João Pedro,BRA,Watford,Premier League,2019,17.0,2001.0,0.3,0,0,0,0,0,0,0,,0,0,0,0,0,0,0,0,"FW,MF",Under 20,Forward,Brazil,South America
1197,João Pedro,BRA,Watford,Premier League,2019,17.0,2001.0,0.3,0,0,0,0,0,0,0,,0,0,0,0,0,0,0,0,"FW,MF",Under 20,Forward,Brazil,South America
1197,João Pedro,BRA,Watford,Premier League,2019,17.0,2001.0,0.3,0,0,0,0,0,0,0,,0,0,0,0,0,0,0,0,"FW,MF",Under 20,Forward,Brazil,South America
1197,João Pedro,BRA,Watford,Premier League,2019,17.0,2001.0,0.3,0,0,0,0,0,0,0,,0,0,0,0,0,0,0,0,"FW,MF",Under 20,Forward,Brazil,South America
1197,João Pedro,BRA,Watford,Premier League,2019,17.0,2001.0,0.3,0,0,0,0,0,0,0,,0,0,0,0,0,0,0,0,"FW,MF",Under 20,Forward,Brazil,South America
1197,João Pedro,BRA,Watford,Premier League,2019,17.0,2001.0,0.3,0,0,0,0,0,0,0,,0,0,0,0,0,0,0,0,"FW,MF",Under 20,Forward,Brazil,South America
1197,João Pedro,BRA,Watford,Premier League,2019,17.0,2001.0,0.3,0,0,0,0,0,0,0,,0,0,0,0,0,0,0,0,"FW,MF",Under 20,Forward,Brazil,South America
1197,João Pedro,BRA,Watford,Premier League,2019,17.0,2001.0,0.3,0,0,0,0,0,0,0,,0,0,0,0,0,0,0,0,"FW,MF",Under 20,Forward,Brazil,South America
1197,João Pedro,BRA,Watford,Premier League,2019,17.0,2001.0,0.3,0,0,0,0,0,0,0,,0,0,0,0,0,0,0,0,"FW,MF",Under 20,Forward,Brazil,South America
1197,João Pedro,BRA,Watford,Premier League,2019,17.0,2001.0,0.3,0,0,0,0,0,0,0,,0,0,0,0,0,0,0,0,"FW,MF",Under 20,Forward,Brazil,South America
1197,João Pedro,BRA,Watford,Premier League,2019,17.0,2001.0,0.3,0,0,0,0,0,0,0,,0,0,0,0,0,0,0,0,"FW,MF",Under 20,Forward,Brazil,South America
1197,João Pedro,BRA,Watford,Premier League,2019,17.0,2001.0,0.3,0,0,0,0,0,0,0,,0,0,0,0,0,0,0,0,"FW,MF",Under 20,Forward,Brazil,South America
1197,João Pedro,BRA,Watford,Premier League,2019,17.0,2001.0,0.3,0,0,0,0,0,0,0,,0,0,0,0,0,0,0,0,"FW,MF",Under 20,Forward,Brazil,South America
1197,João Pedro,BRA,Watford,Premier League,2019,17.0,2001.0,0.3,0,0,0,0,0,0,0,,0,0,0,0,0,0,0,0,"FW,MF",Under 20,Forward,Brazil,South America
1197,João Pedro,BRA,Watford,Premier League,2019,17.0,2001.0,0.3,0,0,0,0,0,0,0,,0,0,0,0,0,0,0,0,"FW,MF",Under 20,Forward,Brazil,South America
1197,João Pedro,BRA,Watford,Premier League,2019,17.0,2001.0,0.3,0,0,0,0,0,0,0,,0,0,0,0,0,0,0,0,"FW,MF",Under 20,Forward,Brazil,South America
1197,João Pedro,BRA,Watford,Premier League,2019,17.0,2001.0,0.3,0,0,0,0,0,0,0,,0,0,0,0,0,0,0,0,"FW,MF",Under 20,Forward,Brazil,South America
1197,João Pedro,BRA,Watford,Premier League,2019,17.0,2001.0,0.3,0,0,0,0,0,0,0,,0,0,0,0,0,0,0,0,"FW,MF",Under 20,Forward,Brazil,South America
1197,João Pedro,BRA,Watford,Premier League,2019,17.0,2001.0,0.3,0,0,0,0,0,0,0,,0,0,0,0,0,0,0,0,"FW,MF",Under 20,Forward,Brazil,South America
1197,João Pedro,BRA,Watford,Premier League,2019,17.0,2001.0,0.3,0,0,0,0,0,0,0,,0,0,0,0,0,0,0,0,"FW,MF",Under 20,Forward,Brazil,South America
1197,João Pedro,BRA,Watford,Premier League,2019,17.0,2001.0,0.3,0,0,0,0,0,0,0,,0,0,0,0,0,0,0,0,"FW,MF",Under 20,Forward,Brazil,South America
1197,João Pedro,BRA,Watford,Premier League,2019,17.0,2001.0,0.3,0,0,0,0,0,0,0,,0,0,0,0,0,0,0,0,"FW,MF",Under 20,Forward,Brazil,South America
1197,João Pedro,BRA,Watford,Premier League,2019,17.0,2001.0,0.3,0,0,0,0,0,0,0,,0,0,0,0,0,0,0,0,"FW,MF",Under 20,Forward,Brazil,South America
1197,João Pedro,BRA,Watford,Premier League,2019,17.0,2001.0,0.3,0,0,0,0,0,0,0,,0,0,0,0,0,0,0,0,"FW,MF",Under 20,Forward,Brazil,South America
1197,João Pedro,BRA,Watford,Premier League,2019,17.0,2001.0,0.3,0,0,0,0,0,0,0,,0,0,0,0,0,0,0,0,"FW,MF",Under 20,Forward,Brazil,South America
1197,João Pedro,BRA,Watford,Premier League,2019,17.0,2001.0,0.3,0,0,0,0,0,0,0,,0,0,0,0,0,0,0,0,"FW,MF",Under 20,Forward,Brazil,South America
1197,João Pedro,BRA,Watford,Premier League,2019,17.0,2001.0,0.3,0,0,0,0,0,0,0,,0,0,0,0,0,0,0,0,"FW,MF",Under 20,Forward,Brazil,South America
1199,Joelinton,BRA,Newcastle Utd,Premier League,2019,22.0,1996.0,29.8,34,20,7,22,5,9,32,28.1,23,32,6,26,11,45,30,0,FW,20-24,Forward,Brazil,South America
1201,Fabian Johnson,USA,Gladbach,Bundesliga,2019,31.0,1987.0,3.0,5,3,2,2,1,2,4,50.0,2,4,1,3,2,7,3,0,"MF,DF",30-34,Midfielder,United States,North America
1202,Curtis Jones,ENG,Liverpool,Premier League,2019,18.0,2001.0,1.4,4,4,0,1,3,3,4,75.0,1,2,0,2,2,6,1,0,MF,Under 20,Midfielder,England,Europe
1203,Phil Jones,ENG,Manchester Utd,Premier League,2019,27.0,1992.0,1.5,2,2,1,1,0,1,1,100.0,0,2,0,2,2,4,9,1,DF,25-29,Defender,England,Europe
1204,Frenkie de Jong,NED,Barcelona,La Liga,2019,22.0,1997.0,23.5,26,19,7,12,7,7,22,31.8,15,17,7,10,21,47,9,0,MF,20-24,Midfielder,Netherlands,Europe
1208,Bruno Jordão,POR,Wolves,Premier League,2019,20.0,1998.0,0.1,0,0,0,0,0,0,0,,0,1,0,1,0,0,0,0,FW,20-24,Forward,Portugal,Europe
1209,Jorginho,ITA,Chelsea,Premier League,2019,27.0,1991.0,26.4,66,40,24,34,8,35,91,38.5,56,30,5,25,64,130,27,2,MF,25-29,Midfielder,Italy,Europe
1209,Jorginho,ITA,Chelsea,Premier League,2019,27.0,1991.0,26.4,66,40,24,34,8,35,91,38.5,56,30,5,25,64,130,27,2,MF,25-29,Midfielder,Italy,Europe
1209,Jorginho,ITA,Chelsea,Premier League,2019,27.0,1991.0,26.4,66,40,24,34,8,35,91,38.5,56,30,5,25,64,130,27,2,MF,25-29,Midfielder,Italy,Europe
1209,Jorginho,ITA,Chelsea,Premier League,2019,27.0,1991.0,26.4,66,40,24,34,8,35,91,38.5,56,30,5,25,64,130,27,2,MF,25-29,Midfielder,Italy,Europe
1209,Jorginho,ITA,Chelsea,Premier League,2019,27.0,1991.0,26.4,66,40,24,34,8,35,91,38.5,56,30,5,25,64,130,27,2,MF,25-29,Midfielder,Italy,Europe
1209,Jorginho,ITA,Chelsea,Premier League,2019,27.0,1991.0,26.4,66,40,24,34,8,35,91,38.5,56,30,5,25,64,130,27,2,MF,25-29,Midfielder,Italy,Europe
1209,Jorginho,ITA,Chelsea,Premier League,2019,27.0,1991.0,26.4,66,40,24,34,8,35,91,38.5,56,30,5,25,64,130,27,2,MF,25-29,Midfielder,Italy,Europe
1209,Jorginho,ITA,Chelsea,Premier League,2019,27.0,1991.0,26.4,66,40,24,34,8,35,91,38.5,56,30,5,25,64,130,27,2,MF,25-29,Midfielder,Italy,Europe
1209,Jorginho,ITA,Chelsea,Premier League,2019,27.0,1991.0,26.4,66,40,24,34,8,35,91,38.5,56,30,5,25,64,130,27,2,MF,25-29,Midfielder,Italy,Europe
1209,Jorginho,ITA,Chelsea,Premier League,2019,27.0,1991.0,26.4,66,40,24,34,8,35,91,38.5,56,30,5,25,64,130,27,2,MF,25-29,Midfielder,Italy,Europe
1209,Jorginho,ITA,Chelsea,Premier League,2019,27.0,1991.0,26.4,66,40,24,34,8,35,91,38.5,56,30,5,25,64,130,27,2,MF,25-29,Midfielder,Italy,Europe
1209,Jorginho,ITA,Chelsea,Premier League,2019,27.0,1991.0,26.4,66,40,24,34,8,35,91,38.5,56,30,5,25,64,130,27,2,MF,25-29,Midfielder,Italy,Europe
1209,Jorginho,ITA,Chelsea,Premier League,2019,27.0,1991.0,26.4,66,40,24,34,8,35,91,38.5,56,30,5,25,64,130,27,2,MF,25-29,Midfielder,Italy,Europe
1209,Jorginho,ITA,Chelsea,Premier League,2019,27.0,1991.0,26.4,66,40,24,34,8,35,91,38.5,56,30,5,25,64,130,27,2,MF,25-29,Midfielder,Italy,Europe
1209,Jorginho,ITA,Chelsea,Premier League,2019,27.0,1991.0,26.4,66,40,24,34,8,35,91,38.5,56,30,5,25,64,130,27,2,MF,25-29,Midfielder,Italy,Europe
1209,Jorginho,ITA,Chelsea,Premier League,2019,27.0,1991.0,26.4,66,40,24,34,8,35,91,38.5,56,30,5,25,64,130,27,2,MF,25-29,Midfielder,Italy,Europe
1210,Jesse Joronen,FIN,Brescia,Serie A,2019,26.0,1993.0,29.0,3,1,3,0,0,3,3,100.0,0,0,0,0,6,9,22,0,GK,25-29,Goalkeeper,Finland,Europe
1211,Willian José,BRA,Real Sociedad,La Liga,2019,27.0,1991.0,22.3,5,2,0,4,1,2,8,25.0,6,10,4,6,1,6,16,0,FW,25-29,Forward,Brazil,South America
1214,Diogo Jota,POR,Wolves,Premier League,2019,22.0,1996.0,25.4,28,15,16,10,2,12,48,25.0,36,17,0,17,9,37,10,2,FW,20-24,Forward,Portugal,Europe
1224,James Justin,ENG,Leicester City,Premier League,2019,21.0,1998.0,11.2,36,17,22,14,0,15,25,60.0,10,15,7,8,11,47,30,0,"DF,MF",20-24,Defender,England,Europe
1227,Ozan Kabak,TUR,Schalke 04,Bundesliga,2019,19.0,2000.0,19.7,37,23,28,9,0,14,21,66.7,7,33,19,14,37,74,97,0,DF,Under 20,Defender,Turkey,Asia
1228,Christian Kabasele,BEL,Watford,Premier League,2019,28.0,1991.0,25.0,37,24,26,11,0,17,32,53.1,15,31,23,8,36,73,127,0,DF,25-29,Defender,Belgium,Europe
1229,Abdoul Kader Bamba,FRA,Nantes,Ligue 1,2019,25.0,1994.0,16.3,19,15,5,9,5,9,30,30.0,21,8,2,6,16,35,8,0,"FW,MF",25-29,Forward,France,Europe
1231,Florian Kainz,AUT,Köln,Bundesliga,2019,26.0,1992.0,17.3,21,13,12,6,3,15,33,45.5,18,26,2,24,13,34,11,0,"FW,MF",25-29,Forward,Austria,Europe
1232,Gaël Kakuta,COD,Amiens,Ligue 1,2019,28.0,1991.0,22.2,46,27,13,27,6,17,48,35.4,31,15,1,14,16,62,8,2,"MF,FW",25-29,Midfielder,DR Congo,Africa
1235,Salomon Kalou,CIV,Hertha BSC,Bundesliga,2019,33.0,1985.0,1.6,1,0,1,0,0,0,2,0.0,2,2,0,2,0,1,1,0,"FW,MF",30-34,Forward,Ivory Coast,Africa
1236,Samuel Kalu,NGA,Bordeaux,Ligue 1,2019,21.0,1997.0,15.1,33,17,19,12,2,16,36,44.4,20,13,1,12,24,57,10,0,"DF,FW",20-24,Defender,Nigeria,Africa
1237,Daichi Kamada,JPN,Eint Frankfurt,Bundesliga,2019,22.0,1996.0,21.9,29,20,7,17,5,8,42,19.0,34,16,1,15,10,39,6,0,"MF,FW",20-24,Midfielder,Japan,Asia
1239,Boubacar Kamara,FRA,Marseille,Ligue 1,2019,19.0,1999.0,23.8,67,34,37,27,3,27,57,47.4,30,27,14,13,34,101,53,1,"DF,MF",Under 20,Defender,France,Europe
1240,Hassane Kamara,CIV,Reims,Ligue 1,2019,25.0,1994.0,19.0,58,47,40,14,4,24,35,68.6,11,17,2,15,58,116,58,0,"DF,FW",25-29,Defender,Ivory Coast,Africa
1242,Harry Kane,ENG,Tottenham,Premier League,2019,26.0,1993.0,28.7,18,12,3,12,3,4,17,23.5,13,17,7,10,6,24,30,0,FW,25-29,Forward,England,Europe
1245,N'Golo Kanté,FRA,Chelsea,Premier League,2019,28.0,1991.0,19.2,44,20,22,14,8,17,36,47.2,19,29,5,24,44,88,32,2,MF,25-29,Midfielder,France,Europe
1247,Wilfrid Kaptoum,CMR,Betis,La Liga,2019,23.0,1996.0,2.2,5,2,3,2,0,3,3,100.0,0,4,1,3,1,6,3,0,MF,20-24,Midfielder,Cameroon,Africa
1249,Yann Karamoh,FRA,Parma,Serie A,2019,21.0,1998.0,6.4,10,7,5,4,1,3,9,33.3,6,5,0,5,2,12,3,0,"FW,MF",20-24,Forward,France,Europe
1251,Florian Kastenmeier,GER,Düsseldorf,Bundesliga,2019,22.0,1997.0,17.0,1,1,1,0,0,0,0,,0,0,0,0,2,3,3,1,GK,20-24,Goalkeeper,Germany,Europe
1252,Noah Katterbach,GER,Köln,Bundesliga,2019,18.0,2001.0,14.6,29,23,21,8,0,11,28,39.3,17,12,1,11,29,58,26,0,DF,Under 20,Defender,Germany,Europe
1253,Moise Kean,ITA,Everton,Premier League,2019,19.0,2000.0,9.5,6,6,5,1,0,0,0,,0,4,0,4,5,11,1,1,FW,Under 20,Forward,Italy,Europe
1254,Michael Keane,ENG,Everton,Premier League,2019,26.0,1993.0,28.4,31,16,18,12,1,14,24,58.3,10,35,28,7,44,75,152,0,DF,25-29,Defender,England,Europe
1255,Thilo Kehrer,GER,Paris S-G,Ligue 1,2019,22.0,1996.0,5.3,10,7,4,5,1,5,10,50.0,5,2,0,2,1,11,2,1,DF,20-24,Defender,Germany,Europe
1256,Jules Keita,GUI,Dijon,Ligue 1,2019,21.0,1998.0,1.8,4,3,2,1,1,1,6,16.7,5,1,0,1,3,7,0,0,"MF,FW",20-24,Midfielder,Guinea,Africa
1257,Naby Keïta,GUI,Liverpool,Premier League,2019,24.0,1995.0,9.1,30,14,8,16,6,11,26,42.3,15,18,0,18,10,40,4,0,MF,20-24,Midfielder,Guinea,Africa
1258,Yannik Keitel,GER,Freiburg,Bundesliga,2019,19.0,2000.0,1.9,2,1,1,1,0,0,6,0.0,6,3,1,2,4,6,4,0,MF,Under 20,Midfielder,Germany,Europe
1259,Lloyd Kelly,ENG,Bournemouth,Premier League,2019,20.0,1998.0,7.1,7,3,3,4,0,6,7,85.7,1,9,5,4,6,13,15,1,DF,20-24,Defender,England,Europe
1260,Martin Kelly,ENG,Crystal Palace,Premier League,2019,29.0,1990.0,17.2,23,18,19,4,0,14,31,45.2,17,18,10,8,16,39,86,1,DF,25-29,Defender,England,Europe
1261,Kenedy,BRA,Getafe,La Liga,2019,23.0,1996.0,6.5,9,5,3,3,3,2,5,40.0,3,10,0,10,11,20,4,0,MF,20-24,Midfielder,Brazil,South America
1262,Jonjoe Kenny,ENG,Schalke 04,Bundesliga,2019,22.0,1997.0,30.2,49,29,24,19,6,26,51,51.0,25,45,10,35,26,75,79,0,DF,20-24,Defender,England,Europe
1263,Franck Kessié,CIV,Milan,Serie A,2019,22.0,1996.0,32.3,54,29,28,18,8,16,52,30.8,36,34,5,29,34,88,32,2,MF,20-24,Midfielder,Ivory Coast,Africa
1264,Saîf-Eddine Khaoui,TUN,Marseille,Ligue 1,2019,24.0,1995.0,1.2,3,1,0,3,0,2,5,40.0,3,2,0,2,1,4,4,0,"MF,FW",20-24,Midfielder,Tunisia,Africa
1265,Wahbi Khazri,TUN,Saint-Étienne,Ligue 1,2019,28.0,1991.0,12.8,17,9,5,7,5,9,27,33.3,18,11,0,11,4,21,0,0,"FW,MF",25-29,Forward,Tunisia,Africa
1266,Rani Khedira,GER,Augsburg,Bundesliga,2019,25.0,1994.0,29.4,60,36,21,35,4,18,45,40.0,27,47,12,35,48,108,62,0,MF,25-29,Midfielder,Germany,Europe
1267,Sami Khedira,GER,Juventus,Serie A,2019,32.0,1987.0,7.6,14,7,3,8,3,4,19,21.1,15,12,1,11,3,17,13,0,MF,30-34,Midfielder,Germany,Europe
1269,Luca Kilian,GER,Paderborn 07,Bundesliga,2019,19.0,1999.0,14.0,33,24,27,6,0,22,41,53.7,19,20,9,11,12,45,67,0,DF,Under 20,Defender,Germany,Europe
1271,Joshua Kimmich,GER,Bayern Munich,Bundesliga,2019,24.0,1995.0,31.3,52,29,21,20,11,22,55,40.0,33,38,9,29,29,81,29,0,"MF,DF",20-24,Midfielder,Germany,Europe
1272,Presnel Kimpembe,FRA,Paris S-G,Ligue 1,2019,23.0,1995.0,13.6,33,25,25,8,0,14,20,70.0,6,7,3,4,21,54,33,1,DF,20-24,Defender,France,Europe
1274,Simon Kjær,DEN,Atalanta,Serie A,2019,30.0,1989.0,3.2,9,6,1,8,0,3,4,75.0,1,5,4,1,7,16,10,1,DF,30-34,Defender,Denmark,Europe
1275,Simon Kjær,DEN,Milan,Serie A,2019,30.0,1989.0,13.8,22,13,17,5,0,10,18,55.6,8,20,16,4,15,37,52,0,DF,30-34,Defender,Denmark,Europe
1277,Felix Klaus,GER,Wolfsburg,Bundesliga,2019,26.0,1992.0,7.4,24,16,4,13,7,7,19,36.8,12,10,2,8,3,27,5,0,"MF,FW",25-29,Midfielder,Germany,Europe
1278,Ragnar Klavan,EST,Cagliari,Serie A,2019,33.0,1985.0,26.2,29,16,20,9,0,14,28,50.0,14,29,19,10,25,54,118,1,DF,30-34,Defender,Estonia,Europe
1279,Timm Klose,SUI,Norwich City,Premier League,2019,31.0,1988.0,6.5,8,2,5,2,1,7,11,63.6,4,6,6,0,7,15,29,0,DF,30-34,Defender,Switzerland,Europe
1280,Lukas Klostermann,GER,RB Leipzig,Bundesliga,2019,23.0,1996.0,29.4,45,26,24,16,5,18,31,58.1,13,34,16,18,26,71,101,2,DF,20-24,Defender,Germany,Europe
1281,Justin Kluivert,NED,Roma,Serie A,2019,20.0,1999.0,16.8,17,11,4,8,5,7,16,43.8,9,15,0,15,6,23,7,0,FW,20-24,Forward,Netherlands,Europe
1282,Lukas Klünter,GER,Hertha BSC,Bundesliga,2019,23.0,1996.0,20.9,44,31,26,16,2,20,30,66.7,10,16,4,12,27,71,61,1,DF,20-24,Defender,Germany,Europe
1283,Robin Knoche,GER,Wolfsburg,Bundesliga,2019,27.0,1992.0,17.7,29,14,24,5,0,17,30,56.7,13,19,11,8,27,56,77,1,DF,25-29,Defender,Germany,Europe
1284,Robin Koch,GER,Freiburg,Bundesliga,2019,23.0,1996.0,30.1,34,20,20,13,1,11,26,42.3,15,30,22,8,45,79,94,4,"DF,MF",20-24,Defender,Germany,Europe
1285,Giorgi Kochorashvili,GEO,Levante,La Liga,2019,20.0,1999.0,0.0,0,0,0,0,0,0,0,,0,0,0,0,0,0,0,0,MF,20-24,Midfielder,Georgia,Asia
1286,Jonathan Kodjia,CIV,Aston Villa,Premier League,2019,29.0,1989.0,1.3,0,0,0,0,0,0,1,0.0,1,0,0,0,0,0,1,0,FW,25-29,Forward,Ivory Coast,Africa
1288,Dominik Kohr,GER,Eint Frankfurt,Bundesliga,2019,25.0,1994.0,16.1,44,35,15,25,4,18,53,34.0,35,31,11,20,30,74,16,0,MF,25-29,Midfielder,Germany,Europe
1292,Timothée Kolodziejczak,FRA,Saint-Étienne,Ligue 1,2019,27.0,1991.0,14.5,17,10,13,4,0,9,21,42.9,12,8,3,5,30,47,44,2,DF,25-29,Defender,France,Europe
1293,Ghislain Konan,CIV,Reims,Ligue 1,2019,23.0,1995.0,14.8,43,26,28,14,1,19,28,67.9,9,13,3,10,24,67,34,0,DF,20-24,Defender,Ivory Coast,Africa
1294,Ibrahima Konaté,FRA,RB Leipzig,Bundesliga,2019,20.0,1999.0,6.3,11,6,10,1,0,2,7,28.6,5,9,4,5,5,16,35,1,DF,20-24,Defender,France,Europe
1296,Geoffrey Kondogbia,CTA,Valencia,La Liga,2019,26.0,1993.0,20.1,63,40,40,18,5,19,51,37.3,32,25,6,19,57,120,36,2,MF,25-29,Midfielder,Central African Republic,Africa
1297,Lamine Koné,CIV,Strasbourg,Ligue 1,2019,30.0,1989.0,16.4,31,21,20,10,1,12,17,70.6,5,8,5,3,25,56,47,1,DF,30-34,Defender,Ivory Coast,Africa
1298,Manu Koné,FRA,Toulouse,Ligue 1,2019,18.0,2001.0,9.7,35,20,17,14,4,13,30,43.3,17,15,1,14,19,54,10,1,MF,Under 20,Midfielder,France,Europe
1301,Ezri Konsa,ENG,Aston Villa,Premier League,2019,21.0,1997.0,22.7,18,9,12,6,0,7,16,43.8,9,34,24,10,25,43,70,2,DF,20-24,Defender,England,Europe
1302,Pascal Köpke,GER,Hertha BSC,Bundesliga,2019,23.0,1995.0,1.3,0,0,0,0,0,0,0,,0,0,0,0,0,0,0,0,FW,20-24,Forward,Germany,Europe
1303,Laurent Koscielny,FRA,Bordeaux,Ligue 1,2019,33.0,1985.0,24.3,28,13,24,4,0,10,20,50.0,10,23,19,4,26,54,104,0,DF,30-34,Defender,France,Europe
1305,Christian Kouamé,CIV,Fiorentina,Serie A,2019,21.0,1997.0,3.3,3,2,0,3,0,0,1,0.0,1,5,1,4,1,4,1,0,"FW,MF",20-24,Forward,Ivory Coast,Africa
1306,Christian Kouamé,CIV,Genoa,Serie A,2019,21.0,1997.0,10.2,2,1,0,1,1,0,8,0.0,8,8,2,6,1,3,13,0,FW,20-24,Forward,Ivory Coast,Africa
1308,Kalidou Koulibaly,SEN,Napoli,Serie A,2019,28.0,1991.0,23.4,51,33,30,17,4,17,28,60.7,11,28,16,12,31,82,61,1,DF,25-29,Defender,Senegal,Africa
1310,Jules Koundé,FRA,Sevilla,La Liga,2019,20.0,1998.0,25.7,23,12,14,5,4,10,18,55.6,8,16,12,4,23,46,91,2,DF,20-24,Defender,France,Europe
1312,Cheikhou Kouyaté,SEN,Crystal Palace,Premier League,2019,29.0,1989.0,28.1,67,32,43,20,4,26,48,54.2,22,35,11,24,43,110,58,1,"MF,DF",25-29,Midfielder,Senegal,Africa
1316,Thomas Kraft,GER,Hertha BSC,Bundesliga,2019,31.0,1988.0,4.0,0,0,0,0,0,0,0,,0,0,0,0,1,1,0,0,GK,30-34,Goalkeeper,Germany,Europe
1317,Emil Krafth,SWE,Newcastle Utd,Premier League,2019,24.0,1994.0,11.3,18,12,15,2,1,9,20,45.0,11,11,8,3,8,26,45,0,DF,20-24,Defender,Sweden,Europe
1319,Christoph Kramer,GER,Gladbach,Bundesliga,2019,28.0,1991.0,16.3,45,29,19,21,5,19,49,38.8,30,22,3,19,14,59,19,0,MF,25-29,Midfielder,Germany,Europe
1320,Tom Krauß,GER,RB Leipzig,Bundesliga,2019,18.0,2001.0,0.0,1,1,0,1,0,1,2,50.0,1,0,0,0,0,1,0,0,MF,Under 20,Midfielder,Germany,Europe
1323,Felix Kroos,GER,Union Berlin,Bundesliga,2019,28.0,1991.0,4.2,17,9,9,6,2,8,15,53.3,7,6,3,3,3,20,13,1,"MF,DF",25-29,Midfielder,Germany,Europe
1324,Toni Kroos,GER,Real Madrid,La Liga,2019,29.0,1990.0,29.5,56,28,18,29,9,18,70,25.7,52,27,0,27,23,79,15,0,MF,25-29,Midfielder,Germany,Europe
1325,Tim Krul,NED,Norwich City,Premier League,2019,31.0,1988.0,36.0,0,0,0,0,0,0,1,0.0,1,2,0,2,1,1,13,1,GK,30-34,Goalkeeper,Netherlands,Europe
1327,Lukas Kübler,GER,Freiburg,Bundesliga,2019,26.0,1992.0,2.3,1,1,0,1,0,1,5,20.0,4,2,0,2,1,2,6,0,DF,25-29,Defender,Germany,Europe
1328,Takefusa Kubo,JPN,Mallorca,La Liga,2019,18.0,2001.0,25.7,34,22,16,12,6,15,44,34.1,29,19,1,18,23,57,10,0,"MF,FW",Under 20,Midfielder,Japan,Asia
1329,Juraj Kucka,SVK,Parma,Serie A,2019,32.0,1987.0,21.5,43,22,21,16,6,14,61,23.0,47,21,4,17,29,72,36,0,"MF,FW",30-34,Midfielder,Slovakia,Europe
1330,Dejan Kulusevski,SWE,Parma,Serie A,2019,19.0,2000.0,32.6,41,21,10,24,7,19,64,29.7,45,25,1,24,23,64,17,0,"FW,MF",Under 20,Forward,Sweden,Europe
1331,Marash Kumbulla,ALB,Hellas Verona,Serie A,2019,19.0,2000.0,21.7,40,24,21,17,2,19,36,52.8,17,33,24,9,50,90,86,3,DF,Under 20,Defender,Albania,Europe
1340,Antonino La Gumina,ITA,Sampdoria,Serie A,2019,23.0,1996.0,2.1,0,0,0,0,0,0,0,,0,0,0,0,0,0,1,0,FW,20-24,Forward,Italy,Europe
1341,Andrea La Mantia,ITA,Lecce,Serie A,2019,28.0,1991.0,6.1,1,0,1,0,0,1,5,20.0,4,3,0,3,7,8,11,0,FW,25-29,Forward,Italy,Europe
1342,Gaëtan Laborde,FRA,Montpellier,Ligue 1,2019,25.0,1994.0,24.9,21,12,4,10,7,9,38,23.7,29,21,0,21,7,28,32,1,FW,25-29,Forward,France,Europe
1343,Alexandre Lacazette,FRA,Arsenal,Premier League,2019,28.0,1991.0,20.8,31,16,8,21,2,9,24,37.5,15,14,0,14,7,38,15,0,FW,25-29,Forward,France,Europe
1344,Riccardo Ladinetti,ITA,Cagliari,Serie A,2019,18.0,2000.0,1.4,2,2,0,2,0,1,1,100.0,0,0,0,0,4,6,0,1,MF,Under 20,Midfielder,Italy,Europe
1345,Alban Lafont,FRA,Nantes,Ligue 1,2019,20.0,1999.0,27.0,1,1,1,0,0,1,1,100.0,0,0,0,0,0,1,12,0,GK,20-24,Goalkeeper,France,Europe
1347,Jack Lahne,SWE,Amiens,Ligue 1,2019,17.0,2001.0,0.1,1,1,0,0,1,0,0,,0,0,0,0,0,1,0,0,FW,Under 20,Forward,Sweden,Europe
1348,Konrad Laimer,AUT,RB Leipzig,Bundesliga,2019,22.0,1997.0,23.5,91,45,30,46,15,43,102,42.2,59,51,8,43,34,125,14,0,MF,20-24,Midfielder,Austria,Europe
1349,Stefan Lainer,AUT,Gladbach,Bundesliga,2019,26.0,1992.0,30.1,51,30,25,19,7,24,54,44.4,30,38,7,31,29,80,71,0,DF,25-29,Defender,Austria,Europe
1351,Kenny Lala,MAD,Strasbourg,Ligue 1,2019,27.0,1991.0,22.7,29,16,17,11,1,11,27,40.7,16,14,5,9,20,49,40,1,"DF,MF",25-29,Defender,Madagascar,Africa
1352,Adam Lallana,ENG,Liverpool,Premier League,2019,31.0,1988.0,4.2,19,9,7,9,3,6,21,28.6,15,7,0,7,5,24,3,0,"MF,FW",30-34,Midfielder,England,Europe
1357,Michael Lang,SUI,Werder Bremen,Bundesliga,2019,28.0,1991.0,6.0,8,5,3,5,0,6,12,50.0,6,5,1,4,7,15,22,0,"DF,FW",25-29,Defender,Switzerland,Europe
1358,Sebastian Langkamp,GER,Werder Bremen,Bundesliga,2019,31.0,1988.0,3.5,3,2,3,0,0,2,4,50.0,2,5,3,2,3,6,11,1,DF,30-34,Defender,Germany,Europe
1359,Henri Lansbury,ENG,Aston Villa,Premier League,2019,28.0,1990.0,2.2,6,2,3,1,2,2,8,25.0,6,4,0,4,0,6,3,0,MF,25-29,Midfielder,England,Europe
1360,Manuel Lanzini,ARG,West Ham,Premier League,2019,26.0,1993.0,15.3,14,9,6,6,2,7,39,17.9,32,9,1,8,10,24,3,0,"MF,FW",25-29,Midfielder,Argentina,South America
1361,Gianluca Lapadula,PER,Lecce,Serie A,2019,29.0,1990.0,19.8,15,8,6,8,1,5,16,31.3,11,2,0,2,1,16,14,0,FW,25-29,Forward,Peru,South America
1365,Gautier Larsonneur,FRA,Brest,Ligue 1,2019,22.0,1997.0,26.6,2,1,2,0,0,2,4,50.0,2,1,0,1,4,6,14,3,GK,20-24,Goalkeeper,France,Europe
1367,Jamaal Lascelles,ENG,Newcastle Utd,Premier League,2019,25.0,1993.0,23.1,14,3,10,4,0,4,9,44.4,5,23,20,3,28,42,116,1,DF,25-29,Defender,England,Europe
1368,Paul Lasne,FRA,Brest,Ligue 1,2019,30.0,1989.0,13.6,25,13,13,11,1,6,20,30.0,14,7,2,5,7,32,5,0,"MF,FW",30-34,Midfielder,France,Europe
1370,Danny Latza,GER,Mainz 05,Bundesliga,2019,29.0,1989.0,15.3,33,19,15,17,1,16,49,32.7,33,22,5,17,17,50,24,0,MF,25-29,Midfielder,Germany,Europe
1371,Vincent Laurini,FRA,Parma,Serie A,2019,30.0,1989.0,9.8,26,22,11,11,4,14,18,77.8,4,10,3,7,11,37,29,0,DF,30-34,Defender,France,Europe
1372,Wesley Lautoa,NCL,Dijon,Ligue 1,2019,31.0,1987.0,20.8,54,29,24,28,2,28,63,44.4,35,31,16,15,42,96,48,2,"MF,DF",30-34,Midfielder,New Caledonia,Oceania
1375,Valentino Lazaro,AUT,Newcastle Utd,Premier League,2019,23.0,1996.0,5.3,13,9,11,2,0,11,18,61.1,7,2,0,2,3,16,4,0,"DF,MF",20-24,Defender,Austria,Europe
1376,Valentino Lazaro,AUT,Inter,Serie A,2019,23.0,1996.0,3.6,6,5,3,2,1,4,8,50.0,4,5,0,5,1,7,8,1,DF,20-24,Defender,Austria,Europe
1378,Manuel Lazzari,ITA,Lazio,Serie A,2019,25.0,1993.0,28.3,20,11,10,7,3,10,31,32.3,21,11,1,10,8,28,34,0,DF,25-29,Defender,Italy,Europe
1379,Mickaël Le Bihan,FRA,Nice,Ligue 1,2019,29.0,1990.0,1.1,0,0,0,0,0,0,2,0.0,2,0,0,0,0,0,2,0,"FW,DF",25-29,Forward,France,Europe
1383,Rafael Leão,POR,Milan,Serie A,2019,20.0,1999.0,15.6,7,4,2,5,0,3,9,33.3,6,4,0,4,0,7,5,0,FW,20-24,Forward,Portugal,Europe
1385,Mathew Leckie,AUS,Hertha BSC,Bundesliga,2019,28.0,1991.0,2.2,3,1,1,2,0,2,3,66.7,1,6,0,6,2,5,2,1,"DF,FW",25-29,Defender,Australia,Oceania
1386,Benjamin Lecomte,FRA,Monaco,Ligue 1,2019,28.0,1991.0,28.0,0,0,0,0,0,0,1,0.0,1,1,0,1,0,0,10,5,GK,25-29,Goalkeeper,France,Europe
1387,Pierre Lees-Melou,FRA,Nice,Ligue 1,2019,26.0,1993.0,25.0,63,27,34,21,8,31,88,35.2,57,38,12,26,32,95,43,0,MF,25-29,Midfielder,France,Europe
1388,Jordan Lefort,FRA,Amiens,Ligue 1,2019,25.0,1993.0,9.4,3,2,2,1,0,3,5,60.0,2,4,1,3,9,12,29,0,DF,25-29,Defender,France,Europe
1391,Moritz Leitner,GER,Norwich City,Premier League,2019,26.0,1992.0,7.6,16,9,8,7,1,9,25,36.0,16,14,4,10,9,25,10,1,MF,25-29,Midfielder,Germany,Europe
1392,Lucas Leiva,BRA,Lazio,Serie A,2019,32.0,1987.0,20.1,60,35,25,31,4,28,72,38.9,44,29,6,23,47,107,34,1,MF,30-34,Midfielder,Brazil,South America
1393,Florian Lejeune,FRA,Newcastle Utd,Premier League,2019,28.0,1991.0,4.9,8,2,6,2,0,4,7,57.1,3,6,2,4,10,18,15,2,DF,25-29,Defender,France,Europe
1395,Nicolas Lemaître,FRA,Reims,Ligue 1,2019,22.0,1997.0,1.0,0,0,0,0,0,0,1,0.0,1,0,0,0,1,1,1,1,GK,20-24,Goalkeeper,France,Europe
1396,Thomas Lemar,FRA,Atlético Madrid,La Liga,2019,23.0,1995.0,10.3,12,8,4,5,3,2,11,18.2,9,14,1,13,6,18,6,0,MF,20-24,Midfielder,France,Europe
1398,Clément Lenglet,FRA,Barcelona,La Liga,2019,24.0,1995.0,26.9,44,31,29,15,0,16,32,50.0,16,29,15,14,35,79,79,1,DF,20-24,Defender,France,Europe
1399,Aaron Lennon,ENG,Burnley,Premier League,2019,32.0,1987.0,5.5,14,8,7,4,3,7,10,70.0,3,6,1,5,8,22,3,0,MF,30-34,Midfielder,England,Europe
1400,Bernd Leno,GER,Arsenal,Premier League,2019,27.0,1992.0,29.4,0,0,0,0,0,0,2,0.0,2,0,0,0,0,0,9,2,GK,25-29,Goalkeeper,Germany,Europe
1401,Christopher Lenz,GER,Union Berlin,Bundesliga,2019,24.0,1994.0,25.2,63,37,37,20,6,26,49,53.1,23,46,11,35,43,106,65,0,"DF,MF",20-24,Defender,Germany,Europe
1406,Mehdi Léris,ALG,Sampdoria,Serie A,2019,21.0,1998.0,5.7,13,11,4,2,7,7,19,36.8,12,12,4,8,6,19,6,0,"MF,FW",20-24,Midfielder,Algeria,Africa
1407,Jefferson Lerma,COL,Bournemouth,Premier League,2019,24.0,1994.0,30.0,54,32,17,31,6,22,48,45.8,26,28,12,16,57,111,54,1,MF,20-24,Midfielder,Colombia,South America
1408,Karlo Letica,CRO,SPAL,Serie A,2019,22.0,1997.0,10.0,0,0,0,0,0,0,2,0.0,2,0,0,0,0,0,4,3,GK,20-24,Goalkeeper,Croatia,Europe
1412,Stephan Lichtsteiner,SUI,Augsburg,Bundesliga,2019,35.0,1984.0,14.9,23,14,16,5,2,10,22,45.5,12,15,7,8,16,39,35,0,DF,35-39,Defender,Switzerland,Europe
1413,Dimitri Liénard,FRA,Strasbourg,Ligue 1,2019,31.0,1988.0,16.5,37,24,10,22,5,18,39,46.2,21,18,4,14,17,54,25,0,MF,30-34,Midfielder,France,Europe
1414,Philipp Lienhart,AUT,Freiburg,Bundesliga,2019,23.0,1996.0,20.2,11,4,10,1,0,6,13,46.2,7,24,17,7,28,39,86,0,DF,20-24,Defender,Austria,Europe
1415,Matthijs de Ligt,NED,Juventus,Serie A,2019,19.0,1999.0,27.2,25,15,14,10,1,13,23,56.5,10,30,23,7,25,50,101,2,DF,Under 20,Defender,Netherlands,Europe
1416,Isaac Lihadji,FRA,Marseille,Ligue 1,2019,17.0,2002.0,0.3,0,0,0,0,0,0,0,,0,0,0,0,0,0,0,0,MF,Under 20,Midfielder,France,Europe
1421,Victor Lindelöf,SWE,Manchester Utd,Premier League,2019,25.0,1994.0,34.4,29,15,16,12,1,17,20,85.0,3,25,16,9,26,55,129,0,DF,25-29,Defender,Sweden,Europe
1423,Jesse Lingard,ENG,Manchester Utd,Premier League,2019,26.0,1992.0,10.4,15,8,6,4,5,5,18,27.8,13,5,0,5,3,18,0,0,"MF,FW",25-29,Midfielder,England,Europe
1428,Gautier Lloris,FRA,Nice,Ligue 1,2019,24.0,1995.0,3.0,5,3,5,0,0,4,5,80.0,1,3,3,0,2,7,11,0,DF,20-24,Defender,France,Europe
1429,Hugo Lloris,FRA,Tottenham,Premier League,2019,32.0,1986.0,20.1,0,0,0,0,0,0,0,,0,0,0,0,1,1,3,2,GK,30-34,Goalkeeper,France,Europe
1430,Giovani Lo Celso,ARG,Tottenham,Premier League,2019,23.0,1996.0,16.6,51,29,12,33,6,12,59,20.3,47,20,4,16,9,60,19,0,"MF,FW",20-24,Midfielder,Argentina,South America
1431,Stanislav Lobotka,SVK,Napoli,Serie A,2019,24.0,1994.0,8.4,11,9,3,5,3,5,12,41.7,7,3,1,2,9,20,2,0,MF,20-24,Midfielder,Slovakia,Europe
1432,Stanislav Lobotka,SVK,Celta Vigo,La Liga,2019,24.0,1994.0,15.4,19,11,13,5,1,4,19,21.1,15,8,2,6,8,27,7,0,MF,20-24,Midfielder,Slovakia,Europe
1433,Jürgen Locadia,CUW,Brighton,Premier League,2019,25.0,1993.0,1.0,0,0,0,0,0,0,0,,0,0,0,0,0,0,0,0,"FW,MF",25-29,Forward,Curaçao,Europe
1434,Jürgen Locadia,CUW,Hoffenheim,Bundesliga,2019,25.0,1993.0,5.9,5,4,0,4,1,1,4,25.0,3,1,0,1,0,5,3,0,FW,25-29,Forward,Curaçao,Europe
1435,Manuel Locatelli,ITA,Sassuolo,Serie A,2019,21.0,1998.0,28.7,76,50,35,37,4,33,69,47.8,36,42,14,28,33,109,36,0,MF,20-24,Midfielder,Italy,Europe
1436,Renan Lodi,BRA,Atlético Madrid,La Liga,2019,21.0,1998.0,26.6,73,46,28,35,10,40,65,61.5,25,28,7,21,38,111,56,0,DF,20-24,Defender,Brazil,South America
1437,Ruben Loftus-Cheek,ENG,Chelsea,Premier League,2019,23.0,1996.0,2.3,0,0,0,0,0,0,2,0.0,2,1,1,0,2,2,2,0,"MF,FW",20-24,Midfielder,England,Europe
1438,Enzo Loiodice,FRA,Dijon,Ligue 1,2019,18.0,2000.0,2.1,6,4,1,4,1,1,3,33.3,2,2,0,2,2,8,1,0,MF,Under 20,Midfielder,France,Europe
1439,Kevin Long,IRL,Burnley,Premier League,2019,28.0,1990.0,6.3,7,5,6,1,0,4,9,44.4,5,9,7,2,4,11,31,0,DF,25-29,Defender,Republic of Ireland,Europe
1440,Shane Long,IRL,Southampton,Premier League,2019,32.0,1987.0,15.5,19,10,5,8,6,7,19,36.8,12,12,0,12,4,23,16,0,FW,30-34,Forward,Republic of Ireland,Europe
1442,Sean Longstaff,ENG,Newcastle Utd,Premier League,2019,21.0,1997.0,15.3,35,19,17,16,2,20,50,40.0,30,23,5,18,19,54,20,2,MF,20-24,Midfielder,England,Europe
1443,Ademola Lookman,NGA,RB Leipzig,Bundesliga,2019,21.0,1997.0,3.4,6,4,3,1,2,1,1,100.0,0,3,0,3,1,7,0,1,"FW,MF",20-24,Forward,Nigeria,Africa
1444,Anthony Lopes,POR,Lyon,Ligue 1,2019,28.0,1990.0,26.0,0,0,0,0,0,0,0,,0,0,0,0,1,1,11,0,GK,25-29,Goalkeeper,Portugal,Europe
1460,Matteo Lovato,ITA,Hellas Verona,Serie A,2019,19.0,2000.0,0.1,0,0,0,0,0,0,0,,0,0,0,0,0,0,1,0,DF,Under 20,Defender,Italy,Europe
1462,Eduard Löwen,GER,Augsburg,Bundesliga,2019,22.0,1997.0,7.5,10,8,6,2,2,6,18,33.3,12,11,2,9,5,15,7,0,MF,20-24,Midfielder,Germany,Europe
1463,Eduard Löwen,GER,Hertha BSC,Bundesliga,2019,22.0,1997.0,3.5,9,6,3,6,0,5,11,45.5,6,2,1,1,7,16,2,0,MF,20-24,Midfielder,Germany,Europe
1464,Matthew Lowton,ENG,Burnley,Premier League,2019,30.0,1989.0,17.0,41,22,20,18,3,22,33,66.7,11,20,6,14,27,68,57,1,DF,30-34,Defender,England,Europe
1465,Hirving Lozano,MEX,Napoli,Serie A,2019,24.0,1995.0,11.4,6,4,1,5,0,2,15,13.3,13,13,0,13,5,11,5,0,"FW,MF",20-24,Forward,Mexico,North America
1468,Jean Lucas,BRA,Lyon,Ligue 1,2019,21.0,1998.0,2.2,16,7,8,5,3,2,9,22.2,7,2,2,0,2,18,0,0,MF,20-24,Midfielder,Brazil,South America
1469,Fabio Lucioni,ITA,Lecce,Serie A,2019,31.0,1987.0,34.8,29,13,20,9,0,14,32,43.8,18,48,38,10,36,65,169,5,DF,30-34,Defender,Italy,Europe
1472,José Luis Palomino,ARG,Atalanta,Serie A,2019,29.0,1990.0,27.6,81,44,46,33,2,28,54,51.9,26,39,14,25,61,142,74,2,DF,25-29,Defender,Argentina,South America
1474,David Luiz,BRA,Arsenal,Premier League,2019,32.0,1987.0,31.2,28,16,14,14,0,13,24,54.2,11,42,37,5,32,60,133,2,DF,30-34,Defender,Brazil,South America
1475,Douglas Luiz,BRA,Aston Villa,Premier League,2019,21.0,1998.0,29.0,46,24,25,17,4,19,65,29.2,46,42,15,27,36,82,54,1,MF,20-24,Midfielder,Brazil,South America
1476,Jordan Lukaku,BEL,Lazio,Serie A,2019,25.0,1994.0,4.4,4,2,1,1,2,2,4,50.0,2,2,1,1,0,4,9,0,DF,25-29,Defender,Belgium,Europe
1477,Romelu Lukaku,BEL,Inter,Serie A,2019,26.0,1993.0,33.1,13,7,4,7,2,3,10,30.0,7,14,6,8,1,14,28,0,FW,25-29,Forward,Belgium,Europe
1482,Sebastiano Luperto,ITA,Napoli,Serie A,2019,22.0,1996.0,5.9,12,9,7,3,2,6,9,66.7,3,5,3,2,6,18,16,0,DF,20-24,Defender,Italy,Europe
1484,Andreas Luthe,GER,Augsburg,Bundesliga,2019,32.0,1987.0,10.0,1,0,1,0,0,1,2,50.0,1,0,0,0,0,1,5,1,GK,30-34,Goalkeeper,Germany,Europe
1485,Lyanco,BRA,Torino,Serie A,2019,22.0,1997.0,13.1,23,13,9,12,2,7,13,53.8,6,29,19,10,23,46,54,2,DF,20-24,Defender,Brazil,South America
1488,Alexis Mac Allister,ARG,Brighton,Premier League,2019,20.0,1998.0,3.9,9,5,4,3,2,5,9,55.6,4,12,0,12,1,10,2,0,"MF,FW",20-24,Midfielder,Argentina,South America
1489,Darwin Machís,VEN,Granada,La Liga,2019,26.0,1993.0,23.7,23,13,11,8,4,8,23,34.8,15,22,4,18,31,54,9,0,"FW,MF",25-29,Forward,Venezuela,South America
1491,James Maddison,ENG,Leicester City,Premier League,2019,22.0,1996.0,29.2,59,30,13,31,15,23,68,33.8,45,16,0,16,9,68,7,1,MF,20-24,Midfielder,England,Europe
1492,Gabriel Magalhães,BRA,Lille,Ligue 1,2019,21.0,1997.0,23.2,41,29,27,11,3,15,22,68.2,7,27,18,9,22,63,86,2,DF,20-24,Defender,Brazil,South America
1493,Lisandro Magallán,ARG,Alavés,La Liga,2019,25.0,1993.0,13.3,22,15,10,12,0,8,14,57.1,6,17,6,11,16,38,43,1,DF,25-29,Defender,Argentina,South America
1494,Francesco Magnanelli,ITA,Sassuolo,Serie A,2019,34.0,1984.0,15.5,25,13,9,12,4,11,35,31.4,24,12,6,6,19,44,23,1,MF,30-34,Midfielder,Italy,Europe
1495,Giangiacomo Magnani,ITA,Brescia,Serie A,2019,23.0,1995.0,1.3,0,0,0,0,0,0,1,0.0,1,2,2,0,2,2,6,0,DF,20-24,Defender,Italy,Europe
1496,Giangiacomo Magnani,ITA,Sassuolo,Serie A,2019,23.0,1995.0,1.6,0,0,0,0,0,0,0,,0,2,1,1,2,2,7,0,DF,20-24,Defender,Italy,Europe
1497,Hugo Magnetti,FRA,Brest,Ligue 1,2019,21.0,1998.0,2.6,16,10,7,7,2,5,9,55.6,4,4,0,4,7,23,4,0,MF,20-24,Midfielder,France,Europe
1498,Harry Maguire,ENG,Manchester Utd,Premier League,2019,26.0,1993.0,38.0,37,23,23,14,0,18,34,52.9,16,31,22,9,72,109,159,0,DF,25-29,Defender,England,Europe
1499,Abdallahi Mahmoud,MTN,Alavés,La Liga,2019,19.0,2000.0,1.7,4,4,2,1,1,1,6,16.7,5,0,0,0,5,9,2,0,MF,Under 20,Midfielder,Mauritania,Africa
1500,Riyad Mahrez,ALG,Manchester City,Premier League,2019,28.0,1991.0,21.6,28,14,11,9,8,11,38,28.9,27,31,1,30,18,46,8,2,"FW,MF",25-29,Forward,Algeria,Africa
1501,Thiago Maia,BRA,Lille,Ligue 1,2019,22.0,1997.0,0.5,4,4,1,3,0,0,1,0.0,1,0,0,0,1,5,1,0,MF,20-24,Midfielder,Brazil,South America
1502,Arne Maier,GER,Hertha BSC,Bundesliga,2019,20.0,1999.0,5.9,9,7,6,1,2,1,10,10.0,9,5,0,5,7,16,2,1,MF,20-24,Midfielder,Germany,Europe
1503,Habib Maïga,CIV,Metz,Ligue 1,2019,23.0,1996.0,25.2,84,50,36,38,10,24,64,37.5,40,39,4,35,34,118,39,2,MF,20-24,Midfielder,Ivory Coast,Africa
1504,Mike Maignan,FRA,Lille,Ligue 1,2019,24.0,1995.0,28.0,0,0,0,0,0,0,0,,0,0,0,0,2,2,5,0,GK,20-24,Goalkeeper,France,Europe
1505,Ainsley Maitland-Niles,ENG,Arsenal,Premier League,2019,21.0,1997.0,15.4,41,23,34,5,2,22,43,51.2,21,12,3,9,28,69,38,0,DF,20-24,Defender,England,Europe
1506,Josh Maja,NGA,Bordeaux,Ligue 1,2019,20.0,1998.0,8.2,5,2,0,2,3,1,10,10.0,9,8,4,4,1,6,3,0,FW,20-24,Forward,Nigeria,Africa
1509,Jean-Victor Makengo,FRA,Toulouse,Ligue 1,2019,21.0,1998.0,11.0,14,11,3,10,1,4,13,30.8,9,7,1,6,3,17,5,1,MF,20-24,Midfielder,France,Europe
1514,Ruslan Malinovskyi,UKR,Atalanta,Serie A,2019,26.0,1993.0,17.1,22,14,2,17,3,9,31,29.0,22,13,2,11,5,27,5,0,"MF,FW",25-29,Midfielder,Ukraine,Europe
1517,Streli Mamba,GER,Paderborn 07,Bundesliga,2019,25.0,1994.0,16.9,15,9,0,9,6,1,13,7.7,12,12,2,10,6,21,2,0,FW,25-29,Forward,Germany,Europe
1519,Vincent Manceau,FRA,Angers,Ligue 1,2019,30.0,1989.0,22.0,34,22,18,13,3,16,36,44.4,20,16,3,13,22,56,51,0,DF,30-34,Defender,France,Europe
1520,Gianluca Mancini,ITA,Roma,Serie A,2019,23.0,1996.0,30.4,49,26,26,18,5,22,44,50.0,22,32,15,17,60,109,98,1,"DF,MF",20-24,Defender,Italy,Europe
1521,Marco Mancosu,ITA,Lecce,Serie A,2019,30.0,1988.0,27.1,32,18,11,16,5,10,46,21.7,36,34,9,25,16,48,15,1,"MF,FW",30-34,Midfielder,Italy,Europe
1522,Steve Mandanda,FRA,Marseille,Ligue 1,2019,34.0,1985.0,26.3,3,1,3,0,0,3,4,75.0,1,0,0,0,1,4,2,4,GK,30-34,Goalkeeper,France,Europe
1523,Reinildo Mandava,MOZ,Lille,Ligue 1,2019,25.0,1994.0,12.3,37,21,23,11,3,25,41,61.0,16,16,1,15,19,56,20,0,"DF,MF",25-29,Defender,Mozambique,Africa
1524,Aïssa Mandi,ALG,Betis,La Liga,2019,27.0,1991.0,28.6,33,15,22,8,3,18,28,64.3,10,29,15,14,38,71,93,0,DF,25-29,Defender,Algeria,Africa
1525,Rolando Mandragora,ITA,Udinese,Serie A,2019,22.0,1997.0,22.8,47,24,15,25,7,15,55,27.3,40,30,5,25,26,73,25,0,MF,20-24,Midfielder,Italy,Europe
1526,Sadio Mané,SEN,Liverpool,Premier League,2019,27.0,1992.0,30.5,44,32,9,20,15,13,40,32.5,27,19,0,19,13,57,11,2,FW,25-29,Forward,Senegal,Africa
1528,Thomas Mangani,FRA,Angers,Ligue 1,2019,32.0,1987.0,20.8,33,23,15,16,2,14,47,29.8,33,17,2,15,12,45,20,1,MF,30-34,Midfielder,France,Europe
1529,Massimiliano Mangraviti,ITA,Brescia,Serie A,2019,21.0,1998.0,10.8,8,6,1,6,1,3,6,50.0,3,11,6,5,8,16,43,0,DF,20-24,Defender,Italy,Europe
1532,Giacomo Manzari,ITA,Sassuolo,Serie A,2019,18.0,2000.0,0.2,0,0,0,0,0,0,0,,0,0,0,0,0,0,0,0,"FW,MF",Under 20,Forward,Italy,Europe
1534,Faitout Maouassa,FRA,Rennes,Ligue 1,2019,21.0,1998.0,20.0,51,33,27,20,4,14,26,53.8,12,13,5,8,23,74,59,0,DF,20-24,Defender,France,Europe
1536,Marcelo,BRA,Real Madrid,La Liga,2019,31.0,1988.0,14.4,19,11,8,8,3,9,28,32.1,19,19,2,17,18,37,21,0,DF,30-34,Defender,Brazil,South America
1536,Marcelo,BRA,Real Madrid,La Liga,2019,31.0,1988.0,14.4,19,11,8,8,3,9,28,32.1,19,19,2,17,18,37,21,0,DF,30-34,Defender,Brazil,South America
1536,Marcelo,BRA,Real Madrid,La Liga,2019,31.0,1988.0,14.4,19,11,8,8,3,9,28,32.1,19,19,2,17,18,37,21,0,DF,30-34,Defender,Brazil,South America
1536,Marcelo,BRA,Real Madrid,La Liga,2019,31.0,1988.0,14.4,19,11,8,8,3,9,28,32.1,19,19,2,17,18,37,21,0,DF,30-34,Defender,Brazil,South America
1536,Marcelo,BRA,Real Madrid,La Liga,2019,31.0,1988.0,14.4,19,11,8,8,3,9,28,32.1,19,19,2,17,18,37,21,0,DF,30-34,Defender,Brazil,South America
1536,Marcelo,BRA,Real Madrid,La Liga,2019,31.0,1988.0,14.4,19,11,8,8,3,9,28,32.1,19,19,2,17,18,37,21,0,DF,30-34,Defender,Brazil,South America
1536,Marcelo,BRA,Real Madrid,La Liga,2019,31.0,1988.0,14.4,19,11,8,8,3,9,28,32.1,19,19,2,17,18,37,21,0,DF,30-34,Defender,Brazil,South America
1536,Marcelo,BRA,Real Madrid,La Liga,2019,31.0,1988.0,14.4,19,11,8,8,3,9,28,32.1,19,19,2,17,18,37,21,0,DF,30-34,Defender,Brazil,South America
1536,Marcelo,BRA,Real Madrid,La Liga,2019,31.0,1988.0,14.4,19,11,8,8,3,9,28,32.1,19,19,2,17,18,37,21,0,DF,30-34,Defender,Brazil,South America
1537,Marcelo,BRA,Lyon,Ligue 1,2019,32.0,1987.0,16.7,27,18,18,8,1,16,23,69.6,7,12,11,1,22,49,77,0,DF,30-34,Defender,Brazil,South America
1537,Marcelo,BRA,Lyon,Ligue 1,2019,32.0,1987.0,16.7,27,18,18,8,1,16,23,69.6,7,12,11,1,22,49,77,0,DF,30-34,Defender,Brazil,South America
1537,Marcelo,BRA,Lyon,Ligue 1,2019,32.0,1987.0,16.7,27,18,18,8,1,16,23,69.6,7,12,11,1,22,49,77,0,DF,30-34,Defender,Brazil,South America
1537,Marcelo,BRA,Lyon,Ligue 1,2019,32.0,1987.0,16.7,27,18,18,8,1,16,23,69.6,7,12,11,1,22,49,77,0,DF,30-34,Defender,Brazil,South America
1537,Marcelo,BRA,Lyon,Ligue 1,2019,32.0,1987.0,16.7,27,18,18,8,1,16,23,69.6,7,12,11,1,22,49,77,0,DF,30-34,Defender,Brazil,South America
1537,Marcelo,BRA,Lyon,Ligue 1,2019,32.0,1987.0,16.7,27,18,18,8,1,16,23,69.6,7,12,11,1,22,49,77,0,DF,30-34,Defender,Brazil,South America
1537,Marcelo,BRA,Lyon,Ligue 1,2019,32.0,1987.0,16.7,27,18,18,8,1,16,23,69.6,7,12,11,1,22,49,77,0,DF,30-34,Defender,Brazil,South America
1537,Marcelo,BRA,Lyon,Ligue 1,2019,32.0,1987.0,16.7,27,18,18,8,1,16,23,69.6,7,12,11,1,22,49,77,0,DF,30-34,Defender,Brazil,South America
1537,Marcelo,BRA,Lyon,Ligue 1,2019,32.0,1987.0,16.7,27,18,18,8,1,16,23,69.6,7,12,11,1,22,49,77,0,DF,30-34,Defender,Brazil,South America
1538,Solly March,ENG,Brighton,Premier League,2019,25.0,1994.0,12.7,25,12,16,6,3,9,19,47.4,10,16,4,12,20,45,14,2,"FW,MF",25-29,Forward,England,Europe
1539,Gian Marco Ferrari,ITA,Sassuolo,Serie A,2019,27.0,1992.0,21.1,9,5,6,3,0,4,8,50.0,4,25,22,3,26,35,41,1,DF,25-29,Defender,Italy,Europe
1541,Dario Maresic,AUT,Reims,Ligue 1,2019,19.0,1999.0,1.0,0,0,0,0,0,0,0,,0,1,1,0,1,1,6,0,DF,Under 20,Defender,Austria,Europe
1544,José María Giménez,URU,Atlético Madrid,La Liga,2019,24.0,1995.0,19.5,20,16,18,1,1,7,11,63.6,4,14,7,7,23,43,75,1,DF,20-24,Defender,Uruguay,South America
1546,Adrian Mariappa,JAM,Watford,Premier League,2019,32.0,1986.0,16.8,20,14,15,4,1,11,30,36.7,19,22,7,15,11,31,73,0,DF,30-34,Defender,Jamaica,North America
1547,Jordan Marié,FRA,Dijon,Ligue 1,2019,27.0,1991.0,2.2,7,5,4,3,0,4,9,44.4,5,3,1,2,4,11,2,0,"MF,FW",25-29,Midfielder,France,Europe
1550,Guillermo Maripán,CHI,Alavés,La Liga,2019,25.0,1994.0,1.0,1,1,1,0,0,1,2,50.0,1,0,0,0,2,3,10,0,DF,25-29,Defender,Chile,South America
1551,Guillermo Maripán,CHI,Monaco,Ligue 1,2019,25.0,1994.0,19.5,42,26,28,13,1,24,41,58.5,17,30,13,17,25,67,69,2,DF,25-29,Defender,Chile,South America
1552,Marlon,BRA,Sassuolo,Serie A,2019,23.0,1995.0,20.2,40,23,24,15,1,17,27,63.0,10,20,13,7,35,75,69,0,DF,20-24,Defender,Brazil,South America
1552,Marlon,BRA,Sassuolo,Serie A,2019,23.0,1995.0,20.2,40,23,24,15,1,17,27,63.0,10,20,13,7,35,75,69,0,DF,20-24,Defender,Brazil,South America
1552,Marlon,BRA,Sassuolo,Serie A,2019,23.0,1995.0,20.2,40,23,24,15,1,17,27,63.0,10,20,13,7,35,75,69,0,DF,20-24,Defender,Brazil,South America
1552,Marlon,BRA,Sassuolo,Serie A,2019,23.0,1995.0,20.2,40,23,24,15,1,17,27,63.0,10,20,13,7,35,75,69,0,DF,20-24,Defender,Brazil,South America
1552,Marlon,BRA,Sassuolo,Serie A,2019,23.0,1995.0,20.2,40,23,24,15,1,17,27,63.0,10,20,13,7,35,75,69,0,DF,20-24,Defender,Brazil,South America
1552,Marlon,BRA,Sassuolo,Serie A,2019,23.0,1995.0,20.2,40,23,24,15,1,17,27,63.0,10,20,13,7,35,75,69,0,DF,20-24,Defender,Brazil,South America
1552,Marlon,BRA,Sassuolo,Serie A,2019,23.0,1995.0,20.2,40,23,24,15,1,17,27,63.0,10,20,13,7,35,75,69,0,DF,20-24,Defender,Brazil,South America
1552,Marlon,BRA,Sassuolo,Serie A,2019,23.0,1995.0,20.2,40,23,24,15,1,17,27,63.0,10,20,13,7,35,75,69,0,DF,20-24,Defender,Brazil,South America
1552,Marlon,BRA,Sassuolo,Serie A,2019,23.0,1995.0,20.2,40,23,24,15,1,17,27,63.0,10,20,13,7,35,75,69,0,DF,20-24,Defender,Brazil,South America
1553,Omar Marmoush,EGY,Wolfsburg,Bundesliga,2019,20.0,1999.0,0.9,1,1,1,0,0,0,0,,0,1,0,1,1,2,0,0,"MF,FW",20-24,Midfielder,Egypt,Africa
1554,Gonzalo Maroni,ARG,Sampdoria,Serie A,2019,20.0,1999.0,2.0,3,1,1,1,1,3,7,42.9,4,1,0,1,3,6,0,0,"MF,FW",20-24,Midfielder,Argentina,South America
1555,Marquinhos,BRA,Paris S-G,Ligue 1,2019,25.0,1994.0,16.4,39,20,17,18,4,11,26,42.3,15,25,8,17,25,64,31,1,"MF,DF",25-29,Midfielder,Brazil,South America
1555,Marquinhos,BRA,Paris S-G,Ligue 1,2019,25.0,1994.0,16.4,39,20,17,18,4,11,26,42.3,15,25,8,17,25,64,31,1,"MF,DF",25-29,Midfielder,Brazil,South America
1555,Marquinhos,BRA,Paris S-G,Ligue 1,2019,25.0,1994.0,16.4,39,20,17,18,4,11,26,42.3,15,25,8,17,25,64,31,1,"MF,DF",25-29,Midfielder,Brazil,South America
1555,Marquinhos,BRA,Paris S-G,Ligue 1,2019,25.0,1994.0,16.4,39,20,17,18,4,11,26,42.3,15,25,8,17,25,64,31,1,"MF,DF",25-29,Midfielder,Brazil,South America
1555,Marquinhos,BRA,Paris S-G,Ligue 1,2019,25.0,1994.0,16.4,39,20,17,18,4,11,26,42.3,15,25,8,17,25,64,31,1,"MF,DF",25-29,Midfielder,Brazil,South America
1555,Marquinhos,BRA,Paris S-G,Ligue 1,2019,25.0,1994.0,16.4,39,20,17,18,4,11,26,42.3,15,25,8,17,25,64,31,1,"MF,DF",25-29,Midfielder,Brazil,South America
1555,Marquinhos,BRA,Paris S-G,Ligue 1,2019,25.0,1994.0,16.4,39,20,17,18,4,11,26,42.3,15,25,8,17,25,64,31,1,"MF,DF",25-29,Midfielder,Brazil,South America
1555,Marquinhos,BRA,Paris S-G,Ligue 1,2019,25.0,1994.0,16.4,39,20,17,18,4,11,26,42.3,15,25,8,17,25,64,31,1,"MF,DF",25-29,Midfielder,Brazil,South America
1555,Marquinhos,BRA,Paris S-G,Ligue 1,2019,25.0,1994.0,16.4,39,20,17,18,4,11,26,42.3,15,25,8,17,25,64,31,1,"MF,DF",25-29,Midfielder,Brazil,South America
1556,Bruno Martella,ITA,Brescia,Serie A,2019,26.0,1992.0,14.1,18,9,14,3,1,9,16,56.3,7,13,7,6,17,35,48,1,DF,25-29,Defender,Italy,Europe
1561,David Martin,ENG,West Ham,Premier League,2019,33.0,1986.0,4.8,0,0,0,0,0,0,0,,0,0,0,0,0,0,1,1,GK,30-34,Goalkeeper,England,Europe
1562,Jonas Martin,FRA,Rennes,Ligue 1,2019,29.0,1990.0,1.3,6,2,4,0,2,1,1,100.0,0,2,2,0,0,6,0,0,MF,25-29,Midfielder,France,Europe
1563,Jonas Martin,FRA,Strasbourg,Ligue 1,2019,29.0,1990.0,2.7,5,3,4,0,1,1,3,33.3,2,3,0,3,1,6,3,0,MF,25-29,Midfielder,France,Europe
1565,Gabriel Martinelli,BRA,Arsenal,Premier League,2019,18.0,2001.0,7.4,20,15,10,6,4,7,20,35.0,13,15,1,14,3,23,8,0,FW,Under 20,Forward,Brazil,South America
1567,Emiliano Martínez,ARG,Arsenal,Premier League,2019,26.0,1992.0,8.6,0,0,0,0,0,0,0,,0,0,0,0,0,0,1,0,GK,25-29,Goalkeeper,Argentina,South America
1567,Emiliano Martínez,ARG,Arsenal,Premier League,2019,26.0,1992.0,8.6,0,0,0,0,0,0,0,,0,0,0,0,0,0,1,0,GK,25-29,Goalkeeper,Argentina,South America
1567,Emiliano Martínez,ARG,Arsenal,Premier League,2019,26.0,1992.0,8.6,0,0,0,0,0,0,0,,0,0,0,0,0,0,1,0,GK,25-29,Goalkeeper,Argentina,South America
1567,Emiliano Martínez,ARG,Arsenal,Premier League,2019,26.0,1992.0,8.6,0,0,0,0,0,0,0,,0,0,0,0,0,0,1,0,GK,25-29,Goalkeeper,Argentina,South America
1572,Lautaro Martínez,ARG,Inter,Serie A,2019,21.0,1997.0,27.2,22,7,2,8,12,4,34,11.8,30,30,2,28,15,37,11,0,FW,20-24,Forward,Argentina,South America
1577,Omar Mascarell,EQG,Schalke 04,Bundesliga,2019,26.0,1993.0,22.5,42,23,17,22,3,21,57,36.8,36,46,14,32,62,104,40,0,MF,25-29,Midfielder,Equatorial Guinea,Africa
1578,Andrea Masiello,ITA,Genoa,Serie A,2019,33.0,1986.0,14.7,26,15,17,8,1,16,32,50.0,16,8,2,6,26,52,55,2,DF,30-34,Defender,Italy,Europe
1579,Andrea Masiello,ITA,Atalanta,Serie A,2019,33.0,1986.0,6.0,11,4,6,4,1,7,14,50.0,7,6,4,2,10,21,13,0,DF,30-34,Defender,Italy,Europe
1580,Adam Masina,MAR,Watford,Premier League,2019,25.0,1994.0,20.2,38,22,24,11,3,14,37,37.8,23,26,12,14,28,66,66,0,DF,25-29,Defender,Morocco,Africa
1586,Jean-Philippe Mateta,FRA,Mainz 05,Bundesliga,2019,22.0,1997.0,11.7,2,2,0,2,0,0,6,0.0,6,3,2,1,1,3,11,0,FW,20-24,Forward,France,Europe
1590,Alessandro Matri,ITA,Brescia,Serie A,2019,34.0,1984.0,1.0,1,0,0,0,1,0,0,,0,1,0,1,0,1,1,0,"FW,MF",30-34,Forward,Italy,Europe
1592,Blaise Matuidi,FRA,Juventus,Serie A,2019,32.0,1987.0,24.9,48,27,13,27,8,13,34,38.2,21,35,6,29,22,70,16,0,MF,30-34,Midfielder,France,Europe
1593,Neal Maupay,FRA,Brighton,Premier League,2019,22.0,1996.0,30.7,20,12,1,13,6,9,29,31.0,20,24,0,24,4,24,10,0,FW,20-24,Forward,France,Europe
1594,Stephy Mavididi,ENG,Dijon,Ligue 1,2019,21.0,1998.0,15.5,18,11,7,8,3,10,26,38.5,16,11,0,11,7,25,5,0,"FW,MF",20-24,Forward,England,Europe
1600,Luca Mazzitelli,ITA,Sassuolo,Serie A,2019,23.0,1995.0,0.1,1,1,0,1,0,1,1,100.0,0,0,0,0,0,1,0,0,MF,20-24,Midfielder,Italy,Europe
1602,Kylian Mbappé,FRA,Paris S-G,Ligue 1,2019,20.0,1998.0,16.8,7,2,1,5,1,3,10,30.0,7,4,0,4,3,10,0,0,FW,20-24,Forward,France,Europe
1603,Ibrahima Mbaye,SEN,Bologna,Serie A,2019,24.0,1994.0,16.7,19,10,13,4,2,7,17,41.2,10,22,11,11,15,34,42,0,DF,20-24,Defender,Senegal,Africa
1607,James McArthur,SCO,Crystal Palace,Premier League,2019,31.0,1987.0,34.3,88,51,43,34,11,37,106,34.9,69,69,19,50,60,148,56,0,MF,30-34,Midfielder,Scotland,Europe
1609,Alex McCarthy,ENG,Southampton,Premier League,2019,29.0,1989.0,28.0,1,1,1,0,0,1,1,100.0,0,1,0,1,0,1,11,3,GK,25-29,Goalkeeper,England,Europe
1611,John McGinn,SCO,Aston Villa,Premier League,2019,24.0,1994.0,25.7,53,35,19,23,11,18,62,29.0,44,25,1,24,25,78,18,0,MF,20-24,Midfielder,Scotland,Europe
1612,David McGoldrick,IRL,Sheffield Utd,Premier League,2019,31.0,1987.0,20.2,41,26,9,24,8,5,20,25.0,15,14,2,12,3,44,23,0,FW,30-34,Forward,Republic of Ireland,Europe
1614,Weston McKennie,USA,Schalke 04,Bundesliga,2019,20.0,1998.0,23.0,38,20,17,16,5,13,40,32.5,27,38,12,26,46,84,39,0,"MF,DF",20-24,Midfielder,United States,North America
1615,Kenny McLean,SCO,Norwich City,Premier League,2019,27.0,1992.0,33.0,44,29,20,18,6,14,42,33.3,28,32,7,25,38,82,67,2,MF,25-29,Midfielder,Scotland,Europe
1616,Dwight McNeil,ENG,Burnley,Premier League,2019,19.0,1999.0,37.1,47,33,18,22,7,23,71,32.4,48,60,8,52,30,77,34,0,MF,Under 20,Midfielder,England,Europe
1617,Scott McTominay,SCO,Manchester Utd,Premier League,2019,22.0,1996.0,19.7,43,22,14,25,4,17,32,53.1,15,25,5,20,31,74,34,2,MF,20-24,Midfielder,Scotland,Europe
1618,Biagio Meccariello,ITA,Lecce,Serie A,2019,28.0,1991.0,8.5,23,13,15,6,2,12,29,41.4,17,14,2,12,10,33,25,0,DF,25-29,Defender,Italy,Europe
1619,Gary Medel,CHI,Bologna,Serie A,2019,31.0,1987.0,19.8,43,22,15,24,4,16,43,37.2,27,24,8,16,34,77,31,2,MF,30-34,Midfielder,Chile,South America
1620,Ben Mee,ENG,Burnley,Premier League,2019,29.0,1989.0,32.0,41,22,25,16,0,17,29,58.6,12,42,31,11,42,83,165,2,DF,25-29,Defender,England,Europe
1621,Joshua Mees,GER,Union Berlin,Bundesliga,2019,23.0,1996.0,3.6,8,5,3,4,1,4,12,33.3,8,3,0,3,2,10,4,0,"MF,FW",20-24,Midfielder,Germany,Europe
1624,Farid El Melali,ALG,Angers,Ligue 1,2019,22.0,1997.0,3.4,7,5,2,2,3,4,14,28.6,10,5,0,5,2,9,4,0,"MF,FW",20-24,Midfielder,Algeria,Africa
1627,Arthur Melo,BRA,Barcelona,La Liga,2019,22.0,1996.0,13.1,15,10,4,7,4,4,12,33.3,8,9,0,9,4,19,5,2,MF,20-24,Midfielder,Brazil,South America
1630,Thiago Mendes,BRA,Lyon,Ligue 1,2019,27.0,1992.0,20.1,43,29,20,19,4,21,45,46.7,24,21,7,14,46,89,36,0,MF,25-29,Midfielder,Brazil,South America
1634,Alexandre Mendy,GNB,Brest,Ligue 1,2019,25.0,1994.0,10.0,5,1,1,0,4,1,4,25.0,3,4,1,3,0,5,10,0,FW,25-29,Forward,Guinea-Bissau,Africa
1635,Benjamin Mendy,FRA,Manchester City,Premier League,2019,25.0,1994.0,16.6,18,15,7,7,4,9,27,33.3,18,10,2,8,16,34,21,3,DF,25-29,Defender,France,Europe
1636,Edouard Mendy,SEN,Rennes,Ligue 1,2019,27.0,1992.0,24.0,0,0,0,0,0,0,0,,0,0,0,0,0,0,5,1,GK,25-29,Goalkeeper,Senegal,Africa
1637,Ferland Mendy,FRA,Real Madrid,La Liga,2019,24.0,1995.0,20.1,32,26,20,9,3,14,18,77.8,4,19,5,14,22,54,30,1,DF,20-24,Defender,France,Europe
1638,Nampalys Mendy,SEN,Leicester City,Premier League,2019,27.0,1992.0,3.2,7,5,4,1,2,4,5,80.0,1,4,1,3,6,13,6,0,MF,25-29,Midfielder,Senegal,Africa
1640,Chris Mepham,WAL,Bournemouth,Premier League,2019,21.0,1997.0,10.1,20,9,13,7,0,11,14,78.6,3,17,11,6,17,37,62,1,DF,20-24,Defender,Wales,Europe
1643,Alex Meret,ITA,Napoli,Serie A,2019,22.0,1997.0,21.7,0,0,0,0,0,0,2,0.0,2,1,0,1,1,1,7,2,GK,20-24,Goalkeeper,Italy,Europe
1650,Lionel Messi,ARG,Barcelona,La Liga,2019,32.0,1987.0,32.0,21,10,4,7,10,3,21,14.3,18,9,0,9,7,28,1,0,FW,30-34,Forward,Argentina,South America
1651,Thomas Meunier,BEL,Paris S-G,Ligue 1,2019,27.0,1991.0,13.8,27,21,9,12,6,16,26,61.5,10,17,5,12,18,45,19,1,DF,25-29,Defender,Belgium,Europe
1654,Kingsley Michael,NGA,Bologna,Serie A,2019,19.0,1999.0,0.8,2,1,0,2,0,0,0,,0,0,0,0,1,3,1,0,MF,Under 20,Midfielder,Nigeria,Africa
1656,Sven Michel,GER,Paderborn 07,Bundesliga,2019,29.0,1990.0,15.3,14,12,3,5,6,3,20,15.0,17,13,2,11,7,21,7,0,FW,25-29,Forward,Germany,Europe
1663,Éder Militão,BRA,Real Madrid,La Liga,2019,21.0,1998.0,11.4,25,15,15,9,1,10,17,58.8,7,12,6,6,20,45,42,0,DF,20-24,Defender,Brazil,South America
1665,Vincenzo Millico,ITA,Torino,Serie A,2019,18.0,2000.0,2.4,1,0,1,0,0,1,3,33.3,2,2,0,2,0,1,1,0,"MF,FW",Under 20,Midfielder,Italy,Europe
1666,James Milner,ENG,Liverpool,Premier League,2019,33.0,1986.0,10.4,16,10,3,10,3,6,26,23.1,20,12,3,9,7,23,17,1,"MF,DF",30-34,Midfielder,England,Europe
1668,Yerry Mina,COL,Everton,Premier League,2019,24.0,1994.0,25.4,39,22,25,12,2,18,24,75.0,6,20,14,6,28,67,102,1,DF,20-24,Defender,Colombia,South America
1669,Takumi Minamino,JPN,Liverpool,Premier League,2019,24.0,1995.0,2.8,3,3,0,2,1,2,10,20.0,8,3,0,3,0,3,3,0,"FW,MF",20-24,Forward,Japan,Asia
1670,Tyrone Mings,ENG,Aston Villa,Premier League,2019,26.0,1993.0,32.2,15,11,11,3,1,10,13,76.9,3,56,48,8,30,45,190,4,DF,25-29,Defender,England,Europe
1673,Antonio Mirante,ITA,Roma,Serie A,2019,36.0,1983.0,5.0,0,0,0,0,0,0,1,0.0,1,0,0,0,0,0,2,1,GK,35-39,Goalkeeper,Italy,Europe
1674,Simone Missiroli,ITA,SPAL,Serie A,2019,33.0,1986.0,31.1,42,27,18,20,4,13,43,30.2,30,42,27,15,54,96,62,1,MF,30-34,Midfielder,Italy,Europe
1677,Maximilian Mittelstädt,GER,Hertha BSC,Bundesliga,2019,22.0,1997.0,21.0,61,38,31,25,5,26,54,48.1,28,38,6,32,53,114,64,0,"DF,FW",20-24,Defender,Germany,Europe
1678,Henrikh Mkhitaryan,ARM,Arsenal,Premier League,2019,30.0,1989.0,1.2,0,0,0,0,0,0,2,0.0,2,3,0,3,0,0,1,0,FW,30-34,Forward,Armenia,Asia
1679,Henrikh Mkhitaryan,ARM,Roma,Serie A,2019,30.0,1989.0,17.0,32,22,10,17,5,19,45,42.2,26,27,3,24,11,43,6,0,"MF,FW",30-34,Midfielder,Armenia,Asia
1680,Anthony Modeste,FRA,Köln,Bundesliga,2019,31.0,1988.0,12.6,10,5,1,5,4,1,10,10.0,9,5,3,2,0,10,19,0,FW,30-34,Forward,France,Europe
1683,Niklas Moisander,FIN,Werder Bremen,Bundesliga,2019,33.0,1985.0,22.0,27,15,19,6,2,11,26,42.3,15,37,19,18,49,76,85,0,DF,30-34,Defender,Finland,Europe
1685,Florent Mollet,FRA,Montpellier,Ligue 1,2019,27.0,1991.0,18.7,13,11,3,8,2,7,28,25.0,21,9,1,8,9,22,2,0,"MF,FW",25-29,Midfielder,France,Europe
1687,Gabriele Moncini,ITA,SPAL,Serie A,2019,23.0,1996.0,1.7,1,0,0,1,0,0,0,,0,2,1,1,1,2,0,0,"FW,MF",20-24,Forward,Italy,Europe
1688,Thomas Monconduit,FRA,Amiens,Ligue 1,2019,28.0,1991.0,15.2,26,12,6,18,2,9,26,34.6,17,11,4,7,10,36,25,3,MF,25-29,Midfielder,France,Europe
1695,Simon Moore,ENG,Sheffield Utd,Premier League,2019,29.0,1990.0,2.0,1,0,1,0,0,1,1,100.0,0,0,0,0,0,1,0,1,GK,25-29,Goalkeeper,England,Europe
1697,Wesley Moraes,BRA,Aston Villa,Premier League,2019,22.0,1996.0,19.8,15,8,3,8,4,0,5,0.0,5,10,2,8,4,19,23,0,FW,20-24,Forward,Brazil,South America
1698,Alfredo Morales,USA,Düsseldorf,Bundesliga,2019,29.0,1990.0,19.2,31,15,11,16,4,11,35,31.4,24,17,6,11,18,49,37,0,MF,25-29,Midfielder,United States,North America
1701,Steven Moreira,CPV,Toulouse,Ligue 1,2019,24.0,1994.0,15.4,37,25,21,15,1,19,31,61.3,12,16,3,13,16,53,29,0,DF,20-24,Defender,Cape Verde,Africa
1702,Jérémy Morel,MAD,Rennes,Ligue 1,2019,35.0,1984.0,20.1,15,9,13,1,1,9,20,45.0,11,21,17,4,17,32,59,1,DF,35-39,Defender,Madagascar,Africa
1707,Wes Morgan,JAM,Leicester City,Premier League,2019,35.0,1984.0,4.8,4,1,3,1,0,0,3,0.0,3,5,3,2,7,11,19,0,DF,35-39,Defender,Jamaica,North America
1711,Leonardo Morosini,ITA,Brescia,Serie A,2019,23.0,1995.0,0.3,1,1,1,0,0,0,0,,0,1,0,1,1,2,1,0,"FW,DF",20-24,Forward,Italy,Europe
1714,Lebo Mothiba,RSA,Strasbourg,Ligue 1,2019,23.0,1996.0,11.6,4,3,1,1,2,1,6,16.7,5,5,0,5,3,7,1,0,FW,20-24,Forward,South Africa,Africa
1716,Jessy Moulin,FRA,Saint-Étienne,Ligue 1,2019,33.0,1986.0,5.0,0,0,0,0,0,0,0,,0,0,0,0,1,1,2,0,GK,30-34,Goalkeeper,France,Europe
1717,Mason Mount,ENG,Chelsea,Premier League,2019,20.0,1999.0,31.9,37,17,8,19,10,9,42,21.4,33,25,3,22,16,53,18,0,"MF,FW",20-24,Midfielder,England,Europe
1718,Lucas Moura,BRA,Tottenham,Premier League,2019,26.0,1992.0,24.9,57,33,25,22,10,16,58,27.6,42,29,2,27,15,72,27,0,"FW,MF",25-29,Forward,Brazil,South America
1719,Lys Mousset,FRA,Sheffield Utd,Premier League,2019,23.0,1996.0,13.8,9,5,0,5,4,3,7,42.9,4,3,0,3,4,13,2,0,FW,20-24,Forward,France,Europe
1720,Wesley Moustache,FRA,Nantes,Ligue 1,2019,20.0,1999.0,0.5,0,0,0,0,0,0,0,,0,1,0,1,0,0,2,0,DF,20-24,Defender,France,Europe
1721,João Moutinho,POR,Wolves,Premier League,2019,32.0,1986.0,34.5,93,50,43,41,9,46,139,33.1,93,43,13,30,50,143,18,1,MF,30-34,Midfielder,Portugal,Europe
1721,João Moutinho,POR,Wolves,Premier League,2019,32.0,1986.0,34.5,93,50,43,41,9,46,139,33.1,93,43,13,30,50,143,18,1,MF,30-34,Midfielder,Portugal,Europe
1721,João Moutinho,POR,Wolves,Premier League,2019,32.0,1986.0,34.5,93,50,43,41,9,46,139,33.1,93,43,13,30,50,143,18,1,MF,30-34,Midfielder,Portugal,Europe
1721,João Moutinho,POR,Wolves,Premier League,2019,32.0,1986.0,34.5,93,50,43,41,9,46,139,33.1,93,43,13,30,50,143,18,1,MF,30-34,Midfielder,Portugal,Europe
1725,Nordi Mukiele,FRA,RB Leipzig,Bundesliga,2019,21.0,1997.0,19.8,61,39,39,12,10,25,38,65.8,13,26,4,22,47,108,57,0,"DF,FW",20-24,Defender,France,Europe
1727,Florian Müller,GER,Mainz 05,Bundesliga,2019,21.0,1997.0,12.5,0,0,0,0,0,0,0,,0,0,0,0,2,2,3,1,GK,20-24,Goalkeeper,Germany,Europe
1728,Thomas Müller,GER,Bayern Munich,Bundesliga,2019,29.0,1989.0,25.1,45,27,7,26,12,22,69,31.9,47,27,3,24,12,57,8,0,"MF,FW",25-29,Midfielder,Germany,Europe
1729,Marshall Munetsi,ZIM,Reims,Ligue 1,2019,23.0,1996.0,9.3,27,19,12,12,3,6,12,50.0,6,13,7,6,12,39,20,1,MF,20-24,Midfielder,Zimbabwe,Africa
1733,Simone Muratore,ITA,Juventus,Serie A,2019,21.0,1998.0,1.8,2,0,0,1,1,1,3,33.3,2,1,0,1,3,5,0,0,MF,20-24,Midfielder,Italy,Europe
1734,Alessandro Murgia,ITA,SPAL,Serie A,2019,22.0,1996.0,19.4,27,17,16,8,3,14,34,41.2,20,10,3,7,18,45,15,0,MF,20-24,Midfielder,Italy,Europe
1735,Luis Muriel,COL,Atalanta,Serie A,2019,28.0,1991.0,14.0,15,9,3,8,4,3,14,21.4,11,12,0,12,4,19,0,0,FW,25-29,Forward,Colombia,South America
1736,Jeison Murillo,COL,Sampdoria,Serie A,2019,27.0,1992.0,7.4,18,6,14,4,0,10,19,52.6,9,8,4,4,10,28,28,0,DF,25-29,Defender,Colombia,South America
1737,Jeison Murillo,COL,Celta Vigo,La Liga,2019,27.0,1992.0,17.0,37,20,30,6,1,18,27,66.7,9,13,9,4,20,57,74,2,DF,25-29,Defender,Colombia,South America
1738,Glenn Murray,ENG,Brighton,Premier League,2019,35.0,1983.0,8.9,5,2,0,3,2,2,9,22.2,7,6,2,4,1,6,12,0,FW,35-39,Forward,England,Europe
1739,Nicola Murru,ITA,Sampdoria,Serie A,2019,24.0,1994.0,25.1,40,22,24,8,8,21,41,51.2,20,22,4,18,27,67,58,0,DF,20-24,Defender,Italy,Europe
1740,Mateo Musacchio,ARG,Milan,Serie A,2019,28.0,1990.0,16.3,15,8,11,4,0,7,20,35.0,13,10,7,3,22,37,50,0,DF,25-29,Defender,Argentina,South America
1741,Torben Müsel,GER,Gladbach,Bundesliga,2019,20.0,1999.0,0.0,0,0,0,0,0,0,0,,0,0,0,0,1,1,0,0,FW,20-24,Forward,Germany,Europe
1743,Juan Musso,ARG,Udinese,Serie A,2019,25.0,1994.0,38.0,0,0,0,0,0,0,1,0.0,1,0,0,0,1,1,18,2,GK,25-29,Goalkeeper,Argentina,South America
1744,Shkodran Mustafi,GER,Arsenal,Premier League,2019,27.0,1992.0,13.4,17,10,11,5,1,6,12,50.0,6,10,6,4,18,35,72,0,DF,25-29,Defender,Germany,Europe
1746,Yvon Mvogo,SUI,RB Leipzig,Bundesliga,2019,25.0,1994.0,2.0,0,0,0,0,0,0,0,,0,0,0,0,0,0,0,1,GK,25-29,Goalkeeper,Switzerland,Europe
1747,Phillipp Mwene,AUT,Mainz 05,Bundesliga,2019,25.0,1994.0,3.5,11,5,9,2,0,7,12,58.3,5,10,1,9,3,14,11,0,DF,25-29,Defender,Austria,Europe
1749,Kévin N'Doram,FRA,Metz,Ligue 1,2019,23.0,1996.0,18.3,43,28,19,21,3,17,40,42.5,23,20,8,12,26,69,23,0,MF,20-24,Midfielder,France,Europe
1751,Ferris N'Goma,FRA,Brest,Ligue 1,2019,26.0,1993.0,0.3,0,0,0,0,0,0,0,,0,1,0,1,0,0,0,0,"MF,FW",25-29,Midfielder,France,Europe
1758,Marvelous Nakamba,ZIM,Aston Villa,Premier League,2019,25.0,1994.0,20.4,55,28,28,20,7,24,67,35.8,43,50,11,39,39,94,38,3,MF,25-29,Midfielder,Zimbabwe,Africa
1759,Naldo,BRA,Espanyol,La Liga,2019,30.0,1988.0,14.8,24,13,15,9,0,7,15,46.7,8,11,7,4,21,45,50,1,DF,30-34,Defender,Brazil,South America
1759,Naldo,BRA,Espanyol,La Liga,2019,30.0,1988.0,14.8,24,13,15,9,0,7,15,46.7,8,11,7,4,21,45,50,1,DF,30-34,Defender,Brazil,South America
1759,Naldo,BRA,Espanyol,La Liga,2019,30.0,1988.0,14.8,24,13,15,9,0,7,15,46.7,8,11,7,4,21,45,50,1,DF,30-34,Defender,Brazil,South America
1759,Naldo,BRA,Espanyol,La Liga,2019,30.0,1988.0,14.8,24,13,15,9,0,7,15,46.7,8,11,7,4,21,45,50,1,DF,30-34,Defender,Brazil,South America
1760,Nahitan Nández,URU,Cagliari,Serie A,2019,23.0,1995.0,32.2,58,38,37,17,4,25,69,36.2,44,30,1,29,25,83,26,0,"MF,DF",20-24,Midfielder,Uruguay,South America
1765,Keylor Navas,CRC,Paris S-G,Ligue 1,2019,32.0,1986.0,21.0,0,0,0,0,0,0,0,,0,1,0,1,0,0,4,2,GK,30-34,Goalkeeper,Costa Rica,North America
1768,Papa Ndiaga Yade,MTN,Metz,Ligue 1,2019,19.0,2000.0,0.0,0,0,0,0,0,0,0,,0,0,0,0,0,0,0,0,FW,Under 20,Forward,Mauritania,Africa
1769,Wilfred Ndidi,NGA,Leicester City,Premier League,2019,22.0,1996.0,29.7,128,67,56,61,11,45,91,49.5,46,52,6,46,80,208,69,3,MF,20-24,Midfielder,Nigeria,Africa
1770,Emanuele Ndoj,ALB,Brescia,Serie A,2019,22.0,1996.0,6.2,9,6,2,6,1,3,13,23.1,10,7,0,7,5,14,5,0,MF,20-24,Midfielder,Albania,Europe
1772,Reiss Nelson,ENG,Arsenal,Premier League,2019,19.0,1999.0,7.0,11,8,5,4,2,7,17,41.2,10,13,2,11,3,14,3,0,FW,Under 20,Forward,England,Europe
1773,Ilija Nestorovski,MKD,Udinese,Serie A,2019,29.0,1990.0,13.9,10,7,5,5,0,6,21,28.6,15,13,2,11,4,14,12,0,FW,25-29,Forward,North Macedonia,Europe
1774,Neto,BRA,Barcelona,La Liga,2019,30.0,1989.0,2.0,0,0,0,0,0,0,0,,0,0,0,0,0,0,1,0,GK,30-34,Goalkeeper,Brazil,South America
1774,Neto,BRA,Barcelona,La Liga,2019,30.0,1989.0,2.0,0,0,0,0,0,0,0,,0,0,0,0,0,0,1,0,GK,30-34,Goalkeeper,Brazil,South America
1774,Neto,BRA,Barcelona,La Liga,2019,30.0,1989.0,2.0,0,0,0,0,0,0,0,,0,0,0,0,0,0,1,0,GK,30-34,Goalkeeper,Brazil,South America
1774,Neto,BRA,Barcelona,La Liga,2019,30.0,1989.0,2.0,0,0,0,0,0,0,0,,0,0,0,0,0,0,1,0,GK,30-34,Goalkeeper,Brazil,South America
1774,Neto,BRA,Barcelona,La Liga,2019,30.0,1989.0,2.0,0,0,0,0,0,0,0,,0,0,0,0,0,0,1,0,GK,30-34,Goalkeeper,Brazil,South America
1774,Neto,BRA,Barcelona,La Liga,2019,30.0,1989.0,2.0,0,0,0,0,0,0,0,,0,0,0,0,0,0,1,0,GK,30-34,Goalkeeper,Brazil,South America
1774,Neto,BRA,Barcelona,La Liga,2019,30.0,1989.0,2.0,0,0,0,0,0,0,0,,0,0,0,0,0,0,1,0,GK,30-34,Goalkeeper,Brazil,South America
1774,Neto,BRA,Barcelona,La Liga,2019,30.0,1989.0,2.0,0,0,0,0,0,0,0,,0,0,0,0,0,0,1,0,GK,30-34,Goalkeeper,Brazil,South America
1774,Neto,BRA,Barcelona,La Liga,2019,30.0,1989.0,2.0,0,0,0,0,0,0,0,,0,0,0,0,0,0,1,0,GK,30-34,Goalkeeper,Brazil,South America
1775,Pedro Neto,POR,Wolves,Premier League,2019,19.0,2000.0,10.4,9,4,3,6,0,4,15,26.7,11,2,0,2,6,15,4,0,"FW,MF",Under 20,Forward,Portugal,Europe
1776,Manuel Neuer,GER,Bayern Munich,Bundesliga,2019,33.0,1986.0,33.0,2,1,1,0,1,2,4,50.0,2,0,0,0,0,2,15,4,GK,30-34,Goalkeeper,Germany,Europe
1777,Florian Neuhaus,GER,Gladbach,Bundesliga,2019,22.0,1997.0,26.2,42,23,13,22,7,12,54,22.2,42,24,4,20,27,69,8,0,MF,20-24,Midfielder,Germany,Europe
1779,Rúben Neves,POR,Wolves,Premier League,2019,22.0,1997.0,34.0,62,33,27,32,3,34,86,39.5,52,38,9,29,56,118,34,1,MF,20-24,Midfielder,Portugal,Europe
1780,Neymar,BRA,Paris S-G,Ligue 1,2019,27.0,1992.0,14.6,12,7,1,9,2,3,21,14.3,18,10,0,10,4,16,1,0,"MF,FW",25-29,Midfielder,Brazil,South America
1782,Jessic Ngankam,GER,Hertha BSC,Bundesliga,2019,19.0,2000.0,0.9,2,2,1,1,0,2,2,100.0,0,2,0,2,0,2,1,0,"FW,MF",Under 20,Forward,Germany,Europe
1785,Opa Nguette,SEN,Metz,Ligue 1,2019,25.0,1994.0,20.3,44,28,23,15,6,11,39,28.2,28,17,3,14,12,56,12,0,FW,25-29,Forward,Senegal,Africa
1787,Ibrahima Niane,SEN,Metz,Ligue 1,2019,20.0,1999.0,10.6,8,7,2,5,1,5,16,31.3,11,5,1,4,10,18,11,1,FW,20-24,Forward,Senegal,Africa
1789,Tanguy Nianzou,FRA,Paris S-G,Ligue 1,2019,17.0,2002.0,5.0,2,1,0,1,1,1,3,33.3,2,4,2,2,3,5,6,0,"DF,MF",Under 20,Defender,France,Europe
1790,Cheikh Niasse,SEN,Lille,Ligue 1,2019,19.0,2000.0,0.2,0,0,0,0,0,0,0,,0,0,0,0,0,0,0,0,MF,Under 20,Midfielder,Senegal,Africa
1791,Oumar Niasse,SEN,Everton,Premier League,2019,29.0,1990.0,0.2,4,0,0,2,2,0,0,,0,0,0,0,1,5,0,0,FW,25-29,Forward,Senegal,Africa
1792,Moritz Nicolas,GER,Union Berlin,Bundesliga,2019,21.0,1997.0,1.0,0,0,0,0,0,0,0,,0,0,0,0,0,0,0,0,GK,20-24,Goalkeeper,Germany,Europe
1793,Florian Niederlechner,GER,Augsburg,Bundesliga,2019,28.0,1990.0,30.2,21,13,7,9,5,4,21,19.0,17,21,5,16,8,29,38,0,"FW,MF",25-29,Forward,Germany,Europe
1795,Casimir Ninga,CHA,Angers,Ligue 1,2019,26.0,1993.0,7.6,5,5,4,0,1,1,5,20.0,4,5,0,5,3,8,2,0,"MF,FW",25-29,Midfielder,Chad,Africa
1798,Eddie Nketiah,ENG,Arsenal,Premier League,2019,20.0,1999.0,7.0,7,5,3,4,0,2,6,33.3,4,9,0,9,2,9,5,0,FW,20-24,Forward,England,Europe
1800,Christopher Nkunku,FRA,RB Leipzig,Bundesliga,2019,21.0,1997.0,21.4,21,13,4,11,6,9,33,27.3,24,25,2,23,20,41,8,0,"MF,FW",20-24,Midfielder,France,Europe
1801,Lukas Nmecha,GER,Wolfsburg,Bundesliga,2019,20.0,1998.0,1.5,0,0,0,0,0,0,0,,0,0,0,0,0,0,0,0,"MF,FW",20-24,Midfielder,Germany,Europe
1802,Mark Noble,ENG,West Ham,Premier League,2019,32.0,1987.0,29.7,52,30,19,28,5,22,64,34.4,42,20,6,14,20,72,10,1,MF,30-34,Midfielder,England,Europe
1805,Arnaud Nordin,FRA,Saint-Étienne,Ligue 1,2019,21.0,1998.0,10.1,7,3,3,3,1,4,13,30.8,9,11,1,10,4,11,6,0,"FW,MF",20-24,Forward,France,Europe
1808,Alexander Nübel,GER,Schalke 04,Bundesliga,2019,22.0,1996.0,25.7,0,0,0,0,0,0,0,,0,0,0,0,2,2,9,6,GK,20-24,Goalkeeper,Germany,Europe
1814,Allan Nyom,CMR,Getafe,La Liga,2019,31.0,1988.0,26.9,45,25,26,15,4,20,37,54.1,17,24,5,19,14,59,50,1,"DF,MF",30-34,Defender,Cameroon,Africa
1816,Jack O'Connell,ENG,Sheffield Utd,Premier League,2019,25.0,1994.0,32.4,23,14,15,6,2,10,20,50.0,10,38,17,21,42,65,154,1,DF,25-29,Defender,England,Europe
1817,Michael Obafemi,IRL,Southampton,Premier League,2019,19.0,2000.0,7.4,7,3,1,3,3,2,14,14.3,12,3,0,3,6,13,0,0,FW,Under 20,Forward,Republic of Ireland,Europe
1818,Pedro Obiang,EQG,Sassuolo,Serie A,2019,27.0,1992.0,18.6,46,31,21,19,6,19,40,47.5,21,24,10,14,21,67,31,1,MF,25-29,Midfielder,Equatorial Guinea,Africa
1821,Lucas Ocampos,ARG,Sevilla,La Liga,2019,25.0,1994.0,30.5,54,31,30,19,5,30,72,41.7,42,33,2,31,22,76,27,0,"FW,MF",25-29,Forward,Argentina,South America
1822,Bastian Oczipka,GER,Schalke 04,Bundesliga,2019,30.0,1989.0,33.5,72,50,42,21,9,36,62,58.1,26,35,6,29,37,109,68,0,DF,30-34,Defender,Germany,Europe
1825,Kelvin Ofori,GHA,Düsseldorf,Bundesliga,2019,18.0,2001.0,0.4,0,0,0,0,0,0,0,,0,0,0,0,0,0,0,0,MF,Under 20,Midfielder,Ghana,Africa
1826,Angelo Ogbonna,ITA,West Ham,Premier League,2019,31.0,1988.0,31.0,38,24,20,14,4,18,32,56.3,14,50,32,18,27,65,134,1,DF,30-34,Defender,Italy,Europe
1831,Christian Oliva,URU,Cagliari,Serie A,2019,23.0,1996.0,5.2,13,7,9,4,0,5,15,33.3,10,5,0,5,7,20,14,0,MF,20-24,Midfielder,Uruguay,South America
1835,Mathías Olivera,URU,Getafe,La Liga,2019,21.0,1997.0,20.8,64,40,34,16,14,27,45,60.0,18,32,3,29,23,87,44,0,DF,20-24,Defender,Uruguay,South America
1837,Marco Olivieri,ITA,Juventus,Serie A,2019,20.0,1999.0,0.3,1,1,1,0,0,1,2,50.0,1,0,0,0,0,1,0,0,FW,20-24,Forward,Italy,Europe
1839,Robin Olsen,SWE,Cagliari,Serie A,2019,29.0,1990.0,16.9,0,0,0,0,0,0,1,0.0,1,0,0,0,0,0,8,0,GK,25-29,Goalkeeper,Sweden,Europe
1841,Jean Onana,CMR,Lille,Ligue 1,2019,19.0,2000.0,0.9,0,0,0,0,0,0,2,0.0,2,1,0,1,1,1,0,0,MF,Under 20,Midfielder,Cameroon,Africa
1842,Karim Onisiwo,AUT,Mainz 05,Bundesliga,2019,27.0,1992.0,19.2,27,19,6,10,11,5,13,38.5,8,20,3,17,7,34,11,0,FW,25-29,Forward,Austria,Europe
1848,Fabián Orellana,CHI,Eibar,La Liga,2019,33.0,1986.0,26.6,29,18,10,6,13,14,52,26.9,38,9,0,9,20,49,2,0,"MF,FW",30-34,Midfielder,Chile,South America
1849,Divock Origi,BEL,Liverpool,Premier League,2019,24.0,1995.0,8.0,12,9,2,5,5,4,9,44.4,5,2,0,2,4,16,5,0,FW,20-24,Forward,Belgium,Europe
1851,Riccardo Orsolini,ITA,Bologna,Serie A,2019,22.0,1997.0,29.8,36,22,21,10,5,12,47,25.5,35,23,1,22,16,52,20,0,"FW,MF",20-24,Forward,Italy,Europe
1852,Yuya Osako,JPN,Werder Bremen,Bundesliga,2019,29.0,1990.0,20.5,29,16,5,19,5,3,29,10.3,26,10,1,9,6,35,13,1,"FW,MF",25-29,Forward,Japan,Asia
1853,Ben Osborn,ENG,Sheffield Utd,Premier League,2019,24.0,1994.0,6.6,15,10,11,3,1,3,16,18.8,13,6,1,5,6,21,7,0,"MF,DF",20-24,Midfielder,England,Europe
1855,David Ospina,COL,Napoli,Serie A,2019,30.0,1988.0,16.3,0,0,0,0,0,0,0,,0,0,0,0,0,0,2,1,GK,30-34,Goalkeeper,Colombia,South America
1857,Otávio,BRA,Bordeaux,Ligue 1,2019,25.0,1994.0,24.6,80,45,23,52,5,35,82,42.7,47,26,9,17,41,121,40,6,MF,25-29,Midfielder,Brazil,South America
1857,Otávio,BRA,Bordeaux,Ligue 1,2019,25.0,1994.0,24.6,80,45,23,52,5,35,82,42.7,47,26,9,17,41,121,40,6,MF,25-29,Midfielder,Brazil,South America
1857,Otávio,BRA,Bordeaux,Ligue 1,2019,25.0,1994.0,24.6,80,45,23,52,5,35,82,42.7,47,26,9,17,41,121,40,6,MF,25-29,Midfielder,Brazil,South America
1857,Otávio,BRA,Bordeaux,Ligue 1,2019,25.0,1994.0,24.6,80,45,23,52,5,35,82,42.7,47,26,9,17,41,121,40,6,MF,25-29,Midfielder,Brazil,South America
1857,Otávio,BRA,Bordeaux,Ligue 1,2019,25.0,1994.0,24.6,80,45,23,52,5,35,82,42.7,47,26,9,17,41,121,40,6,MF,25-29,Midfielder,Brazil,South America
1857,Otávio,BRA,Bordeaux,Ligue 1,2019,25.0,1994.0,24.6,80,45,23,52,5,35,82,42.7,47,26,9,17,41,121,40,6,MF,25-29,Midfielder,Brazil,South America
1857,Otávio,BRA,Bordeaux,Ligue 1,2019,25.0,1994.0,24.6,80,45,23,52,5,35,82,42.7,47,26,9,17,41,121,40,6,MF,25-29,Midfielder,Brazil,South America
1857,Otávio,BRA,Bordeaux,Ligue 1,2019,25.0,1994.0,24.6,80,45,23,52,5,35,82,42.7,47,26,9,17,41,121,40,6,MF,25-29,Midfielder,Brazil,South America
1857,Otávio,BRA,Bordeaux,Ligue 1,2019,25.0,1994.0,24.6,80,45,23,52,5,35,82,42.7,47,26,9,17,41,121,40,6,MF,25-29,Midfielder,Brazil,South America
1858,Paulo Otávio,BRA,Wolfsburg,Bundesliga,2019,24.0,1994.0,4.2,21,16,11,9,1,10,13,76.9,3,12,2,10,9,30,11,0,DF,20-24,Defender,Brazil,South America
1862,Alexandre Oukidja,ALG,Metz,Ligue 1,2019,31.0,1988.0,26.5,0,0,0,0,0,0,1,0.0,1,1,0,1,0,0,15,1,GK,30-34,Goalkeeper,Algeria,Africa
1863,Zinédine Ould Khaled,FRA,Angers,Ligue 1,2019,19.0,2000.0,0.7,2,1,0,2,0,2,4,50.0,2,0,0,0,4,6,0,0,MF,Under 20,Midfielder,France,Europe
1864,Adam Ounas,ALG,Nice,Ligue 1,2019,22.0,1996.0,12.5,10,5,2,6,2,5,13,38.5,8,9,1,8,11,21,8,1,"FW,MF",20-24,Forward,Algeria,Africa
1865,Reece Oxford,ENG,Augsburg,Bundesliga,2019,20.0,1998.0,4.2,7,4,2,4,1,2,8,25.0,6,8,5,3,5,12,10,1,MF,20-24,Midfielder,England,Europe
1868,Ambroise Oyongo,CMR,Montpellier,Ligue 1,2019,28.0,1991.0,20.2,25,10,16,6,3,16,28,57.1,12,8,0,8,17,42,35,0,"DF,FW",25-29,Defender,Cameroon,Africa
1874,Gonçalo Paciência,POR,Eint Frankfurt,Bundesliga,2019,24.0,1994.0,14.3,9,5,1,4,4,3,13,23.1,10,9,1,8,1,10,11,0,FW,20-24,Forward,Portugal,Europe
1875,Daniele Padelli,ITA,Inter,Serie A,2019,33.0,1985.0,3.0,0,0,0,0,0,0,0,,0,0,0,0,0,0,1,1,GK,30-34,Goalkeeper,Italy,Europe
1877,Vincent Pajot,FRA,Angers,Ligue 1,2019,28.0,1990.0,1.3,2,2,1,1,0,1,1,100.0,0,3,0,3,5,7,0,0,MF,25-29,Midfielder,France,Europe
1878,Vincent Pajot,FRA,Metz,Ligue 1,2019,28.0,1990.0,5.8,16,11,8,7,1,2,4,50.0,2,5,1,4,9,25,13,0,MF,25-29,Midfielder,France,Europe
1879,Rodrigo Palacio,ARG,Bologna,Serie A,2019,37.0,1982.0,28.0,19,11,0,9,10,4,27,14.8,23,17,3,14,5,24,38,2,FW,35-39,Forward,Argentina,South America
1880,Exequiel Palacios,ARG,Leverkusen,Bundesliga,2019,20.0,1998.0,2.0,8,7,4,4,0,2,5,40.0,3,2,0,2,1,9,0,0,MF,20-24,Midfielder,Argentina,South America
1882,Nicolas Pallois,FRA,Nantes,Ligue 1,2019,31.0,1987.0,21.0,47,36,28,17,2,31,55,56.4,24,18,13,5,40,87,77,1,DF,30-34,Defender,France,Europe
1884,Alberto Paloschi,ITA,SPAL,Serie A,2019,29.0,1990.0,4.9,3,0,3,0,0,2,8,25.0,6,3,0,3,0,3,2,0,FW,25-29,Forward,Italy,Europe
1885,Alberto Paloschi,ITA,Cagliari,Serie A,2019,29.0,1990.0,2.3,0,0,0,0,0,0,1,0.0,1,1,0,1,1,1,3,0,"FW,MF",25-29,Forward,Italy,Europe
1887,Goran Pandev,MKD,Genoa,Serie A,2019,36.0,1983.0,18.7,12,8,2,7,3,3,25,12.0,22,4,1,3,0,12,5,1,"FW,MF",35-39,Forward,North Macedonia,Europe
1889,Sokratis Papastathopoulos,GRE,Arsenal,Premier League,2019,31.0,1988.0,18.8,25,16,17,7,1,10,21,47.6,11,30,24,6,17,42,68,1,DF,30-34,Defender,Greece,Europe
1891,Lucas Paquetá,BRA,Milan,Serie A,2019,21.0,1997.0,12.3,33,19,12,17,4,14,37,37.8,23,17,2,15,8,41,9,0,"MF,FW",20-24,Midfielder,Brazil,South America
1892,Gaëtan Paquiez,FRA,Nîmes,Ligue 1,2019,25.0,1994.0,17.0,36,25,14,13,9,17,47,36.2,30,18,5,13,33,69,43,0,DF,25-29,Defender,France,Europe
1894,Leandro Paredes,ARG,Paris S-G,Ligue 1,2019,25.0,1994.0,9.0,22,14,7,14,1,13,29,44.8,16,7,1,6,15,37,7,0,MF,25-29,Midfielder,Argentina,South America
1896,Michael Parensen,GER,Union Berlin,Bundesliga,2019,33.0,1986.0,7.0,11,6,5,6,0,5,10,50.0,5,14,8,6,12,23,17,0,DF,30-34,Defender,Germany,Europe
1898,Marco Parolo,ITA,Lazio,Serie A,2019,34.0,1985.0,18.9,54,26,19,27,8,18,46,39.1,28,44,15,29,26,80,49,0,MF,30-34,Midfielder,Italy,Europe
1900,Thomas Partey,GHA,Atlético Madrid,La Liga,2019,26.0,1993.0,28.3,70,41,34,30,6,26,58,44.8,32,32,8,24,48,118,41,7,MF,25-29,Midfielder,Ghana,Africa
1902,Javier Pastore,ARG,Roma,Serie A,2019,30.0,1989.0,5.7,14,10,3,5,6,5,12,41.7,7,4,0,4,5,19,5,0,MF,30-34,Midfielder,Argentina,South America
1904,Rui Patrício,POR,Wolves,Premier League,2019,31.0,1988.0,38.0,0,0,0,0,0,0,2,0.0,2,2,0,2,2,2,5,2,GK,30-34,Goalkeeper,Portugal,Europe
1905,Paulinho,BRA,Leverkusen,Bundesliga,2019,19.0,2000.0,3.4,4,3,3,1,0,1,2,50.0,1,5,1,4,1,5,0,0,"MF,FW",Under 20,Midfielder,Brazil,South America
1905,Paulinho,BRA,Leverkusen,Bundesliga,2019,19.0,2000.0,3.4,4,3,3,1,0,1,2,50.0,1,5,1,4,1,5,0,0,"MF,FW",Under 20,Midfielder,Brazil,South America
1905,Paulinho,BRA,Leverkusen,Bundesliga,2019,19.0,2000.0,3.4,4,3,3,1,0,1,2,50.0,1,5,1,4,1,5,0,0,"MF,FW",Under 20,Midfielder,Brazil,South America
1905,Paulinho,BRA,Leverkusen,Bundesliga,2019,19.0,2000.0,3.4,4,3,3,1,0,1,2,50.0,1,5,1,4,1,5,0,0,"MF,FW",Under 20,Midfielder,Brazil,South America
1905,Paulinho,BRA,Leverkusen,Bundesliga,2019,19.0,2000.0,3.4,4,3,3,1,0,1,2,50.0,1,5,1,4,1,5,0,0,"MF,FW",Under 20,Midfielder,Brazil,South America
1905,Paulinho,BRA,Leverkusen,Bundesliga,2019,19.0,2000.0,3.4,4,3,3,1,0,1,2,50.0,1,5,1,4,1,5,0,0,"MF,FW",Under 20,Midfielder,Brazil,South America
1905,Paulinho,BRA,Leverkusen,Bundesliga,2019,19.0,2000.0,3.4,4,3,3,1,0,1,2,50.0,1,5,1,4,1,5,0,0,"MF,FW",Under 20,Midfielder,Brazil,South America
1905,Paulinho,BRA,Leverkusen,Bundesliga,2019,19.0,2000.0,3.4,4,3,3,1,0,1,2,50.0,1,5,1,4,1,5,0,0,"MF,FW",Under 20,Midfielder,Brazil,South America
1905,Paulinho,BRA,Leverkusen,Bundesliga,2019,19.0,2000.0,3.4,4,3,3,1,0,1,2,50.0,1,5,1,4,1,5,0,0,"MF,FW",Under 20,Midfielder,Brazil,South America
1905,Paulinho,BRA,Leverkusen,Bundesliga,2019,19.0,2000.0,3.4,4,3,3,1,0,1,2,50.0,1,5,1,4,1,5,0,0,"MF,FW",Under 20,Midfielder,Brazil,South America
1905,Paulinho,BRA,Leverkusen,Bundesliga,2019,19.0,2000.0,3.4,4,3,3,1,0,1,2,50.0,1,5,1,4,1,5,0,0,"MF,FW",Under 20,Midfielder,Brazil,South America
1905,Paulinho,BRA,Leverkusen,Bundesliga,2019,19.0,2000.0,3.4,4,3,3,1,0,1,2,50.0,1,5,1,4,1,5,0,0,"MF,FW",Under 20,Midfielder,Brazil,South America
1905,Paulinho,BRA,Leverkusen,Bundesliga,2019,19.0,2000.0,3.4,4,3,3,1,0,1,2,50.0,1,5,1,4,1,5,0,0,"MF,FW",Under 20,Midfielder,Brazil,South America
1905,Paulinho,BRA,Leverkusen,Bundesliga,2019,19.0,2000.0,3.4,4,3,3,1,0,1,2,50.0,1,5,1,4,1,5,0,0,"MF,FW",Under 20,Midfielder,Brazil,South America
1905,Paulinho,BRA,Leverkusen,Bundesliga,2019,19.0,2000.0,3.4,4,3,3,1,0,1,2,50.0,1,5,1,4,1,5,0,0,"MF,FW",Under 20,Midfielder,Brazil,South America
1905,Paulinho,BRA,Leverkusen,Bundesliga,2019,19.0,2000.0,3.4,4,3,3,1,0,1,2,50.0,1,5,1,4,1,5,0,0,"MF,FW",Under 20,Midfielder,Brazil,South America
1905,Paulinho,BRA,Leverkusen,Bundesliga,2019,19.0,2000.0,3.4,4,3,3,1,0,1,2,50.0,1,5,1,4,1,5,0,0,"MF,FW",Under 20,Midfielder,Brazil,South America
1905,Paulinho,BRA,Leverkusen,Bundesliga,2019,19.0,2000.0,3.4,4,3,3,1,0,1,2,50.0,1,5,1,4,1,5,0,0,"MF,FW",Under 20,Midfielder,Brazil,South America
1905,Paulinho,BRA,Leverkusen,Bundesliga,2019,19.0,2000.0,3.4,4,3,3,1,0,1,2,50.0,1,5,1,4,1,5,0,0,"MF,FW",Under 20,Midfielder,Brazil,South America
1905,Paulinho,BRA,Leverkusen,Bundesliga,2019,19.0,2000.0,3.4,4,3,3,1,0,1,2,50.0,1,5,1,4,1,5,0,0,"MF,FW",Under 20,Midfielder,Brazil,South America
1905,Paulinho,BRA,Leverkusen,Bundesliga,2019,19.0,2000.0,3.4,4,3,3,1,0,1,2,50.0,1,5,1,4,1,5,0,0,"MF,FW",Under 20,Midfielder,Brazil,South America
1905,Paulinho,BRA,Leverkusen,Bundesliga,2019,19.0,2000.0,3.4,4,3,3,1,0,1,2,50.0,1,5,1,4,1,5,0,0,"MF,FW",Under 20,Midfielder,Brazil,South America
1905,Paulinho,BRA,Leverkusen,Bundesliga,2019,19.0,2000.0,3.4,4,3,3,1,0,1,2,50.0,1,5,1,4,1,5,0,0,"MF,FW",Under 20,Midfielder,Brazil,South America
1905,Paulinho,BRA,Leverkusen,Bundesliga,2019,19.0,2000.0,3.4,4,3,3,1,0,1,2,50.0,1,5,1,4,1,5,0,0,"MF,FW",Under 20,Midfielder,Brazil,South America
1905,Paulinho,BRA,Leverkusen,Bundesliga,2019,19.0,2000.0,3.4,4,3,3,1,0,1,2,50.0,1,5,1,4,1,5,0,0,"MF,FW",Under 20,Midfielder,Brazil,South America
1905,Paulinho,BRA,Leverkusen,Bundesliga,2019,19.0,2000.0,3.4,4,3,3,1,0,1,2,50.0,1,5,1,4,1,5,0,0,"MF,FW",Under 20,Midfielder,Brazil,South America
1905,Paulinho,BRA,Leverkusen,Bundesliga,2019,19.0,2000.0,3.4,4,3,3,1,0,1,2,50.0,1,5,1,4,1,5,0,0,"MF,FW",Under 20,Midfielder,Brazil,South America
1905,Paulinho,BRA,Leverkusen,Bundesliga,2019,19.0,2000.0,3.4,4,3,3,1,0,1,2,50.0,1,5,1,4,1,5,0,0,"MF,FW",Under 20,Midfielder,Brazil,South America
1905,Paulinho,BRA,Leverkusen,Bundesliga,2019,19.0,2000.0,3.4,4,3,3,1,0,1,2,50.0,1,5,1,4,1,5,0,0,"MF,FW",Under 20,Midfielder,Brazil,South America
1905,Paulinho,BRA,Leverkusen,Bundesliga,2019,19.0,2000.0,3.4,4,3,3,1,0,1,2,50.0,1,5,1,4,1,5,0,0,"MF,FW",Under 20,Midfielder,Brazil,South America
1905,Paulinho,BRA,Leverkusen,Bundesliga,2019,19.0,2000.0,3.4,4,3,3,1,0,1,2,50.0,1,5,1,4,1,5,0,0,"MF,FW",Under 20,Midfielder,Brazil,South America
1905,Paulinho,BRA,Leverkusen,Bundesliga,2019,19.0,2000.0,3.4,4,3,3,1,0,1,2,50.0,1,5,1,4,1,5,0,0,"MF,FW",Under 20,Midfielder,Brazil,South America
1905,Paulinho,BRA,Leverkusen,Bundesliga,2019,19.0,2000.0,3.4,4,3,3,1,0,1,2,50.0,1,5,1,4,1,5,0,0,"MF,FW",Under 20,Midfielder,Brazil,South America
1905,Paulinho,BRA,Leverkusen,Bundesliga,2019,19.0,2000.0,3.4,4,3,3,1,0,1,2,50.0,1,5,1,4,1,5,0,0,"MF,FW",Under 20,Midfielder,Brazil,South America
1905,Paulinho,BRA,Leverkusen,Bundesliga,2019,19.0,2000.0,3.4,4,3,3,1,0,1,2,50.0,1,5,1,4,1,5,0,0,"MF,FW",Under 20,Midfielder,Brazil,South America
1905,Paulinho,BRA,Leverkusen,Bundesliga,2019,19.0,2000.0,3.4,4,3,3,1,0,1,2,50.0,1,5,1,4,1,5,0,0,"MF,FW",Under 20,Midfielder,Brazil,South America
1905,Paulinho,BRA,Leverkusen,Bundesliga,2019,19.0,2000.0,3.4,4,3,3,1,0,1,2,50.0,1,5,1,4,1,5,0,0,"MF,FW",Under 20,Midfielder,Brazil,South America
1905,Paulinho,BRA,Leverkusen,Bundesliga,2019,19.0,2000.0,3.4,4,3,3,1,0,1,2,50.0,1,5,1,4,1,5,0,0,"MF,FW",Under 20,Midfielder,Brazil,South America
1905,Paulinho,BRA,Leverkusen,Bundesliga,2019,19.0,2000.0,3.4,4,3,3,1,0,1,2,50.0,1,5,1,4,1,5,0,0,"MF,FW",Under 20,Midfielder,Brazil,South America
1905,Paulinho,BRA,Leverkusen,Bundesliga,2019,19.0,2000.0,3.4,4,3,3,1,0,1,2,50.0,1,5,1,4,1,5,0,0,"MF,FW",Under 20,Midfielder,Brazil,South America
1905,Paulinho,BRA,Leverkusen,Bundesliga,2019,19.0,2000.0,3.4,4,3,3,1,0,1,2,50.0,1,5,1,4,1,5,0,0,"MF,FW",Under 20,Midfielder,Brazil,South America
1905,Paulinho,BRA,Leverkusen,Bundesliga,2019,19.0,2000.0,3.4,4,3,3,1,0,1,2,50.0,1,5,1,4,1,5,0,0,"MF,FW",Under 20,Midfielder,Brazil,South America
1905,Paulinho,BRA,Leverkusen,Bundesliga,2019,19.0,2000.0,3.4,4,3,3,1,0,1,2,50.0,1,5,1,4,1,5,0,0,"MF,FW",Under 20,Midfielder,Brazil,South America
1905,Paulinho,BRA,Leverkusen,Bundesliga,2019,19.0,2000.0,3.4,4,3,3,1,0,1,2,50.0,1,5,1,4,1,5,0,0,"MF,FW",Under 20,Midfielder,Brazil,South America
1905,Paulinho,BRA,Leverkusen,Bundesliga,2019,19.0,2000.0,3.4,4,3,3,1,0,1,2,50.0,1,5,1,4,1,5,0,0,"MF,FW",Under 20,Midfielder,Brazil,South America
1905,Paulinho,BRA,Leverkusen,Bundesliga,2019,19.0,2000.0,3.4,4,3,3,1,0,1,2,50.0,1,5,1,4,1,5,0,0,"MF,FW",Under 20,Midfielder,Brazil,South America
1905,Paulinho,BRA,Leverkusen,Bundesliga,2019,19.0,2000.0,3.4,4,3,3,1,0,1,2,50.0,1,5,1,4,1,5,0,0,"MF,FW",Under 20,Midfielder,Brazil,South America
1905,Paulinho,BRA,Leverkusen,Bundesliga,2019,19.0,2000.0,3.4,4,3,3,1,0,1,2,50.0,1,5,1,4,1,5,0,0,"MF,FW",Under 20,Midfielder,Brazil,South America
1905,Paulinho,BRA,Leverkusen,Bundesliga,2019,19.0,2000.0,3.4,4,3,3,1,0,1,2,50.0,1,5,1,4,1,5,0,0,"MF,FW",Under 20,Midfielder,Brazil,South America
1905,Paulinho,BRA,Leverkusen,Bundesliga,2019,19.0,2000.0,3.4,4,3,3,1,0,1,2,50.0,1,5,1,4,1,5,0,0,"MF,FW",Under 20,Midfielder,Brazil,South America
1905,Paulinho,BRA,Leverkusen,Bundesliga,2019,19.0,2000.0,3.4,4,3,3,1,0,1,2,50.0,1,5,1,4,1,5,0,0,"MF,FW",Under 20,Midfielder,Brazil,South America
1905,Paulinho,BRA,Leverkusen,Bundesliga,2019,19.0,2000.0,3.4,4,3,3,1,0,1,2,50.0,1,5,1,4,1,5,0,0,"MF,FW",Under 20,Midfielder,Brazil,South America
1905,Paulinho,BRA,Leverkusen,Bundesliga,2019,19.0,2000.0,3.4,4,3,3,1,0,1,2,50.0,1,5,1,4,1,5,0,0,"MF,FW",Under 20,Midfielder,Brazil,South America
1905,Paulinho,BRA,Leverkusen,Bundesliga,2019,19.0,2000.0,3.4,4,3,3,1,0,1,2,50.0,1,5,1,4,1,5,0,0,"MF,FW",Under 20,Midfielder,Brazil,South America
1905,Paulinho,BRA,Leverkusen,Bundesliga,2019,19.0,2000.0,3.4,4,3,3,1,0,1,2,50.0,1,5,1,4,1,5,0,0,"MF,FW",Under 20,Midfielder,Brazil,South America
1905,Paulinho,BRA,Leverkusen,Bundesliga,2019,19.0,2000.0,3.4,4,3,3,1,0,1,2,50.0,1,5,1,4,1,5,0,0,"MF,FW",Under 20,Midfielder,Brazil,South America
1905,Paulinho,BRA,Leverkusen,Bundesliga,2019,19.0,2000.0,3.4,4,3,3,1,0,1,2,50.0,1,5,1,4,1,5,0,0,"MF,FW",Under 20,Midfielder,Brazil,South America
1905,Paulinho,BRA,Leverkusen,Bundesliga,2019,19.0,2000.0,3.4,4,3,3,1,0,1,2,50.0,1,5,1,4,1,5,0,0,"MF,FW",Under 20,Midfielder,Brazil,South America
1905,Paulinho,BRA,Leverkusen,Bundesliga,2019,19.0,2000.0,3.4,4,3,3,1,0,1,2,50.0,1,5,1,4,1,5,0,0,"MF,FW",Under 20,Midfielder,Brazil,South America
1905,Paulinho,BRA,Leverkusen,Bundesliga,2019,19.0,2000.0,3.4,4,3,3,1,0,1,2,50.0,1,5,1,4,1,5,0,0,"MF,FW",Under 20,Midfielder,Brazil,South America
1905,Paulinho,BRA,Leverkusen,Bundesliga,2019,19.0,2000.0,3.4,4,3,3,1,0,1,2,50.0,1,5,1,4,1,5,0,0,"MF,FW",Under 20,Midfielder,Brazil,South America
1905,Paulinho,BRA,Leverkusen,Bundesliga,2019,19.0,2000.0,3.4,4,3,3,1,0,1,2,50.0,1,5,1,4,1,5,0,0,"MF,FW",Under 20,Midfielder,Brazil,South America
1905,Paulinho,BRA,Leverkusen,Bundesliga,2019,19.0,2000.0,3.4,4,3,3,1,0,1,2,50.0,1,5,1,4,1,5,0,0,"MF,FW",Under 20,Midfielder,Brazil,South America
1905,Paulinho,BRA,Leverkusen,Bundesliga,2019,19.0,2000.0,3.4,4,3,3,1,0,1,2,50.0,1,5,1,4,1,5,0,0,"MF,FW",Under 20,Midfielder,Brazil,South America
1905,Paulinho,BRA,Leverkusen,Bundesliga,2019,19.0,2000.0,3.4,4,3,3,1,0,1,2,50.0,1,5,1,4,1,5,0,0,"MF,FW",Under 20,Midfielder,Brazil,South America
1905,Paulinho,BRA,Leverkusen,Bundesliga,2019,19.0,2000.0,3.4,4,3,3,1,0,1,2,50.0,1,5,1,4,1,5,0,0,"MF,FW",Under 20,Midfielder,Brazil,South America
1905,Paulinho,BRA,Leverkusen,Bundesliga,2019,19.0,2000.0,3.4,4,3,3,1,0,1,2,50.0,1,5,1,4,1,5,0,0,"MF,FW",Under 20,Midfielder,Brazil,South America
1905,Paulinho,BRA,Leverkusen,Bundesliga,2019,19.0,2000.0,3.4,4,3,3,1,0,1,2,50.0,1,5,1,4,1,5,0,0,"MF,FW",Under 20,Midfielder,Brazil,South America
1905,Paulinho,BRA,Leverkusen,Bundesliga,2019,19.0,2000.0,3.4,4,3,3,1,0,1,2,50.0,1,5,1,4,1,5,0,0,"MF,FW",Under 20,Midfielder,Brazil,South America
1905,Paulinho,BRA,Leverkusen,Bundesliga,2019,19.0,2000.0,3.4,4,3,3,1,0,1,2,50.0,1,5,1,4,1,5,0,0,"MF,FW",Under 20,Midfielder,Brazil,South America
1905,Paulinho,BRA,Leverkusen,Bundesliga,2019,19.0,2000.0,3.4,4,3,3,1,0,1,2,50.0,1,5,1,4,1,5,0,0,"MF,FW",Under 20,Midfielder,Brazil,South America
1905,Paulinho,BRA,Leverkusen,Bundesliga,2019,19.0,2000.0,3.4,4,3,3,1,0,1,2,50.0,1,5,1,4,1,5,0,0,"MF,FW",Under 20,Midfielder,Brazil,South America
1905,Paulinho,BRA,Leverkusen,Bundesliga,2019,19.0,2000.0,3.4,4,3,3,1,0,1,2,50.0,1,5,1,4,1,5,0,0,"MF,FW",Under 20,Midfielder,Brazil,South America
1905,Paulinho,BRA,Leverkusen,Bundesliga,2019,19.0,2000.0,3.4,4,3,3,1,0,1,2,50.0,1,5,1,4,1,5,0,0,"MF,FW",Under 20,Midfielder,Brazil,South America
1905,Paulinho,BRA,Leverkusen,Bundesliga,2019,19.0,2000.0,3.4,4,3,3,1,0,1,2,50.0,1,5,1,4,1,5,0,0,"MF,FW",Under 20,Midfielder,Brazil,South America
1905,Paulinho,BRA,Leverkusen,Bundesliga,2019,19.0,2000.0,3.4,4,3,3,1,0,1,2,50.0,1,5,1,4,1,5,0,0,"MF,FW",Under 20,Midfielder,Brazil,South America
1905,Paulinho,BRA,Leverkusen,Bundesliga,2019,19.0,2000.0,3.4,4,3,3,1,0,1,2,50.0,1,5,1,4,1,5,0,0,"MF,FW",Under 20,Midfielder,Brazil,South America
1905,Paulinho,BRA,Leverkusen,Bundesliga,2019,19.0,2000.0,3.4,4,3,3,1,0,1,2,50.0,1,5,1,4,1,5,0,0,"MF,FW",Under 20,Midfielder,Brazil,South America
1905,Paulinho,BRA,Leverkusen,Bundesliga,2019,19.0,2000.0,3.4,4,3,3,1,0,1,2,50.0,1,5,1,4,1,5,0,0,"MF,FW",Under 20,Midfielder,Brazil,South America
1905,Paulinho,BRA,Leverkusen,Bundesliga,2019,19.0,2000.0,3.4,4,3,3,1,0,1,2,50.0,1,5,1,4,1,5,0,0,"MF,FW",Under 20,Midfielder,Brazil,South America
1905,Paulinho,BRA,Leverkusen,Bundesliga,2019,19.0,2000.0,3.4,4,3,3,1,0,1,2,50.0,1,5,1,4,1,5,0,0,"MF,FW",Under 20,Midfielder,Brazil,South America
1905,Paulinho,BRA,Leverkusen,Bundesliga,2019,19.0,2000.0,3.4,4,3,3,1,0,1,2,50.0,1,5,1,4,1,5,0,0,"MF,FW",Under 20,Midfielder,Brazil,South America
1905,Paulinho,BRA,Leverkusen,Bundesliga,2019,19.0,2000.0,3.4,4,3,3,1,0,1,2,50.0,1,5,1,4,1,5,0,0,"MF,FW",Under 20,Midfielder,Brazil,South America
1905,Paulinho,BRA,Leverkusen,Bundesliga,2019,19.0,2000.0,3.4,4,3,3,1,0,1,2,50.0,1,5,1,4,1,5,0,0,"MF,FW",Under 20,Midfielder,Brazil,South America
1905,Paulinho,BRA,Leverkusen,Bundesliga,2019,19.0,2000.0,3.4,4,3,3,1,0,1,2,50.0,1,5,1,4,1,5,0,0,"MF,FW",Under 20,Midfielder,Brazil,South America
1905,Paulinho,BRA,Leverkusen,Bundesliga,2019,19.0,2000.0,3.4,4,3,3,1,0,1,2,50.0,1,5,1,4,1,5,0,0,"MF,FW",Under 20,Midfielder,Brazil,South America
1905,Paulinho,BRA,Leverkusen,Bundesliga,2019,19.0,2000.0,3.4,4,3,3,1,0,1,2,50.0,1,5,1,4,1,5,0,0,"MF,FW",Under 20,Midfielder,Brazil,South America
1905,Paulinho,BRA,Leverkusen,Bundesliga,2019,19.0,2000.0,3.4,4,3,3,1,0,1,2,50.0,1,5,1,4,1,5,0,0,"MF,FW",Under 20,Midfielder,Brazil,South America
1905,Paulinho,BRA,Leverkusen,Bundesliga,2019,19.0,2000.0,3.4,4,3,3,1,0,1,2,50.0,1,5,1,4,1,5,0,0,"MF,FW",Under 20,Midfielder,Brazil,South America
1905,Paulinho,BRA,Leverkusen,Bundesliga,2019,19.0,2000.0,3.4,4,3,3,1,0,1,2,50.0,1,5,1,4,1,5,0,0,"MF,FW",Under 20,Midfielder,Brazil,South America
1905,Paulinho,BRA,Leverkusen,Bundesliga,2019,19.0,2000.0,3.4,4,3,3,1,0,1,2,50.0,1,5,1,4,1,5,0,0,"MF,FW",Under 20,Midfielder,Brazil,South America
1905,Paulinho,BRA,Leverkusen,Bundesliga,2019,19.0,2000.0,3.4,4,3,3,1,0,1,2,50.0,1,5,1,4,1,5,0,0,"MF,FW",Under 20,Midfielder,Brazil,South America
1905,Paulinho,BRA,Leverkusen,Bundesliga,2019,19.0,2000.0,3.4,4,3,3,1,0,1,2,50.0,1,5,1,4,1,5,0,0,"MF,FW",Under 20,Midfielder,Brazil,South America
1905,Paulinho,BRA,Leverkusen,Bundesliga,2019,19.0,2000.0,3.4,4,3,3,1,0,1,2,50.0,1,5,1,4,1,5,0,0,"MF,FW",Under 20,Midfielder,Brazil,South America
1905,Paulinho,BRA,Leverkusen,Bundesliga,2019,19.0,2000.0,3.4,4,3,3,1,0,1,2,50.0,1,5,1,4,1,5,0,0,"MF,FW",Under 20,Midfielder,Brazil,South America
1905,Paulinho,BRA,Leverkusen,Bundesliga,2019,19.0,2000.0,3.4,4,3,3,1,0,1,2,50.0,1,5,1,4,1,5,0,0,"MF,FW",Under 20,Midfielder,Brazil,South America
1905,Paulinho,BRA,Leverkusen,Bundesliga,2019,19.0,2000.0,3.4,4,3,3,1,0,1,2,50.0,1,5,1,4,1,5,0,0,"MF,FW",Under 20,Midfielder,Brazil,South America
1905,Paulinho,BRA,Leverkusen,Bundesliga,2019,19.0,2000.0,3.4,4,3,3,1,0,1,2,50.0,1,5,1,4,1,5,0,0,"MF,FW",Under 20,Midfielder,Brazil,South America
1905,Paulinho,BRA,Leverkusen,Bundesliga,2019,19.0,2000.0,3.4,4,3,3,1,0,1,2,50.0,1,5,1,4,1,5,0,0,"MF,FW",Under 20,Midfielder,Brazil,South America
1905,Paulinho,BRA,Leverkusen,Bundesliga,2019,19.0,2000.0,3.4,4,3,3,1,0,1,2,50.0,1,5,1,4,1,5,0,0,"MF,FW",Under 20,Midfielder,Brazil,South America
1905,Paulinho,BRA,Leverkusen,Bundesliga,2019,19.0,2000.0,3.4,4,3,3,1,0,1,2,50.0,1,5,1,4,1,5,0,0,"MF,FW",Under 20,Midfielder,Brazil,South America
1905,Paulinho,BRA,Leverkusen,Bundesliga,2019,19.0,2000.0,3.4,4,3,3,1,0,1,2,50.0,1,5,1,4,1,5,0,0,"MF,FW",Under 20,Midfielder,Brazil,South America
1905,Paulinho,BRA,Leverkusen,Bundesliga,2019,19.0,2000.0,3.4,4,3,3,1,0,1,2,50.0,1,5,1,4,1,5,0,0,"MF,FW",Under 20,Midfielder,Brazil,South America
1905,Paulinho,BRA,Leverkusen,Bundesliga,2019,19.0,2000.0,3.4,4,3,3,1,0,1,2,50.0,1,5,1,4,1,5,0,0,"MF,FW",Under 20,Midfielder,Brazil,South America
1905,Paulinho,BRA,Leverkusen,Bundesliga,2019,19.0,2000.0,3.4,4,3,3,1,0,1,2,50.0,1,5,1,4,1,5,0,0,"MF,FW",Under 20,Midfielder,Brazil,South America
1905,Paulinho,BRA,Leverkusen,Bundesliga,2019,19.0,2000.0,3.4,4,3,3,1,0,1,2,50.0,1,5,1,4,1,5,0,0,"MF,FW",Under 20,Midfielder,Brazil,South America
1905,Paulinho,BRA,Leverkusen,Bundesliga,2019,19.0,2000.0,3.4,4,3,3,1,0,1,2,50.0,1,5,1,4,1,5,0,0,"MF,FW",Under 20,Midfielder,Brazil,South America
1905,Paulinho,BRA,Leverkusen,Bundesliga,2019,19.0,2000.0,3.4,4,3,3,1,0,1,2,50.0,1,5,1,4,1,5,0,0,"MF,FW",Under 20,Midfielder,Brazil,South America
1905,Paulinho,BRA,Leverkusen,Bundesliga,2019,19.0,2000.0,3.4,4,3,3,1,0,1,2,50.0,1,5,1,4,1,5,0,0,"MF,FW",Under 20,Midfielder,Brazil,South America
1905,Paulinho,BRA,Leverkusen,Bundesliga,2019,19.0,2000.0,3.4,4,3,3,1,0,1,2,50.0,1,5,1,4,1,5,0,0,"MF,FW",Under 20,Midfielder,Brazil,South America
1905,Paulinho,BRA,Leverkusen,Bundesliga,2019,19.0,2000.0,3.4,4,3,3,1,0,1,2,50.0,1,5,1,4,1,5,0,0,"MF,FW",Under 20,Midfielder,Brazil,South America
1905,Paulinho,BRA,Leverkusen,Bundesliga,2019,19.0,2000.0,3.4,4,3,3,1,0,1,2,50.0,1,5,1,4,1,5,0,0,"MF,FW",Under 20,Midfielder,Brazil,South America
1905,Paulinho,BRA,Leverkusen,Bundesliga,2019,19.0,2000.0,3.4,4,3,3,1,0,1,2,50.0,1,5,1,4,1,5,0,0,"MF,FW",Under 20,Midfielder,Brazil,South America
1905,Paulinho,BRA,Leverkusen,Bundesliga,2019,19.0,2000.0,3.4,4,3,3,1,0,1,2,50.0,1,5,1,4,1,5,0,0,"MF,FW",Under 20,Midfielder,Brazil,South America
1905,Paulinho,BRA,Leverkusen,Bundesliga,2019,19.0,2000.0,3.4,4,3,3,1,0,1,2,50.0,1,5,1,4,1,5,0,0,"MF,FW",Under 20,Midfielder,Brazil,South America
1905,Paulinho,BRA,Leverkusen,Bundesliga,2019,19.0,2000.0,3.4,4,3,3,1,0,1,2,50.0,1,5,1,4,1,5,0,0,"MF,FW",Under 20,Midfielder,Brazil,South America
1905,Paulinho,BRA,Leverkusen,Bundesliga,2019,19.0,2000.0,3.4,4,3,3,1,0,1,2,50.0,1,5,1,4,1,5,0,0,"MF,FW",Under 20,Midfielder,Brazil,South America
1905,Paulinho,BRA,Leverkusen,Bundesliga,2019,19.0,2000.0,3.4,4,3,3,1,0,1,2,50.0,1,5,1,4,1,5,0,0,"MF,FW",Under 20,Midfielder,Brazil,South America
1905,Paulinho,BRA,Leverkusen,Bundesliga,2019,19.0,2000.0,3.4,4,3,3,1,0,1,2,50.0,1,5,1,4,1,5,0,0,"MF,FW",Under 20,Midfielder,Brazil,South America
1905,Paulinho,BRA,Leverkusen,Bundesliga,2019,19.0,2000.0,3.4,4,3,3,1,0,1,2,50.0,1,5,1,4,1,5,0,0,"MF,FW",Under 20,Midfielder,Brazil,South America
1905,Paulinho,BRA,Leverkusen,Bundesliga,2019,19.0,2000.0,3.4,4,3,3,1,0,1,2,50.0,1,5,1,4,1,5,0,0,"MF,FW",Under 20,Midfielder,Brazil,South America
1905,Paulinho,BRA,Leverkusen,Bundesliga,2019,19.0,2000.0,3.4,4,3,3,1,0,1,2,50.0,1,5,1,4,1,5,0,0,"MF,FW",Under 20,Midfielder,Brazil,South America
1905,Paulinho,BRA,Leverkusen,Bundesliga,2019,19.0,2000.0,3.4,4,3,3,1,0,1,2,50.0,1,5,1,4,1,5,0,0,"MF,FW",Under 20,Midfielder,Brazil,South America
1905,Paulinho,BRA,Leverkusen,Bundesliga,2019,19.0,2000.0,3.4,4,3,3,1,0,1,2,50.0,1,5,1,4,1,5,0,0,"MF,FW",Under 20,Midfielder,Brazil,South America
1905,Paulinho,BRA,Leverkusen,Bundesliga,2019,19.0,2000.0,3.4,4,3,3,1,0,1,2,50.0,1,5,1,4,1,5,0,0,"MF,FW",Under 20,Midfielder,Brazil,South America
1905,Paulinho,BRA,Leverkusen,Bundesliga,2019,19.0,2000.0,3.4,4,3,3,1,0,1,2,50.0,1,5,1,4,1,5,0,0,"MF,FW",Under 20,Midfielder,Brazil,South America
1905,Paulinho,BRA,Leverkusen,Bundesliga,2019,19.0,2000.0,3.4,4,3,3,1,0,1,2,50.0,1,5,1,4,1,5,0,0,"MF,FW",Under 20,Midfielder,Brazil,South America
1905,Paulinho,BRA,Leverkusen,Bundesliga,2019,19.0,2000.0,3.4,4,3,3,1,0,1,2,50.0,1,5,1,4,1,5,0,0,"MF,FW",Under 20,Midfielder,Brazil,South America
1905,Paulinho,BRA,Leverkusen,Bundesliga,2019,19.0,2000.0,3.4,4,3,3,1,0,1,2,50.0,1,5,1,4,1,5,0,0,"MF,FW",Under 20,Midfielder,Brazil,South America
1905,Paulinho,BRA,Leverkusen,Bundesliga,2019,19.0,2000.0,3.4,4,3,3,1,0,1,2,50.0,1,5,1,4,1,5,0,0,"MF,FW",Under 20,Midfielder,Brazil,South America
1905,Paulinho,BRA,Leverkusen,Bundesliga,2019,19.0,2000.0,3.4,4,3,3,1,0,1,2,50.0,1,5,1,4,1,5,0,0,"MF,FW",Under 20,Midfielder,Brazil,South America
1905,Paulinho,BRA,Leverkusen,Bundesliga,2019,19.0,2000.0,3.4,4,3,3,1,0,1,2,50.0,1,5,1,4,1,5,0,0,"MF,FW",Under 20,Midfielder,Brazil,South America
1905,Paulinho,BRA,Leverkusen,Bundesliga,2019,19.0,2000.0,3.4,4,3,3,1,0,1,2,50.0,1,5,1,4,1,5,0,0,"MF,FW",Under 20,Midfielder,Brazil,South America
1905,Paulinho,BRA,Leverkusen,Bundesliga,2019,19.0,2000.0,3.4,4,3,3,1,0,1,2,50.0,1,5,1,4,1,5,0,0,"MF,FW",Under 20,Midfielder,Brazil,South America
1905,Paulinho,BRA,Leverkusen,Bundesliga,2019,19.0,2000.0,3.4,4,3,3,1,0,1,2,50.0,1,5,1,4,1,5,0,0,"MF,FW",Under 20,Midfielder,Brazil,South America
1905,Paulinho,BRA,Leverkusen,Bundesliga,2019,19.0,2000.0,3.4,4,3,3,1,0,1,2,50.0,1,5,1,4,1,5,0,0,"MF,FW",Under 20,Midfielder,Brazil,South America
1905,Paulinho,BRA,Leverkusen,Bundesliga,2019,19.0,2000.0,3.4,4,3,3,1,0,1,2,50.0,1,5,1,4,1,5,0,0,"MF,FW",Under 20,Midfielder,Brazil,South America
1905,Paulinho,BRA,Leverkusen,Bundesliga,2019,19.0,2000.0,3.4,4,3,3,1,0,1,2,50.0,1,5,1,4,1,5,0,0,"MF,FW",Under 20,Midfielder,Brazil,South America
1905,Paulinho,BRA,Leverkusen,Bundesliga,2019,19.0,2000.0,3.4,4,3,3,1,0,1,2,50.0,1,5,1,4,1,5,0,0,"MF,FW",Under 20,Midfielder,Brazil,South America
1905,Paulinho,BRA,Leverkusen,Bundesliga,2019,19.0,2000.0,3.4,4,3,3,1,0,1,2,50.0,1,5,1,4,1,5,0,0,"MF,FW",Under 20,Midfielder,Brazil,South America
1905,Paulinho,BRA,Leverkusen,Bundesliga,2019,19.0,2000.0,3.4,4,3,3,1,0,1,2,50.0,1,5,1,4,1,5,0,0,"MF,FW",Under 20,Midfielder,Brazil,South America
1905,Paulinho,BRA,Leverkusen,Bundesliga,2019,19.0,2000.0,3.4,4,3,3,1,0,1,2,50.0,1,5,1,4,1,5,0,0,"MF,FW",Under 20,Midfielder,Brazil,South America
1905,Paulinho,BRA,Leverkusen,Bundesliga,2019,19.0,2000.0,3.4,4,3,3,1,0,1,2,50.0,1,5,1,4,1,5,0,0,"MF,FW",Under 20,Midfielder,Brazil,South America
1905,Paulinho,BRA,Leverkusen,Bundesliga,2019,19.0,2000.0,3.4,4,3,3,1,0,1,2,50.0,1,5,1,4,1,5,0,0,"MF,FW",Under 20,Midfielder,Brazil,South America
1905,Paulinho,BRA,Leverkusen,Bundesliga,2019,19.0,2000.0,3.4,4,3,3,1,0,1,2,50.0,1,5,1,4,1,5,0,0,"MF,FW",Under 20,Midfielder,Brazil,South America
1905,Paulinho,BRA,Leverkusen,Bundesliga,2019,19.0,2000.0,3.4,4,3,3,1,0,1,2,50.0,1,5,1,4,1,5,0,0,"MF,FW",Under 20,Midfielder,Brazil,South America
1905,Paulinho,BRA,Leverkusen,Bundesliga,2019,19.0,2000.0,3.4,4,3,3,1,0,1,2,50.0,1,5,1,4,1,5,0,0,"MF,FW",Under 20,Midfielder,Brazil,South America
1905,Paulinho,BRA,Leverkusen,Bundesliga,2019,19.0,2000.0,3.4,4,3,3,1,0,1,2,50.0,1,5,1,4,1,5,0,0,"MF,FW",Under 20,Midfielder,Brazil,South America
1905,Paulinho,BRA,Leverkusen,Bundesliga,2019,19.0,2000.0,3.4,4,3,3,1,0,1,2,50.0,1,5,1,4,1,5,0,0,"MF,FW",Under 20,Midfielder,Brazil,South America
1905,Paulinho,BRA,Leverkusen,Bundesliga,2019,19.0,2000.0,3.4,4,3,3,1,0,1,2,50.0,1,5,1,4,1,5,0,0,"MF,FW",Under 20,Midfielder,Brazil,South America
1905,Paulinho,BRA,Leverkusen,Bundesliga,2019,19.0,2000.0,3.4,4,3,3,1,0,1,2,50.0,1,5,1,4,1,5,0,0,"MF,FW",Under 20,Midfielder,Brazil,South America
1905,Paulinho,BRA,Leverkusen,Bundesliga,2019,19.0,2000.0,3.4,4,3,3,1,0,1,2,50.0,1,5,1,4,1,5,0,0,"MF,FW",Under 20,Midfielder,Brazil,South America
1905,Paulinho,BRA,Leverkusen,Bundesliga,2019,19.0,2000.0,3.4,4,3,3,1,0,1,2,50.0,1,5,1,4,1,5,0,0,"MF,FW",Under 20,Midfielder,Brazil,South America
1905,Paulinho,BRA,Leverkusen,Bundesliga,2019,19.0,2000.0,3.4,4,3,3,1,0,1,2,50.0,1,5,1,4,1,5,0,0,"MF,FW",Under 20,Midfielder,Brazil,South America
1905,Paulinho,BRA,Leverkusen,Bundesliga,2019,19.0,2000.0,3.4,4,3,3,1,0,1,2,50.0,1,5,1,4,1,5,0,0,"MF,FW",Under 20,Midfielder,Brazil,South America
1905,Paulinho,BRA,Leverkusen,Bundesliga,2019,19.0,2000.0,3.4,4,3,3,1,0,1,2,50.0,1,5,1,4,1,5,0,0,"MF,FW",Under 20,Midfielder,Brazil,South America
1905,Paulinho,BRA,Leverkusen,Bundesliga,2019,19.0,2000.0,3.4,4,3,3,1,0,1,2,50.0,1,5,1,4,1,5,0,0,"MF,FW",Under 20,Midfielder,Brazil,South America
1905,Paulinho,BRA,Leverkusen,Bundesliga,2019,19.0,2000.0,3.4,4,3,3,1,0,1,2,50.0,1,5,1,4,1,5,0,0,"MF,FW",Under 20,Midfielder,Brazil,South America
1905,Paulinho,BRA,Leverkusen,Bundesliga,2019,19.0,2000.0,3.4,4,3,3,1,0,1,2,50.0,1,5,1,4,1,5,0,0,"MF,FW",Under 20,Midfielder,Brazil,South America
1905,Paulinho,BRA,Leverkusen,Bundesliga,2019,19.0,2000.0,3.4,4,3,3,1,0,1,2,50.0,1,5,1,4,1,5,0,0,"MF,FW",Under 20,Midfielder,Brazil,South America
1905,Paulinho,BRA,Leverkusen,Bundesliga,2019,19.0,2000.0,3.4,4,3,3,1,0,1,2,50.0,1,5,1,4,1,5,0,0,"MF,FW",Under 20,Midfielder,Brazil,South America
1905,Paulinho,BRA,Leverkusen,Bundesliga,2019,19.0,2000.0,3.4,4,3,3,1,0,1,2,50.0,1,5,1,4,1,5,0,0,"MF,FW",Under 20,Midfielder,Brazil,South America
1905,Paulinho,BRA,Leverkusen,Bundesliga,2019,19.0,2000.0,3.4,4,3,3,1,0,1,2,50.0,1,5,1,4,1,5,0,0,"MF,FW",Under 20,Midfielder,Brazil,South America
1905,Paulinho,BRA,Leverkusen,Bundesliga,2019,19.0,2000.0,3.4,4,3,3,1,0,1,2,50.0,1,5,1,4,1,5,0,0,"MF,FW",Under 20,Midfielder,Brazil,South America
1905,Paulinho,BRA,Leverkusen,Bundesliga,2019,19.0,2000.0,3.4,4,3,3,1,0,1,2,50.0,1,5,1,4,1,5,0,0,"MF,FW",Under 20,Midfielder,Brazil,South America
1905,Paulinho,BRA,Leverkusen,Bundesliga,2019,19.0,2000.0,3.4,4,3,3,1,0,1,2,50.0,1,5,1,4,1,5,0,0,"MF,FW",Under 20,Midfielder,Brazil,South America
1905,Paulinho,BRA,Leverkusen,Bundesliga,2019,19.0,2000.0,3.4,4,3,3,1,0,1,2,50.0,1,5,1,4,1,5,0,0,"MF,FW",Under 20,Midfielder,Brazil,South America
1905,Paulinho,BRA,Leverkusen,Bundesliga,2019,19.0,2000.0,3.4,4,3,3,1,0,1,2,50.0,1,5,1,4,1,5,0,0,"MF,FW",Under 20,Midfielder,Brazil,South America
1905,Paulinho,BRA,Leverkusen,Bundesliga,2019,19.0,2000.0,3.4,4,3,3,1,0,1,2,50.0,1,5,1,4,1,5,0,0,"MF,FW",Under 20,Midfielder,Brazil,South America
1908,Benjamin Pavard,FRA,Bayern Munich,Bundesliga,2019,23.0,1996.0,31.0,34,22,15,10,9,16,28,57.1,12,28,10,18,52,86,60,0,DF,20-24,Defender,France,Europe
1911,Leonardo Pavoletti,ITA,Cagliari,Serie A,2019,30.0,1988.0,0.5,0,0,0,0,0,0,0,,0,0,0,0,1,1,3,0,FW,30-34,Forward,Italy,Europe
1912,Dimitri Payet,FRA,Marseille,Ligue 1,2019,32.0,1987.0,21.4,22,12,8,8,6,10,26,38.5,16,8,1,7,8,30,12,0,"FW,MF",30-34,Forward,France,Europe
1913,Nehuén Paz,ARG,Bologna,Serie A,2019,26.0,1993.0,1.3,1,1,0,1,0,0,2,0.0,2,3,3,0,5,6,12,0,DF,25-29,Defender,Argentina,South America
1914,Nehuén Paz,ARG,Lecce,Serie A,2019,26.0,1993.0,9.4,14,5,11,3,0,10,12,83.3,2,12,6,6,20,34,38,1,DF,25-29,Defender,Argentina,South America
1915,Giampaolo Pazzini,ITA,Hellas Verona,Serie A,2019,34.0,1984.0,3.4,1,0,0,1,0,0,4,0.0,4,2,0,2,1,2,4,0,"FW,MF",30-34,Forward,Italy,Europe
1916,Mads Pedersen,DEN,Augsburg,Bundesliga,2019,22.0,1996.0,1.1,4,2,3,0,1,2,6,33.3,4,3,1,2,2,6,0,0,DF,20-24,Defender,Denmark,Europe
1916,Mads Pedersen,DEN,Augsburg,Bundesliga,2019,22.0,1996.0,1.1,4,2,3,0,1,2,6,33.3,4,3,1,2,2,6,0,0,DF,20-24,Defender,Denmark,Europe
1916,Mads Pedersen,DEN,Augsburg,Bundesliga,2019,22.0,1996.0,1.1,4,2,3,0,1,2,6,33.3,4,3,1,2,2,6,0,0,DF,20-24,Defender,Denmark,Europe
1916,Mads Pedersen,DEN,Augsburg,Bundesliga,2019,22.0,1996.0,1.1,4,2,3,0,1,2,6,33.3,4,3,1,2,2,6,0,0,DF,20-24,Defender,Denmark,Europe
1920,Pedro,BRA,Fiorentina,Serie A,2019,22.0,1997.0,0.7,1,1,0,0,1,0,0,,0,1,0,1,0,1,0,0,FW,20-24,Forward,Brazil,South America
1920,Pedro,BRA,Fiorentina,Serie A,2019,22.0,1997.0,0.7,1,1,0,0,1,0,0,,0,1,0,1,0,1,0,0,FW,20-24,Forward,Brazil,South America
1920,Pedro,BRA,Fiorentina,Serie A,2019,22.0,1997.0,0.7,1,1,0,0,1,0,0,,0,1,0,1,0,1,0,0,FW,20-24,Forward,Brazil,South America
1920,Pedro,BRA,Fiorentina,Serie A,2019,22.0,1997.0,0.7,1,1,0,0,1,0,0,,0,1,0,1,0,1,0,0,FW,20-24,Forward,Brazil,South America
1920,Pedro,BRA,Fiorentina,Serie A,2019,22.0,1997.0,0.7,1,1,0,0,1,0,0,,0,1,0,1,0,1,0,0,FW,20-24,Forward,Brazil,South America
1920,Pedro,BRA,Fiorentina,Serie A,2019,22.0,1997.0,0.7,1,1,0,0,1,0,0,,0,1,0,1,0,1,0,0,FW,20-24,Forward,Brazil,South America
1920,Pedro,BRA,Fiorentina,Serie A,2019,22.0,1997.0,0.7,1,1,0,0,1,0,0,,0,1,0,1,0,1,0,0,FW,20-24,Forward,Brazil,South America
1920,Pedro,BRA,Fiorentina,Serie A,2019,22.0,1997.0,0.7,1,1,0,0,1,0,0,,0,1,0,1,0,1,0,0,FW,20-24,Forward,Brazil,South America
1920,Pedro,BRA,Fiorentina,Serie A,2019,22.0,1997.0,0.7,1,1,0,0,1,0,0,,0,1,0,1,0,1,0,0,FW,20-24,Forward,Brazil,South America
1920,Pedro,BRA,Fiorentina,Serie A,2019,22.0,1997.0,0.7,1,1,0,0,1,0,0,,0,1,0,1,0,1,0,0,FW,20-24,Forward,Brazil,South America
1920,Pedro,BRA,Fiorentina,Serie A,2019,22.0,1997.0,0.7,1,1,0,0,1,0,0,,0,1,0,1,0,1,0,0,FW,20-24,Forward,Brazil,South America
1920,Pedro,BRA,Fiorentina,Serie A,2019,22.0,1997.0,0.7,1,1,0,0,1,0,0,,0,1,0,1,0,1,0,0,FW,20-24,Forward,Brazil,South America
1920,Pedro,BRA,Fiorentina,Serie A,2019,22.0,1997.0,0.7,1,1,0,0,1,0,0,,0,1,0,1,0,1,0,0,FW,20-24,Forward,Brazil,South America
1920,Pedro,BRA,Fiorentina,Serie A,2019,22.0,1997.0,0.7,1,1,0,0,1,0,0,,0,1,0,1,0,1,0,0,FW,20-24,Forward,Brazil,South America
1920,Pedro,BRA,Fiorentina,Serie A,2019,22.0,1997.0,0.7,1,1,0,0,1,0,0,,0,1,0,1,0,1,0,0,FW,20-24,Forward,Brazil,South America
1920,Pedro,BRA,Fiorentina,Serie A,2019,22.0,1997.0,0.7,1,1,0,0,1,0,0,,0,1,0,1,0,1,0,0,FW,20-24,Forward,Brazil,South America
1921,João Pedro,ITA,Cagliari,Serie A,2019,27.0,1992.0,35.0,17,11,5,7,5,4,24,16.7,20,35,8,27,9,26,39,0,"FW,MF",25-29,Forward,Italy,Europe
1921,João Pedro,ITA,Cagliari,Serie A,2019,27.0,1992.0,35.0,17,11,5,7,5,4,24,16.7,20,35,8,27,9,26,39,0,"FW,MF",25-29,Forward,Italy,Europe
1921,João Pedro,ITA,Cagliari,Serie A,2019,27.0,1992.0,35.0,17,11,5,7,5,4,24,16.7,20,35,8,27,9,26,39,0,"FW,MF",25-29,Forward,Italy,Europe
1921,João Pedro,ITA,Cagliari,Serie A,2019,27.0,1992.0,35.0,17,11,5,7,5,4,24,16.7,20,35,8,27,9,26,39,0,"FW,MF",25-29,Forward,Italy,Europe
1921,João Pedro,ITA,Cagliari,Serie A,2019,27.0,1992.0,35.0,17,11,5,7,5,4,24,16.7,20,35,8,27,9,26,39,0,"FW,MF",25-29,Forward,Italy,Europe
1921,João Pedro,ITA,Cagliari,Serie A,2019,27.0,1992.0,35.0,17,11,5,7,5,4,24,16.7,20,35,8,27,9,26,39,0,"FW,MF",25-29,Forward,Italy,Europe
1921,João Pedro,ITA,Cagliari,Serie A,2019,27.0,1992.0,35.0,17,11,5,7,5,4,24,16.7,20,35,8,27,9,26,39,0,"FW,MF",25-29,Forward,Italy,Europe
1921,João Pedro,ITA,Cagliari,Serie A,2019,27.0,1992.0,35.0,17,11,5,7,5,4,24,16.7,20,35,8,27,9,26,39,0,"FW,MF",25-29,Forward,Italy,Europe
1921,João Pedro,ITA,Cagliari,Serie A,2019,27.0,1992.0,35.0,17,11,5,7,5,4,24,16.7,20,35,8,27,9,26,39,0,"FW,MF",25-29,Forward,Italy,Europe
1921,João Pedro,ITA,Cagliari,Serie A,2019,27.0,1992.0,35.0,17,11,5,7,5,4,24,16.7,20,35,8,27,9,26,39,0,"FW,MF",25-29,Forward,Italy,Europe
1921,João Pedro,ITA,Cagliari,Serie A,2019,27.0,1992.0,35.0,17,11,5,7,5,4,24,16.7,20,35,8,27,9,26,39,0,"FW,MF",25-29,Forward,Italy,Europe
1921,João Pedro,ITA,Cagliari,Serie A,2019,27.0,1992.0,35.0,17,11,5,7,5,4,24,16.7,20,35,8,27,9,26,39,0,"FW,MF",25-29,Forward,Italy,Europe
1921,João Pedro,ITA,Cagliari,Serie A,2019,27.0,1992.0,35.0,17,11,5,7,5,4,24,16.7,20,35,8,27,9,26,39,0,"FW,MF",25-29,Forward,Italy,Europe
1921,João Pedro,ITA,Cagliari,Serie A,2019,27.0,1992.0,35.0,17,11,5,7,5,4,24,16.7,20,35,8,27,9,26,39,0,"FW,MF",25-29,Forward,Italy,Europe
1921,João Pedro,ITA,Cagliari,Serie A,2019,27.0,1992.0,35.0,17,11,5,7,5,4,24,16.7,20,35,8,27,9,26,39,0,"FW,MF",25-29,Forward,Italy,Europe
1921,João Pedro,ITA,Cagliari,Serie A,2019,27.0,1992.0,35.0,17,11,5,7,5,4,24,16.7,20,35,8,27,9,26,39,0,"FW,MF",25-29,Forward,Italy,Europe
1921,João Pedro,ITA,Cagliari,Serie A,2019,27.0,1992.0,35.0,17,11,5,7,5,4,24,16.7,20,35,8,27,9,26,39,0,"FW,MF",25-29,Forward,Italy,Europe
1921,João Pedro,ITA,Cagliari,Serie A,2019,27.0,1992.0,35.0,17,11,5,7,5,4,24,16.7,20,35,8,27,9,26,39,0,"FW,MF",25-29,Forward,Italy,Europe
1921,João Pedro,ITA,Cagliari,Serie A,2019,27.0,1992.0,35.0,17,11,5,7,5,4,24,16.7,20,35,8,27,9,26,39,0,"FW,MF",25-29,Forward,Italy,Europe
1921,João Pedro,ITA,Cagliari,Serie A,2019,27.0,1992.0,35.0,17,11,5,7,5,4,24,16.7,20,35,8,27,9,26,39,0,"FW,MF",25-29,Forward,Italy,Europe
1921,João Pedro,ITA,Cagliari,Serie A,2019,27.0,1992.0,35.0,17,11,5,7,5,4,24,16.7,20,35,8,27,9,26,39,0,"FW,MF",25-29,Forward,Italy,Europe
1921,João Pedro,ITA,Cagliari,Serie A,2019,27.0,1992.0,35.0,17,11,5,7,5,4,24,16.7,20,35,8,27,9,26,39,0,"FW,MF",25-29,Forward,Italy,Europe
1921,João Pedro,ITA,Cagliari,Serie A,2019,27.0,1992.0,35.0,17,11,5,7,5,4,24,16.7,20,35,8,27,9,26,39,0,"FW,MF",25-29,Forward,Italy,Europe
1921,João Pedro,ITA,Cagliari,Serie A,2019,27.0,1992.0,35.0,17,11,5,7,5,4,24,16.7,20,35,8,27,9,26,39,0,"FW,MF",25-29,Forward,Italy,Europe
1921,João Pedro,ITA,Cagliari,Serie A,2019,27.0,1992.0,35.0,17,11,5,7,5,4,24,16.7,20,35,8,27,9,26,39,0,"FW,MF",25-29,Forward,Italy,Europe
1921,João Pedro,ITA,Cagliari,Serie A,2019,27.0,1992.0,35.0,17,11,5,7,5,4,24,16.7,20,35,8,27,9,26,39,0,"FW,MF",25-29,Forward,Italy,Europe
1921,João Pedro,ITA,Cagliari,Serie A,2019,27.0,1992.0,35.0,17,11,5,7,5,4,24,16.7,20,35,8,27,9,26,39,0,"FW,MF",25-29,Forward,Italy,Europe
1921,João Pedro,ITA,Cagliari,Serie A,2019,27.0,1992.0,35.0,17,11,5,7,5,4,24,16.7,20,35,8,27,9,26,39,0,"FW,MF",25-29,Forward,Italy,Europe
1921,João Pedro,ITA,Cagliari,Serie A,2019,27.0,1992.0,35.0,17,11,5,7,5,4,24,16.7,20,35,8,27,9,26,39,0,"FW,MF",25-29,Forward,Italy,Europe
1921,João Pedro,ITA,Cagliari,Serie A,2019,27.0,1992.0,35.0,17,11,5,7,5,4,24,16.7,20,35,8,27,9,26,39,0,"FW,MF",25-29,Forward,Italy,Europe
1921,João Pedro,ITA,Cagliari,Serie A,2019,27.0,1992.0,35.0,17,11,5,7,5,4,24,16.7,20,35,8,27,9,26,39,0,"FW,MF",25-29,Forward,Italy,Europe
1921,João Pedro,ITA,Cagliari,Serie A,2019,27.0,1992.0,35.0,17,11,5,7,5,4,24,16.7,20,35,8,27,9,26,39,0,"FW,MF",25-29,Forward,Italy,Europe
1921,João Pedro,ITA,Cagliari,Serie A,2019,27.0,1992.0,35.0,17,11,5,7,5,4,24,16.7,20,35,8,27,9,26,39,0,"FW,MF",25-29,Forward,Italy,Europe
1921,João Pedro,ITA,Cagliari,Serie A,2019,27.0,1992.0,35.0,17,11,5,7,5,4,24,16.7,20,35,8,27,9,26,39,0,"FW,MF",25-29,Forward,Italy,Europe
1921,João Pedro,ITA,Cagliari,Serie A,2019,27.0,1992.0,35.0,17,11,5,7,5,4,24,16.7,20,35,8,27,9,26,39,0,"FW,MF",25-29,Forward,Italy,Europe
1921,João Pedro,ITA,Cagliari,Serie A,2019,27.0,1992.0,35.0,17,11,5,7,5,4,24,16.7,20,35,8,27,9,26,39,0,"FW,MF",25-29,Forward,Italy,Europe
1921,João Pedro,ITA,Cagliari,Serie A,2019,27.0,1992.0,35.0,17,11,5,7,5,4,24,16.7,20,35,8,27,9,26,39,0,"FW,MF",25-29,Forward,Italy,Europe
1921,João Pedro,ITA,Cagliari,Serie A,2019,27.0,1992.0,35.0,17,11,5,7,5,4,24,16.7,20,35,8,27,9,26,39,0,"FW,MF",25-29,Forward,Italy,Europe
1921,João Pedro,ITA,Cagliari,Serie A,2019,27.0,1992.0,35.0,17,11,5,7,5,4,24,16.7,20,35,8,27,9,26,39,0,"FW,MF",25-29,Forward,Italy,Europe
1921,João Pedro,ITA,Cagliari,Serie A,2019,27.0,1992.0,35.0,17,11,5,7,5,4,24,16.7,20,35,8,27,9,26,39,0,"FW,MF",25-29,Forward,Italy,Europe
1921,João Pedro,ITA,Cagliari,Serie A,2019,27.0,1992.0,35.0,17,11,5,7,5,4,24,16.7,20,35,8,27,9,26,39,0,"FW,MF",25-29,Forward,Italy,Europe
1921,João Pedro,ITA,Cagliari,Serie A,2019,27.0,1992.0,35.0,17,11,5,7,5,4,24,16.7,20,35,8,27,9,26,39,0,"FW,MF",25-29,Forward,Italy,Europe
1921,João Pedro,ITA,Cagliari,Serie A,2019,27.0,1992.0,35.0,17,11,5,7,5,4,24,16.7,20,35,8,27,9,26,39,0,"FW,MF",25-29,Forward,Italy,Europe
1921,João Pedro,ITA,Cagliari,Serie A,2019,27.0,1992.0,35.0,17,11,5,7,5,4,24,16.7,20,35,8,27,9,26,39,0,"FW,MF",25-29,Forward,Italy,Europe
1921,João Pedro,ITA,Cagliari,Serie A,2019,27.0,1992.0,35.0,17,11,5,7,5,4,24,16.7,20,35,8,27,9,26,39,0,"FW,MF",25-29,Forward,Italy,Europe
1921,João Pedro,ITA,Cagliari,Serie A,2019,27.0,1992.0,35.0,17,11,5,7,5,4,24,16.7,20,35,8,27,9,26,39,0,"FW,MF",25-29,Forward,Italy,Europe
1921,João Pedro,ITA,Cagliari,Serie A,2019,27.0,1992.0,35.0,17,11,5,7,5,4,24,16.7,20,35,8,27,9,26,39,0,"FW,MF",25-29,Forward,Italy,Europe
1921,João Pedro,ITA,Cagliari,Serie A,2019,27.0,1992.0,35.0,17,11,5,7,5,4,24,16.7,20,35,8,27,9,26,39,0,"FW,MF",25-29,Forward,Italy,Europe
1921,João Pedro,ITA,Cagliari,Serie A,2019,27.0,1992.0,35.0,17,11,5,7,5,4,24,16.7,20,35,8,27,9,26,39,0,"FW,MF",25-29,Forward,Italy,Europe
1921,João Pedro,ITA,Cagliari,Serie A,2019,27.0,1992.0,35.0,17,11,5,7,5,4,24,16.7,20,35,8,27,9,26,39,0,"FW,MF",25-29,Forward,Italy,Europe
1921,João Pedro,ITA,Cagliari,Serie A,2019,27.0,1992.0,35.0,17,11,5,7,5,4,24,16.7,20,35,8,27,9,26,39,0,"FW,MF",25-29,Forward,Italy,Europe
1921,João Pedro,ITA,Cagliari,Serie A,2019,27.0,1992.0,35.0,17,11,5,7,5,4,24,16.7,20,35,8,27,9,26,39,0,"FW,MF",25-29,Forward,Italy,Europe
1921,João Pedro,ITA,Cagliari,Serie A,2019,27.0,1992.0,35.0,17,11,5,7,5,4,24,16.7,20,35,8,27,9,26,39,0,"FW,MF",25-29,Forward,Italy,Europe
1921,João Pedro,ITA,Cagliari,Serie A,2019,27.0,1992.0,35.0,17,11,5,7,5,4,24,16.7,20,35,8,27,9,26,39,0,"FW,MF",25-29,Forward,Italy,Europe
1921,João Pedro,ITA,Cagliari,Serie A,2019,27.0,1992.0,35.0,17,11,5,7,5,4,24,16.7,20,35,8,27,9,26,39,0,"FW,MF",25-29,Forward,Italy,Europe
1921,João Pedro,ITA,Cagliari,Serie A,2019,27.0,1992.0,35.0,17,11,5,7,5,4,24,16.7,20,35,8,27,9,26,39,0,"FW,MF",25-29,Forward,Italy,Europe
1921,João Pedro,ITA,Cagliari,Serie A,2019,27.0,1992.0,35.0,17,11,5,7,5,4,24,16.7,20,35,8,27,9,26,39,0,"FW,MF",25-29,Forward,Italy,Europe
1921,João Pedro,ITA,Cagliari,Serie A,2019,27.0,1992.0,35.0,17,11,5,7,5,4,24,16.7,20,35,8,27,9,26,39,0,"FW,MF",25-29,Forward,Italy,Europe
1921,João Pedro,ITA,Cagliari,Serie A,2019,27.0,1992.0,35.0,17,11,5,7,5,4,24,16.7,20,35,8,27,9,26,39,0,"FW,MF",25-29,Forward,Italy,Europe
1921,João Pedro,ITA,Cagliari,Serie A,2019,27.0,1992.0,35.0,17,11,5,7,5,4,24,16.7,20,35,8,27,9,26,39,0,"FW,MF",25-29,Forward,Italy,Europe
1921,João Pedro,ITA,Cagliari,Serie A,2019,27.0,1992.0,35.0,17,11,5,7,5,4,24,16.7,20,35,8,27,9,26,39,0,"FW,MF",25-29,Forward,Italy,Europe
1921,João Pedro,ITA,Cagliari,Serie A,2019,27.0,1992.0,35.0,17,11,5,7,5,4,24,16.7,20,35,8,27,9,26,39,0,"FW,MF",25-29,Forward,Italy,Europe
1921,João Pedro,ITA,Cagliari,Serie A,2019,27.0,1992.0,35.0,17,11,5,7,5,4,24,16.7,20,35,8,27,9,26,39,0,"FW,MF",25-29,Forward,Italy,Europe
1921,João Pedro,ITA,Cagliari,Serie A,2019,27.0,1992.0,35.0,17,11,5,7,5,4,24,16.7,20,35,8,27,9,26,39,0,"FW,MF",25-29,Forward,Italy,Europe
1921,João Pedro,ITA,Cagliari,Serie A,2019,27.0,1992.0,35.0,17,11,5,7,5,4,24,16.7,20,35,8,27,9,26,39,0,"FW,MF",25-29,Forward,Italy,Europe
1921,João Pedro,ITA,Cagliari,Serie A,2019,27.0,1992.0,35.0,17,11,5,7,5,4,24,16.7,20,35,8,27,9,26,39,0,"FW,MF",25-29,Forward,Italy,Europe
1921,João Pedro,ITA,Cagliari,Serie A,2019,27.0,1992.0,35.0,17,11,5,7,5,4,24,16.7,20,35,8,27,9,26,39,0,"FW,MF",25-29,Forward,Italy,Europe
1921,João Pedro,ITA,Cagliari,Serie A,2019,27.0,1992.0,35.0,17,11,5,7,5,4,24,16.7,20,35,8,27,9,26,39,0,"FW,MF",25-29,Forward,Italy,Europe
1921,João Pedro,ITA,Cagliari,Serie A,2019,27.0,1992.0,35.0,17,11,5,7,5,4,24,16.7,20,35,8,27,9,26,39,0,"FW,MF",25-29,Forward,Italy,Europe
1921,João Pedro,ITA,Cagliari,Serie A,2019,27.0,1992.0,35.0,17,11,5,7,5,4,24,16.7,20,35,8,27,9,26,39,0,"FW,MF",25-29,Forward,Italy,Europe
1921,João Pedro,ITA,Cagliari,Serie A,2019,27.0,1992.0,35.0,17,11,5,7,5,4,24,16.7,20,35,8,27,9,26,39,0,"FW,MF",25-29,Forward,Italy,Europe
1921,João Pedro,ITA,Cagliari,Serie A,2019,27.0,1992.0,35.0,17,11,5,7,5,4,24,16.7,20,35,8,27,9,26,39,0,"FW,MF",25-29,Forward,Italy,Europe
1921,João Pedro,ITA,Cagliari,Serie A,2019,27.0,1992.0,35.0,17,11,5,7,5,4,24,16.7,20,35,8,27,9,26,39,0,"FW,MF",25-29,Forward,Italy,Europe
1921,João Pedro,ITA,Cagliari,Serie A,2019,27.0,1992.0,35.0,17,11,5,7,5,4,24,16.7,20,35,8,27,9,26,39,0,"FW,MF",25-29,Forward,Italy,Europe
1921,João Pedro,ITA,Cagliari,Serie A,2019,27.0,1992.0,35.0,17,11,5,7,5,4,24,16.7,20,35,8,27,9,26,39,0,"FW,MF",25-29,Forward,Italy,Europe
1921,João Pedro,ITA,Cagliari,Serie A,2019,27.0,1992.0,35.0,17,11,5,7,5,4,24,16.7,20,35,8,27,9,26,39,0,"FW,MF",25-29,Forward,Italy,Europe
1921,João Pedro,ITA,Cagliari,Serie A,2019,27.0,1992.0,35.0,17,11,5,7,5,4,24,16.7,20,35,8,27,9,26,39,0,"FW,MF",25-29,Forward,Italy,Europe
1921,João Pedro,ITA,Cagliari,Serie A,2019,27.0,1992.0,35.0,17,11,5,7,5,4,24,16.7,20,35,8,27,9,26,39,0,"FW,MF",25-29,Forward,Italy,Europe
1921,João Pedro,ITA,Cagliari,Serie A,2019,27.0,1992.0,35.0,17,11,5,7,5,4,24,16.7,20,35,8,27,9,26,39,0,"FW,MF",25-29,Forward,Italy,Europe
1921,João Pedro,ITA,Cagliari,Serie A,2019,27.0,1992.0,35.0,17,11,5,7,5,4,24,16.7,20,35,8,27,9,26,39,0,"FW,MF",25-29,Forward,Italy,Europe
1921,João Pedro,ITA,Cagliari,Serie A,2019,27.0,1992.0,35.0,17,11,5,7,5,4,24,16.7,20,35,8,27,9,26,39,0,"FW,MF",25-29,Forward,Italy,Europe
1925,Gianluca Pegolo,ITA,Sassuolo,Serie A,2019,38.0,1981.0,5.0,0,0,0,0,0,0,0,,0,0,0,0,0,0,4,0,GK,35-39,Goalkeeper,Italy,Europe
1927,Yohann Pelé,FRA,Marseille,Ligue 1,2019,36.0,1982.0,1.7,0,0,0,0,0,0,0,,0,0,0,0,0,0,0,0,GK,35-39,Goalkeeper,France,Europe
1928,Lorenzo Pellegrini,ITA,Roma,Serie A,2019,23.0,1996.0,23.3,30,13,9,13,8,12,33,36.4,21,28,0,28,15,45,18,0,MF,20-24,Midfielder,Italy,Europe
1929,Luca Pellegrini,ITA,Cagliari,Serie A,2019,20.0,1999.0,21.2,31,15,20,7,4,15,38,39.5,23,19,2,17,21,52,45,2,DF,20-24,Defender,Italy,Europe
1930,Théo Pellenard,FRA,Angers,Ligue 1,2019,25.0,1994.0,5.1,11,8,6,3,2,6,13,46.2,7,4,0,4,5,16,8,0,DF,25-29,Defender,France,Europe
1931,Andy Pelmard,FRA,Nice,Ligue 1,2019,19.0,2000.0,8.5,22,14,13,9,0,9,11,81.8,2,12,4,8,15,37,28,1,DF,Under 20,Defender,France,Europe
1932,Federico Peluso,ITA,Sassuolo,Serie A,2019,35.0,1984.0,16.8,19,16,8,8,3,8,9,88.9,1,14,9,5,22,41,58,1,DF,35-39,Defender,Italy,Europe
1934,Philipp Pentke,GER,Hoffenheim,Bundesliga,2019,34.0,1985.0,4.0,0,0,0,0,0,0,0,,0,0,0,0,0,0,2,0,GK,30-34,Goalkeeper,Germany,Europe
1935,Nicolas Pépé,CIV,Arsenal,Premier League,2019,24.0,1995.0,22.3,32,17,15,13,4,8,16,50.0,8,15,2,13,8,40,5,0,FW,20-24,Forward,Ivory Coast,Africa
1937,Andreas Pereira,BRA,Manchester Utd,Premier League,2019,23.0,1996.0,16.5,24,13,8,9,7,10,39,25.6,29,13,0,13,7,31,7,0,"MF,FW",20-24,Midfielder,Brazil,South America
1938,Mathias Pereira Lage,POR,Angers,Ligue 1,2019,22.0,1996.0,17.1,30,18,16,13,1,12,37,32.4,25,19,0,19,17,47,9,0,MF,20-24,Midfielder,Portugal,Europe
1939,Ricardo Pereira,POR,Leicester City,Premier League,2019,25.0,1993.0,28.0,119,68,65,36,18,53,106,50.0,53,38,6,32,49,168,86,0,DF,25-29,Defender,Portugal,Europe
1940,Gastón Pereiro,URU,Cagliari,Serie A,2019,24.0,1995.0,3.9,2,2,2,0,0,1,4,25.0,3,1,0,1,0,2,1,1,"MF,FW",20-24,Midfielder,Uruguay,South America
1952,Mattia Perin,ITA,Genoa,Serie A,2019,26.0,1992.0,21.0,1,1,1,0,0,1,1,100.0,0,1,0,1,0,1,5,1,GK,25-29,Goalkeeper,Italy,Europe
1954,Diego Perotti,ARG,Roma,Serie A,2019,31.0,1988.0,9.7,16,13,5,8,3,5,20,25.0,15,14,0,14,3,19,6,0,"FW,MF",30-34,Forward,Argentina,South America
1955,Romain Perraud,FRA,Brest,Ligue 1,2019,21.0,1997.0,18.6,29,14,18,9,2,14,28,50.0,14,24,9,15,27,56,50,0,DF,20-24,Defender,France,Europe
1956,Loïc Perrin,FRA,Saint-Étienne,Ligue 1,2019,33.0,1985.0,19.0,27,20,16,11,0,11,14,78.6,3,23,17,6,39,66,59,0,DF,30-34,Defender,France,Europe
1958,Pavao Pervan,AUT,Wolfsburg,Bundesliga,2019,31.0,1987.0,8.0,0,0,0,0,0,0,1,0.0,1,0,0,0,0,0,4,0,GK,30-34,Goalkeeper,Austria,Europe
1959,Matteo Pessina,ITA,Hellas Verona,Serie A,2019,22.0,1997.0,27.7,35,21,9,20,6,12,33,36.4,21,28,8,20,25,60,40,2,MF,20-24,Midfielder,Italy,Europe
1960,Andrea Petagna,ITA,SPAL,Serie A,2019,24.0,1995.0,33.7,9,4,2,7,0,3,17,17.6,14,11,5,6,1,10,27,0,FW,20-24,Forward,Italy,Europe
1961,Nils Petersen,GER,Freiburg,Bundesliga,2019,30.0,1988.0,27.1,19,14,7,9,3,10,28,35.7,18,32,6,26,10,29,67,0,"FW,MF",30-34,Forward,Germany,Europe
1964,Jacopo Petriccione,ITA,Lecce,Serie A,2019,24.0,1995.0,23.8,38,20,29,9,0,15,57,26.3,42,20,7,13,28,66,25,2,MF,20-24,Midfielder,Italy,Europe
1965,Germán Pezzella,ARG,Fiorentina,Serie A,2019,28.0,1991.0,31.4,36,18,26,9,1,14,32,43.8,18,31,20,11,55,91,134,1,DF,25-29,Defender,Argentina,South America
1966,Giuseppe Pezzella,ITA,Udinese,Serie A,2019,21.0,1997.0,0.9,0,0,0,0,0,0,0,,0,0,0,0,1,1,4,0,DF,20-24,Defender,Italy,Europe
1967,Giuseppe Pezzella,ITA,Parma,Serie A,2019,21.0,1997.0,10.5,20,12,17,3,0,11,19,57.9,8,13,9,4,6,26,30,0,DF,20-24,Defender,Italy,Europe
1969,Romain Philippoteaux,FRA,Nîmes,Ligue 1,2019,31.0,1988.0,22.2,23,12,11,11,1,9,43,20.9,34,22,1,21,13,36,10,0,"FW,MF",30-34,Forward,France,Europe
1972,Pablo Piatti,ARG,Espanyol,La Liga,2019,30.0,1989.0,0.6,2,2,1,1,0,1,2,50.0,1,1,0,1,0,2,1,0,"DF,MF",30-34,Defender,Argentina,South America
1973,Cristiano Piccini,ITA,Valencia,La Liga,2019,26.0,1992.0,0.8,5,4,1,0,4,4,4,100.0,0,0,0,0,2,7,1,0,DF,25-29,Defender,Italy,Europe
1976,Jordan Pickford,ENG,Everton,Premier League,2019,25.0,1994.0,38.0,0,0,0,0,0,0,4,0.0,4,0,0,0,3,3,12,6,GK,25-29,Goalkeeper,England,Europe
1977,Jérémy Pied,FRA,Lille,Ligue 1,2019,30.0,1989.0,5.0,18,10,6,11,1,11,16,68.8,5,8,0,8,7,25,10,0,DF,30-34,Defender,France,Europe
1978,Ronaël Pierre-Gabriel,FRA,Mainz 05,Bundesliga,2019,21.0,1998.0,6.4,16,10,9,6,1,7,13,53.8,6,7,0,7,8,24,31,1,DF,20-24,Defender,France,Europe
1980,Erik Pieters,NED,Burnley,Premier League,2019,30.0,1988.0,20.9,54,32,18,29,7,28,69,40.6,41,30,4,26,28,82,60,1,"DF,MF",30-34,Defender,Netherlands,Europe
1982,Andrea Pinamonti,ITA,Genoa,Serie A,2019,20.0,1999.0,24.8,19,12,1,7,11,5,25,20.0,20,19,2,17,9,28,25,0,FW,20-24,Forward,Italy,Europe
1983,Simone Pinna,ITA,Cagliari,Serie A,2019,21.0,1997.0,1.0,1,1,0,1,0,0,0,,0,3,1,2,5,6,4,1,DF,20-24,Defender,Italy,Europe
1984,Carlo Pinsoglio,ITA,Juventus,Serie A,2019,29.0,1990.0,0.2,0,0,0,0,0,0,0,,0,0,0,0,0,0,0,0,GK,25-29,Goalkeeper,Italy,Europe
1988,Fabio Pisacane,ITA,Cagliari,Serie A,2019,33.0,1986.0,27.1,32,21,22,10,0,21,37,56.8,16,36,28,8,27,59,110,2,DF,30-34,Defender,Italy,Europe
1990,Claudio Pizarro,PER,Werder Bremen,Bundesliga,2019,40.0,1978.0,2.6,2,1,0,1,1,0,1,0.0,1,2,0,2,2,4,2,0,"FW,MF",Over 40,Forward,Peru,South America
1993,Marvin Plattenhardt,GER,Hertha BSC,Bundesliga,2019,27.0,1992.0,15.5,18,12,13,4,1,12,17,70.6,5,18,7,11,11,29,47,0,DF,25-29,Defender,Germany,Europe
1994,Alassane Pléa,FRA,Gladbach,Bundesliga,2019,26.0,1993.0,23.8,16,7,5,6,5,8,28,28.6,20,21,2,19,9,25,7,0,FW,25-29,Forward,France,Europe
1995,Thomas Pledl,GER,Düsseldorf,Bundesliga,2019,25.0,1994.0,1.0,4,2,2,2,0,0,1,0.0,1,0,0,0,0,4,1,0,"MF,FW",25-29,Midfielder,Germany,Europe
1997,Paul Pogba,FRA,Manchester Utd,Premier League,2019,26.0,1993.0,13.4,20,9,8,8,4,8,16,50.0,8,12,4,8,7,27,10,2,MF,25-29,Midfielder,France,Europe
1998,Joel Pohjanpalo,FIN,Leverkusen,Bundesliga,2019,24.0,1994.0,0.0,0,0,0,0,0,0,0,,0,0,0,0,0,0,0,0,MF,20-24,Midfielder,Finland,Europe
2000,Matteo Politano,ITA,Napoli,Serie A,2019,25.0,1993.0,8.3,12,6,8,2,2,5,14,35.7,9,6,0,6,5,17,3,0,FW,25-29,Forward,Italy,Europe
2001,Matteo Politano,ITA,Inter,Serie A,2019,25.0,1993.0,2.9,0,0,0,0,0,0,2,0.0,2,1,0,1,0,0,1,0,"FW,MF",25-29,Forward,Italy,Europe
2002,Sebastian Polter,GER,Union Berlin,Bundesliga,2019,28.0,1991.0,3.7,2,2,0,1,1,1,3,33.3,2,2,0,2,1,3,1,0,FW,25-29,Forward,Germany,Europe
2003,Marin Pongračić,CRO,Wolfsburg,Bundesliga,2019,21.0,1997.0,10.3,14,9,11,2,1,9,10,90.0,1,11,7,4,19,33,21,1,DF,20-24,Defender,Croatia,Europe
2005,Nick Pope,ENG,Burnley,Premier League,2019,27.0,1992.0,38.0,1,1,1,0,0,1,2,50.0,1,0,0,0,3,4,15,3,GK,25-29,Goalkeeper,England,Europe
2009,Stefan Posch,AUT,Hoffenheim,Bundesliga,2019,22.0,1997.0,25.6,63,34,35,27,1,35,63,55.6,28,57,25,32,40,103,101,1,DF,20-24,Defender,Austria,Europe
2012,Yussuf Poulsen,DEN,RB Leipzig,Bundesliga,2019,25.0,1994.0,13.6,14,10,2,10,2,4,21,19.0,17,12,0,12,4,18,15,0,FW,25-29,Forward,Denmark,Europe
2013,Maxime Poundjé,FRA,Bordeaux,Ligue 1,2019,26.0,1992.0,0.0,0,0,0,0,0,0,0,,0,0,0,0,0,0,0,0,DF,25-29,Defender,France,Europe
2021,Nicolas de Préville,FRA,Bordeaux,Ligue 1,2019,28.0,1991.0,22.2,35,21,9,22,4,18,56,32.1,38,15,3,12,6,41,19,0,"MF,FW",25-29,Midfielder,France,Europe
2022,Sebastian Prödl,AUT,Watford,Premier League,2019,32.0,1987.0,0.6,0,0,0,0,0,0,0,,0,0,0,0,0,0,4,0,DF,30-34,Defender,Austria,Europe
2023,Kai Pröger,GER,Paderborn 07,Bundesliga,2019,27.0,1992.0,23.1,43,22,21,17,5,17,58,29.3,41,34,6,28,14,57,20,1,"MF,FW",25-29,Midfielder,Germany,Europe
2024,Grischa Prömel,GER,Union Berlin,Bundesliga,2019,24.0,1995.0,10.3,14,11,6,6,2,7,19,36.8,12,10,2,8,14,28,9,0,MF,20-24,Midfielder,Germany,Europe
2028,Teemu Pukki,FIN,Norwich City,Premier League,2019,29.0,1990.0,32.1,12,6,3,5,4,1,23,4.3,22,13,0,13,6,18,7,0,FW,25-29,Forward,Finland,Europe
2029,Erick Pulgar,CHI,Fiorentina,Serie A,2019,25.0,1994.0,32.8,73,46,25,41,7,22,96,22.9,74,45,15,30,49,122,53,1,MF,25-29,Midfielder,Chile,South America
2030,Christian Pulisic,USA,Chelsea,Premier League,2019,20.0,1998.0,19.1,23,11,13,4,6,7,24,29.2,17,15,0,15,6,29,11,0,FW,20-24,Forward,United States,North America
2031,Ignacio Pussetto,ARG,Watford,Premier League,2019,23.0,1995.0,0.8,7,4,4,2,1,3,8,37.5,5,2,1,1,3,10,4,0,"FW,MF",20-24,Forward,Argentina,South America
2032,Ignacio Pussetto,ARG,Udinese,Serie A,2019,23.0,1995.0,3.8,8,4,4,3,1,1,4,25.0,3,3,0,3,4,12,7,0,"FW,MF",20-24,Forward,Argentina,South America
2033,Fabio Quagliarella,ITA,Sampdoria,Serie A,2019,36.0,1983.0,25.3,9,5,0,6,3,2,30,6.7,28,13,0,13,8,17,15,0,FW,35-39,Forward,Italy,Europe
2035,Domingos Quina,POR,Watford,Premier League,2019,19.0,1999.0,0.2,2,0,1,1,0,1,2,50.0,1,3,0,3,0,2,0,0,"MF,FW",Under 20,Midfielder,Portugal,Europe
2039,Adrien Rabiot,FRA,Juventus,Serie A,2019,24.0,1995.0,21.2,47,31,16,19,12,15,41,36.6,26,36,6,30,32,79,19,0,MF,20-24,Midfielder,France,Europe
2046,Rafael,BRA,Cagliari,Serie A,2019,37.0,1982.0,5.0,0,0,0,0,0,0,0,,0,0,0,0,0,0,3,0,GK,35-39,Goalkeeper,Brazil,South America
2046,Rafael,BRA,Cagliari,Serie A,2019,37.0,1982.0,5.0,0,0,0,0,0,0,0,,0,0,0,0,0,0,3,0,GK,35-39,Goalkeeper,Brazil,South America
2046,Rafael,BRA,Cagliari,Serie A,2019,37.0,1982.0,5.0,0,0,0,0,0,0,0,,0,0,0,0,0,0,3,0,GK,35-39,Goalkeeper,Brazil,South America
2046,Rafael,BRA,Cagliari,Serie A,2019,37.0,1982.0,5.0,0,0,0,0,0,0,0,,0,0,0,0,0,0,3,0,GK,35-39,Goalkeeper,Brazil,South America
2047,Rafael,BRA,Lyon,Ligue 1,2019,29.0,1990.0,7.8,24,16,12,8,4,10,18,55.6,8,6,3,3,10,34,14,0,DF,25-29,Defender,Brazil,South America
2047,Rafael,BRA,Lyon,Ligue 1,2019,29.0,1990.0,7.8,24,16,12,8,4,10,18,55.6,8,6,3,3,10,34,14,0,DF,25-29,Defender,Brazil,South America
2047,Rafael,BRA,Lyon,Ligue 1,2019,29.0,1990.0,7.8,24,16,12,8,4,10,18,55.6,8,6,3,3,10,34,14,0,DF,25-29,Defender,Brazil,South America
2047,Rafael,BRA,Lyon,Ligue 1,2019,29.0,1990.0,7.8,24,16,12,8,4,10,18,55.6,8,6,3,3,10,34,14,0,DF,25-29,Defender,Brazil,South America
2048,Raffael,BRA,Gladbach,Bundesliga,2019,34.0,1985.0,0.7,0,0,0,0,0,0,2,0.0,2,2,0,2,0,0,0,0,"MF,FW",30-34,Midfielder,Brazil,South America
19,Adrián,ESP,Liverpool,Premier League,2019,32.0,1987.0,9.7,1,1,1,0,0,1,1,100.0,0,0,0,0,0,1,8,3,GK,30-34,Goalkeeper,Spain,Europe
20,Aritz Aduriz,ESP,Athletic Club,La Liga,2019,38.0,1981.0,2.3,3,2,0,3,0,0,0,,0,0,0,0,0,3,2,0,"FW,MF",35-39,Forward,Spain,Europe
45,Jordi Alba,ESP,Barcelona,La Liga,2019,30.0,1989.0,24.3,20,13,9,7,4,6,27,22.2,21,12,3,9,37,57,40,0,DF,30-34,Defender,Spain,Europe
46,Luis Alberto,ESP,Lazio,Serie A,2019,26.0,1992.0,34.6,50,30,21,19,10,27,82,32.9,55,32,1,31,21,71,9,1,MF,25-29,Midfielder,Spain,Europe
47,Raúl Albiol,ESP,Villarreal,La Liga,2019,33.0,1985.0,36.0,43,23,27,16,0,18,27,66.7,9,29,21,8,42,85,175,2,DF,30-34,Defender,Spain,Europe
49,Paco Alcácer,ESP,Villarreal,La Liga,2019,25.0,1993.0,10.3,3,3,2,1,0,1,7,14.3,6,4,1,3,2,5,10,0,FW,25-29,Forward,Spain,Europe
50,Paco Alcácer,ESP,Dortmund,Bundesliga,2019,25.0,1993.0,5.9,2,2,0,2,0,1,5,20.0,4,4,1,3,2,4,3,0,FW,25-29,Forward,Spain,Europe
51,Thiago Alcántara,ESP,Bayern Munich,Bundesliga,2019,28.0,1991.0,19.7,45,26,17,23,5,12,33,36.4,21,12,3,9,45,90,13,1,MF,25-29,Midfielder,Spain,Europe
52,Rubén Alcaraz,ESP,Valladolid,La Liga,2019,28.0,1991.0,21.4,61,30,37,20,4,30,63,47.6,33,46,15,31,15,76,41,0,MF,25-29,Midfielder,Spain,Europe
55,Álex Alegría,ESP,Mallorca,La Liga,2019,26.0,1992.0,1.2,1,0,1,0,0,0,0,,0,2,0,2,0,1,0,0,FW,25-29,Forward,Spain,Europe
56,Carles Aleñá,ESP,Barcelona,La Liga,2019,21.0,1998.0,1.9,2,1,1,1,0,1,4,25.0,3,1,0,1,0,2,0,0,MF,20-24,Midfielder,Spain,Europe
57,Carles Aleñá,ESP,Betis,La Liga,2019,21.0,1998.0,8.2,14,9,5,7,2,3,17,17.6,14,4,1,3,1,15,3,0,"MF,FW",20-24,Midfielder,Spain,Europe
66,Marcos Alonso,ESP,Chelsea,Premier League,2019,28.0,1990.0,15.9,28,16,20,6,2,14,33,42.4,19,18,2,16,20,48,32,0,DF,25-29,Defender,Spain,Europe
68,Sergio Álvarez,ESP,Eibar,La Liga,2019,27.0,1992.0,12.7,37,22,11,24,2,8,24,33.3,16,16,2,14,17,54,26,1,"MF,DF",25-29,Midfielder,Spain,Europe
68,Sergio Álvarez,ESP,Eibar,La Liga,2019,27.0,1992.0,12.7,37,22,11,24,2,8,24,33.3,16,16,2,14,17,54,26,1,"MF,DF",25-29,Midfielder,Spain,Europe
68,Sergio Álvarez,ESP,Eibar,La Liga,2019,27.0,1992.0,12.7,37,22,11,24,2,8,24,33.3,16,16,2,14,17,54,26,1,"MF,DF",25-29,Midfielder,Spain,Europe
68,Sergio Álvarez,ESP,Eibar,La Liga,2019,27.0,1992.0,12.7,37,22,11,24,2,8,24,33.3,16,16,2,14,17,54,26,1,"MF,DF",25-29,Midfielder,Spain,Europe
69,Sergio Álvarez,ESP,Celta Vigo,La Liga,2019,32.0,1986.0,2.0,0,0,0,0,0,0,0,,0,0,0,0,0,0,1,0,GK,30-34,Goalkeeper,Spain,Europe
69,Sergio Álvarez,ESP,Celta Vigo,La Liga,2019,32.0,1986.0,2.0,0,0,0,0,0,0,0,,0,0,0,0,0,0,1,0,GK,30-34,Goalkeeper,Spain,Europe
69,Sergio Álvarez,ESP,Celta Vigo,La Liga,2019,32.0,1986.0,2.0,0,0,0,0,0,0,0,,0,0,0,0,0,0,1,0,GK,30-34,Goalkeeper,Spain,Europe
69,Sergio Álvarez,ESP,Celta Vigo,La Liga,2019,32.0,1986.0,2.0,0,0,0,0,0,0,0,,0,0,0,0,0,0,1,0,GK,30-34,Goalkeeper,Spain,Europe
70,Yeray Álvarez,ESP,Athletic Club,La Liga,2019,24.0,1995.0,31.2,36,19,28,7,1,17,30,56.7,13,33,22,11,62,98,138,2,DF,20-24,Defender,Spain,Europe
95,Miguel Ángel Moyá,ESP,Real Sociedad,La Liga,2019,35.0,1984.0,13.0,0,0,0,0,0,0,1,0.0,1,0,0,0,1,1,6,2,GK,35-39,Goalkeeper,Spain,Europe
96,Angeliño,ESP,Manchester City,Premier League,2019,22.0,1997.0,4.7,5,2,3,1,1,5,7,71.4,2,1,0,1,9,14,15,0,DF,20-24,Defender,Spain,Europe
97,Angeliño,ESP,RB Leipzig,Bundesliga,2019,22.0,1997.0,12.2,15,9,7,5,3,5,15,33.3,10,14,1,13,19,34,24,0,"DF,FW",20-24,Defender,Spain,Europe
103,Antoñito,ESP,Valladolid,La Liga,2019,31.0,1987.0,11.4,26,18,19,7,0,12,20,60.0,8,9,0,9,15,41,20,1,"DF,MF",30-34,Defender,Spain,Europe
117,Anaitz Arbilla,ESP,Eibar,La Liga,2019,32.0,1987.0,22.3,33,20,23,8,2,16,34,47.1,18,20,4,16,29,62,82,0,DF,30-34,Defender,Spain,Europe
126,Kepa Arrizabalaga,ESP,Chelsea,Premier League,2019,24.0,1994.0,33.0,1,1,1,0,0,1,2,50.0,1,0,0,0,1,2,7,2,GK,20-24,Goalkeeper,Spain,Europe
129,Sergio Asenjo,ESP,Villarreal,La Liga,2019,30.0,1989.0,34.0,0,0,0,0,0,0,2,0.0,2,0,0,0,1,1,15,1,GK,30-34,Goalkeeper,Spain,Europe
130,Marco Asensio,ESP,Real Madrid,La Liga,2019,23.0,1996.0,3.7,4,3,3,1,0,1,4,25.0,3,2,0,2,1,5,4,0,FW,20-24,Forward,Spain,Europe
131,Kristoffer Askildsen,NOR,Sampdoria,Serie A,2019,18.0,2001.0,0.8,1,1,1,0,0,0,0,,0,1,0,1,1,2,0,0,MF,Under 20,Midfielder,Norway,Europe
132,Iago Aspas,ESP,Celta Vigo,La Liga,2019,31.0,1987.0,36.2,29,19,7,9,13,12,45,26.7,33,16,1,15,22,51,7,0,FW,30-34,Forward,Spain,Europe
135,Miguel Atienza,ESP,Eibar,La Liga,2019,20.0,1999.0,0.3,1,1,0,1,0,1,2,50.0,1,1,1,0,2,3,1,0,MF,20-24,Midfielder,Spain,Europe
152,César Azpilicueta,ESP,Chelsea,Premier League,2019,29.0,1989.0,35.9,86,56,40,32,14,35,69,50.7,34,56,21,35,67,153,94,0,DF,25-29,Defender,Spain,Europe
177,Mikel Balenziaga,ESP,Athletic Club,La Liga,2019,31.0,1988.0,6.3,15,10,4,10,1,9,11,81.8,2,4,1,3,2,17,20,0,DF,30-34,Defender,Spain,Europe
197,Kike Barja,ESP,Osasuna,La Liga,2019,22.0,1997.0,3.5,1,1,1,0,0,1,1,100.0,0,3,1,2,0,1,2,0,"MF,FW",20-24,Midfielder,Spain,Europe
202,Antonio Barragán,ESP,Betis,La Liga,2019,32.0,1987.0,7.1,7,5,4,2,1,3,6,50.0,3,2,2,0,8,15,22,0,DF,30-34,Defender,Spain,Europe
205,Ander Barrenetxea,ESP,Real Sociedad,La Liga,2019,17.0,2001.0,4.9,12,9,5,5,2,4,10,40.0,6,3,0,3,3,15,4,0,"FW,MF",Under 20,Forward,Spain,Europe
210,Marc Bartra,ESP,Betis,La Liga,2019,28.0,1991.0,28.0,62,34,39,23,0,27,54,50.0,27,45,24,21,35,97,127,0,"DF,MF",25-29,Defender,Spain,Europe
217,Borja Bastón,ESP,Aston Villa,Premier League,2019,26.0,1992.0,0.2,1,0,0,1,0,0,2,0.0,2,1,0,1,0,1,0,1,"MF,FW",25-29,Midfielder,Spain,Europe
227,Ihlas Bebou,TOG,Hoffenheim,Bundesliga,2019,25.0,1994.0,23.4,27,15,9,13,5,8,23,34.8,15,25,4,21,11,38,25,0,"FW,MF",25-29,Forward,Togo,Africa
231,Jan Bednarek,POL,Southampton,Premier League,2019,23.0,1996.0,34.0,65,38,41,18,6,31,61,50.8,30,44,23,21,77,142,198,4,DF,20-24,Defender,Poland,Europe
242,Héctor Bellerín,ESP,Arsenal,Premier League,2019,24.0,1995.0,12.9,20,13,7,11,2,11,29,37.9,18,20,4,16,19,39,27,1,"DF,MF",20-24,Defender,Spain,Europe
244,Fran Beltrán,ESP,Celta Vigo,La Liga,2019,20.0,1999.0,20.3,31,19,15,12,4,11,35,31.4,24,14,1,13,14,45,17,0,MF,20-24,Midfielder,Spain,Europe
271,Yuri Berchiche,ESP,Athletic Club,La Liga,2019,29.0,1990.0,31.7,48,35,32,15,1,21,40,52.5,19,26,4,22,30,78,73,1,DF,25-29,Defender,Spain,Europe
272,Álex Berenguer,ESP,Torino,Serie A,2019,24.0,1995.0,20.3,20,6,6,13,1,8,33,24.2,25,17,1,16,18,38,17,0,"MF,DF",20-24,Midfielder,Spain,Europe
273,Bartosz Bereszyński,POL,Sampdoria,Serie A,2019,27.0,1992.0,26.7,53,35,25,23,5,26,52,50.0,26,38,16,22,35,88,88,1,DF,25-29,Defender,Poland,Europe
275,Markel Bergara,ESP,Getafe,La Liga,2019,33.0,1986.0,0.8,0,0,0,0,0,0,0,,0,0,0,0,0,0,2,0,MF,30-34,Midfielder,Spain,Europe
276,Sander Berge,NOR,Sheffield Utd,Premier League,2019,21.0,1998.0,10.5,22,15,3,14,5,5,10,50.0,5,15,1,14,10,32,16,0,MF,20-24,Midfielder,Norway,Europe
287,Juan Bernat,ESP,Paris S-G,Ligue 1,2019,26.0,1993.0,15.4,42,27,19,16,7,20,51,39.2,31,13,1,12,10,52,26,0,"DF,MF",25-29,Defender,Spain,Europe
294,Pedro Bigas,ESP,Eibar,La Liga,2019,28.0,1990.0,19.7,18,9,11,7,0,9,19,47.4,10,16,10,6,36,54,82,0,DF,25-29,Defender,Spain,Europe
300,Valter Birsa,SVN,Cagliari,Serie A,2019,32.0,1986.0,4.8,10,6,3,6,1,7,21,33.3,14,6,1,5,4,14,3,0,"MF,FW",30-34,Midfielder,Slovenia,Europe
306,Rubén Blanco,ESP,Celta Vigo,La Liga,2019,24.0,1995.0,32.9,1,1,1,0,0,1,1,100.0,0,0,0,0,0,1,14,1,GK,20-24,Goalkeeper,Spain,Europe
388,Burgui,ESP,Alavés,La Liga,2019,25.0,1993.0,0.2,0,0,0,0,0,0,0,,0,0,0,0,0,0,0,0,MF,25-29,Midfielder,Spain,Europe
394,Sergio Busquets,ESP,Barcelona,La Liga,2019,31.0,1988.0,27.6,80,44,23,43,14,41,71,57.7,30,36,5,31,44,124,24,2,MF,30-34,Midfielder,Spain,Europe
395,Unai Bustinza,ESP,Leganés,La Liga,2019,27.0,1992.0,29.8,66,40,40,19,7,32,53,60.4,21,30,9,21,65,131,77,0,DF,25-29,Defender,Spain,Europe
420,Fernando Calero,ESP,Espanyol,La Liga,2019,23.0,1995.0,11.6,14,9,10,4,0,7,15,46.7,8,13,5,8,8,22,42,1,DF,20-24,Defender,Spain,Europe
424,José Callejón,ESP,Napoli,Serie A,2019,32.0,1987.0,24.1,13,9,3,7,3,9,25,36.0,16,15,3,12,10,23,14,1,"FW,MF",30-34,Forward,Spain,Europe
429,Víctor Camarasa,ESP,Crystal Palace,Premier League,2019,25.0,1994.0,0.1,0,0,0,0,0,0,0,,0,0,0,0,0,0,0,0,FW,25-29,Forward,Spain,Europe
430,Víctor Camarasa,ESP,Alavés,La Liga,2019,25.0,1994.0,14.4,18,10,5,10,3,7,18,38.9,11,8,3,5,15,33,12,0,MF,25-29,Midfielder,Spain,Europe
432,Sergio Camello,ESP,Atlético Madrid,La Liga,2019,18.0,2001.0,0.3,0,0,0,0,0,0,0,,0,0,0,0,0,0,0,0,FW,Under 20,Forward,Spain,Europe
433,José Campaña,ESP,Levante,La Liga,2019,26.0,1993.0,35.1,38,25,15,13,10,13,53,24.5,40,30,5,25,44,82,42,2,MF,25-29,Midfielder,Spain,Europe
434,Xisco Campos,ESP,Mallorca,La Liga,2019,37.0,1982.0,5.3,7,4,5,2,0,5,9,55.6,4,8,5,3,11,18,23,0,DF,35-39,Defender,Spain,Europe
435,Víctor Campuzano,ESP,Espanyol,La Liga,2019,22.0,1997.0,9.7,12,9,1,6,5,3,19,15.8,16,8,0,8,2,14,4,0,FW,20-24,Forward,Spain,Europe
438,Sergio Canales,ESP,Betis,La Liga,2019,28.0,1991.0,35.1,25,16,14,6,5,7,28,25.0,21,30,1,29,13,38,16,0,"MF,FW",25-29,Midfielder,Spain,Europe
443,Ander Capa,ESP,Athletic Club,La Liga,2019,27.0,1992.0,31.9,64,36,37,21,6,24,59,40.7,35,26,7,19,28,92,63,0,DF,25-29,Defender,Spain,Europe
452,Marc Cardona,ESP,Osasuna,La Liga,2019,24.0,1995.0,7.8,1,0,0,1,0,0,8,0.0,8,3,1,2,2,3,2,0,FW,20-24,Forward,Spain,Europe
468,Samu Castillejo,ESP,Milan,Serie A,2019,24.0,1995.0,13.4,24,15,10,11,3,9,42,21.4,33,17,2,15,24,48,5,0,"FW,MF",20-24,Forward,Spain,Europe
474,Craig Cathcart,NIR,Watford,Premier League,2019,30.0,1989.0,27.6,41,26,25,15,1,10,24,41.7,14,19,16,3,25,66,136,1,DF,30-34,Defender,Northern Ireland,Europe
476,Santi Cazorla,ESP,Villarreal,La Liga,2019,34.0,1984.0,27.2,48,25,14,21,13,20,57,35.1,37,23,1,22,19,67,16,2,MF,30-34,Midfielder,Spain,Europe
477,Dani Ceballos,ESP,Arsenal,Premier League,2019,22.0,1996.0,18.8,45,23,26,14,5,18,61,29.5,43,14,3,11,32,77,16,1,MF,20-24,Midfielder,Spain,Europe
517,Per Ciljan Skjelbred,NOR,Hertha BSC,Bundesliga,2019,32.0,1987.0,18.1,50,30,18,29,3,17,41,41.5,24,14,3,11,23,73,17,0,MF,30-34,Midfielder,Norway,Europe
519,Thiago Cionek,POL,SPAL,Serie A,2019,33.0,1986.0,24.1,53,32,36,12,5,22,53,41.5,31,30,11,19,46,99,91,2,DF,30-34,Defender,Poland,Europe
527,Óscar Clemente,ESP,Atlético Madrid,La Liga,2019,20.0,1999.0,0.0,0,0,0,0,0,0,0,,0,1,0,1,0,0,0,0,MF,20-24,Midfielder,Spain,Europe
530,Carlos Clerc,ESP,Levante,La Liga,2019,27.0,1992.0,20.5,28,16,14,13,1,12,20,60.0,8,22,9,13,22,50,61,0,DF,25-29,Defender,Spain,Europe
535,Coke,ESP,Levante,La Liga,2019,32.0,1987.0,11.0,25,18,14,8,3,14,30,46.7,16,9,2,7,13,38,19,0,DF,30-34,Defender,Spain,Europe
537,Álex Collado,ESP,Barcelona,La Liga,2019,20.0,1999.0,0.1,0,0,0,0,0,0,0,,0,0,0,0,0,0,0,0,FW,20-24,Forward,Spain,Europe
564,Rober Correa,ESP,Eibar,La Liga,2019,26.0,1992.0,10.3,13,6,8,3,2,6,10,60.0,4,6,4,2,16,29,31,0,DF,25-29,Defender,Spain,Europe
569,Diego Costa,ESP,Atlético Madrid,La Liga,2019,30.0,1988.0,15.0,9,5,1,4,4,1,10,10.0,9,4,2,2,3,12,10,0,FW,30-34,Forward,Spain,Europe
569,Diego Costa,ESP,Atlético Madrid,La Liga,2019,30.0,1988.0,15.0,9,5,1,4,4,1,10,10.0,9,4,2,2,3,12,10,0,FW,30-34,Forward,Spain,Europe
569,Diego Costa,ESP,Atlético Madrid,La Liga,2019,30.0,1988.0,15.0,9,5,1,4,4,1,10,10.0,9,4,2,2,3,12,10,0,FW,30-34,Forward,Spain,Europe
569,Diego Costa,ESP,Atlético Madrid,La Liga,2019,30.0,1988.0,15.0,9,5,1,4,4,1,10,10.0,9,4,2,2,3,12,10,0,FW,30-34,Forward,Spain,Europe
571,Jaume Costa,ESP,Valencia,La Liga,2019,31.0,1988.0,15.4,27,23,17,8,2,14,28,50.0,14,11,6,5,24,51,52,1,DF,30-34,Defender,Spain,Europe
574,David Costas,ESP,Celta Vigo,La Liga,2019,24.0,1995.0,3.8,4,3,3,1,0,2,4,50.0,2,3,3,0,8,12,12,0,DF,20-24,Defender,Spain,Europe
590,Marc Cucurella,ESP,Getafe,La Liga,2019,21.0,1998.0,36.0,74,51,23,38,13,24,76,31.6,52,58,8,50,36,110,28,1,"MF,DF",20-24,Midfielder,Spain,Europe
591,Iván Cuéllar,ESP,Leganés,La Liga,2019,35.0,1984.0,27.0,0,0,0,0,0,0,2,0.0,2,0,0,0,0,0,28,2,GK,35-39,Goalkeeper,Spain,Europe
624,Sergi Darder,ESP,Espanyol,La Liga,2019,25.0,1993.0,29.5,47,23,11,26,10,17,58,29.3,41,30,1,29,24,71,23,1,MF,25-29,Midfielder,Spain,Europe
631,Paweł Dawidowicz,POL,Hellas Verona,Serie A,2019,24.0,1995.0,7.7,15,12,11,4,0,5,11,45.5,6,6,5,1,12,27,26,0,DF,20-24,Defender,Poland,Europe
666,Gerard Deulofeu,ESP,Watford,Premier League,2019,25.0,1994.0,23.3,33,16,18,9,6,12,59,20.3,47,10,0,10,25,58,6,0,FW,25-29,Forward,Spain,Europe
685,Víctor Díaz,ESP,Granada,La Liga,2019,31.0,1988.0,32.0,74,43,38,31,5,31,60,51.7,29,53,23,30,48,122,94,1,DF,30-34,Defender,Spain,Europe
700,Djené,TOG,Getafe,La Liga,2019,27.0,1991.0,34.0,42,32,27,15,0,17,30,56.7,13,20,7,13,34,76,105,1,DF,25-29,Defender,Togo,Africa
710,Jaume Doménech,ESP,Valencia,La Liga,2019,28.0,1990.0,14.7,0,0,0,0,0,0,1,0.0,1,0,0,0,1,1,3,1,GK,25-29,Goalkeeper,Spain,Europe
736,Rubén Duarte,ESP,Alavés,La Liga,2019,23.0,1995.0,29.6,61,32,30,28,3,34,60,56.7,26,30,8,22,47,108,71,0,DF,20-24,Defender,Spain,Europe
750,Hugo Duro,ESP,Getafe,La Liga,2019,19.0,1999.0,4.2,6,5,2,2,2,4,8,50.0,4,3,0,3,1,7,3,0,"FW,MF",Under 20,Forward,Spain,Europe
767,Aritz Elustondo,ESP,Real Sociedad,La Liga,2019,25.0,1994.0,16.8,28,17,19,8,1,13,23,56.5,10,21,8,13,15,43,67,0,DF,25-29,Defender,Spain,Europe
778,Sergi Enrich,ESP,Eibar,La Liga,2019,29.0,1990.0,20.7,17,6,4,8,5,4,21,19.0,17,16,2,14,9,26,12,0,FW,25-29,Forward,Spain,Europe
783,Aarón Escandell,ESP,Granada,La Liga,2019,23.0,1995.0,3.0,1,1,1,0,0,1,1,100.0,0,0,0,0,0,1,0,0,GK,20-24,Goalkeeper,Spain,Europe
784,Sergio Escudero,ESP,Sevilla,La Liga,2019,29.0,1989.0,8.6,29,16,17,10,2,19,28,67.9,9,11,1,10,13,42,35,0,DF,25-29,Defender,Spain,Europe
787,Vicente Esquerdo,ESP,Valencia,La Liga,2019,20.0,1999.0,0.2,1,0,1,0,0,0,0,,0,1,0,1,0,1,1,0,"MF,FW",20-24,Midfielder,Spain,Europe
791,Beñat Etxebarria,ESP,Athletic Club,La Liga,2019,32.0,1987.0,4.4,6,1,2,3,1,2,13,15.4,11,6,1,5,4,10,6,0,MF,30-34,Midfielder,Spain,Europe
794,Jonny Evans,NIR,Leicester City,Premier League,2019,31.0,1988.0,37.6,48,34,33,14,1,28,39,71.8,11,33,18,15,57,105,174,4,DF,30-34,Defender,Northern Ireland,Europe
795,Edu Expósito,ESP,Eibar,La Liga,2019,22.0,1996.0,25.7,52,28,12,31,9,18,49,36.7,31,20,6,14,31,83,18,1,MF,20-24,Midfielder,Spain,Europe
801,Cesc Fàbregas,ESP,Monaco,Ligue 1,2019,32.0,1987.0,10.3,11,4,6,3,2,6,29,20.7,23,8,1,7,7,18,3,0,MF,30-34,Midfielder,Spain,Europe
810,Iago Falque,ESP,Torino,Serie A,2019,29.0,1990.0,1.1,0,0,0,0,0,0,1,0.0,1,1,0,1,0,0,0,0,"FW,MF",25-29,Forward,Spain,Europe
811,Iago Falque,ESP,Genoa,Serie A,2019,29.0,1990.0,5.8,7,3,1,4,2,4,8,50.0,4,7,0,7,1,8,4,0,MF,25-29,Midfielder,Spain,Europe
818,Ansu Fati,ESP,Barcelona,La Liga,2019,16.0,2002.0,11.4,16,8,4,7,5,5,15,33.3,10,14,1,13,8,24,3,0,FW,Under 20,Forward,Spain,Europe
822,Aleix Febas,ESP,Mallorca,La Liga,2019,23.0,1996.0,18.8,36,24,13,19,4,12,36,33.3,24,15,0,15,17,53,6,0,"MF,FW",20-24,Midfielder,Spain,Europe
824,Ljubomir Fejsa,SRB,Alavés,La Liga,2019,30.0,1988.0,8.7,19,13,8,10,1,6,23,26.1,17,8,1,7,6,25,13,0,MF,30-34,Midfielder,Serbia,Europe
831,Kiko Femenía,ESP,Watford,Premier League,2019,28.0,1991.0,24.9,68,38,49,17,2,43,80,53.8,37,16,2,14,36,104,49,0,DF,25-29,Defender,Spain,Europe
838,Aitor Fernández,ESP,Levante,La Liga,2019,28.0,1991.0,36.0,1,1,1,0,0,1,1,100.0,0,0,0,0,2,3,18,3,GK,25-29,Goalkeeper,Spain,Europe
838,Aitor Fernández,ESP,Levante,La Liga,2019,28.0,1991.0,36.0,1,1,1,0,0,1,1,100.0,0,0,0,0,2,3,18,3,GK,25-29,Goalkeeper,Spain,Europe
838,Aitor Fernández,ESP,Levante,La Liga,2019,28.0,1991.0,36.0,1,1,1,0,0,1,1,100.0,0,0,0,0,2,3,18,3,GK,25-29,Goalkeeper,Spain,Europe
838,Aitor Fernández,ESP,Levante,La Liga,2019,28.0,1991.0,36.0,1,1,1,0,0,1,1,100.0,0,0,0,0,2,3,18,3,GK,25-29,Goalkeeper,Spain,Europe
839,Andrés Fernández,ESP,Villarreal,La Liga,2019,32.0,1986.0,4.0,0,0,0,0,0,0,0,,0,0,0,0,0,0,2,0,GK,30-34,Goalkeeper,Spain,Europe
840,Carlos Fernández,ESP,Granada,La Liga,2019,23.0,1996.0,24.5,24,15,7,11,6,3,32,9.4,29,25,2,23,11,35,30,0,"FW,MF",20-24,Forward,Spain,Europe
868,Pablo Fornals,ESP,West Ham,Premier League,2019,23.0,1996.0,24.1,46,28,21,18,7,19,64,29.7,45,35,1,34,25,71,15,0,"MF,FW",20-24,Midfielder,Spain,Europe
890,Jorge de Frutos,ESP,Valladolid,La Liga,2019,22.0,1997.0,0.7,2,2,2,0,0,1,2,50.0,1,0,0,0,0,2,1,0,"MF,DF",20-24,Midfielder,Spain,Europe
906,Enric Gallego,ESP,Osasuna,La Liga,2019,32.0,1986.0,9.8,9,5,1,5,3,0,4,0.0,4,10,2,8,4,13,8,0,FW,30-34,Forward,Spain,Europe
907,Enric Gallego,ESP,Getafe,La Liga,2019,32.0,1986.0,1.8,3,1,1,1,1,2,4,50.0,2,2,0,2,2,5,1,0,FW,30-34,Forward,Spain,Europe
909,Fran Gámez,ESP,Mallorca,La Liga,2019,28.0,1991.0,19.6,64,42,32,27,5,33,74,44.6,41,31,11,20,29,93,41,0,DF,25-29,Defender,Spain,Europe
914,David García,ESP,Osasuna,La Liga,2019,25.0,1994.0,31.0,28,16,15,12,1,14,31,45.2,17,20,16,4,48,76,123,2,DF,25-29,Defender,Spain,Europe
914,David García,ESP,Osasuna,La Liga,2019,25.0,1994.0,31.0,28,16,15,12,1,14,31,45.2,17,20,16,4,48,76,123,2,DF,25-29,Defender,Spain,Europe
914,David García,ESP,Osasuna,La Liga,2019,25.0,1994.0,31.0,28,16,15,12,1,14,31,45.2,17,20,16,4,48,76,123,2,DF,25-29,Defender,Spain,Europe
914,David García,ESP,Osasuna,La Liga,2019,25.0,1994.0,31.0,28,16,15,12,1,14,31,45.2,17,20,16,4,48,76,123,2,DF,25-29,Defender,Spain,Europe
915,Eric García,ESP,Manchester City,Premier League,2019,18.0,2001.0,8.8,6,1,4,2,0,5,9,55.6,4,2,0,2,18,24,33,0,DF,Under 20,Defender,Spain,Europe
917,Manu García,ESP,Alavés,La Liga,2019,33.0,1986.0,21.9,46,23,11,31,4,17,72,23.6,55,28,12,16,28,74,32,1,MF,30-34,Midfielder,Spain,Europe
917,Manu García,ESP,Alavés,La Liga,2019,33.0,1986.0,21.9,46,23,11,31,4,17,72,23.6,55,28,12,16,28,74,32,1,MF,30-34,Midfielder,Spain,Europe
917,Manu García,ESP,Alavés,La Liga,2019,33.0,1986.0,21.9,46,23,11,31,4,17,72,23.6,55,28,12,16,28,74,32,1,MF,30-34,Midfielder,Spain,Europe
917,Manu García,ESP,Alavés,La Liga,2019,33.0,1986.0,21.9,46,23,11,31,4,17,72,23.6,55,28,12,16,28,74,32,1,MF,30-34,Midfielder,Spain,Europe
918,Raúl García,ESP,Valladolid,La Liga,2019,30.0,1989.0,11.2,20,12,11,7,2,9,22,40.9,13,12,2,10,8,28,30,0,"DF,MF",30-34,Defender,Spain,Europe
918,Raúl García,ESP,Valladolid,La Liga,2019,30.0,1989.0,11.2,20,12,11,7,2,9,22,40.9,13,12,2,10,8,28,30,0,"DF,MF",30-34,Defender,Spain,Europe
918,Raúl García,ESP,Valladolid,La Liga,2019,30.0,1989.0,11.2,20,12,11,7,2,9,22,40.9,13,12,2,10,8,28,30,0,"DF,MF",30-34,Defender,Spain,Europe
918,Raúl García,ESP,Valladolid,La Liga,2019,30.0,1989.0,11.2,20,12,11,7,2,9,22,40.9,13,12,2,10,8,28,30,0,"DF,MF",30-34,Defender,Spain,Europe
919,Raúl García,ESP,Athletic Club,La Liga,2019,33.0,1986.0,31.9,57,37,19,26,12,16,76,21.1,60,46,6,40,24,81,44,0,"MF,FW",30-34,Midfielder,Spain,Europe
919,Raúl García,ESP,Athletic Club,La Liga,2019,33.0,1986.0,31.9,57,37,19,26,12,16,76,21.1,60,46,6,40,24,81,44,0,"MF,FW",30-34,Midfielder,Spain,Europe
919,Raúl García,ESP,Athletic Club,La Liga,2019,33.0,1986.0,31.9,57,37,19,26,12,16,76,21.1,60,46,6,40,24,81,44,0,"MF,FW",30-34,Midfielder,Spain,Europe
919,Raúl García,ESP,Athletic Club,La Liga,2019,33.0,1986.0,31.9,57,37,19,26,12,16,76,21.1,60,46,6,40,24,81,44,0,"MF,FW",30-34,Midfielder,Spain,Europe
920,Raúl García,ESP,Getafe,La Liga,2019,30.0,1989.0,2.7,5,3,2,3,0,3,6,50.0,3,3,1,2,4,9,10,0,DF,30-34,Defender,Spain,Europe
920,Raúl García,ESP,Getafe,La Liga,2019,30.0,1989.0,2.7,5,3,2,3,0,3,6,50.0,3,3,1,2,4,9,10,0,DF,30-34,Defender,Spain,Europe
920,Raúl García,ESP,Getafe,La Liga,2019,30.0,1989.0,2.7,5,3,2,3,0,3,6,50.0,3,3,1,2,4,9,10,0,DF,30-34,Defender,Spain,Europe
920,Raúl García,ESP,Getafe,La Liga,2019,30.0,1989.0,2.7,5,3,2,3,0,3,6,50.0,3,3,1,2,4,9,10,0,DF,30-34,Defender,Spain,Europe
921,Rubén García,ESP,Osasuna,La Liga,2019,26.0,1993.0,24.3,55,30,22,26,7,18,46,39.1,28,34,5,29,11,66,23,1,"MF,FW",25-29,Midfielder,Spain,Europe
921,Rubén García,ESP,Osasuna,La Liga,2019,26.0,1993.0,24.3,55,30,22,26,7,18,46,39.1,28,34,5,29,11,66,23,1,"MF,FW",25-29,Midfielder,Spain,Europe
921,Rubén García,ESP,Osasuna,La Liga,2019,26.0,1993.0,24.3,55,30,22,26,7,18,46,39.1,28,34,5,29,11,66,23,1,"MF,FW",25-29,Midfielder,Spain,Europe
921,Rubén García,ESP,Osasuna,La Liga,2019,26.0,1993.0,24.3,55,30,22,26,7,18,46,39.1,28,34,5,29,11,66,23,1,"MF,FW",25-29,Midfielder,Spain,Europe
922,Unai García,ESP,Osasuna,La Liga,2019,27.0,1992.0,6.0,9,6,4,4,1,5,9,55.6,4,13,9,4,8,17,31,0,DF,25-29,Defender,Spain,Europe
923,Víctor García,ESP,Valladolid,La Liga,2019,21.0,1997.0,1.0,0,0,0,0,0,0,1,0.0,1,1,0,1,0,0,1,0,"FW,MF",20-24,Forward,Spain,Europe
923,Víctor García,ESP,Valladolid,La Liga,2019,21.0,1997.0,1.0,0,0,0,0,0,0,1,0.0,1,1,0,1,0,0,1,0,"FW,MF",20-24,Forward,Spain,Europe
923,Víctor García,ESP,Valladolid,La Liga,2019,21.0,1997.0,1.0,0,0,0,0,0,0,1,0.0,1,1,0,1,0,0,1,0,"FW,MF",20-24,Forward,Spain,Europe
923,Víctor García,ESP,Valladolid,La Liga,2019,21.0,1997.0,1.0,0,0,0,0,0,0,1,0.0,1,1,0,1,0,0,1,0,"FW,MF",20-24,Forward,Spain,Europe
926,Mario Gaspar,ESP,Villarreal,La Liga,2019,28.0,1990.0,21.8,35,20,16,16,3,15,31,48.4,16,25,10,15,26,61,69,0,DF,25-29,Defender,Spain,Europe
932,David de Gea,ESP,Manchester Utd,Premier League,2019,28.0,1990.0,38.0,0,0,0,0,0,0,0,,0,0,0,0,0,0,7,4,GK,25-29,Goalkeeper,Spain,Europe
933,Theodor Gebre Selassie,CZE,Werder Bremen,Bundesliga,2019,32.0,1986.0,27.0,36,27,23,10,3,17,35,48.6,18,26,9,17,63,99,81,0,"DF,MF",30-34,Defender,Czech Republic,Europe
950,Bryan Gil,ESP,Leganés,La Liga,2019,18.0,2001.0,6.2,8,4,3,4,1,1,8,12.5,7,6,0,6,3,11,1,0,"MF,FW",Under 20,Midfielder,Spain,Europe
951,Bryan Gil,ESP,Sevilla,La Liga,2019,18.0,2001.0,0.7,1,1,0,1,0,0,1,0.0,1,0,0,0,0,1,0,0,FW,Under 20,Forward,Spain,Europe
958,Kamil Glik,POL,Monaco,Ligue 1,2019,31.0,1988.0,23.0,26,14,15,11,0,13,21,61.9,8,23,17,6,27,53,118,0,DF,30-34,Defender,Poland,Europe
972,Ibai Gómez,ESP,Athletic Club,La Liga,2019,29.0,1989.0,7.7,5,3,2,2,1,3,8,37.5,5,4,0,4,3,8,6,0,FW,25-29,Forward,Spain,Europe
975,Moi Gómez,ESP,Villarreal,La Liga,2019,25.0,1994.0,25.8,30,22,9,14,7,11,33,33.3,22,22,2,20,25,55,23,0,"FW,MF",25-29,Forward,Spain,Europe
977,Sergi Gómez,ESP,Sevilla,La Liga,2019,27.0,1992.0,8.0,9,7,7,2,0,4,4,100.0,0,6,6,0,7,16,30,0,DF,25-29,Defender,Spain,Europe
983,Álvaro González,ESP,Marseille,Ligue 1,2019,29.0,1990.0,18.1,19,13,14,4,1,9,13,69.2,4,7,4,3,18,37,65,0,DF,25-29,Defender,Spain,Europe
983,Álvaro González,ESP,Marseille,Ligue 1,2019,29.0,1990.0,18.1,19,13,14,4,1,9,13,69.2,4,7,4,3,18,37,65,0,DF,25-29,Defender,Spain,Europe
983,Álvaro González,ESP,Marseille,Ligue 1,2019,29.0,1990.0,18.1,19,13,14,4,1,9,13,69.2,4,7,4,3,18,37,65,0,DF,25-29,Defender,Spain,Europe
983,Álvaro González,ESP,Marseille,Ligue 1,2019,29.0,1990.0,18.1,19,13,14,4,1,9,13,69.2,4,7,4,3,18,37,65,0,DF,25-29,Defender,Spain,Europe
984,Bruno González,ESP,Getafe,La Liga,2019,29.0,1990.0,2.0,3,2,3,0,0,1,1,100.0,0,2,0,2,0,3,3,0,DF,25-29,Defender,Spain,Europe
985,Bruno González,ESP,Levante,La Liga,2019,29.0,1990.0,5.1,10,8,7,2,1,2,4,50.0,2,7,4,3,2,12,32,0,DF,25-29,Defender,Spain,Europe
990,Andoni Gorosabel,ESP,Real Sociedad,La Liga,2019,22.0,1996.0,7.9,14,8,9,3,2,10,20,50.0,10,13,1,12,13,27,21,0,DF,20-24,Defender,Spain,Europe
999,Esteban Granero,ESP,Espanyol,La Liga,2019,32.0,1987.0,5.3,10,4,5,3,2,5,11,45.5,6,3,2,1,2,12,5,0,MF,30-34,Midfielder,Spain,Europe
1017,Vicente Guaita,ESP,Crystal Palace,Premier League,2019,32.0,1987.0,35.0,1,1,1,0,0,1,2,50.0,1,0,0,0,0,1,18,3,GK,30-34,Goalkeeper,Spain,Europe
1019,Sergi Guardiola,ESP,Valladolid,La Liga,2019,28.0,1991.0,29.5,14,6,3,7,4,4,24,16.7,20,23,0,23,6,20,18,1,FW,25-29,Forward,Spain,Europe
1020,Nemanja Gudelj,SRB,Sevilla,La Liga,2019,27.0,1991.0,13.5,20,14,11,8,1,6,19,31.6,13,17,8,9,12,32,35,1,"MF,DF",25-29,Midfielder,Serbia,Europe
1024,Adrián Guerrero,ESP,Valencia,La Liga,2019,21.0,1998.0,1.4,2,2,1,1,0,2,3,66.7,1,0,0,0,2,4,1,0,DF,20-24,Defender,Spain,Europe
1025,Ander Guevara,ESP,Real Sociedad,La Liga,2019,22.0,1997.0,10.4,27,11,9,17,1,12,30,40.0,18,13,3,10,8,35,15,1,MF,20-24,Midfielder,Spain,Europe
1030,Hugo Guillamón,ESP,Valencia,La Liga,2019,19.0,2000.0,5.5,8,3,5,2,1,5,10,50.0,5,3,2,1,5,13,29,0,DF,Under 20,Defender,Spain,Europe
1044,Erling Haaland,NOR,Dortmund,Bundesliga,2019,19.0,2000.0,11.8,4,2,1,0,3,0,4,0.0,4,7,4,3,4,8,4,0,FW,Under 20,Forward,Norway,Europe
1078,Mario Hermoso,ESP,Atlético Madrid,La Liga,2019,24.0,1995.0,13.5,15,8,12,2,1,11,20,55.0,9,11,5,6,12,27,61,0,DF,20-24,Defender,Spain,Europe
1079,Aridane Hernández,ESP,Osasuna,La Liga,2019,30.0,1989.0,29.0,35,23,22,13,0,15,19,78.9,4,24,15,9,34,69,137,2,DF,30-34,Defender,Spain,Europe
1082,Juan Hernández,ESP,Celta Vigo,La Liga,2019,24.0,1994.0,1.0,0,0,0,0,0,0,0,,0,0,0,0,1,1,0,0,"FW,MF",20-24,Forward,Spain,Europe
1084,Onel Hernández,CUB,Norwich City,Premier League,2019,26.0,1993.0,15.4,27,19,13,11,3,9,31,29.0,22,12,1,11,19,46,10,0,"FW,MF",25-29,Forward,Cuba,North America
1087,Ander Herrera,ESP,Paris S-G,Ligue 1,2019,29.0,1989.0,6.1,19,11,9,9,1,5,14,35.7,9,10,2,8,6,25,4,0,"MF,DF",25-29,Midfielder,Spain,Europe
1089,Sergio Herrera,ESP,Osasuna,La Liga,2019,26.0,1993.0,18.4,1,1,1,0,0,1,4,25.0,3,0,0,0,1,2,13,3,GK,25-29,Goalkeeper,Spain,Europe
1091,Iago Herrerín,ESP,Athletic Club,La Liga,2019,31.0,1988.0,4.7,0,0,0,0,0,0,0,,0,0,0,0,0,0,0,0,GK,30-34,Goalkeeper,Spain,Europe
1093,Pablo Hervías,ESP,Valladolid,La Liga,2019,26.0,1993.0,11.3,24,20,8,14,2,12,22,54.5,10,8,0,8,5,29,0,0,"MF,FW",25-29,Midfielder,Spain,Europe
1111,Josué Homawoo,TOG,Nantes,Ligue 1,2019,21.0,1997.0,0.5,6,2,3,3,0,2,2,100.0,0,3,2,1,2,8,2,0,DF,20-24,Defender,Togo,Africa
1141,Borja Iglesias,ESP,Betis,La Liga,2019,26.0,1993.0,21.4,7,5,1,4,2,0,9,0.0,9,7,4,3,5,12,18,0,FW,25-29,Forward,Spain,Europe
1149,Asier Illarramendi,ESP,Real Sociedad,La Liga,2019,29.0,1990.0,2.4,2,2,1,0,1,2,6,33.3,4,2,1,1,5,7,6,0,MF,25-29,Midfielder,Spain,Europe
1161,Isco,ESP,Real Madrid,La Liga,2019,27.0,1992.0,13.1,13,9,2,10,1,5,14,35.7,9,9,0,9,7,20,4,1,"FW,MF",25-29,Forward,Spain,Europe
1166,Ander Iturraspe,ESP,Espanyol,La Liga,2019,30.0,1989.0,2.7,2,0,1,1,0,2,5,40.0,3,0,0,0,1,3,7,0,MF,30-34,Midfielder,Spain,Europe
1180,Jakub Jankto,CZE,Sampdoria,Serie A,2019,23.0,1996.0,23.3,27,13,14,10,3,10,42,23.8,32,30,3,27,22,49,22,0,"MF,FW",20-24,Midfielder,Czech Republic,Europe
1185,Rune Jarstein,NOR,Hertha BSC,Bundesliga,2019,34.0,1984.0,28.3,4,1,4,0,0,2,3,66.7,1,0,0,0,1,5,11,3,GK,30-34,Goalkeeper,Norway,Europe
1187,Dennis Jastrzembski,POL,Paderborn 07,Bundesliga,2019,19.0,2000.0,2.0,2,0,1,1,0,0,1,0.0,1,3,0,3,3,5,0,0,"MF,FW",Under 20,Midfielder,Poland,Europe
1193,Jesé,ESP,Paris S-G,Ligue 1,2019,26.0,1993.0,0.0,0,0,0,0,0,0,0,,0,0,0,0,0,0,0,0,FW,25-29,Forward,Spain,Europe
1198,Joaquín,ESP,Betis,La Liga,2019,38.0,1981.0,22.9,14,7,4,8,2,4,11,36.4,7,10,2,8,15,29,22,1,"MF,FW",35-39,Midfielder,Spain,Europe
1206,Jony,ESP,Lazio,Serie A,2019,28.0,1991.0,13.1,13,9,7,4,2,5,23,21.7,18,11,2,9,14,27,17,0,"DF,FW",25-29,Defender,Spain,Europe
1207,Joan Jordán,ESP,Sevilla,La Liga,2019,25.0,1994.0,25.0,64,34,27,31,6,21,76,27.6,55,25,5,20,26,90,20,4,MF,25-29,Midfielder,Spain,Europe
1212,Joselu,ESP,Alavés,La Liga,2019,29.0,1990.0,30.9,26,17,4,12,10,4,32,12.5,28,36,5,31,13,39,46,0,FW,25-29,Forward,Spain,Europe
1218,Luka Jović,SRB,Real Madrid,La Liga,2019,21.0,1997.0,4.8,2,1,0,0,2,1,2,50.0,1,1,0,1,2,4,0,0,FW,20-24,Forward,Serbia,Europe
1219,Juanmi,ESP,Betis,La Liga,2019,26.0,1993.0,2.9,4,1,1,2,1,1,4,25.0,3,1,0,1,0,4,0,0,"FW,MF",25-29,Forward,Spain,Europe
1220,David Juncà,ESP,Celta Vigo,La Liga,2019,25.0,1993.0,2.9,6,5,4,1,1,2,3,66.7,1,4,1,3,2,8,3,0,DF,25-29,Defender,Spain,Europe
1241,Kevin Kampl,SVN,RB Leipzig,Bundesliga,2019,28.0,1990.0,7.5,17,11,7,10,0,7,23,30.4,16,7,2,5,16,33,6,0,MF,25-29,Midfielder,Slovenia,Europe
1273,Joshua King,NOR,Bournemouth,Premier League,2019,27.0,1992.0,22.3,16,6,4,8,4,4,16,25.0,12,20,3,17,8,24,9,0,"FW,MF",25-29,Forward,Norway,Europe
1289,Koke,ESP,Atlético Madrid,La Liga,2019,27.0,1992.0,30.0,70,42,27,30,13,29,89,32.6,60,33,8,25,29,99,28,2,MF,25-29,Midfielder,Spain,Europe
1290,Aleksandar Kolarov,SRB,Roma,Serie A,2019,33.0,1985.0,30.4,37,28,16,16,5,20,37,54.1,17,20,9,11,31,68,57,0,DF,30-34,Defender,Serbia,Europe
1314,Dawid Kownacki,POL,Düsseldorf,Bundesliga,2019,22.0,1997.0,12.1,13,8,5,7,1,9,20,45.0,11,13,2,11,6,19,8,0,"FW,MF",20-24,Forward,Poland,Europe
1322,Rene Krhin,SVN,Nantes,Ligue 1,2019,29.0,1990.0,3.6,4,3,1,3,0,2,2,100.0,0,1,0,1,6,10,17,0,"DF,MF",25-29,Defender,Slovenia,Europe
1346,Víctor Laguardia,ESP,Alavés,La Liga,2019,29.0,1989.0,29.5,21,15,15,6,0,16,30,53.3,14,24,18,6,37,58,131,1,DF,25-29,Defender,Spain,Europe
1362,Aymeric Laporte,ESP,Manchester City,Premier League,2019,25.0,1994.0,12.2,13,6,6,7,0,4,9,44.4,5,6,5,1,20,33,26,1,DF,25-29,Defender,Spain,Europe
1369,Toni Lato,ESP,Osasuna,La Liga,2019,21.0,1997.0,5.2,22,15,11,8,3,9,10,90.0,1,9,1,8,8,30,13,1,"DF,MF",20-24,Defender,Spain,Europe
1377,Darko Lazović,SRB,Hellas Verona,Serie A,2019,28.0,1990.0,36.0,26,16,14,8,4,14,27,51.9,13,15,4,11,23,49,53,0,DF,25-29,Defender,Serbia,Europe
1380,Robin Le Normand,ESP,Real Sociedad,La Liga,2019,22.0,1996.0,26.6,48,27,33,15,0,26,35,74.3,9,20,7,13,20,68,99,0,DF,20-24,Defender,Spain,Europe
1394,Iñigo Lekue,ESP,Athletic Club,La Liga,2019,26.0,1993.0,6.9,22,12,14,6,2,11,14,78.6,3,7,0,7,3,25,11,0,"FW,DF",25-29,Forward,Spain,Europe
1403,Pedro León,ESP,Eibar,La Liga,2019,32.0,1986.0,21.1,28,20,8,9,11,12,25,48.0,13,18,1,17,19,47,7,0,"MF,FW",30-34,Midfielder,Spain,Europe
1404,Sergio León,ESP,Levante,La Liga,2019,30.0,1989.0,7.5,3,3,0,3,0,2,4,50.0,2,3,0,3,1,4,2,0,FW,30-34,Forward,Spain,Europe
1409,Robert Lewandowski,POL,Bayern Munich,Bundesliga,2019,30.0,1988.0,30.7,18,9,3,9,6,3,15,20.0,12,13,1,12,7,25,13,0,FW,30-34,Forward,Poland,Europe
1410,Jamal Lewis,NIR,Norwich City,Premier League,2019,21.0,1998.0,25.6,51,35,42,6,3,22,36,61.1,14,27,12,15,25,76,68,0,DF,20-24,Defender,Northern Ireland,Europe
1422,Karol Linetty,POL,Sampdoria,Serie A,2019,24.0,1995.0,22.4,61,32,24,25,12,21,65,32.3,44,26,3,23,26,87,17,0,MF,20-24,Midfielder,Poland,Europe
1424,Pol Lirola,ESP,Fiorentina,Serie A,2019,21.0,1997.0,29.4,34,20,18,10,6,21,38,55.3,17,16,4,12,26,60,52,0,DF,20-24,Defender,Spain,Europe
1425,Diego Llorente,ESP,Real Sociedad,La Liga,2019,25.0,1993.0,25.9,30,14,20,9,1,16,28,57.1,12,14,7,7,28,58,101,5,DF,25-29,Defender,Spain,Europe
1425,Diego Llorente,ESP,Real Sociedad,La Liga,2019,25.0,1993.0,25.9,30,14,20,9,1,16,28,57.1,12,14,7,7,28,58,101,5,DF,25-29,Defender,Spain,Europe
1425,Diego Llorente,ESP,Real Sociedad,La Liga,2019,25.0,1993.0,25.9,30,14,20,9,1,16,28,57.1,12,14,7,7,28,58,101,5,DF,25-29,Defender,Spain,Europe
1425,Diego Llorente,ESP,Real Sociedad,La Liga,2019,25.0,1993.0,25.9,30,14,20,9,1,16,28,57.1,12,14,7,7,28,58,101,5,DF,25-29,Defender,Spain,Europe
1426,Fernando Llorente,ESP,Napoli,Serie A,2019,34.0,1985.0,5.6,0,0,0,0,0,0,1,0.0,1,4,0,4,1,1,3,0,FW,30-34,Forward,Spain,Europe
1427,Marcos Llorente,ESP,Atlético Madrid,La Liga,2019,24.0,1995.0,15.2,29,15,7,16,6,7,21,33.3,14,24,4,20,14,43,9,0,"MF,FW",20-24,Midfielder,Spain,Europe
1447,Adrián López,ESP,Osasuna,La Liga,2019,31.0,1988.0,16.0,7,5,1,5,1,2,19,10.5,17,6,2,4,4,11,8,0,FW,30-34,Forward,Spain,Europe
1447,Adrián López,ESP,Osasuna,La Liga,2019,31.0,1988.0,16.0,7,5,1,5,1,2,19,10.5,17,6,2,4,4,11,8,0,FW,30-34,Forward,Spain,Europe
1447,Adrián López,ESP,Osasuna,La Liga,2019,31.0,1988.0,16.0,7,5,1,5,1,2,19,10.5,17,6,2,4,4,11,8,0,FW,30-34,Forward,Spain,Europe
1447,Adrián López,ESP,Osasuna,La Liga,2019,31.0,1988.0,16.0,7,5,1,5,1,2,19,10.5,17,6,2,4,4,11,8,0,FW,30-34,Forward,Spain,Europe
1448,David López,ESP,Espanyol,La Liga,2019,29.0,1989.0,27.3,38,20,15,20,3,13,41,31.7,28,28,13,15,35,73,63,3,"DF,MF",25-29,Defender,Spain,Europe
1448,David López,ESP,Espanyol,La Liga,2019,29.0,1989.0,27.3,38,20,15,20,3,13,41,31.7,28,28,13,15,35,73,63,3,"DF,MF",25-29,Defender,Spain,Europe
1448,David López,ESP,Espanyol,La Liga,2019,29.0,1989.0,27.3,38,20,15,20,3,13,41,31.7,28,28,13,15,35,73,63,3,"DF,MF",25-29,Defender,Spain,Europe
1448,David López,ESP,Espanyol,La Liga,2019,29.0,1989.0,27.3,38,20,15,20,3,13,41,31.7,28,28,13,15,35,73,63,3,"DF,MF",25-29,Defender,Spain,Europe
1449,Diego López,ESP,Espanyol,La Liga,2019,37.0,1981.0,35.9,2,2,2,0,0,1,2,50.0,1,0,0,0,2,4,8,1,GK,35-39,Goalkeeper,Spain,Europe
1449,Diego López,ESP,Espanyol,La Liga,2019,37.0,1981.0,35.9,2,2,2,0,0,1,2,50.0,1,0,0,0,2,4,8,1,GK,35-39,Goalkeeper,Spain,Europe
1449,Diego López,ESP,Espanyol,La Liga,2019,37.0,1981.0,35.9,2,2,2,0,0,1,2,50.0,1,0,0,0,2,4,8,1,GK,35-39,Goalkeeper,Spain,Europe
1449,Diego López,ESP,Espanyol,La Liga,2019,37.0,1981.0,35.9,2,2,2,0,0,1,2,50.0,1,0,0,0,2,4,8,1,GK,35-39,Goalkeeper,Spain,Europe
1449,Diego López,ESP,Espanyol,La Liga,2019,37.0,1981.0,35.9,2,2,2,0,0,1,2,50.0,1,0,0,0,2,4,8,1,GK,35-39,Goalkeeper,Spain,Europe
1449,Diego López,ESP,Espanyol,La Liga,2019,37.0,1981.0,35.9,2,2,2,0,0,1,2,50.0,1,0,0,0,2,4,8,1,GK,35-39,Goalkeeper,Spain,Europe
1449,Diego López,ESP,Espanyol,La Liga,2019,37.0,1981.0,35.9,2,2,2,0,0,1,2,50.0,1,0,0,0,2,4,8,1,GK,35-39,Goalkeeper,Spain,Europe
1449,Diego López,ESP,Espanyol,La Liga,2019,37.0,1981.0,35.9,2,2,2,0,0,1,2,50.0,1,0,0,0,2,4,8,1,GK,35-39,Goalkeeper,Spain,Europe
1449,Diego López,ESP,Espanyol,La Liga,2019,37.0,1981.0,35.9,2,2,2,0,0,1,2,50.0,1,0,0,0,2,4,8,1,GK,35-39,Goalkeeper,Spain,Europe
1450,Javi López,ESP,Alavés,La Liga,2019,17.0,2002.0,1.0,6,5,4,2,0,4,5,80.0,1,1,1,0,1,7,5,0,DF,Under 20,Defender,Spain,Europe
1450,Javi López,ESP,Alavés,La Liga,2019,17.0,2002.0,1.0,6,5,4,2,0,4,5,80.0,1,1,1,0,1,7,5,0,DF,Under 20,Defender,Spain,Europe
1450,Javi López,ESP,Alavés,La Liga,2019,17.0,2002.0,1.0,6,5,4,2,0,4,5,80.0,1,1,1,0,1,7,5,0,DF,Under 20,Defender,Spain,Europe
1450,Javi López,ESP,Alavés,La Liga,2019,17.0,2002.0,1.0,6,5,4,2,0,4,5,80.0,1,1,1,0,1,7,5,0,DF,Under 20,Defender,Spain,Europe
1451,Javi López,ESP,Espanyol,La Liga,2019,33.0,1986.0,15.4,47,34,23,18,6,19,40,47.5,21,12,6,6,21,68,38,2,DF,30-34,Defender,Spain,Europe
1451,Javi López,ESP,Espanyol,La Liga,2019,33.0,1986.0,15.4,47,34,23,18,6,19,40,47.5,21,12,6,6,21,68,38,2,DF,30-34,Defender,Spain,Europe
1451,Javi López,ESP,Espanyol,La Liga,2019,33.0,1986.0,15.4,47,34,23,18,6,19,40,47.5,21,12,6,6,21,68,38,2,DF,30-34,Defender,Spain,Europe
1451,Javi López,ESP,Espanyol,La Liga,2019,33.0,1986.0,15.4,47,34,23,18,6,19,40,47.5,21,12,6,6,21,68,38,2,DF,30-34,Defender,Spain,Europe
1454,Pau López,ESP,Roma,Serie A,2019,24.0,1994.0,32.0,1,0,1,0,0,1,5,20.0,4,0,0,0,1,2,10,3,GK,20-24,Goalkeeper,Spain,Europe
1455,Roberto López,ESP,Real Sociedad,La Liga,2019,19.0,2000.0,0.6,4,2,1,1,2,2,2,100.0,0,0,0,0,0,4,0,0,"FW,MF",Under 20,Forward,Spain,Europe
1456,Unai López,ESP,Athletic Club,La Liga,2019,23.0,1995.0,19.9,30,22,8,18,4,10,41,24.4,31,13,2,11,18,48,12,1,MF,20-24,Midfielder,Spain,Europe
1457,Iker Losada,ESP,Celta Vigo,La Liga,2019,17.0,2001.0,0.1,0,0,0,0,0,0,0,,0,0,0,0,0,0,0,0,"MF,FW",Under 20,Midfielder,Spain,Europe
1466,Pol Lozano,ESP,Espanyol,La Liga,2019,19.0,1999.0,1.9,5,3,3,2,0,3,7,42.9,4,3,0,3,1,6,2,0,MF,Under 20,Midfielder,Spain,Europe
1471,José Luis Morales,ESP,Levante,La Liga,2019,32.0,1987.0,28.0,17,8,5,9,3,6,34,17.6,28,14,1,13,6,23,5,1,"FW,MF",30-34,Forward,Spain,Europe
1479,Saša Lukić,SRB,Torino,Serie A,2019,22.0,1996.0,20.7,29,17,8,19,2,10,35,28.6,25,21,7,14,29,58,15,0,MF,20-24,Midfielder,Serbia,Europe
1511,Nikola Maksimović,SRB,Napoli,Serie A,2019,27.0,1991.0,20.0,35,24,21,14,0,10,21,47.6,11,19,11,8,30,65,64,1,DF,25-29,Defender,Serbia,Europe
1531,Javier Manquillo,ESP,Newcastle Utd,Premier League,2019,25.0,1994.0,17.8,39,26,27,8,4,24,38,63.2,14,14,2,12,18,57,56,0,DF,25-29,Defender,Spain,Europe
1540,Óscar de Marcos,ESP,Athletic Club,La Liga,2019,30.0,1989.0,6.0,5,3,2,1,2,3,6,50.0,3,6,0,6,8,13,8,0,"DF,FW",30-34,Defender,Spain,Europe
1542,Miguel Marí,ESP,Eibar,La Liga,2019,22.0,1997.0,0.1,0,0,0,0,0,0,0,,0,0,0,0,0,0,0,0,MF,20-24,Midfielder,Spain,Europe
1543,Pablo Marí,ESP,Arsenal,Premier League,2019,25.0,1993.0,1.3,2,1,2,0,0,0,0,,0,0,0,0,1,3,10,0,DF,25-29,Defender,Spain,Europe
1557,Roger Martí,ESP,Levante,La Liga,2019,28.0,1991.0,25.2,18,11,8,7,3,7,29,24.1,22,14,0,14,6,24,17,0,FW,25-29,Forward,Spain,Europe
1559,Aarón Martín,ESP,Mainz 05,Bundesliga,2019,22.0,1997.0,19.9,29,15,17,8,4,9,22,40.9,13,11,5,6,30,59,36,0,DF,20-24,Defender,Spain,Europe
1566,Álex Martínez,ESP,Granada,La Liga,2019,28.0,1990.0,0.2,0,0,0,0,0,0,0,,0,0,0,0,0,0,0,0,DF,25-29,Defender,Spain,Europe
1568,Iñigo Martínez,ESP,Athletic Club,La Liga,2019,28.0,1991.0,33.0,48,30,33,13,2,27,47,57.4,20,28,13,15,39,87,140,0,DF,25-29,Defender,Spain,Europe
1569,Javi Martínez,ESP,Osasuna,La Liga,2019,19.0,1999.0,0.1,0,0,0,0,0,0,0,,0,0,0,0,0,0,1,0,MF,Under 20,Midfielder,Spain,Europe
1569,Javi Martínez,ESP,Osasuna,La Liga,2019,19.0,1999.0,0.1,0,0,0,0,0,0,0,,0,0,0,0,0,0,1,0,MF,Under 20,Midfielder,Spain,Europe
1569,Javi Martínez,ESP,Osasuna,La Liga,2019,19.0,1999.0,0.1,0,0,0,0,0,0,0,,0,0,0,0,0,0,1,0,MF,Under 20,Midfielder,Spain,Europe
1569,Javi Martínez,ESP,Osasuna,La Liga,2019,19.0,1999.0,0.1,0,0,0,0,0,0,0,,0,0,0,0,0,0,1,0,MF,Under 20,Midfielder,Spain,Europe
1570,Javi Martínez,ESP,Bayern Munich,Bundesliga,2019,30.0,1988.0,7.5,16,12,9,7,0,9,11,81.8,2,9,8,1,18,34,30,0,"DF,MF",30-34,Defender,Spain,Europe
1570,Javi Martínez,ESP,Bayern Munich,Bundesliga,2019,30.0,1988.0,7.5,16,12,9,7,0,9,11,81.8,2,9,8,1,18,34,30,0,"DF,MF",30-34,Defender,Spain,Europe
1570,Javi Martínez,ESP,Bayern Munich,Bundesliga,2019,30.0,1988.0,7.5,16,12,9,7,0,9,11,81.8,2,9,8,1,18,34,30,0,"DF,MF",30-34,Defender,Spain,Europe
1570,Javi Martínez,ESP,Bayern Munich,Bundesliga,2019,30.0,1988.0,7.5,16,12,9,7,0,9,11,81.8,2,9,8,1,18,34,30,0,"DF,MF",30-34,Defender,Spain,Europe
1573,Pablo Martínez,ESP,Levante,La Liga,2019,21.0,1998.0,0.4,2,0,1,1,0,0,1,0.0,1,0,0,0,0,2,2,0,MF,20-24,Midfielder,Spain,Europe
1573,Pablo Martínez,ESP,Levante,La Liga,2019,21.0,1998.0,0.4,2,0,1,1,0,0,1,0.0,1,0,0,0,0,2,2,0,MF,20-24,Midfielder,Spain,Europe
1573,Pablo Martínez,ESP,Levante,La Liga,2019,21.0,1998.0,0.4,2,0,1,1,0,0,1,0.0,1,0,0,0,0,2,2,0,MF,20-24,Midfielder,Spain,Europe
1573,Pablo Martínez,ESP,Levante,La Liga,2019,21.0,1998.0,0.4,2,0,1,1,0,0,1,0.0,1,0,0,0,0,2,2,0,MF,20-24,Midfielder,Spain,Europe
1581,Jordi Masip,ESP,Valladolid,La Liga,2019,30.0,1989.0,35.0,1,1,1,0,0,0,2,0.0,2,0,0,0,1,2,7,3,GK,30-34,Goalkeeper,Spain,Europe
1583,Jaime Mata,ESP,Getafe,La Liga,2019,30.0,1988.0,30.5,21,13,3,11,7,3,20,15.0,17,16,1,15,7,28,15,0,FW,30-34,Forward,Spain,Europe
1599,Borja Mayoral,ESP,Levante,La Liga,2019,22.0,1997.0,23.8,12,3,4,6,2,2,13,15.4,11,11,0,11,4,16,6,0,FW,20-24,Forward,Spain,Europe
1625,Óscar Melendo,ESP,Espanyol,La Liga,2019,21.0,1997.0,12.4,10,4,4,4,2,4,12,33.3,8,7,2,5,2,12,3,0,"MF,FW",20-24,Midfielder,Spain,Europe
1626,Gonzalo Melero,ESP,Levante,La Liga,2019,25.0,1994.0,13.7,20,13,9,9,2,7,27,25.9,20,12,3,9,9,29,15,1,MF,25-29,Midfielder,Spain,Europe
1631,Brais Méndez,ESP,Celta Vigo,La Liga,2019,22.0,1997.0,16.4,26,11,14,9,3,12,39,30.8,27,20,0,20,12,38,23,1,"MF,FW",20-24,Midfielder,Spain,Europe
1642,Jorge Meré,ESP,Köln,Bundesliga,2019,22.0,1997.0,6.9,6,5,2,4,0,1,2,50.0,1,13,11,2,14,20,30,0,DF,20-24,Defender,Spain,Europe
1644,Fran Mérida,ESP,Osasuna,La Liga,2019,29.0,1990.0,12.9,27,15,11,10,6,9,27,33.3,18,15,4,11,25,52,10,0,MF,25-29,Midfielder,Spain,Europe
1645,Mikel Merino,ESP,Real Sociedad,La Liga,2019,23.0,1996.0,34.9,79,52,20,44,15,28,86,32.6,58,46,8,38,51,130,52,0,MF,20-24,Midfielder,Spain,Europe
1646,Sabin Merino,ESP,Leganés,La Liga,2019,27.0,1992.0,0.9,0,0,0,0,0,0,0,,0,0,0,0,0,0,0,0,FW,25-29,Forward,Spain,Europe
1649,Roque Mesa,ESP,Leganés,La Liga,2019,30.0,1989.0,22.4,40,21,17,18,5,13,44,29.5,31,13,4,9,11,51,8,0,MF,30-34,Midfielder,Spain,Europe
1660,Nikola Milenković,SRB,Fiorentina,Serie A,2019,21.0,1997.0,36.2,46,25,30,16,0,11,31,35.5,20,39,21,18,29,75,129,1,DF,20-24,Defender,Serbia,Europe
1661,Arkadiusz Milik,POL,Napoli,Serie A,2019,25.0,1994.0,19.4,12,5,4,1,7,3,11,27.3,8,11,1,10,2,14,12,0,FW,25-29,Forward,Poland,Europe
1662,Sergej Milinković-Savić,SRB,Lazio,Serie A,2019,24.0,1995.0,33.7,60,35,25,24,11,15,79,19.0,64,67,16,51,37,97,60,1,MF,20-24,Midfielder,Serbia,Europe
1667,Santi Mina,ESP,Celta Vigo,La Liga,2019,23.0,1995.0,21.6,13,8,8,5,0,5,38,13.2,33,19,2,17,10,23,27,0,"FW,MF",20-24,Forward,Spain,Europe
1671,Jorge Miramón,ESP,Levante,La Liga,2019,30.0,1989.0,27.0,52,27,35,13,4,26,45,57.8,19,30,8,22,46,98,61,1,DF,30-34,Defender,Spain,Europe
1672,Juan Miranda,ESP,Schalke 04,Bundesliga,2019,19.0,2000.0,8.7,14,10,8,6,0,6,18,33.3,12,12,4,8,10,24,27,1,DF,Under 20,Defender,Spain,Europe
1684,Jorge Molina,ESP,Getafe,La Liga,2019,37.0,1982.0,21.0,8,2,0,4,4,0,12,0.0,12,13,2,11,4,12,18,0,FW,35-39,Forward,Spain,Europe
1686,Jon Moncayola,ESP,Osasuna,La Liga,2019,21.0,1998.0,16.6,52,30,26,22,4,27,54,50.0,27,29,5,24,16,68,23,1,"MF,DF",20-24,Midfielder,Spain,Europe
1689,Nacho Monreal,ESP,Arsenal,Premier League,2019,33.0,1986.0,3.0,1,1,1,0,0,1,3,33.3,2,3,1,2,3,4,10,0,DF,30-34,Defender,Spain,Europe
1690,Nacho Monreal,ESP,Real Sociedad,La Liga,2019,33.0,1986.0,26.6,38,16,26,9,3,22,42,52.4,20,20,4,16,43,81,66,0,DF,30-34,Defender,Spain,Europe
1691,Joan Monterde,ESP,Levante,La Liga,2019,21.0,1997.0,0.1,0,0,0,0,0,0,0,,0,0,0,0,0,0,0,0,MF,20-24,Midfielder,Spain,Europe
1693,Ángel Montoro,ESP,Granada,La Liga,2019,31.0,1988.0,10.8,19,8,8,9,2,3,13,23.1,10,10,1,9,13,32,15,0,MF,30-34,Midfielder,Spain,Europe
1703,Alberto Moreno,ESP,Villarreal,La Liga,2019,27.0,1992.0,16.3,27,16,15,11,1,9,25,36.0,16,15,3,12,25,52,36,0,DF,25-29,Defender,Spain,Europe
1703,Alberto Moreno,ESP,Villarreal,La Liga,2019,27.0,1992.0,16.3,27,16,15,11,1,9,25,36.0,16,15,3,12,25,52,36,0,DF,25-29,Defender,Spain,Europe
1703,Alberto Moreno,ESP,Villarreal,La Liga,2019,27.0,1992.0,16.3,27,16,15,11,1,9,25,36.0,16,15,3,12,25,52,36,0,DF,25-29,Defender,Spain,Europe
1703,Alberto Moreno,ESP,Villarreal,La Liga,2019,27.0,1992.0,16.3,27,16,15,11,1,9,25,36.0,16,15,3,12,25,52,36,0,DF,25-29,Defender,Spain,Europe
1704,Álex Moreno,ESP,Betis,La Liga,2019,26.0,1993.0,25.2,37,20,27,8,2,12,32,37.5,20,21,8,13,23,60,47,1,DF,25-29,Defender,Spain,Europe
1705,Gerard Moreno,ESP,Villarreal,La Liga,2019,27.0,1992.0,30.5,19,8,4,10,5,5,46,10.9,41,19,3,16,10,29,51,0,"FW,MF",25-29,Forward,Spain,Europe
1706,Mateu Morey,ESP,Dortmund,Bundesliga,2019,19.0,2000.0,2.2,7,3,2,4,1,4,10,40.0,6,4,0,4,5,12,3,0,"DF,MF",Under 20,Defender,Spain,Europe
1708,Manu Morlanes,ESP,Villarreal,La Liga,2019,20.0,1999.0,2.8,7,3,3,4,0,2,9,22.2,7,1,1,0,2,9,2,0,MF,20-24,Midfielder,Spain,Europe
1723,Toni Moya,ESP,Atlético Madrid,La Liga,2019,21.0,1998.0,0.0,0,0,0,0,0,0,0,,0,0,0,0,0,0,0,0,MF,20-24,Midfielder,Spain,Europe
1724,Javi Moyano,ESP,Valladolid,La Liga,2019,33.0,1986.0,24.7,19,8,11,8,0,8,20,40.0,12,18,5,13,27,46,63,0,DF,30-34,Defender,Spain,Europe
1730,Iker Muniain,ESP,Athletic Club,La Liga,2019,26.0,1992.0,26.5,26,19,11,10,5,4,24,16.7,20,9,0,9,12,38,7,0,"FW,MF",25-29,Forward,Spain,Europe
1731,Aihen Muñoz,ESP,Real Sociedad,La Liga,2019,21.0,1997.0,10.9,28,18,13,12,3,18,27,66.7,9,13,2,11,2,30,19,0,DF,20-24,Defender,Spain,Europe
1761,Matija Nastasić,SRB,Schalke 04,Bundesliga,2019,26.0,1993.0,15.2,26,16,17,9,0,14,17,82.4,3,28,16,12,22,48,79,0,DF,25-29,Defender,Serbia,Europe
1762,Marc Navarro,ESP,Leganés,La Liga,2019,24.0,1995.0,2.4,3,3,2,1,0,1,1,100.0,0,2,1,1,0,3,3,0,"FW,DF",20-24,Forward,Spain,Europe
1764,Jesús Navas,ESP,Sevilla,La Liga,2019,33.0,1985.0,37.4,27,15,16,7,4,15,32,46.9,17,20,7,13,31,58,70,0,DF,30-34,Defender,Spain,Europe
1766,Raúl Navas,ESP,Osasuna,La Liga,2019,31.0,1988.0,7.9,10,5,4,6,0,4,13,30.8,9,10,4,6,18,28,30,0,DF,30-34,Defender,Spain,Europe
1778,Carlos Neva,ESP,Granada,La Liga,2019,23.0,1996.0,24.5,16,11,12,3,1,9,21,42.9,12,15,2,13,28,44,60,0,DF,20-24,Defender,Spain,Europe
1794,Saúl Ñíguez,ESP,Atlético Madrid,La Liga,2019,24.0,1994.0,34.1,95,59,44,42,9,39,88,44.3,49,58,13,45,55,150,68,1,"MF,DF",20-24,Midfielder,Spain,Europe
1803,Nolito,ESP,Sevilla,La Liga,2019,32.0,1986.0,10.0,21,12,5,11,5,7,20,35.0,13,7,0,7,1,22,1,0,FW,30-34,Forward,Spain,Europe
1804,Nolito,ESP,Celta Vigo,La Liga,2019,32.0,1986.0,3.6,7,5,5,2,0,3,8,37.5,5,4,1,3,1,8,4,0,"MF,FW",30-34,Midfielder,Spain,Europe
1807,Oliver Norwood,NIR,Sheffield Utd,Premier League,2019,28.0,1991.0,34.3,66,37,35,24,7,28,97,28.9,69,34,12,22,47,113,40,1,MF,25-29,Midfielder,Northern Ireland,Europe
1810,Unai Núñez,ESP,Athletic Club,La Liga,2019,22.0,1997.0,17.5,13,10,10,2,1,6,16,37.5,10,25,17,8,23,36,71,0,DF,20-24,Defender,Spain,Europe
1813,Ørjan Nyland,NOR,Aston Villa,Premier League,2019,28.0,1990.0,6.0,0,0,0,0,0,0,0,,0,0,0,0,0,0,1,1,GK,25-29,Goalkeeper,Norway,Europe
1819,Jan Oblak,SVN,Atlético Madrid,La Liga,2019,26.0,1993.0,37.7,0,0,0,0,0,0,0,,0,0,0,0,1,1,4,2,GK,25-29,Goalkeeper,Slovenia,Europe
1823,Álvaro Odriozola,ESP,Real Madrid,La Liga,2019,23.0,1995.0,3.8,5,2,4,0,1,5,8,62.5,3,4,0,4,2,7,8,0,DF,20-24,Defender,Spain,Europe
1824,Álvaro Odriozola,ESP,Bayern Munich,Bundesliga,2019,23.0,1995.0,1.7,2,2,1,0,1,2,3,66.7,1,1,0,1,1,3,2,0,DF,20-24,Defender,Spain,Europe
1830,Oier Olazábal,ESP,Espanyol,La Liga,2019,29.0,1989.0,2.0,0,0,0,0,0,0,0,,0,1,0,1,0,0,0,0,GK,25-29,Goalkeeper,Spain,Europe
1832,Kiko Olivas,ESP,Valladolid,La Liga,2019,30.0,1988.0,32.7,33,16,25,7,1,13,35,37.1,22,30,16,14,61,94,112,2,DF,30-34,Defender,Spain,Europe
1838,Dani Olmo,ESP,RB Leipzig,Bundesliga,2019,21.0,1998.0,8.3,20,14,5,10,5,1,13,7.7,12,7,1,6,4,24,6,0,"MF,FW",20-24,Midfielder,Spain,Europe
1850,Aimar Oroz,ESP,Osasuna,La Liga,2019,17.0,2001.0,0.1,0,0,0,0,0,0,0,,0,1,0,1,0,0,0,0,FW,Under 20,Forward,Spain,Europe
1867,Mikel Oyarzabal,ESP,Real Sociedad,La Liga,2019,22.0,1997.0,33.9,36,15,13,15,8,16,46,34.8,30,32,2,30,13,49,19,1,"FW,MF",20-24,Forward,Spain,Europe
1872,Fernando Pacheco,ESP,Alavés,La Liga,2019,27.0,1992.0,26.2,1,0,1,0,0,1,3,33.3,2,0,0,0,0,1,10,0,GK,25-29,Goalkeeper,Spain,Europe
1872,Fernando Pacheco,ESP,Alavés,La Liga,2019,27.0,1992.0,26.2,1,0,1,0,0,1,3,33.3,2,0,0,0,0,1,10,0,GK,25-29,Goalkeeper,Spain,Europe
1872,Fernando Pacheco,ESP,Alavés,La Liga,2019,27.0,1992.0,26.2,1,0,1,0,0,1,3,33.3,2,0,0,0,0,1,10,0,GK,25-29,Goalkeeper,Spain,Europe
1872,Fernando Pacheco,ESP,Alavés,La Liga,2019,27.0,1992.0,26.2,1,0,1,0,0,1,3,33.3,2,0,0,0,0,1,10,0,GK,25-29,Goalkeeper,Spain,Europe
1873,Jon Pacheco,ESP,Real Sociedad,La Liga,2019,18.0,2001.0,0.9,0,0,0,0,0,0,0,,0,1,0,1,0,0,2,0,DF,Under 20,Defender,Spain,Europe
1881,Sergi Palencia,ESP,Saint-Étienne,Ligue 1,2019,23.0,1996.0,5.2,16,10,6,10,0,5,7,71.4,2,6,1,5,8,24,4,0,DF,20-24,Defender,Spain,Europe
1897,Miquel Parera,ESP,Mallorca,La Liga,2019,23.0,1996.0,1.0,0,0,0,0,0,0,0,,0,0,0,0,0,0,0,0,GK,20-24,Goalkeeper,Spain,Europe
1903,Patric,ESP,Lazio,Serie A,2019,26.0,1993.0,18.6,34,20,24,7,3,18,25,72.0,7,19,9,10,15,49,45,0,DF,25-29,Defender,Spain,Europe
1917,Alfonso Pedraza,ESP,Betis,La Liga,2019,23.0,1996.0,15.0,30,19,16,11,3,19,33,57.6,14,18,6,12,16,46,26,1,DF,20-24,Defender,Spain,Europe
1918,Marc Pedraza,ESP,Mallorca,La Liga,2019,32.0,1987.0,1.4,1,1,1,0,0,1,5,20.0,4,0,0,0,4,5,1,0,MF,30-34,Midfielder,Spain,Europe
1919,Pedro,ESP,Chelsea,Premier League,2019,32.0,1987.0,7.3,15,7,5,9,1,3,15,20.0,12,9,0,9,9,24,1,0,"FW,MF",30-34,Forward,Spain,Europe
1919,Pedro,ESP,Chelsea,Premier League,2019,32.0,1987.0,7.3,15,7,5,9,1,3,15,20.0,12,9,0,9,9,24,1,0,"FW,MF",30-34,Forward,Spain,Europe
1919,Pedro,ESP,Chelsea,Premier League,2019,32.0,1987.0,7.3,15,7,5,9,1,3,15,20.0,12,9,0,9,9,24,1,0,"FW,MF",30-34,Forward,Spain,Europe
1919,Pedro,ESP,Chelsea,Premier League,2019,32.0,1987.0,7.3,15,7,5,9,1,3,15,20.0,12,9,0,9,9,24,1,0,"FW,MF",30-34,Forward,Spain,Europe
1919,Pedro,ESP,Chelsea,Premier League,2019,32.0,1987.0,7.3,15,7,5,9,1,3,15,20.0,12,9,0,9,9,24,1,0,"FW,MF",30-34,Forward,Spain,Europe
1919,Pedro,ESP,Chelsea,Premier League,2019,32.0,1987.0,7.3,15,7,5,9,1,3,15,20.0,12,9,0,9,9,24,1,0,"FW,MF",30-34,Forward,Spain,Europe
1919,Pedro,ESP,Chelsea,Premier League,2019,32.0,1987.0,7.3,15,7,5,9,1,3,15,20.0,12,9,0,9,9,24,1,0,"FW,MF",30-34,Forward,Spain,Europe
1919,Pedro,ESP,Chelsea,Premier League,2019,32.0,1987.0,7.3,15,7,5,9,1,3,15,20.0,12,9,0,9,9,24,1,0,"FW,MF",30-34,Forward,Spain,Europe
1919,Pedro,ESP,Chelsea,Premier League,2019,32.0,1987.0,7.3,15,7,5,9,1,3,15,20.0,12,9,0,9,9,24,1,0,"FW,MF",30-34,Forward,Spain,Europe
1919,Pedro,ESP,Chelsea,Premier League,2019,32.0,1987.0,7.3,15,7,5,9,1,3,15,20.0,12,9,0,9,9,24,1,0,"FW,MF",30-34,Forward,Spain,Europe
1919,Pedro,ESP,Chelsea,Premier League,2019,32.0,1987.0,7.3,15,7,5,9,1,3,15,20.0,12,9,0,9,9,24,1,0,"FW,MF",30-34,Forward,Spain,Europe
1919,Pedro,ESP,Chelsea,Premier League,2019,32.0,1987.0,7.3,15,7,5,9,1,3,15,20.0,12,9,0,9,9,24,1,0,"FW,MF",30-34,Forward,Spain,Europe
1919,Pedro,ESP,Chelsea,Premier League,2019,32.0,1987.0,7.3,15,7,5,9,1,3,15,20.0,12,9,0,9,9,24,1,0,"FW,MF",30-34,Forward,Spain,Europe
1919,Pedro,ESP,Chelsea,Premier League,2019,32.0,1987.0,7.3,15,7,5,9,1,3,15,20.0,12,9,0,9,9,24,1,0,"FW,MF",30-34,Forward,Spain,Europe
1919,Pedro,ESP,Chelsea,Premier League,2019,32.0,1987.0,7.3,15,7,5,9,1,3,15,20.0,12,9,0,9,9,24,1,0,"FW,MF",30-34,Forward,Spain,Europe
1919,Pedro,ESP,Chelsea,Premier League,2019,32.0,1987.0,7.3,15,7,5,9,1,3,15,20.0,12,9,0,9,9,24,1,0,"FW,MF",30-34,Forward,Spain,Europe
1922,Adrià Pedrosa,ESP,Espanyol,La Liga,2019,21.0,1998.0,12.1,19,13,8,9,2,7,25,28.0,18,12,1,11,11,30,32,0,"DF,MF",20-24,Defender,Spain,Europe
1933,Rubén Peña,ESP,Villarreal,La Liga,2019,28.0,1991.0,21.2,42,24,23,19,0,17,50,34.0,33,25,8,17,35,77,58,2,DF,25-29,Defender,Spain,Europe
1943,Ayoze Pérez,ESP,Leicester City,Premier League,2019,26.0,1993.0,22.3,45,28,14,26,5,8,54,14.8,46,33,1,32,14,59,9,1,"MF,FW",25-29,Midfielder,Spain,Europe
1944,Carles Pérez,ESP,Roma,Serie A,2019,21.0,1998.0,6.3,12,8,4,6,2,3,10,30.0,7,6,1,5,3,15,1,0,"FW,MF",20-24,Forward,Spain,Europe
1945,Carles Pérez,ESP,Barcelona,La Liga,2019,21.0,1998.0,5.3,7,4,2,2,3,3,15,20.0,12,5,2,3,1,8,1,0,FW,20-24,Forward,Spain,Europe
1946,Iñigo Pérez,ESP,Osasuna,La Liga,2019,31.0,1988.0,12.0,15,11,3,7,5,8,22,36.4,14,7,1,6,12,27,6,0,MF,30-34,Midfielder,Spain,Europe
1947,Juan Pérez,ESP,Osasuna,La Liga,2019,23.0,1996.0,2.0,1,1,1,0,0,1,2,50.0,1,0,0,0,0,1,0,0,GK,20-24,Goalkeeper,Spain,Europe
1948,Kike Pérez,ESP,Valladolid,La Liga,2019,22.0,1997.0,2.4,6,1,1,3,2,3,7,42.9,4,1,0,1,10,16,4,0,"MF,FW",20-24,Midfielder,Spain,Europe
1986,Gerard Piqué,ESP,Barcelona,La Liga,2019,32.0,1987.0,34.4,32,23,20,11,1,16,26,61.5,10,39,24,15,36,68,157,0,DF,30-34,Defender,Spain,Europe
1992,Óscar Plano,ESP,Valladolid,La Liga,2019,28.0,1991.0,27.8,48,30,25,19,4,20,61,32.8,41,36,3,33,35,83,29,0,MF,25-29,Midfielder,Spain,Europe
2004,Pere Pons,ESP,Alavés,La Liga,2019,26.0,1993.0,12.1,28,16,14,12,2,12,26,46.2,14,16,3,13,12,40,8,1,MF,25-29,Midfielder,Spain,Europe
2006,Pedro Porro,ESP,Valladolid,La Liga,2019,19.0,1999.0,8.2,18,10,11,7,0,10,18,55.6,8,3,0,3,7,25,19,1,"DF,MF",Under 20,Defender,Spain,Europe
2007,Francisco Portillo,ESP,Getafe,La Liga,2019,29.0,1990.0,4.2,11,6,3,6,2,4,12,33.3,8,2,0,2,2,13,3,0,MF,25-29,Midfielder,Spain,Europe
2008,Portu,ESP,Real Sociedad,La Liga,2019,27.0,1992.0,26.6,32,21,10,15,7,13,33,39.4,20,28,3,25,13,45,5,0,"FW,MF",25-29,Forward,Spain,Europe
2010,Sergio Postigo,ESP,Levante,La Liga,2019,30.0,1988.0,26.4,32,15,23,7,2,11,18,61.1,7,24,15,9,34,66,132,1,DF,30-34,Defender,Spain,Europe
2019,Abdón Prats,ESP,Mallorca,La Liga,2019,26.0,1992.0,3.1,1,1,0,0,1,0,1,0.0,1,1,0,1,0,1,1,0,FW,25-29,Forward,Spain,Europe
2026,Antonio Puertas,ESP,Granada,La Liga,2019,27.0,1992.0,28.5,37,24,8,18,11,16,53,30.2,37,21,3,18,12,49,21,0,"FW,MF",25-29,Forward,Spain,Europe
2027,Riqui Puig,ESP,Barcelona,La Liga,2019,19.0,1999.0,5.7,11,7,1,9,1,5,17,29.4,12,2,0,2,5,16,1,0,MF,Under 20,Midfielder,Spain,Europe
2040,Nemanja Radoja,SRB,Levante,La Liga,2019,26.0,1993.0,22.1,43,19,27,16,0,15,46,32.6,31,21,4,17,23,66,24,0,MF,25-29,Midfielder,Serbia,Europe
2041,Nemanja Radonjić,SRB,Marseille,Ligue 1,2019,23.0,1996.0,9.8,10,3,4,3,3,6,17,35.3,11,7,0,7,2,12,7,0,"FW,MF",20-24,Forward,Serbia,Europe
2045,Boris Radunović,SRB,Hellas Verona,Serie A,2019,23.0,1996.0,3.0,0,0,0,0,0,0,0,,0,0,0,0,0,0,1,0,GK,20-24,Goalkeeper,Serbia,Europe
2049,Rafinha,BRA,Barcelona,La Liga,2019,26.0,1993.0,2.1,3,2,1,1,1,1,2,50.0,1,0,0,0,1,4,0,0,"FW,MF",25-29,Forward,Brazil,South America
2049,Rafinha,BRA,Barcelona,La Liga,2019,26.0,1993.0,2.1,3,2,1,1,1,1,2,50.0,1,0,0,0,1,4,0,0,"FW,MF",25-29,Forward,Brazil,South America
2049,Rafinha,BRA,Barcelona,La Liga,2019,26.0,1993.0,2.1,3,2,1,1,1,1,2,50.0,1,0,0,0,1,4,0,0,"FW,MF",25-29,Forward,Brazil,South America
2049,Rafinha,BRA,Barcelona,La Liga,2019,26.0,1993.0,2.1,3,2,1,1,1,1,2,50.0,1,0,0,0,1,4,0,0,"FW,MF",25-29,Forward,Brazil,South America
2049,Rafinha,BRA,Barcelona,La Liga,2019,26.0,1993.0,2.1,3,2,1,1,1,1,2,50.0,1,0,0,0,1,4,0,0,"FW,MF",25-29,Forward,Brazil,South America
2049,Rafinha,BRA,Barcelona,La Liga,2019,26.0,1993.0,2.1,3,2,1,1,1,1,2,50.0,1,0,0,0,1,4,0,0,"FW,MF",25-29,Forward,Brazil,South America
2049,Rafinha,BRA,Barcelona,La Liga,2019,26.0,1993.0,2.1,3,2,1,1,1,1,2,50.0,1,0,0,0,1,4,0,0,"FW,MF",25-29,Forward,Brazil,South America
2049,Rafinha,BRA,Barcelona,La Liga,2019,26.0,1993.0,2.1,3,2,1,1,1,1,2,50.0,1,0,0,0,1,4,0,0,"FW,MF",25-29,Forward,Brazil,South America
2049,Rafinha,BRA,Barcelona,La Liga,2019,26.0,1993.0,2.1,3,2,1,1,1,1,2,50.0,1,0,0,0,1,4,0,0,"FW,MF",25-29,Forward,Brazil,South America
2049,Rafinha,BRA,Barcelona,La Liga,2019,26.0,1993.0,2.1,3,2,1,1,1,1,2,50.0,1,0,0,0,1,4,0,0,"FW,MF",25-29,Forward,Brazil,South America
2049,Rafinha,BRA,Barcelona,La Liga,2019,26.0,1993.0,2.1,3,2,1,1,1,1,2,50.0,1,0,0,0,1,4,0,0,"FW,MF",25-29,Forward,Brazil,South America
2049,Rafinha,BRA,Barcelona,La Liga,2019,26.0,1993.0,2.1,3,2,1,1,1,1,2,50.0,1,0,0,0,1,4,0,0,"FW,MF",25-29,Forward,Brazil,South America
2049,Rafinha,BRA,Barcelona,La Liga,2019,26.0,1993.0,2.1,3,2,1,1,1,1,2,50.0,1,0,0,0,1,4,0,0,"FW,MF",25-29,Forward,Brazil,South America
2049,Rafinha,BRA,Barcelona,La Liga,2019,26.0,1993.0,2.1,3,2,1,1,1,1,2,50.0,1,0,0,0,1,4,0,0,"FW,MF",25-29,Forward,Brazil,South America
2049,Rafinha,BRA,Barcelona,La Liga,2019,26.0,1993.0,2.1,3,2,1,1,1,1,2,50.0,1,0,0,0,1,4,0,0,"FW,MF",25-29,Forward,Brazil,South America
2049,Rafinha,BRA,Barcelona,La Liga,2019,26.0,1993.0,2.1,3,2,1,1,1,1,2,50.0,1,0,0,0,1,4,0,0,"FW,MF",25-29,Forward,Brazil,South America
2050,Rafinha,BRA,Celta Vigo,La Liga,2019,26.0,1993.0,23.5,71,37,29,37,5,20,62,32.3,42,37,4,33,33,104,25,0,MF,25-29,Midfielder,Brazil,South America
2050,Rafinha,BRA,Celta Vigo,La Liga,2019,26.0,1993.0,23.5,71,37,29,37,5,20,62,32.3,42,37,4,33,33,104,25,0,MF,25-29,Midfielder,Brazil,South America
2050,Rafinha,BRA,Celta Vigo,La Liga,2019,26.0,1993.0,23.5,71,37,29,37,5,20,62,32.3,42,37,4,33,33,104,25,0,MF,25-29,Midfielder,Brazil,South America
2050,Rafinha,BRA,Celta Vigo,La Liga,2019,26.0,1993.0,23.5,71,37,29,37,5,20,62,32.3,42,37,4,33,33,104,25,0,MF,25-29,Midfielder,Brazil,South America
2050,Rafinha,BRA,Celta Vigo,La Liga,2019,26.0,1993.0,23.5,71,37,29,37,5,20,62,32.3,42,37,4,33,33,104,25,0,MF,25-29,Midfielder,Brazil,South America
2050,Rafinha,BRA,Celta Vigo,La Liga,2019,26.0,1993.0,23.5,71,37,29,37,5,20,62,32.3,42,37,4,33,33,104,25,0,MF,25-29,Midfielder,Brazil,South America
2050,Rafinha,BRA,Celta Vigo,La Liga,2019,26.0,1993.0,23.5,71,37,29,37,5,20,62,32.3,42,37,4,33,33,104,25,0,MF,25-29,Midfielder,Brazil,South America
2050,Rafinha,BRA,Celta Vigo,La Liga,2019,26.0,1993.0,23.5,71,37,29,37,5,20,62,32.3,42,37,4,33,33,104,25,0,MF,25-29,Midfielder,Brazil,South America
2050,Rafinha,BRA,Celta Vigo,La Liga,2019,26.0,1993.0,23.5,71,37,29,37,5,20,62,32.3,42,37,4,33,33,104,25,0,MF,25-29,Midfielder,Brazil,South America
2050,Rafinha,BRA,Celta Vigo,La Liga,2019,26.0,1993.0,23.5,71,37,29,37,5,20,62,32.3,42,37,4,33,33,104,25,0,MF,25-29,Midfielder,Brazil,South America
2050,Rafinha,BRA,Celta Vigo,La Liga,2019,26.0,1993.0,23.5,71,37,29,37,5,20,62,32.3,42,37,4,33,33,104,25,0,MF,25-29,Midfielder,Brazil,South America
2050,Rafinha,BRA,Celta Vigo,La Liga,2019,26.0,1993.0,23.5,71,37,29,37,5,20,62,32.3,42,37,4,33,33,104,25,0,MF,25-29,Midfielder,Brazil,South America
2050,Rafinha,BRA,Celta Vigo,La Liga,2019,26.0,1993.0,23.5,71,37,29,37,5,20,62,32.3,42,37,4,33,33,104,25,0,MF,25-29,Midfielder,Brazil,South America
2050,Rafinha,BRA,Celta Vigo,La Liga,2019,26.0,1993.0,23.5,71,37,29,37,5,20,62,32.3,42,37,4,33,33,104,25,0,MF,25-29,Midfielder,Brazil,South America
2050,Rafinha,BRA,Celta Vigo,La Liga,2019,26.0,1993.0,23.5,71,37,29,37,5,20,62,32.3,42,37,4,33,33,104,25,0,MF,25-29,Midfielder,Brazil,South America
2050,Rafinha,BRA,Celta Vigo,La Liga,2019,26.0,1993.0,23.5,71,37,29,37,5,20,62,32.3,42,37,4,33,33,104,25,0,MF,25-29,Midfielder,Brazil,South America
2051,Daniele Ragatzu,ITA,Cagliari,Serie A,2019,27.0,1991.0,3.5,3,2,0,2,1,1,3,33.3,2,1,0,1,1,4,5,0,"MF,FW",25-29,Midfielder,Italy,Europe
2057,Gastón Ramírez,URU,Sampdoria,Serie A,2019,28.0,1990.0,15.5,32,21,7,16,9,8,30,26.7,22,28,2,26,11,43,10,0,"MF,FW",25-29,Midfielder,Uruguay,South America
2060,Adrián Ramos,COL,Granada,La Liga,2019,33.0,1986.0,2.5,6,2,0,2,4,2,3,66.7,1,2,0,2,1,7,1,0,"FW,MF",30-34,Forward,Colombia,South America
2062,Aaron Ramsdale,ENG,Bournemouth,Premier League,2019,21.0,1998.0,37.0,4,3,4,0,0,3,3,100.0,0,0,0,0,0,4,25,1,GK,20-24,Goalkeeper,England,Europe
2063,Aaron Ramsey,WAL,Juventus,Serie A,2019,28.0,1990.0,11.7,20,15,6,8,6,6,24,25.0,18,18,3,15,11,31,12,0,MF,25-29,Midfielder,Wales,Europe
2063,Aaron Ramsey,WAL,Juventus,Serie A,2019,28.0,1990.0,11.7,20,15,6,8,6,6,24,25.0,18,18,3,15,11,31,12,0,MF,25-29,Midfielder,Wales,Europe
2063,Aaron Ramsey,WAL,Juventus,Serie A,2019,28.0,1990.0,11.7,20,15,6,8,6,6,24,25.0,18,18,3,15,11,31,12,0,MF,25-29,Midfielder,Wales,Europe
2063,Aaron Ramsey,WAL,Juventus,Serie A,2019,28.0,1990.0,11.7,20,15,6,8,6,6,24,25.0,18,18,3,15,11,31,12,0,MF,25-29,Midfielder,Wales,Europe
2064,Darren Randolph,IRL,West Ham,Premier League,2019,32.0,1987.0,2.0,0,0,0,0,0,0,0,,0,0,0,0,0,0,2,0,GK,30-34,Goalkeeper,Republic of Ireland,Europe
2065,Luca Ranieri,ITA,Fiorentina,Serie A,2019,20.0,1999.0,2.6,2,2,2,0,0,2,3,66.7,1,1,0,1,2,4,7,0,DF,20-24,Defender,Italy,Europe
2066,Andrea Ranocchia,ITA,Inter,Serie A,2019,31.0,1988.0,5.8,17,10,10,7,0,5,8,62.5,3,11,6,5,8,25,18,0,DF,30-34,Defender,Italy,Europe
2067,Raphinha,BRA,Rennes,Ligue 1,2019,22.0,1996.0,18.8,22,18,5,12,5,10,32,31.3,22,23,1,22,17,39,14,1,"MF,FW",20-24,Midfielder,Brazil,South America
2068,Tobias Raschl,GER,Dortmund,Bundesliga,2019,19.0,2000.0,0.3,0,0,0,0,0,0,1,0.0,1,1,0,1,0,0,0,0,MF,Under 20,Midfielder,Germany,Europe
2069,Marcus Rashford,ENG,Manchester Utd,Premier League,2019,21.0,1997.0,29.4,13,9,1,6,6,9,23,39.1,14,23,0,23,10,23,19,0,FW,20-24,Forward,England,Europe
2071,Giacomo Raspadori,ITA,Sassuolo,Serie A,2019,19.0,2000.0,2.9,8,6,5,2,1,3,4,75.0,1,5,0,5,1,9,0,0,"MF,FW",Under 20,Midfielder,Italy,Europe
2073,Ante Rebić,CRO,Milan,Serie A,2019,25.0,1993.0,15.5,16,11,4,9,3,7,34,20.6,27,14,1,13,3,19,12,0,"FW,MF",25-29,Forward,Croatia,Europe
2074,Ante Rebić,CRO,Eint Frankfurt,Bundesliga,2019,25.0,1993.0,1.0,1,0,0,1,0,0,0,,0,0,0,0,0,1,1,0,"FW,MF",25-29,Forward,Croatia,Europe
2078,Nathan Redmond,ENG,Southampton,Premier League,2019,25.0,1994.0,30.7,49,29,17,23,9,21,57,36.8,36,39,2,37,16,65,16,0,"MF,FW",25-29,Midfielder,England,Europe
2079,Fabian Reese,GER,Schalke 04,Bundesliga,2019,21.0,1997.0,1.0,1,1,1,0,0,0,0,,0,1,1,0,0,1,1,0,FW,20-24,Forward,Germany,Europe
2080,Vasco Regini,ITA,Sampdoria,Serie A,2019,28.0,1990.0,1.9,4,2,3,1,0,0,0,,0,4,2,2,1,5,6,0,DF,25-29,Defender,Italy,Europe
2081,Vasco Regini,ITA,Parma,Serie A,2019,28.0,1990.0,0.6,0,0,0,0,0,0,0,,0,0,0,0,0,0,3,0,DF,25-29,Defender,Italy,Europe
2083,Ken Reichel,GER,Union Berlin,Bundesliga,2019,32.0,1986.0,5.9,6,3,2,3,1,3,13,23.1,10,8,1,7,9,15,12,0,DF,30-34,Defender,Germany,Europe
2087,Jeff Reine-Adélaïde,FRA,Angers,Ligue 1,2019,21.0,1998.0,0.9,3,1,1,2,0,1,1,100.0,0,1,0,1,0,3,1,0,MF,20-24,Midfielder,France,Europe
2088,Jeff Reine-Adélaïde,FRA,Lyon,Ligue 1,2019,21.0,1998.0,8.7,10,8,3,3,4,5,13,38.5,8,3,1,2,7,17,4,0,"MF,FW",20-24,Midfielder,France,Europe
2089,Karim Rekik,NED,Hertha BSC,Bundesliga,2019,24.0,1994.0,14.0,16,10,10,6,0,3,6,50.0,3,23,15,8,18,34,44,0,DF,20-24,Defender,Netherlands,Europe
2091,Loïc Rémy,FRA,Lille,Ligue 1,2019,32.0,1987.0,10.7,4,1,0,3,1,0,4,0.0,4,1,1,0,0,4,7,0,FW,30-34,Forward,France,Europe
2093,Marco Reus,GER,Dortmund,Bundesliga,2019,30.0,1989.0,16.6,26,16,5,11,10,3,19,15.8,16,17,2,15,9,35,11,0,"MF,FW",30-34,Midfielder,Germany,Europe
2096,Baptiste Reynet,FRA,Toulouse,Ligue 1,2019,28.0,1990.0,22.6,1,1,1,0,0,1,3,33.3,2,0,0,0,0,1,12,0,GK,25-29,Goalkeeper,France,Europe
2098,Lucas Ribeiro,BRA,Hoffenheim,Bundesliga,2019,20.0,1999.0,0.7,1,0,1,0,0,0,3,0.0,3,1,0,1,1,2,1,0,MF,20-24,Midfielder,Brazil,South America
2099,Franck Ribéry,FRA,Fiorentina,Serie A,2019,36.0,1983.0,15.7,20,14,7,10,3,4,20,20.0,16,9,0,9,3,23,3,0,FW,35-39,Forward,France,Europe
2100,Davide Riccardi,ITA,Lecce,Serie A,2019,23.0,1996.0,0.2,0,0,0,0,0,0,1,0.0,1,0,0,0,0,0,1,0,DF,20-24,Defender,Italy,Europe
2101,Declan Rice,ENG,West Ham,Premier League,2019,20.0,1999.0,38.0,116,60,64,48,4,47,98,48.0,51,41,9,32,77,193,55,0,MF,20-24,Midfielder,England,Europe
2102,Chris Richards,USA,Bayern Munich,Bundesliga,2019,19.0,2000.0,0.1,0,0,0,0,0,0,0,,0,0,0,0,0,0,1,0,DF,Under 20,Defender,United States,North America
2103,Richarlison,BRA,Everton,Premier League,2019,22.0,1997.0,34.1,70,47,28,28,14,27,56,48.2,29,34,4,30,12,82,42,0,"FW,MF",20-24,Forward,Brazil,South America
2104,Marco Richter,GER,Augsburg,Bundesliga,2019,21.0,1997.0,25.3,21,16,7,9,5,14,51,27.5,37,15,0,15,24,45,17,0,"MF,FW",20-24,Midfielder,Germany,Europe
2109,Tomás Rincón,VEN,Torino,Serie A,2019,31.0,1988.0,30.0,56,25,23,25,8,23,65,35.4,42,20,3,17,36,92,62,0,MF,30-34,Midfielder,Venezuela,South America
2111,Renaud Ripart,FRA,Nîmes,Ligue 1,2019,26.0,1993.0,22.5,39,23,17,20,2,18,46,39.1,28,17,2,15,12,51,37,0,"FW,DF",25-29,Forward,France,Europe
2113,Andrea Rispoli,ITA,Lecce,Serie A,2019,30.0,1988.0,21.2,24,18,14,9,1,15,30,50.0,15,28,7,21,32,56,62,1,DF,30-34,Defender,Italy,Europe
2114,Marcel Risse,GER,Köln,Bundesliga,2019,29.0,1989.0,1.5,3,2,3,0,0,1,1,100.0,0,1,0,1,1,4,1,0,"MF,FW",25-29,Midfielder,Germany,Europe
2116,Matt Ritchie,SCO,Newcastle Utd,Premier League,2019,29.0,1989.0,14.6,22,15,9,10,3,3,15,20.0,12,20,5,15,14,36,31,1,"DF,MF",25-29,Defender,Scotland,Europe
2117,Marlon Ritter,GER,Paderborn 07,Bundesliga,2019,24.0,1994.0,4.8,7,5,5,2,0,4,9,44.4,5,7,0,7,8,15,3,0,MF,20-24,Midfielder,Germany,Europe
2124,Patrick Roberts,ENG,Norwich City,Premier League,2019,22.0,1997.0,0.3,0,0,0,0,0,0,0,,0,0,0,0,0,0,0,0,"FW,MF",20-24,Forward,England,Europe
2125,Andrew Robertson,SCO,Liverpool,Premier League,2019,25.0,1994.0,34.6,54,31,17,25,12,27,61,44.3,34,29,7,22,38,92,72,1,DF,25-29,Defender,Scotland,Europe
2126,Callum Robinson,IRL,Sheffield Utd,Premier League,2019,24.0,1995.0,7.5,6,3,2,2,2,2,7,28.6,5,3,0,3,7,13,3,0,"FW,MF",20-24,Forward,Republic of Ireland,Europe
2127,Jack Robinson,ENG,Sheffield Utd,Premier League,2019,25.0,1993.0,5.6,10,5,5,5,0,1,6,16.7,5,12,5,7,8,18,24,0,DF,25-29,Defender,England,Europe
2131,Sebastian Rode,GER,Eint Frankfurt,Bundesliga,2019,28.0,1990.0,21.5,58,33,27,27,4,17,59,28.8,42,32,5,27,34,92,13,0,MF,25-29,Midfielder,Germany,Europe
2139,Guido Rodríguez,ARG,Betis,La Liga,2019,25.0,1994.0,10.4,24,16,11,11,2,15,25,60.0,10,13,4,9,10,34,21,0,MF,25-29,Midfielder,Argentina,South America
2143,Ricardo Rodríguez,SUI,Milan,Serie A,2019,26.0,1992.0,4.3,6,1,2,2,2,2,6,33.3,4,3,2,1,5,11,17,0,DF,25-29,Defender,Switzerland,Europe
2144,Rodrygo,BRA,Real Madrid,La Liga,2019,18.0,2001.0,11.3,6,1,2,3,1,2,21,9.5,19,13,0,13,10,16,5,0,FW,Under 20,Forward,Brazil,South America
2145,Jack Rodwell,ENG,Sheffield Utd,Premier League,2019,28.0,1991.0,0.2,0,0,0,0,0,0,0,,0,0,0,0,0,0,1,0,MF,25-29,Midfielder,England,Europe
2146,Marko Rog,CRO,Cagliari,Serie A,2019,24.0,1995.0,25.7,69,47,31,29,9,22,84,26.2,62,40,12,28,22,91,23,0,MF,20-24,Midfielder,Croatia,Europe
2147,Agustín Rogel,URU,Toulouse,Ligue 1,2019,21.0,1997.0,9.5,15,8,12,3,0,7,13,53.8,6,13,10,3,11,26,35,2,DF,20-24,Defender,Uruguay,South America
2148,Rogério,BRA,Sassuolo,Serie A,2019,21.0,1998.0,11.3,22,14,12,8,2,16,23,69.6,7,13,3,10,9,31,34,0,DF,20-24,Defender,Brazil,South America
2148,Rogério,BRA,Sassuolo,Serie A,2019,21.0,1998.0,11.3,22,14,12,8,2,16,23,69.6,7,13,3,10,9,31,34,0,DF,20-24,Defender,Brazil,South America
2148,Rogério,BRA,Sassuolo,Serie A,2019,21.0,1998.0,11.3,22,14,12,8,2,16,23,69.6,7,13,3,10,9,31,34,0,DF,20-24,Defender,Brazil,South America
2148,Rogério,BRA,Sassuolo,Serie A,2019,21.0,1998.0,11.3,22,14,12,8,2,16,23,69.6,7,13,3,10,9,31,34,0,DF,20-24,Defender,Brazil,South America
2149,Marcos Rojo,ARG,Manchester Utd,Premier League,2019,29.0,1990.0,1.4,3,1,2,1,0,1,2,50.0,1,2,1,1,0,3,6,0,DF,25-29,Defender,Argentina,South America
2150,Filippo Romagna,ITA,Sassuolo,Serie A,2019,22.0,1997.0,16.4,7,6,2,5,0,5,6,83.3,1,24,17,7,10,17,69,0,DF,20-24,Defender,Italy,Europe
2151,Alessio Romagnoli,ITA,Milan,Serie A,2019,24.0,1995.0,34.3,46,25,28,15,3,16,27,59.3,11,32,18,14,56,102,157,1,DF,20-24,Defender,Italy,Europe
2153,Cristian Romero,ARG,Genoa,Serie A,2019,21.0,1998.0,28.6,52,35,36,12,4,12,41,29.3,29,59,33,26,75,127,116,2,DF,20-24,Defender,Argentina,South America
2156,Rômulo,ITA,Brescia,Serie A,2019,32.0,1987.0,19.1,30,19,12,14,4,12,34,35.3,22,18,1,17,8,38,12,1,MF,30-34,Midfielder,Italy,Europe
2156,Rômulo,ITA,Brescia,Serie A,2019,32.0,1987.0,19.1,30,19,12,14,4,12,34,35.3,22,18,1,17,8,38,12,1,MF,30-34,Midfielder,Italy,Europe
2156,Rômulo,ITA,Brescia,Serie A,2019,32.0,1987.0,19.1,30,19,12,14,4,12,34,35.3,22,18,1,17,8,38,12,1,MF,30-34,Midfielder,Italy,Europe
2156,Rômulo,ITA,Brescia,Serie A,2019,32.0,1987.0,19.1,30,19,12,14,4,12,34,35.3,22,18,1,17,8,38,12,1,MF,30-34,Midfielder,Italy,Europe
2156,Rômulo,ITA,Brescia,Serie A,2019,32.0,1987.0,19.1,30,19,12,14,4,12,34,35.3,22,18,1,17,8,38,12,1,MF,30-34,Midfielder,Italy,Europe
2156,Rômulo,ITA,Brescia,Serie A,2019,32.0,1987.0,19.1,30,19,12,14,4,12,34,35.3,22,18,1,17,8,38,12,1,MF,30-34,Midfielder,Italy,Europe
2156,Rômulo,ITA,Brescia,Serie A,2019,32.0,1987.0,19.1,30,19,12,14,4,12,34,35.3,22,18,1,17,8,38,12,1,MF,30-34,Midfielder,Italy,Europe
2156,Rômulo,ITA,Brescia,Serie A,2019,32.0,1987.0,19.1,30,19,12,14,4,12,34,35.3,22,18,1,17,8,38,12,1,MF,30-34,Midfielder,Italy,Europe
2156,Rômulo,ITA,Brescia,Serie A,2019,32.0,1987.0,19.1,30,19,12,14,4,12,34,35.3,22,18,1,17,8,38,12,1,MF,30-34,Midfielder,Italy,Europe
2156,Rômulo,ITA,Brescia,Serie A,2019,32.0,1987.0,19.1,30,19,12,14,4,12,34,35.3,22,18,1,17,8,38,12,1,MF,30-34,Midfielder,Italy,Europe
2156,Rômulo,ITA,Brescia,Serie A,2019,32.0,1987.0,19.1,30,19,12,14,4,12,34,35.3,22,18,1,17,8,38,12,1,MF,30-34,Midfielder,Italy,Europe
2156,Rômulo,ITA,Brescia,Serie A,2019,32.0,1987.0,19.1,30,19,12,14,4,12,34,35.3,22,18,1,17,8,38,12,1,MF,30-34,Midfielder,Italy,Europe
2156,Rômulo,ITA,Brescia,Serie A,2019,32.0,1987.0,19.1,30,19,12,14,4,12,34,35.3,22,18,1,17,8,38,12,1,MF,30-34,Midfielder,Italy,Europe
2156,Rômulo,ITA,Brescia,Serie A,2019,32.0,1987.0,19.1,30,19,12,14,4,12,34,35.3,22,18,1,17,8,38,12,1,MF,30-34,Midfielder,Italy,Europe
2156,Rômulo,ITA,Brescia,Serie A,2019,32.0,1987.0,19.1,30,19,12,14,4,12,34,35.3,22,18,1,17,8,38,12,1,MF,30-34,Midfielder,Italy,Europe
2156,Rômulo,ITA,Brescia,Serie A,2019,32.0,1987.0,19.1,30,19,12,14,4,12,34,35.3,22,18,1,17,8,38,12,1,MF,30-34,Midfielder,Italy,Europe
2157,Rômulo,ITA,Genoa,Serie A,2019,32.0,1987.0,0.2,2,1,1,1,0,0,0,,0,0,0,0,0,2,1,0,DF,30-34,Defender,Italy,Europe
2157,Rômulo,ITA,Genoa,Serie A,2019,32.0,1987.0,0.2,2,1,1,1,0,0,0,,0,0,0,0,0,2,1,0,DF,30-34,Defender,Italy,Europe
2157,Rômulo,ITA,Genoa,Serie A,2019,32.0,1987.0,0.2,2,1,1,1,0,0,0,,0,0,0,0,0,2,1,0,DF,30-34,Defender,Italy,Europe
2157,Rômulo,ITA,Genoa,Serie A,2019,32.0,1987.0,0.2,2,1,1,1,0,0,0,,0,0,0,0,0,2,1,0,DF,30-34,Defender,Italy,Europe
2157,Rômulo,ITA,Genoa,Serie A,2019,32.0,1987.0,0.2,2,1,1,1,0,0,0,,0,0,0,0,0,2,1,0,DF,30-34,Defender,Italy,Europe
2157,Rômulo,ITA,Genoa,Serie A,2019,32.0,1987.0,0.2,2,1,1,1,0,0,0,,0,0,0,0,0,2,1,0,DF,30-34,Defender,Italy,Europe
2157,Rômulo,ITA,Genoa,Serie A,2019,32.0,1987.0,0.2,2,1,1,1,0,0,0,,0,0,0,0,0,2,1,0,DF,30-34,Defender,Italy,Europe
2157,Rômulo,ITA,Genoa,Serie A,2019,32.0,1987.0,0.2,2,1,1,1,0,0,0,,0,0,0,0,0,2,1,0,DF,30-34,Defender,Italy,Europe
2157,Rômulo,ITA,Genoa,Serie A,2019,32.0,1987.0,0.2,2,1,1,1,0,0,0,,0,0,0,0,0,2,1,0,DF,30-34,Defender,Italy,Europe
2157,Rômulo,ITA,Genoa,Serie A,2019,32.0,1987.0,0.2,2,1,1,1,0,0,0,,0,0,0,0,0,2,1,0,DF,30-34,Defender,Italy,Europe
2157,Rômulo,ITA,Genoa,Serie A,2019,32.0,1987.0,0.2,2,1,1,1,0,0,0,,0,0,0,0,0,2,1,0,DF,30-34,Defender,Italy,Europe
2157,Rômulo,ITA,Genoa,Serie A,2019,32.0,1987.0,0.2,2,1,1,1,0,0,0,,0,0,0,0,0,2,1,0,DF,30-34,Defender,Italy,Europe
2157,Rômulo,ITA,Genoa,Serie A,2019,32.0,1987.0,0.2,2,1,1,1,0,0,0,,0,0,0,0,0,2,1,0,DF,30-34,Defender,Italy,Europe
2157,Rômulo,ITA,Genoa,Serie A,2019,32.0,1987.0,0.2,2,1,1,1,0,0,0,,0,0,0,0,0,2,1,0,DF,30-34,Defender,Italy,Europe
2157,Rômulo,ITA,Genoa,Serie A,2019,32.0,1987.0,0.2,2,1,1,1,0,0,0,,0,0,0,0,0,2,1,0,DF,30-34,Defender,Italy,Europe
2157,Rômulo,ITA,Genoa,Serie A,2019,32.0,1987.0,0.2,2,1,1,1,0,0,0,,0,0,0,0,0,2,1,0,DF,30-34,Defender,Italy,Europe
2158,Cristiano Ronaldo,POR,Juventus,Serie A,2019,34.0,1985.0,32.4,14,10,3,3,8,4,20,20.0,16,10,3,7,6,20,21,1,FW,30-34,Forward,Portugal,Europe
2159,Facundo Roncaglia,ARG,Osasuna,La Liga,2019,32.0,1987.0,14.2,24,20,12,10,2,11,20,55.0,9,18,3,15,22,46,46,0,DF,30-34,Defender,Argentina,South America
2160,Valentin Rongier,FRA,Marseille,Ligue 1,2019,24.0,1994.0,19.9,76,51,25,41,10,22,63,34.9,41,30,4,26,36,112,16,2,MF,20-24,Midfielder,France,Europe
2161,Valentin Rongier,FRA,Nantes,Ligue 1,2019,24.0,1994.0,3.0,5,4,0,2,3,3,5,60.0,2,4,0,4,2,7,0,0,MF,20-24,Midfielder,France,Europe
2162,Marten de Roon,NED,Atalanta,Serie A,2019,28.0,1991.0,30.2,77,43,36,29,12,34,75,45.3,41,32,8,24,46,123,45,0,"MF,DF",25-29,Midfielder,Netherlands,Europe
2163,Roberto Rosales,VEN,Leganés,La Liga,2019,30.0,1988.0,20.8,42,23,23,17,2,19,43,44.2,24,17,4,13,30,72,48,0,DF,30-34,Defender,Venezuela,South America
2164,Antonio Rosati,ITA,Torino,Serie A,2019,36.0,1983.0,1.0,0,0,0,0,0,0,0,,0,0,0,0,0,0,0,1,GK,35-39,Goalkeeper,Italy,Europe
2165,Danny Rose,ENG,Tottenham,Premier League,2019,29.0,1990.0,9.9,18,11,6,10,2,9,20,45.0,11,14,6,8,8,26,34,2,DF,25-29,Defender,England,Europe
2166,Danny Rose,ENG,Newcastle Utd,Premier League,2019,29.0,1990.0,9.6,21,12,11,8,2,12,21,57.1,9,11,4,7,10,31,14,1,DF,25-29,Defender,England,Europe
2167,Luca Rossettini,ITA,Lecce,Serie A,2019,34.0,1985.0,25.1,25,14,18,7,0,17,34,50.0,17,31,22,9,35,60,126,1,DF,30-34,Defender,Italy,Europe
2168,Francesco Rossi,ITA,Atalanta,Serie A,2019,28.0,1991.0,0.1,0,0,0,0,0,0,0,,0,0,0,0,0,0,0,0,GK,25-29,Goalkeeper,Italy,Europe
2169,Jérôme Roussillon,FRA,Wolfsburg,Bundesliga,2019,26.0,1993.0,26.3,48,29,26,18,4,15,29,51.7,14,33,5,28,30,78,58,0,DF,25-29,Defender,France,Europe
2170,Nolan Roux,FRA,Nîmes,Ligue 1,2019,31.0,1988.0,6.5,5,2,1,3,1,1,3,33.3,2,2,0,2,4,9,5,0,FW,30-34,Forward,France,Europe
2175,Antonio Rüdiger,GER,Chelsea,Premier League,2019,26.0,1993.0,19.0,28,18,19,7,2,16,25,64.0,9,15,9,6,16,44,59,1,DF,25-29,Defender,Germany,Europe
2176,Sebastian Rudy,GER,Hoffenheim,Bundesliga,2019,29.0,1990.0,30.4,73,49,31,29,13,28,75,37.3,47,26,5,21,27,100,38,0,"MF,DF",25-29,Midfielder,Germany,Europe
2177,Stéphane Ruffier,FRA,Saint-Étienne,Ligue 1,2019,32.0,1986.0,22.0,0,0,0,0,0,0,0,,0,0,0,0,0,0,5,3,GK,30-34,Goalkeeper,France,Europe
2180,Mário Rui,POR,Napoli,Serie A,2019,28.0,1991.0,21.8,31,17,12,12,7,11,29,37.9,18,24,5,19,21,52,43,0,DF,25-29,Defender,Portugal,Europe
2183,Gerónimo Rulli,ARG,Montpellier,Ligue 1,2019,27.0,1992.0,25.0,3,1,3,0,0,3,4,75.0,1,1,0,1,2,5,9,1,GK,25-29,Goalkeeper,Argentina,South America
2186,Mathew Ryan,AUS,Brighton,Premier League,2019,27.0,1992.0,38.0,1,1,1,0,0,1,4,25.0,3,0,0,0,2,3,13,2,GK,25-29,Goalkeeper,Australia,Oceania
2189,Roli Pereira de Sa,FRA,Nantes,Ligue 1,2019,22.0,1996.0,0.1,0,0,0,0,0,0,0,,0,0,0,0,0,0,0,0,MF,20-24,Midfielder,France,Europe
2191,Youssouf Sabaly,SEN,Bordeaux,Ligue 1,2019,26.0,1993.0,10.1,18,11,9,4,5,6,22,27.3,16,8,1,7,18,36,23,0,DF,25-29,Defender,Senegal,Africa
2192,Stefano Sabelli,ITA,Brescia,Serie A,2019,26.0,1993.0,35.2,83,44,51,28,4,50,106,47.2,56,40,13,27,58,141,107,0,DF,25-29,Defender,Italy,Europe
2193,Abdelhamid Sabiri,MAR,Paderborn 07,Bundesliga,2019,22.0,1996.0,11.6,20,16,6,11,3,9,27,33.3,18,9,2,7,8,28,18,1,MF,20-24,Midfielder,Morocco,Africa
2194,Marcel Sabitzer,AUT,RB Leipzig,Bundesliga,2019,25.0,1994.0,27.8,39,25,15,18,6,19,56,33.9,37,27,4,23,23,62,25,0,"MF,FW",25-29,Midfielder,Austria,Europe
2195,Ihsan Sacko,FRA,Nice,Ligue 1,2019,22.0,1997.0,1.6,1,1,1,0,0,0,1,0.0,1,0,0,0,0,1,0,0,FW,20-24,Forward,France,Europe
2196,Alexis Saelemaekers,BEL,Milan,Serie A,2019,20.0,1999.0,7.6,14,8,5,7,2,6,20,30.0,14,13,1,12,8,22,1,0,"FW,DF",20-24,Forward,Belgium,Europe
2199,Wesley Saïd,FRA,Toulouse,Ligue 1,2019,24.0,1995.0,12.9,20,9,8,10,2,2,13,15.4,11,6,0,6,9,29,8,0,"MF,FW",20-24,Midfielder,France,Europe
2201,Théo Sainte-Luce,FRA,Nîmes,Ligue 1,2019,20.0,1998.0,0.2,0,0,0,0,0,0,0,,0,0,0,0,0,0,0,0,"MF,DF",20-24,Midfielder,France,Europe
2204,Bukayo Saka,ENG,Arsenal,Premier League,2019,17.0,2001.0,19.5,36,21,21,8,7,19,37,51.4,18,12,3,9,12,48,19,0,"DF,FW",Under 20,Defender,England,Europe
2205,Hiroki Sakai,JPN,Marseille,Ligue 1,2019,29.0,1990.0,18.0,57,36,26,24,7,25,40,62.5,15,20,5,15,23,80,34,1,DF,25-29,Defender,Japan,Asia
2206,Mamadou Sakho,FRA,Crystal Palace,Premier League,2019,29.0,1990.0,10.3,7,5,5,1,1,2,5,40.0,3,12,5,7,20,27,46,2,DF,25-29,Defender,France,Europe
2207,Jacopo Sala,ITA,SPAL,Serie A,2019,27.0,1991.0,9.5,29,24,17,11,1,17,31,54.8,14,4,0,4,13,42,15,1,DF,25-29,Defender,Italy,Europe
2208,Mohamed Salah,EGY,Liverpool,Premier League,2019,27.0,1992.0,32.0,16,6,1,4,11,5,22,22.7,17,3,1,2,8,24,2,1,FW,25-29,Forward,Egypt,Africa
2211,William Saliba,FRA,Saint-Étienne,Ligue 1,2019,18.0,2001.0,11.0,19,9,15,3,1,5,10,50.0,5,13,4,9,21,40,36,1,DF,Under 20,Defender,France,Europe
2213,Romain Salin,FRA,Rennes,Ligue 1,2019,35.0,1984.0,4.0,0,0,0,0,0,0,1,0.0,1,0,0,0,0,0,3,0,GK,35-39,Goalkeeper,France,Europe
2214,Mohammed Salisu,GHA,Valladolid,La Liga,2019,20.0,1999.0,30.3,41,24,28,13,0,21,34,61.8,13,32,26,6,35,76,158,3,DF,20-24,Defender,Ghana,Africa
2220,Junior Sambia,FRA,Montpellier,Ligue 1,2019,22.0,1996.0,6.5,8,6,4,2,2,3,13,23.1,10,4,0,4,8,16,6,0,"DF,MF",20-24,Defender,France,Europe
2221,Frédéric Sammaritano,FRA,Dijon,Ligue 1,2019,33.0,1986.0,5.8,9,7,4,4,1,4,11,36.4,7,6,1,5,2,11,3,1,"MF,FW",30-34,Midfielder,France,Europe
2224,Antonio Sanabria,PAR,Genoa,Serie A,2019,23.0,1996.0,15.4,14,11,2,7,5,3,14,21.4,11,13,1,12,5,19,12,1,FW,20-24,Forward,Paraguay,South America
2228,Alexis Sánchez,CHI,Inter,Serie A,2019,30.0,1988.0,10.3,9,7,1,4,4,5,13,38.5,8,7,0,7,3,12,1,0,FW,30-34,Forward,Chile,South America
2229,Carlos Sánchez,COL,West Ham,Premier League,2019,33.0,1986.0,1.3,1,0,0,1,0,1,1,100.0,0,1,0,1,2,3,1,0,MF,30-34,Midfielder,Colombia,South America
2235,Jadon Sancho,ENG,Dortmund,Bundesliga,2019,19.0,2000.0,25.4,14,11,6,6,2,8,24,33.3,16,8,0,8,14,28,6,0,"FW,MF",Under 20,Forward,England,Europe
2236,Alex Sandro,BRA,Juventus,Serie A,2019,28.0,1991.0,26.5,44,26,23,14,7,12,33,36.4,21,26,6,20,47,91,46,3,DF,25-29,Defender,Brazil,South America
2237,Leroy Sané,GER,Manchester City,Premier League,2019,23.0,1996.0,0.1,0,0,0,0,0,0,0,,0,0,0,0,0,0,0,0,FW,20-24,Forward,Germany,Europe
2238,Salif Sané,SEN,Schalke 04,Bundesliga,2019,28.0,1990.0,12.5,16,9,12,4,0,11,19,57.9,8,19,7,12,21,37,50,0,DF,25-29,Defender,Senegal,Africa
2240,Ibrahim Sangaré,CIV,Toulouse,Ligue 1,2019,21.0,1997.0,24.2,84,54,37,42,5,33,74,44.6,41,28,10,18,39,123,49,4,MF,20-24,Midfielder,Ivory Coast,Africa
2242,Yaya Sanogo,FRA,Toulouse,Ligue 1,2019,26.0,1993.0,10.1,6,3,2,3,1,1,2,50.0,1,4,1,3,7,13,14,0,FW,25-29,Forward,France,Europe
2243,Morgan Sanson,FRA,Marseille,Ligue 1,2019,24.0,1994.0,24.1,60,28,20,29,11,13,52,25.0,39,39,5,34,23,83,9,0,MF,20-24,Midfielder,France,Europe
2244,Nicola Sansone,ITA,Bologna,Serie A,2019,27.0,1991.0,25.2,34,20,12,18,4,15,59,25.4,44,21,0,21,11,45,9,0,"FW,MF",25-29,Forward,Italy,Europe
2245,Baptiste Santamaria,FRA,Angers,Ligue 1,2019,24.0,1995.0,27.8,91,53,39,43,9,35,79,44.3,44,27,5,22,43,134,36,0,MF,20-24,Midfielder,France,Europe
2246,Federico Santander,PAR,Bologna,Serie A,2019,28.0,1991.0,8.6,13,8,3,0,10,1,4,25.0,3,3,0,3,7,20,12,0,FW,25-29,Forward,Paraguay,South America
2247,Davide Santon,ITA,Roma,Serie A,2019,28.0,1991.0,6.9,11,6,6,5,0,6,17,35.3,11,2,1,1,11,22,13,0,DF,25-29,Defender,Italy,Europe
2253,Marcelo Saracchi,URU,RB Leipzig,Bundesliga,2019,21.0,1998.0,2.0,8,6,2,5,1,5,6,83.3,1,3,1,2,1,9,5,0,DF,20-24,Defender,Uruguay,South America
2254,Josh Sargent,USA,Werder Bremen,Bundesliga,2019,19.0,2000.0,15.7,11,6,5,4,2,2,12,16.7,10,17,1,16,14,25,21,0,FW,Under 20,Forward,United States,North America
2255,Bouna Sarr,SEN,Marseille,Ligue 1,2019,27.0,1992.0,24.0,60,37,30,19,11,30,53,56.6,23,17,1,16,32,92,38,0,"DF,FW",25-29,Defender,Senegal,Africa
2257,Malang Sarr,FRA,Nice,Ligue 1,2019,20.0,1999.0,16.2,19,11,13,6,0,9,22,40.9,13,10,4,6,38,57,31,4,DF,20-24,Defender,France,Europe
2260,Téji Savanier,FRA,Montpellier,Ligue 1,2019,27.0,1991.0,16.9,52,39,16,30,6,25,77,32.5,52,10,0,10,35,87,21,1,MF,25-29,Midfielder,France,Europe
2262,Fabian Schär,SUI,Newcastle Utd,Premier League,2019,27.0,1991.0,18.6,39,21,25,14,0,19,40,47.5,21,35,18,17,47,86,74,2,"DF,MF",25-29,Defender,Switzerland,Europe
2263,Louis Schaub,AUT,Köln,Bundesliga,2019,24.0,1994.0,6.9,15,12,2,9,4,5,14,35.7,9,10,1,9,3,18,2,0,MF,20-24,Midfielder,Austria,Europe
2264,Ezequiel Schelotto,ITA,Brighton,Premier League,2019,30.0,1989.0,4.0,4,3,1,2,1,2,8,25.0,6,3,0,3,7,11,14,0,DF,30-34,Defender,Italy,Europe
2266,Julian Schieber,GER,Augsburg,Bundesliga,2019,30.0,1989.0,0.5,1,1,0,1,0,0,0,,0,0,0,0,0,1,0,0,FW,30-34,Forward,Germany,Europe
2268,Xaver Schlager,AUT,Wolfsburg,Bundesliga,2019,21.0,1997.0,19.1,47,29,13,30,4,14,44,31.8,30,16,2,14,17,64,12,0,MF,20-24,Midfielder,Austria,Europe
2269,Keven Schlotterbeck,GER,Union Berlin,Bundesliga,2019,22.0,1997.0,21.5,52,27,36,15,1,17,29,58.6,12,40,21,19,40,92,113,1,DF,20-24,Defender,Germany,Europe
2270,Nico Schlotterbeck,GER,Freiburg,Bundesliga,2019,19.0,1999.0,4.1,6,3,4,2,0,2,5,40.0,3,7,5,2,3,9,20,1,DF,Under 20,Defender,Germany,Europe
2273,Marcel Schmelzer,GER,Dortmund,Bundesliga,2019,31.0,1988.0,0.7,2,1,1,1,0,1,1,100.0,0,0,0,0,1,3,2,0,DF,30-34,Defender,Germany,Europe
2274,Jonathan Schmid,FRA,Freiburg,Bundesliga,2019,29.0,1990.0,31.5,42,27,19,19,4,19,37,51.4,18,23,8,15,35,77,84,0,DF,25-29,Defender,France,Europe
2275,Manuel Schmiedebach,GER,Union Berlin,Bundesliga,2019,30.0,1988.0,2.0,4,1,0,3,1,1,7,14.3,6,1,1,0,3,7,3,0,MF,30-34,Midfielder,Germany,Europe
2276,Benno Schmitz,GER,Köln,Bundesliga,2019,24.0,1994.0,12.9,28,17,13,11,4,16,36,44.4,20,11,1,10,16,44,27,0,DF,20-24,Defender,Germany,Europe
2279,Sebastian Schonlau,GER,Paderborn 07,Bundesliga,2019,24.0,1994.0,23.0,64,43,50,14,0,41,66,62.1,25,36,15,21,40,104,138,1,DF,20-24,Defender,Germany,Europe
2280,Alessandro Schöpf,AUT,Schalke 04,Bundesliga,2019,25.0,1994.0,15.9,29,16,11,10,8,12,33,36.4,21,17,1,16,26,55,8,0,MF,25-29,Midfielder,Austria,Europe
2283,Nico Schulz,GER,Dortmund,Bundesliga,2019,26.0,1993.0,6.6,11,7,3,6,2,8,13,61.5,5,14,4,10,9,20,9,0,"DF,MF",25-29,Defender,Germany,Europe
2284,Alexander Schwolow,GER,Freiburg,Bundesliga,2019,27.0,1992.0,23.2,0,0,0,0,0,0,0,,0,2,0,2,1,1,8,3,GK,25-29,Goalkeeper,Germany,Europe
2285,Matteo Scozzarella,ITA,Parma,Serie A,2019,31.0,1988.0,10.2,23,15,8,13,2,14,29,48.3,15,19,14,5,27,50,28,0,MF,30-34,Midfielder,Italy,Europe
2287,Davie Selke,GER,Hertha BSC,Bundesliga,2019,24.0,1995.0,10.7,6,3,2,2,2,4,7,57.1,3,7,1,6,1,7,11,0,FW,20-24,Forward,Germany,Europe
2288,Davie Selke,GER,Werder Bremen,Bundesliga,2019,24.0,1995.0,5.1,2,0,1,1,0,0,2,0.0,2,1,0,1,0,2,2,0,FW,20-24,Forward,Germany,Europe
2289,Matz Sels,BEL,Strasbourg,Ligue 1,2019,27.0,1992.0,27.0,0,0,0,0,0,0,1,0.0,1,0,0,0,1,1,6,0,GK,25-29,Goalkeeper,Belgium,Europe
2290,Ken Sema,SWE,Udinese,Serie A,2019,25.0,1993.0,27.3,59,41,43,15,1,36,68,52.9,32,26,6,20,17,76,41,1,"DF,MF",25-29,Defender,Sweden,Europe
2291,Nélson Semedo,POR,Barcelona,La Liga,2019,25.0,1993.0,23.3,51,30,27,18,6,21,36,58.3,15,18,3,15,22,73,30,0,DF,25-29,Defender,Portugal,Europe
2292,Alessandro Semprini,ITA,Brescia,Serie A,2019,21.0,1998.0,7.0,10,4,7,3,0,7,9,77.8,2,10,3,7,9,19,16,0,DF,20-24,Defender,Italy,Europe
2294,Stefano Sensi,ITA,Inter,Serie A,2019,23.0,1995.0,8.0,18,10,10,7,1,6,22,27.3,16,15,1,14,9,27,4,0,MF,20-24,Midfielder,Italy,Europe
2295,Luigi Sepe,ITA,Parma,Serie A,2019,28.0,1991.0,34.0,1,0,1,0,0,1,2,50.0,1,0,0,0,0,1,6,2,GK,25-29,Goalkeeper,Italy,Europe
2296,Suat Serdar,GER,Schalke 04,Bundesliga,2019,22.0,1997.0,17.8,56,37,16,33,7,18,61,29.5,43,39,7,32,24,80,7,0,MF,20-24,Midfielder,Germany,Europe
2297,Ryan Sessegnon,ENG,Tottenham,Premier League,2019,19.0,2000.0,3.8,6,4,2,4,0,3,6,50.0,3,0,0,0,3,9,12,0,"DF,FW",Under 20,Defender,England,Europe
2300,Xherdan Shaqiri,SUI,Liverpool,Premier League,2019,27.0,1991.0,2.1,1,0,0,1,0,0,1,0.0,1,0,0,0,0,1,0,0,"FW,MF",25-29,Forward,Switzerland,Europe
2301,Billy Sharp,ENG,Sheffield Utd,Premier League,2019,33.0,1986.0,11.7,6,5,2,1,3,1,6,16.7,5,2,0,2,1,7,2,0,FW,30-34,Forward,England,Europe
2302,Luke Shaw,ENG,Manchester Utd,Premier League,2019,24.0,1995.0,19.3,34,18,19,11,4,19,33,57.6,14,26,6,20,24,58,56,1,DF,20-24,Defender,England,Europe
2303,Khiry Shelton,USA,Paderborn 07,Bundesliga,2019,26.0,1993.0,0.4,1,1,1,0,0,0,0,,0,0,0,0,0,1,0,0,FW,25-29,Forward,United States,North America
2305,Gen Shoji,JPN,Toulouse,Ligue 1,2019,26.0,1992.0,0.5,2,2,2,0,0,1,1,100.0,0,0,0,0,0,2,2,0,DF,25-29,Defender,Japan,Asia
2306,Djibril Sidibé,FRA,Everton,Premier League,2019,27.0,1992.0,20.3,83,44,48,25,10,43,72,59.7,29,19,3,16,40,123,41,0,"DF,MF",25-29,Defender,France,Europe
2307,Kalidou Sidibé,FRA,Toulouse,Ligue 1,2019,20.0,1999.0,1.0,3,3,0,3,0,2,5,40.0,3,0,0,0,1,4,0,0,MF,20-24,Midfielder,France,Europe
2308,Sidnei,BRA,Betis,La Liga,2019,29.0,1989.0,13.1,23,19,17,6,0,9,14,64.3,5,15,12,3,21,44,57,0,DF,25-29,Defender,Brazil,South America
2311,Luca Siligardi,ITA,Parma,Serie A,2019,31.0,1988.0,3.7,6,2,3,2,1,4,8,50.0,4,3,0,3,3,9,5,0,"MF,FW",30-34,Midfielder,Italy,Europe
2313,André Silva,POR,Milan,Serie A,2019,23.0,1995.0,0.7,2,1,0,0,2,0,1,0.0,1,0,0,0,0,2,0,0,FW,20-24,Forward,Portugal,Europe
2313,André Silva,POR,Milan,Serie A,2019,23.0,1995.0,0.7,2,1,0,0,2,0,1,0.0,1,0,0,0,0,2,0,0,FW,20-24,Forward,Portugal,Europe
2313,André Silva,POR,Milan,Serie A,2019,23.0,1995.0,0.7,2,1,0,0,2,0,1,0.0,1,0,0,0,0,2,0,0,FW,20-24,Forward,Portugal,Europe
2313,André Silva,POR,Milan,Serie A,2019,23.0,1995.0,0.7,2,1,0,0,2,0,1,0.0,1,0,0,0,0,2,0,0,FW,20-24,Forward,Portugal,Europe
2313,André Silva,POR,Milan,Serie A,2019,23.0,1995.0,0.7,2,1,0,0,2,0,1,0.0,1,0,0,0,0,2,0,0,FW,20-24,Forward,Portugal,Europe
2313,André Silva,POR,Milan,Serie A,2019,23.0,1995.0,0.7,2,1,0,0,2,0,1,0.0,1,0,0,0,0,2,0,0,FW,20-24,Forward,Portugal,Europe
2313,André Silva,POR,Milan,Serie A,2019,23.0,1995.0,0.7,2,1,0,0,2,0,1,0.0,1,0,0,0,0,2,0,0,FW,20-24,Forward,Portugal,Europe
2313,André Silva,POR,Milan,Serie A,2019,23.0,1995.0,0.7,2,1,0,0,2,0,1,0.0,1,0,0,0,0,2,0,0,FW,20-24,Forward,Portugal,Europe
2313,André Silva,POR,Milan,Serie A,2019,23.0,1995.0,0.7,2,1,0,0,2,0,1,0.0,1,0,0,0,0,2,0,0,FW,20-24,Forward,Portugal,Europe
2314,André Silva,POR,Eint Frankfurt,Bundesliga,2019,23.0,1995.0,17.5,7,2,0,5,2,2,14,14.3,12,9,0,9,8,15,4,0,FW,20-24,Forward,Portugal,Europe
2314,André Silva,POR,Eint Frankfurt,Bundesliga,2019,23.0,1995.0,17.5,7,2,0,5,2,2,14,14.3,12,9,0,9,8,15,4,0,FW,20-24,Forward,Portugal,Europe
2314,André Silva,POR,Eint Frankfurt,Bundesliga,2019,23.0,1995.0,17.5,7,2,0,5,2,2,14,14.3,12,9,0,9,8,15,4,0,FW,20-24,Forward,Portugal,Europe
2314,André Silva,POR,Eint Frankfurt,Bundesliga,2019,23.0,1995.0,17.5,7,2,0,5,2,2,14,14.3,12,9,0,9,8,15,4,0,FW,20-24,Forward,Portugal,Europe
2314,André Silva,POR,Eint Frankfurt,Bundesliga,2019,23.0,1995.0,17.5,7,2,0,5,2,2,14,14.3,12,9,0,9,8,15,4,0,FW,20-24,Forward,Portugal,Europe
2314,André Silva,POR,Eint Frankfurt,Bundesliga,2019,23.0,1995.0,17.5,7,2,0,5,2,2,14,14.3,12,9,0,9,8,15,4,0,FW,20-24,Forward,Portugal,Europe
2314,André Silva,POR,Eint Frankfurt,Bundesliga,2019,23.0,1995.0,17.5,7,2,0,5,2,2,14,14.3,12,9,0,9,8,15,4,0,FW,20-24,Forward,Portugal,Europe
2314,André Silva,POR,Eint Frankfurt,Bundesliga,2019,23.0,1995.0,17.5,7,2,0,5,2,2,14,14.3,12,9,0,9,8,15,4,0,FW,20-24,Forward,Portugal,Europe
2314,André Silva,POR,Eint Frankfurt,Bundesliga,2019,23.0,1995.0,17.5,7,2,0,5,2,2,14,14.3,12,9,0,9,8,15,4,0,FW,20-24,Forward,Portugal,Europe
2315,Bernardo Silva,POR,Manchester City,Premier League,2019,24.0,1994.0,22.6,36,18,8,21,7,13,44,29.5,31,25,1,24,24,60,13,0,"FW,MF",20-24,Forward,Portugal,Europe
2317,Gabriel Silva,BRA,Saint-Étienne,Ligue 1,2019,28.0,1991.0,2.6,4,1,1,2,1,2,3,66.7,1,2,0,2,4,8,8,0,DF,25-29,Defender,Brazil,South America
2317,Gabriel Silva,BRA,Saint-Étienne,Ligue 1,2019,28.0,1991.0,2.6,4,1,1,2,1,2,3,66.7,1,2,0,2,4,8,8,0,DF,25-29,Defender,Brazil,South America
2317,Gabriel Silva,BRA,Saint-Étienne,Ligue 1,2019,28.0,1991.0,2.6,4,1,1,2,1,2,3,66.7,1,2,0,2,4,8,8,0,DF,25-29,Defender,Brazil,South America
2317,Gabriel Silva,BRA,Saint-Étienne,Ligue 1,2019,28.0,1991.0,2.6,4,1,1,2,1,2,3,66.7,1,2,0,2,4,8,8,0,DF,25-29,Defender,Brazil,South America
2318,Jonathan Silva,ARG,Leganés,La Liga,2019,25.0,1994.0,30.9,60,34,32,22,6,27,52,51.9,25,12,4,8,34,94,46,0,DF,25-29,Defender,Argentina,South America
2318,Jonathan Silva,ARG,Leganés,La Liga,2019,25.0,1994.0,30.9,60,34,32,22,6,27,52,51.9,25,12,4,8,34,94,46,0,DF,25-29,Defender,Argentina,South America
2318,Jonathan Silva,ARG,Leganés,La Liga,2019,25.0,1994.0,30.9,60,34,32,22,6,27,52,51.9,25,12,4,8,34,94,46,0,DF,25-29,Defender,Argentina,South America
2318,Jonathan Silva,ARG,Leganés,La Liga,2019,25.0,1994.0,30.9,60,34,32,22,6,27,52,51.9,25,12,4,8,34,94,46,0,DF,25-29,Defender,Argentina,South America
2321,Thiago Silva,BRA,Paris S-G,Ligue 1,2019,34.0,1984.0,17.5,28,16,15,13,0,13,16,81.3,3,18,15,3,26,54,54,0,DF,30-34,Defender,Brazil,South America
2321,Thiago Silva,BRA,Paris S-G,Ligue 1,2019,34.0,1984.0,17.5,28,16,15,13,0,13,16,81.3,3,18,15,3,26,54,54,0,DF,30-34,Defender,Brazil,South America
2321,Thiago Silva,BRA,Paris S-G,Ligue 1,2019,34.0,1984.0,17.5,28,16,15,13,0,13,16,81.3,3,18,15,3,26,54,54,0,DF,30-34,Defender,Brazil,South America
2321,Thiago Silva,BRA,Paris S-G,Ligue 1,2019,34.0,1984.0,17.5,28,16,15,13,0,13,16,81.3,3,18,15,3,26,54,54,0,DF,30-34,Defender,Brazil,South America
2322,Marco Silvestri,ITA,Hellas Verona,Serie A,2019,28.0,1991.0,35.0,1,0,1,0,0,1,2,50.0,1,0,0,0,4,5,11,1,GK,25-29,Goalkeeper,Italy,Europe
2323,Mohamed Simakan,FRA,Strasbourg,Ligue 1,2019,19.0,2000.0,16.7,54,32,35,16,3,22,34,64.7,12,14,3,11,31,85,25,0,DF,Under 20,Defender,France,Europe
2324,Giovanni Simeone,ARG,Cagliari,Serie A,2019,24.0,1995.0,32.5,24,13,9,10,5,5,32,15.6,27,24,7,17,11,35,16,1,FW,20-24,Forward,Argentina,South America
2325,Moses Simon,NGA,Nantes,Ligue 1,2019,24.0,1995.0,24.2,15,7,5,4,6,6,21,28.6,15,6,0,6,8,23,6,0,"FW,MF",20-24,Forward,Nigeria,Africa
2328,Sarpreet Singh,NZL,Bayern Munich,Bundesliga,2019,20.0,1999.0,0.8,1,0,0,1,0,0,1,0.0,1,0,0,0,0,1,0,0,"FW,MF",20-24,Forward,New Zealand,Oceania
2329,Wilfried Singo,CIV,Torino,Serie A,2019,18.0,2000.0,1.5,1,0,0,1,0,0,0,,0,0,0,0,1,2,2,0,DF,Under 20,Defender,Ivory Coast,Africa
2333,Ibrahima Sissoko,MLI,Strasbourg,Ligue 1,2019,21.0,1997.0,17.8,46,27,21,21,4,16,48,33.3,32,14,5,9,20,66,25,0,MF,20-24,Midfielder,Mali,Africa
2334,Moussa Sissoko,FRA,Tottenham,Premier League,2019,29.0,1989.0,27.2,39,25,25,12,2,20,48,41.7,28,19,4,15,27,66,43,2,MF,25-29,Midfielder,France,Europe
2338,Ellyes Skhiri,TUN,Köln,Bundesliga,2019,24.0,1995.0,29.7,74,52,30,37,7,29,77,37.7,48,47,9,38,67,141,33,0,MF,20-24,Midfielder,Tunisia,Africa
2339,Oliver Skipp,ENG,Tottenham,Premier League,2019,18.0,2000.0,0.9,2,2,0,2,0,1,4,25.0,3,3,2,1,0,2,0,0,MF,Under 20,Midfielder,England,Europe
2341,Andreas Skov Olsen,DEN,Bologna,Serie A,2019,19.0,1999.0,8.4,11,8,5,5,1,4,12,33.3,8,10,1,9,8,19,5,0,"FW,MF",Under 20,Forward,Denmark,Europe
2342,Robert Skov,DEN,Hoffenheim,Bundesliga,2019,23.0,1996.0,29.0,41,28,30,9,2,26,50,52.0,24,26,6,20,20,61,40,0,"DF,FW",20-24,Defender,Denmark,Europe
2345,Steven Skrzybski,GER,Düsseldorf,Bundesliga,2019,26.0,1992.0,5.9,4,4,2,1,1,0,16,0.0,16,10,0,10,10,14,4,0,"FW,MF",25-29,Forward,Germany,Europe
2349,Chris Smalling,ENG,Roma,Serie A,2019,29.0,1989.0,28.5,25,16,15,9,1,10,13,76.9,3,44,35,9,56,81,126,2,DF,25-29,Defender,England,Europe
2350,Dennis Smarsch,GER,Hertha BSC,Bundesliga,2019,20.0,1999.0,1.7,0,0,0,0,0,0,0,,0,0,0,0,0,0,1,0,GK,20-24,Goalkeeper,Germany,Europe
2351,Adam Smith,ENG,Bournemouth,Premier League,2019,28.0,1991.0,22.8,47,32,29,16,2,23,50,46.0,27,27,6,21,25,72,64,1,DF,25-29,Defender,England,Europe
2351,Adam Smith,ENG,Bournemouth,Premier League,2019,28.0,1991.0,22.8,47,32,29,16,2,23,50,46.0,27,27,6,21,25,72,64,1,DF,25-29,Defender,England,Europe
2351,Adam Smith,ENG,Bournemouth,Premier League,2019,28.0,1991.0,22.8,47,32,29,16,2,23,50,46.0,27,27,6,21,25,72,64,1,DF,25-29,Defender,England,Europe
2351,Adam Smith,ENG,Bournemouth,Premier League,2019,28.0,1991.0,22.8,47,32,29,16,2,23,50,46.0,27,27,6,21,25,72,64,1,DF,25-29,Defender,England,Europe
2352,Emile Smith Rowe,ENG,Arsenal,Premier League,2019,19.0,2000.0,1.1,1,1,1,0,0,1,3,33.3,2,0,0,0,1,2,2,0,MF,Under 20,Midfielder,England,Europe
2355,Cédric Soares,POR,Arsenal,Premier League,2019,27.0,1991.0,2.8,8,6,2,6,0,1,3,33.3,2,3,0,3,3,11,4,0,"MF,DF",25-29,Midfielder,Portugal,Europe
2356,Cédric Soares,POR,Southampton,Premier League,2019,27.0,1991.0,14.5,45,26,19,24,2,25,41,61.0,16,18,4,14,19,64,51,0,DF,25-29,Defender,Portugal,Europe
2358,Lasse Sobiech,GER,Köln,Bundesliga,2019,28.0,1991.0,1.0,1,0,0,0,1,0,0,,0,0,0,0,4,5,6,0,DF,25-29,Defender,Germany,Europe
2359,Marcel Sobottka,GER,Düsseldorf,Bundesliga,2019,25.0,1994.0,7.8,15,10,6,8,1,4,13,30.8,9,9,1,8,9,24,12,0,MF,25-29,Midfielder,Germany,Europe
2361,Dominic Solanke,ENG,Bournemouth,Premier League,2019,21.0,1997.0,18.3,8,4,2,5,1,5,33,15.2,28,9,1,8,8,16,18,1,FW,20-24,Forward,England,Europe
2364,Oumar Solet,FRA,Lyon,Ligue 1,2019,19.0,2000.0,0.1,0,0,0,0,0,0,0,,0,1,1,0,0,0,1,0,DF,Under 20,Defender,France,Europe
2365,Yann Sommer,SUI,Gladbach,Bundesliga,2019,30.0,1988.0,34.0,0,0,0,0,0,0,1,0.0,1,0,0,0,1,1,11,6,GK,30-34,Goalkeeper,Switzerland,Europe
2370,Roberto Soriano,ITA,Bologna,Serie A,2019,28.0,1991.0,27.4,43,25,15,21,7,10,46,21.7,36,19,0,19,17,60,23,1,MF,25-29,Midfielder,Italy,Europe
2371,Riccardo Sottil,ITA,Fiorentina,Serie A,2019,20.0,1999.0,5.7,6,4,4,2,0,3,10,30.0,7,4,0,4,0,6,0,0,"FW,DF",20-24,Forward,Italy,Europe
2373,Adama Soumaoro,FRA,Genoa,Serie A,2019,27.0,1992.0,7.1,3,2,3,0,0,1,3,33.3,2,12,12,0,11,14,32,0,DF,25-29,Defender,France,Europe
2374,Adama Soumaoro,FRA,Lille,Ligue 1,2019,27.0,1992.0,4.6,1,1,0,1,0,0,0,,0,6,5,1,4,5,17,0,DF,25-29,Defender,France,Europe
2375,Boubakary Soumaré,FRA,Lille,Ligue 1,2019,20.0,1999.0,13.5,19,12,6,13,0,9,19,47.4,10,6,0,6,16,35,9,0,MF,20-24,Midfielder,France,Europe
2376,Bryan Soumaré,FRA,Dijon,Ligue 1,2019,20.0,1999.0,4.3,12,1,6,5,1,6,9,66.7,3,1,0,1,2,14,1,0,"MF,FW",20-24,Midfielder,France,Europe
2377,Arnaud Souquet,FRA,Montpellier,Ligue 1,2019,27.0,1992.0,22.4,62,40,45,13,4,30,67,44.8,37,20,6,14,17,79,44,0,"DF,FW",25-29,Defender,France,Europe
2378,Djibril Sow,SUI,Eint Frankfurt,Bundesliga,2019,22.0,1997.0,19.4,56,33,26,17,13,16,47,34.0,31,15,3,12,30,86,9,0,MF,20-24,Midfielder,Switzerland,Europe
2381,Leonardo Spinazzola,ITA,Roma,Serie A,2019,26.0,1993.0,17.2,24,12,11,8,5,12,21,57.1,9,13,5,8,20,44,41,0,DF,25-29,Defender,Italy,Europe
2382,Marco Sportiello,ITA,Atalanta,Serie A,2019,27.0,1992.0,5.8,0,0,0,0,0,0,0,,0,0,0,0,0,0,3,0,GK,25-29,Goalkeeper,Italy,Europe
2383,Mattia Sprocati,ITA,Parma,Serie A,2019,26.0,1993.0,6.6,4,2,3,1,0,0,1,0.0,1,5,1,4,2,6,2,0,"FW,MF",25-29,Forward,Italy,Europe
2385,Dennis Srbeny,GER,Norwich City,Premier League,2019,25.0,1994.0,0.5,5,5,3,2,0,1,3,33.3,2,1,0,1,0,5,1,0,"MF,FW",25-29,Midfielder,Germany,Europe
2386,Dennis Srbeny,GER,Paderborn 07,Bundesliga,2019,25.0,1994.0,12.4,11,6,4,4,3,5,18,27.8,13,11,1,10,3,14,9,0,"FW,MF",25-29,Forward,Germany,Europe
2388,Jack Stacey,ENG,Bournemouth,Premier League,2019,23.0,1996.0,17.2,21,11,9,11,1,8,22,36.4,14,27,11,16,18,39,64,1,DF,20-24,Defender,England,Europe
2391,Junior Stanislas,ENG,Bournemouth,Premier League,2019,29.0,1989.0,7.9,10,7,2,3,5,3,8,37.5,5,6,0,6,4,14,6,0,"MF,FW",25-29,Midfielder,England,Europe
2392,Niklas Stark,GER,Hertha BSC,Bundesliga,2019,24.0,1995.0,19.2,36,20,24,10,2,9,21,42.9,12,27,12,15,21,57,97,2,DF,20-24,Defender,Germany,Europe
2393,Jed Steer,ENG,Aston Villa,Premier League,2019,26.0,1992.0,0.1,0,0,0,0,0,0,0,,0,0,0,0,0,0,0,0,GK,25-29,Goalkeeper,England,Europe
2394,Renato Steffen,SUI,Wolfsburg,Bundesliga,2019,27.0,1991.0,17.6,25,18,4,14,7,14,39,35.9,25,25,2,23,23,48,10,0,"MF,FW",25-29,Midfielder,Switzerland,Europe
2395,Zack Steffen,USA,Düsseldorf,Bundesliga,2019,24.0,1995.0,17.0,0,0,0,0,0,0,0,,0,0,0,0,0,0,5,4,GK,20-24,Goalkeeper,United States,North America
2396,Dale Stephens,ENG,Brighton,Premier League,2019,30.0,1989.0,28.1,73,44,30,37,6,25,75,33.3,50,31,11,20,58,131,42,2,MF,30-34,Midfielder,England,Europe
2397,Jack Stephens,ENG,Southampton,Premier League,2019,25.0,1994.0,27.2,44,27,30,13,1,24,46,52.2,22,38,22,16,31,75,120,2,DF,25-29,Defender,England,Europe
2399,Raheem Sterling,ENG,Manchester City,Premier League,2019,24.0,1994.0,29.5,27,15,8,10,9,6,28,21.4,22,16,2,14,15,42,4,0,FW,20-24,Forward,England,Europe
2400,Enda Stevens,IRL,Sheffield Utd,Premier League,2019,29.0,1990.0,37.2,81,46,48,26,7,42,96,43.8,54,27,8,19,35,116,71,3,DF,25-29,Defender,Republic of Ireland,Europe
2401,Marco Stiepermann,GER,Norwich City,Premier League,2019,28.0,1991.0,13.1,20,8,8,9,3,5,21,23.8,16,11,3,8,5,25,16,0,MF,25-29,Midfielder,Germany,Europe
2402,Lars Stindl,GER,Gladbach,Bundesliga,2019,30.0,1988.0,15.9,27,16,4,15,8,10,28,35.7,18,18,2,16,10,37,7,0,"MF,FW",30-34,Midfielder,Germany,Europe
2403,Kevin Stöger,AUT,Düsseldorf,Bundesliga,2019,25.0,1993.0,14.1,21,15,10,7,4,6,24,25.0,18,24,2,22,26,47,7,1,MF,25-29,Midfielder,Austria,Europe
2404,Vlatko Stojanovski,MKD,Nîmes,Ligue 1,2019,22.0,1997.0,1.4,3,3,0,3,0,1,1,100.0,0,0,0,0,0,3,1,0,FW,20-24,Forward,North Macedonia,Europe
2405,John Stones,ENG,Manchester City,Premier League,2019,25.0,1994.0,12.5,16,10,8,7,1,3,5,60.0,2,5,3,2,9,25,32,2,DF,25-29,Defender,England,Europe
2407,Gabriel Strefezza,BRA,SPAL,Serie A,2019,22.0,1997.0,23.4,64,40,28,26,10,22,54,40.7,32,29,3,26,21,85,17,0,"DF,MF",20-24,Defender,Brazil,South America
2408,Tobias Strobl,GER,Gladbach,Bundesliga,2019,29.0,1990.0,6.8,9,6,5,4,0,3,8,37.5,5,8,4,4,11,20,5,0,"MF,DF",25-29,Midfielder,Germany,Europe
2409,Christian Strohdiek,GER,Paderborn 07,Bundesliga,2019,31.0,1988.0,15.1,26,22,21,5,0,20,42,47.6,22,16,10,6,25,51,92,0,DF,30-34,Defender,Germany,Europe
2410,Kevin Strootman,NED,Marseille,Ligue 1,2019,29.0,1990.0,15.7,39,27,13,23,3,20,49,40.8,29,16,1,15,17,56,24,0,MF,25-29,Midfielder,Netherlands,Europe
2413,Damián Suárez,URU,Getafe,La Liga,2019,31.0,1988.0,28.8,62,32,32,21,9,38,72,52.8,34,25,2,23,27,89,41,0,DF,30-34,Defender,Uruguay,South America
2415,Luis Suárez,URU,Barcelona,La Liga,2019,32.0,1987.0,22.2,4,0,0,1,3,2,12,16.7,10,6,1,5,1,5,11,0,FW,30-34,Forward,Uruguay,South America
2415,Luis Suárez,URU,Barcelona,La Liga,2019,32.0,1987.0,22.2,4,0,0,1,3,2,12,16.7,10,6,1,5,1,5,11,0,FW,30-34,Forward,Uruguay,South America
2415,Luis Suárez,URU,Barcelona,La Liga,2019,32.0,1987.0,22.2,4,0,0,1,3,2,12,16.7,10,6,1,5,1,5,11,0,FW,30-34,Forward,Uruguay,South America
2415,Luis Suárez,URU,Barcelona,La Liga,2019,32.0,1987.0,22.2,4,0,0,1,3,2,12,16.7,10,6,1,5,1,5,11,0,FW,30-34,Forward,Uruguay,South America
2416,Mathías Suárez,URU,Montpellier,Ligue 1,2019,23.0,1996.0,0.7,2,2,2,0,0,2,3,66.7,1,0,0,0,1,3,3,0,DF,20-24,Defender,Uruguay,South America
2418,Isaac Success,NGA,Watford,Premier League,2019,23.0,1996.0,0.8,0,0,0,0,0,0,0,,0,0,0,0,1,1,0,0,"FW,MF",20-24,Forward,Nigeria,Africa
2420,Niklas Süle,GER,Bayern Munich,Bundesliga,2019,23.0,1995.0,7.1,10,6,8,2,0,4,5,80.0,1,8,6,2,8,18,22,1,DF,20-24,Defender,Germany,Europe
2423,Stoppila Sunzu,ZAM,Metz,Ligue 1,2019,30.0,1989.0,15.0,16,8,12,4,0,10,15,66.7,5,22,15,7,24,40,63,0,DF,30-34,Defender,Zambia,Africa
2424,Andrew Surman,ENG,Bournemouth,Premier League,2019,32.0,1986.0,2.6,4,2,2,2,0,1,3,33.3,2,1,0,1,1,5,5,1,MF,30-34,Midfielder,England,Europe
2425,Sam Surridge,ENG,Bournemouth,Premier League,2019,21.0,1998.0,0.3,0,0,0,0,0,0,0,,0,1,0,1,1,1,0,0,"FW,MF",20-24,Forward,England,Europe
2429,Markus Suttner,AUT,Düsseldorf,Bundesliga,2019,32.0,1987.0,14.9,21,16,11,9,1,11,24,45.8,13,22,7,15,13,34,33,0,DF,30-34,Defender,Austria,Europe
2430,Mattias Svanberg,SWE,Bologna,Serie A,2019,20.0,1999.0,11.7,13,8,9,4,0,6,31,19.4,25,15,4,11,13,26,10,0,MF,20-24,Midfielder,Sweden,Europe
2431,Issiaga Sylla,GUI,Toulouse,Ligue 1,2019,25.0,1994.0,28.0,73,49,44,21,8,40,69,58.0,29,31,7,24,67,140,90,2,DF,25-29,Defender,Guinea,Africa
2434,Ádám Szalai,HUN,Mainz 05,Bundesliga,2019,31.0,1987.0,12.7,8,4,0,6,2,1,11,9.1,10,9,0,9,2,10,14,0,FW,30-34,Forward,Hungary,Europe
2436,Andrea Tabanelli,ITA,Lecce,Serie A,2019,29.0,1990.0,10.7,22,13,10,9,3,8,28,28.6,20,13,2,11,11,33,19,0,MF,25-29,Midfielder,Italy,Europe
2438,Panagiotis Tachtsidis,GRE,Lecce,Serie A,2019,28.0,1991.0,22.3,52,27,26,20,6,20,56,35.7,36,27,11,16,35,87,32,2,MF,25-29,Midfielder,Greece,Europe
2439,Jonathan Tah,GER,Leverkusen,Bundesliga,2019,23.0,1996.0,23.2,36,26,23,11,2,18,29,62.1,11,25,13,12,27,63,98,2,DF,20-24,Defender,Germany,Europe
2441,Madih Talal,FRA,Amiens,Ligue 1,2019,21.0,1997.0,0.2,0,0,0,0,0,0,1,0.0,1,1,0,1,0,0,2,0,FW,20-24,Forward,France,Europe
2444,Japhet Tanganga,ENG,Tottenham,Premier League,2019,20.0,1999.0,5.8,17,9,10,6,1,10,17,58.8,7,7,6,1,11,28,31,2,DF,20-24,Defender,England,Europe
2445,Adil Taoui,FRA,Toulouse,Ligue 1,2019,17.0,2001.0,0.3,2,2,0,2,0,0,2,0.0,2,0,0,0,2,4,0,0,MF,Under 20,Midfielder,France,Europe
2446,Edmond Tapsoba,BFA,Leverkusen,Bundesliga,2019,20.0,1999.0,11.8,24,15,17,5,2,15,25,60.0,10,9,5,4,9,33,44,0,DF,20-24,Defender,Burkina Faso,Africa
2447,Matt Targett,ENG,Aston Villa,Premier League,2019,23.0,1995.0,25.5,52,29,37,11,4,22,53,41.5,31,28,8,20,56,108,82,0,"DF,MF",20-24,Defender,England,Europe
2449,James Tarkowski,ENG,Burnley,Premier League,2019,26.0,1992.0,38.0,66,43,47,19,0,31,54,57.4,23,63,47,16,63,129,204,4,DF,25-29,Defender,England,Europe
2452,Charlie Taylor,ENG,Burnley,Premier League,2019,25.0,1993.0,21.6,39,24,26,9,4,19,39,48.7,20,29,9,20,29,68,78,1,DF,25-29,Defender,England,Europe
2453,Neil Taylor,WAL,Aston Villa,Premier League,2019,30.0,1989.0,12.1,16,11,12,4,0,11,20,55.0,9,15,5,10,20,36,43,0,DF,30-34,Defender,Wales,Europe
2454,Aurélien Tchouaméni,FRA,Bordeaux,Ligue 1,2019,19.0,2000.0,12.3,30,14,15,13,2,11,27,40.7,16,11,3,8,13,43,19,1,MF,Under 20,Midfielder,France,Europe
2455,Aurélien Tchouaméni,FRA,Monaco,Ligue 1,2019,19.0,2000.0,0.7,0,0,0,0,0,0,2,0.0,2,0,0,0,0,0,2,1,MF,Under 20,Midfielder,France,Europe
2456,Georg Teigl,AUT,Augsburg,Bundesliga,2019,28.0,1991.0,1.2,3,1,1,2,0,2,4,50.0,2,0,0,0,3,6,1,0,"DF,MF",25-29,Defender,Austria,Europe
2458,Bernard Tekpetey,GHA,Düsseldorf,Bundesliga,2019,21.0,1997.0,5.0,4,4,1,2,1,0,2,0.0,2,5,0,5,2,6,0,0,"FW,MF",20-24,Forward,Ghana,Africa
2461,Lino Tempelmann,GER,Freiburg,Bundesliga,2019,20.0,1999.0,0.4,1,0,1,0,0,1,1,100.0,0,1,1,0,0,1,0,0,MF,20-24,Midfielder,Germany,Europe
2464,Marc-André ter Stegen,GER,Barcelona,La Liga,2019,27.0,1992.0,36.0,2,2,2,0,0,2,3,66.7,1,0,0,0,2,4,17,6,GK,25-29,Goalkeeper,Germany,Europe
2465,Simon Terodde,GER,Köln,Bundesliga,2019,31.0,1988.0,9.0,8,5,4,3,1,3,13,23.1,10,14,3,11,2,10,14,0,FW,30-34,Forward,Germany,Europe
2466,Pietro Terracciano,ITA,Fiorentina,Serie A,2019,29.0,1990.0,6.9,0,0,0,0,0,0,0,,0,0,0,0,0,0,4,0,GK,25-29,Goalkeeper,Italy,Europe
2467,Martin Terrier,FRA,Lyon,Ligue 1,2019,22.0,1997.0,13.3,20,15,7,10,3,3,14,21.4,11,14,1,13,10,30,11,0,"FW,MF",20-24,Forward,France,Europe
2469,Kenny Tete,NED,Lyon,Ligue 1,2019,23.0,1995.0,11.9,33,21,12,16,5,15,23,65.2,8,12,3,9,19,52,34,0,DF,20-24,Defender,Netherlands,Europe
2471,Florian Thauvin,FRA,Marseille,Ligue 1,2019,26.0,1993.0,0.2,1,0,0,1,0,0,1,0.0,1,0,0,0,0,1,0,0,FW,25-29,Forward,France,Europe
2472,Demba Thiam,SEN,SPAL,Serie A,2019,21.0,1998.0,2.0,0,0,0,0,0,0,0,,0,0,0,0,1,1,0,0,GK,20-24,Goalkeeper,Senegal,Africa
2474,Niclas Thiede,GER,Freiburg,Bundesliga,2019,20.0,1999.0,0.8,0,0,0,0,0,0,0,,0,0,0,0,0,0,1,0,GK,20-24,Goalkeeper,Germany,Europe
2475,Jan Thielmann,GER,Köln,Bundesliga,2019,17.0,2002.0,6.2,9,6,2,6,1,5,12,41.7,7,8,0,8,8,17,6,0,"FW,MF",Under 20,Forward,Germany,Europe
2476,Sada Thioub,SEN,Angers,Ligue 1,2019,24.0,1995.0,16.8,20,12,8,9,3,5,18,27.8,13,9,1,8,4,24,5,0,"MF,FW",20-24,Midfielder,Senegal,Africa
2479,Romain Thomas,FRA,Angers,Ligue 1,2019,31.0,1988.0,26.0,24,17,16,7,1,8,18,44.4,10,35,18,17,39,63,118,1,DF,30-34,Defender,France,Europe
2480,Adrien Thomasson,FRA,Strasbourg,Ligue 1,2019,25.0,1993.0,23.0,36,21,11,16,9,15,47,31.9,32,21,1,20,9,45,9,0,"MF,FW",25-29,Midfielder,France,Europe
2481,Erik Thommy,GER,Düsseldorf,Bundesliga,2019,24.0,1994.0,25.1,40,23,16,16,8,15,39,38.5,24,23,2,21,16,56,20,1,"MF,FW",20-24,Midfielder,Germany,Europe
2484,Khéphren Thuram,FRA,Nice,Ligue 1,2019,18.0,2001.0,6.6,22,7,14,8,0,6,17,35.3,11,12,2,10,7,29,13,0,MF,Under 20,Midfielder,France,Europe
2485,Marcus Thuram,FRA,Gladbach,Bundesliga,2019,21.0,1997.0,24.5,26,18,7,8,11,11,29,37.9,18,20,1,19,12,38,18,0,FW,20-24,Forward,France,Europe
2486,Youri Tielemans,BEL,Leicester City,Premier League,2019,22.0,1997.0,31.4,52,29,17,30,5,24,74,32.4,50,43,4,39,22,74,18,0,MF,20-24,Midfielder,Belgium,Europe
2487,Kieran Tierney,SCO,Arsenal,Premier League,2019,22.0,1997.0,11.0,20,16,13,6,1,11,15,73.3,4,10,4,6,9,29,37,1,"DF,MF",20-24,Defender,Scotland,Europe
2488,Cheick Timite,CIV,Amiens,Ligue 1,2019,21.0,1997.0,1.3,1,0,0,1,0,0,1,0.0,1,0,0,0,2,3,1,0,"MF,FW",20-24,Midfielder,Ivory Coast,Africa
2491,Jean-Clair Todibo,FRA,Barcelona,La Liga,2019,19.0,1999.0,0.9,1,0,1,0,0,0,1,0.0,1,0,0,0,0,1,6,0,DF,Under 20,Defender,France,Europe
2492,Jean-Clair Todibo,FRA,Schalke 04,Bundesliga,2019,19.0,1999.0,4.1,15,10,10,5,0,8,9,88.9,1,2,0,2,15,30,24,0,DF,Under 20,Defender,France,Europe
2493,Karl Toko Ekambi,CMR,Villarreal,La Liga,2019,26.0,1992.0,11.0,5,3,0,3,2,1,4,25.0,3,2,0,2,3,8,2,0,FW,25-29,Forward,Cameroon,Africa
2494,Karl Toko Ekambi,CMR,Lyon,Ligue 1,2019,26.0,1992.0,6.0,5,2,0,1,4,3,5,60.0,2,2,0,2,5,10,1,0,"FW,MF",25-29,Forward,Cameroon,Africa
2495,Corentin Tolisso,FRA,Bayern Munich,Bundesliga,2019,24.0,1994.0,7.1,9,4,4,3,2,1,9,11.1,8,9,3,6,4,13,2,1,MF,20-24,Midfielder,France,Europe
2496,Jeremy Toljan,GER,Sassuolo,Serie A,2019,24.0,1994.0,24.3,37,21,24,10,3,18,35,51.4,17,23,12,11,18,55,58,1,DF,20-24,Defender,Germany,Europe
2497,Rafael Tolói,ITA,Atalanta,Serie A,2019,28.0,1990.0,29.0,56,29,28,23,5,33,76,43.4,43,31,17,14,45,101,80,0,DF,25-29,Defender,Italy,Europe
2499,Takehiro Tomiyasu,JPN,Bologna,Serie A,2019,20.0,1998.0,28.1,42,24,25,13,4,22,41,53.7,19,34,9,25,49,91,78,1,DF,20-24,Defender,Japan,Asia
2500,James Tomkins,ENG,Crystal Palace,Premier League,2019,30.0,1989.0,17.6,29,17,21,8,0,18,25,72.0,7,17,15,2,21,50,103,0,DF,30-34,Defender,England,Europe
2501,Fikayo Tomori,ENG,Chelsea,Premier League,2019,21.0,1997.0,14.3,29,16,21,8,0,10,15,66.7,5,13,7,6,22,51,48,2,DF,20-24,Defender,England,Europe
2503,Sandro Tonali,ITA,Brescia,Serie A,2019,19.0,2000.0,33.5,39,25,16,20,3,16,55,29.1,39,36,14,22,41,80,42,0,MF,Under 20,Midfielder,Italy,Europe
2504,Lorenzo Tonelli,ITA,Sampdoria,Serie A,2019,29.0,1990.0,7.8,13,9,13,0,0,4,10,40.0,6,10,7,3,4,17,23,0,DF,25-29,Defender,Italy,Europe
2507,Ernesto Torregrossa,VEN,Brescia,Serie A,2019,27.0,1992.0,20.5,17,7,5,10,2,6,22,27.3,16,10,2,8,5,22,22,0,FW,25-29,Forward,Venezuela,South America
2517,Abdoulaye Touré,GUI,Nantes,Ligue 1,2019,25.0,1994.0,24.7,32,21,10,21,1,10,30,33.3,20,31,11,20,29,61,18,1,MF,25-29,Midfielder,Guinea,Africa
2517,Abdoulaye Touré,GUI,Nantes,Ligue 1,2019,25.0,1994.0,24.7,32,21,10,21,1,10,30,33.3,20,31,11,20,29,61,18,1,MF,25-29,Midfielder,Guinea,Africa
2517,Abdoulaye Touré,GUI,Nantes,Ligue 1,2019,25.0,1994.0,24.7,32,21,10,21,1,10,30,33.3,20,31,11,20,29,61,18,1,MF,25-29,Midfielder,Guinea,Africa
2517,Abdoulaye Touré,GUI,Nantes,Ligue 1,2019,25.0,1994.0,24.7,32,21,10,21,1,10,30,33.3,20,31,11,20,29,61,18,1,MF,25-29,Midfielder,Guinea,Africa
2518,Almamy Touré,MLI,Eint Frankfurt,Bundesliga,2019,23.0,1996.0,16.6,32,19,18,11,3,11,22,50.0,11,18,7,11,23,55,54,1,DF,20-24,Defender,Mali,Africa
2519,Lucas Tousart,FRA,Lyon,Ligue 1,2019,22.0,1997.0,19.6,58,32,19,34,5,17,56,30.4,39,19,7,12,31,89,27,1,MF,20-24,Midfielder,France,Europe
2523,Adama Traoré,MLI,Metz,Ligue 1,2019,24.0,1995.0,11.2,3,1,1,2,0,3,12,25.0,9,7,2,5,3,6,5,0,"FW,MF",20-24,Forward,Mali,Africa
2523,Adama Traoré,MLI,Metz,Ligue 1,2019,24.0,1995.0,11.2,3,1,1,2,0,3,12,25.0,9,7,2,5,3,6,5,0,"FW,MF",20-24,Forward,Mali,Africa
2523,Adama Traoré,MLI,Metz,Ligue 1,2019,24.0,1995.0,11.2,3,1,1,2,0,3,12,25.0,9,7,2,5,3,6,5,0,"FW,MF",20-24,Forward,Mali,Africa
2523,Adama Traoré,MLI,Metz,Ligue 1,2019,24.0,1995.0,11.2,3,1,1,2,0,3,12,25.0,9,7,2,5,3,6,5,0,"FW,MF",20-24,Forward,Mali,Africa
2523,Adama Traoré,MLI,Metz,Ligue 1,2019,24.0,1995.0,11.2,3,1,1,2,0,3,12,25.0,9,7,2,5,3,6,5,0,"FW,MF",20-24,Forward,Mali,Africa
2523,Adama Traoré,MLI,Metz,Ligue 1,2019,24.0,1995.0,11.2,3,1,1,2,0,3,12,25.0,9,7,2,5,3,6,5,0,"FW,MF",20-24,Forward,Mali,Africa
2523,Adama Traoré,MLI,Metz,Ligue 1,2019,24.0,1995.0,11.2,3,1,1,2,0,3,12,25.0,9,7,2,5,3,6,5,0,"FW,MF",20-24,Forward,Mali,Africa
2523,Adama Traoré,MLI,Metz,Ligue 1,2019,24.0,1995.0,11.2,3,1,1,2,0,3,12,25.0,9,7,2,5,3,6,5,0,"FW,MF",20-24,Forward,Mali,Africa
2523,Adama Traoré,MLI,Metz,Ligue 1,2019,24.0,1995.0,11.2,3,1,1,2,0,3,12,25.0,9,7,2,5,3,6,5,0,"FW,MF",20-24,Forward,Mali,Africa
2523,Adama Traoré,MLI,Metz,Ligue 1,2019,24.0,1995.0,11.2,3,1,1,2,0,3,12,25.0,9,7,2,5,3,6,5,0,"FW,MF",20-24,Forward,Mali,Africa
2523,Adama Traoré,MLI,Metz,Ligue 1,2019,24.0,1995.0,11.2,3,1,1,2,0,3,12,25.0,9,7,2,5,3,6,5,0,"FW,MF",20-24,Forward,Mali,Africa
2523,Adama Traoré,MLI,Metz,Ligue 1,2019,24.0,1995.0,11.2,3,1,1,2,0,3,12,25.0,9,7,2,5,3,6,5,0,"FW,MF",20-24,Forward,Mali,Africa
2523,Adama Traoré,MLI,Metz,Ligue 1,2019,24.0,1995.0,11.2,3,1,1,2,0,3,12,25.0,9,7,2,5,3,6,5,0,"FW,MF",20-24,Forward,Mali,Africa
2523,Adama Traoré,MLI,Metz,Ligue 1,2019,24.0,1995.0,11.2,3,1,1,2,0,3,12,25.0,9,7,2,5,3,6,5,0,"FW,MF",20-24,Forward,Mali,Africa
2523,Adama Traoré,MLI,Metz,Ligue 1,2019,24.0,1995.0,11.2,3,1,1,2,0,3,12,25.0,9,7,2,5,3,6,5,0,"FW,MF",20-24,Forward,Mali,Africa
2523,Adama Traoré,MLI,Metz,Ligue 1,2019,24.0,1995.0,11.2,3,1,1,2,0,3,12,25.0,9,7,2,5,3,6,5,0,"FW,MF",20-24,Forward,Mali,Africa
2524,Adama Traoré,MLI,Monaco,Ligue 1,2019,24.0,1995.0,0.3,0,0,0,0,0,0,0,,0,0,0,0,1,1,0,0,MF,20-24,Midfielder,Mali,Africa
2524,Adama Traoré,MLI,Monaco,Ligue 1,2019,24.0,1995.0,0.3,0,0,0,0,0,0,0,,0,0,0,0,1,1,0,0,MF,20-24,Midfielder,Mali,Africa
2524,Adama Traoré,MLI,Monaco,Ligue 1,2019,24.0,1995.0,0.3,0,0,0,0,0,0,0,,0,0,0,0,1,1,0,0,MF,20-24,Midfielder,Mali,Africa
2524,Adama Traoré,MLI,Monaco,Ligue 1,2019,24.0,1995.0,0.3,0,0,0,0,0,0,0,,0,0,0,0,1,1,0,0,MF,20-24,Midfielder,Mali,Africa
2524,Adama Traoré,MLI,Monaco,Ligue 1,2019,24.0,1995.0,0.3,0,0,0,0,0,0,0,,0,0,0,0,1,1,0,0,MF,20-24,Midfielder,Mali,Africa
2524,Adama Traoré,MLI,Monaco,Ligue 1,2019,24.0,1995.0,0.3,0,0,0,0,0,0,0,,0,0,0,0,1,1,0,0,MF,20-24,Midfielder,Mali,Africa
2524,Adama Traoré,MLI,Monaco,Ligue 1,2019,24.0,1995.0,0.3,0,0,0,0,0,0,0,,0,0,0,0,1,1,0,0,MF,20-24,Midfielder,Mali,Africa
2524,Adama Traoré,MLI,Monaco,Ligue 1,2019,24.0,1995.0,0.3,0,0,0,0,0,0,0,,0,0,0,0,1,1,0,0,MF,20-24,Midfielder,Mali,Africa
2524,Adama Traoré,MLI,Monaco,Ligue 1,2019,24.0,1995.0,0.3,0,0,0,0,0,0,0,,0,0,0,0,1,1,0,0,MF,20-24,Midfielder,Mali,Africa
2524,Adama Traoré,MLI,Monaco,Ligue 1,2019,24.0,1995.0,0.3,0,0,0,0,0,0,0,,0,0,0,0,1,1,0,0,MF,20-24,Midfielder,Mali,Africa
2524,Adama Traoré,MLI,Monaco,Ligue 1,2019,24.0,1995.0,0.3,0,0,0,0,0,0,0,,0,0,0,0,1,1,0,0,MF,20-24,Midfielder,Mali,Africa
2524,Adama Traoré,MLI,Monaco,Ligue 1,2019,24.0,1995.0,0.3,0,0,0,0,0,0,0,,0,0,0,0,1,1,0,0,MF,20-24,Midfielder,Mali,Africa
2524,Adama Traoré,MLI,Monaco,Ligue 1,2019,24.0,1995.0,0.3,0,0,0,0,0,0,0,,0,0,0,0,1,1,0,0,MF,20-24,Midfielder,Mali,Africa
2524,Adama Traoré,MLI,Monaco,Ligue 1,2019,24.0,1995.0,0.3,0,0,0,0,0,0,0,,0,0,0,0,1,1,0,0,MF,20-24,Midfielder,Mali,Africa
2524,Adama Traoré,MLI,Monaco,Ligue 1,2019,24.0,1995.0,0.3,0,0,0,0,0,0,0,,0,0,0,0,1,1,0,0,MF,20-24,Midfielder,Mali,Africa
2524,Adama Traoré,MLI,Monaco,Ligue 1,2019,24.0,1995.0,0.3,0,0,0,0,0,0,0,,0,0,0,0,1,1,0,0,MF,20-24,Midfielder,Mali,Africa
2527,Hamari Traoré,MLI,Rennes,Ligue 1,2019,27.0,1992.0,26.8,55,26,34,18,3,32,64,50.0,32,22,5,17,48,103,59,1,DF,25-29,Defender,Mali,Africa
2528,Ibrahima Traoré,GUI,Gladbach,Bundesliga,2019,31.0,1988.0,1.7,4,3,1,1,2,1,7,14.3,6,1,0,1,1,5,3,0,"FW,MF",30-34,Forward,Guinea,Africa
2529,Ismaël Traoré,CIV,Angers,Ligue 1,2019,32.0,1986.0,22.8,23,12,14,7,2,10,17,58.8,7,23,13,10,27,50,85,1,DF,30-34,Defender,Ivory Coast,Africa
2530,Kevin Trapp,GER,Eint Frankfurt,Bundesliga,2019,29.0,1990.0,22.0,0,0,0,0,0,0,1,0.0,1,0,0,0,3,3,5,0,GK,25-29,Goalkeeper,Germany,Europe
2531,Miguel Trauco,PER,Saint-Étienne,Ligue 1,2019,26.0,1992.0,16.4,32,20,16,12,4,19,44,43.2,25,8,1,7,23,55,25,0,DF,25-29,Defender,Peru,South America
2532,Mark Travers,IRL,Bournemouth,Premier League,2019,20.0,1999.0,1.0,0,0,0,0,0,0,0,,0,0,0,0,0,0,1,1,GK,20-24,Goalkeeper,Republic of Ireland,Europe
2533,Luca Tremolada,ITA,Brescia,Serie A,2019,27.0,1991.0,0.2,0,0,0,0,0,0,0,,0,0,0,0,0,0,0,0,MF,25-29,Midfielder,Italy,Europe
2536,Christopher Trimmel,AUT,Union Berlin,Bundesliga,2019,32.0,1987.0,31.8,71,41,35,32,4,32,54,59.3,22,31,10,21,51,122,88,1,"DF,MF",30-34,Defender,Austria,Europe
2537,Alessandro Tripaldelli,ITA,Sassuolo,Serie A,2019,20.0,1999.0,1.5,4,4,1,3,0,1,3,33.3,2,1,0,1,3,7,3,0,DF,20-24,Defender,Italy,Europe
2538,Kieran Trippier,ENG,Atlético Madrid,La Liga,2019,28.0,1990.0,22.0,52,34,24,21,7,34,53,64.2,19,33,7,26,24,76,46,0,DF,25-29,Defender,England,Europe
2540,Leandro Trossard,BEL,Brighton,Premier League,2019,24.0,1994.0,22.3,22,17,7,12,3,6,38,15.8,32,16,1,15,9,31,8,0,"FW,MF",20-24,Forward,Belgium,Europe
2542,Axel Tuanzebe,COD,Manchester Utd,Premier League,2019,21.0,1997.0,2.1,2,2,0,2,0,1,2,50.0,1,1,0,1,5,7,5,1,DF,20-24,Defender,DR Congo,Africa
2545,Gennaro Tutino,ITA,Hellas Verona,Serie A,2019,22.0,1996.0,2.5,0,0,0,0,0,0,0,,0,0,0,0,2,2,1,0,"FW,MF",20-24,Forward,Italy,Europe
2546,Matthieu Udol,FRA,Metz,Ligue 1,2019,23.0,1996.0,12.2,29,19,19,8,2,13,24,54.2,11,21,4,17,23,52,43,0,DF,20-24,Defender,France,Europe
2548,Anthony Ujah,NGA,Union Berlin,Bundesliga,2019,28.0,1990.0,10.5,8,6,4,2,2,1,6,16.7,5,0,0,0,3,11,10,0,"FW,MF",25-29,Forward,Nigeria,Africa
2550,Sven Ulreich,GER,Bayern Munich,Bundesliga,2019,30.0,1988.0,1.0,0,0,0,0,0,0,0,,0,0,0,0,0,0,0,0,GK,30-34,Goalkeeper,Germany,Europe
2551,Samuel Umtiti,FRA,Barcelona,La Liga,2019,25.0,1993.0,10.5,11,5,5,5,1,5,8,62.5,3,4,2,2,22,33,32,0,DF,25-29,Defender,France,Europe
2552,Enes Ünal,TUR,Valladolid,La Liga,2019,22.0,1997.0,26.0,20,12,6,11,3,6,28,21.4,22,17,5,12,6,26,13,0,FW,20-24,Forward,Turkey,Asia
2554,Dayot Upamecano,FRA,RB Leipzig,Bundesliga,2019,20.0,1998.0,26.2,52,31,37,15,0,23,43,53.5,20,31,17,14,43,95,88,1,DF,20-24,Defender,France,Europe
2555,Mark Uth,GER,Köln,Bundesliga,2019,27.0,1991.0,12.9,19,12,4,10,5,9,32,28.1,23,15,0,15,7,26,3,0,"MF,FW",25-29,Midfielder,Germany,Europe
2556,Mark Uth,GER,Schalke 04,Bundesliga,2019,27.0,1991.0,3.9,3,2,1,1,1,0,3,0.0,3,4,0,4,1,4,0,0,"FW,MF",25-29,Forward,Germany,Europe
2559,William Vainqueur,FRA,Toulouse,Ligue 1,2019,30.0,1988.0,19.1,68,36,30,32,6,22,60,36.7,38,21,5,16,29,97,23,0,MF,30-34,Midfielder,France,Europe
2560,Mirko Valdifiori,ITA,SPAL,Serie A,2019,33.0,1986.0,15.6,31,15,14,17,0,16,33,48.5,17,8,3,5,4,35,25,0,MF,30-34,Midfielder,Italy,Europe
2561,Pierrick Valdivia,FRA,Nîmes,Ligue 1,2019,31.0,1988.0,0.8,1,1,0,0,1,0,1,0.0,1,0,0,0,0,1,0,0,MF,30-34,Midfielder,France,Europe
2565,Yan Valery,TUN,Southampton,Premier League,2019,20.0,1999.0,8.7,20,7,9,7,4,11,19,57.9,8,9,1,8,13,33,32,2,DF,20-24,Defender,Tunisia,Africa
2566,Martin Valjent,SVK,Mallorca,La Liga,2019,23.0,1995.0,35.4,25,17,14,10,1,13,25,52.0,12,39,27,12,37,62,146,1,DF,20-24,Defender,Slovakia,Europe
2572,Mattia Valoti,ITA,SPAL,Serie A,2019,25.0,1993.0,17.0,48,30,21,25,2,16,43,37.2,27,27,6,21,16,64,18,0,"MF,FW",25-29,Midfielder,Italy,Europe
2573,Federico Valverde,URU,Real Madrid,La Liga,2019,21.0,1998.0,21.2,38,19,9,19,10,12,36,33.3,24,38,4,34,21,59,12,2,MF,20-24,Midfielder,Uruguay,South America
2574,Virgil van Dijk,NED,Liverpool,Premier League,2019,28.0,1991.0,38.0,23,12,18,5,0,6,13,46.2,7,20,15,5,40,63,166,2,DF,25-29,Defender,Netherlands,Europe
2575,Raphaël Varane,FRA,Real Madrid,La Liga,2019,26.0,1993.0,31.4,30,17,15,14,1,12,23,52.2,11,32,16,16,31,61,124,0,DF,25-29,Defender,France,Europe
2576,Jamie Vardy,ENG,Leicester City,Premier League,2019,32.0,1987.0,33.7,15,12,0,9,6,2,4,50.0,2,22,4,18,2,17,22,0,FW,30-34,Forward,England,Europe
2580,Sebastian Vasiliadis,GRE,Paderborn 07,Bundesliga,2019,21.0,1997.0,31.2,73,45,34,31,8,28,81,34.6,53,47,6,41,34,107,50,0,MF,20-24,Midfielder,Greece,Europe
2582,Denis Vavro,SVK,Lazio,Serie A,2019,23.0,1996.0,3.6,3,3,2,1,0,1,3,33.3,2,8,6,2,5,8,10,0,DF,20-24,Defender,Slovakia,Europe
2583,Franco Vázquez,ARG,Sevilla,La Liga,2019,30.0,1989.0,12.2,25,17,9,14,2,6,36,16.7,30,13,0,13,10,35,10,0,"MF,FW",30-34,Midfielder,Argentina,South America
2586,Matías Vecino,URU,Inter,Serie A,2019,27.0,1991.0,14.2,31,20,14,11,6,9,36,25.0,27,20,3,17,15,46,26,0,MF,25-29,Midfielder,Uruguay,South America
2589,Miguel Veloso,POR,Hellas Verona,Serie A,2019,33.0,1986.0,31.2,52,29,20,28,4,18,60,30.0,42,36,12,24,32,84,46,1,MF,30-34,Midfielder,Portugal,Europe
2591,Lorenzo Venuti,ITA,Fiorentina,Serie A,2019,24.0,1995.0,9.5,20,10,12,6,2,13,19,68.4,6,5,1,4,11,31,15,0,"DF,MF",20-24,Defender,Italy,Europe
2592,Brayan Vera,COL,Lecce,Serie A,2019,20.0,1999.0,1.7,4,1,2,1,1,3,7,42.9,4,1,0,1,1,5,4,0,"DF,FW",20-24,Defender,Colombia,South America
2593,Simone Verdi,ITA,Torino,Serie A,2019,27.0,1992.0,23.0,19,10,4,12,3,9,38,23.7,29,14,0,14,7,26,1,0,"MF,FW",25-29,Midfielder,Italy,Europe
2594,Jordan Veretout,FRA,Roma,Serie A,2019,26.0,1993.0,29.2,36,18,13,16,7,14,43,32.6,29,35,5,30,18,54,31,1,MF,25-29,Midfielder,France,Europe
2595,Marco Verratti,ITA,Paris S-G,Ligue 1,2019,26.0,1992.0,16.5,54,32,22,22,10,20,56,35.7,36,23,3,20,19,73,9,0,MF,25-29,Midfielder,Italy,Europe
2596,Valerio Verre,ITA,Hellas Verona,Serie A,2019,25.0,1994.0,19.7,25,15,4,11,10,9,23,39.1,14,5,0,5,13,38,9,0,"MF,FW",25-29,Midfielder,Italy,Europe
2600,Jannik Vestergaard,DEN,Southampton,Premier League,2019,26.0,1992.0,16.6,19,12,14,5,0,11,28,39.3,17,15,9,6,26,45,99,2,DF,25-29,Defender,Denmark,Europe
2602,Francesco Vicari,ITA,SPAL,Serie A,2019,24.0,1994.0,32.2,27,13,20,6,1,12,25,48.0,13,48,37,11,38,65,145,1,DF,20-24,Defender,Italy,Europe
2605,Arturo Vidal,CHI,Barcelona,La Liga,2019,32.0,1987.0,18.6,63,38,22,30,11,24,58,41.4,34,31,7,24,17,80,16,1,MF,30-34,Midfielder,Chile,South America
2606,Clément Vidal,FRA,Montpellier,Ligue 1,2019,19.0,2000.0,1.0,0,0,0,0,0,0,2,0.0,2,1,1,0,0,0,6,0,DF,Under 20,Defender,France,Europe
2608,Ronaldo Vieira,ENG,Sampdoria,Serie A,2019,21.0,1998.0,20.2,33,19,13,17,3,6,28,21.4,22,14,2,12,21,54,31,0,MF,20-24,Midfielder,England,Europe
2609,Mauro Vigorito,ITA,Lecce,Serie A,2019,29.0,1990.0,4.7,0,0,0,0,0,0,0,,0,0,0,0,0,0,3,1,GK,25-29,Goalkeeper,Italy,Europe
2616,Rúben Vinagre,POR,Wolves,Premier League,2019,20.0,1999.0,7.2,23,13,15,6,2,12,15,80.0,3,7,2,5,11,34,22,0,"MF,DF",20-24,Midfielder,Portugal,Europe
2617,Luigi Vitale,ITA,Hellas Verona,Serie A,2019,31.0,1987.0,0.5,1,0,0,1,0,0,0,,0,1,0,1,0,1,0,0,DF,30-34,Defender,Italy,Europe
2619,Mattia Viviani,ITA,Brescia,Serie A,2019,18.0,2000.0,3.8,3,1,0,3,0,1,8,12.5,7,3,3,0,9,12,2,1,MF,Under 20,Midfielder,Italy,Europe
2621,Kevin Vogt,GER,Hoffenheim,Bundesliga,2019,27.0,1991.0,10.7,7,5,4,3,0,3,9,33.3,6,12,6,6,8,15,52,1,DF,25-29,Defender,Germany,Europe
2622,Kevin Vogt,GER,Werder Bremen,Bundesliga,2019,27.0,1991.0,12.3,14,10,8,6,0,8,16,50.0,8,15,12,3,25,39,37,1,"DF,MF",25-29,Defender,Germany,Europe
2624,Kevin Volland,GER,Leverkusen,Bundesliga,2019,27.0,1992.0,22.7,16,6,5,6,5,5,16,31.3,11,14,2,12,5,21,7,0,FW,25-29,Forward,Germany,Europe
2626,Stefan de Vrij,NED,Inter,Serie A,2019,27.0,1992.0,31.4,33,18,20,12,1,14,27,51.9,13,34,24,10,52,85,121,1,DF,25-29,Defender,Netherlands,Europe
2627,Giacomo Vrioni,ALB,Juventus,Serie A,2019,20.0,1998.0,0.1,0,0,0,0,0,0,0,,0,0,0,0,0,0,0,0,FW,20-24,Forward,Albania,Europe
2635,Walace,BRA,Udinese,Serie A,2019,24.0,1995.0,12.7,28,9,19,6,3,13,42,31.0,29,14,6,8,33,61,19,0,MF,20-24,Midfielder,Brazil,South America
2636,Theo Walcott,ENG,Everton,Premier League,2019,30.0,1989.0,14.3,13,8,6,5,2,3,15,20.0,12,13,0,13,8,21,1,0,"MF,FW",30-34,Midfielder,England,Europe
2637,Luca Waldschmidt,GER,Freiburg,Bundesliga,2019,23.0,1996.0,14.1,10,7,3,5,2,2,18,11.1,16,11,2,9,4,14,4,0,"FW,MF",20-24,Forward,Germany,Europe
2638,Kyle Walker,ENG,Manchester City,Premier League,2019,29.0,1990.0,26.6,28,18,12,15,1,12,29,41.4,17,15,6,9,28,56,42,1,DF,25-29,Defender,England,Europe
2639,Kyle Walker-Peters,ENG,Southampton,Premier League,2019,22.0,1997.0,7.8,13,8,5,6,2,6,16,37.5,10,10,3,7,14,27,21,1,DF,20-24,Defender,England,Europe
2640,Kyle Walker-Peters,ENG,Tottenham,Premier League,2019,22.0,1997.0,2.7,8,5,8,0,0,5,9,55.6,4,4,2,2,3,11,5,1,DF,20-24,Defender,England,Europe
2643,Aaron Wan-Bissaka,ENG,Manchester Utd,Premier League,2019,21.0,1997.0,34.1,129,80,71,50,8,64,86,74.4,22,46,13,33,66,195,83,0,DF,20-24,Defender,England,Europe
2644,Victor Wanyama,KEN,Tottenham,Premier League,2019,28.0,1991.0,0.3,0,0,0,0,0,0,0,,0,0,0,0,0,0,0,0,MF,25-29,Midfielder,Kenya,Africa
2645,Joel Ward,ENG,Crystal Palace,Premier League,2019,29.0,1989.0,26.5,69,42,48,16,5,39,56,69.6,17,13,6,7,48,117,93,1,DF,25-29,Defender,England,Europe
2646,James Ward-Prowse,ENG,Southampton,Premier League,2019,24.0,1994.0,38.0,92,48,39,39,14,39,94,41.5,55,48,14,34,60,152,75,1,"MF,DF",20-24,Midfielder,England,Europe
2649,Timothy Weah,USA,Lille,Ligue 1,2019,19.0,2000.0,0.9,0,0,0,0,0,0,1,0.0,1,0,0,0,0,0,1,0,"MF,FW",Under 20,Midfielder,United States,North America
2650,Adam Webster,ENG,Brighton,Premier League,2019,24.0,1995.0,29.6,30,17,21,8,1,14,32,43.8,18,43,26,17,45,75,110,2,DF,20-24,Defender,England,Europe
2652,Julian Weigl,GER,Dortmund,Bundesliga,2019,23.0,1995.0,11.3,16,9,12,3,1,9,16,56.3,7,10,0,10,8,24,21,0,"MF,DF",20-24,Midfielder,Germany,Europe
2653,Mitchell Weiser,GER,Leverkusen,Bundesliga,2019,25.0,1994.0,13.0,41,29,20,17,4,18,30,60.0,12,19,2,17,24,65,22,1,"DF,MF",25-29,Defender,Germany,Europe
2654,Danny Welbeck,ENG,Watford,Premier League,2019,28.0,1990.0,9.1,14,6,6,5,3,3,11,27.3,8,12,1,11,5,19,7,0,"FW,MF",25-29,Forward,England,Europe
2656,Oscar Wendt,SWE,Gladbach,Bundesliga,2019,33.0,1985.0,18.7,26,14,16,8,2,12,31,38.7,19,27,6,21,20,46,45,0,DF,30-34,Defender,Sweden,Europe
2657,Timo Werner,GER,RB Leipzig,Bundesliga,2019,23.0,1996.0,31.1,20,9,6,7,7,3,16,18.8,13,16,0,16,5,25,2,0,FW,20-24,Forward,Germany,Europe
2658,Ashley Westwood,ENG,Burnley,Premier League,2019,29.0,1990.0,35.0,54,33,15,32,7,17,48,35.4,31,23,11,12,32,86,32,3,MF,25-29,Midfielder,England,Europe
2659,Connor Wickham,ENG,Crystal Palace,Premier League,2019,26.0,1993.0,1.1,1,1,1,0,0,0,0,,0,1,0,1,1,2,0,0,"FW,MF",25-29,Forward,England,Europe
2661,Georginio Wijnaldum,NED,Liverpool,Premier League,2019,28.0,1990.0,32.6,38,20,12,21,5,10,40,25.0,30,18,4,14,17,55,34,3,MF,25-29,Midfielder,Netherlands,Europe
2663,William,BRA,Wolfsburg,Bundesliga,2019,24.0,1995.0,15.2,55,26,34,14,7,27,59,45.8,32,10,3,7,24,79,38,1,DF,20-24,Defender,Brazil,South America
2663,William,BRA,Wolfsburg,Bundesliga,2019,24.0,1995.0,15.2,55,26,34,14,7,27,59,45.8,32,10,3,7,24,79,38,1,DF,20-24,Defender,Brazil,South America
2663,William,BRA,Wolfsburg,Bundesliga,2019,24.0,1995.0,15.2,55,26,34,14,7,27,59,45.8,32,10,3,7,24,79,38,1,DF,20-24,Defender,Brazil,South America
2663,William,BRA,Wolfsburg,Bundesliga,2019,24.0,1995.0,15.2,55,26,34,14,7,27,59,45.8,32,10,3,7,24,79,38,1,DF,20-24,Defender,Brazil,South America
2663,William,BRA,Wolfsburg,Bundesliga,2019,24.0,1995.0,15.2,55,26,34,14,7,27,59,45.8,32,10,3,7,24,79,38,1,DF,20-24,Defender,Brazil,South America
2663,William,BRA,Wolfsburg,Bundesliga,2019,24.0,1995.0,15.2,55,26,34,14,7,27,59,45.8,32,10,3,7,24,79,38,1,DF,20-24,Defender,Brazil,South America
2663,William,BRA,Wolfsburg,Bundesliga,2019,24.0,1995.0,15.2,55,26,34,14,7,27,59,45.8,32,10,3,7,24,79,38,1,DF,20-24,Defender,Brazil,South America
2663,William,BRA,Wolfsburg,Bundesliga,2019,24.0,1995.0,15.2,55,26,34,14,7,27,59,45.8,32,10,3,7,24,79,38,1,DF,20-24,Defender,Brazil,South America
2663,William,BRA,Wolfsburg,Bundesliga,2019,24.0,1995.0,15.2,55,26,34,14,7,27,59,45.8,32,10,3,7,24,79,38,1,DF,20-24,Defender,Brazil,South America
2663,William,BRA,Wolfsburg,Bundesliga,2019,24.0,1995.0,15.2,55,26,34,14,7,27,59,45.8,32,10,3,7,24,79,38,1,DF,20-24,Defender,Brazil,South America
2663,William,BRA,Wolfsburg,Bundesliga,2019,24.0,1995.0,15.2,55,26,34,14,7,27,59,45.8,32,10,3,7,24,79,38,1,DF,20-24,Defender,Brazil,South America
2663,William,BRA,Wolfsburg,Bundesliga,2019,24.0,1995.0,15.2,55,26,34,14,7,27,59,45.8,32,10,3,7,24,79,38,1,DF,20-24,Defender,Brazil,South America
2663,William,BRA,Wolfsburg,Bundesliga,2019,24.0,1995.0,15.2,55,26,34,14,7,27,59,45.8,32,10,3,7,24,79,38,1,DF,20-24,Defender,Brazil,South America
2663,William,BRA,Wolfsburg,Bundesliga,2019,24.0,1995.0,15.2,55,26,34,14,7,27,59,45.8,32,10,3,7,24,79,38,1,DF,20-24,Defender,Brazil,South America
2663,William,BRA,Wolfsburg,Bundesliga,2019,24.0,1995.0,15.2,55,26,34,14,7,27,59,45.8,32,10,3,7,24,79,38,1,DF,20-24,Defender,Brazil,South America
2663,William,BRA,Wolfsburg,Bundesliga,2019,24.0,1995.0,15.2,55,26,34,14,7,27,59,45.8,32,10,3,7,24,79,38,1,DF,20-24,Defender,Brazil,South America
2664,Brandon Williams,ENG,Manchester Utd,Premier League,2019,18.0,2000.0,11.2,21,15,11,6,4,9,29,31.0,20,9,4,5,16,37,27,0,DF,Under 20,Defender,England,Europe
2665,Iñaki Williams,GHA,Athletic Club,La Liga,2019,25.0,1994.0,32.7,15,5,0,7,8,5,18,27.8,13,18,2,16,5,20,29,0,FW,25-29,Forward,Ghana,Africa
2667,Willian,BRA,Chelsea,Premier League,2019,30.0,1988.0,28.9,45,27,14,24,7,14,43,32.6,29,15,0,15,20,65,7,0,"FW,MF",30-34,Forward,Brazil,South America
2667,Willian,BRA,Chelsea,Premier League,2019,30.0,1988.0,28.9,45,27,14,24,7,14,43,32.6,29,15,0,15,20,65,7,0,"FW,MF",30-34,Forward,Brazil,South America
2667,Willian,BRA,Chelsea,Premier League,2019,30.0,1988.0,28.9,45,27,14,24,7,14,43,32.6,29,15,0,15,20,65,7,0,"FW,MF",30-34,Forward,Brazil,South America
2667,Willian,BRA,Chelsea,Premier League,2019,30.0,1988.0,28.9,45,27,14,24,7,14,43,32.6,29,15,0,15,20,65,7,0,"FW,MF",30-34,Forward,Brazil,South America
2668,Joe Willock,ENG,Arsenal,Premier League,2019,19.0,1999.0,9.5,25,16,9,12,4,8,21,38.1,13,16,2,14,4,29,11,2,"MF,FW",Under 20,Midfielder,England,Europe
2670,Callum Wilson,ENG,Bournemouth,Premier League,2019,27.0,1992.0,32.3,12,9,3,6,3,2,17,11.8,15,16,2,14,4,16,16,0,FW,25-29,Forward,England,Europe
2670,Callum Wilson,ENG,Bournemouth,Premier League,2019,27.0,1992.0,32.3,12,9,3,6,3,2,17,11.8,15,16,2,14,4,16,16,0,FW,25-29,Forward,England,Europe
2670,Callum Wilson,ENG,Bournemouth,Premier League,2019,27.0,1992.0,32.3,12,9,3,6,3,2,17,11.8,15,16,2,14,4,16,16,0,FW,25-29,Forward,England,Europe
2670,Callum Wilson,ENG,Bournemouth,Premier League,2019,27.0,1992.0,32.3,12,9,3,6,3,2,17,11.8,15,16,2,14,4,16,16,0,FW,25-29,Forward,England,Europe
2671,Harry Wilson,WAL,Bournemouth,Premier League,2019,22.0,1997.0,18.3,23,13,8,10,5,11,34,32.4,23,26,2,24,11,34,15,1,"MF,FW",20-24,Midfielder,Wales,Europe
2672,Harry Winks,ENG,Tottenham,Premier League,2019,23.0,1996.0,24.7,40,24,18,20,2,17,54,31.5,37,27,8,19,36,76,32,1,MF,20-24,Midfielder,England,Europe
2674,Axel Witsel,BEL,Dortmund,Bundesliga,2019,30.0,1989.0,24.9,28,20,10,17,1,14,33,42.4,19,26,7,19,31,59,19,1,MF,30-34,Midfielder,Belgium,Europe
2675,Hannes Wolf,AUT,RB Leipzig,Bundesliga,2019,20.0,1999.0,0.6,3,0,0,1,2,1,4,25.0,3,0,0,0,0,3,0,0,"FW,MF",20-24,Forward,Austria,Europe
2676,Marius Wolf,GER,Hertha BSC,Bundesliga,2019,24.0,1995.0,15.7,19,11,9,7,3,10,27,37.0,17,14,1,13,17,36,13,0,"FW,MF",20-24,Forward,Germany,Europe
2678,Chris Wood,NZL,Burnley,Premier League,2019,27.0,1991.0,27.1,7,4,2,4,1,5,15,33.3,10,15,2,13,4,11,18,0,FW,25-29,Forward,New Zealand,Oceania
2680,Granit Xhaka,SUI,Arsenal,Premier League,2019,26.0,1992.0,28.7,45,25,20,19,6,25,55,45.5,30,32,16,16,21,66,59,3,MF,25-29,Midfielder,Switzerland,Europe
2681,Jawad El Yamiq,MAR,Genoa,Serie A,2019,27.0,1992.0,2.2,3,2,3,0,0,1,4,25.0,3,3,2,1,1,4,3,0,DF,25-29,Defender,Morocco,Africa
2687,Maya Yoshida,JPN,Southampton,Premier League,2019,30.0,1988.0,6.2,8,5,4,1,3,3,7,42.9,4,6,2,4,4,12,27,1,DF,30-34,Defender,Japan,Asia
2688,Maya Yoshida,JPN,Sampdoria,Serie A,2019,30.0,1988.0,13.2,4,3,2,2,0,2,6,33.3,4,15,12,3,27,31,72,0,DF,30-34,Defender,Japan,Asia
2691,Ashley Young,ENG,Manchester Utd,Premier League,2019,34.0,1985.0,10.6,14,7,7,4,3,5,17,29.4,12,8,2,6,11,25,29,0,DF,30-34,Defender,England,Europe
2692,Ashley Young,ENG,Inter,Serie A,2019,34.0,1985.0,13.2,11,5,3,5,3,6,19,31.6,13,11,3,8,14,25,24,0,DF,30-34,Defender,England,Europe
2694,Pablo Zabaleta,ARG,West Ham,Premier League,2019,34.0,1985.0,6.6,18,10,12,5,1,6,13,46.2,7,5,3,2,14,32,21,0,DF,30-34,Defender,Argentina,South America
2695,Mattia Zaccagni,ITA,Hellas Verona,Serie A,2019,24.0,1995.0,23.5,20,11,10,5,5,3,15,20.0,12,14,3,11,20,40,21,0,"MF,FW",20-24,Midfielder,Italy,Europe
2696,Dan-Axel Zagadou,FRA,Dortmund,Bundesliga,2019,20.0,1999.0,10.9,16,10,12,4,0,6,8,75.0,2,12,8,4,15,31,38,0,DF,20-24,Defender,France,Europe
2699,Denis Zakaria,SUI,Gladbach,Bundesliga,2019,22.0,1996.0,21.6,49,30,23,23,3,20,39,51.3,19,39,12,27,37,86,31,1,"MF,DF",20-24,Midfielder,Switzerland,Europe
2702,Luca Zanimacchia,ITA,Juventus,Serie A,2019,21.0,1998.0,1.3,5,1,1,2,2,1,2,50.0,1,1,0,1,0,5,0,0,"FW,MF",20-24,Forward,Italy,Europe
2703,Nicolò Zaniolo,ITA,Roma,Serie A,2019,20.0,1999.0,16.7,15,11,4,7,4,3,24,12.5,21,14,0,14,5,20,5,0,"FW,MF",20-24,Forward,Italy,Europe
2704,Cristián Zapata,COL,Genoa,Serie A,2019,32.0,1986.0,19.1,23,17,16,7,0,8,16,50.0,8,29,17,12,24,47,75,0,DF,30-34,Defender,Colombia,South America
2705,Duván Zapata,COL,Atalanta,Serie A,2019,28.0,1991.0,22.5,7,3,1,2,4,1,6,16.7,5,18,7,11,2,9,11,0,FW,25-29,Forward,Colombia,South America
2706,Davide Zappacosta,ITA,Roma,Serie A,2019,27.0,1992.0,5.0,7,3,2,3,2,4,8,50.0,4,3,1,2,6,13,8,1,DF,25-29,Defender,Italy,Europe
2707,Simone Zaza,ITA,Torino,Serie A,2019,28.0,1991.0,18.2,15,10,6,4,5,3,10,30.0,7,11,0,11,9,24,13,1,FW,25-29,Forward,Italy,Europe
2708,Marvin Zeegelaar,NED,Udinese,Serie A,2019,28.0,1990.0,6.6,15,9,8,4,3,6,11,54.5,5,9,2,7,5,20,10,0,DF,25-29,Defender,Netherlands,Europe
2711,Robin Zentner,GER,Mainz 05,Bundesliga,2019,24.0,1994.0,21.5,1,1,1,0,0,1,1,100.0,0,0,0,0,0,1,11,0,GK,20-24,Goalkeeper,Germany,Europe
2713,Jean Zimmer,GER,Düsseldorf,Bundesliga,2019,25.0,1993.0,8.0,11,6,5,5,1,5,10,50.0,5,3,1,2,3,14,0,0,"DF,FW",25-29,Defender,Germany,Europe
2714,Christoph Zimmermann,GER,Norwich City,Premier League,2019,26.0,1993.0,15.9,32,21,26,6,0,21,30,70.0,9,22,18,4,19,51,87,2,DF,25-29,Defender,Germany,Europe
2715,Matthias Zimmermann,GER,Düsseldorf,Bundesliga,2019,27.0,1992.0,32.5,62,47,26,27,9,31,64,48.4,33,41,15,26,43,105,59,0,"DF,MF",25-29,Defender,Germany,Europe
2716,Oleksandr Zinchenko,UKR,Manchester City,Premier League,2019,22.0,1996.0,14.2,31,19,16,11,4,17,32,53.1,15,9,0,9,17,48,21,1,DF,20-24,Defender,Ukraine,Europe
2717,Leopold Zingerle,GER,Paderborn 07,Bundesliga,2019,25.0,1994.0,28.0,3,1,3,0,0,2,4,50.0,2,0,0,0,0,3,7,2,GK,25-29,Goalkeeper,Germany,Europe
2718,Joshua Zirkzee,NED,Bayern Munich,Bundesliga,2019,18.0,2001.0,3.3,5,2,0,2,3,2,4,50.0,2,2,0,2,1,6,0,0,FW,Under 20,Forward,Netherlands,Europe
2722,Ben Zolinski,GER,Paderborn 07,Bundesliga,2019,27.0,1992.0,13.4,17,9,7,9,1,7,27,25.9,20,12,0,12,8,25,4,0,"FW,MF",25-29,Forward,Germany,Europe
2723,Kurt Zouma,FRA,Chelsea,Premier League,2019,24.0,1994.0,26.0,23,14,17,6,0,9,16,56.3,7,22,14,8,58,81,116,2,DF,20-24,Defender,France,Europe
2054,Predrag Rajković,SRB,Reims,Ligue 1,2019,23.0,1995.0,27.0,1,1,1,0,0,1,1,100.0,0,0,0,0,1,2,9,0,GK,20-24,Goalkeeper,Serbia,Europe
2058,Sandro Ramírez,ESP,Valladolid,La Liga,2019,24.0,1995.0,14.5,12,10,2,6,4,2,20,10.0,18,11,1,10,7,19,2,0,"FW,MF",20-24,Forward,Spain,Europe
2059,Iván Ramis,ESP,Eibar,La Liga,2019,34.0,1984.0,5.1,3,2,2,1,0,1,4,25.0,3,2,0,2,4,7,23,2,DF,30-34,Defender,Spain,Europe
2061,Sergio Ramos,ESP,Real Madrid,La Liga,2019,33.0,1986.0,33.5,46,31,26,17,3,20,42,47.6,22,22,9,13,49,95,102,4,DF,30-34,Defender,Spain,Europe
2075,Arkadiusz Reca,POL,SPAL,Serie A,2019,24.0,1995.0,21.4,38,23,22,10,6,13,39,33.3,26,15,2,13,32,70,48,1,DF,20-24,Defender,Poland,Europe
2076,Recio,ESP,Leganés,La Liga,2019,28.0,1991.0,17.4,30,19,13,12,5,10,40,25.0,30,14,3,11,22,52,9,0,MF,25-29,Midfielder,Spain,Europe
2082,Sergio Reguilón,ESP,Sevilla,La Liga,2019,22.0,1996.0,27.9,57,30,28,25,4,27,64,42.2,37,25,5,20,33,90,53,0,DF,20-24,Defender,Spain,Europe
2084,Manolo Reina,ESP,Mallorca,La Liga,2019,34.0,1985.0,36.0,0,0,0,0,0,0,1,0.0,1,2,0,2,5,5,9,1,GK,30-34,Goalkeeper,Spain,Europe
2085,Pepe Reina,ESP,Aston Villa,Premier League,2019,36.0,1982.0,12.0,0,0,0,0,0,0,2,0.0,2,0,0,0,0,0,9,1,GK,35-39,Goalkeeper,Spain,Europe
2086,Pepe Reina,ESP,Milan,Serie A,2019,36.0,1982.0,1.0,0,0,0,0,0,0,0,,0,0,0,0,0,0,0,1,GK,35-39,Goalkeeper,Spain,Europe
2090,Álex Remiro,ESP,Real Sociedad,La Liga,2019,24.0,1995.0,25.0,0,0,0,0,0,0,1,0.0,1,0,0,0,0,0,25,1,GK,20-24,Goalkeeper,Spain,Europe
2105,Diego Rico,ESP,Bournemouth,Premier League,2019,26.0,1993.0,25.9,61,39,32,24,5,29,59,49.2,30,31,7,24,84,145,91,0,DF,25-29,Defender,Spain,Europe
2106,Sergio Rico,ESP,Paris S-G,Ligue 1,2019,25.0,1993.0,2.0,0,0,0,0,0,0,0,,0,0,0,0,0,0,1,2,GK,25-29,Goalkeeper,Spain,Europe
2110,Luis Rioja,ESP,Alavés,La Liga,2019,25.0,1993.0,18.2,18,12,11,6,1,8,25,32.0,17,21,0,21,16,34,6,0,MF,25-29,Midfielder,Spain,Europe
2112,Rodrigo Riquelme,ESP,Atlético Madrid,La Liga,2019,19.0,2000.0,0.1,0,0,0,0,0,0,0,,0,0,0,0,0,0,0,0,"FW,MF",Under 20,Forward,Spain,Europe
2121,Roberto,ESP,West Ham,Premier League,2019,33.0,1986.0,7.6,0,0,0,0,0,0,0,,0,0,0,0,0,0,2,2,GK,30-34,Goalkeeper,Spain,Europe
2121,Roberto,ESP,West Ham,Premier League,2019,33.0,1986.0,7.6,0,0,0,0,0,0,0,,0,0,0,0,0,0,2,2,GK,30-34,Goalkeeper,Spain,Europe
2121,Roberto,ESP,West Ham,Premier League,2019,33.0,1986.0,7.6,0,0,0,0,0,0,0,,0,0,0,0,0,0,2,2,GK,30-34,Goalkeeper,Spain,Europe
2121,Roberto,ESP,West Ham,Premier League,2019,33.0,1986.0,7.6,0,0,0,0,0,0,0,,0,0,0,0,0,0,2,2,GK,30-34,Goalkeeper,Spain,Europe
2122,Roberto,ESP,Alavés,La Liga,2019,33.0,1986.0,8.8,1,1,1,0,0,1,1,100.0,0,0,0,0,0,1,2,0,GK,30-34,Goalkeeper,Spain,Europe
2122,Roberto,ESP,Alavés,La Liga,2019,33.0,1986.0,8.8,1,1,1,0,0,1,1,100.0,0,0,0,0,0,1,2,0,GK,30-34,Goalkeeper,Spain,Europe
2122,Roberto,ESP,Alavés,La Liga,2019,33.0,1986.0,8.8,1,1,1,0,0,1,1,100.0,0,0,0,0,0,1,2,0,GK,30-34,Goalkeeper,Spain,Europe
2122,Roberto,ESP,Alavés,La Liga,2019,33.0,1986.0,8.8,1,1,1,0,0,1,1,100.0,0,0,0,0,0,1,2,0,GK,30-34,Goalkeeper,Spain,Europe
2123,Sergi Roberto,ESP,Barcelona,La Liga,2019,27.0,1992.0,26.0,35,22,16,11,8,15,25,60.0,10,12,3,9,33,68,36,0,"DF,MF",25-29,Defender,Spain,Europe
2129,Marc Roca,ESP,Espanyol,La Liga,2019,22.0,1996.0,33.4,82,52,29,44,9,29,82,35.4,53,28,10,18,31,113,53,2,MF,20-24,Midfielder,Spain,Europe
2130,Rubén Rochina,ESP,Levante,La Liga,2019,28.0,1991.0,20.8,41,26,22,9,10,19,52,36.5,33,16,0,16,12,53,19,1,MF,25-29,Midfielder,Spain,Europe
2132,Rodri,ESP,Manchester City,Premier League,2019,23.0,1996.0,27.6,50,30,17,25,8,23,63,36.5,40,19,5,14,26,76,35,0,MF,20-24,Midfielder,Spain,Europe
2132,Rodri,ESP,Manchester City,Premier League,2019,23.0,1996.0,27.6,50,30,17,25,8,23,63,36.5,40,19,5,14,26,76,35,0,MF,20-24,Midfielder,Spain,Europe
2132,Rodri,ESP,Manchester City,Premier League,2019,23.0,1996.0,27.6,50,30,17,25,8,23,63,36.5,40,19,5,14,26,76,35,0,MF,20-24,Midfielder,Spain,Europe
2132,Rodri,ESP,Manchester City,Premier League,2019,23.0,1996.0,27.6,50,30,17,25,8,23,63,36.5,40,19,5,14,26,76,35,0,MF,20-24,Midfielder,Spain,Europe
2133,Rodrigo,ESP,Valencia,La Liga,2019,28.0,1991.0,20.9,10,6,4,5,1,2,23,8.7,21,9,1,8,9,19,13,0,FW,25-29,Forward,Spain,Europe
2136,Ángel Rodríguez,ESP,Getafe,La Liga,2019,32.0,1987.0,15.6,14,8,2,8,4,2,18,11.1,16,10,1,9,3,17,10,0,FW,30-34,Forward,Spain,Europe
2138,Dani Rodríguez,ESP,Mallorca,La Liga,2019,31.0,1988.0,33.8,59,32,24,28,7,18,61,29.5,43,35,3,32,38,97,27,1,"MF,FW",30-34,Midfielder,Spain,Europe
2138,Dani Rodríguez,ESP,Mallorca,La Liga,2019,31.0,1988.0,33.8,59,32,24,28,7,18,61,29.5,43,35,3,32,38,97,27,1,"MF,FW",30-34,Midfielder,Spain,Europe
2138,Dani Rodríguez,ESP,Mallorca,La Liga,2019,31.0,1988.0,33.8,59,32,24,28,7,18,61,29.5,43,35,3,32,38,97,27,1,"MF,FW",30-34,Midfielder,Spain,Europe
2138,Dani Rodríguez,ESP,Mallorca,La Liga,2019,31.0,1988.0,33.8,59,32,24,28,7,18,61,29.5,43,35,3,32,38,97,27,1,"MF,FW",30-34,Midfielder,Spain,Europe
2155,Oriol Romeu,ESP,Southampton,Premier League,2019,27.0,1991.0,20.7,55,35,23,30,2,27,75,36.0,48,35,13,22,34,89,32,0,MF,25-29,Midfielder,Spain,Europe
2181,Aitor Ruibal,ESP,Leganés,La Liga,2019,23.0,1996.0,13.6,27,17,14,11,2,16,39,41.0,23,18,1,17,8,35,11,0,"DF,MF",20-24,Defender,Spain,Europe
2187,Julian Ryerson,NOR,Union Berlin,Bundesliga,2019,21.0,1997.0,4.1,7,5,2,1,4,3,6,50.0,3,5,3,2,5,12,9,0,"DF,MF",20-24,Defender,Norway,Europe
2197,Jorge Sáenz,ESP,Celta Vigo,La Liga,2019,22.0,1996.0,4.1,6,1,4,2,0,3,5,60.0,2,5,2,3,10,16,15,0,DF,20-24,Defender,Spain,Europe
2209,Bartosz Salamon,POL,SPAL,Serie A,2019,28.0,1991.0,3.8,2,1,2,0,0,1,2,50.0,1,4,4,0,6,8,14,0,DF,25-29,Defender,Poland,Europe
2222,Fede San Emeterio,ESP,Valladolid,La Liga,2019,22.0,1997.0,19.5,26,13,18,6,2,7,29,24.1,22,20,8,12,28,54,13,1,MF,20-24,Midfielder,Spain,Europe
2223,Mikel San José,ESP,Athletic Club,La Liga,2019,30.0,1989.0,4.0,9,4,2,4,3,2,10,20.0,8,3,1,2,9,18,12,0,MF,30-34,Midfielder,Spain,Europe
2225,Oihan Sancet,ESP,Athletic Club,La Liga,2019,19.0,2000.0,8.2,11,7,5,4,2,4,11,36.4,7,6,0,6,2,13,2,0,"MF,FW",Under 20,Midfielder,Spain,Europe
2231,Germán Sánchez,ESP,Granada,La Liga,2019,32.0,1986.0,25.5,16,10,12,4,0,6,16,37.5,10,29,23,6,33,49,115,2,DF,30-34,Defender,Spain,Europe
2232,Javi Sánchez,ESP,Valladolid,La Liga,2019,22.0,1997.0,5.5,5,4,3,2,0,1,3,33.3,2,4,2,2,4,9,24,0,DF,20-24,Defender,Spain,Europe
2233,Manu Sánchez,ESP,Atlético Madrid,La Liga,2019,18.0,2000.0,3.6,13,7,2,7,4,8,15,53.3,7,3,0,3,7,20,1,0,DF,Under 20,Defender,Spain,Europe
2234,Víctor Sánchez,ESP,Espanyol,La Liga,2019,31.0,1987.0,18.8,66,36,36,23,7,30,71,42.3,41,31,8,23,27,93,23,1,MF,30-34,Midfielder,Spain,Europe
2239,Luca Sangalli,ESP,Real Sociedad,La Liga,2019,24.0,1995.0,4.1,1,0,0,1,0,1,8,12.5,7,3,0,3,1,2,0,0,MF,20-24,Midfielder,Spain,Europe
2241,Oier Sanjurjo,ESP,Osasuna,La Liga,2019,33.0,1986.0,25.8,65,34,21,34,10,28,64,43.8,36,33,8,25,35,100,39,1,MF,30-34,Midfielder,Spain,Europe
2252,Pablo Sarabia,ESP,Paris S-G,Ligue 1,2019,27.0,1992.0,12.9,12,7,3,6,3,4,25,16.0,21,19,1,18,10,22,5,0,"FW,MF",25-29,Forward,Spain,Europe
2265,Patrik Schick,CZE,RB Leipzig,Bundesliga,2019,23.0,1996.0,14.4,7,3,1,3,3,2,9,22.2,7,8,2,6,2,9,17,0,FW,20-24,Forward,Czech Republic,Europe
2286,Aleksandar Sedlar,SRB,Mallorca,La Liga,2019,27.0,1991.0,9.0,13,6,10,2,1,7,11,63.6,4,17,11,6,16,29,31,0,DF,25-29,Defender,Serbia,Europe
2293,Josep Señé,ESP,Mallorca,La Liga,2019,27.0,1991.0,1.7,2,1,2,0,0,2,5,40.0,3,2,1,1,0,2,2,0,MF,25-29,Midfielder,Spain,Europe
2298,Salva Sevilla,ESP,Mallorca,La Liga,2019,35.0,1984.0,28.5,27,21,11,16,0,9,30,30.0,21,17,5,12,29,56,17,1,MF,35-39,Midfielder,Spain,Europe
2316,David Silva,ESP,Manchester City,Premier League,2019,33.0,1986.0,20.3,26,14,3,15,8,10,28,35.7,18,18,3,15,13,39,5,0,MF,30-34,Midfielder,Spain,Europe
2316,David Silva,ESP,Manchester City,Premier League,2019,33.0,1986.0,20.3,26,14,3,15,8,10,28,35.7,18,18,3,15,13,39,5,0,MF,30-34,Midfielder,Spain,Europe
2316,David Silva,ESP,Manchester City,Premier League,2019,33.0,1986.0,20.3,26,14,3,15,8,10,28,35.7,18,18,3,15,13,39,5,0,MF,30-34,Midfielder,Spain,Europe
2316,David Silva,ESP,Manchester City,Premier League,2019,33.0,1986.0,20.3,26,14,3,15,8,10,28,35.7,18,18,3,15,13,39,5,0,MF,30-34,Midfielder,Spain,Europe
2326,Unai Simón,ESP,Athletic Club,La Liga,2019,22.0,1997.0,33.2,0,0,0,0,0,0,1,0.0,1,1,0,1,1,1,10,1,GK,20-24,Goalkeeper,Spain,Europe
2337,Antonio Sivera,ESP,Alavés,La Liga,2019,22.0,1996.0,3.0,0,0,0,0,0,0,0,,0,0,0,0,0,0,2,0,GK,20-24,Goalkeeper,Spain,Europe
2360,Rubén Sobrino,ESP,Valencia,La Liga,2019,27.0,1992.0,1.9,7,5,3,2,2,2,3,66.7,1,1,0,1,0,7,1,0,"FW,MF",25-29,Forward,Spain,Europe
2362,Roberto Soldado,ESP,Granada,La Liga,2019,34.0,1985.0,26.1,16,9,2,7,7,7,24,29.2,17,16,4,12,4,20,16,0,FW,30-34,Forward,Spain,Europe
2363,Carlos Soler,ESP,Valencia,La Liga,2019,22.0,1997.0,23.0,21,10,10,10,1,9,39,23.1,30,16,6,10,9,30,14,0,MF,20-24,Midfielder,Spain,Europe
2367,David Soria,ESP,Getafe,La Liga,2019,26.0,1993.0,38.0,2,1,2,0,0,2,4,50.0,2,0,0,0,3,5,17,5,GK,25-29,Goalkeeper,Spain,Europe
2368,Bruno Soriano,ESP,Villarreal,La Liga,2019,35.0,1984.0,2.9,4,0,1,2,1,1,1,100.0,0,4,0,4,1,5,7,0,"MF,FW",35-39,Midfielder,Spain,Europe
2369,Juan Soriano,ESP,Leganés,La Liga,2019,21.0,1997.0,11.0,0,0,0,0,0,0,0,,0,0,0,0,0,0,1,1,GK,20-24,Goalkeeper,Spain,Europe
2414,Denis Suárez,ESP,Celta Vigo,La Liga,2019,25.0,1994.0,18.1,22,15,14,7,1,10,37,27.0,27,9,1,8,14,36,12,1,"MF,FW",25-29,Midfielder,Spain,Europe
2426,Suso,ESP,Milan,Serie A,2019,25.0,1993.0,15.1,7,3,2,3,2,2,10,20.0,8,5,0,5,8,15,3,0,"FW,MF",25-29,Forward,Spain,Europe
2427,Suso,ESP,Sevilla,La Liga,2019,25.0,1993.0,8.7,9,4,4,4,1,7,16,43.8,9,6,0,6,2,11,0,0,"FW,MF",25-29,Forward,Spain,Europe
2437,Tachi,ESP,Alavés,La Liga,2019,21.0,1997.0,2.6,2,1,2,0,0,1,4,25.0,3,5,4,1,4,6,12,0,DF,20-24,Defender,Spain,Europe
2457,Álvaro Tejero,ESP,Eibar,La Liga,2019,23.0,1996.0,16.1,30,18,17,10,3,14,23,60.9,9,17,4,13,28,58,38,0,DF,20-24,Defender,Spain,Europe
2460,Cristian Tello,ESP,Betis,La Liga,2019,27.0,1991.0,8.7,8,5,2,2,4,4,8,50.0,4,5,0,5,4,12,0,0,"MF,FW",25-29,Midfielder,Spain,Europe
2470,Alexander Tettey,NOR,Norwich City,Premier League,2019,33.0,1986.0,26.0,23,18,7,16,0,11,39,28.2,28,20,9,11,43,66,72,1,"MF,DF",30-34,Midfielder,Norway,Europe
2483,Morten Thorsby,NOR,Sampdoria,Serie A,2019,23.0,1996.0,20.7,53,34,17,23,13,27,52,51.9,25,24,6,18,17,70,34,0,"MF,DF",20-24,Midfielder,Norway,Europe
2489,David Timor,ESP,Getafe,La Liga,2019,29.0,1989.0,10.5,9,6,4,5,0,5,16,31.3,11,8,3,5,18,27,23,0,"MF,DF",25-29,Midfielder,Spain,Europe
2498,Raúl de Tomás,ESP,Espanyol,La Liga,2019,24.0,1994.0,11.9,9,7,3,4,2,4,13,30.8,9,8,1,7,10,19,4,0,FW,20-24,Forward,Spain,Europe
2502,Nenad Tomović,SRB,SPAL,Serie A,2019,31.0,1987.0,19.5,26,19,18,6,2,10,21,47.6,11,32,23,9,30,56,65,1,DF,30-34,Defender,Serbia,Europe
2505,Toño,ESP,Levante,La Liga,2019,29.0,1989.0,17.7,26,19,18,7,1,15,28,53.6,13,11,3,8,13,39,34,1,DF,25-29,Defender,Spain,Europe
2505,Toño,ESP,Levante,La Liga,2019,29.0,1989.0,17.7,26,19,18,7,1,15,28,53.6,13,11,3,8,13,39,34,1,DF,25-29,Defender,Spain,Europe
2505,Toño,ESP,Levante,La Liga,2019,29.0,1989.0,17.7,26,19,18,7,1,15,28,53.6,13,11,3,8,13,39,34,1,DF,25-29,Defender,Spain,Europe
2505,Toño,ESP,Levante,La Liga,2019,29.0,1989.0,17.7,26,19,18,7,1,15,28,53.6,13,11,3,8,13,39,34,1,DF,25-29,Defender,Spain,Europe
2510,Óliver Torres,ESP,Sevilla,La Liga,2019,24.0,1994.0,17.7,45,27,12,26,7,23,60,38.3,37,23,1,22,13,58,9,1,"MF,FW",20-24,Midfielder,Spain,Europe
2511,Pau Torres,ESP,Villarreal,La Liga,2019,22.0,1997.0,33.0,34,21,24,10,0,16,24,66.7,8,39,23,16,27,61,153,1,DF,20-24,Defender,Spain,Europe
2512,Roberto Torres,ESP,Osasuna,La Liga,2019,30.0,1989.0,30.2,33,16,12,18,3,21,49,42.9,28,41,2,39,31,64,37,0,"MF,FW",30-34,Midfielder,Spain,Europe
2513,Lucas Torró,ESP,Eint Frankfurt,Bundesliga,2019,25.0,1994.0,3.7,12,7,6,6,0,8,16,50.0,8,2,1,1,8,20,3,0,MF,25-29,Midfielder,Spain,Europe
2522,Adama Traoré,ESP,Wolves,Premier League,2019,23.0,1996.0,28.9,33,21,6,14,13,8,23,34.8,15,19,3,16,13,46,14,2,"FW,DF",20-24,Forward,Spain,Europe
2522,Adama Traoré,ESP,Wolves,Premier League,2019,23.0,1996.0,28.9,33,21,6,14,13,8,23,34.8,15,19,3,16,13,46,14,2,"FW,DF",20-24,Forward,Spain,Europe
2522,Adama Traoré,ESP,Wolves,Premier League,2019,23.0,1996.0,28.9,33,21,6,14,13,8,23,34.8,15,19,3,16,13,46,14,2,"FW,DF",20-24,Forward,Spain,Europe
2522,Adama Traoré,ESP,Wolves,Premier League,2019,23.0,1996.0,28.9,33,21,6,14,13,8,23,34.8,15,19,3,16,13,46,14,2,"FW,DF",20-24,Forward,Spain,Europe
2522,Adama Traoré,ESP,Wolves,Premier League,2019,23.0,1996.0,28.9,33,21,6,14,13,8,23,34.8,15,19,3,16,13,46,14,2,"FW,DF",20-24,Forward,Spain,Europe
2522,Adama Traoré,ESP,Wolves,Premier League,2019,23.0,1996.0,28.9,33,21,6,14,13,8,23,34.8,15,19,3,16,13,46,14,2,"FW,DF",20-24,Forward,Spain,Europe
2522,Adama Traoré,ESP,Wolves,Premier League,2019,23.0,1996.0,28.9,33,21,6,14,13,8,23,34.8,15,19,3,16,13,46,14,2,"FW,DF",20-24,Forward,Spain,Europe
2522,Adama Traoré,ESP,Wolves,Premier League,2019,23.0,1996.0,28.9,33,21,6,14,13,8,23,34.8,15,19,3,16,13,46,14,2,"FW,DF",20-24,Forward,Spain,Europe
2522,Adama Traoré,ESP,Wolves,Premier League,2019,23.0,1996.0,28.9,33,21,6,14,13,8,23,34.8,15,19,3,16,13,46,14,2,"FW,DF",20-24,Forward,Spain,Europe
2522,Adama Traoré,ESP,Wolves,Premier League,2019,23.0,1996.0,28.9,33,21,6,14,13,8,23,34.8,15,19,3,16,13,46,14,2,"FW,DF",20-24,Forward,Spain,Europe
2522,Adama Traoré,ESP,Wolves,Premier League,2019,23.0,1996.0,28.9,33,21,6,14,13,8,23,34.8,15,19,3,16,13,46,14,2,"FW,DF",20-24,Forward,Spain,Europe
2522,Adama Traoré,ESP,Wolves,Premier League,2019,23.0,1996.0,28.9,33,21,6,14,13,8,23,34.8,15,19,3,16,13,46,14,2,"FW,DF",20-24,Forward,Spain,Europe
2522,Adama Traoré,ESP,Wolves,Premier League,2019,23.0,1996.0,28.9,33,21,6,14,13,8,23,34.8,15,19,3,16,13,46,14,2,"FW,DF",20-24,Forward,Spain,Europe
2522,Adama Traoré,ESP,Wolves,Premier League,2019,23.0,1996.0,28.9,33,21,6,14,13,8,23,34.8,15,19,3,16,13,46,14,2,"FW,DF",20-24,Forward,Spain,Europe
2522,Adama Traoré,ESP,Wolves,Premier League,2019,23.0,1996.0,28.9,33,21,6,14,13,8,23,34.8,15,19,3,16,13,46,14,2,"FW,DF",20-24,Forward,Spain,Europe
2522,Adama Traoré,ESP,Wolves,Premier League,2019,23.0,1996.0,28.9,33,21,6,14,13,8,23,34.8,15,19,3,16,13,46,14,2,"FW,DF",20-24,Forward,Spain,Europe
2535,Manu Trigueros,ESP,Villarreal,La Liga,2019,27.0,1991.0,17.2,34,21,10,17,7,12,45,26.7,33,23,12,11,4,38,21,0,MF,25-29,Midfielder,Spain,Europe
2558,Álvaro Vadillo,ESP,Granada,La Liga,2019,24.0,1994.0,13.5,16,11,6,8,2,9,16,56.3,7,12,0,12,7,23,2,0,"FW,MF",20-24,Forward,Spain,Europe
2562,Germán Valera,ESP,Atlético Madrid,La Liga,2019,17.0,2002.0,0.0,0,0,0,0,0,0,0,,0,1,0,1,0,0,0,0,FW,Under 20,Forward,Spain,Europe
2564,Borja Valero,ESP,Inter,Serie A,2019,34.0,1985.0,10.3,18,7,9,3,6,6,24,25.0,18,12,3,9,8,26,9,0,MF,30-34,Midfielder,Spain,Europe
2567,Jesús Vallejo,ESP,Wolves,Premier League,2019,22.0,1997.0,1.8,1,1,1,0,0,1,2,50.0,1,4,3,1,2,3,8,1,DF,20-24,Defender,Spain,Europe
2568,Jesús Vallejo,ESP,Granada,La Liga,2019,22.0,1997.0,7.0,6,5,4,2,0,3,4,75.0,1,7,4,3,5,11,28,0,DF,20-24,Defender,Spain,Europe
2569,Manu Vallejo,ESP,Valencia,La Liga,2019,22.0,1997.0,4.6,7,3,0,3,4,5,9,55.6,4,4,0,4,2,9,2,0,"MF,FW",20-24,Midfielder,Spain,Europe
2584,Kevin Vázquez,ESP,Celta Vigo,La Liga,2019,26.0,1993.0,14.7,26,15,16,6,4,15,28,53.6,13,18,1,17,26,52,28,0,DF,25-29,Defender,Spain,Europe
2585,Lucas Vázquez,ESP,Real Madrid,La Liga,2019,28.0,1991.0,9.4,23,17,10,13,0,11,26,42.3,15,10,0,10,10,33,8,1,"MF,FW",25-29,Midfielder,Spain,Europe
2587,Koke Vegas,ESP,Levante,La Liga,2019,23.0,1995.0,2.0,0,0,0,0,0,0,1,0.0,1,0,0,0,0,0,3,0,GK,20-24,Goalkeeper,Spain,Europe
2599,Mikel Vesga,ESP,Athletic Club,La Liga,2019,26.0,1993.0,14.1,25,17,7,12,6,9,45,20.0,36,18,7,11,31,56,24,1,MF,25-29,Midfielder,Spain,Europe
2604,Aleix Vidal,ESP,Alavés,La Liga,2019,29.0,1989.0,24.1,21,14,8,11,2,8,37,21.6,29,14,1,13,23,44,18,0,MF,25-29,Midfielder,Spain,Europe
2607,Nacho Vidal,ESP,Osasuna,La Liga,2019,24.0,1995.0,25.9,45,29,26,13,6,21,38,55.3,17,24,6,18,44,89,70,1,DF,20-24,Defender,Spain,Europe
2610,Dídac Vilà,ESP,Espanyol,La Liga,2019,30.0,1989.0,27.7,73,42,44,23,6,25,61,41.0,36,31,5,26,40,113,63,0,DF,30-34,Defender,Spain,Europe
2611,Toni Villa,ESP,Valladolid,La Liga,2019,24.0,1995.0,15.0,31,16,13,14,4,13,50,26.0,37,16,1,15,8,39,11,0,MF,20-24,Midfielder,Spain,Europe
2612,Asier Villalibre,ESP,Athletic Club,La Liga,2019,21.0,1997.0,5.9,0,0,0,0,0,0,3,0.0,3,3,0,3,1,1,4,0,FW,20-24,Forward,Spain,Europe
2613,Gonzalo Villar,ESP,Roma,Serie A,2019,21.0,1998.0,3.3,5,3,4,0,1,2,4,50.0,2,2,0,2,2,7,3,0,MF,20-24,Midfielder,Spain,Europe
2614,Iván Villar,ESP,Celta Vigo,La Liga,2019,22.0,1997.0,3.1,0,0,0,0,0,0,0,,0,0,0,0,0,0,5,0,GK,20-24,Goalkeeper,Spain,Europe
2615,Juan Villar,ESP,Osasuna,La Liga,2019,31.0,1988.0,2.7,1,0,0,1,0,0,2,0.0,2,4,1,3,1,2,0,0,FW,30-34,Forward,Spain,Europe
2618,Vitolo,ESP,Atlético Madrid,La Liga,2019,29.0,1989.0,13.6,15,12,7,7,1,5,17,29.4,12,9,0,9,10,25,9,0,"FW,MF",25-29,Forward,Spain,Europe
2618,Vitolo,ESP,Atlético Madrid,La Liga,2019,29.0,1989.0,13.6,15,12,7,7,1,5,17,29.4,12,9,0,9,10,25,9,0,"FW,MF",25-29,Forward,Spain,Europe
2618,Vitolo,ESP,Atlético Madrid,La Liga,2019,29.0,1989.0,13.6,15,12,7,7,1,5,17,29.4,12,9,0,9,10,25,9,0,"FW,MF",25-29,Forward,Spain,Europe
2618,Vitolo,ESP,Atlético Madrid,La Liga,2019,29.0,1989.0,13.6,15,12,7,7,1,5,17,29.4,12,9,0,9,10,25,9,0,"FW,MF",25-29,Forward,Spain,Europe
2620,Dušan Vlahović,SRB,Fiorentina,Serie A,2019,19.0,2000.0,16.7,6,2,1,4,1,4,13,30.8,9,5,2,3,7,13,6,0,FW,Under 20,Forward,Serbia,Europe
2642,Sebastian Walukiewicz,POL,Cagliari,Serie A,2019,19.0,2000.0,12.9,25,11,17,8,0,14,22,63.6,8,21,14,7,14,39,41,0,DF,Under 20,Defender,Poland,Europe
2712,Piotr Zieliński,POL,Napoli,Serie A,2019,25.0,1994.0,32.5,26,16,10,11,5,12,30,40.0,18,28,5,23,21,47,15,0,MF,25-29,Midfielder,Poland,Europe
2724,Igor Zubeldia,ESP,Real Sociedad,La Liga,2019,22.0,1997.0,29.3,42,21,18,19,5,17,35,48.6,18,38,21,17,26,68,82,2,"MF,DF",20-24,Midfielder,Spain,Europe
2726,Martín Zubimendi,ESP,Real Sociedad,La Liga,2019,20.0,1999.0,5.8,16,12,9,7,0,6,12,50.0,6,7,0,7,9,25,2,0,MF,20-24,Midfielder,Spain,Europe
2729,Szymon Żurkowski,POL,Fiorentina,Serie A,2019,21.0,1997.0,0.1,1,0,0,0,1,0,2,0.0,2,0,0,0,0,1,1,0,MF,20-24,Midfielder,Poland,Europe
2730,David Zurutuza,ESP,Real Sociedad,La Liga,2019,33.0,1986.0,1.7,4,3,0,3,1,1,2,50.0,1,1,0,1,4,8,3,0,MF,30-34,Midfielder,Spain,Europe
2731,Martin Ødegaard,NOR,Real Sociedad,La Liga,2019,20.0,1998.0,28.1,27,19,5,14,8,7,34,20.6,27,13,0,13,17,44,5,0,MF,20-24,Midfielder,Norway,Europe
67,Mickaël Alphonse,GLP,Dijon,Ligue 1,2019,30.0,1989.0,15.3,39,25,26,12,1,23,37,62.2,14,19,3,16,17,56,64,0,DF,30-34,Defender,France,Europe
280,Valon Berisha,KVX,Lazio,Serie A,2019,26.0,1993.0,0.4,1,1,0,1,0,1,2,50.0,1,0,0,0,0,1,1,0,MF,25-29,Midfielder,Sweden,Europe
281,Valon Berisha,KVX,Düsseldorf,Bundesliga,2019,26.0,1993.0,10.5,14,9,3,8,3,6,21,28.6,15,4,1,3,9,23,8,0,MF,25-29,Midfielder,Sweden,Europe
641,Grégoire Defrel,MTQ,Sassuolo,Serie A,2019,28.0,1991.0,10.9,12,8,4,6,2,4,15,26.7,11,9,0,9,3,15,5,0,"FW,MF",25-29,Forward,France,Europe
2,Yunis Abdelhamid,MAR,Reims,Ligue 1,2021,33.0,1987.0,33.1,48,27,34,14,0,16,32,50.0,16,50,25,25,68,116,104,0,DF,30-34,Defender,Morocco,Africa
3,Salis Abdul Samed,GHA,Clermont Foot,Ligue 1,2021,21.0,2000.0,27.4,43,23,25,16,2,20,57,35.1,37,18,1,17,42,85,15,0,MF,20-24,Midfielder,Ghana,Africa
4,Laurent Abergel,FRA,Lorient,Ligue 1,2021,28.0,1993.0,32.8,110,60,44,53,13,71,166,42.8,95,58,1,57,55,165,13,0,MF,25-29,Midfielder,France,Europe
5,Charles Abi,FRA,Saint-Étienne,Ligue 1,2021,21.0,2000.0,0.5,0,0,0,0,0,0,1,0.0,1,2,0,2,0,0,0,0,FW,20-24,Forward,France,Europe
6,Dickson Abiama,NGA,Greuther Fürth,Bundesliga,2021,22.0,1998.0,8.1,11,7,4,5,2,2,10,20.0,8,12,1,11,4,15,8,0,FW,20-24,Forward,Nigeria,Africa
7,Matthis Abline,FRA,Rennes,Ligue 1,2021,18.0,2003.0,1.1,0,0,0,0,0,0,0,,0,2,0,2,0,0,1,0,FW,Under 20,Forward,France,Europe
8,Tammy Abraham,ENG,Roma,Serie A,2021,23.0,1997.0,34.3,27,13,7,14,6,9,22,40.9,13,17,3,14,5,32,27,0,FW,20-24,Forward,England,Europe
9,Luis Abram,PER,Granada,La Liga,2021,25.0,1996.0,6.2,6,3,3,3,0,2,4,50.0,2,6,5,1,5,11,37,1,DF,25-29,Defender,Peru,South America
10,Francesco Acerbi,ITA,Lazio,Serie A,2021,33.0,1988.0,28.2,25,12,15,9,1,12,19,63.2,7,37,28,9,34,59,92,0,DF,30-34,Defender,Italy,Europe
11,Ragnar Ache,GER,Eint Frankfurt,Bundesliga,2021,23.0,1998.0,2.9,2,0,0,1,1,1,4,25.0,3,3,0,3,0,2,1,0,"MF,FW",20-24,Midfielder,Germany,Europe
13,Marcos Acuña,ARG,Sevilla,La Liga,2021,29.0,1991.0,25.1,50,29,27,14,9,30,46,65.2,16,22,5,17,14,64,25,1,DF,25-29,Defender,Argentina,South America
15,Tyler Adams,USA,RB Leipzig,Bundesliga,2021,22.0,1999.0,15.0,23,7,5,16,2,7,25,28.0,18,24,1,23,16,39,19,2,MF,20-24,Midfielder,United States,North America
16,Sargis Adamyan,ARM,Hoffenheim,Bundesliga,2021,28.0,1993.0,3.7,8,6,3,4,1,3,11,27.3,8,4,0,4,1,9,2,0,"FW,MF",25-29,Forward,Armenia,Asia
18,Amine Adli,MAR,Leverkusen,Bundesliga,2021,21.0,2000.0,14.0,27,14,10,14,3,8,15,53.3,7,26,2,24,11,38,12,0,"FW,MF",20-24,Forward,Morocco,Africa
19,Yacine Adli,FRA,Bordeaux,Ligue 1,2021,21.0,2000.0,25.1,43,27,22,14,7,19,68,27.9,49,33,3,30,37,80,11,2,"MF,FW",20-24,Midfielder,France,Europe
42,Ilias Akhomach,MAR,Barcelona,La Liga,2021,17.0,2004.0,1.4,2,0,0,1,1,0,0,,0,0,0,0,0,2,0,0,FW,Under 20,Forward,Morocco,Africa
43,Maghnes Akliouche,FRA,Monaco,Ligue 1,2021,19.0,2002.0,0.6,2,0,0,2,0,0,1,0.0,1,2,0,2,0,2,0,0,"MF,FW",Under 20,Midfielder,France,Europe
44,Paul Akouokou,CIV,Betis,La Liga,2021,23.0,1997.0,5.7,14,9,5,7,2,8,12,66.7,4,6,0,6,11,25,6,0,MF,20-24,Midfielder,Ivory Coast,Africa
46,Kevin Akpoguma,NGA,Hoffenheim,Bundesliga,2021,26.0,1995.0,17.0,33,19,16,11,6,16,28,57.1,12,32,2,30,20,53,29,2,"DF,FW",25-29,Defender,Nigeria,Africa
47,David Alaba,AUT,Real Madrid,La Liga,2021,29.0,1992.0,29.4,23,13,15,6,2,9,19,47.4,10,26,15,11,22,45,70,1,DF,25-29,Defender,Austria,Europe
48,Sofiane Alakouch,MAR,Metz,Ligue 1,2021,23.0,1998.0,1.8,7,4,3,4,0,2,5,40.0,3,4,0,4,1,8,4,0,"DF,MF",20-24,Defender,Morocco,Africa
49,Tomás Alarcón,CHI,Cádiz,La Liga,2021,22.0,1999.0,15.8,31,20,17,10,4,10,31,32.3,21,19,7,12,30,61,31,0,MF,20-24,Midfielder,Chile,South America
50,Lucas Alario,ARG,Leverkusen,Bundesliga,2021,28.0,1992.0,7.3,6,5,0,2,4,2,5,40.0,3,5,0,5,1,7,6,0,FW,25-29,Forward,Argentina,South America
55,Marc Albrighton,ENG,Leicester City,Premier League,2021,31.0,1989.0,12.6,31,19,16,9,6,10,47,21.3,37,15,3,12,14,45,20,0,"FW,DF",30-34,Forward,England,Europe
59,Omar Alderete,PAR,Valencia,La Liga,2021,24.0,1996.0,26.7,53,34,34,17,2,34,53,64.2,19,30,18,12,35,88,153,0,DF,20-24,Defender,Paraguay,South America
61,Doğan Alemdar,TUR,Rennes,Ligue 1,2021,18.0,2002.0,12.0,0,0,0,0,0,0,0,,0,0,0,0,0,0,9,1,GK,Under 20,Goalkeeper,Turkey,Asia
63,Trent Alexander-Arnold,ENG,Liverpool,Premier League,2021,22.0,1998.0,31.7,40,23,19,13,8,27,60,45.0,33,22,4,18,43,83,40,0,DF,20-24,Defender,England,Europe
65,Alisson,BRA,Liverpool,Premier League,2021,28.0,1992.0,36.0,3,1,3,0,0,3,5,60.0,2,1,0,1,0,3,28,1,GK,25-29,Goalkeeper,Brazil,South America
65,Alisson,BRA,Liverpool,Premier League,2021,28.0,1992.0,36.0,3,1,3,0,0,3,5,60.0,2,1,0,1,0,3,28,1,GK,25-29,Goalkeeper,Brazil,South America
65,Alisson,BRA,Liverpool,Premier League,2021,28.0,1992.0,36.0,3,1,3,0,0,3,5,60.0,2,1,0,1,0,3,28,1,GK,25-29,Goalkeeper,Brazil,South America
65,Alisson,BRA,Liverpool,Premier League,2021,28.0,1992.0,36.0,3,1,3,0,0,3,5,60.0,2,1,0,1,0,3,28,1,GK,25-29,Goalkeeper,Brazil,South America
66,Allan,BRA,Everton,Premier League,2021,30.0,1991.0,24.3,74,44,28,39,7,34,105,32.4,71,40,9,31,23,97,39,1,MF,30-34,Midfielder,Brazil,South America
66,Allan,BRA,Everton,Premier League,2021,30.0,1991.0,24.3,74,44,28,39,7,34,105,32.4,71,40,9,31,23,97,39,1,MF,30-34,Midfielder,Brazil,South America
66,Allan,BRA,Everton,Premier League,2021,30.0,1991.0,24.3,74,44,28,39,7,34,105,32.4,71,40,9,31,23,97,39,1,MF,30-34,Midfielder,Brazil,South America
66,Allan,BRA,Everton,Premier League,2021,30.0,1991.0,24.3,74,44,28,39,7,34,105,32.4,71,40,9,31,23,97,39,1,MF,30-34,Midfielder,Brazil,South America
67,Jim Allevinah,GAB,Clermont Foot,Ligue 1,2021,26.0,1995.0,16.5,18,13,8,8,2,5,18,27.8,13,11,0,11,6,24,4,0,FW,25-29,Forward,Gabon,Africa
68,Dele Alli,ENG,Tottenham,Premier League,2021,25.0,1996.0,7.3,14,8,10,3,1,5,17,29.4,12,22,5,17,6,20,16,0,MF,25-29,Midfielder,England,Europe
69,Dele Alli,ENG,Everton,Premier League,2021,25.0,1996.0,3.8,7,2,3,4,0,0,4,0.0,4,7,2,5,6,13,10,0,"MF,FW",25-29,Midfielder,England,Europe
70,Miguel Almirón,PAR,Newcastle Utd,Premier League,2021,27.0,1994.0,19.1,47,29,23,17,7,11,44,25.0,33,14,1,13,20,67,13,0,"MF,FW",25-29,Midfielder,Paraguay,South America
72,Giorgio Altare,ITA,Cagliari,Serie A,2021,22.0,1998.0,16.3,39,28,18,18,3,21,26,80.8,5,17,5,12,30,69,70,0,DF,20-24,Defender,Italy,Europe
75,Dani Alves,BRA,Barcelona,La Liga,2021,38.0,1983.0,12.2,30,19,13,13,4,14,26,53.8,12,10,3,7,11,41,10,2,DF,35-39,Defender,Brazil,South America
76,Steven Alzate,COL,Brighton,Premier League,2021,22.0,1998.0,4.5,10,4,4,5,1,4,7,57.1,3,2,1,1,10,20,10,0,MF,20-24,Midfielder,Colombia,South America
77,Ibrahim Amadou,FRA,Metz,Ligue 1,2021,28.0,1993.0,9.0,16,8,10,6,0,8,15,53.3,7,4,2,2,14,30,26,0,"DF,MF",25-29,Defender,France,Europe
81,Jordan Amavi,FRA,Nice,Ligue 1,2021,27.0,1994.0,4.6,16,10,8,7,1,10,17,58.8,7,3,1,2,15,31,7,0,DF,25-29,Defender,France,Europe
82,Jordan Amavi,FRA,Marseille,Ligue 1,2021,27.0,1994.0,1.4,6,5,3,1,2,5,10,50.0,5,1,0,1,1,7,3,0,"DF,FW",25-29,Defender,France,Europe
84,Kelvin Amian,FRA,Spezia,Serie A,2021,23.0,1998.0,29.4,66,42,43,18,5,30,41,73.2,11,39,21,18,32,98,75,0,DF,20-24,Defender,France,Europe
85,Nadiem Amiri,GER,Genoa,Serie A,2021,24.0,1996.0,7.6,6,4,2,2,2,2,9,22.2,7,7,0,7,0,6,0,0,"MF,FW",20-24,Midfielder,Germany,Europe
86,Nadiem Amiri,GER,Leverkusen,Bundesliga,2021,24.0,1996.0,4.1,8,4,3,2,3,4,8,50.0,4,4,2,2,5,13,0,0,"MF,FW",20-24,Midfielder,Germany,Europe
87,Ethan Ampadu,WAL,Venezia,Serie A,2021,20.0,2000.0,25.4,67,43,37,27,3,24,58,41.4,34,49,19,30,51,118,76,0,"MF,DF",20-24,Midfielder,Wales,Europe
89,Joachim Andersen,DEN,Crystal Palace,Premier League,2021,25.0,1996.0,32.4,30,23,21,9,0,16,27,59.3,11,29,19,10,37,67,125,3,DF,25-29,Defender,Denmark,Europe
90,Felipe Anderson,BRA,Lazio,Serie A,2021,28.0,1993.0,32.1,71,45,30,33,8,27,99,27.3,72,65,6,59,20,91,16,0,FW,25-29,Forward,Brazil,South America
91,Sebastian Andersson,SWE,Köln,Bundesliga,2021,30.0,1991.0,14.0,11,7,0,3,8,3,9,33.3,6,8,0,8,3,14,14,0,FW,30-34,Forward,Sweden,Europe
92,Florin Andone,ROU,Cádiz,La Liga,2021,28.0,1993.0,2.0,1,1,1,0,0,0,1,0.0,1,2,0,2,0,1,1,0,FW,25-29,Forward,Romania,Europe
94,Benjamin André,FRA,Lille,Ligue 1,2021,30.0,1990.0,30.6,123,69,49,65,9,51,113,45.1,62,49,11,38,50,173,56,0,MF,30-34,Midfielder,France,Europe
96,Marcos André,BRA,Valencia,La Liga,2021,24.0,1996.0,10.8,15,11,4,6,5,5,16,31.3,11,15,0,15,7,22,13,0,"FW,MF",20-24,Forward,Brazil,South America
96,Marcos André,BRA,Valencia,La Liga,2021,24.0,1996.0,10.8,15,11,4,6,5,5,16,31.3,11,15,0,15,7,22,13,0,"FW,MF",20-24,Forward,Brazil,South America
96,Marcos André,BRA,Valencia,La Liga,2021,24.0,1996.0,10.8,15,11,4,6,5,5,16,31.3,11,15,0,15,7,22,13,0,"FW,MF",20-24,Forward,Brazil,South America
96,Marcos André,BRA,Valencia,La Liga,2021,24.0,1996.0,10.8,15,11,4,6,5,5,16,31.3,11,15,0,15,7,22,13,0,"FW,MF",20-24,Forward,Brazil,South America
97,Robert Andrich,GER,Leverkusen,Bundesliga,2021,26.0,1994.0,20.2,33,17,18,14,1,14,28,50.0,14,19,7,12,31,64,46,0,MF,25-29,Midfielder,Germany,Europe
100,Ebenezer Annan,GHA,Bologna,Serie A,2021,18.0,2002.0,0.3,1,1,1,0,0,0,0,,0,0,0,0,1,2,1,0,DF,Under 20,Defender,Ghana,Africa
101,Cristian Ansaldi,ARG,Torino,Serie A,2021,34.0,1986.0,7.7,20,9,11,7,2,10,13,76.9,3,9,1,8,6,26,10,0,DF,30-34,Defender,Argentina,South America
102,Janis Antiste,FRA,Spezia,Serie A,2021,18.0,2002.0,8.8,18,11,6,6,6,5,13,38.5,8,7,1,6,4,22,6,0,FW,Under 20,Forward,France,Europe
103,Waldemar Anton,GER,Stuttgart,Bundesliga,2021,25.0,1996.0,28.8,40,26,22,15,3,19,32,59.4,13,27,16,11,32,72,116,1,DF,25-29,Defender,Germany,Europe
105,Michail Antonio,JAM,West Ham,Premier League,2021,31.0,1990.0,33.0,23,17,5,9,9,7,18,38.9,11,19,1,18,3,26,13,0,FW,30-34,Forward,Jamaica,North America
106,Christopher Antwi-Adjei,GHA,Bochum,Bundesliga,2021,27.0,1994.0,12.6,21,18,7,8,6,6,26,23.1,20,12,0,12,1,22,8,0,"FW,MF",25-29,Forward,Ghana,Africa
107,Houssem Aouar,ALG,Lyon,Ligue 1,2021,23.0,1998.0,27.8,46,30,9,25,12,27,54,50.0,27,26,1,25,20,66,5,0,"MF,FW",20-24,Midfielder,Algeria,Africa
108,Adil Aouchiche,FRA,Saint-Étienne,Ligue 1,2021,19.0,2002.0,12.0,13,6,5,5,3,5,33,15.2,28,18,1,17,17,30,4,0,"MF,FW",Under 20,Midfielder,France,Europe
109,Dennis Appiah,FRA,Nantes,Ligue 1,2021,29.0,1992.0,23.3,55,34,35,18,2,28,48,58.3,20,30,13,17,27,82,74,0,DF,25-29,Defender,France,Europe
110,Mauro Arambarri,URU,Getafe,La Liga,2021,25.0,1995.0,29.6,62,37,19,32,11,20,68,29.4,48,35,5,30,32,94,18,0,MF,25-29,Midfielder,Uruguay,South America
111,Mattia Aramu,ITA,Venezia,Serie A,2021,26.0,1995.0,23.3,20,15,5,9,6,8,33,24.2,25,20,2,18,8,28,19,0,"MF,FW",25-29,Midfielder,Italy,Europe
112,Charles Aránguiz,CHI,Leverkusen,Bundesliga,2021,32.0,1989.0,17.5,45,25,18,21,6,22,52,42.3,30,24,4,20,33,78,21,0,MF,30-34,Midfielder,Chile,South America
115,Cameron Archer,ENG,Aston Villa,Premier League,2021,20.0,2001.0,0.3,0,0,0,0,0,0,0,,0,0,0,0,0,0,0,0,"FW,MF",20-24,Forward,England,Europe
116,Alphonse Areola,FRA,West Ham,Premier League,2021,28.0,1993.0,1.0,0,0,0,0,0,0,0,,0,0,0,0,0,0,1,0,GK,25-29,Goalkeeper,France,Europe
119,Santiago Arias,COL,Granada,La Liga,2021,29.0,1992.0,4.9,12,5,8,3,1,4,9,44.4,5,8,4,4,5,17,10,0,DF,25-29,Defender,Colombia,South America
120,Adam Armstrong,ENG,Southampton,Premier League,2021,24.0,1997.0,15.7,10,4,2,2,6,0,6,0.0,6,13,1,12,3,13,6,0,FW,20-24,Forward,England,Europe
121,Stuart Armstrong,SCO,Southampton,Premier League,2021,29.0,1992.0,16.4,27,19,15,6,6,9,23,39.1,14,10,1,9,8,35,15,0,MF,25-29,Midfielder,Scotland,Europe
123,Maximilian Arnold,GER,Wolfsburg,Bundesliga,2021,27.0,1994.0,33.3,37,20,19,16,2,20,50,40.0,30,43,15,28,37,74,55,0,MF,25-29,Midfielder,Germany,Europe
125,Tolgay Arslan,GER,Udinese,Serie A,2021,30.0,1990.0,18.4,35,20,15,16,4,19,50,38.0,31,17,4,13,13,48,23,1,MF,30-34,Midfielder,Germany,Europe
126,Santiago Arzamendia,PAR,Cádiz,La Liga,2021,23.0,1998.0,5.2,14,6,6,5,3,6,13,46.2,7,6,0,6,4,18,7,0,MF,20-24,Midfielder,Paraguay,South America
127,Takuma Asano,JPN,Bochum,Bundesliga,2021,26.0,1994.0,17.9,11,6,3,6,2,5,19,26.3,14,14,1,13,7,18,7,0,"FW,MF",25-29,Forward,Japan,Asia
128,Santiago Ascacíbar,ARG,Hertha BSC,Bundesliga,2021,24.0,1997.0,26.4,93,54,50,37,6,38,89,42.7,51,31,6,25,41,134,42,0,MF,20-24,Midfielder,Argentina,South America
132,Harrison Ashby,SCO,West Ham,Premier League,2021,19.0,2001.0,0.1,0,0,0,0,0,0,0,,0,1,0,1,1,1,1,0,DF,Under 20,Defender,Scotland,Europe
135,Kristjan Asllani,ALB,Empoli,Serie A,2021,19.0,2002.0,15.0,18,9,9,8,1,11,29,37.9,18,16,7,9,19,37,15,1,MF,Under 20,Midfielder,Albania,Europe
138,Simon Asta,GER,Greuther Fürth,Bundesliga,2021,20.0,2001.0,8.7,13,6,4,5,4,4,8,50.0,4,14,2,12,8,21,16,0,DF,20-24,Defender,Germany,Europe
140,Pierre-Emerick Aubameyang,GAB,Arsenal,Premier League,2021,32.0,1989.0,11.5,11,5,6,4,1,3,10,30.0,7,12,1,11,0,11,4,0,FW,30-34,Forward,Gabon,Africa
141,Pierre-Emerick Aubameyang,GAB,Barcelona,La Liga,2021,32.0,1989.0,12.0,2,2,0,1,1,0,5,0.0,5,9,1,8,2,4,4,0,FW,30-34,Forward,Gabon,Africa
142,Emil Audero,ITA,Sampdoria,Serie A,2021,24.0,1997.0,28.4,3,1,3,0,0,3,5,60.0,2,0,0,0,2,5,17,2,GK,20-24,Goalkeeper,Italy,Europe
143,Tommaso Augello,ITA,Sampdoria,Serie A,2021,26.0,1994.0,26.6,36,20,22,8,6,17,29,58.6,12,19,4,15,29,65,68,1,DF,25-29,Defender,Italy,Europe
144,Jean-Kévin Augustin,FRA,Nantes,Ligue 1,2021,24.0,1997.0,0.9,1,0,0,0,1,0,3,0.0,3,1,0,1,0,1,0,0,"FW,MF",20-24,Forward,France,Europe
146,Serge Aurier,CIV,Villarreal,La Liga,2021,28.0,1992.0,11.2,14,9,11,2,1,4,7,57.1,3,14,7,7,11,25,25,0,DF,25-29,Defender,Ivory Coast,Africa
148,Taiwo Awoniyi,NGA,Union Berlin,Bundesliga,2021,23.0,1997.0,24.2,11,7,3,6,2,1,9,11.1,8,11,2,9,2,13,29,0,FW,20-24,Forward,Nigeria,Africa
149,Ramzi Aya,ITA,Salernitana,Serie A,2021,30.0,1990.0,1.5,1,1,1,0,0,1,1,100.0,0,0,0,0,0,1,4,0,DF,30-34,Defender,Italy,Europe
150,Jordan Ayew,GHA,Crystal Palace,Premier League,2021,29.0,1991.0,22.4,47,30,20,20,7,17,31,54.8,14,33,3,30,15,62,15,0,FW,25-29,Forward,Ghana,Africa
152,Luke Ayling,ENG,Leeds United,Premier League,2021,29.0,1991.0,25.2,74,42,46,23,5,51,97,52.6,46,46,25,21,28,102,52,1,DF,25-29,Defender,England,Europe
153,Karim Azamoum,FRA,Troyes,Ligue 1,2021,31.0,1990.0,4.3,6,5,4,2,0,3,5,60.0,2,4,2,2,1,7,10,0,DF,30-34,Defender,France,Europe
154,Sardar Azmoun,IRN,Leverkusen,Bundesliga,2021,26.0,1995.0,4.0,3,1,0,2,1,0,5,0.0,5,2,0,2,0,3,8,0,"FW,MF",25-29,Forward,Iran,Asia
156,Iddrisu Baba,GHA,Mallorca,La Liga,2021,25.0,1996.0,21.5,57,30,31,23,3,25,43,58.1,18,19,5,14,24,81,34,1,MF,25-29,Midfielder,Ghana,Africa
157,Carlos Bacca,COL,Granada,La Liga,2021,34.0,1986.0,5.7,4,4,2,0,2,0,3,0.0,3,5,0,5,1,5,5,0,FW,30-34,Forward,Colombia,South America
158,Daniel Bachmann,AUT,Watford,Premier League,2021,27.0,1994.0,12.0,0,0,0,0,0,0,0,,0,0,0,0,1,1,5,0,GK,25-29,Goalkeeper,Austria,Europe
160,Milan Badelj,CRO,Genoa,Serie A,2021,32.0,1989.0,31.6,64,37,25,30,9,34,80,42.5,46,39,7,32,85,149,43,0,MF,30-34,Midfielder,Croatia,Europe
162,Benoît Badiashile,FRA,Monaco,Ligue 1,2021,20.0,2001.0,20.4,36,19,21,15,0,14,23,60.9,9,18,12,6,28,64,68,1,DF,20-24,Defender,France,Europe
166,Issa Bah,LUX,Venezia,Serie A,2021,19.0,2002.0,0.1,0,0,0,0,0,0,0,,0,0,0,0,0,0,0,0,FW,Under 20,Forward,Luxembourg,Europe
168,Leon Bailey,JAM,Aston Villa,Premier League,2021,23.0,1997.0,8.5,17,11,6,8,3,6,13,46.2,7,10,1,9,1,18,2,0,"FW,MF",20-24,Forward,Jamaica,North America
169,Eric Bailly,CIV,Manchester Utd,Premier League,2021,27.0,1994.0,2.4,5,4,4,0,1,3,4,75.0,1,4,2,2,3,8,11,0,DF,25-29,Defender,Ivory Coast,Africa
171,Stefan Bajic,FRA,Saint-Étienne,Ligue 1,2021,19.0,2001.0,5.7,0,0,0,0,0,0,0,,0,0,0,0,0,0,4,0,GK,Under 20,Goalkeeper,France,Europe
173,Cédric Bakambu,COD,Marseille,Ligue 1,2021,30.0,1991.0,4.0,2,0,1,0,1,0,3,0.0,3,2,0,2,0,2,1,0,FW,30-34,Forward,DR Congo,Africa
174,Abdoulaye Bakayoko,FRA,Saint-Étienne,Ligue 1,2021,18.0,2002.0,3.4,15,9,13,2,0,8,12,66.7,4,5,4,1,12,27,15,0,DF,Under 20,Defender,France,Europe
176,Mitchel Bakker,NED,Leverkusen,Bundesliga,2021,21.0,2000.0,20.2,33,22,16,12,5,20,34,58.8,14,13,2,11,23,56,42,3,DF,20-24,Defender,Netherlands,Europe
177,Ridle Baku,GER,Wolfsburg,Bundesliga,2021,23.0,1998.0,27.2,62,37,30,24,8,25,65,38.5,40,43,1,42,21,83,52,1,"DF,FW",20-24,Defender,Germany,Europe
178,Dilane Bakwa,FRA,Bordeaux,Ligue 1,2021,18.0,2002.0,0.5,1,1,0,1,0,1,2,50.0,1,0,0,0,0,1,1,0,"FW,MF",Under 20,Forward,France,Europe
179,Tommaso Baldanzi,ITA,Empoli,Serie A,2021,18.0,2003.0,0.2,0,0,0,0,0,0,0,,0,1,0,1,0,0,0,0,FW,Under 20,Forward,Italy,Europe
181,Ibrahima Baldé,FRA,Lens,Ligue 1,2021,18.0,2003.0,0.6,0,0,0,0,0,0,0,,0,0,0,0,0,0,0,0,"FW,MF",Under 20,Forward,France,Europe
182,Keita Baldé,SEN,Cagliari,Serie A,2021,26.0,1995.0,13.7,8,4,1,5,2,1,10,10.0,9,6,0,6,4,12,6,0,FW,25-29,Forward,Senegal,Africa
183,Gareth Bale,WAL,Real Madrid,La Liga,2021,32.0,1989.0,3.1,2,1,1,0,1,1,4,25.0,3,2,0,2,2,4,1,0,FW,30-34,Forward,Wales,Europe
185,Leonardo Balerdi,ARG,Marseille,Ligue 1,2021,22.0,1999.0,10.6,9,6,9,0,0,5,14,35.7,9,11,4,7,19,28,30,0,DF,20-24,Defender,Argentina,South America
186,Iván Balliu,ALB,Rayo Vallecano,La Liga,2021,29.0,1992.0,35.0,45,22,25,11,9,19,31,61.3,12,24,5,19,39,84,64,0,DF,25-29,Defender,Albania,Europe
187,Fodé Ballo-Touré,SEN,Milan,Serie A,2021,24.0,1997.0,5.0,18,14,5,13,0,4,9,44.4,5,6,2,4,3,21,5,0,DF,20-24,Defender,Senegal,Africa
188,Folarin Balogun,USA,Arsenal,Premier League,2021,20.0,2001.0,0.8,1,1,0,0,1,0,0,,0,1,0,1,0,1,1,0,FW,20-24,Forward,United States,North America
189,Abdoulaye Bamba,CIV,Angers,Ligue 1,2021,31.0,1990.0,5.1,6,5,6,0,0,4,11,36.4,7,5,1,4,9,15,13,0,"DF,FW",30-34,Defender,Ivory Coast,Africa
190,Jonathan Bamba,CIV,Lille,Ligue 1,2021,25.0,1996.0,27.0,30,12,13,9,8,13,36,36.1,23,24,1,23,21,51,10,0,"MF,FW",25-29,Midfielder,Ivory Coast,Africa
191,Patrick Bamford,ENG,Leeds United,Premier League,2021,27.0,1993.0,6.2,1,0,0,1,0,0,3,0.0,3,8,2,6,2,3,8,0,FW,25-29,Forward,England,Europe
192,Filippo Bandinelli,ITA,Empoli,Serie A,2021,26.0,1995.0,21.7,33,20,10,17,6,15,31,48.4,16,22,5,17,10,43,37,2,MF,25-29,Midfielder,Italy,Europe
193,Mattia Bani,ITA,Genoa,Serie A,2021,27.0,1993.0,13.5,23,13,17,6,0,14,18,77.8,4,19,11,8,20,43,76,0,DF,25-29,Defender,Italy,Europe
195,Shandon Baptiste,GRN,Brentford,Premier League,2021,23.0,1998.0,10.1,14,4,9,4,1,6,15,40.0,9,10,0,10,11,25,12,0,MF,20-24,Midfielder,Grenada,North America
198,Danilo Barbosa,BRA,Nice,Ligue 1,2021,25.0,1996.0,1.0,0,0,0,0,0,0,0,,0,1,1,0,2,2,10,0,DF,25-29,Defender,Brazil,South America
201,Melvin Bard,FRA,Nice,Ligue 1,2021,20.0,2000.0,28.8,59,37,38,17,4,41,63,65.1,22,33,10,23,51,110,56,0,DF,20-24,Defender,France,Europe
203,Francesco Bardi,ITA,Bologna,Serie A,2021,29.0,1992.0,2.0,0,0,0,0,0,0,0,,0,0,0,0,0,0,0,0,GK,25-29,Goalkeeper,Italy,Europe
204,Keidi Bare,ALB,Espanyol,La Liga,2021,23.0,1997.0,16.5,27,17,14,12,1,11,31,35.5,20,20,10,10,15,42,26,1,MF,20-24,Midfielder,Albania,Europe
205,Nicolò Barella,ITA,Inter,Serie A,2021,24.0,1997.0,32.4,63,42,17,35,11,29,55,52.7,26,26,2,24,21,84,8,2,MF,20-24,Midfielder,Italy,Europe
207,Ross Barkley,ENG,Chelsea,Premier League,2021,27.0,1993.0,2.0,0,0,0,0,0,0,1,0.0,1,1,0,1,1,1,0,0,"MF,FW",25-29,Midfielder,England,Europe
208,Aymen Barkok,MAR,Eint Frankfurt,Bundesliga,2021,23.0,1998.0,1.8,6,2,2,3,1,2,7,28.6,5,4,1,3,5,11,6,0,"MF,DF",20-24,Midfielder,Morocco,Africa
209,Ashley Barnes,ENG,Burnley,Premier League,2021,31.0,1989.0,9.0,11,2,2,7,2,2,9,22.2,7,8,1,7,2,13,5,0,FW,30-34,Forward,England,Europe
210,Harvey Barnes,ENG,Leicester City,Premier League,2021,23.0,1997.0,23.3,31,16,9,11,11,7,23,30.4,16,24,1,23,5,36,7,0,"FW,MF",20-24,Forward,England,Europe
215,Musa Barrow,GAM,Bologna,Serie A,2021,22.0,1998.0,23.7,12,4,4,4,4,6,20,30.0,14,20,1,19,6,18,8,0,"FW,MF",20-24,Forward,Gambia,Africa
216,Abdourahmane Barry,GUI,Greuther Fürth,Bundesliga,2021,21.0,2000.0,2.3,6,4,3,3,0,5,7,71.4,2,5,2,3,4,10,1,0,DF,20-24,Defender,Guinea,Africa
218,Daniele Baselli,ITA,Torino,Serie A,2021,29.0,1992.0,1.7,3,3,2,0,1,2,6,33.3,4,0,0,0,1,4,2,0,"MF,FW",25-29,Midfielder,Italy,Europe
219,Daniele Baselli,ITA,Cagliari,Serie A,2021,29.0,1992.0,3.2,6,5,3,1,2,1,5,20.0,4,2,0,2,2,8,5,0,MF,25-29,Midfielder,Italy,Europe
220,Toma Bašić,CRO,Lazio,Serie A,2021,24.0,1996.0,10.9,12,8,3,9,0,5,17,29.4,12,13,4,9,4,16,21,0,MF,20-24,Midfielder,Croatia,Europe
221,Toma Bašić,CRO,Bordeaux,Ligue 1,2021,24.0,1996.0,2.3,2,2,1,0,1,0,4,0.0,4,4,1,3,2,4,0,0,MF,20-24,Midfielder,Croatia,Europe
222,Amine Bassi,FRA,Metz,Ligue 1,2021,23.0,1997.0,2.0,6,3,2,3,1,1,3,33.3,2,5,0,5,0,6,0,0,"MF,FW",20-24,Midfielder,France,Europe
224,Alessandro Bastoni,ITA,Inter,Serie A,2021,22.0,1999.0,25.7,44,25,28,13,3,17,34,50.0,17,22,12,10,35,79,59,1,DF,20-24,Defender,Italy,Europe
225,Simone Bastoni,ITA,Spezia,Serie A,2021,24.0,1996.0,25.4,52,34,28,17,7,21,65,32.3,44,38,11,27,30,82,31,0,"MF,DF",20-24,Midfielder,Italy,Europe
226,Lewis Bate,ENG,Leeds United,Premier League,2021,18.0,2002.0,1.6,1,0,0,0,1,0,8,0.0,8,1,0,1,1,2,1,0,MF,Under 20,Midfielder,England,Europe
227,Rodrigo Battaglia,ARG,Mallorca,La Liga,2021,30.0,1991.0,13.1,32,16,13,19,0,15,30,50.0,15,21,10,11,10,42,36,0,MF,30-34,Midfielder,Argentina,South America
228,Maximilian Bauer,GER,Greuther Fürth,Bundesliga,2021,21.0,2000.0,18.8,28,15,17,10,1,11,28,39.3,17,24,14,10,29,57,99,0,DF,20-24,Defender,Germany,Europe
229,Oliver Baumann,GER,Hoffenheim,Bundesliga,2021,31.0,1990.0,33.0,0,0,0,0,0,0,3,0.0,3,0,0,0,0,0,19,1,GK,30-34,Goalkeeper,Germany,Europe
230,Timo Baumgartl,GER,Union Berlin,Bundesliga,2021,25.0,1996.0,24.1,59,28,34,21,4,31,47,66.0,16,27,11,16,37,96,58,0,DF,25-29,Defender,Germany,Europe
231,Julian Baumgartlinger,AUT,Leverkusen,Bundesliga,2021,33.0,1988.0,1.0,3,1,2,1,0,1,2,50.0,1,1,0,1,2,5,0,0,"MF,FW",30-34,Midfielder,Austria,Europe
232,Christoph Baumgartner,AUT,Hoffenheim,Bundesliga,2021,21.0,1999.0,21.0,28,15,14,7,7,13,32,40.6,19,24,3,21,8,36,16,0,"MF,FW",20-24,Midfielder,Austria,Europe
234,Paul Baysse,FRA,Bordeaux,Ligue 1,2021,33.0,1988.0,0.1,1,1,0,1,0,0,0,,0,0,0,0,0,1,1,0,"MF,DF",30-34,Midfielder,France,Europe
235,Noah Joel Sarenren Bazee,NGA,Augsburg,Bundesliga,2021,24.0,1996.0,2.7,5,2,2,2,1,3,4,75.0,1,8,2,6,1,6,4,0,"MF,FW",20-24,Midfielder,Nigeria,Africa
236,Bebé,CPV,Rayo Vallecano,La Liga,2021,31.0,1990.0,9.6,6,5,1,3,2,4,16,25.0,12,18,0,18,3,9,6,0,FW,30-34,Forward,Cape Verde,Africa
240,Sheraldo Becker,SUR,Union Berlin,Bundesliga,2021,26.0,1995.0,19.5,9,6,3,4,2,6,18,33.3,12,11,0,11,2,11,4,0,"FW,MF",25-29,Forward,Suriname,South America
242,Donny van de Beek,NED,Manchester Utd,Premier League,2021,24.0,1997.0,0.8,6,4,4,1,1,1,2,50.0,1,5,1,4,2,8,1,0,MF,20-24,Midfielder,Netherlands,Europe
243,Donny van de Beek,NED,Everton,Premier League,2021,24.0,1997.0,5.4,15,7,8,6,1,6,13,46.2,7,6,2,4,6,21,4,0,MF,20-24,Midfielder,Netherlands,Europe
245,Valon Behrami,SUI,Genoa,Serie A,2021,36.0,1985.0,3.5,3,1,0,2,1,0,7,0.0,7,4,1,3,1,4,4,0,"MF,FW",35-39,Midfielder,Switzerland,Europe
246,Kevin Behrens,GER,Union Berlin,Bundesliga,2021,30.0,1991.0,5.5,3,2,1,1,1,0,4,0.0,4,3,0,3,3,6,7,0,FW,30-34,Forward,Germany,Europe
247,Youcef Belaïli,ALG,Brest,Ligue 1,2021,29.0,1992.0,9.2,2,1,0,0,2,2,9,22.2,7,5,1,4,7,9,4,0,"MF,FW",25-29,Midfielder,Algeria,Africa
249,Ishak Belfodil,ALG,Hertha BSC,Bundesliga,2021,29.0,1992.0,18.2,9,6,4,4,1,4,8,50.0,4,9,1,8,5,14,16,0,FW,25-29,Forward,Algeria,Africa
250,Haris Belkebla,ALG,Brest,Ligue 1,2021,27.0,1994.0,25.7,46,23,21,21,4,18,39,46.2,21,26,6,20,48,94,30,1,MF,25-29,Midfielder,Algeria,Africa
251,Stefan Bell,GER,Mainz 05,Bundesliga,2021,29.0,1991.0,31.8,54,23,37,16,1,30,63,47.6,33,26,15,11,41,95,112,1,DF,25-29,Defender,Germany,Europe
253,Raoul Bellanova,ITA,Cagliari,Serie A,2021,21.0,2000.0,27.7,29,15,14,12,3,6,27,22.2,21,39,8,31,21,50,51,0,"DF,FW",20-24,Defender,Italy,Europe
254,Karim Bellarabi,GER,Leverkusen,Bundesliga,2021,31.0,1990.0,7.6,9,4,4,4,1,3,13,23.1,10,5,0,5,9,18,4,0,"FW,MF",30-34,Forward,Germany,Europe
255,Jean-Ricner Bellegarde,FRA,Strasbourg,Ligue 1,2021,23.0,1998.0,25.9,51,32,21,21,9,17,41,41.5,24,29,4,25,27,78,19,0,MF,20-24,Midfielder,France,Europe
257,Jude Bellingham,ENG,Dortmund,Bundesliga,2021,18.0,2003.0,31.0,52,34,15,31,6,21,53,39.6,32,50,4,46,42,94,32,0,MF,Under 20,Midfielder,England,Europe
258,George Bello,USA,Arminia,Bundesliga,2021,19.0,2002.0,4.8,7,7,7,0,0,4,4,100.0,0,5,4,1,6,13,11,0,DF,Under 20,Defender,United States,North America
262,Hatem Ben Arfa,FRA,Lille,Ligue 1,2021,34.0,1987.0,3.5,4,2,2,1,1,2,4,50.0,2,3,0,3,0,4,1,0,"FW,MF",30-34,Forward,France,Europe
263,Salim Ben Seghir,FRA,Marseille,Ligue 1,2021,18.0,2003.0,0.0,0,0,0,0,0,0,0,,0,0,0,0,0,0,0,0,MF,Under 20,Midfielder,France,Europe
264,Wissam Ben Yedder,FRA,Monaco,Ligue 1,2021,30.0,1990.0,28.1,18,8,1,11,6,6,15,40.0,9,12,1,11,0,18,1,0,FW,30-34,Forward,France,Europe
265,Marco Benassi,ITA,Fiorentina,Serie A,2021,26.0,1994.0,1.8,1,0,1,0,0,1,2,50.0,1,3,0,3,3,4,3,0,"DF,MF",25-29,Defender,Italy,Europe
266,Marco Benassi,ITA,Empoli,Serie A,2021,26.0,1994.0,4.2,6,3,3,2,1,1,10,10.0,9,4,0,4,3,9,6,0,MF,25-29,Midfielder,Italy,Europe
267,Darío Benedetto,ARG,Elche,La Liga,2021,31.0,1990.0,6.6,5,1,2,2,1,3,6,50.0,3,4,0,4,1,6,1,0,"FW,MF",30-34,Forward,Argentina,South America
268,Darío Benedetto,ARG,Marseille,Ligue 1,2021,31.0,1990.0,0.6,0,0,0,0,0,0,0,,0,2,0,2,0,0,0,0,"FW,MF",30-34,Forward,Argentina,South America
269,László Bénes,SVK,Gladbach,Bundesliga,2021,23.0,1997.0,2.7,5,3,1,3,1,1,6,16.7,5,5,2,3,2,7,5,0,MF,20-24,Midfielder,Slovakia,Europe
272,Loris Benito,SUI,Bordeaux,Ligue 1,2021,29.0,1992.0,0.7,0,0,0,0,0,0,0,,0,0,0,0,1,1,3,1,DF,25-29,Defender,Switzerland,Europe
275,Ismaël Bennacer,ALG,Milan,Serie A,2021,23.0,1997.0,16.9,44,30,22,15,7,21,50,42.0,29,20,4,16,25,69,15,0,MF,20-24,Midfielder,Algeria,Africa
276,Keanan Bennetts,ENG,Gladbach,Bundesliga,2021,22.0,1999.0,0.6,2,0,1,1,0,1,1,100.0,0,1,0,1,0,2,0,0,"FW,DF",20-24,Forward,England,Europe
277,Saïd Benrahma,ALG,West Ham,Premier League,2021,25.0,1995.0,24.1,28,17,16,9,3,15,38,39.5,23,17,1,16,9,37,8,0,"FW,MF",25-29,Forward,Algeria,Africa
278,Ramy Bensebaini,ALG,Gladbach,Bundesliga,2021,26.0,1995.0,22.4,42,30,24,15,3,27,44,61.4,17,33,7,26,39,81,77,1,DF,25-29,Defender,Algeria,Africa
279,Nabil Bentaleb,ALG,Angers,Ligue 1,2021,26.0,1994.0,16.8,42,24,15,20,7,16,29,55.2,13,24,9,15,28,70,13,0,MF,25-29,Midfielder,Algeria,Africa
280,Rodrigo Bentancur,URU,Tottenham,Premier League,2021,24.0,1997.0,15.1,36,18,14,14,8,16,32,50.0,16,24,9,15,20,56,35,0,MF,20-24,Midfielder,Uruguay,South America
281,Rodrigo Bentancur,URU,Juventus,Serie A,2021,24.0,1997.0,12.8,32,18,11,18,3,7,20,35.0,13,15,2,13,26,58,15,1,MF,20-24,Midfielder,Uruguay,South America
282,Christian Benteke,BEL,Crystal Palace,Premier League,2021,30.0,1990.0,12.7,3,2,1,2,0,2,6,33.3,4,7,3,4,2,5,33,0,FW,30-34,Forward,Belgium,Europe
283,Karim Benzema,FRA,Real Madrid,La Liga,2021,33.0,1987.0,28.8,11,9,5,3,3,2,9,22.2,7,10,0,10,4,15,13,0,FW,30-34,Forward,France,Europe
284,Alessandro Berardi,ITA,Hellas Verona,Serie A,2021,30.0,1991.0,1.0,0,0,0,0,0,0,0,,0,0,0,0,0,0,0,0,GK,30-34,Goalkeeper,Italy,Europe
285,Domenico Berardi,ITA,Sassuolo,Serie A,2021,26.0,1994.0,31.3,32,19,9,16,7,15,57,26.3,42,39,2,37,31,63,23,0,FW,25-29,Forward,Italy,Europe
293,Etrit Berisha,ALB,Torino,Serie A,2021,32.0,1989.0,10.0,0,0,0,0,0,0,0,,0,0,0,0,0,0,4,0,GK,30-34,Goalkeeper,Albania,Europe
295,Federico Bernardeschi,ITA,Juventus,Serie A,2021,27.0,1994.0,16.4,16,10,7,4,5,6,13,46.2,7,12,4,8,5,21,15,0,"MF,FW",25-29,Midfielder,Italy,Europe
299,Dimitry Bertaud,COD,Montpellier,Ligue 1,2021,23.0,1998.0,9.3,0,0,0,0,0,0,1,0.0,1,0,0,0,0,0,5,1,GK,20-24,Goalkeeper,DR Congo,Africa
300,Jason Berthomier,FRA,Clermont Foot,Ligue 1,2021,31.0,1990.0,19.2,29,14,5,17,7,12,34,35.3,22,14,2,12,8,37,4,1,MF,30-34,Midfielder,France,Europe
301,Nicolò Bertola,ITA,Spezia,Serie A,2021,18.0,2003.0,0.4,3,2,3,0,0,3,4,75.0,1,0,0,0,3,6,1,0,"MF,DF",Under 20,Midfielder,Italy,Europe
302,Ryan Bertrand,ENG,Leicester City,Premier League,2021,31.0,1989.0,3.7,8,5,3,4,1,2,5,40.0,3,8,3,5,1,9,7,0,DF,30-34,Defender,England,Europe
303,Daniel Bessa,ITA,Hellas Verona,Serie A,2021,28.0,1993.0,8.5,7,2,3,3,1,4,15,26.7,11,13,3,10,5,12,11,0,MF,25-29,Midfielder,Italy,Europe
304,Beto,GNB,Udinese,Serie A,2021,23.0,1998.0,24.1,21,6,2,14,5,9,19,47.4,10,16,1,15,5,26,25,1,FW,20-24,Forward,Guinea-Bissau,Africa
304,Beto,GNB,Udinese,Serie A,2021,23.0,1998.0,24.1,21,6,2,14,5,9,19,47.4,10,16,1,15,5,26,25,1,FW,20-24,Forward,Guinea-Bissau,Africa
304,Beto,GNB,Udinese,Serie A,2021,23.0,1998.0,24.1,21,6,2,14,5,9,19,47.4,10,16,1,15,5,26,25,1,FW,20-24,Forward,Guinea-Bissau,Africa
304,Beto,GNB,Udinese,Serie A,2021,23.0,1998.0,24.1,21,6,2,14,5,9,19,47.4,10,16,1,15,5,26,25,1,FW,20-24,Forward,Guinea-Bissau,Africa
305,Jordan Beyer,GER,Gladbach,Bundesliga,2021,21.0,2000.0,15.4,46,27,32,13,1,23,39,59.0,16,18,5,13,15,61,52,2,DF,20-24,Defender,Germany,Europe
311,El Bilal Touré,MLI,Reims,Ligue 1,2021,19.0,2001.0,13.3,13,6,4,6,3,2,7,28.6,5,10,3,7,6,19,19,0,FW,Under 20,Forward,Mali,Africa
312,Jean-Claude Billong,CMR,Clermont Foot,Ligue 1,2021,27.0,1993.0,10.9,17,8,14,1,2,8,11,72.7,3,9,1,8,10,27,35,0,DF,25-29,Defender,Cameroon,Africa
313,Luis Binks,ENG,Bologna,Serie A,2021,19.0,2001.0,7.2,8,4,7,1,0,4,6,66.7,2,6,5,1,17,25,33,1,DF,Under 20,Defender,England,Europe
314,Cristiano Biraghi,ITA,Fiorentina,Serie A,2021,28.0,1992.0,35.0,37,24,17,15,5,22,53,41.5,31,28,10,18,19,56,31,1,DF,25-29,Defender,Italy,Europe
316,Tom Bischof,GER,Hoffenheim,Bundesliga,2021,16.0,2005.0,0.2,0,0,0,0,0,0,0,,0,1,0,1,0,0,1,0,MF,Under 20,Midfielder,Germany,Europe
317,Yves Bissouma,MLI,Brighton,Premier League,2021,24.0,1996.0,23.5,76,49,35,37,4,21,37,56.8,16,33,3,30,50,126,49,0,MF,20-24,Midfielder,Mali,Africa
319,Marco Bizot,NED,Brest,Ligue 1,2021,30.0,1991.0,38.0,3,1,3,0,0,3,5,60.0,2,1,0,1,0,3,24,1,GK,30-34,Goalkeeper,Netherlands,Europe
320,Bjarki Bjarkason,ISL,Venezia,Serie A,2021,21.0,2000.0,0.0,0,0,0,0,0,0,0,,0,0,0,0,0,0,0,0,MF,20-24,Midfielder,Iceland,Europe
322,Ludovic Blas,FRA,Nantes,Ligue 1,2021,23.0,1997.0,32.9,33,18,7,20,6,15,44,34.1,29,33,3,30,31,64,6,1,"MF,FW",20-24,Midfielder,France,Europe
323,Danny Blum,GER,Bochum,Bundesliga,2021,30.0,1991.0,3.8,2,1,0,0,2,0,2,0.0,2,4,0,4,2,4,1,0,FW,30-34,Forward,Germany,Europe
324,Myron Boadu,NED,Monaco,Ligue 1,2021,20.0,2001.0,10.7,9,7,2,3,4,1,5,20.0,4,6,0,6,2,11,1,0,FW,20-24,Forward,Netherlands,Europe
325,Jérôme Boateng,GER,Lyon,Ligue 1,2021,32.0,1988.0,18.0,20,15,11,9,0,9,17,52.9,8,20,10,10,20,40,73,0,DF,30-34,Defender,Germany,Europe
326,Kevin-Prince Boateng,GHA,Hertha BSC,Bundesliga,2021,34.0,1987.0,7.7,6,5,1,4,1,3,9,33.3,6,7,2,5,6,12,11,0,"MF,FW",30-34,Midfielder,Ghana,Africa
327,Antonin Bobichon,FRA,Angers,Ligue 1,2021,25.0,1995.0,0.4,1,0,0,1,0,0,0,,0,0,0,0,1,2,0,0,"MF,FW",25-29,Midfielder,France,Europe
328,Herbert Bockhorn,GER,Bochum,Bundesliga,2021,26.0,1995.0,9.4,20,14,13,4,3,12,20,60.0,8,10,1,9,14,34,18,0,DF,25-29,Defender,Germany,Europe
329,Jean-Paul Boëtius,NED,Mainz 05,Bundesliga,2021,27.0,1994.0,20.0,40,23,18,17,5,22,53,41.5,31,41,3,38,25,65,11,0,MF,25-29,Midfielder,Netherlands,Europe
332,Luka Bogdan,CRO,Salernitana,Serie A,2021,25.0,1996.0,4.4,6,3,6,0,0,4,8,50.0,4,3,2,1,6,12,21,0,DF,25-29,Defender,Croatia,Europe
334,Quentin Boisgard,FRA,Lorient,Ligue 1,2021,24.0,1997.0,10.6,19,11,6,10,3,8,17,47.1,9,15,0,15,6,25,5,0,"MF,FW",20-24,Midfielder,France,Europe
335,Charles Boli,FRA,Lens,Ligue 1,2021,22.0,1998.0,0.4,2,1,0,2,0,0,0,,0,0,0,0,0,2,0,0,"MF,DF",20-24,Midfielder,France,Europe
336,Willy Boly,CIV,Wolves,Premier League,2021,30.0,1991.0,10.0,25,19,18,7,0,8,15,53.3,7,14,6,8,14,39,35,0,DF,30-34,Defender,Ivory Coast,Africa
337,Giacomo Bonaventura,ITA,Fiorentina,Serie A,2021,31.0,1989.0,25.2,33,17,12,16,5,21,46,45.7,25,20,2,18,14,47,9,1,MF,30-34,Midfielder,Italy,Europe
338,Federico Bonazzoli,ITA,Salernitana,Serie A,2021,24.0,1997.0,20.7,24,12,9,8,7,6,25,24.0,19,17,1,16,6,30,7,0,"FW,MF",20-24,Forward,Italy,Europe
339,Tarsis Bonga,GER,Bochum,Bundesliga,2021,24.0,1997.0,0.2,0,0,0,0,0,0,0,,0,0,0,0,0,0,0,0,"MF,FW",20-24,Midfielder,Germany,Europe
340,Kevin Bonifazi,ITA,Bologna,Serie A,2021,25.0,1996.0,13.4,25,16,16,7,2,13,14,92.9,1,22,7,15,16,41,35,0,DF,25-29,Defender,Italy,Europe
341,Solomon Bonnah,NED,RB Leipzig,Bundesliga,2021,17.0,2003.0,0.1,0,0,0,0,0,0,0,,0,1,0,1,1,1,0,0,DF,Under 20,Defender,Netherlands,Europe
343,Sebastiaan Bornauw,BEL,Wolfsburg,Bundesliga,2021,22.0,1999.0,22.3,30,19,23,5,2,16,25,64.0,9,29,8,21,42,72,97,1,DF,20-24,Defender,Belgium,Europe
344,Rafael Borré,COL,Eint Frankfurt,Bundesliga,2021,25.0,1995.0,26.4,31,22,4,13,14,7,33,21.2,26,24,4,20,5,36,9,0,FW,25-29,Forward,Colombia,South America
345,Sven Botman,NED,Lille,Ligue 1,2021,21.0,2000.0,25.0,24,11,13,11,0,12,18,66.7,6,32,21,11,26,50,116,0,DF,20-24,Defender,Netherlands,Europe
346,Denis Bouanga,GAB,Saint-Étienne,Ligue 1,2021,26.0,1994.0,27.1,46,25,14,13,19,22,63,34.9,41,30,0,30,8,54,34,1,"FW,MF",25-29,Forward,Gabon,Africa
347,Hicham Boudaoui,ALG,Nice,Ligue 1,2021,21.0,1999.0,18.0,31,18,15,10,6,13,36,36.1,23,17,4,13,18,49,15,0,MF,20-24,Midfielder,Algeria,Africa
348,Ryad Boudebouz,ALG,Saint-Étienne,Ligue 1,2021,31.0,1990.0,25.0,27,15,11,12,4,12,29,41.4,17,17,2,15,10,37,5,0,"MF,FW",30-34,Midfielder,Algeria,Africa
350,Farid Boulaya,ALG,Metz,Ligue 1,2021,28.0,1993.0,17.0,18,10,7,9,2,14,38,36.8,24,8,2,6,12,30,5,0,"MF,FW",25-29,Midfielder,Algeria,Africa
354,Benjamin Bourigeaud,FRA,Rennes,Ligue 1,2021,27.0,1994.0,35.5,46,24,16,18,12,24,67,35.8,43,33,3,30,30,76,44,0,"FW,MF",25-29,Forward,France,Europe
356,Edoardo Bove,ITA,Roma,Serie A,2021,19.0,2002.0,0.8,1,1,1,0,0,0,2,0.0,2,1,0,1,1,2,0,0,"MF,DF",Under 20,Midfielder,Italy,Europe
357,Jarrod Bowen,ENG,West Ham,Premier League,2021,24.0,1996.0,33.1,36,20,20,11,5,17,44,38.6,27,29,2,27,21,57,14,0,FW,20-24,Forward,England,Europe
359,Lucas Boyé,ARG,Elche,La Liga,2021,25.0,1996.0,19.0,27,13,5,15,7,9,24,37.5,15,24,1,23,2,29,23,0,FW,25-29,Forward,Argentina,South America
360,Domagoj Bradarić,CRO,Lille,Ligue 1,2021,21.0,1999.0,4.6,11,9,8,2,1,7,12,58.3,5,5,2,3,10,21,7,1,DF,20-24,Defender,Croatia,Europe
363,Martin Braithwaite,DEN,Barcelona,La Liga,2021,30.0,1991.0,2.6,1,1,0,0,1,0,0,,0,2,0,2,1,2,1,0,FW,30-34,Forward,Denmark,Europe
364,Julian Brandt,GER,Dortmund,Bundesliga,2021,25.0,1996.0,23.1,37,19,13,20,4,17,54,31.5,37,19,2,17,24,61,14,1,"MF,FW",25-29,Midfielder,Germany,Europe
365,Jarrad Branthwaite,ENG,Everton,Premier League,2021,19.0,2002.0,4.3,4,1,3,1,0,3,8,37.5,5,3,2,1,1,5,20,0,DF,Under 20,Defender,England,Europe
367,Lilian Brassier,FRA,Brest,Ligue 1,2021,21.0,1999.0,25.1,40,24,23,13,4,10,21,47.6,11,31,21,10,32,72,86,0,DF,20-24,Defender,France,Europe
368,Claudio Bravo,CHI,Betis,La Liga,2021,38.0,1983.0,16.2,0,0,0,0,0,0,0,,0,0,0,0,0,0,6,2,GK,35-39,Goalkeeper,Chile,South America
370,Fabian Bredlow,GER,Stuttgart,Bundesliga,2021,26.0,1995.0,4.0,0,0,0,0,0,0,0,,0,0,0,0,0,0,1,0,GK,25-29,Goalkeeper,Germany,Europe
374,Jimmy Briand,FRA,Bordeaux,Ligue 1,2021,35.0,1985.0,2.5,2,0,2,0,0,0,2,0.0,2,0,0,0,1,3,2,0,"FW,MF",35-39,Forward,France,Europe
377,Armando Broja,ALB,Southampton,Premier League,2021,19.0,2001.0,21.9,12,5,2,7,3,2,9,22.2,7,17,1,16,3,15,11,0,FW,Under 20,Forward,Albania,Europe
378,Dylan Bronn,TUN,Metz,Ligue 1,2021,26.0,1995.0,28.3,47,29,33,13,1,20,31,64.5,11,32,19,13,40,87,78,1,DF,25-29,Defender,Tunisia,Africa
379,John Brooks,USA,Wolfsburg,Bundesliga,2021,28.0,1993.0,29.1,47,25,25,18,4,36,60,60.0,24,33,19,14,41,88,125,1,DF,25-29,Defender,United States,North America
380,Daniel Brosinski,GER,Mainz 05,Bundesliga,2021,33.0,1988.0,4.3,2,1,1,1,0,1,1,100.0,0,6,0,6,3,5,9,0,DF,30-34,Defender,Germany,Europe
381,Josh Brownhill,ENG,Burnley,Premier League,2021,25.0,1995.0,32.8,73,37,25,42,6,21,53,39.6,32,37,12,25,68,141,42,1,MF,25-29,Midfielder,England,Europe
383,Cédric Brunner,SUI,Arminia,Bundesliga,2021,27.0,1994.0,24.3,51,35,29,20,2,25,49,51.0,24,27,10,17,43,94,84,0,DF,25-29,Defender,Switzerland,Europe
385,Jacob Bruun Larsen,DEN,Hoffenheim,Bundesliga,2021,22.0,1998.0,9.0,2,1,1,1,0,0,5,0.0,5,14,3,11,5,7,5,2,"FW,MF",20-24,Forward,Denmark,Europe
386,Ante Budimir,CRO,Osasuna,La Liga,2021,30.0,1991.0,19.3,24,10,3,15,6,6,19,31.6,13,22,4,18,3,27,16,0,FW,30-34,Forward,Croatia,Europe
388,Osman Bukari,GHA,Nantes,Ligue 1,2021,22.0,1998.0,11.2,18,8,7,6,5,8,22,36.4,14,8,0,8,8,26,1,0,"FW,MF",20-24,Forward,Ghana,Africa
390,Alessandro Buongiorno,ITA,Torino,Serie A,2021,22.0,1999.0,13.1,20,9,9,8,3,9,13,69.2,4,12,6,6,31,51,44,0,DF,20-24,Defender,Italy,Europe
391,Sascha Burchert,GER,Greuther Fürth,Bundesliga,2021,31.0,1989.0,14.0,1,1,1,0,0,1,2,50.0,1,0,0,0,0,1,11,1,GK,30-34,Goalkeeper,Germany,Europe
392,Delano Burgzorg,SUR,Mainz 05,Bundesliga,2021,22.0,1998.0,0.3,1,1,1,0,0,0,1,0.0,1,0,0,0,0,1,0,0,MF,20-24,Midfielder,Suriname,South America
393,Jonathan Burkardt,GER,Mainz 05,Bundesliga,2021,21.0,2000.0,29.0,17,8,0,10,7,6,25,24.0,19,31,5,26,8,25,16,0,"FW,MF",20-24,Forward,Germany,Europe
394,Roman Bürki,SUI,Dortmund,Bundesliga,2021,30.0,1990.0,1.0,0,0,0,0,0,0,0,,0,0,0,0,0,0,0,0,GK,30-34,Goalkeeper,Switzerland,Europe
395,Dan Burn,ENG,Newcastle Utd,Premier League,2021,29.0,1992.0,16.0,16,11,11,4,1,7,11,63.6,4,22,14,8,20,36,101,0,DF,25-29,Defender,England,Europe
396,Dan Burn,ENG,Brighton,Premier League,2021,29.0,1992.0,11.4,22,12,13,8,1,6,15,40.0,9,14,10,4,24,46,51,0,DF,25-29,Defender,England,Europe
398,Gianluca Busio,USA,Venezia,Serie A,2021,19.0,2002.0,21.7,53,28,27,20,6,28,63,44.4,35,45,13,32,21,74,30,1,MF,Under 20,Midfielder,United States,North America
404,Sam Byram,ENG,Norwich City,Premier League,2021,27.0,1993.0,11.4,24,15,17,6,1,19,27,70.4,8,21,11,10,22,46,48,0,DF,25-29,Defender,England,Europe
406,Willy Caballero,ARG,Southampton,Premier League,2021,39.0,1981.0,2.0,0,0,0,0,0,0,0,,0,0,0,0,0,0,2,1,GK,35-39,Goalkeeper,Argentina,South America
407,Rémy Cabella,FRA,Montpellier,Ligue 1,2021,31.0,1990.0,3.5,15,7,4,8,3,5,15,33.3,10,7,0,7,5,20,1,0,"MF,FW",30-34,Midfielder,France,Europe
408,Jimmy Cabot,FRA,Angers,Ligue 1,2021,27.0,1994.0,22.3,81,44,59,15,7,47,83,56.6,36,29,0,29,32,113,30,0,DF,25-29,Defender,France,Europe
411,Leandro Cabrera,URU,Espanyol,La Liga,2021,30.0,1991.0,37.0,37,24,27,10,0,21,34,61.8,13,32,23,9,44,81,222,2,DF,30-34,Defender,Uruguay,South America
412,Liberato Cacace,NZL,Empoli,Serie A,2021,20.0,2000.0,5.2,15,6,8,4,3,8,8,100.0,0,7,2,5,8,23,9,0,DF,20-24,Defender,New Zealand,Oceania
413,Martín Cáceres,URU,Cagliari,Serie A,2021,34.0,1987.0,9.2,13,7,5,5,3,4,12,33.3,8,12,3,9,14,27,21,0,DF,30-34,Defender,Uruguay,South America
414,Martín Cáceres,URU,Levante,La Liga,2021,34.0,1987.0,7.4,2,2,2,0,0,1,5,20.0,4,2,2,0,11,13,16,1,DF,30-34,Defender,Uruguay,South America
415,Anthony Caci,FRA,Strasbourg,Ligue 1,2021,24.0,1997.0,26.6,65,34,35,24,6,33,55,60.0,22,22,3,19,33,98,49,1,DF,20-24,Defender,France,Europe
416,Mathieu Cafaro,FRA,Reims,Ligue 1,2021,24.0,1997.0,2.1,4,2,3,1,0,0,7,0.0,7,2,0,2,3,7,1,0,"MF,FW",20-24,Midfielder,France,Europe
417,Yannick Cahuzac,FRA,Lens,Ligue 1,2021,36.0,1985.0,6.9,5,2,2,3,0,0,5,0.0,5,8,2,6,9,14,12,0,MF,35-39,Midfielder,France,Europe
418,Felipe Caicedo,ECU,Genoa,Serie A,2021,32.0,1988.0,3.2,3,3,0,2,1,0,1,0.0,1,1,0,1,0,3,4,0,FW,30-34,Forward,Ecuador,South America
419,Felipe Caicedo,ECU,Inter,Serie A,2021,32.0,1988.0,0.3,0,0,0,0,0,0,0,,0,1,0,1,0,0,0,0,"FW,DF",30-34,Forward,Ecuador,South America
420,Moisés Caicedo,ECU,Brighton,Premier League,2021,19.0,2001.0,7.3,16,10,7,7,2,5,12,41.7,7,18,4,14,10,26,7,0,MF,Under 20,Midfielder,Ecuador,South America
421,Marc-Aurèle Caillard,FRA,Metz,Ligue 1,2021,27.0,1994.0,17.1,0,0,0,0,0,0,2,0.0,2,0,0,0,2,2,9,1,GK,25-29,Goalkeeper,France,Europe
422,Jens Cajuste,SWE,Reims,Ligue 1,2021,21.0,1999.0,4.0,10,6,6,2,2,6,17,35.3,11,7,2,5,5,15,6,0,"MF,FW",20-24,Midfielder,Sweden,Europe
424,Davide Calabria,ITA,Milan,Serie A,2021,24.0,1996.0,23.5,62,37,31,23,8,37,72,51.4,35,25,5,20,23,85,40,1,DF,20-24,Defender,Italy,Europe
425,Riccardo Calafiori,ITA,Genoa,Serie A,2021,19.0,2002.0,0.9,1,0,0,0,1,1,2,50.0,1,2,1,1,2,3,4,0,DF,Under 20,Defender,Italy,Europe
426,Riccardo Calafiori,ITA,Roma,Serie A,2021,19.0,2002.0,1.9,5,4,2,2,1,1,5,20.0,4,3,0,3,3,8,1,0,DF,Under 20,Defender,Italy,Europe
427,Mattia Caldara,ITA,Venezia,Serie A,2021,27.0,1994.0,30.0,48,28,30,15,3,20,34,58.8,14,49,37,12,62,110,147,1,DF,25-29,Defender,Italy,Europe
431,Hakan Çalhanoğlu,TUR,Inter,Serie A,2021,27.0,1994.0,27.6,41,23,16,19,6,11,40,27.5,29,29,5,24,25,66,12,0,MF,25-29,Midfielder,Turkey,Asia
432,Daniel Caligiuri,ITA,Augsburg,Bundesliga,2021,33.0,1988.0,22.3,46,30,17,26,3,27,72,37.5,45,36,5,31,18,64,33,0,"DF,MF",30-34,Defender,Italy,Europe
435,Dominic Calvert-Lewin,ENG,Everton,Premier League,2021,24.0,1997.0,14.3,11,8,1,6,4,3,8,37.5,5,5,2,3,3,14,12,0,FW,20-24,Forward,England,Europe
436,Mahdi Camara,FRA,Saint-Étienne,Ligue 1,2021,23.0,1998.0,34.1,101,57,39,50,12,39,70,55.7,31,44,8,36,57,158,35,1,"MF,DF",20-24,Midfielder,France,Europe
437,Mamadou Camara,MLI,Troyes,Ligue 1,2021,20.0,2001.0,0.4,1,1,1,0,0,0,0,,0,0,0,0,0,1,0,0,FW,20-24,Forward,Mali,Africa
437,Mamadou Camara,MLI,Troyes,Ligue 1,2021,20.0,2001.0,0.4,1,1,1,0,0,0,0,,0,0,0,0,0,1,0,0,FW,20-24,Forward,Mali,Africa
437,Mamadou Camara,MLI,Troyes,Ligue 1,2021,20.0,2001.0,0.4,1,1,1,0,0,0,0,,0,0,0,0,0,1,0,0,FW,20-24,Forward,Mali,Africa
437,Mamadou Camara,MLI,Troyes,Ligue 1,2021,20.0,2001.0,0.4,1,1,1,0,0,0,0,,0,0,0,0,0,1,0,0,FW,20-24,Forward,Mali,Africa
439,Eduardo Camavinga,FRA,Real Madrid,La Liga,2021,18.0,2002.0,13.7,52,35,22,20,10,20,38,52.6,18,20,2,18,17,69,14,1,MF,Under 20,Midfielder,France,Europe
440,Eduardo Camavinga,FRA,Rennes,Ligue 1,2021,18.0,2002.0,1.6,4,1,2,1,1,2,5,40.0,3,1,1,0,1,5,3,0,MF,Under 20,Midfielder,France,Europe
441,Andrea Cambiaso,ITA,Genoa,Serie A,2021,21.0,2000.0,19.9,46,20,28,14,4,18,32,56.3,14,33,8,25,23,69,37,1,DF,20-24,Defender,Italy,Europe
444,Emre Can,GER,Dortmund,Bundesliga,2021,27.0,1994.0,18.8,36,22,20,16,0,15,30,50.0,15,26,10,16,36,72,40,2,"DF,MF",25-29,Defender,Germany,Europe
446,Matteo Cancellieri,ITA,Hellas Verona,Serie A,2021,19.0,2002.0,2.5,4,4,2,2,0,0,5,0.0,5,2,0,2,1,5,0,0,"MF,DF",Under 20,Midfielder,Italy,Europe
447,João Cancelo,POR,Manchester City,Premier League,2021,27.0,1994.0,35.9,83,54,33,35,15,46,91,50.5,45,25,3,22,59,142,45,1,DF,25-29,Defender,Portugal,Europe
448,Fali Candé,GNB,Metz,Ligue 1,2021,23.0,1998.0,10.8,30,18,13,15,2,13,31,41.9,18,11,2,9,6,36,21,0,DF,20-24,Defender,Guinea-Bissau,Africa
449,Antonio Candreva,ITA,Sampdoria,Serie A,2021,34.0,1987.0,34.7,27,16,9,11,7,19,55,34.5,36,23,2,21,33,60,19,0,"MF,FW",30-34,Midfielder,Italy,Europe
454,Pierrick Capelle,FRA,Angers,Ligue 1,2021,34.0,1987.0,13.3,36,24,16,17,3,18,52,34.6,34,12,1,11,16,52,20,0,"MF,DF",30-34,Midfielder,France,Europe
455,Leonardo Capezzi,ITA,Salernitana,Serie A,2021,26.0,1995.0,1.9,3,1,0,3,0,1,4,25.0,3,8,4,4,0,3,2,0,MF,25-29,Midfielder,Italy,Europe
456,Étienne Capoue,FRA,Villarreal,La Liga,2021,33.0,1988.0,25.4,44,26,18,23,3,15,28,53.6,13,17,5,12,35,79,51,0,MF,30-34,Midfielder,France,Europe
457,Gianluca Caprari,ITA,Hellas Verona,Serie A,2021,28.0,1993.0,30.4,43,25,10,22,11,17,51,33.3,34,32,0,32,4,47,7,0,"MF,FW",25-29,Midfielder,Italy,Europe
458,Francesco Caputo,ITA,Sampdoria,Serie A,2021,33.0,1987.0,31.0,5,2,1,3,1,1,6,16.7,5,5,0,5,2,7,10,0,FW,30-34,Forward,Italy,Europe
459,Francesco Caputo,ITA,Sassuolo,Serie A,2021,33.0,1987.0,1.7,0,0,0,0,0,0,0,,0,0,0,0,0,0,0,0,FW,30-34,Forward,Italy,Europe
460,Maxence Caqueret,FRA,Lyon,Ligue 1,2021,21.0,2000.0,25.9,73,40,29,36,8,30,80,37.5,50,38,10,28,43,116,26,2,MF,20-24,Midfielder,France,Europe
461,Andrea Carboni,ITA,Cagliari,Serie A,2021,20.0,2001.0,24.6,53,24,33,16,4,19,42,45.2,23,42,15,27,27,80,87,0,DF,20-24,Defender,Italy,Europe
464,Irvin Cardona,FRA,Brest,Ligue 1,2021,23.0,1997.0,14.8,13,7,5,4,4,3,16,18.8,13,10,0,10,5,18,17,0,"FW,MF",20-24,Forward,France,Europe
469,Yannick Carrasco,BEL,Atlético Madrid,La Liga,2021,27.0,1993.0,28.7,34,19,16,12,6,19,44,43.2,25,26,5,21,19,53,12,2,"FW,MF",25-29,Forward,Belgium,Europe
470,Guido Carrillo,ARG,Elche,La Liga,2021,30.0,1991.0,13.0,7,4,2,4,1,3,13,23.1,10,9,2,7,1,8,27,0,FW,30-34,Forward,Argentina,South America
472,William Carvalho,POR,Betis,La Liga,2021,29.0,1992.0,20.1,49,33,20,25,4,15,40,37.5,25,18,7,11,16,65,20,0,MF,25-29,Midfielder,Portugal,Europe
473,Nicolò Casale,ITA,Hellas Verona,Serie A,2021,23.0,1998.0,28.7,46,30,25,19,2,21,37,56.8,16,31,12,19,49,95,95,0,DF,20-24,Defender,Italy,Europe
474,Casemiro,BRA,Real Madrid,La Liga,2021,29.0,1992.0,28.5,79,51,45,30,4,30,67,44.8,37,65,19,46,38,117,65,3,MF,25-29,Midfielder,Brazil,South America
478,Francesco Cassata,ITA,Genoa,Serie A,2021,24.0,1997.0,0.1,0,0,0,0,0,0,0,,0,0,0,0,0,0,0,0,MF,20-24,Midfielder,Italy,Europe
479,Timothy Castagne,BEL,Leicester City,Premier League,2021,25.0,1995.0,23.6,67,31,38,22,7,27,43,62.8,16,28,9,19,29,96,54,1,DF,25-29,Defender,Belgium,Europe
480,Koen Casteels,BEL,Wolfsburg,Bundesliga,2021,29.0,1992.0,28.0,0,0,0,0,0,0,1,0.0,1,0,0,0,0,0,9,2,GK,25-29,Goalkeeper,Belgium,Europe
481,Jean-Charles Castelletto,CMR,Nantes,Ligue 1,2021,26.0,1995.0,27.9,45,24,27,17,1,25,35,71.4,10,38,27,11,30,75,73,0,DF,25-29,Defender,Cameroon,Africa
483,Gonzalo Castro,GER,Arminia,Bundesliga,2021,34.0,1987.0,4.8,8,3,4,4,0,1,5,20.0,4,3,0,3,3,11,3,0,"MF,FW",30-34,Midfielder,Germany,Europe
485,Gaetano Castrovilli,ITA,Fiorentina,Serie A,2021,24.0,1997.0,15.5,25,17,15,6,4,12,23,52.2,11,18,4,14,11,36,6,0,MF,20-24,Midfielder,Italy,Europe
486,Danilo Cataldi,ITA,Lazio,Serie A,2021,26.0,1994.0,19.0,36,17,15,17,4,12,38,31.6,26,24,12,12,17,53,19,1,MF,25-29,Midfielder,Italy,Europe
489,Edinson Cavani,URU,Manchester Utd,Premier League,2021,34.0,1987.0,8.5,4,1,0,3,1,2,8,25.0,6,6,0,6,2,6,8,0,FW,30-34,Forward,Uruguay,South America
491,Pietro Ceccaroni,ITA,Venezia,Serie A,2021,25.0,1995.0,34.7,55,31,33,18,4,25,36,69.4,11,45,32,13,30,85,143,0,DF,25-29,Defender,Italy,Europe
494,Zeki Çelik,TUR,Lille,Ligue 1,2021,24.0,1997.0,30.0,64,37,43,17,4,36,63,57.1,27,32,9,23,43,107,62,2,DF,20-24,Defender,Turkey,Asia
495,Fabien Centonze,FRA,Metz,Ligue 1,2021,25.0,1996.0,17.6,33,21,22,9,2,13,32,40.6,19,37,8,29,32,65,51,0,DF,25-29,Defender,France,Europe
496,Luca Ceppitelli,ITA,Cagliari,Serie A,2021,31.0,1989.0,16.1,23,12,13,10,0,16,27,59.3,11,21,14,7,25,48,54,0,DF,30-34,Defender,Italy,Europe
497,Franco Cervi,ARG,Celta Vigo,La Liga,2021,27.0,1994.0,20.0,73,41,35,22,16,33,77,42.9,44,38,2,36,21,94,19,0,MF,25-29,Midfielder,Argentina,South America
498,Damir Ceter,COL,Cagliari,Serie A,2021,23.0,1997.0,0.1,0,0,0,0,0,0,0,,0,0,0,0,0,0,0,0,FW,20-24,Forward,Colombia,South America
501,El Chadaille Bitshiabu,FRA,Paris S-G,Ligue 1,2021,16.0,2005.0,0.1,0,0,0,0,0,0,0,,0,0,0,0,0,0,2,0,DF,Under 20,Defender,France,Europe
502,Nassim Chadli,FRA,Troyes,Ligue 1,2021,20.0,2001.0,1.1,5,3,3,0,2,2,4,50.0,2,1,0,1,0,5,0,0,"MF,DF",20-24,Midfielder,France,Europe
504,Mehdi Chahiri,MAR,Strasbourg,Ligue 1,2021,25.0,1996.0,0.2,1,1,1,0,0,1,1,100.0,0,0,0,0,0,1,0,0,DF,25-29,Defender,Morocco,Africa
505,Trevoh Chalobah,ENG,Chelsea,Premier League,2021,22.0,1999.0,16.1,40,27,22,18,0,24,31,77.4,7,16,6,10,19,59,43,2,DF,20-24,Defender,England,Europe
506,Calum Chambers,ENG,Arsenal,Premier League,2021,26.0,1995.0,1.9,5,3,3,1,1,3,4,75.0,1,6,3,3,0,5,10,0,DF,25-29,Defender,England,Europe
507,Calum Chambers,ENG,Aston Villa,Premier League,2021,26.0,1995.0,9.2,16,8,10,6,0,4,6,66.7,2,14,8,6,5,21,42,0,DF,25-29,Defender,England,Europe
508,Dylan Chambost,FRA,Troyes,Ligue 1,2021,23.0,1997.0,8.4,16,11,6,9,1,4,25,16.0,21,9,2,7,8,24,4,0,"MF,FW",20-24,Midfielder,France,Europe
509,Timothy Chandler,USA,Eint Frankfurt,Bundesliga,2021,31.0,1990.0,13.5,18,12,10,8,0,11,24,45.8,13,10,3,7,19,37,28,1,DF,30-34,Defender,United States,North America
511,Brendan Chardonnet,FRA,Brest,Ligue 1,2021,26.0,1994.0,29.8,44,25,32,11,1,29,40,72.5,11,42,29,13,55,99,141,0,DF,25-29,Defender,France,Europe
512,Xavier Chavalerin,FRA,Troyes,Ligue 1,2021,30.0,1991.0,30.2,49,26,19,25,5,12,55,21.8,43,32,5,27,39,88,36,0,MF,30-34,Midfielder,France,Europe
513,Xavier Chavalerin,FRA,Reims,Ligue 1,2021,30.0,1991.0,2.4,4,4,2,1,1,1,3,33.3,2,2,0,2,5,9,2,1,MF,30-34,Midfielder,France,Europe
514,Justin Che,USA,Hoffenheim,Bundesliga,2021,17.0,2003.0,0.5,2,0,1,0,1,1,2,50.0,1,0,0,0,1,3,0,0,"FW,DF",Under 20,Forward,United States,North America
516,Rayan Cherki,FRA,Lyon,Ligue 1,2021,17.0,2003.0,4.9,6,2,1,3,2,4,9,44.4,5,2,0,2,1,7,0,0,"FW,MF",Under 20,Forward,France,Europe
517,Denis Cheryshev,RUS,Valencia,La Liga,2021,30.0,1990.0,6.3,14,5,6,1,7,6,15,40.0,9,9,1,8,9,23,9,0,"MF,FW",30-34,Midfielder,Russia,Europe
519,Giorgio Chiellini,ITA,Juventus,Serie A,2021,36.0,1984.0,15.0,22,13,17,4,1,7,13,53.8,6,24,18,6,22,44,59,0,DF,35-39,Defender,Italy,Europe
520,Federico Chiesa,ITA,Juventus,Serie A,2021,23.0,1997.0,9.6,26,19,9,9,8,12,26,46.2,14,7,0,7,4,30,3,0,"MF,FW",20-24,Midfielder,Italy,Europe
521,Ben Chilwell,ENG,Chelsea,Premier League,2021,24.0,1996.0,6.0,8,3,2,6,0,2,5,40.0,3,7,0,7,4,12,14,1,DF,20-24,Defender,England,Europe
522,Chiquinho,POR,Wolves,Premier League,2021,21.0,2000.0,2.3,9,6,4,5,0,4,5,80.0,1,5,0,5,2,11,1,0,"DF,FW",20-24,Defender,Portugal,Europe
522,Chiquinho,POR,Wolves,Premier League,2021,21.0,2000.0,2.3,9,6,4,5,0,4,5,80.0,1,5,0,5,2,11,1,0,"DF,FW",20-24,Defender,Portugal,Europe
522,Chiquinho,POR,Wolves,Premier League,2021,21.0,2000.0,2.3,9,6,4,5,0,4,5,80.0,1,5,0,5,2,11,1,0,"DF,FW",20-24,Defender,Portugal,Europe
522,Chiquinho,POR,Wolves,Premier League,2021,21.0,2000.0,2.3,9,6,4,5,0,4,5,80.0,1,5,0,5,2,11,1,0,"DF,FW",20-24,Defender,Portugal,Europe
525,Joris Chotard,FRA,Montpellier,Ligue 1,2021,19.0,2001.0,32.6,59,30,33,23,3,36,78,46.2,42,27,15,12,42,101,56,0,MF,Under 20,Midfielder,France,Europe
526,Hamza Choudhury,ENG,Leicester City,Premier League,2021,23.0,1997.0,3.2,9,3,4,4,1,3,5,60.0,2,0,0,0,12,21,10,0,"DF,MF",20-24,Defender,England,Europe
527,Andreas Christensen,DEN,Chelsea,Premier League,2021,25.0,1996.0,16.6,14,8,9,4,1,4,7,57.1,3,14,6,8,29,43,57,1,DF,25-29,Defender,Denmark,Europe
528,Max Christiansen,GER,Greuther Fürth,Bundesliga,2021,24.0,1996.0,22.8,46,25,19,22,5,18,43,41.9,25,52,16,36,68,114,56,0,MF,20-24,Midfielder,Germany,Europe
529,Carney Chukwuemeka,ENG,Aston Villa,Premier League,2021,17.0,2003.0,3.3,7,1,2,5,0,3,5,60.0,2,3,0,3,1,8,2,1,"MF,FW",Under 20,Midfielder,England,Europe
530,Samuel Chukwueze,NGA,Villarreal,La Liga,2021,22.0,1999.0,14.8,13,9,6,5,2,3,6,50.0,3,7,0,7,5,18,4,0,"MF,FW",20-24,Midfielder,Nigeria,Africa
532,Riccardo Ciervo,ITA,Sampdoria,Serie A,2021,19.0,2002.0,2.5,8,3,4,3,1,2,6,33.3,4,1,0,1,2,10,2,0,"MF,DF",Under 20,Midfielder,Italy,Europe
533,Jasper Cillessen,NED,Valencia,La Liga,2021,32.0,1989.0,16.2,0,0,0,0,0,0,1,0.0,1,0,0,0,1,1,6,0,GK,30-34,Goalkeeper,Netherlands,Europe
534,Pathé Ciss,SEN,Rayo Vallecano,La Liga,2021,27.0,1994.0,12.2,31,15,20,8,3,12,26,46.2,14,16,6,10,30,61,27,0,MF,25-29,Midfielder,Senegal,Africa
536,Giorgio Cittadini,ITA,Atalanta,Serie A,2021,19.0,2002.0,0.0,0,0,0,0,0,0,0,,0,0,0,0,1,1,0,0,DF,Under 20,Defender,Italy,Europe
537,Ciaran Clark,IRL,Newcastle Utd,Premier League,2021,31.0,1989.0,11.3,13,10,4,7,2,9,14,64.3,5,14,11,3,13,26,43,1,DF,30-34,Defender,Republic of Ireland,Europe
538,Alexis Claude-Maurice,FRA,Nice,Ligue 1,2021,23.0,1998.0,2.3,2,0,1,0,1,1,4,25.0,3,7,0,7,3,5,1,0,MF,20-24,Midfielder,France,Europe
539,Jonathan Clauss,FRA,Lens,Ligue 1,2021,28.0,1992.0,33.8,63,34,33,20,10,22,55,40.0,33,43,1,42,73,136,51,0,DF,25-29,Defender,France,Europe
541,Tom Cleverley,ENG,Watford,Premier League,2021,31.0,1989.0,18.0,37,20,19,17,1,18,33,54.5,15,23,6,17,18,55,19,3,MF,30-34,Midfielder,England,Europe
542,Nathaniel Clyne,ENG,Crystal Palace,Premier League,2021,30.0,1991.0,15.0,21,10,11,9,1,10,20,50.0,10,7,2,5,15,36,32,0,DF,30-34,Defender,England,Europe
543,Conor Coady,ENG,Wolves,Premier League,2021,28.0,1993.0,37.3,31,14,23,7,1,16,28,57.1,12,46,40,6,28,59,140,0,DF,25-29,Defender,England,Europe
544,Marcus Coco,FRA,Nantes,Ligue 1,2021,25.0,1996.0,10.3,34,14,17,11,6,8,18,44.4,10,11,1,10,10,44,15,0,"MF,FW",25-29,Midfielder,France,Europe
546,Séamus Coleman,IRL,Everton,Premier League,2021,32.0,1988.0,29.5,61,36,35,16,10,33,51,64.7,18,30,11,19,32,93,80,2,DF,30-34,Defender,Republic of Ireland,Europe
550,Nathan Collins,IRL,Burnley,Premier League,2021,20.0,2001.0,18.6,37,15,27,8,2,17,27,63.0,10,38,25,13,24,61,83,2,DF,20-24,Defender,Republic of Ireland,Europe
551,Kingsley Coman,FRA,Bayern Munich,Bundesliga,2021,25.0,1996.0,15.1,14,8,1,9,4,5,16,31.3,11,14,0,14,8,22,5,0,"FW,DF",25-29,Forward,France,Europe
552,Eray Cömert,SUI,Valencia,La Liga,2021,23.0,1998.0,4.5,5,3,4,1,0,3,6,50.0,3,3,2,1,2,7,6,0,DF,20-24,Defender,Switzerland,Europe
555,Aaron Connolly,IRL,Brighton,Premier League,2021,21.0,2000.0,1.7,0,0,0,0,0,0,1,0.0,1,2,0,2,0,0,0,0,"FW,MF",20-24,Forward,Republic of Ireland,Europe
556,Andrea Consigli,ITA,Sassuolo,Serie A,2021,34.0,1987.0,36.9,0,0,0,0,0,0,2,0.0,2,0,0,0,0,0,23,3,GK,30-34,Goalkeeper,Italy,Europe
557,Abdu Conté,POR,Troyes,Ligue 1,2021,23.0,1998.0,15.0,22,12,16,5,1,12,24,50.0,12,12,2,10,4,26,10,0,DF,20-24,Defender,Portugal,Europe
558,Andrea Conti,ITA,Sampdoria,Serie A,2021,27.0,1994.0,2.6,4,2,2,1,1,3,6,50.0,3,4,0,4,7,11,4,0,"DF,MF",25-29,Defender,Italy,Europe
559,Andrea Conti,ITA,Milan,Serie A,2021,27.0,1994.0,0.1,0,0,0,0,0,0,0,,0,0,0,0,0,0,0,0,DF,25-29,Defender,Italy,Europe
560,Liam Cooper,SCO,Leeds United,Premier League,2021,29.0,1991.0,20.2,41,23,27,13,1,23,33,69.7,10,29,18,11,43,84,72,2,DF,25-29,Defender,Scotland,Europe
561,Lucas Copado,GER,Bayern Munich,Bundesliga,2021,17.0,2004.0,0.2,1,0,1,0,0,1,1,100.0,0,0,0,0,0,1,0,0,FW,Under 20,Forward,Germany,Europe
563,Francis Coquelin,FRA,Villarreal,La Liga,2021,30.0,1991.0,9.2,26,17,9,11,6,11,20,55.0,9,15,5,10,19,45,11,0,MF,30-34,Midfielder,France,Europe
564,Sébastien Corchia,FRA,Nantes,Ligue 1,2021,30.0,1990.0,14.7,33,20,17,11,5,24,42,57.1,18,24,3,21,13,46,36,0,DF,30-34,Defender,France,Europe
566,Jack Cork,ENG,Burnley,Premier League,2021,32.0,1989.0,18.6,20,6,6,11,3,7,20,35.0,13,17,4,13,17,37,29,1,MF,30-34,Midfielder,England,Europe
567,Maxwel Cornet,CIV,Burnley,Premier League,2021,24.0,1996.0,19.6,16,9,7,5,4,7,15,46.7,8,13,4,9,10,26,14,0,"FW,MF",20-24,Forward,Ivory Coast,Africa
568,Maxwel Cornet,CIV,Lyon,Ligue 1,2021,24.0,1996.0,0.7,3,1,1,0,2,3,4,75.0,1,0,0,0,1,4,1,0,DF,20-24,Defender,Ivory Coast,Africa
569,Jesús Corona,MEX,Sevilla,La Liga,2021,28.0,1993.0,12.9,12,7,7,5,0,3,6,50.0,3,4,0,4,8,20,6,0,"FW,DF",25-29,Forward,Mexico,North America
570,Ángel Correa,ARG,Atlético Madrid,La Liga,2021,26.0,1995.0,20.6,16,8,5,10,1,7,29,24.1,22,25,2,23,10,26,4,0,"FW,MF",25-29,Forward,Argentina,South America
571,Joaquín Correa,ARG,Inter,Serie A,2021,26.0,1994.0,11.4,11,5,2,6,3,1,13,7.7,12,8,1,7,3,14,2,0,FW,25-29,Forward,Argentina,South America
572,Thierry Correia,POR,Valencia,La Liga,2021,22.0,1999.0,15.7,35,23,26,6,3,14,29,48.3,15,20,5,15,19,54,27,0,DF,20-24,Defender,Portugal,Europe
573,Danny da Costa,GER,Eint Frankfurt,Bundesliga,2021,28.0,1993.0,8.1,15,4,6,7,2,6,18,33.3,12,14,1,13,11,26,18,1,"DF,MF",25-29,Defender,Germany,Europe
575,Hélder Costa,ANG,Leeds United,Premier League,2021,27.0,1994.0,0.2,0,0,0,0,0,0,0,,0,1,0,1,0,0,0,0,MF,25-29,Midfielder,Angola,Africa
576,Hélder Costa,ANG,Valencia,La Liga,2021,27.0,1994.0,12.4,27,16,11,9,7,14,41,34.1,27,12,1,11,3,30,9,0,"MF,FW",25-29,Midfielder,Angola,Africa
578,Benoît Costil,FRA,Bordeaux,Ligue 1,2021,34.0,1987.0,25.0,1,0,1,0,0,1,2,50.0,1,0,0,0,0,1,6,3,GK,30-34,Goalkeeper,France,Europe
580,Kalifa Coulibaly,MLI,Nantes,Ligue 1,2021,29.0,1991.0,9.4,5,1,1,1,3,0,4,0.0,4,2,2,0,0,5,11,0,FW,25-29,Forward,Mali,Africa
581,Lassana Coulibaly,MLI,Salernitana,Serie A,2021,25.0,1996.0,25.9,58,32,29,26,3,24,62,38.7,38,40,13,27,22,80,27,0,MF,25-29,Midfielder,Mali,Africa
582,Mamadou Coulibaly,SEN,Salernitana,Serie A,2021,22.0,1999.0,9.0,15,12,8,5,2,7,20,35.0,13,9,0,9,11,26,9,0,MF,20-24,Midfielder,Senegal,Africa
582,Mamadou Coulibaly,SEN,Salernitana,Serie A,2021,22.0,1999.0,9.0,15,12,8,5,2,7,20,35.0,13,9,0,9,11,26,9,0,MF,20-24,Midfielder,Senegal,Africa
582,Mamadou Coulibaly,SEN,Salernitana,Serie A,2021,22.0,1999.0,9.0,15,12,8,5,2,7,20,35.0,13,9,0,9,11,26,9,0,MF,20-24,Midfielder,Senegal,Africa
582,Mamadou Coulibaly,SEN,Salernitana,Serie A,2021,22.0,1999.0,9.0,15,12,8,5,2,7,20,35.0,13,9,0,9,11,26,9,0,MF,20-24,Midfielder,Senegal,Africa
583,Tanguy Coulibaly,FRA,Stuttgart,Bundesliga,2021,20.0,2001.0,12.0,27,15,14,11,2,9,19,47.4,10,14,2,12,4,31,10,0,"FW,MF",20-24,Forward,France,Europe
584,Thibaut Courtois,BEL,Real Madrid,La Liga,2021,29.0,1992.0,36.0,1,0,1,0,0,1,2,50.0,1,0,0,0,0,1,9,1,GK,25-29,Goalkeeper,Belgium,Europe
585,Philippe Coutinho,BRA,Aston Villa,Premier League,2021,29.0,1992.0,14.8,17,12,4,11,2,6,21,28.6,15,11,1,10,7,24,4,0,"MF,FW",25-29,Midfielder,Brazil,South America
586,Philippe Coutinho,BRA,Barcelona,La Liga,2021,29.0,1992.0,5.6,6,3,3,3,0,3,11,27.3,8,3,0,3,4,10,3,0,"MF,FW",25-29,Midfielder,Brazil,South America
587,Nicolas Cozza,FRA,Montpellier,Ligue 1,2021,22.0,1999.0,30.8,80,47,50,23,7,35,65,53.8,30,35,19,16,38,118,82,1,DF,20-24,Defender,France,Europe
588,Alessio Cragno,ITA,Cagliari,Serie A,2021,27.0,1994.0,35.0,3,3,2,1,0,3,3,100.0,0,0,0,0,1,4,14,1,GK,25-29,Goalkeeper,Italy,Europe
589,Aaron Cresswell,ENG,West Ham,Premier League,2021,31.0,1989.0,30.3,28,18,18,6,4,13,25,52.0,12,31,18,13,35,63,66,0,DF,30-34,Defender,England,Europe
590,Charlie Cresswell,ENG,Leeds United,Premier League,2021,18.0,2002.0,1.6,5,2,1,4,0,3,3,100.0,0,1,1,0,2,7,6,0,DF,Under 20,Defender,England,Europe
591,Domenico Criscito,ITA,Genoa,Serie A,2021,34.0,1986.0,18.0,37,21,19,14,4,16,25,64.0,9,22,12,10,39,76,57,0,DF,30-34,Defender,Italy,Europe
592,Bryan Cristante,ITA,Roma,Serie A,2021,26.0,1995.0,29.8,79,39,31,39,9,37,69,53.6,32,31,5,26,40,119,45,0,MF,25-29,Midfielder,Italy,Europe
596,Giovanni Crociata,ITA,Empoli,Serie A,2021,23.0,1997.0,0.2,0,0,0,0,0,0,1,0.0,1,0,0,0,0,0,0,0,FW,20-24,Forward,Italy,Europe
598,Juan Cuadrado,COL,Juventus,Serie A,2021,33.0,1988.0,27.6,48,23,30,13,5,30,55,54.5,25,23,5,18,29,77,34,0,"DF,MF",30-34,Defender,Colombia,South America
605,Luke Cundle,ENG,Wolves,Premier League,2021,19.0,2002.0,2.0,4,3,0,4,0,1,1,100.0,0,0,0,0,1,5,1,0,MF,Under 20,Midfielder,England,Europe
606,Matheus Cunha,BRA,Atlético Madrid,La Liga,2021,22.0,1999.0,11.8,19,12,3,11,5,5,20,25.0,15,18,2,16,6,25,9,0,FW,20-24,Forward,Brazil,South America
607,Matheus Cunha,BRA,Hertha BSC,Bundesliga,2021,22.0,1999.0,0.7,0,0,0,0,0,0,0,,0,0,0,0,0,0,0,0,FW,20-24,Forward,Brazil,South America
608,Patrick Cutrone,ITA,Empoli,Serie A,2021,23.0,1998.0,15.6,5,2,0,3,2,1,9,11.1,8,11,1,10,5,10,1,0,FW,20-24,Forward,Italy,Europe
609,Wylan Cyprien,FRA,Nantes,Ligue 1,2021,26.0,1995.0,16.6,33,17,12,18,3,13,32,40.6,19,16,6,10,10,43,14,2,MF,25-29,Midfielder,France,Europe
610,Rafael Czichos,GER,Köln,Bundesliga,2021,31.0,1990.0,15.6,29,18,18,9,2,14,28,50.0,14,23,13,10,19,48,53,2,DF,30-34,Defender,Germany,Europe
612,Danilo D'Ambrosio,ITA,Inter,Serie A,2021,32.0,1988.0,11.1,30,15,21,8,1,11,22,50.0,11,21,10,11,8,38,20,0,DF,30-34,Defender,Italy,Europe
613,Lucas Da Cunha,FRA,Nice,Ligue 1,2021,20.0,2001.0,4.4,13,7,2,7,4,6,11,54.5,5,2,0,2,1,14,2,0,MF,20-24,Midfielder,France,Europe
614,Lucas Da Cunha,FRA,Clermont Foot,Ligue 1,2021,20.0,2001.0,9.3,17,11,5,8,4,9,18,50.0,9,13,0,13,1,18,3,0,"FW,MF",20-24,Forward,France,Europe
615,Damien Da Silva,FRA,Lyon,Ligue 1,2021,33.0,1988.0,12.5,13,9,7,5,1,5,9,55.6,4,15,10,5,22,35,53,1,DF,30-34,Defender,France,Europe
618,Finn Dahmen,GER,Mainz 05,Bundesliga,2021,23.0,1998.0,2.0,0,0,0,0,0,0,0,,0,0,0,0,0,0,2,0,GK,20-24,Goalkeeper,Germany,Europe
619,Mahmoud Dahoud,GER,Dortmund,Bundesliga,2021,25.0,1996.0,18.4,42,19,10,24,8,20,46,43.5,26,18,3,15,17,59,16,0,MF,25-29,Midfielder,Germany,Europe
620,Patson Daka,ZAM,Leicester City,Premier League,2021,22.0,1998.0,12.9,15,10,2,8,5,2,19,10.5,17,7,0,7,2,17,8,0,FW,20-24,Forward,Zambia,Africa
622,Diogo Dalot,POR,Manchester Utd,Premier League,2021,22.0,1999.0,20.0,55,41,35,12,8,31,57,54.4,26,24,13,11,29,84,59,0,DF,20-24,Defender,Portugal,Europe
623,Mikkel Damsgaard,DEN,Sampdoria,Serie A,2021,21.0,2000.0,6.4,27,13,12,11,4,20,36,55.6,16,16,1,15,7,34,7,0,"MF,FW",20-24,Midfielder,Denmark,Europe
624,Flavius Daniliuc,AUT,Nice,Ligue 1,2021,20.0,2001.0,14.4,46,31,26,17,3,34,43,79.1,9,13,7,6,14,60,34,1,DF,20-24,Defender,Austria,Europe
625,Danilo,BRA,Juventus,Serie A,2021,30.0,1991.0,21.0,37,26,20,13,4,18,28,64.3,10,21,12,9,32,69,53,1,"DF,MF",30-34,Defender,Brazil,South America
625,Danilo,BRA,Juventus,Serie A,2021,30.0,1991.0,21.0,37,26,20,13,4,18,28,64.3,10,21,12,9,32,69,53,1,"DF,MF",30-34,Defender,Brazil,South America
625,Danilo,BRA,Juventus,Serie A,2021,30.0,1991.0,21.0,37,26,20,13,4,18,28,64.3,10,21,12,9,32,69,53,1,"DF,MF",30-34,Defender,Brazil,South America
625,Danilo,BRA,Juventus,Serie A,2021,30.0,1991.0,21.0,37,26,20,13,4,18,28,64.3,10,21,12,9,32,69,53,1,"DF,MF",30-34,Defender,Brazil,South America
625,Danilo,BRA,Juventus,Serie A,2021,30.0,1991.0,21.0,37,26,20,13,4,18,28,64.3,10,21,12,9,32,69,53,1,"DF,MF",30-34,Defender,Brazil,South America
625,Danilo,BRA,Juventus,Serie A,2021,30.0,1991.0,21.0,37,26,20,13,4,18,28,64.3,10,21,12,9,32,69,53,1,"DF,MF",30-34,Defender,Brazil,South America
625,Danilo,BRA,Juventus,Serie A,2021,30.0,1991.0,21.0,37,26,20,13,4,18,28,64.3,10,21,12,9,32,69,53,1,"DF,MF",30-34,Defender,Brazil,South America
625,Danilo,BRA,Juventus,Serie A,2021,30.0,1991.0,21.0,37,26,20,13,4,18,28,64.3,10,21,12,9,32,69,53,1,"DF,MF",30-34,Defender,Brazil,South America
625,Danilo,BRA,Juventus,Serie A,2021,30.0,1991.0,21.0,37,26,20,13,4,18,28,64.3,10,21,12,9,32,69,53,1,"DF,MF",30-34,Defender,Brazil,South America
625,Danilo,BRA,Juventus,Serie A,2021,30.0,1991.0,21.0,37,26,20,13,4,18,28,64.3,10,21,12,9,32,69,53,1,"DF,MF",30-34,Defender,Brazil,South America
625,Danilo,BRA,Juventus,Serie A,2021,30.0,1991.0,21.0,37,26,20,13,4,18,28,64.3,10,21,12,9,32,69,53,1,"DF,MF",30-34,Defender,Brazil,South America
625,Danilo,BRA,Juventus,Serie A,2021,30.0,1991.0,21.0,37,26,20,13,4,18,28,64.3,10,21,12,9,32,69,53,1,"DF,MF",30-34,Defender,Brazil,South America
625,Danilo,BRA,Juventus,Serie A,2021,30.0,1991.0,21.0,37,26,20,13,4,18,28,64.3,10,21,12,9,32,69,53,1,"DF,MF",30-34,Defender,Brazil,South America
625,Danilo,BRA,Juventus,Serie A,2021,30.0,1991.0,21.0,37,26,20,13,4,18,28,64.3,10,21,12,9,32,69,53,1,"DF,MF",30-34,Defender,Brazil,South America
625,Danilo,BRA,Juventus,Serie A,2021,30.0,1991.0,21.0,37,26,20,13,4,18,28,64.3,10,21,12,9,32,69,53,1,"DF,MF",30-34,Defender,Brazil,South America
625,Danilo,BRA,Juventus,Serie A,2021,30.0,1991.0,21.0,37,26,20,13,4,18,28,64.3,10,21,12,9,32,69,53,1,"DF,MF",30-34,Defender,Brazil,South America
625,Danilo,BRA,Juventus,Serie A,2021,30.0,1991.0,21.0,37,26,20,13,4,18,28,64.3,10,21,12,9,32,69,53,1,"DF,MF",30-34,Defender,Brazil,South America
625,Danilo,BRA,Juventus,Serie A,2021,30.0,1991.0,21.0,37,26,20,13,4,18,28,64.3,10,21,12,9,32,69,53,1,"DF,MF",30-34,Defender,Brazil,South America
625,Danilo,BRA,Juventus,Serie A,2021,30.0,1991.0,21.0,37,26,20,13,4,18,28,64.3,10,21,12,9,32,69,53,1,"DF,MF",30-34,Defender,Brazil,South America
625,Danilo,BRA,Juventus,Serie A,2021,30.0,1991.0,21.0,37,26,20,13,4,18,28,64.3,10,21,12,9,32,69,53,1,"DF,MF",30-34,Defender,Brazil,South America
625,Danilo,BRA,Juventus,Serie A,2021,30.0,1991.0,21.0,37,26,20,13,4,18,28,64.3,10,21,12,9,32,69,53,1,"DF,MF",30-34,Defender,Brazil,South America
625,Danilo,BRA,Juventus,Serie A,2021,30.0,1991.0,21.0,37,26,20,13,4,18,28,64.3,10,21,12,9,32,69,53,1,"DF,MF",30-34,Defender,Brazil,South America
625,Danilo,BRA,Juventus,Serie A,2021,30.0,1991.0,21.0,37,26,20,13,4,18,28,64.3,10,21,12,9,32,69,53,1,"DF,MF",30-34,Defender,Brazil,South America
625,Danilo,BRA,Juventus,Serie A,2021,30.0,1991.0,21.0,37,26,20,13,4,18,28,64.3,10,21,12,9,32,69,53,1,"DF,MF",30-34,Defender,Brazil,South America
625,Danilo,BRA,Juventus,Serie A,2021,30.0,1991.0,21.0,37,26,20,13,4,18,28,64.3,10,21,12,9,32,69,53,1,"DF,MF",30-34,Defender,Brazil,South America
625,Danilo,BRA,Juventus,Serie A,2021,30.0,1991.0,21.0,37,26,20,13,4,18,28,64.3,10,21,12,9,32,69,53,1,"DF,MF",30-34,Defender,Brazil,South America
625,Danilo,BRA,Juventus,Serie A,2021,30.0,1991.0,21.0,37,26,20,13,4,18,28,64.3,10,21,12,9,32,69,53,1,"DF,MF",30-34,Defender,Brazil,South America
625,Danilo,BRA,Juventus,Serie A,2021,30.0,1991.0,21.0,37,26,20,13,4,18,28,64.3,10,21,12,9,32,69,53,1,"DF,MF",30-34,Defender,Brazil,South America
625,Danilo,BRA,Juventus,Serie A,2021,30.0,1991.0,21.0,37,26,20,13,4,18,28,64.3,10,21,12,9,32,69,53,1,"DF,MF",30-34,Defender,Brazil,South America
625,Danilo,BRA,Juventus,Serie A,2021,30.0,1991.0,21.0,37,26,20,13,4,18,28,64.3,10,21,12,9,32,69,53,1,"DF,MF",30-34,Defender,Brazil,South America
625,Danilo,BRA,Juventus,Serie A,2021,30.0,1991.0,21.0,37,26,20,13,4,18,28,64.3,10,21,12,9,32,69,53,1,"DF,MF",30-34,Defender,Brazil,South America
625,Danilo,BRA,Juventus,Serie A,2021,30.0,1991.0,21.0,37,26,20,13,4,18,28,64.3,10,21,12,9,32,69,53,1,"DF,MF",30-34,Defender,Brazil,South America
625,Danilo,BRA,Juventus,Serie A,2021,30.0,1991.0,21.0,37,26,20,13,4,18,28,64.3,10,21,12,9,32,69,53,1,"DF,MF",30-34,Defender,Brazil,South America
625,Danilo,BRA,Juventus,Serie A,2021,30.0,1991.0,21.0,37,26,20,13,4,18,28,64.3,10,21,12,9,32,69,53,1,"DF,MF",30-34,Defender,Brazil,South America
625,Danilo,BRA,Juventus,Serie A,2021,30.0,1991.0,21.0,37,26,20,13,4,18,28,64.3,10,21,12,9,32,69,53,1,"DF,MF",30-34,Defender,Brazil,South America
625,Danilo,BRA,Juventus,Serie A,2021,30.0,1991.0,21.0,37,26,20,13,4,18,28,64.3,10,21,12,9,32,69,53,1,"DF,MF",30-34,Defender,Brazil,South America
625,Danilo,BRA,Juventus,Serie A,2021,30.0,1991.0,21.0,37,26,20,13,4,18,28,64.3,10,21,12,9,32,69,53,1,"DF,MF",30-34,Defender,Brazil,South America
625,Danilo,BRA,Juventus,Serie A,2021,30.0,1991.0,21.0,37,26,20,13,4,18,28,64.3,10,21,12,9,32,69,53,1,"DF,MF",30-34,Defender,Brazil,South America
625,Danilo,BRA,Juventus,Serie A,2021,30.0,1991.0,21.0,37,26,20,13,4,18,28,64.3,10,21,12,9,32,69,53,1,"DF,MF",30-34,Defender,Brazil,South America
625,Danilo,BRA,Juventus,Serie A,2021,30.0,1991.0,21.0,37,26,20,13,4,18,28,64.3,10,21,12,9,32,69,53,1,"DF,MF",30-34,Defender,Brazil,South America
625,Danilo,BRA,Juventus,Serie A,2021,30.0,1991.0,21.0,37,26,20,13,4,18,28,64.3,10,21,12,9,32,69,53,1,"DF,MF",30-34,Defender,Brazil,South America
625,Danilo,BRA,Juventus,Serie A,2021,30.0,1991.0,21.0,37,26,20,13,4,18,28,64.3,10,21,12,9,32,69,53,1,"DF,MF",30-34,Defender,Brazil,South America
625,Danilo,BRA,Juventus,Serie A,2021,30.0,1991.0,21.0,37,26,20,13,4,18,28,64.3,10,21,12,9,32,69,53,1,"DF,MF",30-34,Defender,Brazil,South America
625,Danilo,BRA,Juventus,Serie A,2021,30.0,1991.0,21.0,37,26,20,13,4,18,28,64.3,10,21,12,9,32,69,53,1,"DF,MF",30-34,Defender,Brazil,South America
625,Danilo,BRA,Juventus,Serie A,2021,30.0,1991.0,21.0,37,26,20,13,4,18,28,64.3,10,21,12,9,32,69,53,1,"DF,MF",30-34,Defender,Brazil,South America
625,Danilo,BRA,Juventus,Serie A,2021,30.0,1991.0,21.0,37,26,20,13,4,18,28,64.3,10,21,12,9,32,69,53,1,"DF,MF",30-34,Defender,Brazil,South America
625,Danilo,BRA,Juventus,Serie A,2021,30.0,1991.0,21.0,37,26,20,13,4,18,28,64.3,10,21,12,9,32,69,53,1,"DF,MF",30-34,Defender,Brazil,South America
625,Danilo,BRA,Juventus,Serie A,2021,30.0,1991.0,21.0,37,26,20,13,4,18,28,64.3,10,21,12,9,32,69,53,1,"DF,MF",30-34,Defender,Brazil,South America
625,Danilo,BRA,Juventus,Serie A,2021,30.0,1991.0,21.0,37,26,20,13,4,18,28,64.3,10,21,12,9,32,69,53,1,"DF,MF",30-34,Defender,Brazil,South America
626,Arnaut Danjuma,NED,Villarreal,La Liga,2021,24.0,1997.0,16.4,7,6,3,0,4,2,4,50.0,2,5,0,5,2,9,3,0,FW,20-24,Forward,Netherlands,Europe
627,Kevin Danso,AUT,Lens,Ligue 1,2021,22.0,1998.0,31.0,41,29,29,12,0,23,34,67.6,11,38,25,13,40,81,111,0,DF,20-24,Defender,Austria,Europe
628,Dante,BRA,Nice,Ligue 1,2021,37.0,1983.0,31.9,42,29,30,12,0,23,33,69.7,10,43,27,16,49,91,96,1,DF,35-39,Defender,Brazil,South America
629,Ebrima Darboe,GAM,Roma,Serie A,2021,20.0,2001.0,0.7,1,1,0,1,0,0,0,,0,0,0,0,1,2,0,1,MF,20-24,Midfielder,Gambia,Africa
630,Márton Dárdai,HUN,Hertha BSC,Bundesliga,2021,19.0,2002.0,8.4,10,4,8,2,0,8,18,44.4,10,16,6,10,20,30,33,2,DF,Under 20,Defender,Hungary,Europe
633,Karl Darlow,WAL,Newcastle Utd,Premier League,2021,30.0,1990.0,8.0,0,0,0,0,0,0,0,,0,0,0,0,0,0,5,1,GK,30-34,Goalkeeper,Wales,Europe
634,Matteo Darmian,ITA,Inter,Serie A,2021,31.0,1989.0,16.7,32,16,17,9,6,16,41,39.0,25,16,1,15,19,51,25,0,DF,30-34,Defender,Italy,Europe
635,Josh Dasilva,ENG,Brentford,Premier League,2021,22.0,1998.0,2.9,2,1,0,1,1,1,2,50.0,1,3,0,3,1,3,7,0,"MF,FW",20-24,Midfielder,England,Europe
636,Jonathan David,CAN,Lille,Ligue 1,2021,21.0,2000.0,31.2,24,9,7,11,6,9,30,30.0,21,14,4,10,5,29,15,0,FW,20-24,Forward,Canada,North America
637,Alphonso Davies,CAN,Bayern Munich,Bundesliga,2021,20.0,2000.0,19.3,34,17,17,8,9,13,31,41.9,18,27,1,26,23,57,26,1,DF,20-24,Defender,Canada,North America
638,Ben Davies,WAL,Tottenham,Premier League,2021,28.0,1993.0,28.2,36,21,20,12,4,13,26,50.0,13,32,19,13,30,66,75,1,DF,25-29,Defender,Wales,Europe
638,Ben Davies,WAL,Tottenham,Premier League,2021,28.0,1993.0,28.2,36,21,20,12,4,13,26,50.0,13,32,19,13,30,66,75,1,DF,25-29,Defender,Wales,Europe
638,Ben Davies,WAL,Tottenham,Premier League,2021,28.0,1993.0,28.2,36,21,20,12,4,13,26,50.0,13,32,19,13,30,66,75,1,DF,25-29,Defender,Wales,Europe
638,Ben Davies,WAL,Tottenham,Premier League,2021,28.0,1993.0,28.2,36,21,20,12,4,13,26,50.0,13,32,19,13,30,66,75,1,DF,25-29,Defender,Wales,Europe
639,Tom Davies,ENG,Everton,Premier League,2021,23.0,1998.0,2.6,3,1,1,1,1,2,5,40.0,3,2,1,1,2,5,9,0,MF,20-24,Midfielder,England,Europe
639,Tom Davies,ENG,Everton,Premier League,2021,23.0,1998.0,2.6,3,1,1,1,1,2,5,40.0,3,2,1,1,2,5,9,0,MF,20-24,Midfielder,England,Europe
639,Tom Davies,ENG,Everton,Premier League,2021,23.0,1998.0,2.6,3,1,1,1,1,2,5,40.0,3,2,1,1,2,5,9,0,MF,20-24,Midfielder,England,Europe
639,Tom Davies,ENG,Everton,Premier League,2021,23.0,1998.0,2.6,3,1,1,1,1,2,5,40.0,3,2,1,1,2,5,9,0,MF,20-24,Midfielder,England,Europe
640,Keinan Davis,ENG,Aston Villa,Premier League,2021,23.0,1998.0,0.1,0,0,0,0,0,0,0,,0,0,0,0,0,0,0,0,FW,20-24,Forward,England,Europe
642,Craig Dawson,ENG,West Ham,Premier League,2021,31.0,1990.0,30.6,29,17,20,8,1,14,25,56.0,11,59,52,7,29,58,139,0,DF,30-34,Defender,England,Europe
643,Kevin De Bruyne,BEL,Manchester City,Premier League,2021,30.0,1991.0,24.5,32,16,4,15,13,12,37,32.4,25,32,2,30,6,38,16,0,MF,30-34,Midfielder,Belgium,Europe
645,Sebastien De Maio,FRA,Udinese,Serie A,2021,34.0,1987.0,2.0,5,1,4,1,0,1,9,11.1,8,6,5,1,1,6,9,0,DF,30-34,Defender,France,Europe
647,Rodrigo De Paul,ARG,Atlético Madrid,La Liga,2021,27.0,1994.0,23.9,55,30,22,25,8,30,60,50.0,30,24,3,21,21,76,17,2,MF,25-29,Midfielder,Argentina,South America
648,Mattia De Sciglio,ITA,Juventus,Serie A,2021,28.0,1992.0,13.0,24,12,7,9,8,11,24,45.8,13,10,0,10,10,34,30,0,DF,25-29,Defender,Italy,Europe
649,Lorenzo De Silvestri,ITA,Bologna,Serie A,2021,33.0,1988.0,25.5,23,14,13,8,2,9,31,29.0,22,25,7,18,26,49,52,0,DF,30-34,Defender,Italy,Europe
650,Saulo Decarli,SUI,Bochum,Bundesliga,2021,29.0,1992.0,0.1,0,0,0,0,0,0,0,,0,0,0,0,0,0,0,0,DF,25-29,Defender,Switzerland,Europe
651,Troy Deeney,ENG,Watford,Premier League,2021,33.0,1988.0,0.3,0,0,0,0,0,0,1,0.0,1,0,0,0,0,0,2,0,FW,30-34,Forward,England,Europe
653,Alessandro Deiola,ITA,Cagliari,Serie A,2021,25.0,1995.0,23.7,47,22,15,25,7,23,58,39.7,35,28,10,18,26,73,45,0,MF,25-29,Midfielder,Italy,Europe
654,Romain Del Castillo,FRA,Rennes,Ligue 1,2021,25.0,1996.0,0.3,2,1,0,1,1,2,2,100.0,0,0,0,0,1,3,0,0,"MF,FW",25-29,Midfielder,France,Europe
655,Romain Del Castillo,FRA,Brest,Ligue 1,2021,25.0,1996.0,10.8,27,16,3,17,7,12,31,38.7,19,12,0,12,7,34,3,0,"MF,FW",25-29,Midfielder,France,Europe
656,Thomas Delaine,FRA,Metz,Ligue 1,2021,29.0,1992.0,25.7,48,35,34,12,2,22,42,52.4,20,20,7,13,27,75,31,0,DF,25-29,Defender,France,Europe
661,Filippo Delli Carri,ITA,Salernitana,Serie A,2021,22.0,1999.0,3.7,6,4,4,2,0,5,14,35.7,9,6,2,4,4,10,14,0,DF,20-24,Defender,Italy,Europe
662,Andy Delort,ALG,Nice,Ligue 1,2021,29.0,1991.0,27.2,15,9,3,5,7,7,12,58.3,5,13,4,9,9,24,14,0,FW,25-29,Forward,Algeria,Africa
663,Andy Delort,ALG,Montpellier,Ligue 1,2021,29.0,1991.0,3.0,2,0,0,1,1,0,1,0.0,1,1,0,1,0,2,4,0,FW,25-29,Forward,Algeria,Africa
664,Fabian Delph,ENG,Everton,Premier League,2021,31.0,1989.0,7.4,18,15,10,7,1,8,21,38.1,13,12,5,7,14,32,10,0,MF,30-34,Midfielder,England,Europe
665,Moussa Dembélé,FRA,Lyon,Ligue 1,2021,25.0,1996.0,24.5,18,9,5,5,8,6,15,40.0,9,13,0,13,8,26,30,1,FW,25-29,Forward,France,Europe
666,Ousmane Dembélé,FRA,Barcelona,La Liga,2021,24.0,1997.0,15.7,24,16,6,10,8,7,23,30.4,16,8,0,8,8,32,3,0,FW,20-24,Forward,France,Europe
668,Merih Demiral,TUR,Atalanta,Serie A,2021,23.0,1998.0,21.3,31,17,18,12,1,15,28,53.6,13,26,14,12,58,89,68,1,DF,20-24,Defender,Turkey,Asia
671,Diego Demme,GER,Napoli,Serie A,2021,29.0,1991.0,7.7,21,12,4,13,4,10,21,47.6,11,11,2,9,9,30,2,0,MF,25-29,Midfielder,Germany,Europe
672,Jason Denayer,BEL,Lyon,Ligue 1,2021,26.0,1995.0,11.1,11,4,8,3,0,6,7,85.7,1,8,7,1,16,27,52,0,DF,25-29,Defender,Belgium,Europe
674,Emmanuel Dennis,NGA,Watford,Premier League,2021,23.0,1997.0,28.7,51,35,20,22,9,17,52,32.7,35,36,2,34,15,66,13,0,"FW,MF",20-24,Forward,Nigeria,Africa
675,Fabio Depaoli,ITA,Hellas Verona,Serie A,2021,24.0,1997.0,7.8,12,7,6,4,2,1,7,14.3,6,9,2,7,8,20,14,0,DF,20-24,Defender,Italy,Europe
676,Fabio Depaoli,ITA,Sampdoria,Serie A,2021,24.0,1997.0,1.2,3,1,1,2,0,0,2,0.0,2,2,1,1,1,4,2,0,"MF,DF",20-24,Midfielder,Italy,Europe
678,Arthur Desmas,FRA,Clermont Foot,Ligue 1,2021,27.0,1994.0,14.5,0,0,0,0,0,0,3,0.0,3,0,0,0,0,0,1,3,GK,25-29,Goalkeeper,France,Europe
680,Mattia Destro,ITA,Genoa,Serie A,2021,30.0,1991.0,19.4,9,4,1,4,4,1,6,16.7,5,14,1,13,2,11,16,0,FW,30-34,Forward,Italy,Europe
682,Kiernan Dewsbury-Hall,ENG,Leicester City,Premier League,2021,22.0,1998.0,23.4,39,24,20,14,5,19,40,47.5,21,37,8,29,21,60,26,1,MF,20-24,Midfielder,England,Europe
683,Jacopo Dezi,ITA,Venezia,Serie A,2021,29.0,1992.0,0.2,0,0,0,0,0,0,1,0.0,1,0,0,0,1,1,0,0,MF,25-29,Midfielder,Italy,Europe
684,Samuel Di Carmine,ITA,Hellas Verona,Serie A,2021,32.0,1988.0,0.4,0,0,0,0,0,0,0,,0,0,0,0,0,0,0,0,FW,30-34,Forward,Italy,Europe
685,Federico Di Francesco,ITA,Empoli,Serie A,2021,27.0,1994.0,15.2,16,5,2,8,6,9,23,39.1,14,17,1,16,9,25,11,0,"FW,MF",25-29,Forward,Italy,Europe
686,Giovanni Di Lorenzo,ITA,Napoli,Serie A,2021,27.0,1993.0,31.9,58,36,30,20,8,33,58,56.9,25,28,10,18,38,96,46,1,DF,25-29,Defender,Italy,Europe
688,Francesco Di Mariano,ITA,Venezia,Serie A,2021,25.0,1996.0,0.7,1,1,0,1,0,0,0,,0,2,1,1,0,1,0,0,FW,25-29,Forward,Italy,Europe
689,Francesco Di Tacchio,ITA,Salernitana,Serie A,2021,31.0,1990.0,13.9,17,7,5,10,2,9,25,36.0,16,16,8,8,22,39,25,0,MF,30-34,Midfielder,Italy,Europe
690,Boulaye Dia,SEN,Villarreal,La Liga,2021,24.0,1996.0,14.1,8,6,3,4,1,2,5,40.0,3,6,1,5,5,13,4,0,FW,20-24,Forward,Senegal,Africa
691,Moussa Diaby,FRA,Leverkusen,Bundesliga,2021,22.0,1999.0,30.7,20,11,8,9,3,5,38,13.2,33,11,0,11,8,28,2,0,"FW,MF",20-24,Forward,France,Europe
693,Mouctar Diakhaby,GUI,Valencia,La Liga,2021,24.0,1996.0,21.6,35,24,18,15,2,13,23,56.5,10,29,17,12,30,65,87,3,DF,20-24,Defender,Guinea,Africa
695,Abdou Diallo,SEN,Paris S-G,Ligue 1,2021,25.0,1996.0,9.7,22,14,10,9,3,8,14,57.1,6,6,2,4,10,32,19,1,DF,25-29,Defender,Senegal,Africa
696,Habib Diallo,SEN,Strasbourg,Ligue 1,2021,26.0,1995.0,17.1,9,5,0,8,1,0,8,0.0,8,13,4,9,4,13,11,0,FW,25-29,Forward,Senegal,Africa
697,Ibrahima Diallo,FRA,Southampton,Premier League,2021,22.0,1999.0,11.4,22,11,10,9,3,10,24,41.7,14,7,0,7,9,31,10,0,MF,20-24,Midfielder,France,Europe
697,Ibrahima Diallo,FRA,Southampton,Premier League,2021,22.0,1999.0,11.4,22,11,10,9,3,10,24,41.7,14,7,0,7,9,31,10,0,MF,20-24,Midfielder,France,Europe
697,Ibrahima Diallo,FRA,Southampton,Premier League,2021,22.0,1999.0,11.4,22,11,10,9,3,10,24,41.7,14,7,0,7,9,31,10,0,MF,20-24,Midfielder,France,Europe
697,Ibrahima Diallo,FRA,Southampton,Premier League,2021,22.0,1999.0,11.4,22,11,10,9,3,10,24,41.7,14,7,0,7,9,31,10,0,MF,20-24,Midfielder,France,Europe
697,Ibrahima Diallo,FRA,Southampton,Premier League,2021,22.0,1999.0,11.4,22,11,10,9,3,10,24,41.7,14,7,0,7,9,31,10,0,MF,20-24,Midfielder,France,Europe
697,Ibrahima Diallo,FRA,Southampton,Premier League,2021,22.0,1999.0,11.4,22,11,10,9,3,10,24,41.7,14,7,0,7,9,31,10,0,MF,20-24,Midfielder,France,Europe
697,Ibrahima Diallo,FRA,Southampton,Premier League,2021,22.0,1999.0,11.4,22,11,10,9,3,10,24,41.7,14,7,0,7,9,31,10,0,MF,20-24,Midfielder,France,Europe
697,Ibrahima Diallo,FRA,Southampton,Premier League,2021,22.0,1999.0,11.4,22,11,10,9,3,10,24,41.7,14,7,0,7,9,31,10,0,MF,20-24,Midfielder,France,Europe
697,Ibrahima Diallo,FRA,Southampton,Premier League,2021,22.0,1999.0,11.4,22,11,10,9,3,10,24,41.7,14,7,0,7,9,31,10,0,MF,20-24,Midfielder,France,Europe
698,Habib Diarra,SEN,Strasbourg,Ligue 1,2021,17.0,2004.0,1.2,2,1,1,1,0,1,1,100.0,0,0,0,0,0,2,0,0,MF,Under 20,Midfielder,Senegal,Africa
699,Stéphane Diarra,FRA,Lorient,Ligue 1,2021,22.0,1998.0,5.8,11,9,7,3,1,5,10,50.0,5,4,0,4,7,18,1,0,"MF,FW",20-24,Midfielder,France,Europe
700,Rúben Dias,POR,Manchester City,Premier League,2021,24.0,1997.0,26.7,26,19,11,12,3,8,15,53.3,7,19,13,6,23,49,66,0,DF,20-24,Defender,Portugal,Europe
701,Krépin Diatta,SEN,Monaco,Ligue 1,2021,22.0,1999.0,3.2,3,2,1,0,2,1,3,33.3,2,2,0,2,1,4,0,0,"MF,DF",20-24,Midfielder,Senegal,Africa
703,Brahim Díaz,MAR,Milan,Serie A,2021,21.0,1999.0,20.6,23,17,3,11,9,8,22,36.4,14,11,0,11,8,31,4,0,MF,20-24,Midfielder,Morocco,Africa
705,Luis Díaz,COL,Liverpool,Premier League,2021,24.0,1997.0,10.6,9,7,3,5,1,2,8,25.0,6,7,0,7,4,13,2,0,FW,20-24,Forward,Colombia,South America
707,Daniel Didavi,GER,Stuttgart,Bundesliga,2021,31.0,1990.0,3.1,6,2,0,4,2,4,7,57.1,3,4,1,3,1,7,1,0,"MF,FW",30-34,Midfielder,Germany,Europe
708,Bamba Dieng,SEN,Marseille,Ligue 1,2021,21.0,2000.0,10.8,17,11,5,5,7,4,14,28.6,10,7,0,7,5,22,8,0,FW,20-24,Forward,Senegal,Africa
709,Eric Dier,ENG,Tottenham,Premier League,2021,27.0,1994.0,34.1,15,9,6,8,1,7,14,50.0,7,37,32,5,27,42,142,1,DF,25-29,Defender,England,Europe
711,Lucas Digne,FRA,Aston Villa,Premier League,2021,28.0,1993.0,14.1,13,10,8,3,2,9,19,47.4,10,15,8,7,23,36,40,0,DF,25-29,Defender,France,Europe
712,Lucas Digne,FRA,Everton,Premier League,2021,28.0,1993.0,13.0,33,19,26,4,3,21,28,75.0,7,16,5,11,14,47,30,0,DF,25-29,Defender,France,Europe
716,Federico Dimarco,ITA,Inter,Serie A,2021,23.0,1997.0,15.9,28,15,10,15,3,13,24,54.2,11,6,1,5,19,47,19,0,DF,20-24,Defender,Italy,Europe
718,Stole Dimitrievski,MKD,Rayo Vallecano,La Liga,2021,27.0,1993.0,30.8,0,0,0,0,0,0,0,,0,0,0,0,1,1,14,3,GK,25-29,Goalkeeper,North Macedonia,Europe
719,Junior Dina Ebimbe,FRA,Paris S-G,Ligue 1,2021,20.0,2000.0,3.5,9,4,3,4,2,2,3,66.7,1,5,3,2,2,11,1,0,MF,20-24,Midfielder,France,Europe
720,Tristan Dingomé,CMR,Troyes,Ligue 1,2021,30.0,1991.0,12.0,23,11,10,12,1,10,18,55.6,8,7,1,6,9,32,3,0,"MF,FW",30-34,Midfielder,Cameroon,Africa
722,Issa Diop,FRA,West Ham,Premier League,2021,24.0,1997.0,10.7,10,8,5,5,0,4,11,36.4,7,14,13,1,7,17,44,0,DF,20-24,Defender,France,Europe
723,Sofiane Diop,FRA,Monaco,Ligue 1,2021,21.0,2000.0,21.6,38,20,12,19,7,15,47,31.9,32,10,0,10,23,61,4,0,"MF,FW",20-24,Midfielder,France,Europe
724,Andy Diouf,FRA,Rennes,Ligue 1,2021,18.0,2003.0,0.2,1,1,1,0,0,1,1,100.0,0,1,0,1,0,1,0,0,MF,Under 20,Midfielder,France,Europe
725,Assane Dioussé,SEN,Saint-Étienne,Ligue 1,2021,23.0,1997.0,0.3,1,1,1,0,0,1,1,100.0,0,0,0,0,0,1,0,0,MF,20-24,Midfielder,Senegal,Africa
726,Axel Disasi,FRA,Monaco,Ligue 1,2021,23.0,1998.0,30.2,42,27,20,21,1,23,39,59.0,16,40,30,10,26,68,75,0,DF,20-24,Defender,France,Europe
732,Koffi Djidji,CIV,Torino,Serie A,2021,28.0,1992.0,19.3,48,29,21,23,4,14,18,77.8,4,20,9,11,34,82,60,0,DF,25-29,Defender,Ivory Coast,Africa
735,Berat Djimsiti,ALB,Atalanta,Serie A,2021,28.0,1993.0,25.1,43,24,21,20,2,29,46,63.0,17,21,11,10,31,74,56,0,DF,25-29,Defender,Albania,Europe
736,Ouparine Djoco,GNB,Clermont Foot,Ligue 1,2021,23.0,1998.0,23.5,0,0,0,0,0,0,0,,0,0,0,0,1,1,14,2,GK,20-24,Goalkeeper,Guinea-Bissau,Africa
739,Lewis Dobbin,ENG,Everton,Premier League,2021,18.0,2003.0,0.4,2,1,0,1,1,1,2,50.0,1,0,0,0,0,2,0,0,"FW,MF",Under 20,Forward,England,Europe
740,Matt Doherty,IRL,Tottenham,Premier League,2021,29.0,1992.0,9.7,18,12,5,11,2,8,14,57.1,6,11,2,9,13,31,20,0,DF,25-29,Defender,Republic of Ireland,Europe
747,Nicolás Domínguez,ARG,Bologna,Serie A,2021,23.0,1998.0,22.4,76,45,36,32,8,32,76,42.1,44,38,9,29,32,108,34,1,MF,20-24,Midfielder,Argentina,South America
750,Anastasios Donis,GRE,Reims,Ligue 1,2021,24.0,1996.0,4.1,8,7,4,2,2,2,6,33.3,4,3,0,3,0,8,1,0,"FW,MF",20-24,Forward,Greece,Europe
751,Gianluigi Donnarumma,ITA,Paris S-G,Ligue 1,2021,22.0,1999.0,17.0,0,0,0,0,0,0,0,,0,0,0,0,0,0,9,2,GK,20-24,Goalkeeper,Italy,Europe
752,Niklas Dorsch,GER,Augsburg,Bundesliga,2021,23.0,1998.0,25.8,76,47,47,23,6,30,60,50.0,30,34,12,22,35,111,36,3,MF,20-24,Midfielder,Germany,Europe
753,Jodel Dossou,BEN,Clermont Foot,Ligue 1,2021,29.0,1992.0,22.3,36,17,15,14,7,15,43,34.9,28,14,0,14,5,41,7,0,FW,25-29,Forward,Benin,Africa
755,Abdoulaye Doucouré,MLI,Everton,Premier League,2021,28.0,1993.0,28.2,75,43,30,37,8,32,71,45.1,39,33,8,25,28,103,32,0,MF,25-29,Midfielder,Mali,Africa
756,Cheick Doucouré,MLI,Lens,Ligue 1,2021,21.0,2000.0,32.7,75,43,34,34,7,35,79,44.3,44,30,7,23,68,143,24,0,MF,20-24,Midfielder,Mali,Africa
757,Fodé Doucouré,MLI,Reims,Ligue 1,2021,20.0,2001.0,1.7,12,9,9,3,0,9,11,81.8,2,1,0,1,4,16,6,0,"DF,FW",20-24,Defender,Mali,Africa
758,Ismaël Doukouré,FRA,Strasbourg,Ligue 1,2021,18.0,2003.0,0.2,0,0,0,0,0,0,0,,0,0,0,0,0,0,1,0,DF,Under 20,Defender,France,Europe
760,Moussa Doumbia,MLI,Reims,Ligue 1,2021,26.0,1994.0,1.0,0,0,0,0,0,0,1,0.0,1,0,0,0,0,0,0,0,FW,25-29,Forward,Mali,Africa
764,Radu Drăgușin,ROU,Sampdoria,Serie A,2021,19.0,2002.0,6.9,4,3,2,2,0,2,6,33.3,4,8,4,4,10,14,33,0,DF,Under 20,Defender,Romania,Europe
765,Radu Drăgușin,ROU,Salernitana,Serie A,2021,19.0,2002.0,5.4,5,4,2,3,0,4,10,40.0,6,7,3,4,13,18,17,0,DF,Under 20,Defender,Romania,Europe
766,Cody Drameh,ENG,Leeds United,Premier League,2021,19.0,2001.0,1.4,4,2,3,1,0,1,3,33.3,2,0,0,0,1,5,4,0,"DF,MF",Under 20,Defender,England,Europe
768,Matthieu Dreyer,FRA,Lorient,Ligue 1,2021,32.0,1989.0,16.0,1,1,1,0,0,1,1,100.0,0,0,0,0,0,1,9,0,GK,30-34,Goalkeeper,France,Europe
769,Domingos Duarte,POR,Granada,La Liga,2021,26.0,1995.0,18.7,18,14,9,9,0,6,11,54.5,5,27,20,7,22,40,82,0,DF,25-29,Defender,Portugal,Europe
770,Óscar Duarte,CRC,Levante,La Liga,2021,32.0,1989.0,19.7,18,8,12,6,0,8,23,34.8,15,18,9,9,24,42,102,0,DF,30-34,Defender,Costa Rica,North America
773,Martin Dúbravka,SVK,Newcastle Utd,Premier League,2021,32.0,1989.0,26.0,1,1,1,0,0,0,1,0.0,1,0,0,0,0,1,8,2,GK,30-34,Goalkeeper,Slovakia,Europe
774,Ondrej Duda,SVK,Köln,Bundesliga,2021,26.0,1994.0,17.9,23,16,4,12,7,6,23,26.1,17,14,2,12,17,40,9,0,"MF,FW",25-29,Midfielder,Slovakia,Europe
776,Shane Duffy,IRL,Brighton,Premier League,2021,29.0,1992.0,16.0,15,12,12,3,0,8,14,57.1,6,24,18,6,16,31,76,1,DF,25-29,Defender,Republic of Ireland,Europe
778,Denzel Dumfries,NED,Inter,Serie A,2021,25.0,1996.0,22.5,32,12,9,14,9,16,32,50.0,16,15,6,9,9,41,26,0,DF,25-29,Defender,Netherlands,Europe
779,Paul Dummett,WAL,Newcastle Utd,Premier League,2021,29.0,1991.0,2.2,7,3,3,4,0,5,8,62.5,3,5,0,5,3,10,5,0,DF,25-29,Defender,Wales,Europe
780,Alfred Duncan,GHA,Fiorentina,Serie A,2021,28.0,1993.0,21.5,34,19,13,16,5,11,32,34.4,21,32,3,29,10,44,7,0,MF,25-29,Midfielder,Ghana,Africa
781,Lewis Dunk,ENG,Brighton,Premier League,2021,29.0,1991.0,28.6,10,8,5,5,0,5,11,45.5,6,32,28,4,27,37,113,3,DF,25-29,Defender,England,Europe
782,Erik Durm,GER,Eint Frankfurt,Bundesliga,2021,29.0,1992.0,5.3,13,7,6,5,2,10,13,76.9,3,8,1,7,10,23,7,0,DF,25-29,Defender,Germany,Europe
786,Paulo Dybala,ARG,Juventus,Serie A,2021,27.0,1993.0,22.9,30,13,7,14,9,8,35,22.9,27,19,0,19,9,39,4,3,"FW,MF",25-29,Forward,Argentina,South America
788,Enzo Ebosse,CMR,Angers,Ligue 1,2021,22.0,1999.0,21.0,25,14,19,6,0,11,19,57.9,8,19,9,10,15,40,42,0,DF,20-24,Defender,Cameroon,Africa
789,Tyronne Ebuehi,NGA,Venezia,Serie A,2021,25.0,1995.0,12.6,28,12,16,8,4,10,18,55.6,8,13,3,10,16,44,38,1,DF,25-29,Defender,Nigeria,Africa
790,Ederson,BRA,Manchester City,Premier League,2021,27.0,1993.0,37.0,2,1,2,0,0,0,2,0.0,2,0,0,0,0,2,12,0,GK,25-29,Goalkeeper,Brazil,South America
790,Ederson,BRA,Manchester City,Premier League,2021,27.0,1993.0,37.0,2,1,2,0,0,0,2,0.0,2,0,0,0,0,2,12,0,GK,25-29,Goalkeeper,Brazil,South America
790,Ederson,BRA,Manchester City,Premier League,2021,27.0,1993.0,37.0,2,1,2,0,0,0,2,0.0,2,0,0,0,0,2,12,0,GK,25-29,Goalkeeper,Brazil,South America
790,Ederson,BRA,Manchester City,Premier League,2021,27.0,1993.0,37.0,2,1,2,0,0,0,2,0.0,2,0,0,0,0,2,12,0,GK,25-29,Goalkeeper,Brazil,South America
791,Éderson,BRA,Salernitana,Serie A,2021,22.0,1999.0,12.7,29,18,11,14,4,14,26,53.8,12,11,2,9,19,48,8,0,MF,20-24,Midfielder,Brazil,South America
793,CJ Egan-Riley,ENG,Manchester City,Premier League,2021,18.0,2003.0,0.0,1,1,1,0,0,1,1,100.0,0,0,0,0,0,1,0,0,DF,Under 20,Defender,England,Europe
794,Maximilian Eggestein,GER,Freiburg,Bundesliga,2021,24.0,1996.0,24.4,48,28,17,25,6,22,50,44.0,28,35,11,24,30,78,32,1,MF,20-24,Midfielder,Germany,Europe
795,Lilian Egloff,GER,Stuttgart,Bundesliga,2021,18.0,2002.0,0.3,1,0,0,1,0,0,0,,0,1,0,1,0,1,0,0,"MF,DF",Under 20,Midfielder,Germany,Europe
796,Kingsley Ehizibue,NED,Köln,Bundesliga,2021,26.0,1995.0,7.6,32,18,27,5,0,15,24,62.5,9,13,4,9,9,41,26,0,DF,25-29,Defender,Netherlands,Europe
798,Albin Ekdal,SWE,Sampdoria,Serie A,2021,32.0,1989.0,18.2,43,28,17,21,5,26,56,46.4,30,27,7,20,29,72,25,0,MF,30-34,Midfielder,Sweden,Europe
800,Jurgen Ekkelenkamp,NED,Hertha BSC,Bundesliga,2021,21.0,2000.0,8.0,8,3,2,6,0,2,7,28.6,5,9,2,7,4,12,5,0,"MF,FW",20-24,Midfielder,Netherlands,Europe
801,Caleb Ekuban,GHA,Genoa,Serie A,2021,27.0,1994.0,19.1,19,12,2,12,5,7,23,30.4,16,19,5,14,9,28,6,0,"FW,MF",25-29,Forward,Ghana,Africa
802,Anthony Elanga,SWE,Manchester Utd,Premier League,2021,19.0,2002.0,13.5,26,20,12,12,2,15,29,51.7,14,17,1,16,9,35,7,0,FW,Under 20,Forward,Sweden,Europe
804,Harvey Elliott,ENG,Liverpool,Premier League,2021,18.0,2003.0,3.8,3,0,1,1,1,0,6,0.0,6,8,1,7,4,7,2,0,MF,Under 20,Midfielder,England,Europe
806,Mohamed Elneny,EGY,Arsenal,Premier League,2021,29.0,1992.0,9.0,16,8,10,5,1,7,12,58.3,5,7,1,6,14,30,13,0,MF,25-29,Midfielder,Egypt,Africa
808,Nico Elvedi,SUI,Gladbach,Bundesliga,2021,24.0,1996.0,27.0,40,24,23,17,0,22,36,61.1,14,33,22,11,34,74,83,1,DF,20-24,Defender,Switzerland,Europe
811,Breel Embolo,SUI,Gladbach,Bundesliga,2021,24.0,1997.0,24.1,16,11,1,12,3,3,8,37.5,5,14,2,12,6,22,7,0,FW,20-24,Forward,Switzerland,Europe
812,Emerson,BRA,Tottenham,Premier League,2021,22.0,1999.0,25.4,72,47,50,16,6,36,67,53.7,31,25,2,23,22,94,92,1,"DF,MF",20-24,Defender,Brazil,South America
813,Emerson,BRA,Barcelona,La Liga,2021,22.0,1999.0,1.0,3,3,2,1,0,1,2,50.0,1,1,0,1,2,5,1,0,DF,20-24,Defender,Brazil,South America
816,Keita Endo,JPN,Union Berlin,Bundesliga,2021,23.0,1997.0,0.6,1,1,1,0,0,0,0,,0,1,0,1,0,1,0,0,MF,20-24,Midfielder,Japan,Asia
817,Wataru Endo,JPN,Stuttgart,Bundesliga,2021,28.0,1993.0,32.2,73,41,34,34,5,31,72,43.1,41,43,12,31,30,103,64,0,MF,25-29,Midfielder,Japan,Asia
818,Christian Eriksen,DEN,Brentford,Premier League,2021,29.0,1992.0,10.4,13,6,4,5,4,8,17,47.1,9,9,1,8,9,22,14,0,MF,25-29,Midfielder,Denmark,Europe
820,Gonzalo Escalante,ARG,Lazio,Serie A,2021,28.0,1993.0,0.1,1,0,1,0,0,1,1,100.0,0,2,1,1,1,2,0,0,MF,25-29,Midfielder,Argentina,South America
821,Gonzalo Escalante,ARG,Alavés,La Liga,2021,28.0,1993.0,14.4,30,14,9,20,1,13,34,38.2,21,27,2,25,21,51,28,0,MF,25-29,Midfielder,Argentina,South America
824,Alfonso Espino,URU,Cádiz,La Liga,2021,29.0,1992.0,37.0,107,63,58,39,10,44,112,39.3,68,45,10,35,54,161,87,1,DF,25-29,Defender,Uruguay,South America
825,Michael Esser,GER,Bochum,Bundesliga,2021,33.0,1987.0,3.0,0,0,0,0,0,0,1,0.0,1,0,0,0,0,0,2,0,GK,30-34,Goalkeeper,Germany,Europe
827,Maxime Estève,FRA,Montpellier,Ligue 1,2021,19.0,2002.0,20.6,27,18,22,4,1,15,27,55.6,12,31,24,7,22,49,69,1,DF,Under 20,Defender,France,Europe
828,Pervis Estupiñán,ECU,Villarreal,La Liga,2021,23.0,1998.0,17.5,36,22,20,11,5,17,24,70.8,7,13,5,8,25,61,29,2,DF,20-24,Defender,Ecuador,South America
831,Eberechi Eze,ENG,Crystal Palace,Premier League,2021,23.0,1998.0,6.7,10,6,5,2,3,6,11,54.5,5,4,1,3,5,15,1,0,"MF,FW",20-24,Midfielder,England,Europe
832,Abde Ezzalzouli,MAR,Barcelona,La Liga,2021,19.0,2001.0,6.4,17,9,9,5,3,5,8,62.5,3,3,0,3,9,26,0,0,FW,Under 20,Forward,Morocco,Africa
834,Fabinho,BRA,Liverpool,Premier League,2021,27.0,1993.0,25.7,46,25,17,23,6,24,70,34.3,46,33,10,23,39,85,25,1,MF,25-29,Midfielder,Brazil,South America
834,Fabinho,BRA,Liverpool,Premier League,2021,27.0,1993.0,25.7,46,25,17,23,6,24,70,34.3,46,33,10,23,39,85,25,1,MF,25-29,Midfielder,Brazil,South America
834,Fabinho,BRA,Liverpool,Premier League,2021,27.0,1993.0,25.7,46,25,17,23,6,24,70,34.3,46,33,10,23,39,85,25,1,MF,25-29,Midfielder,Brazil,South America
834,Fabinho,BRA,Liverpool,Premier League,2021,27.0,1993.0,25.7,46,25,17,23,6,24,70,34.3,46,33,10,23,39,85,25,1,MF,25-29,Midfielder,Brazil,South America
834,Fabinho,BRA,Liverpool,Premier League,2021,27.0,1993.0,25.7,46,25,17,23,6,24,70,34.3,46,33,10,23,39,85,25,1,MF,25-29,Midfielder,Brazil,South America
834,Fabinho,BRA,Liverpool,Premier League,2021,27.0,1993.0,25.7,46,25,17,23,6,24,70,34.3,46,33,10,23,39,85,25,1,MF,25-29,Midfielder,Brazil,South America
834,Fabinho,BRA,Liverpool,Premier League,2021,27.0,1993.0,25.7,46,25,17,23,6,24,70,34.3,46,33,10,23,39,85,25,1,MF,25-29,Midfielder,Brazil,South America
834,Fabinho,BRA,Liverpool,Premier League,2021,27.0,1993.0,25.7,46,25,17,23,6,24,70,34.3,46,33,10,23,39,85,25,1,MF,25-29,Midfielder,Brazil,South America
834,Fabinho,BRA,Liverpool,Premier League,2021,27.0,1993.0,25.7,46,25,17,23,6,24,70,34.3,46,33,10,23,39,85,25,1,MF,25-29,Midfielder,Brazil,South America
834,Fabinho,BRA,Liverpool,Premier League,2021,27.0,1993.0,25.7,46,25,17,23,6,24,70,34.3,46,33,10,23,39,85,25,1,MF,25-29,Midfielder,Brazil,South America
834,Fabinho,BRA,Liverpool,Premier League,2021,27.0,1993.0,25.7,46,25,17,23,6,24,70,34.3,46,33,10,23,39,85,25,1,MF,25-29,Midfielder,Brazil,South America
834,Fabinho,BRA,Liverpool,Premier League,2021,27.0,1993.0,25.7,46,25,17,23,6,24,70,34.3,46,33,10,23,39,85,25,1,MF,25-29,Midfielder,Brazil,South America
834,Fabinho,BRA,Liverpool,Premier League,2021,27.0,1993.0,25.7,46,25,17,23,6,24,70,34.3,46,33,10,23,39,85,25,1,MF,25-29,Midfielder,Brazil,South America
834,Fabinho,BRA,Liverpool,Premier League,2021,27.0,1993.0,25.7,46,25,17,23,6,24,70,34.3,46,33,10,23,39,85,25,1,MF,25-29,Midfielder,Brazil,South America
834,Fabinho,BRA,Liverpool,Premier League,2021,27.0,1993.0,25.7,46,25,17,23,6,24,70,34.3,46,33,10,23,39,85,25,1,MF,25-29,Midfielder,Brazil,South America
834,Fabinho,BRA,Liverpool,Premier League,2021,27.0,1993.0,25.7,46,25,17,23,6,24,70,34.3,46,33,10,23,39,85,25,1,MF,25-29,Midfielder,Brazil,South America
834,Fabinho,BRA,Liverpool,Premier League,2021,27.0,1993.0,25.7,46,25,17,23,6,24,70,34.3,46,33,10,23,39,85,25,1,MF,25-29,Midfielder,Brazil,South America
834,Fabinho,BRA,Liverpool,Premier League,2021,27.0,1993.0,25.7,46,25,17,23,6,24,70,34.3,46,33,10,23,39,85,25,1,MF,25-29,Midfielder,Brazil,South America
834,Fabinho,BRA,Liverpool,Premier League,2021,27.0,1993.0,25.7,46,25,17,23,6,24,70,34.3,46,33,10,23,39,85,25,1,MF,25-29,Midfielder,Brazil,South America
834,Fabinho,BRA,Liverpool,Premier League,2021,27.0,1993.0,25.7,46,25,17,23,6,24,70,34.3,46,33,10,23,39,85,25,1,MF,25-29,Midfielder,Brazil,South America
834,Fabinho,BRA,Liverpool,Premier League,2021,27.0,1993.0,25.7,46,25,17,23,6,24,70,34.3,46,33,10,23,39,85,25,1,MF,25-29,Midfielder,Brazil,South America
834,Fabinho,BRA,Liverpool,Premier League,2021,27.0,1993.0,25.7,46,25,17,23,6,24,70,34.3,46,33,10,23,39,85,25,1,MF,25-29,Midfielder,Brazil,South America
834,Fabinho,BRA,Liverpool,Premier League,2021,27.0,1993.0,25.7,46,25,17,23,6,24,70,34.3,46,33,10,23,39,85,25,1,MF,25-29,Midfielder,Brazil,South America
834,Fabinho,BRA,Liverpool,Premier League,2021,27.0,1993.0,25.7,46,25,17,23,6,24,70,34.3,46,33,10,23,39,85,25,1,MF,25-29,Midfielder,Brazil,South America
834,Fabinho,BRA,Liverpool,Premier League,2021,27.0,1993.0,25.7,46,25,17,23,6,24,70,34.3,46,33,10,23,39,85,25,1,MF,25-29,Midfielder,Brazil,South America
835,Fábio,BRA,Nantes,Ligue 1,2021,31.0,1990.0,18.5,61,40,31,23,7,36,74,48.6,38,29,7,22,35,96,31,1,DF,30-34,Defender,Brazil,South America
837,Wout Faes,BEL,Reims,Ligue 1,2021,23.0,1998.0,37.0,40,24,30,9,1,25,33,75.8,8,47,37,10,53,93,169,2,DF,20-24,Defender,Belgium,Europe
838,Wahid Faghir,DEN,Stuttgart,Bundesliga,2021,18.0,2003.0,1.4,0,0,0,0,0,0,1,0.0,1,2,0,2,0,0,0,0,FW,Under 20,Forward,Denmark,Europe
839,Romain Faivre,FRA,Lyon,Ligue 1,2021,23.0,1998.0,9.9,10,4,2,6,2,4,13,30.8,9,4,0,4,3,13,2,0,"FW,MF",20-24,Forward,France,Europe
840,Romain Faivre,FRA,Brest,Ligue 1,2021,23.0,1998.0,19.9,30,18,12,13,5,12,30,40.0,18,11,0,11,13,43,10,0,MF,20-24,Midfielder,France,Europe
841,Radamel Falcao,COL,Rayo Vallecano,La Liga,2021,35.0,1986.0,9.3,2,1,0,1,1,1,4,25.0,3,4,1,3,2,4,11,0,FW,35-39,Forward,Colombia,South America
842,Diego Falcinelli,ITA,Bologna,Serie A,2021,30.0,1991.0,0.7,2,2,2,0,0,0,0,,0,0,0,0,1,3,1,0,FW,30-34,Forward,Italy,Europe
843,Wladimiro Falcone,ITA,Sampdoria,Serie A,2021,26.0,1995.0,9.5,0,0,0,0,0,0,0,,0,0,0,0,1,1,5,0,GK,25-29,Goalkeeper,Italy,Europe
845,Paolo Faragò,ITA,Cagliari,Serie A,2021,28.0,1993.0,0.2,1,1,1,0,0,0,0,,0,2,0,2,0,1,0,0,MF,25-29,Midfielder,Italy,Europe
846,Omar Faraj,PLE,Levante,La Liga,2021,19.0,2002.0,0.0,1,0,1,0,0,1,1,100.0,0,0,0,0,0,1,0,0,FW,Under 20,Forward,Palestine,Asia
847,Davide Faraoni,ITA,Hellas Verona,Serie A,2021,29.0,1991.0,28.6,62,40,38,21,3,29,62,46.8,33,38,5,33,23,85,62,1,DF,25-29,Defender,Italy,Europe
849,Diego Farias,BRA,Cagliari,Serie A,2021,31.0,1990.0,0.7,1,1,0,1,0,1,3,33.3,2,0,0,0,0,1,0,0,"MF,FW",30-34,Midfielder,Brazil,South America
852,Noah Fatar,FRA,Angers,Ligue 1,2021,19.0,2002.0,0.1,1,0,0,0,1,0,1,0.0,1,0,0,0,1,2,0,0,"DF,MF",Under 20,Defender,France,Europe
854,Julien Faussurier,FRA,Brest,Ligue 1,2021,34.0,1987.0,5.4,10,6,3,3,4,6,13,46.2,7,12,1,11,5,15,6,0,"MF,DF",30-34,Midfielder,France,Europe
855,Andrea Favilli,ITA,Genoa,Serie A,2021,24.0,1997.0,0.4,1,1,0,0,1,0,0,,0,0,0,0,0,1,2,0,FW,20-24,Forward,Italy,Europe
856,Federico Fazio,ARG,Salernitana,Serie A,2021,34.0,1987.0,15.9,17,11,10,6,1,9,12,75.0,3,21,16,5,27,44,67,1,DF,30-34,Defender,Argentina,South America
858,Peter Federico,DOM,Real Madrid,La Liga,2021,19.0,2002.0,0.3,0,0,0,0,0,0,0,,0,0,0,0,1,1,0,0,"MF,DF",Under 20,Midfielder,Dominican Republic,North America
860,Nabil Fekir,FRA,Betis,La Liga,2021,28.0,1993.0,31.0,43,29,5,25,13,7,36,19.4,29,14,0,14,7,50,7,0,MF,25-29,Midfielder,France,Europe
861,Felipe,BRA,Atlético Madrid,La Liga,2021,32.0,1989.0,16.7,20,15,11,8,1,8,18,44.4,10,17,11,6,28,48,77,0,DF,30-34,Defender,Brazil,South America
861,Felipe,BRA,Atlético Madrid,La Liga,2021,32.0,1989.0,16.7,20,15,11,8,1,8,18,44.4,10,17,11,6,28,48,77,0,DF,30-34,Defender,Brazil,South America
861,Felipe,BRA,Atlético Madrid,La Liga,2021,32.0,1989.0,16.7,20,15,11,8,1,8,18,44.4,10,17,11,6,28,48,77,0,DF,30-34,Defender,Brazil,South America
861,Felipe,BRA,Atlético Madrid,La Liga,2021,32.0,1989.0,16.7,20,15,11,8,1,8,18,44.4,10,17,11,6,28,48,77,0,DF,30-34,Defender,Brazil,South America
862,Luiz Felipe,ITA,Lazio,Serie A,2021,24.0,1997.0,27.7,41,23,21,16,4,20,34,58.8,14,40,33,7,33,74,102,1,DF,20-24,Defender,Italy,Europe
862,Luiz Felipe,ITA,Lazio,Serie A,2021,24.0,1997.0,27.7,41,23,21,16,4,20,34,58.8,14,40,33,7,33,74,102,1,DF,20-24,Defender,Italy,Europe
862,Luiz Felipe,ITA,Lazio,Serie A,2021,24.0,1997.0,27.7,41,23,21,16,4,20,34,58.8,14,40,33,7,33,74,102,1,DF,20-24,Defender,Italy,Europe
862,Luiz Felipe,ITA,Lazio,Serie A,2021,24.0,1997.0,27.7,41,23,21,16,4,20,34,58.8,14,40,33,7,33,74,102,1,DF,20-24,Defender,Italy,Europe
863,João Félix,POR,Atlético Madrid,La Liga,2021,21.0,1999.0,14.0,5,2,1,4,0,1,5,20.0,4,4,1,3,7,12,8,0,"FW,MF",20-24,Forward,Portugal,Europe
866,Evan Ferguson,IRL,Brighton,Premier League,2021,16.0,2004.0,0.3,0,0,0,0,0,0,0,,0,0,0,0,0,0,0,0,MF,Under 20,Midfielder,Republic of Ireland,Europe
867,Nathan Ferguson,ENG,Crystal Palace,Premier League,2021,20.0,2000.0,0.1,0,0,0,0,0,0,0,,0,0,0,0,0,0,0,0,DF,20-24,Defender,England,Europe
868,Bruno Fernandes,POR,Manchester Utd,Premier League,2021,26.0,1994.0,34.6,54,28,26,22,6,26,91,28.6,65,36,0,36,17,71,42,2,MF,25-29,Midfielder,Portugal,Europe
869,Edimilson Fernandes,SUI,Arminia,Bundesliga,2021,25.0,1996.0,3.1,2,0,1,1,0,1,4,25.0,3,2,2,0,2,4,6,0,"MF,FW",25-29,Midfielder,Switzerland,Europe
873,Federico Fernández,ARG,Newcastle Utd,Premier League,2021,32.0,1989.0,5.8,3,0,3,0,0,2,5,40.0,3,10,10,0,4,7,28,0,DF,30-34,Defender,Argentina,South America
874,Fernandinho,BRA,Manchester City,Premier League,2021,36.0,1985.0,10.7,21,10,7,10,4,9,27,33.3,18,8,2,6,8,29,13,1,"MF,DF",35-39,Midfielder,Brazil,South America
874,Fernandinho,BRA,Manchester City,Premier League,2021,36.0,1985.0,10.7,21,10,7,10,4,9,27,33.3,18,8,2,6,8,29,13,1,"MF,DF",35-39,Midfielder,Brazil,South America
874,Fernandinho,BRA,Manchester City,Premier League,2021,36.0,1985.0,10.7,21,10,7,10,4,9,27,33.3,18,8,2,6,8,29,13,1,"MF,DF",35-39,Midfielder,Brazil,South America
874,Fernandinho,BRA,Manchester City,Premier League,2021,36.0,1985.0,10.7,21,10,7,10,4,9,27,33.3,18,8,2,6,8,29,13,1,"MF,DF",35-39,Midfielder,Brazil,South America
874,Fernandinho,BRA,Manchester City,Premier League,2021,36.0,1985.0,10.7,21,10,7,10,4,9,27,33.3,18,8,2,6,8,29,13,1,"MF,DF",35-39,Midfielder,Brazil,South America
874,Fernandinho,BRA,Manchester City,Premier League,2021,36.0,1985.0,10.7,21,10,7,10,4,9,27,33.3,18,8,2,6,8,29,13,1,"MF,DF",35-39,Midfielder,Brazil,South America
874,Fernandinho,BRA,Manchester City,Premier League,2021,36.0,1985.0,10.7,21,10,7,10,4,9,27,33.3,18,8,2,6,8,29,13,1,"MF,DF",35-39,Midfielder,Brazil,South America
874,Fernandinho,BRA,Manchester City,Premier League,2021,36.0,1985.0,10.7,21,10,7,10,4,9,27,33.3,18,8,2,6,8,29,13,1,"MF,DF",35-39,Midfielder,Brazil,South America
874,Fernandinho,BRA,Manchester City,Premier League,2021,36.0,1985.0,10.7,21,10,7,10,4,9,27,33.3,18,8,2,6,8,29,13,1,"MF,DF",35-39,Midfielder,Brazil,South America
874,Fernandinho,BRA,Manchester City,Premier League,2021,36.0,1985.0,10.7,21,10,7,10,4,9,27,33.3,18,8,2,6,8,29,13,1,"MF,DF",35-39,Midfielder,Brazil,South America
874,Fernandinho,BRA,Manchester City,Premier League,2021,36.0,1985.0,10.7,21,10,7,10,4,9,27,33.3,18,8,2,6,8,29,13,1,"MF,DF",35-39,Midfielder,Brazil,South America
874,Fernandinho,BRA,Manchester City,Premier League,2021,36.0,1985.0,10.7,21,10,7,10,4,9,27,33.3,18,8,2,6,8,29,13,1,"MF,DF",35-39,Midfielder,Brazil,South America
874,Fernandinho,BRA,Manchester City,Premier League,2021,36.0,1985.0,10.7,21,10,7,10,4,9,27,33.3,18,8,2,6,8,29,13,1,"MF,DF",35-39,Midfielder,Brazil,South America
874,Fernandinho,BRA,Manchester City,Premier League,2021,36.0,1985.0,10.7,21,10,7,10,4,9,27,33.3,18,8,2,6,8,29,13,1,"MF,DF",35-39,Midfielder,Brazil,South America
874,Fernandinho,BRA,Manchester City,Premier League,2021,36.0,1985.0,10.7,21,10,7,10,4,9,27,33.3,18,8,2,6,8,29,13,1,"MF,DF",35-39,Midfielder,Brazil,South America
874,Fernandinho,BRA,Manchester City,Premier League,2021,36.0,1985.0,10.7,21,10,7,10,4,9,27,33.3,18,8,2,6,8,29,13,1,"MF,DF",35-39,Midfielder,Brazil,South America
875,Fernando,BRA,Sevilla,La Liga,2021,34.0,1987.0,20.6,24,17,14,9,1,12,33,36.4,21,21,13,8,29,53,32,2,"MF,DF",30-34,Midfielder,Brazil,South America
875,Fernando,BRA,Sevilla,La Liga,2021,34.0,1987.0,20.6,24,17,14,9,1,12,33,36.4,21,21,13,8,29,53,32,2,"MF,DF",30-34,Midfielder,Brazil,South America
875,Fernando,BRA,Sevilla,La Liga,2021,34.0,1987.0,20.6,24,17,14,9,1,12,33,36.4,21,21,13,8,29,53,32,2,"MF,DF",30-34,Midfielder,Brazil,South America
875,Fernando,BRA,Sevilla,La Liga,2021,34.0,1987.0,20.6,24,17,14,9,1,12,33,36.4,21,21,13,8,29,53,32,2,"MF,DF",30-34,Midfielder,Brazil,South America
875,Fernando,BRA,Sevilla,La Liga,2021,34.0,1987.0,20.6,24,17,14,9,1,12,33,36.4,21,21,13,8,29,53,32,2,"MF,DF",30-34,Midfielder,Brazil,South America
875,Fernando,BRA,Sevilla,La Liga,2021,34.0,1987.0,20.6,24,17,14,9,1,12,33,36.4,21,21,13,8,29,53,32,2,"MF,DF",30-34,Midfielder,Brazil,South America
875,Fernando,BRA,Sevilla,La Liga,2021,34.0,1987.0,20.6,24,17,14,9,1,12,33,36.4,21,21,13,8,29,53,32,2,"MF,DF",30-34,Midfielder,Brazil,South America
875,Fernando,BRA,Sevilla,La Liga,2021,34.0,1987.0,20.6,24,17,14,9,1,12,33,36.4,21,21,13,8,29,53,32,2,"MF,DF",30-34,Midfielder,Brazil,South America
875,Fernando,BRA,Sevilla,La Liga,2021,34.0,1987.0,20.6,24,17,14,9,1,12,33,36.4,21,21,13,8,29,53,32,2,"MF,DF",30-34,Midfielder,Brazil,South America
875,Fernando,BRA,Sevilla,La Liga,2021,34.0,1987.0,20.6,24,17,14,9,1,12,33,36.4,21,21,13,8,29,53,32,2,"MF,DF",30-34,Midfielder,Brazil,South America
875,Fernando,BRA,Sevilla,La Liga,2021,34.0,1987.0,20.6,24,17,14,9,1,12,33,36.4,21,21,13,8,29,53,32,2,"MF,DF",30-34,Midfielder,Brazil,South America
875,Fernando,BRA,Sevilla,La Liga,2021,34.0,1987.0,20.6,24,17,14,9,1,12,33,36.4,21,21,13,8,29,53,32,2,"MF,DF",30-34,Midfielder,Brazil,South America
875,Fernando,BRA,Sevilla,La Liga,2021,34.0,1987.0,20.6,24,17,14,9,1,12,33,36.4,21,21,13,8,29,53,32,2,"MF,DF",30-34,Midfielder,Brazil,South America
875,Fernando,BRA,Sevilla,La Liga,2021,34.0,1987.0,20.6,24,17,14,9,1,12,33,36.4,21,21,13,8,29,53,32,2,"MF,DF",30-34,Midfielder,Brazil,South America
875,Fernando,BRA,Sevilla,La Liga,2021,34.0,1987.0,20.6,24,17,14,9,1,12,33,36.4,21,21,13,8,29,53,32,2,"MF,DF",30-34,Midfielder,Brazil,South America
875,Fernando,BRA,Sevilla,La Liga,2021,34.0,1987.0,20.6,24,17,14,9,1,12,33,36.4,21,21,13,8,29,53,32,2,"MF,DF",30-34,Midfielder,Brazil,South America
876,Alex Ferrari,ITA,Sampdoria,Serie A,2021,27.0,1994.0,18.3,40,22,28,9,3,19,33,57.6,14,31,22,9,39,79,63,1,DF,25-29,Defender,Italy,Europe
878,Jordan Ferri,FRA,Montpellier,Ligue 1,2021,29.0,1992.0,32.3,55,35,28,23,4,29,87,33.3,58,21,5,16,30,85,35,0,MF,25-29,Midfielder,France,Europe
879,Riccardo Fiamozzi,ITA,Empoli,Serie A,2021,28.0,1993.0,6.9,7,5,2,2,3,2,4,50.0,2,6,5,1,7,14,12,0,DF,25-29,Defender,Italy,Europe
883,Luca Fiordilino,ITA,Venezia,Serie A,2021,25.0,1996.0,7.3,21,13,11,6,4,13,27,48.1,14,14,4,10,11,32,12,0,MF,25-29,Midfielder,Italy,Europe
884,Vincenzo Fiorillo,ITA,Salernitana,Serie A,2021,31.0,1990.0,1.0,0,0,0,0,0,0,0,,0,0,0,0,0,0,1,0,GK,30-34,Goalkeeper,Italy,Europe
885,Roberto Firmino,BRA,Liverpool,Premier League,2021,29.0,1991.0,11.0,23,14,5,8,10,3,16,18.8,13,20,0,20,4,27,3,0,FW,25-29,Forward,Brazil,South America
886,Junior Firpo,DOM,Leeds United,Premier League,2021,24.0,1996.0,19.0,61,29,30,26,5,31,59,52.5,28,22,6,16,24,85,37,0,"DF,MF",20-24,Defender,Dominican Republic,North America
887,Mark Flekken,NED,Freiburg,Bundesliga,2021,28.0,1993.0,32.0,0,0,0,0,0,0,2,0.0,2,1,0,1,2,2,10,1,GK,25-29,Goalkeeper,Netherlands,Europe
888,Ashley Fletcher,ENG,Watford,Premier League,2021,25.0,1995.0,0.3,2,1,1,1,0,1,1,100.0,0,1,1,0,0,2,0,0,FW,25-29,Forward,England,Europe
890,Alessandro Florenzi,ITA,Milan,Serie A,2021,30.0,1991.0,12.8,28,14,14,7,7,14,32,43.8,18,9,2,7,27,55,10,1,"DF,FW",30-34,Defender,Italy,Europe
891,Phil Foden,ENG,Manchester City,Premier League,2021,21.0,2000.0,23.6,16,8,10,4,2,7,17,41.2,10,9,0,9,11,27,5,0,FW,20-24,Forward,England,Europe
892,Mamadou Fofana,MLI,Metz,Ligue 1,2021,23.0,1998.0,0.4,1,1,0,1,0,1,2,50.0,1,2,1,1,1,2,2,0,DF,20-24,Defender,Mali,Africa
893,Seko Fofana,CIV,Lens,Ligue 1,2021,26.0,1995.0,37.3,27,19,11,13,3,12,58,20.7,46,24,2,22,26,53,17,1,MF,25-29,Midfielder,Ivory Coast,Africa
894,Wesley Fofana,FRA,Leicester City,Premier League,2021,20.0,2000.0,7.0,12,8,11,1,0,7,11,63.6,4,5,2,3,12,24,26,1,DF,20-24,Defender,France,Europe
895,Youssouf Fofana,FRA,Monaco,Ligue 1,2021,22.0,1999.0,24.3,69,43,19,41,9,29,56,51.8,27,29,7,22,32,101,22,2,MF,20-24,Midfielder,France,Europe
897,Thomas Fontaine,MAD,Lorient,Ligue 1,2021,30.0,1991.0,1.9,2,0,1,0,1,0,1,0.0,1,3,3,0,2,4,4,0,DF,30-34,Defender,Madagascar,Africa
900,Fernando Forestieri,ITA,Udinese,Serie A,2021,31.0,1990.0,0.6,0,0,0,0,0,0,1,0.0,1,1,0,1,0,0,1,0,"FW,MF",30-34,Forward,Italy,Europe
902,Emil Forsberg,SWE,RB Leipzig,Bundesliga,2021,29.0,1991.0,19.0,21,12,2,11,8,7,22,31.8,15,18,0,18,2,23,2,1,MF,25-29,Midfielder,Sweden,Europe
903,Adam Forshaw,ENG,Leeds United,Premier League,2021,29.0,1991.0,17.0,53,23,21,27,5,21,54,38.9,33,17,1,16,19,72,12,2,MF,25-29,Midfielder,England,Europe
904,Marcus Forss,FIN,Brentford,Premier League,2021,22.0,1999.0,2.3,3,3,0,2,1,2,4,50.0,2,5,0,5,1,4,0,0,"FW,MF",20-24,Forward,Finland,Europe
905,Fraser Forster,ENG,Southampton,Premier League,2021,33.0,1988.0,19.0,1,0,1,0,0,0,1,0.0,1,0,0,0,0,1,23,2,GK,30-34,Goalkeeper,England,Europe
906,Philipp Förster,GER,Stuttgart,Bundesliga,2021,26.0,1995.0,10.7,20,13,4,12,4,11,26,42.3,15,12,1,11,3,23,2,0,"MF,FW",25-29,Midfielder,Germany,Europe
907,Francesco Forte,ITA,Venezia,Serie A,2021,28.0,1993.0,4.7,3,2,0,2,1,2,5,40.0,3,1,0,1,0,3,2,0,FW,25-29,Forward,Italy,Europe
907,Francesco Forte,ITA,Venezia,Serie A,2021,28.0,1993.0,4.7,3,2,0,2,1,2,5,40.0,3,1,0,1,0,3,2,0,FW,25-29,Forward,Italy,Europe
907,Francesco Forte,ITA,Venezia,Serie A,2021,28.0,1993.0,4.7,3,2,0,2,1,2,5,40.0,3,1,0,1,0,3,2,0,FW,25-29,Forward,Italy,Europe
907,Francesco Forte,ITA,Venezia,Serie A,2021,28.0,1993.0,4.7,3,2,0,2,1,2,5,40.0,3,1,0,1,0,3,2,0,FW,25-29,Forward,Italy,Europe
908,Steven Fortes,CPV,Lens,Ligue 1,2021,29.0,1992.0,1.0,2,0,2,0,0,1,2,50.0,1,2,1,1,0,2,4,0,DF,25-29,Defender,Cape Verde,Africa
909,Ben Foster,ENG,Watford,Premier League,2021,38.0,1983.0,26.0,0,0,0,0,0,0,3,0.0,3,0,0,0,0,0,9,4,GK,35-39,Goalkeeper,England,Europe
910,Tariqe Fosu,GHA,Brentford,Premier League,2021,25.0,1995.0,0.2,0,0,0,0,0,0,0,,0,1,0,1,0,0,0,0,DF,25-29,Defender,Ghana,Africa
911,Timothy Fosu-Mensah,NED,Leverkusen,Bundesliga,2021,23.0,1998.0,1.6,5,3,3,1,1,4,4,100.0,0,1,0,1,2,7,2,0,DF,20-24,Defender,Netherlands,Europe
912,Dimitri Foulquier,FRA,Granada,La Liga,2021,28.0,1993.0,2.0,0,0,0,0,0,0,1,0.0,1,2,1,1,1,1,2,0,DF,25-29,Defender,France,Europe
913,Dimitri Foulquier,FRA,Valencia,La Liga,2021,28.0,1993.0,26.0,36,17,17,15,4,21,34,61.8,13,19,3,16,29,65,49,0,DF,25-29,Defender,France,Europe
914,Juan Foyth,ARG,Villarreal,La Liga,2021,23.0,1998.0,21.4,69,49,35,28,6,35,47,74.5,12,29,7,22,20,89,50,0,DF,20-24,Defender,Argentina,South America
915,Gianluca Frabotta,ITA,Hellas Verona,Serie A,2021,22.0,1999.0,0.2,0,0,0,0,0,0,1,0.0,1,1,0,1,1,1,0,0,"DF,MF",20-24,Defender,Italy,Europe
916,Raphael Framberger,GER,Augsburg,Bundesliga,2021,25.0,1995.0,9.4,26,19,12,10,4,13,27,48.1,14,8,2,6,9,35,25,0,DF,25-29,Defender,Germany,Europe
920,Ryan Fraser,SCO,Newcastle Utd,Premier League,2021,27.0,1994.0,16.3,10,3,5,3,2,5,13,38.5,8,11,1,10,11,21,11,0,"FW,MF",25-29,Forward,Scotland,Europe
921,Davide Frattesi,ITA,Sassuolo,Serie A,2021,21.0,1999.0,31.7,46,16,26,18,2,26,52,50.0,26,44,12,32,29,75,62,1,MF,20-24,Midfielder,Italy,Europe
923,Ryan Fredericks,ENG,West Ham,Premier League,2021,28.0,1992.0,3.4,2,2,2,0,0,0,1,0.0,1,2,1,1,4,6,6,0,DF,25-29,Defender,England,Europe
924,Morten Frendrup,DEN,Genoa,Serie A,2021,20.0,2001.0,7.7,40,24,19,13,8,13,29,44.8,16,19,2,17,17,57,7,1,"DF,MF",20-24,Defender,Denmark,Europe
925,Remo Freuler,SUI,Atalanta,Serie A,2021,29.0,1992.0,26.3,69,39,22,33,14,30,70,42.9,40,48,8,40,35,104,26,1,MF,25-29,Midfielder,Switzerland,Europe
926,Marvin Friedrich,GER,Gladbach,Bundesliga,2021,25.0,1995.0,6.7,14,8,10,4,0,9,11,81.8,2,5,3,2,5,19,26,0,DF,25-29,Defender,Germany,Europe
927,Marvin Friedrich,GER,Union Berlin,Bundesliga,2021,25.0,1995.0,13.0,17,5,14,3,0,10,16,62.5,6,13,7,6,23,40,47,0,DF,25-29,Defender,Germany,Europe
928,Jeremie Frimpong,NED,Leverkusen,Bundesliga,2021,20.0,2000.0,22.8,32,18,19,12,1,12,23,52.2,11,24,6,18,17,49,40,2,DF,20-24,Defender,Netherlands,Europe
929,Christian Früchtl,GER,Bayern Munich,Bundesliga,2021,21.0,2000.0,0.1,0,0,0,0,0,0,0,,0,0,0,0,0,0,0,0,GK,20-24,Goalkeeper,Germany,Europe
932,Chris Führich,GER,Stuttgart,Bundesliga,2021,23.0,1998.0,19.0,28,16,10,10,8,18,39,46.2,21,31,2,29,8,36,9,0,"FW,MF",20-24,Forward,Germany,Europe
933,Angelo Fulgini,FRA,Angers,Ligue 1,2021,24.0,1996.0,32.5,35,25,8,18,9,14,44,31.8,30,21,5,16,22,57,5,1,"MF,FW",20-24,Midfielder,France,Europe
934,Marius Funk,GER,Greuther Fürth,Bundesliga,2021,25.0,1996.0,8.0,0,0,0,0,0,0,0,,0,0,0,0,0,0,8,1,GK,25-29,Goalkeeper,Germany,Europe
935,Stephan Fürstner,GER,Mainz 05,Bundesliga,2021,33.0,1987.0,0.1,0,0,0,0,0,0,2,0.0,2,0,0,0,0,0,1,0,MF,30-34,Midfielder,Germany,Europe
936,Matteo Gabbia,ITA,Milan,Serie A,2021,21.0,1999.0,6.0,4,3,1,3,0,0,4,0.0,4,2,2,0,8,12,12,0,DF,20-24,Defender,Italy,Europe
937,Manolo Gabbiadini,ITA,Sampdoria,Serie A,2021,29.0,1991.0,12.7,6,4,3,2,1,1,7,14.3,6,5,2,3,3,9,10,0,"FW,MF",25-29,Forward,Italy,Europe
939,Gianluca Gaetano,ITA,Napoli,Serie A,2021,21.0,2000.0,0.2,1,1,1,0,0,1,2,50.0,1,0,0,0,2,3,0,0,MF,20-24,Midfielder,Italy,Europe
940,Luca Gagliano,ITA,Cagliari,Serie A,2021,21.0,2000.0,0.1,0,0,0,0,0,0,0,,0,1,0,1,0,0,1,0,"FW,DF",20-24,Forward,Italy,Europe
941,Roberto Gagliardini,ITA,Inter,Serie A,2021,27.0,1994.0,7.2,12,6,7,4,1,1,13,7.7,12,14,5,9,9,21,7,0,MF,25-29,Midfielder,Italy,Europe
942,Riccardo Gagliolo,SWE,Salernitana,Serie A,2021,31.0,1990.0,12.6,23,12,16,4,3,16,27,59.3,11,15,8,7,28,51,52,0,DF,30-34,Defender,Sweden,Europe
945,Nicolas Galazzi,ITA,Venezia,Serie A,2021,20.0,2000.0,0.2,2,1,1,0,1,0,1,0.0,1,0,0,0,0,2,0,0,MF,20-24,Midfielder,Italy,Europe
947,Thiago Galhardo,BRA,Celta Vigo,La Liga,2021,32.0,1989.0,12.8,12,6,3,3,6,2,12,16.7,10,15,2,13,6,18,9,0,"FW,MF",30-34,Forward,Brazil,South America
948,Conor Gallagher,ENG,Crystal Palace,Premier League,2021,21.0,2000.0,31.6,69,38,35,20,14,21,69,30.4,48,58,9,49,29,98,26,0,MF,20-24,Midfielder,England,Europe
949,Gauthier Gallon,FRA,Troyes,Ligue 1,2021,28.0,1993.0,31.0,3,0,3,0,0,1,1,100.0,0,0,0,0,2,5,12,1,GK,25-29,Goalkeeper,France,Europe
950,Cristian Gamboa,CRC,Bochum,Bundesliga,2021,31.0,1989.0,19.1,59,36,40,16,3,30,61,49.2,31,22,7,15,32,91,35,1,DF,30-34,Defender,Costa Rica,North America
951,Kévin Gameiro,FRA,Strasbourg,Ligue 1,2021,34.0,1987.0,26.5,19,10,5,9,5,6,18,33.3,12,22,1,21,6,25,1,0,FW,30-34,Forward,France,Europe
953,Ignatius Ganago,CMR,Lens,Ligue 1,2021,22.0,1999.0,11.4,3,2,1,2,0,2,6,33.3,4,4,0,4,2,5,3,0,FW,20-24,Forward,Cameroon,Africa
969,Johan Gastien,FRA,Clermont Foot,Ligue 1,2021,33.0,1988.0,30.5,56,34,26,25,5,27,74,36.5,47,45,11,34,53,109,49,1,MF,30-34,Midfielder,France,Europe
974,Linus Gechter,GER,Hertha BSC,Bundesliga,2021,17.0,2004.0,8.0,15,8,13,2,0,7,14,50.0,7,12,7,5,11,26,29,0,DF,Under 20,Defender,Germany,Europe
975,Dennis Geiger,GER,Hoffenheim,Bundesliga,2021,23.0,1998.0,15.3,34,23,9,20,5,17,30,56.7,13,15,1,14,14,48,7,1,MF,20-24,Midfielder,Germany,Europe
976,Joe Gelhardt,ENG,Leeds United,Premier League,2021,19.0,2002.0,8.3,4,3,1,0,3,2,10,20.0,8,9,0,9,0,4,3,0,"FW,MF",Under 20,Forward,England,Europe
977,Luca Gemello,ITA,Torino,Serie A,2021,21.0,2000.0,1.0,0,0,0,0,0,0,0,,0,0,0,0,0,0,0,0,GK,20-24,Goalkeeper,Italy,Europe
978,Yannick Gerhardt,GER,Wolfsburg,Bundesliga,2021,27.0,1994.0,17.5,42,20,18,17,7,22,36,61.1,14,24,1,23,25,67,25,1,"MF,DF",25-29,Midfielder,Germany,Europe
979,Valère Germain,FRA,Montpellier,Ligue 1,2021,31.0,1990.0,21.9,23,14,6,11,6,8,31,25.8,23,13,1,12,9,32,27,0,FW,30-34,Forward,France,Europe
980,Gerson,BRA,Marseille,Ligue 1,2021,24.0,1997.0,28.3,42,17,16,20,6,8,35,22.9,27,26,4,22,16,58,16,2,"MF,FW",20-24,Midfielder,Brazil,South America
981,Willem Geubbels,FRA,Nantes,Ligue 1,2021,19.0,2001.0,6.0,8,5,4,2,2,5,12,41.7,7,5,0,5,6,14,5,0,"FW,MF",Under 20,Forward,France,Europe
982,Hamadi Al Ghaddioui,MAR,Stuttgart,Bundesliga,2021,30.0,1990.0,5.5,5,4,2,1,2,0,4,0.0,4,3,1,2,0,5,4,0,FW,30-34,Forward,Morocco,Africa
984,Anwar El Ghazi,NED,Aston Villa,Premier League,2021,26.0,1995.0,4.3,4,4,2,2,0,2,7,28.6,5,6,0,6,1,5,2,0,"FW,MF",25-29,Forward,Netherlands,Europe
985,Anwar El Ghazi,NED,Everton,Premier League,2021,26.0,1995.0,0.1,1,1,1,0,0,1,1,100.0,0,3,0,3,0,1,0,0,"FW,MF",25-29,Forward,Netherlands,Europe
986,Lamine Ghezali,FRA,Saint-Étienne,Ligue 1,2021,22.0,1999.0,0.0,0,0,0,0,0,0,0,,0,1,0,1,0,0,0,0,DF,20-24,Defender,France,Europe
987,Paolo Ghiglione,ITA,Genoa,Serie A,2021,24.0,1997.0,6.7,17,12,8,6,3,9,14,64.3,5,11,5,6,10,27,12,1,DF,20-24,Defender,Italy,Europe
988,Saman Ghoddos,IRN,Brentford,Premier League,2021,27.0,1993.0,6.0,17,10,8,6,3,9,15,60.0,6,2,0,2,3,20,16,0,"MF,DF",25-29,Midfielder,Iran,Asia
991,Morgan Gibbs-White,ENG,Wolves,Premier League,2021,21.0,2000.0,0.1,0,0,0,0,0,0,0,,0,1,0,1,0,0,0,0,"DF,FW",20-24,Defender,England,Europe
992,Ben Gibson,ENG,Norwich City,Premier League,2021,28.0,1993.0,27.7,23,16,17,6,0,7,12,58.3,5,36,30,6,27,50,139,2,DF,25-29,Defender,England,Europe
993,Niko Gießelmann,GER,Union Berlin,Bundesliga,2021,29.0,1991.0,23.1,24,17,10,11,3,15,38,39.5,23,26,4,22,18,42,29,1,"DF,FW",25-29,Defender,Germany,Europe
999,Billy Gilmour,SCO,Norwich City,Premier League,2021,20.0,2001.0,20.6,41,21,16,21,4,14,52,26.9,38,21,4,17,17,58,29,0,MF,20-24,Midfielder,Scotland,Europe
1000,Daniel Ginczek,GER,Wolfsburg,Bundesliga,2021,30.0,1991.0,0.1,0,0,0,0,0,0,0,,0,0,0,0,0,0,0,0,"MF,FW",30-34,Midfielder,Germany,Europe
1001,Matthias Ginter,GER,Gladbach,Bundesliga,2021,27.0,1994.0,26.2,36,22,20,13,3,27,40,67.5,13,21,10,11,33,69,76,0,DF,25-29,Defender,Germany,Europe
1003,Sebastian Giovinco,ITA,Sampdoria,Serie A,2021,34.0,1987.0,0.4,0,0,0,0,0,0,1,0.0,1,0,0,0,0,0,0,0,MF,30-34,Midfielder,Italy,Europe
1004,Jimmy Giraudon,FRA,Troyes,Ligue 1,2021,29.0,1992.0,18.0,14,6,10,4,0,7,22,31.8,15,24,14,10,37,51,68,1,DF,25-29,Defender,France,Europe
1005,Andrei Girotto,BRA,Nantes,Ligue 1,2021,29.0,1992.0,35.0,85,52,49,32,4,52,103,50.5,51,67,33,34,69,154,143,0,"DF,MF",25-29,Defender,Brazil,South America
1006,Olivier Giroud,FRA,Milan,Serie A,2021,34.0,1986.0,21.0,15,11,4,6,5,3,17,17.6,14,13,4,9,3,18,19,0,FW,30-34,Forward,France,Europe
1008,Serge Gnabry,GER,Bayern Munich,Bundesliga,2021,26.0,1995.0,24.3,47,31,16,20,11,22,57,38.6,35,26,0,26,14,61,3,0,"FW,DF",25-29,Forward,Germany,Europe
1009,Ben Godfrey,ENG,Everton,Premier League,2021,23.0,1998.0,22.5,47,32,29,14,4,24,39,61.5,15,41,19,22,15,62,100,2,DF,20-24,Defender,England,Europe
1010,Diego Godín,URU,Cagliari,Serie A,2021,35.0,1986.0,9.1,18,7,13,3,2,10,15,66.7,5,7,5,2,13,31,46,0,DF,35-39,Defender,Uruguay,South America
1011,Edoardo Goldaniga,ITA,Cagliari,Serie A,2021,27.0,1993.0,10.4,12,5,7,5,0,4,11,36.4,7,8,5,3,22,34,23,0,DF,25-29,Defender,Italy,Europe
1012,Edoardo Goldaniga,ITA,Sassuolo,Serie A,2021,27.0,1993.0,0.0,0,0,0,0,0,0,0,,0,0,0,0,0,0,0,0,"DF,MF",25-29,Defender,Italy,Europe
1013,Aleksandr Golovin,RUS,Monaco,Ligue 1,2021,25.0,1996.0,16.7,40,22,10,18,12,18,41,43.9,23,26,1,25,12,52,8,0,"FW,MF",25-29,Forward,Russia,Europe
1014,André Gomes,POR,Everton,Premier League,2021,28.0,1993.0,6.9,16,4,6,6,4,8,32,25.0,24,8,2,6,1,17,7,1,MF,25-29,Midfielder,Portugal,Europe
1014,André Gomes,POR,Everton,Premier League,2021,28.0,1993.0,6.9,16,4,6,6,4,8,32,25.0,24,8,2,6,1,17,7,1,MF,25-29,Midfielder,Portugal,Europe
1014,André Gomes,POR,Everton,Premier League,2021,28.0,1993.0,6.9,16,4,6,6,4,8,32,25.0,24,8,2,6,1,17,7,1,MF,25-29,Midfielder,Portugal,Europe
1014,André Gomes,POR,Everton,Premier League,2021,28.0,1993.0,6.9,16,4,6,6,4,8,32,25.0,24,8,2,6,1,17,7,1,MF,25-29,Midfielder,Portugal,Europe
1015,Angel Gomes,ENG,Lille,Ligue 1,2021,20.0,2000.0,10.6,23,13,6,12,5,10,15,66.7,5,4,0,4,3,26,4,0,"MF,FW",20-24,Midfielder,England,Europe
1018,Joe Gomez,ENG,Liverpool,Premier League,2021,24.0,1997.0,3.7,10,6,5,2,3,5,9,55.6,4,4,1,3,5,15,6,0,DF,20-24,Defender,England,Europe
1019,Maxi Gómez,URU,Valencia,La Liga,2021,24.0,1996.0,21.7,5,3,1,2,2,5,8,62.5,3,5,1,4,3,8,22,0,FW,20-24,Forward,Uruguay,South America
1021,Papu Gómez,ARG,Sevilla,La Liga,2021,33.0,1988.0,19.8,19,11,9,5,5,9,35,25.7,26,15,2,13,7,26,12,2,"FW,MF",30-34,Forward,Argentina,South America
1024,Alfred Gomis,SEN,Rennes,Ligue 1,2021,27.0,1993.0,25.0,1,0,1,0,0,1,2,50.0,1,0,0,0,1,2,8,2,GK,25-29,Goalkeeper,Senegal,Africa
1025,Maxime Gonalons,FRA,Granada,La Liga,2021,32.0,1989.0,17.2,43,28,17,22,4,14,39,35.9,25,33,10,23,18,61,29,0,MF,30-34,Midfielder,France,Europe
1027,Cedric Gondo,CIV,Salernitana,Serie A,2021,24.0,1996.0,7.8,5,2,2,2,1,2,5,40.0,3,2,0,2,3,8,2,0,FW,20-24,Forward,Ivory Coast,Africa
1035,Charlie Goode,ENG,Brentford,Premier League,2021,25.0,1995.0,5.0,7,5,5,2,0,4,4,100.0,0,4,2,2,2,9,8,0,DF,25-29,Defender,England,Europe
1036,Anthony Gordon,ENG,Everton,Premier League,2021,20.0,2001.0,25.4,54,32,20,30,4,21,59,35.6,38,49,3,46,22,76,17,0,"MF,FW",20-24,Midfielder,England,Europe
1037,Kaide Gordon,ENG,Liverpool,Premier League,2021,16.0,2004.0,0.1,1,0,0,0,1,0,0,,0,0,0,0,0,1,0,0,FW,Under 20,Forward,England,Europe
1038,Leon Goretzka,GER,Bayern Munich,Bundesliga,2021,26.0,1995.0,15.5,25,15,12,9,4,11,26,42.3,15,11,1,10,17,42,23,2,MF,25-29,Midfielder,Germany,Europe
1041,Robin Gosens,GER,Atalanta,Serie A,2021,27.0,1994.0,5.1,7,3,3,4,0,4,8,50.0,4,4,0,4,9,16,1,0,DF,25-29,Defender,Germany,Europe
1042,Robin Gosens,GER,Inter,Serie A,2021,27.0,1994.0,1.9,3,1,1,2,0,0,0,,0,5,2,3,3,6,3,0,DF,25-29,Defender,Germany,Europe
1043,Dan Gosling,ENG,Watford,Premier League,2021,31.0,1990.0,1.8,2,1,1,1,0,2,6,33.3,4,2,0,2,0,2,3,0,MF,30-34,Midfielder,England,Europe
1044,Amine Gouiri,ALG,Nice,Ligue 1,2021,21.0,2000.0,30.6,22,13,2,13,7,10,32,31.3,22,22,5,17,11,33,17,1,"FW,MF",20-24,Forward,Algeria,Africa
1045,Lucas Gourna-Douath,FRA,Saint-Étienne,Ligue 1,2021,17.0,2003.0,20.0,45,26,22,18,5,21,36,58.3,15,22,3,19,13,58,9,2,MF,Under 20,Midfielder,France,Europe
1046,Jeffrey Gouweleeuw,NED,Augsburg,Bundesliga,2021,30.0,1991.0,28.6,50,27,33,17,0,22,36,61.1,14,35,18,17,49,99,116,0,DF,30-34,Defender,Netherlands,Europe
1047,Jonathan Gradit,FRA,Lens,Ligue 1,2021,28.0,1992.0,34.1,60,28,24,28,8,25,45,55.6,20,39,27,12,65,125,106,0,DF,25-29,Defender,France,Europe
1048,Jens Grahl,GER,Eint Frankfurt,Bundesliga,2021,32.0,1988.0,1.0,0,0,0,0,0,0,0,,0,0,0,0,0,0,1,0,GK,30-34,Goalkeeper,Germany,Europe
1049,Alberto Grassi,ITA,Cagliari,Serie A,2021,26.0,1995.0,24.2,47,26,13,30,4,16,38,42.1,22,27,9,18,63,110,33,1,MF,25-29,Midfielder,Italy,Europe
1052,Demarai Gray,JAM,Everton,Premier League,2021,25.0,1996.0,26.0,30,19,13,10,7,10,22,45.5,12,30,2,28,15,45,21,1,"MF,FW",25-29,Midfielder,Jamaica,North America
1055,Jack Grealish,ENG,Manchester City,Premier League,2021,25.0,1995.0,21.3,18,17,4,10,4,5,13,38.5,8,11,1,10,8,26,7,0,FW,25-29,Forward,England,Europe
1056,Etienne Green,ENG,Saint-Étienne,Ligue 1,2021,21.0,2000.0,13.3,1,1,1,0,0,0,0,,0,0,0,0,1,2,9,0,GK,20-24,Goalkeeper,England,Europe
1057,Julian Green,USA,Greuther Fürth,Bundesliga,2021,26.0,1995.0,11.7,9,5,0,8,1,2,8,25.0,6,10,2,8,7,16,10,0,MF,25-29,Midfielder,United States,North America
1058,Mason Greenwood,ENG,Manchester Utd,Premier League,2021,19.0,2001.0,14.1,15,9,9,1,5,3,9,33.3,6,5,0,5,1,16,6,0,"FW,MF",Under 20,Forward,England,Europe
1059,Sam Greenwood,ENG,Leeds United,Premier League,2021,19.0,2002.0,2.6,8,5,0,5,3,4,7,57.1,3,3,0,3,2,10,1,0,"MF,FW",Under 20,Midfielder,England,Europe
1060,Michael Gregoritsch,AUT,Augsburg,Bundesliga,2021,27.0,1994.0,15.5,19,8,4,10,5,2,15,13.3,13,18,2,16,6,25,29,0,"FW,MF",25-29,Forward,Austria,Europe
1061,Dominik Greif,SVK,Mallorca,La Liga,2021,24.0,1997.0,1.0,0,0,0,0,0,0,0,,0,0,0,0,0,0,0,0,GK,20-24,Goalkeeper,Slovakia,Europe
1062,Clément Grenier,FRA,Mallorca,La Liga,2021,30.0,1991.0,0.7,0,0,0,0,0,0,0,,0,1,1,0,0,0,1,0,MF,30-34,Midfielder,France,Europe
1063,Sebastian Griesbeck,GER,Greuther Fürth,Bundesliga,2021,30.0,1990.0,27.1,60,31,38,19,3,39,62,62.9,23,38,13,25,43,103,100,1,"DF,MF",30-34,Defender,Germany,Europe
1064,Sebastian Griesbeck,GER,Union Berlin,Bundesliga,2021,30.0,1990.0,0.1,1,1,0,1,0,1,1,100.0,0,0,0,0,0,1,0,0,MF,30-34,Midfielder,Germany,Europe
1065,Antoine Griezmann,FRA,Barcelona,La Liga,2021,30.0,1991.0,2.9,13,5,3,10,0,2,6,33.3,4,4,0,4,3,16,5,0,FW,30-34,Forward,France,Europe
1066,Antoine Griezmann,FRA,Atlético Madrid,La Liga,2021,30.0,1991.0,18.8,30,14,11,15,4,12,32,37.5,20,18,1,17,7,37,18,0,"FW,MF",30-34,Forward,France,Europe
1067,Vincenzo Grifo,ITA,Freiburg,Bundesliga,2021,28.0,1993.0,30.8,27,15,9,13,5,9,26,34.6,17,12,2,10,13,40,28,0,"MF,FW",25-29,Midfielder,Italy,Europe
1068,Lennart Grill,GER,Leverkusen,Bundesliga,2021,22.0,1999.0,1.0,0,0,0,0,0,0,0,,0,0,0,0,0,0,0,0,GK,20-24,Goalkeeper,Germany,Europe
1069,Florian Grillitsch,AUT,Hoffenheim,Bundesliga,2021,25.0,1995.0,16.6,37,19,15,21,1,17,31,54.8,14,18,7,11,29,66,36,1,"DF,MF",25-29,Defender,Austria,Europe
1070,Pascal Groß,GER,Brighton,Premier League,2021,30.0,1991.0,22.6,28,15,15,11,2,12,33,36.4,21,34,8,26,18,46,23,0,"MF,DF",30-34,Midfielder,Germany,Europe
1071,Carlos Gruezo,ECU,Augsburg,Bundesliga,2021,26.0,1995.0,10.8,22,11,10,10,2,8,21,38.1,13,11,2,9,9,31,15,0,MF,25-29,Midfielder,Ecuador,South America
1073,Andrés Guardado,MEX,Betis,La Liga,2021,34.0,1986.0,15.5,30,13,12,17,1,13,34,38.2,21,18,4,14,21,51,29,1,MF,30-34,Midfielder,Mexico,North America
1076,Gabriel Gudmundsson,SWE,Lille,Ligue 1,2021,22.0,1999.0,14.9,43,31,24,16,3,17,35,48.6,18,15,3,12,20,63,13,0,"DF,MF",20-24,Defender,Sweden,Europe
1078,Gonçalo Guedes,POR,Valencia,La Liga,2021,24.0,1996.0,29.0,21,14,6,7,8,2,22,9.1,20,14,0,14,9,30,1,0,"FW,MF",20-24,Forward,Portugal,Europe
1079,Marc Guéhi,ENG,Crystal Palace,Premier League,2021,21.0,2000.0,35.8,35,17,24,10,1,15,16,93.8,1,34,26,8,30,65,127,0,DF,20-24,Defender,England,Europe
1080,Mattéo Guendouzi,FRA,Marseille,Ligue 1,2021,22.0,1999.0,35.0,45,30,10,26,9,13,47,27.7,34,15,1,14,16,61,18,0,MF,20-24,Midfielder,France,Europe
1081,Yanis Guermouche,FRA,Montpellier,Ligue 1,2021,20.0,2001.0,0.1,2,1,0,1,1,1,1,100.0,0,0,0,0,0,2,0,0,"MF,FW",20-24,Midfielder,France,Europe
1082,Raphaël Guerreiro,POR,Dortmund,Bundesliga,2021,27.0,1993.0,19.9,35,19,19,12,4,16,31,51.6,15,18,2,16,25,60,14,1,DF,25-29,Defender,Portugal,Europe
1083,Evann Guessand,CIV,Nice,Ligue 1,2021,20.0,2001.0,4.9,9,8,2,5,2,3,8,37.5,5,4,0,4,0,9,1,0,FW,20-24,Forward,Ivory Coast,Africa
1085,Lamine Gueye,SEN,Metz,Ligue 1,2021,23.0,1998.0,6.2,5,5,1,1,3,3,7,42.9,4,4,0,4,6,11,1,0,"FW,MF",20-24,Forward,Senegal,Africa
1086,Pape Gueye,SEN,Marseille,Ligue 1,2021,22.0,1999.0,17.0,38,19,15,22,1,16,31,51.6,15,15,3,12,24,62,16,0,MF,20-24,Midfielder,Senegal,Africa
1087,John Guidetti,SWE,Alavés,La Liga,2021,29.0,1992.0,3.1,2,1,0,0,2,0,1,0.0,1,1,0,1,0,2,0,0,"FW,MF",25-29,Forward,Sweden,Europe
1088,Josuha Guilavogui,FRA,Bordeaux,Ligue 1,2021,30.0,1990.0,14.8,39,16,18,17,4,14,29,48.3,15,16,8,8,36,75,23,0,"MF,DF",30-34,Midfielder,France,Europe
1089,Josuha Guilavogui,FRA,Wolfsburg,Bundesliga,2021,30.0,1990.0,10.5,23,14,13,9,1,7,18,38.9,11,11,6,5,25,48,42,0,"MF,DF",30-34,Midfielder,France,Europe
1092,Bruno Guimarães,BRA,Newcastle Utd,Premier League,2021,23.0,1997.0,11.5,44,23,18,22,4,21,38,55.3,17,25,6,19,9,53,13,0,MF,20-24,Midfielder,Brazil,South America
1093,Bruno Guimarães,BRA,Lyon,Ligue 1,2021,23.0,1997.0,18.2,50,31,20,25,5,23,59,39.0,36,21,4,17,21,71,11,1,MF,20-24,Midfielder,Brazil,South America
1094,Serhou Guirassy,GUI,Rennes,Ligue 1,2021,25.0,1996.0,11.3,4,2,1,2,1,1,7,14.3,6,4,0,4,1,5,8,0,FW,25-29,Forward,Guinea,Africa
1095,Péter Gulácsi,HUN,RB Leipzig,Bundesliga,2021,31.0,1990.0,33.0,0,0,0,0,0,0,0,,0,0,0,0,1,1,15,1,GK,30-34,Goalkeeper,Hungary,Europe
1096,Manuel Gulde,GER,Freiburg,Bundesliga,2021,30.0,1991.0,13.6,18,10,14,3,1,8,11,72.7,3,16,8,8,17,35,37,0,DF,30-34,Defender,Germany,Europe
1099,İlkay Gündoğan,GER,Manchester City,Premier League,2021,30.0,1990.0,20.6,23,9,10,12,1,12,31,38.7,19,11,1,10,15,38,10,0,MF,30-34,Midfielder,Germany,Europe
1100,Angus Gunn,SCO,Norwich City,Premier League,2021,25.0,1996.0,9.0,0,0,0,0,0,0,0,,0,0,0,0,0,0,11,0,GK,25-29,Goalkeeper,Scotland,Europe
1101,Christian Günter,GER,Freiburg,Bundesliga,2021,28.0,1993.0,34.0,34,20,16,15,3,18,50,36.0,32,23,6,17,17,51,49,2,"DF,MF",25-29,Defender,Germany,Europe
1103,Lasse Günther,GER,Augsburg,Bundesliga,2021,18.0,2003.0,1.8,8,5,4,3,1,5,9,55.6,4,0,0,0,2,10,2,0,DF,Under 20,Defender,Germany,Europe
1105,Malo Gusto,FRA,Lyon,Ligue 1,2021,18.0,2003.0,20.9,55,35,29,21,5,24,40,60.0,16,21,6,15,33,88,41,1,DF,Under 20,Defender,France,Europe
1111,Emmanuel Gyasi,GHA,Spezia,Serie A,2021,27.0,1994.0,33.7,47,30,31,9,7,21,41,51.2,20,22,4,18,16,63,43,1,"FW,MF",25-29,Forward,Ghana,Africa
1112,Norbert Gyömbér,SVK,Salernitana,Serie A,2021,29.0,1992.0,28.5,53,32,40,11,2,33,50,66.0,17,38,24,14,44,97,126,1,DF,25-29,Defender,Slovakia,Europe
1114,Nicolas Haas,SUI,Empoli,Serie A,2021,25.0,1996.0,11.1,35,22,15,10,10,17,39,43.6,22,24,4,20,9,44,17,1,MF,25-29,Midfielder,Switzerland,Europe
1115,Janik Haberer,GER,Freiburg,Bundesliga,2021,27.0,1994.0,9.1,14,8,5,6,3,7,19,36.8,12,11,4,7,16,30,11,0,MF,25-29,Midfielder,Germany,Europe
1116,Alexander Hack,GER,Mainz 05,Bundesliga,2021,27.0,1993.0,23.0,52,26,35,17,0,29,46,63.0,17,31,14,17,51,103,95,1,DF,25-29,Defender,Germany,Europe
1117,Robin Hack,GER,Arminia,Bundesliga,2021,22.0,1998.0,15.2,14,8,6,5,3,3,21,14.3,18,18,1,17,5,19,4,0,"FW,MF",20-24,Forward,Germany,Europe
1118,Munir El Haddadi,MAR,Sevilla,La Liga,2021,25.0,1995.0,5.3,8,4,1,6,1,2,8,25.0,6,7,1,6,5,13,2,0,"FW,MF",25-29,Forward,Morocco,Africa
1119,André Hahn,GER,Augsburg,Bundesliga,2021,30.0,1990.0,23.3,36,20,9,15,12,17,50,34.0,33,38,5,33,15,51,43,0,"MF,FW",30-34,Midfielder,Germany,Europe
1120,Amadou Haidara,MLI,RB Leipzig,Bundesliga,2021,23.0,1998.0,14.7,30,14,11,19,0,17,37,45.9,20,22,6,16,16,46,8,1,MF,20-24,Midfielder,Mali,Africa
1122,Oualid El Hajjam,MAR,Troyes,Ligue 1,2021,30.0,1991.0,11.9,22,11,12,6,4,15,23,65.2,8,12,6,6,22,44,28,0,DF,30-34,Defender,Morocco,Africa
1123,Achraf Hakimi,MAR,Paris S-G,Ligue 1,2021,22.0,1998.0,27.5,74,51,38,27,9,40,72,55.6,32,26,5,21,28,102,23,2,DF,20-24,Defender,Morocco,Africa
1124,Marcel Halstenberg,GER,RB Leipzig,Bundesliga,2021,29.0,1991.0,5.6,10,7,6,4,0,6,11,54.5,5,6,0,6,7,17,11,0,DF,25-29,Defender,Germany,Europe
1125,Pierre-Yves Hamel,FRA,Lorient,Ligue 1,2021,27.0,1994.0,0.3,0,0,0,0,0,0,1,0.0,1,0,0,0,2,2,0,0,"FW,MF",25-29,Forward,France,Europe
1126,Pierre-Yves Hamel,FRA,Clermont Foot,Ligue 1,2021,27.0,1994.0,5.8,11,6,0,5,6,5,6,83.3,1,2,1,1,0,11,0,0,FW,25-29,Forward,France,Europe
1127,Romain Hamouma,FRA,Saint-Étienne,Ligue 1,2021,34.0,1987.0,9.8,10,7,1,5,4,2,13,15.4,11,8,0,8,4,14,1,0,"FW,MF",30-34,Forward,France,Europe
1129,Grant Hanley,SCO,Norwich City,Premier League,2021,29.0,1991.0,32.2,44,25,28,14,2,18,35,51.4,17,56,45,11,56,100,176,2,DF,25-29,Defender,Scotland,Europe
1130,Ridgeciano Haps,SUR,Venezia,Serie A,2021,28.0,1993.0,22.8,36,20,26,4,6,11,21,52.4,10,34,12,22,29,65,57,1,DF,25-29,Defender,Suriname,South America
1131,Genki Haraguchi,JPN,Union Berlin,Bundesliga,2021,30.0,1991.0,19.5,37,20,12,22,3,15,48,31.3,33,25,3,22,26,63,15,0,MF,30-34,Midfielder,Japan,Asia
1132,Amine Harit,MAR,Marseille,Ligue 1,2021,24.0,1997.0,12.9,18,11,9,9,0,9,17,52.9,8,10,0,10,4,22,2,0,"FW,MF",20-24,Forward,Morocco,Africa
1133,Varazdat Haroyan,ARM,Cádiz,La Liga,2021,28.0,1992.0,16.0,31,21,20,10,1,19,29,65.5,10,22,12,10,15,46,62,0,DF,25-29,Defender,Armenia,Asia
1134,Jack Harrison,ENG,Leeds United,Premier League,2021,24.0,1996.0,29.3,57,37,22,22,13,31,76,40.8,45,35,1,34,21,78,19,0,"FW,MF",20-24,Forward,England,Europe
1135,Abdou Harroui,NED,Sassuolo,Serie A,2021,23.0,1998.0,5.0,11,4,4,7,0,8,11,72.7,3,14,0,14,4,15,5,0,MF,20-24,Midfielder,Netherlands,Europe
1136,Luis Hartwig,GER,Bochum,Bundesliga,2021,18.0,2002.0,0.0,0,0,0,0,0,0,0,,0,0,0,0,0,0,0,0,FW,Under 20,Forward,Germany,Europe
1137,Makoto Hasebe,JPN,Eint Frankfurt,Bundesliga,2021,37.0,1984.0,13.2,27,12,15,11,1,13,29,44.8,16,24,8,16,22,49,36,0,DF,35-39,Defender,Japan,Asia
1138,Hans Hateboer,NED,Atalanta,Serie A,2021,27.0,1994.0,15.4,22,14,10,8,4,11,26,42.3,15,11,1,10,7,29,20,0,"DF,MF",25-29,Defender,Netherlands,Europe
1139,Kortney Hause,ENG,Aston Villa,Premier League,2021,26.0,1995.0,4.4,3,3,2,0,1,3,4,75.0,1,8,5,3,6,9,13,0,DF,25-29,Defender,England,Europe
1140,Kai Havertz,GER,Chelsea,Premier League,2021,22.0,1999.0,20.1,17,8,5,7,5,4,14,28.6,10,28,1,27,4,21,32,1,"FW,MF",20-24,Forward,Germany,Europe
1141,Isaac Hayden,ENG,Newcastle Utd,Premier League,2021,26.0,1995.0,11.1,28,14,11,14,3,12,29,41.4,17,17,8,9,14,42,24,0,"MF,DF",25-29,Midfielder,England,Europe
1142,Eden Hazard,BEL,Real Madrid,La Liga,2021,30.0,1991.0,8.0,6,3,3,2,1,3,7,42.9,4,3,0,3,2,8,0,0,"FW,MF",30-34,Forward,Belgium,Europe
1144,Jonas Hector,GER,Köln,Bundesliga,2021,31.0,1990.0,28.4,76,39,36,26,14,29,74,39.2,45,59,8,51,50,126,68,1,DF,30-34,Defender,Germany,Europe
1147,Silvan Hefti,SUI,Genoa,Serie A,2021,23.0,1997.0,14.3,50,30,23,22,5,32,58,55.2,26,20,4,16,20,70,34,1,DF,20-24,Defender,Switzerland,Europe
1148,Dominique Heintz,GER,Union Berlin,Bundesliga,2021,27.0,1993.0,5.2,8,5,5,3,0,3,6,50.0,3,7,4,3,7,15,14,0,DF,25-29,Defender,Germany,Europe
1149,Dominique Heintz,GER,Freiburg,Bundesliga,2021,27.0,1993.0,0.3,0,0,0,0,0,0,0,,0,0,0,0,1,1,0,0,DF,25-29,Defender,Germany,Europe
1151,Liam Henderson,SCO,Empoli,Serie A,2021,25.0,1996.0,22.4,22,13,7,8,7,9,31,29.0,22,14,4,10,9,31,13,0,MF,25-29,Midfielder,Scotland,Europe
1152,Jeff Hendrick,IRL,Newcastle Utd,Premier League,2021,29.0,1992.0,0.8,1,1,0,1,0,1,1,100.0,0,0,0,0,0,1,1,0,MF,25-29,Midfielder,Republic of Ireland,Europe
1153,Wayne Hennessey,WAL,Burnley,Premier League,2021,34.0,1987.0,2.0,0,0,0,0,0,0,0,,0,0,0,0,1,1,0,1,GK,30-34,Goalkeeper,Wales,Europe
1154,Benjamin Henrichs,GER,RB Leipzig,Bundesliga,2021,24.0,1997.0,12.7,30,21,18,6,6,12,22,54.5,10,16,1,15,19,49,14,0,DF,20-24,Defender,Germany,Europe
1157,Luis Henrique,BRA,Marseille,Ligue 1,2021,19.0,2001.0,7.8,4,3,2,1,1,2,5,40.0,3,2,0,2,5,9,1,0,"FW,MF",Under 20,Forward,Brazil,South America
1157,Luis Henrique,BRA,Marseille,Ligue 1,2021,19.0,2001.0,7.8,4,3,2,1,1,2,5,40.0,3,2,0,2,5,9,1,0,"FW,MF",Under 20,Forward,Brazil,South America
1157,Luis Henrique,BRA,Marseille,Ligue 1,2021,19.0,2001.0,7.8,4,3,2,1,1,2,5,40.0,3,2,0,2,5,9,1,0,"FW,MF",Under 20,Forward,Brazil,South America
1157,Luis Henrique,BRA,Marseille,Ligue 1,2021,19.0,2001.0,7.8,4,3,2,1,1,2,5,40.0,3,2,0,2,5,9,1,0,"FW,MF",Under 20,Forward,Brazil,South America
1158,Matheus Henrique,BRA,Sassuolo,Serie A,2021,23.0,1997.0,12.0,10,3,6,3,1,6,24,25.0,18,14,2,12,7,17,12,1,MF,20-24,Midfielder,Brazil,South America
1159,Rico Henry,ENG,Brentford,Premier League,2021,24.0,1997.0,30.8,28,20,18,8,2,12,34,35.3,22,31,10,21,26,54,76,1,DF,20-24,Defender,England,Europe
1160,Thomas Henry,FRA,Venezia,Serie A,2021,26.0,1994.0,23.5,9,4,2,3,4,5,13,38.5,8,11,5,6,2,11,25,0,FW,25-29,Forward,France,Europe
1162,Jérôme Hergault,FRA,Lorient,Ligue 1,2021,35.0,1986.0,3.9,3,1,1,2,0,2,5,40.0,3,4,1,3,4,7,7,0,DF,35-39,Defender,France,Europe
1166,Lucas Hernández,FRA,Bayern Munich,Bundesliga,2021,25.0,1996.0,22.6,50,31,20,24,6,26,42,61.9,16,22,11,11,28,78,54,1,DF,25-29,Defender,France,Europe
1169,Theo Hernández,FRA,Milan,Serie A,2021,23.0,1997.0,30.1,53,35,34,14,5,29,40,72.5,11,16,3,13,23,76,29,3,DF,20-24,Defender,France,Europe
1170,Hernani,BRA,Genoa,Serie A,2021,27.0,1994.0,7.6,20,10,8,9,3,13,32,40.6,19,17,4,13,13,33,5,1,"MF,FW",25-29,Midfielder,Brazil,South America
1172,Héctor Herrera,MEX,Atlético Madrid,La Liga,2021,31.0,1990.0,9.5,16,8,11,4,1,7,20,35.0,13,13,2,11,12,28,16,0,MF,30-34,Midfielder,Mexico,North America
1174,Yangel Herrera,VEN,Espanyol,La Liga,2021,23.0,1998.0,18.3,41,31,19,19,3,18,39,46.2,21,27,5,22,19,60,33,1,MF,20-24,Midfielder,Venezuela,South America
1175,Patrick Herrmann,GER,Gladbach,Bundesliga,2021,30.0,1991.0,8.4,15,7,5,6,4,9,24,37.5,15,10,1,9,6,21,8,0,"DF,FW",30-34,Defender,Germany,Europe
1178,Aaron Hickey,SCO,Bologna,Serie A,2021,19.0,2002.0,31.3,46,29,24,15,7,20,30,66.7,10,36,13,23,29,75,44,0,DF,Under 20,Defender,Scotland,Europe
1179,Piero Hincapié,ECU,Leverkusen,Bundesliga,2021,19.0,2002.0,19.5,33,23,23,8,2,19,25,76.0,6,34,15,19,33,66,56,2,DF,Under 20,Defender,Ecuador,South America
1180,Martin Hinteregger,AUT,Eint Frankfurt,Bundesliga,2021,28.0,1992.0,24.7,45,28,28,16,1,28,43,65.1,15,36,16,20,42,87,78,3,DF,25-29,Defender,Austria,Europe
1181,Marwin Hitz,SUI,Dortmund,Bundesliga,2021,33.0,1987.0,4.5,0,0,0,0,0,0,0,,0,0,0,0,0,0,2,0,GK,30-34,Goalkeeper,Switzerland,Europe
1182,Ki-Jana Hoever,NED,Wolves,Premier League,2021,19.0,2002.0,3.4,10,6,5,5,0,7,12,58.3,5,6,0,6,6,16,8,0,"DF,MF",Under 20,Defender,Netherlands,Europe
1183,Nicolas Höfler,GER,Freiburg,Bundesliga,2021,31.0,1990.0,28.9,73,42,37,29,7,28,62,45.2,34,50,21,29,46,119,42,0,MF,30-34,Midfielder,Germany,Europe
1184,Jonas Hofmann,GER,Gladbach,Bundesliga,2021,29.0,1992.0,23.1,30,20,6,17,7,17,42,40.5,25,23,0,23,12,42,10,0,"MF,FW",25-29,Midfielder,Germany,Europe
1184,Jonas Hofmann,GER,Gladbach,Bundesliga,2021,29.0,1992.0,23.1,30,20,6,17,7,17,42,40.5,25,23,0,23,12,42,10,0,"MF,FW",25-29,Midfielder,Germany,Europe
1184,Jonas Hofmann,GER,Gladbach,Bundesliga,2021,29.0,1992.0,23.1,30,20,6,17,7,17,42,40.5,25,23,0,23,12,42,10,0,"MF,FW",25-29,Midfielder,Germany,Europe
1184,Jonas Hofmann,GER,Gladbach,Bundesliga,2021,29.0,1992.0,23.1,30,20,6,17,7,17,42,40.5,25,23,0,23,12,42,10,0,"MF,FW",25-29,Midfielder,Germany,Europe
1185,Rob Holding,ENG,Arsenal,Premier League,2021,25.0,1995.0,9.4,13,9,11,1,1,5,6,83.3,1,23,18,5,10,23,42,1,DF,25-29,Defender,England,Europe
1186,Lucas Höler,GER,Freiburg,Bundesliga,2021,27.0,1994.0,28.7,41,25,10,17,14,13,28,46.4,15,25,4,21,17,58,39,2,FW,25-29,Forward,Germany,Europe
1187,Mason Holgate,ENG,Everton,Premier League,2021,24.0,1996.0,23.7,35,18,26,9,0,11,26,42.3,15,25,17,8,26,61,95,1,DF,20-24,Defender,England,Europe
1188,Gerrit Holtmann,PHI,Bochum,Bundesliga,2021,26.0,1995.0,20.4,15,9,5,3,7,6,22,27.3,16,26,2,24,8,23,6,0,"FW,MF",25-29,Forward,Philippines,Asia
1189,Martin Hongla,CMR,Hellas Verona,Serie A,2021,23.0,1998.0,7.2,14,8,5,6,3,4,8,50.0,4,6,2,4,4,18,16,1,MF,20-24,Midfielder,Cameroon,Africa
1190,Franck Honorat,FRA,Brest,Ligue 1,2021,24.0,1996.0,32.2,54,38,25,13,16,27,47,57.4,20,24,2,22,15,69,25,0,"FW,MF",20-24,Forward,France,Europe
1194,Jannes Horn,GER,Köln,Bundesliga,2021,24.0,1997.0,5.3,6,4,4,2,0,4,8,50.0,4,1,1,0,3,9,9,0,DF,20-24,Defender,Germany,Europe
1195,Timo Horn,GER,Köln,Bundesliga,2021,28.0,1993.0,13.0,0,0,0,0,0,0,1,0.0,1,0,0,0,0,0,5,0,GK,25-29,Goalkeeper,Germany,Europe
1196,Fraser Hornby,SCO,Reims,Ligue 1,2021,21.0,1999.0,3.9,3,1,1,2,0,0,2,0.0,2,3,0,3,4,7,5,0,"FW,MF",20-24,Forward,Scotland,Europe
1197,Cédric Hountondji,BEN,Clermont Foot,Ligue 1,2021,27.0,1994.0,22.6,33,17,20,12,1,16,24,66.7,8,23,12,11,34,67,76,0,DF,25-29,Defender,Benin,Africa
1199,Branimir Hrgota,SWE,Greuther Fürth,Bundesliga,2021,28.0,1993.0,30.9,46,29,10,31,5,21,72,29.2,51,27,1,26,11,57,3,1,FW,25-29,Forward,Sweden,Europe
1200,Petko Hristov,BUL,Spezia,Serie A,2021,22.0,1999.0,13.9,17,10,11,6,0,10,16,62.5,6,29,23,6,19,36,47,0,DF,20-24,Defender,Bulgaria,Europe
1202,Timo Hübers,GER,Köln,Bundesliga,2021,25.0,1996.0,19.3,45,27,28,17,0,27,45,60.0,18,31,19,12,52,97,95,0,DF,25-29,Defender,Germany,Europe
1203,Benjamin Hübner,GER,Hoffenheim,Bundesliga,2021,32.0,1989.0,4.2,9,5,0,7,2,3,5,60.0,2,2,2,0,9,18,7,0,DF,30-34,Defender,Germany,Europe
1204,Callum Hudson-Odoi,ENG,Chelsea,Premier League,2021,20.0,2000.0,10.7,14,10,5,6,3,8,23,34.8,15,8,0,8,2,16,6,1,"MF,FW",20-24,Midfielder,England,Europe
1205,Will Hughes,ENG,Crystal Palace,Premier League,2021,26.0,1995.0,11.7,29,14,10,16,3,7,16,43.8,9,13,7,6,8,37,10,0,MF,25-29,Midfielder,England,Europe
1206,Mats Hummels,GER,Dortmund,Bundesliga,2021,32.0,1988.0,19.6,34,22,20,13,1,20,36,55.6,16,18,13,5,32,66,66,1,DF,30-34,Defender,Germany,Europe
1207,Elseid Hysaj,ALB,Lazio,Serie A,2021,27.0,1994.0,22.5,46,30,25,17,4,29,45,64.4,16,18,6,12,24,70,34,1,DF,25-29,Defender,Albania,Europe
1210,Iago,BRA,Augsburg,Bundesliga,2021,24.0,1997.0,24.2,49,29,25,19,5,15,34,44.1,19,28,6,22,27,76,62,0,DF,20-24,Defender,Brazil,South America
1214,Zlatan Ibrahimović,SWE,Milan,Serie A,2021,39.0,1981.0,11.3,0,0,0,0,0,0,2,0.0,2,2,1,1,3,3,9,0,FW,35-39,Forward,Sweden,Europe
1221,Jonathan Iglesias,URU,Clermont Foot,Ligue 1,2021,32.0,1988.0,6.4,18,11,6,10,2,10,18,55.6,8,8,2,6,5,23,2,1,MF,30-34,Midfielder,Uruguay,South America
1223,Igor,BRA,Fiorentina,Serie A,2021,23.0,1998.0,24.9,53,31,34,16,3,30,40,75.0,10,37,19,18,31,84,46,4,DF,20-24,Defender,Brazil,South America
1223,Igor,BRA,Fiorentina,Serie A,2021,23.0,1998.0,24.9,53,31,34,16,3,30,40,75.0,10,37,19,18,31,84,46,4,DF,20-24,Defender,Brazil,South America
1223,Igor,BRA,Fiorentina,Serie A,2021,23.0,1998.0,24.9,53,31,34,16,3,30,40,75.0,10,37,19,18,31,84,46,4,DF,20-24,Defender,Brazil,South America
1223,Igor,BRA,Fiorentina,Serie A,2021,23.0,1998.0,24.9,53,31,34,16,3,30,40,75.0,10,37,19,18,31,84,46,4,DF,20-24,Defender,Brazil,South America
1224,Kelechi Iheanacho,NGA,Leicester City,Premier League,2021,24.0,1996.0,14.0,10,7,2,5,3,3,14,21.4,11,19,0,19,4,14,10,0,FW,20-24,Forward,Nigeria,Africa
1231,Stefan Ilsanker,AUT,Eint Frankfurt,Bundesliga,2021,32.0,1989.0,3.0,14,8,7,6,1,5,10,50.0,5,6,2,4,6,20,15,1,"DF,MF",30-34,Defender,Austria,Europe
1234,Danny Ings,ENG,Aston Villa,Premier League,2021,29.0,1992.0,21.1,23,16,2,16,5,13,37,35.1,24,31,2,29,6,29,22,0,FW,25-29,Forward,England,Europe
1237,Bonke Innocent,NGA,Lorient,Ligue 1,2021,25.0,1996.0,9.7,27,16,10,16,1,11,26,42.3,15,11,3,8,16,43,14,0,MF,25-29,Midfielder,Nigeria,Africa
1238,Lorenzo Insigne,ITA,Napoli,Serie A,2021,30.0,1991.0,25.4,23,14,8,12,3,8,44,18.2,36,30,1,29,20,43,3,1,FW,30-34,Forward,Italy,Europe
1239,Nikita Iosifov,RUS,Villarreal,La Liga,2021,20.0,2001.0,0.0,0,0,0,0,0,0,0,,0,0,0,0,0,0,0,0,MF,20-24,Midfielder,Russia,Europe
1241,Alexander Isak,SWE,Real Sociedad,La Liga,2021,21.0,1999.0,23.8,7,4,1,3,3,2,12,16.7,10,14,2,12,3,10,10,0,FW,20-24,Forward,Sweden,Europe
1244,Ardian Ismajli,ALB,Empoli,Serie A,2021,24.0,1996.0,14.1,13,9,8,4,1,5,14,35.7,9,21,11,10,24,37,80,0,DF,20-24,Defender,Albania,Europe
1245,Hiroki Ito,JPN,Stuttgart,Bundesliga,2021,22.0,1999.0,26.1,43,31,21,19,3,25,43,58.1,18,40,19,21,53,96,95,0,DF,20-24,Defender,Japan,Asia
1246,Cedric Itten,SUI,Greuther Fürth,Bundesliga,2021,24.0,1996.0,7.1,5,2,1,2,2,1,6,16.7,5,3,0,3,2,7,4,0,FW,20-24,Forward,Switzerland,Europe
1248,Alex Iwobi,NGA,Everton,Premier League,2021,25.0,1996.0,22.6,40,19,23,12,5,21,52,40.4,31,39,3,36,20,60,25,2,"MF,DF",25-29,Midfielder,Nigeria,Africa
1249,Armando Izzo,ITA,Torino,Serie A,2021,29.0,1992.0,5.8,16,9,14,2,0,9,11,81.8,2,5,4,1,17,33,21,0,DF,25-29,Defender,Italy,Europe
1250,Nicolas Jackson,SEN,Villarreal,La Liga,2021,20.0,2001.0,1.8,2,0,1,0,1,0,0,,0,0,0,0,1,3,1,0,"FW,MF",20-24,Forward,Senegal,Africa
1252,Paul Jaeckel,GER,Union Berlin,Bundesliga,2021,23.0,1998.0,22.7,51,29,27,24,0,29,51,56.9,22,34,10,24,57,108,81,0,DF,20-24,Defender,Germany,Europe
1253,Mato Jajalo,BIH,Udinese,Serie A,2021,33.0,1988.0,7.0,24,14,14,7,3,11,23,47.8,12,7,0,7,11,35,5,0,MF,30-34,Midfielder,Bosnia and Herzegovina,Europe
1258,Daniel James,WAL,Manchester Utd,Premier League,2021,23.0,1997.0,1.4,2,1,0,2,0,0,0,,0,2,0,2,0,2,1,0,FW,20-24,Forward,Wales,Europe
1259,Daniel James,WAL,Leeds United,Premier League,2021,23.0,1997.0,26.3,24,14,8,8,8,10,23,43.5,13,18,1,17,8,32,12,0,"FW,MF",20-24,Forward,Wales,Europe
1260,Reece James,ENG,Chelsea,Premier League,2021,21.0,1999.0,20.7,33,25,14,18,1,9,22,40.9,13,20,2,18,17,50,22,0,DF,20-24,Defender,England,Europe
1260,Reece James,ENG,Chelsea,Premier League,2021,21.0,1999.0,20.7,33,25,14,18,1,9,22,40.9,13,20,2,18,17,50,22,0,DF,20-24,Defender,England,Europe
1260,Reece James,ENG,Chelsea,Premier League,2021,21.0,1999.0,20.7,33,25,14,18,1,9,22,40.9,13,20,2,18,17,50,22,0,DF,20-24,Defender,England,Europe
1260,Reece James,ENG,Chelsea,Premier League,2021,21.0,1999.0,20.7,33,25,14,18,1,9,22,40.9,13,20,2,18,17,50,22,0,DF,20-24,Defender,England,Europe
1261,Vitaly Janelt,GER,Brentford,Premier League,2021,23.0,1998.0,25.5,61,32,26,27,8,27,53,50.9,26,23,7,16,28,89,35,0,MF,20-24,Midfielder,Germany,Europe
1263,Pontus Jansson,SWE,Brentford,Premier League,2021,30.0,1991.0,36.9,40,21,32,8,0,22,34,64.7,12,37,27,10,52,92,187,0,DF,30-34,Defender,Sweden,Europe
1264,Tony Jantschke,GER,Gladbach,Bundesliga,2021,31.0,1990.0,2.5,6,5,2,4,0,3,6,50.0,3,3,2,1,5,11,8,0,DF,30-34,Defender,Germany,Europe
1265,Adnan Januzaj,BEL,Real Sociedad,La Liga,2021,26.0,1995.0,18.1,17,11,5,8,4,9,24,37.5,15,15,3,12,12,29,15,0,"FW,MF",25-29,Forward,Belgium,Europe
1266,Léo Jardim,BRA,Lille,Ligue 1,2021,26.0,1995.0,17.0,0,0,0,0,0,0,0,,0,0,0,0,1,1,10,0,GK,25-29,Goalkeeper,Brazil,South America
1272,Corentin Jean,FRA,Lens,Ligue 1,2021,26.0,1995.0,2.8,9,6,4,4,1,3,6,50.0,3,5,0,5,1,10,0,0,"FW,MF",25-29,Forward,France,Europe
1273,Jemerson,BRA,Metz,Ligue 1,2021,28.0,1992.0,13.4,37,25,30,7,0,18,26,69.2,8,23,8,15,25,62,33,1,DF,25-29,Defender,Brazil,South America
1274,Fredrik Jensen,FIN,Augsburg,Bundesliga,2021,23.0,1997.0,4.6,5,4,1,3,1,4,7,57.1,3,5,1,4,2,7,4,0,"MF,FW",20-24,Midfielder,Finland,Europe
1275,Mathias Jensen,DEN,Brentford,Premier League,2021,25.0,1996.0,17.8,33,18,12,16,5,22,63,34.9,41,32,3,29,22,55,13,0,MF,25-29,Midfielder,Denmark,Europe
1276,Moritz Jenz,GER,Lorient,Ligue 1,2021,22.0,1999.0,15.3,26,12,18,6,2,11,24,45.8,13,19,11,8,28,54,55,0,DF,20-24,Defender,Germany,Europe
1277,Gabriel Jesus,BRA,Manchester City,Premier League,2021,24.0,1997.0,20.9,18,12,2,4,12,6,26,23.1,20,18,0,18,15,33,8,0,FW,20-24,Forward,Brazil,South America
1278,Juan Jesus,BRA,Napoli,Serie A,2021,30.0,1991.0,14.2,25,17,14,11,0,12,18,66.7,6,21,16,5,9,34,34,0,DF,30-34,Defender,Brazil,South America
1280,Raúl Jiménez,MEX,Wolves,Premier League,2021,30.0,1991.0,29.2,29,14,6,16,7,6,30,20.0,24,31,5,26,13,42,26,0,FW,30-34,Forward,Mexico,North America
1281,João Pedro,BRA,Watford,Premier League,2021,19.0,2001.0,18.3,20,14,7,8,5,6,23,26.1,17,23,3,20,15,35,17,0,"FW,MF",Under 20,Forward,Brazil,South America
1281,João Pedro,BRA,Watford,Premier League,2021,19.0,2001.0,18.3,20,14,7,8,5,6,23,26.1,17,23,3,20,15,35,17,0,"FW,MF",Under 20,Forward,Brazil,South America
1281,João Pedro,BRA,Watford,Premier League,2021,19.0,2001.0,18.3,20,14,7,8,5,6,23,26.1,17,23,3,20,15,35,17,0,"FW,MF",Under 20,Forward,Brazil,South America
1281,João Pedro,BRA,Watford,Premier League,2021,19.0,2001.0,18.3,20,14,7,8,5,6,23,26.1,17,23,3,20,15,35,17,0,"FW,MF",Under 20,Forward,Brazil,South America
1281,João Pedro,BRA,Watford,Premier League,2021,19.0,2001.0,18.3,20,14,7,8,5,6,23,26.1,17,23,3,20,15,35,17,0,"FW,MF",Under 20,Forward,Brazil,South America
1281,João Pedro,BRA,Watford,Premier League,2021,19.0,2001.0,18.3,20,14,7,8,5,6,23,26.1,17,23,3,20,15,35,17,0,"FW,MF",Under 20,Forward,Brazil,South America
1281,João Pedro,BRA,Watford,Premier League,2021,19.0,2001.0,18.3,20,14,7,8,5,6,23,26.1,17,23,3,20,15,35,17,0,"FW,MF",Under 20,Forward,Brazil,South America
1281,João Pedro,BRA,Watford,Premier League,2021,19.0,2001.0,18.3,20,14,7,8,5,6,23,26.1,17,23,3,20,15,35,17,0,"FW,MF",Under 20,Forward,Brazil,South America
1281,João Pedro,BRA,Watford,Premier League,2021,19.0,2001.0,18.3,20,14,7,8,5,6,23,26.1,17,23,3,20,15,35,17,0,"FW,MF",Under 20,Forward,Brazil,South America
1281,João Pedro,BRA,Watford,Premier League,2021,19.0,2001.0,18.3,20,14,7,8,5,6,23,26.1,17,23,3,20,15,35,17,0,"FW,MF",Under 20,Forward,Brazil,South America
1281,João Pedro,BRA,Watford,Premier League,2021,19.0,2001.0,18.3,20,14,7,8,5,6,23,26.1,17,23,3,20,15,35,17,0,"FW,MF",Under 20,Forward,Brazil,South America
1281,João Pedro,BRA,Watford,Premier League,2021,19.0,2001.0,18.3,20,14,7,8,5,6,23,26.1,17,23,3,20,15,35,17,0,"FW,MF",Under 20,Forward,Brazil,South America
1281,João Pedro,BRA,Watford,Premier League,2021,19.0,2001.0,18.3,20,14,7,8,5,6,23,26.1,17,23,3,20,15,35,17,0,"FW,MF",Under 20,Forward,Brazil,South America
1281,João Pedro,BRA,Watford,Premier League,2021,19.0,2001.0,18.3,20,14,7,8,5,6,23,26.1,17,23,3,20,15,35,17,0,"FW,MF",Under 20,Forward,Brazil,South America
1281,João Pedro,BRA,Watford,Premier League,2021,19.0,2001.0,18.3,20,14,7,8,5,6,23,26.1,17,23,3,20,15,35,17,0,"FW,MF",Under 20,Forward,Brazil,South America
1281,João Pedro,BRA,Watford,Premier League,2021,19.0,2001.0,18.3,20,14,7,8,5,6,23,26.1,17,23,3,20,15,35,17,0,"FW,MF",Under 20,Forward,Brazil,South America
1281,João Pedro,BRA,Watford,Premier League,2021,19.0,2001.0,18.3,20,14,7,8,5,6,23,26.1,17,23,3,20,15,35,17,0,"FW,MF",Under 20,Forward,Brazil,South America
1281,João Pedro,BRA,Watford,Premier League,2021,19.0,2001.0,18.3,20,14,7,8,5,6,23,26.1,17,23,3,20,15,35,17,0,"FW,MF",Under 20,Forward,Brazil,South America
1281,João Pedro,BRA,Watford,Premier League,2021,19.0,2001.0,18.3,20,14,7,8,5,6,23,26.1,17,23,3,20,15,35,17,0,"FW,MF",Under 20,Forward,Brazil,South America
1281,João Pedro,BRA,Watford,Premier League,2021,19.0,2001.0,18.3,20,14,7,8,5,6,23,26.1,17,23,3,20,15,35,17,0,"FW,MF",Under 20,Forward,Brazil,South America
1281,João Pedro,BRA,Watford,Premier League,2021,19.0,2001.0,18.3,20,14,7,8,5,6,23,26.1,17,23,3,20,15,35,17,0,"FW,MF",Under 20,Forward,Brazil,South America
1281,João Pedro,BRA,Watford,Premier League,2021,19.0,2001.0,18.3,20,14,7,8,5,6,23,26.1,17,23,3,20,15,35,17,0,"FW,MF",Under 20,Forward,Brazil,South America
1281,João Pedro,BRA,Watford,Premier League,2021,19.0,2001.0,18.3,20,14,7,8,5,6,23,26.1,17,23,3,20,15,35,17,0,"FW,MF",Under 20,Forward,Brazil,South America
1281,João Pedro,BRA,Watford,Premier League,2021,19.0,2001.0,18.3,20,14,7,8,5,6,23,26.1,17,23,3,20,15,35,17,0,"FW,MF",Under 20,Forward,Brazil,South America
1281,João Pedro,BRA,Watford,Premier League,2021,19.0,2001.0,18.3,20,14,7,8,5,6,23,26.1,17,23,3,20,15,35,17,0,"FW,MF",Under 20,Forward,Brazil,South America
1281,João Pedro,BRA,Watford,Premier League,2021,19.0,2001.0,18.3,20,14,7,8,5,6,23,26.1,17,23,3,20,15,35,17,0,"FW,MF",Under 20,Forward,Brazil,South America
1281,João Pedro,BRA,Watford,Premier League,2021,19.0,2001.0,18.3,20,14,7,8,5,6,23,26.1,17,23,3,20,15,35,17,0,"FW,MF",Under 20,Forward,Brazil,South America
1281,João Pedro,BRA,Watford,Premier League,2021,19.0,2001.0,18.3,20,14,7,8,5,6,23,26.1,17,23,3,20,15,35,17,0,"FW,MF",Under 20,Forward,Brazil,South America
1281,João Pedro,BRA,Watford,Premier League,2021,19.0,2001.0,18.3,20,14,7,8,5,6,23,26.1,17,23,3,20,15,35,17,0,"FW,MF",Under 20,Forward,Brazil,South America
1281,João Pedro,BRA,Watford,Premier League,2021,19.0,2001.0,18.3,20,14,7,8,5,6,23,26.1,17,23,3,20,15,35,17,0,"FW,MF",Under 20,Forward,Brazil,South America
1281,João Pedro,BRA,Watford,Premier League,2021,19.0,2001.0,18.3,20,14,7,8,5,6,23,26.1,17,23,3,20,15,35,17,0,"FW,MF",Under 20,Forward,Brazil,South America
1281,João Pedro,BRA,Watford,Premier League,2021,19.0,2001.0,18.3,20,14,7,8,5,6,23,26.1,17,23,3,20,15,35,17,0,"FW,MF",Under 20,Forward,Brazil,South America
1281,João Pedro,BRA,Watford,Premier League,2021,19.0,2001.0,18.3,20,14,7,8,5,6,23,26.1,17,23,3,20,15,35,17,0,"FW,MF",Under 20,Forward,Brazil,South America
1281,João Pedro,BRA,Watford,Premier League,2021,19.0,2001.0,18.3,20,14,7,8,5,6,23,26.1,17,23,3,20,15,35,17,0,"FW,MF",Under 20,Forward,Brazil,South America
1281,João Pedro,BRA,Watford,Premier League,2021,19.0,2001.0,18.3,20,14,7,8,5,6,23,26.1,17,23,3,20,15,35,17,0,"FW,MF",Under 20,Forward,Brazil,South America
1281,João Pedro,BRA,Watford,Premier League,2021,19.0,2001.0,18.3,20,14,7,8,5,6,23,26.1,17,23,3,20,15,35,17,0,"FW,MF",Under 20,Forward,Brazil,South America
1281,João Pedro,BRA,Watford,Premier League,2021,19.0,2001.0,18.3,20,14,7,8,5,6,23,26.1,17,23,3,20,15,35,17,0,"FW,MF",Under 20,Forward,Brazil,South America
1281,João Pedro,BRA,Watford,Premier League,2021,19.0,2001.0,18.3,20,14,7,8,5,6,23,26.1,17,23,3,20,15,35,17,0,"FW,MF",Under 20,Forward,Brazil,South America
1281,João Pedro,BRA,Watford,Premier League,2021,19.0,2001.0,18.3,20,14,7,8,5,6,23,26.1,17,23,3,20,15,35,17,0,"FW,MF",Under 20,Forward,Brazil,South America
1281,João Pedro,BRA,Watford,Premier League,2021,19.0,2001.0,18.3,20,14,7,8,5,6,23,26.1,17,23,3,20,15,35,17,0,"FW,MF",Under 20,Forward,Brazil,South America
1281,João Pedro,BRA,Watford,Premier League,2021,19.0,2001.0,18.3,20,14,7,8,5,6,23,26.1,17,23,3,20,15,35,17,0,"FW,MF",Under 20,Forward,Brazil,South America
1281,João Pedro,BRA,Watford,Premier League,2021,19.0,2001.0,18.3,20,14,7,8,5,6,23,26.1,17,23,3,20,15,35,17,0,"FW,MF",Under 20,Forward,Brazil,South America
1281,João Pedro,BRA,Watford,Premier League,2021,19.0,2001.0,18.3,20,14,7,8,5,6,23,26.1,17,23,3,20,15,35,17,0,"FW,MF",Under 20,Forward,Brazil,South America
1281,João Pedro,BRA,Watford,Premier League,2021,19.0,2001.0,18.3,20,14,7,8,5,6,23,26.1,17,23,3,20,15,35,17,0,"FW,MF",Under 20,Forward,Brazil,South America
1281,João Pedro,BRA,Watford,Premier League,2021,19.0,2001.0,18.3,20,14,7,8,5,6,23,26.1,17,23,3,20,15,35,17,0,"FW,MF",Under 20,Forward,Brazil,South America
1281,João Pedro,BRA,Watford,Premier League,2021,19.0,2001.0,18.3,20,14,7,8,5,6,23,26.1,17,23,3,20,15,35,17,0,"FW,MF",Under 20,Forward,Brazil,South America
1281,João Pedro,BRA,Watford,Premier League,2021,19.0,2001.0,18.3,20,14,7,8,5,6,23,26.1,17,23,3,20,15,35,17,0,"FW,MF",Under 20,Forward,Brazil,South America
1281,João Pedro,BRA,Watford,Premier League,2021,19.0,2001.0,18.3,20,14,7,8,5,6,23,26.1,17,23,3,20,15,35,17,0,"FW,MF",Under 20,Forward,Brazil,South America
1281,João Pedro,BRA,Watford,Premier League,2021,19.0,2001.0,18.3,20,14,7,8,5,6,23,26.1,17,23,3,20,15,35,17,0,"FW,MF",Under 20,Forward,Brazil,South America
1281,João Pedro,BRA,Watford,Premier League,2021,19.0,2001.0,18.3,20,14,7,8,5,6,23,26.1,17,23,3,20,15,35,17,0,"FW,MF",Under 20,Forward,Brazil,South America
1281,João Pedro,BRA,Watford,Premier League,2021,19.0,2001.0,18.3,20,14,7,8,5,6,23,26.1,17,23,3,20,15,35,17,0,"FW,MF",Under 20,Forward,Brazil,South America
1281,João Pedro,BRA,Watford,Premier League,2021,19.0,2001.0,18.3,20,14,7,8,5,6,23,26.1,17,23,3,20,15,35,17,0,"FW,MF",Under 20,Forward,Brazil,South America
1281,João Pedro,BRA,Watford,Premier League,2021,19.0,2001.0,18.3,20,14,7,8,5,6,23,26.1,17,23,3,20,15,35,17,0,"FW,MF",Under 20,Forward,Brazil,South America
1281,João Pedro,BRA,Watford,Premier League,2021,19.0,2001.0,18.3,20,14,7,8,5,6,23,26.1,17,23,3,20,15,35,17,0,"FW,MF",Under 20,Forward,Brazil,South America
1281,João Pedro,BRA,Watford,Premier League,2021,19.0,2001.0,18.3,20,14,7,8,5,6,23,26.1,17,23,3,20,15,35,17,0,"FW,MF",Under 20,Forward,Brazil,South America
1281,João Pedro,BRA,Watford,Premier League,2021,19.0,2001.0,18.3,20,14,7,8,5,6,23,26.1,17,23,3,20,15,35,17,0,"FW,MF",Under 20,Forward,Brazil,South America
1281,João Pedro,BRA,Watford,Premier League,2021,19.0,2001.0,18.3,20,14,7,8,5,6,23,26.1,17,23,3,20,15,35,17,0,"FW,MF",Under 20,Forward,Brazil,South America
1281,João Pedro,BRA,Watford,Premier League,2021,19.0,2001.0,18.3,20,14,7,8,5,6,23,26.1,17,23,3,20,15,35,17,0,"FW,MF",Under 20,Forward,Brazil,South America
1281,João Pedro,BRA,Watford,Premier League,2021,19.0,2001.0,18.3,20,14,7,8,5,6,23,26.1,17,23,3,20,15,35,17,0,"FW,MF",Under 20,Forward,Brazil,South America
1281,João Pedro,BRA,Watford,Premier League,2021,19.0,2001.0,18.3,20,14,7,8,5,6,23,26.1,17,23,3,20,15,35,17,0,"FW,MF",Under 20,Forward,Brazil,South America
1281,João Pedro,BRA,Watford,Premier League,2021,19.0,2001.0,18.3,20,14,7,8,5,6,23,26.1,17,23,3,20,15,35,17,0,"FW,MF",Under 20,Forward,Brazil,South America
1281,João Pedro,BRA,Watford,Premier League,2021,19.0,2001.0,18.3,20,14,7,8,5,6,23,26.1,17,23,3,20,15,35,17,0,"FW,MF",Under 20,Forward,Brazil,South America
1281,João Pedro,BRA,Watford,Premier League,2021,19.0,2001.0,18.3,20,14,7,8,5,6,23,26.1,17,23,3,20,15,35,17,0,"FW,MF",Under 20,Forward,Brazil,South America
1281,João Pedro,BRA,Watford,Premier League,2021,19.0,2001.0,18.3,20,14,7,8,5,6,23,26.1,17,23,3,20,15,35,17,0,"FW,MF",Under 20,Forward,Brazil,South America
1281,João Pedro,BRA,Watford,Premier League,2021,19.0,2001.0,18.3,20,14,7,8,5,6,23,26.1,17,23,3,20,15,35,17,0,"FW,MF",Under 20,Forward,Brazil,South America
1281,João Pedro,BRA,Watford,Premier League,2021,19.0,2001.0,18.3,20,14,7,8,5,6,23,26.1,17,23,3,20,15,35,17,0,"FW,MF",Under 20,Forward,Brazil,South America
1281,João Pedro,BRA,Watford,Premier League,2021,19.0,2001.0,18.3,20,14,7,8,5,6,23,26.1,17,23,3,20,15,35,17,0,"FW,MF",Under 20,Forward,Brazil,South America
1281,João Pedro,BRA,Watford,Premier League,2021,19.0,2001.0,18.3,20,14,7,8,5,6,23,26.1,17,23,3,20,15,35,17,0,"FW,MF",Under 20,Forward,Brazil,South America
1281,João Pedro,BRA,Watford,Premier League,2021,19.0,2001.0,18.3,20,14,7,8,5,6,23,26.1,17,23,3,20,15,35,17,0,"FW,MF",Under 20,Forward,Brazil,South America
1281,João Pedro,BRA,Watford,Premier League,2021,19.0,2001.0,18.3,20,14,7,8,5,6,23,26.1,17,23,3,20,15,35,17,0,"FW,MF",Under 20,Forward,Brazil,South America
1281,João Pedro,BRA,Watford,Premier League,2021,19.0,2001.0,18.3,20,14,7,8,5,6,23,26.1,17,23,3,20,15,35,17,0,"FW,MF",Under 20,Forward,Brazil,South America
1281,João Pedro,BRA,Watford,Premier League,2021,19.0,2001.0,18.3,20,14,7,8,5,6,23,26.1,17,23,3,20,15,35,17,0,"FW,MF",Under 20,Forward,Brazil,South America
1281,João Pedro,BRA,Watford,Premier League,2021,19.0,2001.0,18.3,20,14,7,8,5,6,23,26.1,17,23,3,20,15,35,17,0,"FW,MF",Under 20,Forward,Brazil,South America
1281,João Pedro,BRA,Watford,Premier League,2021,19.0,2001.0,18.3,20,14,7,8,5,6,23,26.1,17,23,3,20,15,35,17,0,"FW,MF",Under 20,Forward,Brazil,South America
1281,João Pedro,BRA,Watford,Premier League,2021,19.0,2001.0,18.3,20,14,7,8,5,6,23,26.1,17,23,3,20,15,35,17,0,"FW,MF",Under 20,Forward,Brazil,South America
1281,João Pedro,BRA,Watford,Premier League,2021,19.0,2001.0,18.3,20,14,7,8,5,6,23,26.1,17,23,3,20,15,35,17,0,"FW,MF",Under 20,Forward,Brazil,South America
1281,João Pedro,BRA,Watford,Premier League,2021,19.0,2001.0,18.3,20,14,7,8,5,6,23,26.1,17,23,3,20,15,35,17,0,"FW,MF",Under 20,Forward,Brazil,South America
1281,João Pedro,BRA,Watford,Premier League,2021,19.0,2001.0,18.3,20,14,7,8,5,6,23,26.1,17,23,3,20,15,35,17,0,"FW,MF",Under 20,Forward,Brazil,South America
1281,João Pedro,BRA,Watford,Premier League,2021,19.0,2001.0,18.3,20,14,7,8,5,6,23,26.1,17,23,3,20,15,35,17,0,"FW,MF",Under 20,Forward,Brazil,South America
1281,João Pedro,BRA,Watford,Premier League,2021,19.0,2001.0,18.3,20,14,7,8,5,6,23,26.1,17,23,3,20,15,35,17,0,"FW,MF",Under 20,Forward,Brazil,South America
1281,João Pedro,BRA,Watford,Premier League,2021,19.0,2001.0,18.3,20,14,7,8,5,6,23,26.1,17,23,3,20,15,35,17,0,"FW,MF",Under 20,Forward,Brazil,South America
1283,Joelinton,BRA,Newcastle Utd,Premier League,2021,24.0,1996.0,28.4,72,38,30,33,9,26,61,42.6,35,46,11,35,34,106,50,2,"MF,FW",20-24,Midfielder,Brazil,South America
1285,Marco John,GER,Hoffenheim,Bundesliga,2021,19.0,2002.0,0.5,0,0,0,0,0,0,1,0.0,1,1,0,1,1,1,1,0,DF,Under 20,Defender,Germany,Europe
1287,Ben Johnson,ENG,West Ham,Premier League,2021,21.0,2000.0,15.5,33,16,15,15,3,21,28,75.0,7,16,8,8,22,55,55,0,DF,20-24,Defender,England,Europe
1288,Curtis Jones,ENG,Liverpool,Premier League,2021,20.0,2001.0,9.5,11,9,3,6,2,1,10,10.0,9,4,0,4,6,17,4,0,MF,20-24,Midfielder,England,Europe
1289,Phil Jones,ENG,Manchester Utd,Premier League,2021,29.0,1992.0,1.8,5,5,3,1,1,2,3,66.7,1,4,4,0,3,8,8,0,DF,25-29,Defender,England,Europe
1290,Frenkie de Jong,NED,Barcelona,La Liga,2021,24.0,1997.0,27.5,35,19,12,18,5,12,23,52.2,11,19,5,14,20,55,16,0,MF,20-24,Midfielder,Netherlands,Europe
1293,Kaio Jorge,BRA,Juventus,Serie A,2021,19.0,2002.0,1.3,2,1,0,2,0,1,3,33.3,2,1,0,1,0,2,2,0,"MF,FW",Under 20,Midfielder,Brazil,South America
1294,Jorginho,ITA,Chelsea,Premier League,2021,29.0,1991.0,25.3,64,33,27,31,6,29,83,34.9,54,27,4,23,36,100,21,1,MF,25-29,Midfielder,Italy,Europe
1294,Jorginho,ITA,Chelsea,Premier League,2021,29.0,1991.0,25.3,64,33,27,31,6,29,83,34.9,54,27,4,23,36,100,21,1,MF,25-29,Midfielder,Italy,Europe
1294,Jorginho,ITA,Chelsea,Premier League,2021,29.0,1991.0,25.3,64,33,27,31,6,29,83,34.9,54,27,4,23,36,100,21,1,MF,25-29,Midfielder,Italy,Europe
1294,Jorginho,ITA,Chelsea,Premier League,2021,29.0,1991.0,25.3,64,33,27,31,6,29,83,34.9,54,27,4,23,36,100,21,1,MF,25-29,Midfielder,Italy,Europe
1294,Jorginho,ITA,Chelsea,Premier League,2021,29.0,1991.0,25.3,64,33,27,31,6,29,83,34.9,54,27,4,23,36,100,21,1,MF,25-29,Midfielder,Italy,Europe
1294,Jorginho,ITA,Chelsea,Premier League,2021,29.0,1991.0,25.3,64,33,27,31,6,29,83,34.9,54,27,4,23,36,100,21,1,MF,25-29,Midfielder,Italy,Europe
1294,Jorginho,ITA,Chelsea,Premier League,2021,29.0,1991.0,25.3,64,33,27,31,6,29,83,34.9,54,27,4,23,36,100,21,1,MF,25-29,Midfielder,Italy,Europe
1294,Jorginho,ITA,Chelsea,Premier League,2021,29.0,1991.0,25.3,64,33,27,31,6,29,83,34.9,54,27,4,23,36,100,21,1,MF,25-29,Midfielder,Italy,Europe
1294,Jorginho,ITA,Chelsea,Premier League,2021,29.0,1991.0,25.3,64,33,27,31,6,29,83,34.9,54,27,4,23,36,100,21,1,MF,25-29,Midfielder,Italy,Europe
1294,Jorginho,ITA,Chelsea,Premier League,2021,29.0,1991.0,25.3,64,33,27,31,6,29,83,34.9,54,27,4,23,36,100,21,1,MF,25-29,Midfielder,Italy,Europe
1294,Jorginho,ITA,Chelsea,Premier League,2021,29.0,1991.0,25.3,64,33,27,31,6,29,83,34.9,54,27,4,23,36,100,21,1,MF,25-29,Midfielder,Italy,Europe
1294,Jorginho,ITA,Chelsea,Premier League,2021,29.0,1991.0,25.3,64,33,27,31,6,29,83,34.9,54,27,4,23,36,100,21,1,MF,25-29,Midfielder,Italy,Europe
1294,Jorginho,ITA,Chelsea,Premier League,2021,29.0,1991.0,25.3,64,33,27,31,6,29,83,34.9,54,27,4,23,36,100,21,1,MF,25-29,Midfielder,Italy,Europe
1294,Jorginho,ITA,Chelsea,Premier League,2021,29.0,1991.0,25.3,64,33,27,31,6,29,83,34.9,54,27,4,23,36,100,21,1,MF,25-29,Midfielder,Italy,Europe
1294,Jorginho,ITA,Chelsea,Premier League,2021,29.0,1991.0,25.3,64,33,27,31,6,29,83,34.9,54,27,4,23,36,100,21,1,MF,25-29,Midfielder,Italy,Europe
1294,Jorginho,ITA,Chelsea,Premier League,2021,29.0,1991.0,25.3,64,33,27,31,6,29,83,34.9,54,27,4,23,36,100,21,1,MF,25-29,Midfielder,Italy,Europe
1296,Willian José,BRA,Betis,La Liga,2021,29.0,1991.0,17.8,15,13,2,10,3,2,8,25.0,6,10,2,8,3,18,16,0,FW,25-29,Forward,Brazil,South America
1299,Lenny Joseph,FRA,Metz,Ligue 1,2021,20.0,2000.0,1.7,2,1,1,1,0,0,0,,0,3,0,3,0,2,0,0,"FW,MF",20-24,Forward,France,Europe
1300,Diogo Jota,POR,Liverpool,Premier League,2021,24.0,1996.0,26.3,39,18,12,18,9,13,55,23.6,42,19,2,17,6,45,6,0,FW,20-24,Forward,Portugal,Europe
1304,José Juan Macías,MEX,Getafe,La Liga,2021,21.0,1999.0,2.2,1,0,0,0,1,0,1,0.0,1,1,0,1,1,2,0,0,"FW,MF",20-24,Forward,Mexico,North America
1306,Gideon Jung,GER,Greuther Fürth,Bundesliga,2021,26.0,1994.0,1.6,3,1,1,2,0,2,4,50.0,2,1,1,0,2,5,5,0,DF,25-29,Defender,Germany,Europe
1311,James Justin,ENG,Leicester City,Premier League,2021,23.0,1998.0,11.1,22,13,11,8,3,7,15,46.7,8,16,4,12,17,39,34,0,DF,20-24,Defender,England,Europe
1315,Ozan Kabak,TUR,Norwich City,Premier League,2021,21.0,2000.0,10.2,10,5,4,6,0,5,9,55.6,4,19,11,8,16,26,26,0,DF,20-24,Defender,Turkey,Asia
1316,Christian Kabasele,BEL,Watford,Premier League,2021,30.0,1991.0,13.3,11,5,10,1,0,7,10,70.0,3,20,16,4,14,25,67,1,DF,30-34,Defender,Belgium,Europe
1317,Issa Kaboré,BFA,Troyes,Ligue 1,2021,20.0,2001.0,25.0,45,22,22,14,9,20,38,52.6,18,27,2,25,20,65,38,1,"DF,MF",20-24,Defender,Burkina Faso,Africa
1320,Tino Kadewere,ZIM,Lyon,Ligue 1,2021,25.0,1996.0,5.6,7,5,2,2,3,4,13,30.8,9,7,0,7,4,11,1,1,FW,25-29,Forward,Zimbabwe,Africa
1321,Florian Kainz,AUT,Köln,Bundesliga,2021,28.0,1992.0,25.8,41,26,9,25,7,23,51,45.1,28,27,3,24,32,73,24,0,"MF,FW",25-29,Midfielder,Austria,Europe
1322,Gaël Kakuta,COD,Lens,Ligue 1,2021,30.0,1991.0,18.6,22,14,2,13,7,4,20,20.0,16,10,0,10,4,26,3,0,"MF,FW",30-34,Midfielder,DR Congo,Africa
1323,Sasa Kalajdzic,AUT,Stuttgart,Bundesliga,2021,24.0,1997.0,13.6,10,6,2,5,3,3,11,27.3,8,5,0,5,2,12,14,0,FW,20-24,Forward,Austria,Europe
1324,Arnaud Kalimuendo,FRA,Lens,Ligue 1,2021,19.0,2002.0,23.9,9,8,1,3,5,2,7,28.6,5,6,1,5,8,17,0,0,FW,Under 20,Forward,France,Europe
1325,Arnaud Kalimuendo,FRA,Paris S-G,Ligue 1,2021,19.0,2002.0,0.1,0,0,0,0,0,0,0,,0,0,0,0,0,0,0,0,FW,Under 20,Forward,France,Europe
1327,Yayah Kallon,SLE,Genoa,Serie A,2021,20.0,2001.0,7.1,15,11,5,6,4,3,11,27.3,8,7,1,6,1,16,5,0,"FW,MF",20-24,Forward,Sierra Leone,Africa
1328,Samuel Kalu,NGA,Watford,Premier League,2021,23.0,1997.0,2.5,2,2,0,2,0,1,1,100.0,0,2,0,2,3,5,3,0,FW,20-24,Forward,Nigeria,Africa
1329,Samuel Kalu,NGA,Bordeaux,Ligue 1,2021,23.0,1997.0,3.6,8,5,3,4,1,2,5,40.0,3,2,0,2,3,11,1,0,"FW,MF",20-24,Forward,Nigeria,Africa
1330,Pierre Kalulu,FRA,Milan,Serie A,2021,21.0,2000.0,21.6,61,36,36,21,4,17,22,77.3,5,36,15,21,26,87,54,0,DF,20-24,Defender,France,Europe
1331,Daichi Kamada,JPN,Eint Frankfurt,Bundesliga,2021,24.0,1996.0,23.8,40,21,7,26,7,11,40,27.5,29,18,0,18,8,48,10,0,MF,20-24,Midfielder,Japan,Asia
1332,Boubacar Kamara,FRA,Marseille,Ligue 1,2021,21.0,1999.0,30.9,68,38,27,36,5,26,47,55.3,21,29,10,19,46,114,44,1,"MF,DF",20-24,Midfielder,France,Europe
1333,Hassane Kamara,CIV,Watford,Premier League,2021,27.0,1994.0,18.0,53,34,31,16,6,27,43,62.8,16,20,4,16,69,122,67,0,DF,25-29,Defender,Ivory Coast,Africa
1334,Hassane Kamara,CIV,Nice,Ligue 1,2021,27.0,1994.0,6.0,13,10,4,6,3,5,8,62.5,3,10,2,8,9,22,4,0,"MF,DF",25-29,Midfielder,Ivory Coast,Africa
1337,Jean-Armel Kana-Biyik,CMR,Metz,Ligue 1,2021,32.0,1989.0,7.4,10,6,8,2,0,4,9,44.4,5,11,4,7,16,26,22,1,DF,30-34,Defender,Cameroon,Africa
1339,Harry Kane,ENG,Tottenham,Premier League,2021,28.0,1993.0,35.9,15,5,2,10,3,7,18,38.9,11,26,8,18,3,18,39,0,FW,25-29,Forward,England,Europe
1341,N'Golo Kanté,FRA,Chelsea,Premier League,2021,30.0,1991.0,19.7,59,31,20,27,12,25,40,62.5,15,37,2,35,31,90,8,0,MF,30-34,Midfielder,France,Europe
1346,Grigoris Kastanos,CYP,Salernitana,Serie A,2021,23.0,1998.0,15.0,30,19,9,19,2,7,23,30.4,16,21,5,16,22,52,8,0,"MF,FW",20-24,Midfielder,Cyprus,Asia
1348,Noah Katterbach,GER,Köln,Bundesliga,2021,20.0,2001.0,0.2,1,1,1,0,0,1,1,100.0,0,0,0,0,0,1,1,0,DF,20-24,Defender,Germany,Europe
1349,Eiji Kawashima,JPN,Strasbourg,Ligue 1,2021,38.0,1983.0,1.0,0,0,0,0,0,0,0,,0,0,0,0,0,0,0,0,GK,35-39,Goalkeeper,Japan,Asia
1350,Edo Kayembe,COD,Watford,Premier League,2021,23.0,1998.0,8.9,21,13,11,9,1,8,16,50.0,8,6,1,5,9,30,13,0,MF,20-24,Midfielder,DR Congo,Africa
1351,Moise Kean,ITA,Everton,Premier League,2021,21.0,2000.0,0.0,0,0,0,0,0,0,0,,0,0,0,0,0,0,0,0,FW,20-24,Forward,Italy,Europe
1352,Moise Kean,ITA,Juventus,Serie A,2021,21.0,2000.0,12.2,9,4,2,5,2,6,16,37.5,10,5,0,5,3,12,8,1,FW,20-24,Forward,Italy,Europe
1353,Michael Keane,ENG,Everton,Premier League,2021,28.0,1993.0,31.0,46,25,32,13,1,28,45,62.2,17,33,28,5,62,108,128,2,DF,25-29,Defender,England,Europe
1354,Ilan Kebbal,ALG,Reims,Ligue 1,2021,23.0,1998.0,19.7,31,15,13,10,8,12,44,27.3,32,16,0,16,13,44,3,0,"MF,FW",20-24,Midfielder,Algeria,Africa
1356,Thilo Kehrer,GER,Paris S-G,Ligue 1,2021,24.0,1996.0,16.8,21,14,9,11,1,9,21,42.9,12,19,11,8,24,45,29,0,DF,20-24,Defender,Germany,Europe
1358,Naby Keïta,GUI,Liverpool,Premier League,2021,26.0,1995.0,13.0,46,23,17,19,10,26,42,61.9,16,33,2,31,14,60,8,0,MF,25-29,Midfielder,Guinea,Africa
1359,Yannik Keitel,GER,Freiburg,Bundesliga,2021,21.0,2000.0,5.6,11,4,5,4,2,5,15,33.3,10,7,1,6,1,12,8,0,MF,20-24,Midfielder,Germany,Europe
1360,Caoimhín Kelleher,IRL,Liverpool,Premier League,2021,22.0,1998.0,2.0,1,1,1,0,0,1,1,100.0,0,0,0,0,0,1,1,0,GK,20-24,Goalkeeper,Republic of Ireland,Europe
1363,Kenedy,BRA,Chelsea,Premier League,2021,25.0,1996.0,0.6,5,2,1,2,2,2,3,66.7,1,0,0,0,0,5,0,0,DF,25-29,Defender,Brazil,South America
1364,Jonjoe Kenny,ENG,Everton,Premier League,2021,24.0,1997.0,11.3,17,7,11,6,0,13,21,61.9,8,8,1,7,20,37,31,0,DF,20-24,Defender,England,Europe
1366,Franck Kessié,CIV,Milan,Serie A,2021,24.0,1996.0,25.6,41,23,12,24,5,17,26,65.4,9,39,10,29,23,64,22,0,MF,20-24,Midfielder,Ivory Coast,Africa
1367,Saîf-Eddine Khaoui,TUN,Clermont Foot,Ligue 1,2021,26.0,1995.0,10.3,19,10,5,10,4,9,18,50.0,9,9,0,9,14,33,5,0,"MF,FW",25-29,Midfielder,Tunisia,Africa
1368,Wahbi Khazri,TUN,Saint-Étienne,Ligue 1,2021,30.0,1991.0,24.7,33,18,7,17,9,9,34,26.5,25,21,0,21,12,45,7,0,"FW,MF",30-34,Forward,Tunisia,Africa
1369,Rani Khedira,GER,Union Berlin,Bundesliga,2021,27.0,1994.0,30.6,75,38,25,42,8,32,66,48.5,34,21,8,13,50,125,27,1,MF,25-29,Midfielder,Germany,Europe
1371,Luca Kilian,GER,Mainz 05,Bundesliga,2021,21.0,1999.0,0.0,0,0,0,0,0,0,0,,0,0,0,0,0,0,0,0,FW,20-24,Forward,Germany,Europe
1372,Luca Kilian,GER,Köln,Bundesliga,2021,21.0,1999.0,25.3,42,24,30,9,3,21,41,51.2,20,31,13,18,46,88,109,3,DF,20-24,Defender,Germany,Europe
1374,Joshua Kimmich,GER,Bayern Munich,Bundesliga,2021,26.0,1995.0,27.5,39,20,14,17,8,18,58,31.0,40,34,8,26,52,91,29,1,MF,25-29,Midfielder,Germany,Europe
1375,Presnel Kimpembe,FRA,Paris S-G,Ligue 1,2021,25.0,1995.0,28.6,34,19,18,15,1,14,23,60.9,9,20,14,6,38,72,73,1,DF,25-29,Defender,France,Europe
1379,Simon Kjær,DEN,Milan,Serie A,2021,32.0,1989.0,8.9,20,12,9,8,3,6,12,50.0,6,17,13,4,9,29,39,0,DF,30-34,Defender,Denmark,Europe
1381,Philipp Klement,GER,Stuttgart,Bundesliga,2021,28.0,1992.0,3.8,7,3,1,4,2,3,3,100.0,0,6,1,5,1,8,0,0,MF,25-29,Midfielder,Germany,Europe
1384,Mateo Klimowicz,GER,Stuttgart,Bundesliga,2021,21.0,2000.0,6.7,13,6,6,7,0,5,16,31.3,11,2,0,2,4,17,3,0,"MF,FW",20-24,Midfielder,Germany,Europe
1385,Fabian Klos,GER,Arminia,Bundesliga,2021,33.0,1987.0,15.8,7,5,0,5,2,2,10,20.0,8,17,4,13,0,7,31,0,FW,30-34,Forward,Germany,Europe
1386,Lukas Klostermann,GER,RB Leipzig,Bundesliga,2021,25.0,1996.0,18.3,29,16,11,15,3,13,19,68.4,6,16,3,13,26,55,58,0,DF,25-29,Defender,Germany,Europe
1387,Justin Kluivert,NED,Nice,Ligue 1,2021,22.0,1999.0,20.8,19,9,6,12,1,5,21,23.8,16,13,1,12,14,33,6,0,MF,20-24,Midfielder,Netherlands,Europe
1388,Lukas Klünter,GER,Hertha BSC,Bundesliga,2021,25.0,1996.0,2.2,1,1,1,0,0,1,5,20.0,4,1,0,1,2,3,2,0,DF,25-29,Defender,Germany,Europe
1389,Ansgar Knauff,GER,Dortmund,Bundesliga,2021,19.0,2002.0,1.3,3,1,1,1,1,0,4,0.0,4,2,0,2,0,3,4,0,"FW,MF",Under 20,Forward,Germany,Europe
1390,Ansgar Knauff,GER,Eint Frankfurt,Bundesliga,2021,19.0,2002.0,8.4,18,14,8,5,5,8,15,53.3,7,11,1,10,8,26,6,0,"DF,MF",Under 20,Defender,Germany,Europe
1391,Robin Knoche,GER,Union Berlin,Bundesliga,2021,29.0,1992.0,33.0,50,24,38,12,0,30,53,56.6,23,45,26,19,49,99,151,1,DF,25-29,Defender,Germany,Europe
1392,Gregor Kobel,SUI,Dortmund,Bundesliga,2021,23.0,1997.0,28.5,0,0,0,0,0,0,2,0.0,2,0,0,0,1,1,20,0,GK,20-24,Goalkeeper,Switzerland,Europe
1393,Robin Koch,GER,Leeds United,Premier League,2021,25.0,1996.0,17.5,21,13,9,10,2,9,34,26.5,25,26,10,16,20,41,44,0,"MF,DF",25-29,Midfielder,Germany,Europe
1396,Dominik Kohr,GER,Mainz 05,Bundesliga,2021,27.0,1994.0,17.9,40,20,18,19,3,16,42,38.1,26,21,2,19,35,75,22,0,MF,25-29,Midfielder,Germany,Europe
1399,Aleksandr Kokorin,RUS,Fiorentina,Serie A,2021,30.0,1991.0,0.6,1,1,1,0,0,0,0,,0,1,0,1,0,1,0,0,"FW,MF",30-34,Forward,Russia,Europe
1404,Randal Kolo Muani,FRA,Nantes,Ligue 1,2021,22.0,1998.0,32.8,28,14,7,10,11,10,25,40.0,15,14,3,11,6,34,31,0,"FW,MF",20-24,Forward,France,Europe
1405,Timothée Kolodziejczak,FRA,Saint-Étienne,Ligue 1,2021,29.0,1991.0,28.5,43,24,22,14,7,20,36,55.6,16,29,7,22,60,103,72,1,DF,25-29,Defender,France,Europe
1406,Ghislain Konan,CIV,Reims,Ligue 1,2021,25.0,1995.0,26.9,35,19,19,15,1,16,30,53.3,14,35,8,27,28,63,45,0,DF,25-29,Defender,Ivory Coast,Africa
1407,Ibrahima Konaté,FRA,Liverpool,Premier League,2021,22.0,1999.0,11.0,16,10,9,6,1,7,10,70.0,3,13,9,4,16,32,37,1,DF,20-24,Defender,France,Europe
1408,Geoffrey Kondogbia,CTA,Atlético Madrid,La Liga,2021,28.0,1993.0,20.9,74,44,25,40,9,21,49,42.9,28,16,5,11,44,118,24,0,"MF,DF",25-29,Midfielder,Central African Republic,Africa
1410,Manu Koné,FRA,Gladbach,Bundesliga,2021,20.0,2001.0,24.3,60,37,29,28,3,25,42,59.5,17,27,4,23,34,94,12,0,MF,20-24,Midfielder,France,Europe
1412,Ezri Konsa,ENG,Aston Villa,Premier League,2021,23.0,1997.0,27.5,25,15,13,11,1,10,13,76.9,3,31,22,9,15,40,86,2,DF,20-24,Defender,England,Europe
1413,Teun Koopmeiners,NED,Atalanta,Serie A,2021,23.0,1998.0,23.6,40,24,10,19,11,22,54,40.7,32,31,2,29,15,55,19,0,MF,20-24,Midfielder,Netherlands,Europe
1414,Laurent Koscielny,FRA,Bordeaux,Ligue 1,2021,35.0,1985.0,10.4,14,9,10,3,1,8,13,61.5,5,17,12,5,12,26,39,0,DF,35-39,Defender,France,Europe
1415,Odilon Kossounou,CIV,Leverkusen,Bundesliga,2021,20.0,2001.0,19.9,23,17,16,6,1,15,25,60.0,10,36,14,22,26,49,66,0,DF,20-24,Defender,Ivory Coast,Africa
1417,Rominigue Kouamé,MLI,Troyes,Ligue 1,2021,24.0,1996.0,33.0,47,22,24,20,3,19,58,32.8,39,33,5,28,46,93,22,2,MF,20-24,Midfielder,Mali,Africa
1418,Kalidou Koulibaly,SEN,Napoli,Serie A,2021,30.0,1991.0,26.7,39,23,31,6,2,25,38,65.8,13,41,25,16,29,68,90,1,DF,30-34,Defender,Senegal,Africa
1419,Jules Koundé,FRA,Sevilla,La Liga,2021,22.0,1998.0,30.4,40,17,27,10,3,18,28,64.3,10,33,18,15,21,61,101,2,DF,20-24,Defender,France,Europe
1420,Christos Kourfalidis,GRE,Cagliari,Serie A,2021,18.0,2002.0,0.2,0,0,0,0,0,0,1,0.0,1,1,0,1,0,0,0,0,"MF,FW",Under 20,Midfielder,Greece,Europe
1422,Cheikhou Kouyaté,SEN,Crystal Palace,Premier League,2021,31.0,1989.0,21.9,52,38,28,22,2,18,39,46.2,21,40,14,26,38,90,39,0,MF,30-34,Midfielder,Senegal,Africa
1424,Viktor Kovalenko,UKR,Spezia,Serie A,2021,25.0,1996.0,14.7,16,10,7,8,1,9,21,42.9,12,16,3,13,13,29,8,0,MF,25-29,Midfielder,Ukraine,Europe
1425,Emil Krafth,SWE,Newcastle Utd,Premier League,2021,26.0,1994.0,18.2,37,16,25,11,1,27,36,75.0,9,16,10,6,25,62,56,0,DF,25-29,Defender,Sweden,Europe
1428,Christoph Kramer,GER,Gladbach,Bundesliga,2021,30.0,1991.0,8.3,28,11,15,10,3,12,28,42.9,16,18,5,13,12,40,9,0,MF,30-34,Midfielder,Germany,Europe
1429,Jean-Philippe Krasso,CIV,Saint-Étienne,Ligue 1,2021,24.0,1997.0,5.0,7,5,0,5,2,2,10,20.0,8,7,1,6,0,7,1,0,FW,20-24,Forward,Ivory Coast,Africa
1431,Toni Kroos,GER,Real Madrid,La Liga,2021,31.0,1990.0,23.4,34,26,13,17,4,14,36,38.9,22,16,3,13,12,46,13,1,MF,30-34,Midfielder,Germany,Europe
1433,Tim Krul,NED,Norwich City,Premier League,2021,33.0,1988.0,29.0,1,1,1,0,0,1,4,25.0,3,0,0,0,0,1,10,4,GK,30-34,Goalkeeper,Netherlands,Europe
1435,Max Kruse,GER,Wolfsburg,Bundesliga,2021,33.0,1988.0,12.5,9,3,4,4,1,5,12,41.7,7,2,0,2,3,12,4,0,"MF,FW",30-34,Midfielder,Germany,Europe
1436,Max Kruse,GER,Union Berlin,Bundesliga,2021,33.0,1988.0,14.1,4,1,0,3,1,2,16,12.5,14,12,0,12,3,7,2,0,"FW,MF",30-34,Forward,Germany,Europe
1437,Lukas Kübler,GER,Freiburg,Bundesliga,2021,28.0,1992.0,25.9,62,35,38,16,8,28,49,57.1,21,24,8,16,44,106,70,0,"DF,MF",25-29,Defender,Germany,Europe
1438,Takefusa Kubo,JPN,Mallorca,La Liga,2021,20.0,2001.0,17.8,31,19,12,14,5,10,24,41.7,14,24,3,21,8,39,4,0,"FW,MF",20-24,Forward,Japan,Asia
1439,Juraj Kucka,SVK,Watford,Premier League,2021,34.0,1987.0,21.3,59,39,32,25,2,27,73,37.0,46,30,9,21,27,86,46,2,MF,30-34,Midfielder,Slovakia,Europe
1441,Dejan Kulusevski,SWE,Tottenham,Premier League,2021,21.0,2000.0,14.0,19,13,7,10,2,5,23,21.7,18,14,0,14,13,32,3,0,"MF,FW",20-24,Midfielder,Sweden,Europe
1442,Dejan Kulusevski,SWE,Juventus,Serie A,2021,21.0,2000.0,8.6,15,12,9,6,0,8,21,38.1,13,14,0,14,5,20,5,0,"FW,MF",20-24,Forward,Sweden,Europe
1443,Marash Kumbulla,ALB,Roma,Serie A,2021,21.0,2000.0,11.4,21,13,13,7,1,8,15,53.3,7,17,8,9,16,37,26,0,DF,20-24,Defender,Albania,Europe
1444,Fabian Kunze,GER,Arminia,Bundesliga,2021,23.0,1998.0,14.0,35,21,14,20,1,15,32,46.9,17,17,2,15,19,54,27,1,MF,20-24,Midfielder,Germany,Europe
1448,Andrea La Mantia,ITA,Empoli,Serie A,2021,30.0,1991.0,5.4,2,0,0,0,2,1,2,50.0,1,3,1,2,1,3,6,0,"FW,MF",30-34,Forward,Italy,Europe
1449,Gaëtan Laborde,FRA,Montpellier,Ligue 1,2021,27.0,1994.0,3.8,2,2,1,1,0,2,4,50.0,2,3,0,3,5,7,5,0,FW,25-29,Forward,France,Europe
1450,Gaëtan Laborde,FRA,Rennes,Ligue 1,2021,27.0,1994.0,30.3,19,7,5,8,6,3,22,13.6,19,29,3,26,8,27,16,0,FW,25-29,Forward,France,Europe
1451,Alexandre Lacazette,FRA,Arsenal,Premier League,2021,30.0,1991.0,19.8,27,10,8,13,6,7,21,33.3,14,12,1,11,5,32,6,0,FW,30-34,Forward,France,Europe
1453,Lenny Lacroix,FRA,Metz,Ligue 1,2021,18.0,2003.0,2.2,9,7,8,1,0,5,8,62.5,3,5,1,4,10,19,5,0,DF,Under 20,Defender,France,Europe
1454,Maxence Lacroix,FRA,Wolfsburg,Bundesliga,2021,21.0,2000.0,27.7,59,33,41,16,2,29,40,72.5,11,35,16,19,60,119,144,0,DF,20-24,Defender,France,Europe
1455,Alban Lafont,FRA,Nantes,Ligue 1,2021,22.0,1999.0,38.0,3,3,3,0,0,3,8,37.5,5,1,0,1,1,4,25,2,GK,20-24,Goalkeeper,France,Europe
1457,Konrad Laimer,AUT,RB Leipzig,Bundesliga,2021,24.0,1997.0,13.8,38,24,11,22,5,24,53,45.3,29,29,3,26,4,42,9,0,MF,20-24,Midfielder,Austria,Europe
1458,Stefan Lainer,AUT,Gladbach,Bundesliga,2021,28.0,1992.0,16.3,19,11,9,7,3,12,28,42.9,16,24,5,19,14,33,31,0,DF,25-29,Defender,Austria,Europe
1460,Adam Lallana,ENG,Brighton,Premier League,2021,33.0,1988.0,17.3,34,17,14,14,6,12,41,29.3,29,16,6,10,16,50,13,1,MF,30-34,Midfielder,England,Europe
1467,Tariq Lamptey,GHA,Brighton,Premier League,2021,20.0,2000.0,17.3,36,25,14,17,5,15,25,60.0,10,13,3,10,21,57,23,0,"DF,FW",20-24,Defender,Ghana,Africa
1468,Manuel Lanzini,ARG,West Ham,Premier League,2021,28.0,1993.0,19.8,28,15,10,11,7,10,35,28.6,25,16,0,16,19,47,10,0,"MF,FW",25-29,Midfielder,Argentina,South America
1470,Julien Laporte,FRA,Lorient,Ligue 1,2021,27.0,1993.0,32.1,63,45,35,26,2,32,64,50.0,32,37,22,15,54,117,174,0,DF,25-29,Defender,France,Europe
1471,Yasser Larouci,ALG,Troyes,Ligue 1,2021,20.0,2001.0,3.8,6,5,2,4,0,3,3,100.0,0,1,0,1,7,13,5,0,DF,20-24,Defender,Algeria,Africa
1473,Jamaal Lascelles,ENG,Newcastle Utd,Premier League,2021,27.0,1993.0,22.9,15,7,9,5,1,4,12,33.3,8,38,28,10,22,37,121,1,DF,25-29,Defender,England,Europe
1474,Bryan Lasme,FRA,Arminia,Bundesliga,2021,22.0,1998.0,9.7,6,6,1,2,3,0,3,0.0,3,7,0,7,1,7,9,0,FW,20-24,Forward,France,Europe
1475,Paul Lasne,FRA,Brest,Ligue 1,2021,32.0,1989.0,9.4,26,12,6,16,4,8,18,44.4,10,11,2,9,24,50,10,0,MF,30-34,Midfielder,France,Europe
1480,Manuel Lazzari,ITA,Lazio,Serie A,2021,27.0,1993.0,18.5,28,14,13,15,0,16,26,61.5,10,10,2,8,12,40,16,1,DF,25-29,Defender,Italy,Europe
1481,Théo Le Bris,FRA,Lorient,Ligue 1,2021,18.0,2002.0,0.7,2,1,1,1,0,1,2,50.0,1,2,0,2,0,2,1,0,MF,Under 20,Midfielder,France,Europe
1482,Jérémy Le Douaron,FRA,Brest,Ligue 1,2021,23.0,1998.0,16.1,11,5,4,4,3,1,17,5.9,16,15,0,15,4,15,14,0,"FW,MF",20-24,Forward,France,Europe
1483,Enzo Le Fée,FRA,Lorient,Ligue 1,2021,21.0,2000.0,24.4,70,44,25,36,9,41,90,45.6,49,25,1,24,29,99,18,0,"MF,FW",20-24,Midfielder,France,Europe
1484,Vincent Le Goff,FRA,Lorient,Ligue 1,2021,31.0,1989.0,34.0,61,38,38,19,4,37,62,59.7,25,18,3,15,37,98,50,0,DF,30-34,Defender,France,Europe
1485,Maxime Le Marchand,FRA,Strasbourg,Ligue 1,2021,31.0,1989.0,9.6,17,8,16,1,0,8,10,80.0,2,9,5,4,14,31,32,0,DF,30-34,Defender,France,Europe
1488,Rafael Leão,POR,Milan,Serie A,2021,22.0,1999.0,28.9,17,7,3,9,5,10,20,50.0,10,12,1,11,12,29,8,0,FW,20-24,Forward,Portugal,Europe
1489,Jean-Louis Leca,FRA,Lens,Ligue 1,2021,35.0,1985.0,25.7,0,0,0,0,0,0,0,,0,1,0,1,1,1,11,1,GK,35-39,Goalkeeper,France,Europe
1491,Pierre Lees-Melou,FRA,Norwich City,Premier League,2021,28.0,1993.0,25.2,58,36,23,29,6,25,92,27.2,67,37,11,26,25,83,23,0,MF,25-29,Midfielder,France,Europe
1493,Maxim Leitsch,GER,Bochum,Bundesliga,2021,23.0,1998.0,17.1,18,10,9,7,2,10,15,66.7,5,31,19,12,31,49,74,1,DF,20-24,Defender,Germany,Europe
1494,Lucas Leiva,BRA,Lazio,Serie A,2021,34.0,1987.0,18.9,55,30,26,25,4,15,53,28.3,38,27,10,17,28,83,37,0,MF,30-34,Midfielder,Brazil,South America
1495,Florian Lejeune,FRA,Alavés,La Liga,2021,30.0,1991.0,30.0,33,24,22,10,1,12,20,60.0,8,30,19,11,31,64,158,0,DF,30-34,Defender,France,Europe
1497,Thomas Lemar,FRA,Atlético Madrid,La Liga,2021,25.0,1995.0,16.0,24,14,9,12,3,8,23,34.8,15,18,0,18,8,32,11,0,MF,25-29,Midfielder,France,Europe
1498,Félix Lemaréchal,FRA,Monaco,Ligue 1,2021,17.0,2003.0,0.1,0,0,0,0,0,0,1,0.0,1,0,0,0,0,0,0,0,MF,Under 20,Midfielder,France,Europe
1500,Fabien Lemoine,FRA,Lorient,Ligue 1,2021,34.0,1987.0,12.4,35,22,20,14,1,17,41,41.5,24,21,4,17,14,49,24,1,MF,30-34,Midfielder,France,Europe
1501,Tim Lemperle,GER,Köln,Bundesliga,2021,19.0,2002.0,1.7,4,1,2,1,1,1,3,33.3,2,1,0,1,2,6,2,0,"FW,MF",Under 20,Forward,Germany,Europe
1503,Clément Lenglet,FRA,Barcelona,La Liga,2021,26.0,1995.0,9.2,20,11,11,7,2,8,13,61.5,5,7,3,4,13,33,21,0,DF,25-29,Defender,France,Europe
1504,Aaron Lennon,ENG,Burnley,Premier League,2021,34.0,1987.0,17.2,33,17,10,13,10,10,34,29.4,24,26,4,22,9,42,14,0,"MF,FW",30-34,Midfielder,England,Europe
1505,Bernd Leno,GER,Arsenal,Premier League,2021,29.0,1992.0,4.0,1,1,1,0,0,1,1,100.0,0,0,0,0,0,1,1,0,GK,25-29,Goalkeeper,Germany,Europe
1506,Christopher Lenz,GER,Eint Frankfurt,Bundesliga,2021,26.0,1994.0,7.4,29,15,22,6,1,12,21,57.1,9,9,4,5,7,36,21,0,DF,25-29,Defender,Germany,Europe
1507,Léo Leroy,FRA,Montpellier,Ligue 1,2021,21.0,2000.0,7.0,31,21,17,11,3,12,34,35.3,22,20,4,16,8,39,8,0,MF,20-24,Midfielder,France,Europe
1508,Alexandre Letellier,FRA,Paris S-G,Ligue 1,2021,30.0,1990.0,0.1,0,0,0,0,0,0,0,,0,0,0,0,0,0,0,0,GK,30-34,Goalkeeper,France,Europe
1510,Jamie Leweling,GER,Greuther Fürth,Bundesliga,2021,20.0,2001.0,21.8,13,8,3,7,3,3,16,18.8,13,9,0,9,13,26,5,0,"FW,MF",20-24,Forward,Germany,Europe
1512,Luca Lezzerini,ITA,Venezia,Serie A,2021,26.0,1995.0,5.5,0,0,0,0,0,0,0,,0,1,0,1,0,0,0,0,GK,25-29,Goalkeeper,Italy,Europe
1513,Ben Lhassine Kone,CIV,Torino,Serie A,2021,21.0,2000.0,0.9,3,3,1,2,0,1,2,50.0,1,0,0,0,1,4,1,0,MF,20-24,Midfielder,Ivory Coast,Africa
1515,Dimitri Liénard,FRA,Strasbourg,Ligue 1,2021,33.0,1988.0,22.7,71,43,40,21,10,46,77,59.7,31,12,0,12,21,92,28,0,"DF,MF",30-34,Defender,France,Europe
1516,Philipp Lienhart,AUT,Freiburg,Bundesliga,2021,25.0,1996.0,31.9,24,13,17,6,1,13,24,54.2,11,33,23,10,50,74,158,1,DF,25-29,Defender,Austria,Europe
1517,Matthijs de Ligt,NED,Juventus,Serie A,2021,21.0,1999.0,29.7,34,19,21,13,0,15,18,83.3,3,31,21,10,26,60,103,0,DF,20-24,Defender,Netherlands,Europe
1518,Isaac Lihadji,FRA,Lille,Ligue 1,2021,19.0,2002.0,2.6,3,3,1,1,1,1,5,20.0,4,1,0,1,2,5,0,0,"MF,FW",Under 20,Midfielder,France,Europe
1520,Andreas Linde,SWE,Greuther Fürth,Bundesliga,2021,28.0,1993.0,12.0,0,0,0,0,0,0,0,,0,0,0,0,1,1,1,1,GK,25-29,Goalkeeper,Sweden,Europe
1521,Victor Lindelöf,SWE,Manchester Utd,Premier League,2021,27.0,1994.0,26.2,16,11,9,7,0,9,14,64.3,5,26,17,9,25,41,96,0,DF,25-29,Defender,Sweden,Europe
1522,Jesper Lindstrøm,DEN,Eint Frankfurt,Bundesliga,2021,21.0,2000.0,22.0,28,13,6,13,9,12,36,33.3,24,30,0,30,24,52,11,1,"MF,FW",20-24,Midfielder,Denmark,Europe
1524,Jesse Lingard,ENG,Manchester Utd,Premier League,2021,28.0,1992.0,4.1,9,7,4,3,2,2,6,33.3,4,4,0,4,0,9,1,0,"FW,MF",25-29,Forward,England,Europe
1527,Dejan Ljubicic,AUT,Köln,Bundesliga,2021,23.0,1997.0,21.9,33,19,12,13,8,13,49,26.5,36,19,1,18,15,48,11,0,"MF,FW",20-24,Midfielder,Austria,Europe
1531,Hugo Lloris,FRA,Tottenham,Premier League,2021,34.0,1986.0,38.0,1,1,1,0,0,1,2,50.0,1,0,0,0,1,2,24,3,GK,30-34,Goalkeeper,France,Europe
1532,Giovani Lo Celso,ARG,Tottenham,Premier League,2021,25.0,1996.0,2.6,8,4,4,2,2,4,10,40.0,6,6,1,5,1,9,0,1,"MF,FW",25-29,Midfielder,Argentina,South America
1533,Giovani Lo Celso,ARG,Villarreal,La Liga,2021,25.0,1996.0,11.0,22,12,8,10,4,9,22,40.9,13,4,0,4,5,27,3,0,"FW,MF",25-29,Forward,Argentina,South America
1535,Stanislav Lobotka,SVK,Napoli,Serie A,2021,26.0,1994.0,18.7,39,24,16,20,3,14,36,38.9,22,9,1,8,12,51,13,1,MF,25-29,Midfielder,Slovakia,Europe
1536,Jürgen Locadia,CUW,Brighton,Premier League,2021,27.0,1993.0,0.3,0,0,0,0,0,0,0,,0,0,0,0,0,0,0,0,"MF,FW",25-29,Midfielder,Curaçao,Europe
1537,Jürgen Locadia,CUW,Bochum,Bundesliga,2021,27.0,1993.0,4.9,4,2,1,0,3,1,1,100.0,0,1,0,1,1,5,2,0,"FW,MF",25-29,Forward,Curaçao,Europe
1538,Manuel Locatelli,ITA,Juventus,Serie A,2021,23.0,1998.0,24.0,44,25,21,16,7,21,47,44.7,26,43,21,22,22,66,33,0,MF,20-24,Midfielder,Italy,Europe
1539,Bradley Locko,FRA,Reims,Ligue 1,2021,19.0,2002.0,11.2,28,19,13,11,4,14,24,58.3,10,20,8,12,14,42,15,0,"MF,DF",Under 20,Midfielder,France,Europe
1540,Renan Lodi,BRA,Atlético Madrid,La Liga,2021,23.0,1998.0,13.1,31,18,14,13,4,11,27,40.7,16,22,4,18,13,44,19,1,DF,20-24,Defender,Brazil,South America
1541,Ruben Loftus-Cheek,ENG,Chelsea,Premier League,2021,25.0,1996.0,15.5,29,10,16,11,2,10,19,52.6,9,15,6,9,11,40,17,0,"MF,DF",25-29,Midfielder,England,Europe
1542,Kevin Long,IRL,Burnley,Premier League,2021,30.0,1990.0,4.6,3,2,1,2,0,1,2,50.0,1,4,1,3,1,4,20,0,DF,30-34,Defender,Republic of Ireland,Europe
1543,Shane Long,IRL,Southampton,Premier League,2021,34.0,1987.0,3.4,9,5,2,4,3,1,1,100.0,0,4,0,4,0,9,2,0,FW,30-34,Forward,Republic of Ireland,Europe
1544,Sean Longstaff,ENG,Newcastle Utd,Premier League,2021,23.0,1997.0,16.3,54,34,18,31,5,24,65,36.9,41,18,6,12,9,63,18,0,MF,20-24,Midfielder,England,Europe
1545,Ademola Lookman,NGA,Leicester City,Premier League,2021,23.0,1997.0,16.1,32,14,10,13,9,10,28,35.7,18,19,1,18,10,42,4,0,"FW,MF",20-24,Forward,Nigeria,Africa
1546,Anthony Lopes,POR,Lyon,Ligue 1,2021,30.0,1990.0,33.1,0,0,0,0,0,0,0,,0,0,0,0,3,3,12,3,GK,30-34,Goalkeeper,Portugal,Europe
1553,Dion Lopy,SEN,Reims,Ligue 1,2021,19.0,2002.0,18.2,53,29,22,24,7,21,53,39.6,32,20,4,16,22,75,17,0,MF,Under 20,Midfielder,Senegal,Africa
1554,Samuel Loric,FRA,Lorient,Ligue 1,2021,21.0,2000.0,3.0,7,5,2,3,2,5,8,62.5,3,2,0,2,5,12,9,0,DF,20-24,Defender,France,Europe
1555,Anthony Losilla,FRA,Bochum,Bundesliga,2021,35.0,1986.0,32.6,65,39,29,30,6,34,69,49.3,35,32,9,23,70,135,53,1,MF,35-39,Midfielder,France,Europe
1562,Matteo Lovato,ITA,Atalanta,Serie A,2021,21.0,2000.0,3.4,5,4,4,1,0,0,1,0.0,1,4,2,2,7,12,8,0,DF,20-24,Defender,Italy,Europe
1563,Matteo Lovato,ITA,Cagliari,Serie A,2021,21.0,2000.0,13.8,23,15,13,10,0,8,20,40.0,12,21,10,11,28,51,43,0,DF,20-24,Defender,Italy,Europe
1564,Eduard Löwen,GER,Bochum,Bundesliga,2021,24.0,1997.0,15.7,28,22,12,11,5,10,43,23.3,33,17,2,15,9,37,15,1,MF,20-24,Midfielder,Germany,Europe
1565,Matthew Lowton,ENG,Burnley,Premier League,2021,32.0,1989.0,19.7,38,24,20,10,8,20,37,54.1,17,25,11,14,26,64,68,0,DF,30-34,Defender,England,Europe
1567,Hirving Lozano,MEX,Napoli,Serie A,2021,26.0,1995.0,17.9,28,20,12,11,5,8,30,26.7,22,24,0,24,9,37,9,0,FW,25-29,Forward,Mexico,North America
1568,Jean Lucas,BRA,Monaco,Ligue 1,2021,23.0,1998.0,16.1,43,25,14,24,5,17,40,42.5,23,15,5,10,13,56,4,1,MF,20-24,Midfielder,Brazil,South America
1569,Anderson Lucoqui,ANG,Mainz 05,Bundesliga,2021,24.0,1997.0,8.3,22,10,11,6,5,11,22,50.0,11,15,3,12,11,33,10,0,DF,20-24,Defender,Angola,Africa
1573,José Luis Palomino,ARG,Atalanta,Serie A,2021,31.0,1990.0,29.7,78,40,42,33,3,32,50,64.0,18,43,21,22,100,178,80,2,DF,30-34,Defender,Argentina,South America
1575,Douglas Luiz,BRA,Aston Villa,Premier League,2021,23.0,1998.0,30.2,59,39,30,24,5,21,72,29.2,51,30,7,23,34,93,28,1,MF,20-24,Midfielder,Brazil,South America
1576,Romelu Lukaku,BEL,Chelsea,Premier League,2021,28.0,1993.0,17.7,2,1,0,1,1,1,5,20.0,4,11,1,10,0,2,20,0,FW,25-29,Forward,Belgium,Europe
1577,Castello Lukeba,FRA,Lyon,Ligue 1,2021,18.0,2002.0,23.3,34,19,27,7,0,15,23,65.2,8,18,9,9,38,72,64,2,DF,Under 20,Defender,France,Europe
1581,Levi Lumeka,ENG,Troyes,Ligue 1,2021,22.0,1998.0,0.7,0,0,0,0,0,0,2,0.0,2,0,0,0,0,0,2,0,"DF,FW",20-24,Defender,England,Europe
1582,Andriy Lunin,UKR,Real Madrid,La Liga,2021,22.0,1999.0,2.0,0,0,0,0,0,0,0,,0,0,0,0,0,0,2,0,GK,20-24,Goalkeeper,Ukraine,Europe
1584,Sebastiano Luperto,ITA,Empoli,Serie A,2021,24.0,1996.0,21.8,29,17,17,10,2,10,20,50.0,10,32,26,6,45,74,132,0,DF,20-24,Defender,Italy,Europe
1585,Andreas Luthe,GER,Union Berlin,Bundesliga,2021,34.0,1987.0,27.0,0,0,0,0,0,0,1,0.0,1,0,0,0,0,0,11,4,GK,30-34,Goalkeeper,Germany,Europe
1586,Lyanco,BRA,Southampton,Premier League,2021,24.0,1997.0,10.1,18,15,11,7,0,10,18,55.6,8,18,13,5,13,31,50,1,DF,20-24,Defender,Brazil,South America
1589,Alexis Mac Allister,ARG,Brighton,Premier League,2021,22.0,1998.0,23.6,65,40,23,30,12,29,68,42.6,39,37,7,30,13,78,22,0,"MF,FW",20-24,Midfielder,Argentina,South America
1590,Deiver Machado,COL,Lens,Ligue 1,2021,27.0,1993.0,5.8,16,14,11,1,4,12,14,85.7,2,9,1,8,3,19,12,1,"DF,MF",25-29,Defender,Colombia,South America
1591,Darwin Machís,VEN,Granada,La Liga,2021,28.0,1993.0,15.3,23,13,11,8,4,9,23,39.1,14,10,0,10,15,38,17,0,"MF,FW",25-29,Midfielder,Venezuela,South America
1593,James Maddison,ENG,Leicester City,Premier League,2021,24.0,1996.0,27.3,40,20,8,24,8,14,46,30.4,32,18,3,15,11,51,12,0,"MF,FW",20-24,Midfielder,England,Europe
1596,Louis Mafouta,CTA,Metz,Ligue 1,2021,27.0,1994.0,5.8,0,0,0,0,0,0,5,0.0,5,1,0,1,0,0,4,0,FW,25-29,Forward,Central African Republic,Africa
1597,Gabriel Magalhães,BRA,Arsenal,Premier League,2021,23.0,1997.0,34.0,50,30,36,12,2,30,41,73.2,11,34,26,8,13,63,112,4,DF,20-24,Defender,Brazil,South America
1598,Giulio Maggiore,ITA,Spezia,Serie A,2021,23.0,1998.0,31.3,58,32,20,32,6,31,77,40.3,46,30,5,25,29,87,33,0,MF,20-24,Midfielder,Italy,Europe
1599,Matej Maglica,CRO,Stuttgart,Bundesliga,2021,22.0,1998.0,0.1,0,0,0,0,0,0,1,0.0,1,0,0,0,0,0,0,0,MF,20-24,Midfielder,Croatia,Europe
1600,Francesco Magnanelli,ITA,Sassuolo,Serie A,2021,36.0,1984.0,3.0,5,4,4,1,0,1,9,11.1,8,3,1,2,1,6,3,0,MF,35-39,Midfielder,Italy,Europe
1601,Giangiacomo Magnani,ITA,Hellas Verona,Serie A,2021,25.0,1995.0,5.9,10,7,5,5,0,8,16,50.0,8,5,3,2,10,20,46,0,DF,25-29,Defender,Italy,Europe
1602,Giangiacomo Magnani,ITA,Sampdoria,Serie A,2021,25.0,1995.0,2.7,4,2,4,0,0,1,1,100.0,0,2,2,0,7,11,12,0,DF,25-29,Defender,Italy,Europe
1603,Hugo Magnetti,FRA,Brest,Ligue 1,2021,23.0,1998.0,16.3,50,34,27,20,3,22,50,44.0,28,14,3,11,25,75,13,0,MF,20-24,Midfielder,France,Europe
1604,Yohann Magnin,FRA,Clermont Foot,Ligue 1,2021,24.0,1997.0,19.1,53,31,22,26,5,24,42,57.1,18,17,7,10,20,73,36,0,"MF,DF",20-24,Midfielder,France,Europe
1605,Harry Maguire,ENG,Manchester Utd,Premier League,2021,28.0,1993.0,27.9,34,21,22,8,4,19,31,61.3,12,36,29,7,32,66,101,3,DF,25-29,Defender,England,Europe
1606,Riyad Mahrez,ALG,Manchester City,Premier League,2021,30.0,1991.0,16.6,11,3,5,4,2,5,19,26.3,14,15,1,14,6,17,6,0,FW,30-34,Forward,Algeria,Africa
1607,Arne Maier,GER,Augsburg,Bundesliga,2021,22.0,1999.0,20.7,20,13,6,10,4,8,26,30.8,18,18,1,17,15,35,13,0,MF,20-24,Midfielder,Germany,Europe
1608,Habib Maïga,CIV,Metz,Ligue 1,2021,25.0,1996.0,14.1,47,28,29,13,5,24,48,50.0,24,20,7,13,14,61,18,0,MF,25-29,Midfielder,Ivory Coast,Africa
1609,Mike Maignan,FRA,Milan,Serie A,2021,26.0,1995.0,32.0,2,1,2,0,0,2,2,100.0,0,0,0,0,1,3,4,2,GK,25-29,Goalkeeper,France,Europe
1610,Ainsley Maitland-Niles,ENG,Arsenal,Premier League,2021,23.0,1997.0,3.0,8,4,5,3,0,2,4,50.0,2,2,0,2,4,12,4,0,MF,20-24,Midfielder,England,Europe
1611,Ainsley Maitland-Niles,ENG,Roma,Serie A,2021,23.0,1997.0,5.4,8,6,5,0,3,5,14,35.7,9,7,0,7,6,14,7,0,DF,20-24,Defender,England,Europe
1612,Josh Maja,NGA,Bordeaux,Ligue 1,2021,22.0,1998.0,0.1,0,0,0,0,0,0,0,,0,1,0,1,0,0,0,0,FW,20-24,Forward,Nigeria,Africa
1614,Lovro Majer,CRO,Rennes,Ligue 1,2021,23.0,1998.0,20.4,32,21,9,14,9,11,42,26.2,31,26,2,24,11,43,9,0,"MF,FW",20-24,Midfielder,Croatia,Europe
1615,Jean-Victor Makengo,FRA,Udinese,Serie A,2021,23.0,1998.0,26.1,30,21,7,17,6,15,29,51.7,14,26,6,20,19,49,17,0,MF,20-24,Midfielder,France,Europe
1620,Daniel Maldini,ITA,Milan,Serie A,2021,19.0,2001.0,1.6,8,3,4,3,1,2,6,33.3,4,4,0,4,1,9,0,0,MF,Under 20,Midfielder,Italy,Europe
1621,Youssef Maleh,MAR,Fiorentina,Serie A,2021,22.0,1998.0,11.3,27,16,8,13,6,12,25,48.0,13,14,1,13,6,33,2,0,MF,20-24,Midfielder,Morocco,Africa
1622,Donyell Malen,NED,Dortmund,Bundesliga,2021,22.0,1999.0,18.7,13,10,4,5,4,7,13,53.8,6,10,0,10,10,23,11,0,FW,20-24,Forward,Netherlands,Europe
1623,Ruslan Malinovskyi,UKR,Atalanta,Serie A,2021,28.0,1993.0,17.7,18,10,3,10,5,5,19,26.3,14,27,3,24,5,23,1,0,"MF,FW",25-29,Midfielder,Ukraine,Europe
1625,Lennard Maloney,USA,Dortmund,Bundesliga,2021,21.0,1999.0,0.1,1,0,1,0,0,1,1,100.0,0,0,0,0,0,1,0,0,DF,20-24,Defender,United States,North America
1627,Giorgi Mamardashvili,GEO,Valencia,La Liga,2021,20.0,2000.0,18.0,0,0,0,0,0,0,0,,0,0,0,0,0,0,6,1,GK,20-24,Goalkeeper,Georgia,Asia
1630,Vincent Manceau,FRA,Angers,Ligue 1,2021,32.0,1989.0,26.2,32,19,18,13,1,14,37,37.8,23,23,6,17,32,64,72,0,DF,30-34,Defender,France,Europe
1631,Gianluca Mancini,ITA,Roma,Serie A,2021,25.0,1996.0,32.0,41,25,22,18,1,18,33,54.5,15,38,19,19,39,80,69,0,DF,25-29,Defender,Italy,Europe
1632,Leonardo Mancuso,ITA,Empoli,Serie A,2021,29.0,1992.0,4.7,1,1,0,1,0,0,6,0.0,6,2,0,2,1,2,2,0,FW,25-29,Forward,Italy,Europe
1633,Steve Mandanda,FRA,Marseille,Ligue 1,2021,36.0,1985.0,9.0,0,0,0,0,0,0,1,0.0,1,1,0,1,1,1,4,1,GK,35-39,Goalkeeper,France,Europe
1634,Reinildo Mandava,MOZ,Atlético Madrid,La Liga,2021,27.0,1994.0,14.4,45,25,30,14,1,22,30,73.3,8,18,9,9,21,66,38,0,DF,25-29,Defender,Mozambique,Africa
1635,Reinildo Mandava,MOZ,Lille,Ligue 1,2021,27.0,1994.0,16.9,43,23,29,11,3,32,51,62.7,19,13,4,9,37,80,55,0,DF,25-29,Defender,Mozambique,Africa
1636,Aïssa Mandi,ALG,Villarreal,La Liga,2021,29.0,1991.0,15.3,11,5,2,8,1,3,6,50.0,3,17,14,3,13,24,49,3,DF,25-29,Defender,Algeria,Africa
1637,Rolando Mandragora,ITA,Torino,Serie A,2021,24.0,1997.0,14.7,21,10,3,16,2,12,21,57.1,9,18,4,14,10,31,13,0,MF,20-24,Midfielder,Italy,Europe
1639,Sadio Mané,SEN,Liverpool,Premier League,2021,29.0,1992.0,31.3,33,20,7,14,12,8,26,30.8,18,30,1,29,8,41,15,0,FW,25-29,Forward,Senegal,Africa
1641,Orel Mangala,BEL,Stuttgart,Bundesliga,2021,23.0,1998.0,20.6,17,10,5,7,5,11,22,50.0,11,11,4,7,12,29,19,1,MF,20-24,Midfielder,Belgium,Europe
1642,Thomas Mangani,FRA,Angers,Ligue 1,2021,34.0,1987.0,24.4,58,30,23,34,1,31,68,45.6,37,38,11,27,36,94,29,0,MF,30-34,Midfielder,France,Europe
1651,Marcelo,BRA,Real Madrid,La Liga,2021,33.0,1988.0,5.8,8,4,2,3,3,5,10,50.0,5,7,2,5,1,9,11,0,DF,30-34,Defender,Brazil,South America
1651,Marcelo,BRA,Real Madrid,La Liga,2021,33.0,1988.0,5.8,8,4,2,3,3,5,10,50.0,5,7,2,5,1,9,11,0,DF,30-34,Defender,Brazil,South America
1651,Marcelo,BRA,Real Madrid,La Liga,2021,33.0,1988.0,5.8,8,4,2,3,3,5,10,50.0,5,7,2,5,1,9,11,0,DF,30-34,Defender,Brazil,South America
1651,Marcelo,BRA,Real Madrid,La Liga,2021,33.0,1988.0,5.8,8,4,2,3,3,5,10,50.0,5,7,2,5,1,9,11,0,DF,30-34,Defender,Brazil,South America
1651,Marcelo,BRA,Real Madrid,La Liga,2021,33.0,1988.0,5.8,8,4,2,3,3,5,10,50.0,5,7,2,5,1,9,11,0,DF,30-34,Defender,Brazil,South America
1651,Marcelo,BRA,Real Madrid,La Liga,2021,33.0,1988.0,5.8,8,4,2,3,3,5,10,50.0,5,7,2,5,1,9,11,0,DF,30-34,Defender,Brazil,South America
1651,Marcelo,BRA,Real Madrid,La Liga,2021,33.0,1988.0,5.8,8,4,2,3,3,5,10,50.0,5,7,2,5,1,9,11,0,DF,30-34,Defender,Brazil,South America
1651,Marcelo,BRA,Real Madrid,La Liga,2021,33.0,1988.0,5.8,8,4,2,3,3,5,10,50.0,5,7,2,5,1,9,11,0,DF,30-34,Defender,Brazil,South America
1651,Marcelo,BRA,Real Madrid,La Liga,2021,33.0,1988.0,5.8,8,4,2,3,3,5,10,50.0,5,7,2,5,1,9,11,0,DF,30-34,Defender,Brazil,South America
1652,Marcelo,BRA,Bordeaux,Ligue 1,2021,34.0,1987.0,10.0,9,5,7,2,0,4,6,66.7,2,4,3,1,13,22,46,1,DF,30-34,Defender,Brazil,South America
1652,Marcelo,BRA,Bordeaux,Ligue 1,2021,34.0,1987.0,10.0,9,5,7,2,0,4,6,66.7,2,4,3,1,13,22,46,1,DF,30-34,Defender,Brazil,South America
1652,Marcelo,BRA,Bordeaux,Ligue 1,2021,34.0,1987.0,10.0,9,5,7,2,0,4,6,66.7,2,4,3,1,13,22,46,1,DF,30-34,Defender,Brazil,South America
1652,Marcelo,BRA,Bordeaux,Ligue 1,2021,34.0,1987.0,10.0,9,5,7,2,0,4,6,66.7,2,4,3,1,13,22,46,1,DF,30-34,Defender,Brazil,South America
1652,Marcelo,BRA,Bordeaux,Ligue 1,2021,34.0,1987.0,10.0,9,5,7,2,0,4,6,66.7,2,4,3,1,13,22,46,1,DF,30-34,Defender,Brazil,South America
1652,Marcelo,BRA,Bordeaux,Ligue 1,2021,34.0,1987.0,10.0,9,5,7,2,0,4,6,66.7,2,4,3,1,13,22,46,1,DF,30-34,Defender,Brazil,South America
1652,Marcelo,BRA,Bordeaux,Ligue 1,2021,34.0,1987.0,10.0,9,5,7,2,0,4,6,66.7,2,4,3,1,13,22,46,1,DF,30-34,Defender,Brazil,South America
1652,Marcelo,BRA,Bordeaux,Ligue 1,2021,34.0,1987.0,10.0,9,5,7,2,0,4,6,66.7,2,4,3,1,13,22,46,1,DF,30-34,Defender,Brazil,South America
1652,Marcelo,BRA,Bordeaux,Ligue 1,2021,34.0,1987.0,10.0,9,5,7,2,0,4,6,66.7,2,4,3,1,13,22,46,1,DF,30-34,Defender,Brazil,South America
1653,Marcelo,BRA,Lyon,Ligue 1,2021,34.0,1987.0,2.0,4,3,0,4,0,4,6,66.7,2,3,2,1,4,8,10,0,DF,30-34,Defender,Brazil,South America
1653,Marcelo,BRA,Lyon,Ligue 1,2021,34.0,1987.0,2.0,4,3,0,4,0,4,6,66.7,2,3,2,1,4,8,10,0,DF,30-34,Defender,Brazil,South America
1653,Marcelo,BRA,Lyon,Ligue 1,2021,34.0,1987.0,2.0,4,3,0,4,0,4,6,66.7,2,3,2,1,4,8,10,0,DF,30-34,Defender,Brazil,South America
1653,Marcelo,BRA,Lyon,Ligue 1,2021,34.0,1987.0,2.0,4,3,0,4,0,4,6,66.7,2,3,2,1,4,8,10,0,DF,30-34,Defender,Brazil,South America
1653,Marcelo,BRA,Lyon,Ligue 1,2021,34.0,1987.0,2.0,4,3,0,4,0,4,6,66.7,2,3,2,1,4,8,10,0,DF,30-34,Defender,Brazil,South America
1653,Marcelo,BRA,Lyon,Ligue 1,2021,34.0,1987.0,2.0,4,3,0,4,0,4,6,66.7,2,3,2,1,4,8,10,0,DF,30-34,Defender,Brazil,South America
1653,Marcelo,BRA,Lyon,Ligue 1,2021,34.0,1987.0,2.0,4,3,0,4,0,4,6,66.7,2,3,2,1,4,8,10,0,DF,30-34,Defender,Brazil,South America
1653,Marcelo,BRA,Lyon,Ligue 1,2021,34.0,1987.0,2.0,4,3,0,4,0,4,6,66.7,2,3,2,1,4,8,10,0,DF,30-34,Defender,Brazil,South America
1653,Marcelo,BRA,Lyon,Ligue 1,2021,34.0,1987.0,2.0,4,3,0,4,0,4,6,66.7,2,3,2,1,4,8,10,0,DF,30-34,Defender,Brazil,South America
1654,Solly March,ENG,Brighton,Premier League,2021,27.0,1994.0,19.4,30,17,11,9,10,7,22,31.8,15,22,3,19,17,47,25,0,"DF,FW",25-29,Defender,England,Europe
1655,Riccardo Marchizza,ITA,Empoli,Serie A,2021,23.0,1998.0,15.0,21,15,11,8,2,11,16,68.8,5,15,6,9,10,31,24,0,DF,20-24,Defender,Italy,Europe
1656,Gian Marco Ferrari,ITA,Sassuolo,Serie A,2021,29.0,1992.0,34.7,16,11,10,6,0,10,23,43.5,13,37,27,10,43,59,114,2,DF,25-29,Defender,Italy,Europe
1657,Iván Marcone,ARG,Elche,La Liga,2021,31.0,1990.0,9.0,24,14,17,6,1,12,24,50.0,12,8,3,5,12,36,13,0,MF,30-34,Midfielder,Argentina,South America
1659,Davide Marfella,ITA,Napoli,Serie A,2021,21.0,1999.0,0.1,0,0,0,0,0,0,0,,0,0,0,0,0,0,0,0,GK,20-24,Goalkeeper,Italy,Europe
1663,José María Giménez,URU,Atlético Madrid,La Liga,2021,26.0,1995.0,22.7,18,12,12,6,0,8,16,50.0,8,25,19,6,25,43,96,1,DF,25-29,Defender,Uruguay,South America
1665,Răzvan Marin,ROU,Cagliari,Serie A,2021,25.0,1996.0,31.3,42,21,16,22,4,24,54,44.4,30,23,5,18,10,52,17,1,MF,25-29,Midfielder,Romania,Europe
1666,Guillermo Maripán,CHI,Monaco,Ligue 1,2021,27.0,1994.0,20.4,36,24,27,9,0,20,40,50.0,20,21,14,7,25,61,66,1,DF,25-29,Defender,Chile,South America
1668,Omar Marmoush,EGY,Wolfsburg,Bundesliga,2021,22.0,1999.0,0.3,0,0,0,0,0,0,0,,0,0,0,0,0,0,0,0,FW,20-24,Forward,Egypt,Africa
1669,Omar Marmoush,EGY,Stuttgart,Bundesliga,2021,22.0,1999.0,17.5,26,17,6,14,6,4,20,20.0,16,9,1,8,7,33,6,0,FW,20-24,Forward,Egypt,Africa
1670,Marquinhos,BRA,Paris S-G,Ligue 1,2021,27.0,1994.0,31.8,37,14,25,11,1,20,35,57.1,15,35,19,16,16,53,102,0,DF,25-29,Defender,Brazil,South America
1670,Marquinhos,BRA,Paris S-G,Ligue 1,2021,27.0,1994.0,31.8,37,14,25,11,1,20,35,57.1,15,35,19,16,16,53,102,0,DF,25-29,Defender,Brazil,South America
1670,Marquinhos,BRA,Paris S-G,Ligue 1,2021,27.0,1994.0,31.8,37,14,25,11,1,20,35,57.1,15,35,19,16,16,53,102,0,DF,25-29,Defender,Brazil,South America
1670,Marquinhos,BRA,Paris S-G,Ligue 1,2021,27.0,1994.0,31.8,37,14,25,11,1,20,35,57.1,15,35,19,16,16,53,102,0,DF,25-29,Defender,Brazil,South America
1670,Marquinhos,BRA,Paris S-G,Ligue 1,2021,27.0,1994.0,31.8,37,14,25,11,1,20,35,57.1,15,35,19,16,16,53,102,0,DF,25-29,Defender,Brazil,South America
1670,Marquinhos,BRA,Paris S-G,Ligue 1,2021,27.0,1994.0,31.8,37,14,25,11,1,20,35,57.1,15,35,19,16,16,53,102,0,DF,25-29,Defender,Brazil,South America
1670,Marquinhos,BRA,Paris S-G,Ligue 1,2021,27.0,1994.0,31.8,37,14,25,11,1,20,35,57.1,15,35,19,16,16,53,102,0,DF,25-29,Defender,Brazil,South America
1670,Marquinhos,BRA,Paris S-G,Ligue 1,2021,27.0,1994.0,31.8,37,14,25,11,1,20,35,57.1,15,35,19,16,16,53,102,0,DF,25-29,Defender,Brazil,South America
1670,Marquinhos,BRA,Paris S-G,Ligue 1,2021,27.0,1994.0,31.8,37,14,25,11,1,20,35,57.1,15,35,19,16,16,53,102,0,DF,25-29,Defender,Brazil,South America
1680,Jonas Martin,FRA,Rennes,Ligue 1,2021,31.0,1990.0,23.4,35,20,12,21,2,19,53,35.8,34,17,3,14,22,57,28,1,MF,30-34,Midfielder,France,Europe
1681,Gabriel Martinelli,BRA,Arsenal,Premier League,2021,20.0,2001.0,20.7,27,19,7,14,6,10,29,34.5,19,26,1,25,20,47,15,0,"FW,MF",20-24,Forward,Brazil,South America
1682,Emiliano Martínez,ARG,Aston Villa,Premier League,2021,28.0,1992.0,36.0,1,1,1,0,0,1,3,33.3,2,0,0,0,0,1,6,1,GK,25-29,Goalkeeper,Argentina,South America
1682,Emiliano Martínez,ARG,Aston Villa,Premier League,2021,28.0,1992.0,36.0,1,1,1,0,0,1,3,33.3,2,0,0,0,0,1,6,1,GK,25-29,Goalkeeper,Argentina,South America
1682,Emiliano Martínez,ARG,Aston Villa,Premier League,2021,28.0,1992.0,36.0,1,1,1,0,0,1,3,33.3,2,0,0,0,0,1,6,1,GK,25-29,Goalkeeper,Argentina,South America
1682,Emiliano Martínez,ARG,Aston Villa,Premier League,2021,28.0,1992.0,36.0,1,1,1,0,0,1,3,33.3,2,0,0,0,0,1,6,1,GK,25-29,Goalkeeper,Argentina,South America
1686,Lautaro Martínez,ARG,Inter,Serie A,2021,23.0,1997.0,25.4,20,10,3,10,7,6,11,54.5,5,21,1,20,18,38,6,0,FW,20-24,Forward,Argentina,South America
1688,Lucas Martínez Quarta,ARG,Fiorentina,Serie A,2021,25.0,1996.0,15.9,36,25,23,11,2,21,34,61.8,13,22,9,13,19,55,46,0,DF,25-29,Defender,Argentina,South America
1691,Omar Mascarell,EQG,Elche,La Liga,2021,28.0,1993.0,27.7,46,26,16,23,7,24,60,40.0,36,42,14,28,48,94,52,2,MF,25-29,Midfielder,Equatorial Guinea,Africa
1692,Andrea Masiello,ITA,Genoa,Serie A,2021,35.0,1986.0,5.7,5,3,4,1,0,4,7,57.1,3,8,4,4,11,16,20,1,DF,35-39,Defender,Italy,Europe
1693,Adam Masina,MAR,Watford,Premier League,2021,27.0,1994.0,12.0,24,13,11,10,3,12,29,41.4,17,18,6,12,18,42,45,0,DF,25-29,Defender,Morocco,Africa
1695,Roberto Massimo,GER,Stuttgart,Bundesliga,2021,20.0,2000.0,9.7,14,5,6,7,1,4,16,25.0,12,9,0,9,3,17,6,0,"DF,FW",20-24,Defender,Germany,Europe
1699,Pape Matar Sarr,SEN,Metz,Ligue 1,2021,18.0,2002.0,23.7,45,26,21,23,1,18,39,46.2,21,33,3,30,29,74,22,0,MF,Under 20,Midfielder,Senegal,Africa
1700,Eliot Matazo,BEL,Monaco,Ligue 1,2021,19.0,2002.0,8.8,8,7,4,4,0,2,11,18.2,9,11,3,8,13,21,9,0,MF,Under 20,Midfielder,Belgium,Europe
1702,Jean-Philippe Mateta,FRA,Crystal Palace,Premier League,2021,24.0,1997.0,12.7,8,4,2,5,1,3,18,16.7,15,11,3,8,4,12,13,0,FW,20-24,Forward,France,Europe
1705,Chrislain Matsima,FRA,Monaco,Ligue 1,2021,19.0,2002.0,1.5,3,2,1,2,0,2,7,28.6,5,3,3,0,1,4,6,1,DF,Under 20,Defender,France,Europe
1706,Azor Matusiwa,NED,Reims,Ligue 1,2021,23.0,1998.0,27.4,58,32,28,26,4,26,55,47.3,29,49,19,30,62,120,43,0,MF,20-24,Midfielder,Netherlands,Europe
1707,Neal Maupay,FRA,Brighton,Premier League,2021,24.0,1996.0,25.3,17,10,2,6,9,4,18,22.2,14,21,2,19,2,19,2,0,FW,20-24,Forward,France,Europe
1708,Stephy Mavididi,ENG,Montpellier,Ligue 1,2021,23.0,1998.0,25.5,24,13,11,7,6,14,39,35.9,25,23,2,21,8,32,11,0,"FW,MF",20-24,Forward,England,Europe
1709,Konstantinos Mavropanos,GRE,Stuttgart,Bundesliga,2021,23.0,1997.0,30.1,57,39,35,21,1,30,51,58.8,21,46,23,23,69,126,174,2,DF,20-24,Defender,Greece,Europe
1711,Luís Maximiano,POR,Granada,La Liga,2021,22.0,1999.0,34.8,3,1,3,0,0,3,6,50.0,3,0,0,0,1,4,16,2,GK,20-24,Goalkeeper,Portugal,Europe
1715,Pasquale Mazzocchi,ITA,Venezia,Serie A,2021,26.0,1995.0,13.8,18,8,11,4,3,10,26,38.5,16,11,8,3,21,39,31,1,DF,25-29,Defender,Italy,Europe
1716,Pasquale Mazzocchi,ITA,Salernitana,Serie A,2021,26.0,1995.0,14.1,28,19,15,11,2,14,34,41.2,20,5,0,5,11,39,31,0,DF,25-29,Defender,Italy,Europe
1718,Kylian Mbappé,FRA,Paris S-G,Ligue 1,2021,22.0,1998.0,33.6,11,8,1,4,6,7,13,53.8,6,6,0,6,5,16,13,0,FW,20-24,Forward,France,Europe
1719,Ibrahima Mbaye,SEN,Bologna,Serie A,2021,26.0,1994.0,1.2,1,1,1,0,0,1,2,50.0,1,1,1,0,1,2,6,0,DF,25-29,Defender,Senegal,Africa
1721,Bryan Mbeumo,CMR,Brentford,Premier League,2021,21.0,1999.0,32.3,28,16,1,12,15,6,20,30.0,14,21,6,15,11,39,20,0,FW,20-24,Forward,Cameroon,Africa
1722,Jason Mbock,FRA,Angers,Ligue 1,2021,21.0,1999.0,0.2,0,0,0,0,0,0,0,,0,0,0,0,0,0,0,0,FW,20-24,Forward,France,Europe
1726,James McArthur,SCO,Crystal Palace,Premier League,2021,33.0,1987.0,16.0,33,23,13,19,1,16,44,36.4,28,23,9,14,30,63,27,0,MF,30-34,Midfielder,Scotland,Europe
1728,Kasey McAteer,IRL,Leicester City,Premier League,2021,19.0,2001.0,0.0,0,0,0,0,0,0,0,,0,0,0,0,0,0,0,0,FW,Under 20,Forward,Republic of Ireland,Europe
1729,Liam McCarron,SCO,Leeds United,Premier League,2021,20.0,2001.0,0.1,0,0,0,0,0,0,0,,0,1,0,1,0,0,0,0,FW,20-24,Forward,Scotland,Europe
1730,Alex McCarthy,ENG,Southampton,Premier League,2021,31.0,1989.0,17.0,0,0,0,0,0,0,0,,0,0,0,0,0,0,4,0,GK,30-34,Goalkeeper,England,Europe
1731,John McGinn,SCO,Aston Villa,Premier League,2021,26.0,1994.0,34.3,106,64,35,55,16,54,104,51.9,50,53,6,47,35,141,34,0,MF,25-29,Midfielder,Scotland,Europe
1732,Weston McKennie,USA,Juventus,Serie A,2021,22.0,1998.0,15.2,20,11,11,7,2,8,26,30.8,18,17,8,9,23,43,20,0,MF,20-24,Midfielder,United States,North America
1734,Kenny McLean,SCO,Norwich City,Premier League,2021,29.0,1992.0,30.1,42,22,18,20,4,17,59,28.8,42,29,7,22,34,76,54,0,MF,25-29,Midfielder,Scotland,Europe
1735,Dwight McNeil,ENG,Burnley,Premier League,2021,21.0,1999.0,34.5,78,49,27,38,13,33,73,45.2,40,64,11,53,35,113,31,1,MF,20-24,Midfielder,England,Europe
1736,Scott McTominay,SCO,Manchester Utd,Premier League,2021,24.0,1996.0,26.5,65,33,32,24,9,30,61,49.2,31,45,10,35,31,96,60,1,MF,20-24,Midfielder,Scotland,Europe
1737,Gary Medel,CHI,Bologna,Serie A,2021,33.0,1987.0,31.4,39,23,27,11,1,16,36,44.4,20,30,21,9,44,83,112,0,DF,30-34,Defender,Chile,South America
1738,Facundo Medina,ARG,Lens,Ligue 1,2021,22.0,1999.0,28.8,61,42,34,23,4,38,62,61.3,24,24,8,16,37,98,78,3,DF,20-24,Defender,Argentina,South America
1739,Nathan de Medina,BEL,Arminia,Bundesliga,2021,23.0,1997.0,8.6,17,10,11,6,0,6,10,60.0,4,14,3,11,10,27,28,0,DF,20-24,Defender,Belgium,Europe
1740,Ben Mee,ENG,Burnley,Premier League,2021,31.0,1989.0,20.4,26,12,16,7,3,12,19,63.2,7,28,22,6,24,50,94,1,DF,30-34,Defender,England,Europe
1743,Farid El Melali,ALG,Angers,Ligue 1,2021,24.0,1997.0,0.2,0,0,0,0,0,0,1,0.0,1,1,0,1,0,0,1,0,FW,20-24,Forward,Algeria,Africa
1744,Filippo Melegoni,ITA,Genoa,Serie A,2021,22.0,1999.0,10.9,20,12,5,8,7,8,16,50.0,8,10,1,9,11,31,8,1,"MF,FW",20-24,Midfielder,Italy,Europe
1748,Arthur Melo,BRA,Juventus,Serie A,2021,24.0,1996.0,10.7,25,12,10,14,1,13,24,54.2,11,11,2,9,7,32,8,1,MF,20-24,Midfielder,Brazil,South America
1750,Houboulang Mendes,GNB,Lorient,Ligue 1,2021,23.0,1998.0,35.8,58,28,37,18,3,40,57,70.2,17,41,21,20,41,99,128,4,DF,20-24,Defender,Guinea-Bissau,Africa
1751,Nuno Mendes,POR,Paris S-G,Ligue 1,2021,19.0,2002.0,18.4,48,29,23,18,7,25,47,53.2,22,27,5,22,21,69,17,1,DF,Under 20,Defender,Portugal,Europe
1753,Thiago Mendes,BRA,Lyon,Ligue 1,2021,29.0,1992.0,20.7,36,22,18,16,2,12,30,40.0,18,24,5,19,34,70,56,1,"MF,DF",25-29,Midfielder,Brazil,South America
1757,Arial Mendy,SEN,Clermont Foot,Ligue 1,2021,26.0,1994.0,8.8,6,4,4,2,0,2,11,18.2,9,6,1,5,7,13,17,0,"DF,FW",25-29,Defender,Senegal,Africa
1759,Benjamin Mendy,FRA,Manchester City,Premier League,2021,27.0,1994.0,0.9,2,2,1,1,0,2,6,33.3,4,0,0,0,0,2,0,0,DF,25-29,Defender,France,Europe
1760,Edouard Mendy,SEN,Chelsea,Premier League,2021,29.0,1992.0,34.0,1,0,1,0,0,1,3,33.3,2,0,0,0,0,1,13,4,GK,25-29,Goalkeeper,Senegal,Africa
1761,Ferland Mendy,FRA,Real Madrid,La Liga,2021,26.0,1995.0,19.3,24,14,11,10,3,8,14,57.1,6,8,2,6,18,42,27,3,DF,25-29,Defender,France,Europe
1762,Nampalys Mendy,SEN,Leicester City,Premier League,2021,29.0,1992.0,11.5,12,6,8,4,0,6,17,35.3,11,7,4,3,11,23,11,1,MF,25-29,Midfielder,Senegal,Africa
1763,Gideon Mensah,GHA,Bordeaux,Ligue 1,2021,23.0,1998.0,13.4,37,24,19,12,6,18,38,47.4,20,11,2,9,16,53,21,0,DF,20-24,Defender,Ghana,Africa
1765,Alex Meret,ITA,Napoli,Serie A,2021,24.0,1997.0,6.9,0,0,0,0,0,0,0,,0,0,0,0,0,0,3,1,GK,20-24,Goalkeeper,Italy,Europe
1768,Quentin Merlin,FRA,Nantes,Ligue 1,2021,19.0,2002.0,21.4,45,28,19,20,6,26,49,53.1,23,25,4,21,27,72,29,2,"DF,MF",Under 20,Defender,France,Europe
1772,Illan Meslier,FRA,Leeds United,Premier League,2021,21.0,2000.0,37.6,1,1,1,0,0,1,1,100.0,0,0,0,0,0,1,27,1,GK,20-24,Goalkeeper,France,Europe
1773,Lionel Messi,ARG,Paris S-G,Ligue 1,2021,34.0,1987.0,23.9,10,3,1,5,4,3,13,23.1,10,5,0,5,4,14,0,0,"FW,MF",30-34,Forward,Argentina,South America
1774,Junior Messias,BRA,Milan,Serie A,2021,30.0,1991.0,15.9,34,18,11,14,9,15,34,44.1,19,11,1,10,17,51,17,0,"FW,MF",30-34,Forward,Brazil,South America
1775,Thomas Meunier,BEL,Dortmund,Bundesliga,2021,29.0,1991.0,15.6,29,19,13,12,4,16,33,48.5,17,10,2,8,12,41,25,1,DF,25-29,Defender,Belgium,Europe
1777,Marco Meyerhöfer,GER,Greuther Fürth,Bundesliga,2021,25.0,1995.0,25.3,53,35,22,22,9,24,37,64.9,13,38,19,19,47,100,64,1,DF,25-29,Defender,Germany,Europe
1778,Matt Miazga,USA,Alavés,La Liga,2021,26.0,1995.0,9.3,7,7,3,4,0,2,7,28.6,5,14,12,2,11,18,55,1,DF,25-29,Defender,United States,North America
1779,Kingsley Michael,NGA,Bologna,Serie A,2021,21.0,1999.0,0.8,4,1,2,2,0,1,2,50.0,1,2,1,1,1,5,1,1,MF,20-24,Midfielder,Nigeria,Africa
1780,Sven Michel,GER,Union Berlin,Bundesliga,2021,31.0,1990.0,3.8,10,6,5,3,2,2,8,25.0,6,3,0,3,1,11,1,0,FW,30-34,Forward,Germany,Europe
1784,Mikael,BRA,Salernitana,Serie A,2021,22.0,1999.0,1.0,1,1,0,1,0,0,0,,0,0,0,0,0,1,1,0,"FW,MF",20-24,Forward,Brazil,South America
1786,Georges Mikautadze,GEO,Metz,Ligue 1,2021,20.0,2000.0,0.0,0,0,0,0,0,0,0,,0,0,0,0,0,0,0,0,FW,20-24,Forward,Georgia,Asia
1787,William Mikelbrencis,FRA,Metz,Ligue 1,2021,17.0,2004.0,6.8,11,5,6,4,1,6,9,66.7,3,6,3,3,5,16,9,0,DF,Under 20,Defender,France,Europe
1792,Éder Militão,BRA,Real Madrid,La Liga,2021,23.0,1998.0,33.7,50,32,30,12,8,20,39,51.3,19,42,20,22,52,102,107,3,DF,20-24,Defender,Brazil,South America
1796,Enzo Millot,FRA,Stuttgart,Bundesliga,2021,19.0,2002.0,0.6,2,0,0,2,0,0,1,0.0,1,0,0,0,1,3,1,0,MF,Under 20,Midfielder,France,Europe
1797,James Milner,ENG,Liverpool,Premier League,2021,35.0,1986.0,9.5,28,16,12,11,5,12,29,41.4,17,19,5,14,17,45,20,0,"MF,DF",35-39,Midfielder,England,Europe
1799,Yerry Mina,COL,Everton,Premier League,2021,26.0,1994.0,9.4,12,10,12,0,0,10,13,76.9,3,13,9,4,11,23,38,1,DF,25-29,Defender,Colombia,South America
1800,Takumi Minamino,JPN,Liverpool,Premier League,2021,26.0,1995.0,2.1,3,2,1,1,1,2,8,25.0,6,2,0,2,1,4,2,0,"FW,MF",25-29,Forward,Japan,Asia
1801,Tyrone Mings,ENG,Aston Villa,Premier League,2021,28.0,1993.0,35.4,23,12,17,3,3,14,22,63.6,8,47,30,17,46,69,153,2,DF,25-29,Defender,England,Europe
1807,Fabio Miretti,ITA,Juventus,Serie A,2021,17.0,2003.0,3.6,4,2,2,2,0,2,9,22.2,7,3,1,2,2,6,3,0,MF,Under 20,Midfielder,Italy,Europe
1808,Tyrick Mitchell,ENG,Crystal Palace,Premier League,2021,21.0,1999.0,34.5,104,57,67,26,11,46,67,68.7,21,47,5,42,41,145,101,0,DF,20-24,Defender,England,Europe
1810,Maximilian Mittelstädt,GER,Hertha BSC,Bundesliga,2021,24.0,1997.0,16.6,52,33,30,12,10,26,50,52.0,24,28,5,23,46,98,37,0,"DF,FW",20-24,Defender,Germany,Europe
1811,Henrikh Mkhitaryan,ARM,Roma,Serie A,2021,32.0,1989.0,27.7,45,29,11,27,7,17,52,32.7,35,33,2,31,22,67,33,0,"MF,FW",30-34,Midfielder,Armenia,Asia
1813,Anthony Modeste,FRA,Köln,Bundesliga,2021,33.0,1988.0,29.0,10,6,4,5,1,3,18,16.7,15,11,2,9,4,14,29,0,FW,30-34,Forward,France,Europe
1814,Marco Modolo,ITA,Venezia,Serie A,2021,32.0,1989.0,4.4,6,3,4,2,0,2,5,40.0,3,6,6,0,4,10,26,0,DF,30-34,Defender,Italy,Europe
1816,Terem Moffi,NGA,Lorient,Ligue 1,2021,22.0,1999.0,30.1,17,10,3,12,2,9,32,28.1,23,11,2,9,4,21,22,0,FW,20-24,Forward,Nigeria,Africa
1819,Johan Mojica,COL,Elche,La Liga,2021,28.0,1992.0,31.7,46,25,34,7,5,23,31,74.2,8,22,3,19,25,71,61,3,DF,25-29,Defender,Colombia,South America
1820,Clinton Mola,ENG,Stuttgart,Bundesliga,2021,20.0,2001.0,1.3,3,1,2,1,0,2,4,50.0,2,5,5,0,3,6,2,0,DF,20-24,Defender,England,Europe
1822,Nahuel Molina,ARG,Udinese,Serie A,2021,23.0,1998.0,29.3,41,24,17,21,3,16,48,33.3,32,24,3,21,22,63,44,2,DF,20-24,Defender,Argentina,South America
1823,Cristian Molinaro,ITA,Venezia,Serie A,2021,38.0,1983.0,6.1,12,9,10,2,0,5,7,71.4,2,7,2,5,6,18,20,0,DF,35-39,Defender,Italy,Europe
1824,Florent Mollet,FRA,Montpellier,Ligue 1,2021,29.0,1991.0,29.2,31,22,14,12,5,14,57,24.6,43,27,4,23,24,55,13,0,"FW,MF",25-29,Forward,France,Europe
1827,Thomas Monconduit,FRA,Lorient,Ligue 1,2021,30.0,1991.0,25.0,41,25,19,17,5,20,57,35.1,37,21,10,11,22,63,51,1,MF,30-34,Midfielder,France,Europe
1828,Gonzalo Montiel,ARG,Sevilla,La Liga,2021,24.0,1997.0,11.8,15,4,8,5,2,12,24,50.0,12,8,2,6,10,25,22,0,DF,20-24,Defender,Argentina,South America
1829,Lorenzo Montipò,ITA,Hellas Verona,Serie A,2021,25.0,1996.0,34.0,0,0,0,0,0,0,0,,0,0,0,0,1,1,16,3,GK,25-29,Goalkeeper,Italy,Europe
1832,Wesley Moraes,BRA,Aston Villa,Premier League,2021,24.0,1996.0,0.0,0,0,0,0,0,0,0,,0,0,0,0,0,0,0,0,FW,20-24,Forward,Brazil,South America
1836,Jérémy Morel,MAD,Lorient,Ligue 1,2021,37.0,1984.0,6.7,13,9,8,4,1,6,6,100.0,0,9,7,2,7,20,31,0,DF,35-39,Defender,Madagascar,Africa
1841,Ilaix Moriba,GUI,Valencia,La Liga,2021,18.0,2003.0,9.1,26,18,10,13,3,14,35,40.0,21,15,0,15,12,38,14,0,MF,Under 20,Midfielder,Guinea,Africa
1842,Ilaix Moriba,GUI,RB Leipzig,Bundesliga,2021,18.0,2003.0,0.4,0,0,0,0,0,0,4,0.0,4,2,0,2,1,1,0,0,MF,Under 20,Midfielder,Guinea,Africa
1847,Tyler Morton,ENG,Liverpool,Premier League,2021,18.0,2002.0,0.7,0,0,0,0,0,0,2,0.0,2,0,0,0,3,3,0,0,MF,Under 20,Midfielder,England,Europe
1849,Lebo Mothiba,RSA,Troyes,Ligue 1,2021,25.0,1996.0,5.8,8,4,4,3,1,2,5,40.0,3,3,0,3,2,10,0,0,"FW,MF",25-29,Forward,South Africa,Africa
1850,Lebo Mothiba,RSA,Strasbourg,Ligue 1,2021,25.0,1996.0,0.0,0,0,0,0,0,0,0,,0,0,0,0,0,0,0,0,FW,25-29,Forward,South Africa,Africa
1851,Andrei Motoc,MDA,Salernitana,Serie A,2021,19.0,2002.0,1.0,1,1,0,1,0,0,0,,0,2,2,0,2,3,1,0,DF,Under 20,Defender,Moldova,Europe
1852,Baptiste Mouazan,FRA,Lorient,Ligue 1,2021,19.0,2001.0,1.1,4,3,2,2,0,1,3,33.3,2,3,0,3,1,5,1,0,MF,Under 20,Midfielder,France,Europe
1854,Youssoufa Moukoko,GER,Dortmund,Bundesliga,2021,16.0,2004.0,2.5,1,0,0,1,0,0,1,0.0,1,5,0,5,3,4,0,0,"FW,MF",Under 20,Forward,Germany,Europe
1856,Jessy Moulin,FRA,Troyes,Ligue 1,2021,35.0,1986.0,7.0,0,0,0,0,0,0,0,,0,0,0,0,1,1,7,0,GK,35-39,Goalkeeper,France,Europe
1857,Steve Mounié,BEN,Brest,Ligue 1,2021,26.0,1994.0,25.7,17,6,3,12,2,4,27,14.8,23,13,1,12,6,23,12,0,FW,25-29,Forward,Benin,Africa
1858,Mason Mount,ENG,Chelsea,Premier League,2021,22.0,1999.0,26.3,41,16,10,17,14,10,34,29.4,24,18,1,17,13,54,12,0,MF,20-24,Midfielder,England,Europe
1859,Lucas Moura,BRA,Tottenham,Premier League,2021,28.0,1992.0,19.7,25,10,7,14,4,8,35,22.9,27,19,0,19,18,43,19,0,"FW,MF",25-29,Forward,Brazil,South America
1860,Lys Mousset,FRA,Salernitana,Serie A,2021,25.0,1996.0,1.8,1,0,0,1,0,0,0,,0,2,0,2,0,1,0,0,"MF,FW",25-29,Midfielder,France,Europe
1861,João Moutinho,POR,Wolves,Premier League,2021,34.0,1986.0,33.0,74,39,34,27,13,30,106,28.3,76,48,8,40,34,108,36,2,MF,30-34,Midfielder,Portugal,Europe
1861,João Moutinho,POR,Wolves,Premier League,2021,34.0,1986.0,33.0,74,39,34,27,13,30,106,28.3,76,48,8,40,34,108,36,2,MF,30-34,Midfielder,Portugal,Europe
1861,João Moutinho,POR,Wolves,Premier League,2021,34.0,1986.0,33.0,74,39,34,27,13,30,106,28.3,76,48,8,40,34,108,36,2,MF,30-34,Midfielder,Portugal,Europe
1861,João Moutinho,POR,Wolves,Premier League,2021,34.0,1986.0,33.0,74,39,34,27,13,30,106,28.3,76,48,8,40,34,108,36,2,MF,30-34,Midfielder,Portugal,Europe
1865,Nordi Mukiele,FRA,RB Leipzig,Bundesliga,2021,23.0,1997.0,20.5,35,22,23,9,3,14,27,51.9,13,31,5,26,31,66,44,2,"DF,FW",20-24,Defender,France,Europe
1867,Florian Müller,GER,Stuttgart,Bundesliga,2021,23.0,1997.0,30.0,0,0,0,0,0,0,1,0.0,1,1,0,1,0,0,13,2,GK,20-24,Goalkeeper,Germany,Europe
1868,Thomas Müller,GER,Bayern Munich,Bundesliga,2021,31.0,1989.0,28.4,35,20,7,16,12,16,54,29.6,38,32,1,31,15,50,12,0,MF,30-34,Midfielder,Germany,Europe
1869,Bali Mumba,ENG,Norwich City,Premier League,2021,19.0,2001.0,0.5,1,1,1,0,0,0,0,,0,0,0,0,0,1,5,0,DF,Under 20,Defender,England,Europe
1870,Marshall Munetsi,ZIM,Reims,Ligue 1,2021,25.0,1996.0,20.9,34,17,21,11,2,17,39,43.6,22,39,13,26,43,77,72,2,"MF,DF",25-29,Midfielder,Zimbabwe,Africa
1873,Luis Muriel,COL,Atalanta,Serie A,2021,30.0,1991.0,17.1,15,4,2,7,6,3,19,15.8,16,12,0,12,4,19,5,0,"FW,MF",30-34,Forward,Colombia,South America
1874,Jeison Murillo,COL,Celta Vigo,La Liga,2021,29.0,1992.0,12.4,15,10,13,2,0,9,13,69.2,4,11,8,3,17,32,37,0,DF,25-29,Defender,Colombia,South America
1877,Jacob Murphy,ENG,Newcastle Utd,Premier League,2021,26.0,1995.0,16.4,49,26,34,11,4,26,41,63.4,15,20,2,18,23,72,17,0,"FW,DF",25-29,Forward,England,Europe
1878,Nicola Murru,ITA,Sampdoria,Serie A,2021,26.0,1994.0,10.9,22,17,10,11,1,8,13,61.5,5,17,3,14,7,29,20,1,DF,25-29,Defender,Italy,Europe
1879,Yunus Musah,USA,Valencia,La Liga,2021,18.0,2002.0,14.0,23,13,8,8,7,6,20,30.0,14,19,1,18,14,37,11,0,"MF,FW",Under 20,Midfielder,United States,North America
1880,Torben Müsel,GER,Gladbach,Bundesliga,2021,22.0,1999.0,0.1,0,0,0,0,0,0,0,,0,0,0,0,0,0,0,0,MF,20-24,Midfielder,Germany,Europe
1881,Jamal Musiala,GER,Bayern Munich,Bundesliga,2021,18.0,2003.0,16.3,40,26,11,16,13,15,36,41.7,21,25,0,25,19,59,2,1,"MF,FW",Under 20,Midfielder,Germany,Europe
1882,Juan Musso,ARG,Atalanta,Serie A,2021,27.0,1994.0,32.6,1,1,1,0,0,0,0,,0,0,0,0,0,1,17,1,GK,25-29,Goalkeeper,Argentina,South America
1883,Shkodran Mustafi,GER,Levante,La Liga,2021,29.0,1992.0,7.3,9,6,6,3,0,5,9,55.6,4,6,3,3,15,24,40,0,DF,25-29,Defender,Germany,Europe
1885,Enock Mwepu,ZAM,Brighton,Premier League,2021,23.0,1998.0,11.1,22,12,10,10,2,5,27,18.5,22,20,2,18,12,34,19,0,MF,20-24,Midfielder,Zambia,Africa
1886,Vitaliy Mykolenko,UKR,Everton,Premier League,2021,22.0,1999.0,11.7,25,15,15,7,3,12,21,57.1,9,15,2,13,16,41,37,0,DF,20-24,Defender,Ukraine,Europe
1889,Kévin N'Doram,FRA,Metz,Ligue 1,2021,25.0,1996.0,13.7,10,8,3,5,2,3,20,15.0,17,24,5,19,19,29,21,0,MF,25-29,Midfielder,France,Europe
1894,Marvelous Nakamba,ZIM,Aston Villa,Premier League,2021,27.0,1994.0,10.0,32,19,18,14,0,12,34,35.3,22,14,4,10,12,44,17,1,MF,25-29,Midfielder,Zimbabwe,Africa
1895,Nahitan Nández,URU,Cagliari,Serie A,2021,25.0,1995.0,16.9,39,21,16,15,8,18,33,54.5,15,16,1,15,9,48,15,1,"MF,DF",25-29,Midfielder,Uruguay,South America
1898,Nikolas Nartey,DEN,Stuttgart,Bundesliga,2021,21.0,2000.0,4.5,6,3,0,5,1,3,9,33.3,6,4,2,2,7,13,5,0,"MF,DF",20-24,Midfielder,Denmark,Europe
1903,Keylor Navas,CRC,Paris S-G,Ligue 1,2021,34.0,1986.0,20.6,0,0,0,0,0,0,0,,0,0,0,0,0,0,5,1,GK,30-34,Goalkeeper,Costa Rica,North America
1904,Papa Ndiaga Yade,MTN,Metz,Ligue 1,2021,21.0,2000.0,7.7,15,10,8,7,0,8,18,44.4,10,4,1,3,10,25,9,0,"DF,FW",20-24,Defender,Mauritania,Africa
1905,Wilfred Ndidi,NGA,Leicester City,Premier League,2021,24.0,1996.0,18.0,60,32,32,27,1,22,55,40.0,33,36,8,28,42,102,54,1,"MF,DF",20-24,Midfielder,Nigeria,Africa
1908,Dan Ndoye,SUI,Nice,Ligue 1,2021,20.0,2000.0,2.3,0,0,0,0,0,0,2,0.0,2,4,0,4,0,0,0,0,"FW,MF",20-24,Forward,Switzerland,Europe
1909,Paul Nebel,GER,Mainz 05,Bundesliga,2021,18.0,2002.0,2.5,5,3,3,1,1,2,3,66.7,1,0,0,0,0,5,1,0,"MF,FW",Under 20,Midfielder,Germany,Europe
1911,Reiss Nelson,ENG,Arsenal,Premier League,2021,21.0,1999.0,0.2,1,0,0,0,1,0,1,0.0,1,1,0,1,0,1,0,0,FW,20-24,Forward,England,Europe
1912,David Nemeth,AUT,Mainz 05,Bundesliga,2021,20.0,2001.0,3.5,3,2,2,1,0,1,3,33.3,2,5,1,4,6,9,11,1,DF,20-24,Defender,Austria,Europe
1913,Ilija Nestorovski,MKD,Udinese,Serie A,2021,31.0,1990.0,2.1,0,0,0,0,0,0,3,0.0,3,0,0,0,0,0,4,0,FW,30-34,Forward,North Macedonia,Europe
1914,Neto,BRA,Barcelona,La Liga,2021,32.0,1989.0,3.0,0,0,0,0,0,0,0,,0,0,0,0,0,0,2,1,GK,30-34,Goalkeeper,Brazil,South America
1914,Neto,BRA,Barcelona,La Liga,2021,32.0,1989.0,3.0,0,0,0,0,0,0,0,,0,0,0,0,0,0,2,1,GK,30-34,Goalkeeper,Brazil,South America
1914,Neto,BRA,Barcelona,La Liga,2021,32.0,1989.0,3.0,0,0,0,0,0,0,0,,0,0,0,0,0,0,2,1,GK,30-34,Goalkeeper,Brazil,South America
1914,Neto,BRA,Barcelona,La Liga,2021,32.0,1989.0,3.0,0,0,0,0,0,0,0,,0,0,0,0,0,0,2,1,GK,30-34,Goalkeeper,Brazil,South America
1914,Neto,BRA,Barcelona,La Liga,2021,32.0,1989.0,3.0,0,0,0,0,0,0,0,,0,0,0,0,0,0,2,1,GK,30-34,Goalkeeper,Brazil,South America
1914,Neto,BRA,Barcelona,La Liga,2021,32.0,1989.0,3.0,0,0,0,0,0,0,0,,0,0,0,0,0,0,2,1,GK,30-34,Goalkeeper,Brazil,South America
1914,Neto,BRA,Barcelona,La Liga,2021,32.0,1989.0,3.0,0,0,0,0,0,0,0,,0,0,0,0,0,0,2,1,GK,30-34,Goalkeeper,Brazil,South America
1914,Neto,BRA,Barcelona,La Liga,2021,32.0,1989.0,3.0,0,0,0,0,0,0,0,,0,0,0,0,0,0,2,1,GK,30-34,Goalkeeper,Brazil,South America
1914,Neto,BRA,Barcelona,La Liga,2021,32.0,1989.0,3.0,0,0,0,0,0,0,0,,0,0,0,0,0,0,2,1,GK,30-34,Goalkeeper,Brazil,South America
1915,Pedro Neto,POR,Wolves,Premier League,2021,21.0,2000.0,5.2,4,4,2,0,2,0,9,0.0,9,0,0,0,6,10,1,0,"FW,MF",20-24,Forward,Portugal,Europe
1916,Luca Netz,GER,Gladbach,Bundesliga,2021,18.0,2003.0,15.5,24,11,12,10,2,11,40,27.5,29,24,4,20,13,37,33,1,"DF,FW",Under 20,Defender,Germany,Europe
1917,Manuel Neuer,GER,Bayern Munich,Bundesliga,2021,35.0,1986.0,27.9,2,1,2,0,0,1,2,50.0,1,0,0,0,0,2,7,1,GK,35-39,Goalkeeper,Germany,Europe
1918,Florian Neuhaus,GER,Gladbach,Bundesliga,2021,24.0,1997.0,23.6,55,28,24,26,5,27,64,42.2,37,38,6,32,31,86,19,4,MF,20-24,Midfielder,Germany,Europe
1920,Rúben Neves,POR,Wolves,Premier League,2021,24.0,1997.0,29.6,68,37,23,41,4,24,87,27.6,63,39,5,34,41,109,49,3,MF,20-24,Midfielder,Portugal,Europe
1921,Neymar,BRA,Paris S-G,Ligue 1,2021,29.0,1992.0,20.6,29,19,5,12,12,12,36,33.3,24,9,1,8,4,33,2,1,"FW,MF",25-29,Forward,Brazil,South America
1922,Yvan Neyou,CMR,Saint-Étienne,Ligue 1,2021,24.0,1997.0,10.4,29,13,14,12,3,9,27,33.3,18,8,3,5,23,52,13,0,MF,20-24,Midfielder,Cameroon,Africa
1923,Jeremy Ngakia,ENG,Watford,Premier League,2021,20.0,2000.0,10.0,31,18,23,5,3,11,26,42.3,15,11,4,7,12,43,32,0,DF,20-24,Defender,England,Europe
1924,Jessic Ngankam,GER,Greuther Fürth,Bundesliga,2021,21.0,2000.0,3.8,3,1,1,1,1,1,2,50.0,1,3,0,3,0,3,1,0,FW,20-24,Forward,Germany,Europe
1925,Opa Nguette,SEN,Metz,Ligue 1,2021,27.0,1994.0,11.6,21,14,9,6,6,5,14,35.7,9,13,3,10,2,23,9,0,"FW,MF",25-29,Forward,Senegal,Africa
1926,Aurélien Nguiamba,FRA,Spezia,Serie A,2021,22.0,1999.0,0.6,3,2,1,2,0,2,3,66.7,1,2,1,1,0,3,1,0,MF,20-24,Midfielder,France,Europe
1929,Ibrahima Niane,SEN,Metz,Ligue 1,2021,22.0,1999.0,17.6,1,1,0,1,0,0,5,0.0,5,6,1,5,3,4,16,0,FW,20-24,Forward,Senegal,Africa
1931,Tanguy Nianzou,FRA,Bayern Munich,Bundesliga,2021,19.0,2002.0,6.5,11,7,7,3,1,7,11,63.6,4,7,2,5,7,18,17,0,DF,Under 20,Defender,France,Europe
1932,Cheikh Niasse,SEN,Lille,Ligue 1,2021,21.0,2000.0,0.5,2,2,0,2,0,2,3,66.7,1,1,1,0,1,3,2,0,"FW,MF",20-24,Forward,Senegal,Africa
1933,Florian Niederlechner,GER,Augsburg,Bundesliga,2021,30.0,1990.0,12.9,6,5,1,3,2,4,13,30.8,9,9,0,9,4,10,7,0,FW,30-34,Forward,Germany,Europe
1938,Joakim Nilsson,SWE,Arminia,Bundesliga,2021,27.0,1994.0,30.4,37,19,24,13,0,20,26,76.9,6,36,23,13,56,93,143,1,DF,25-29,Defender,Sweden,Europe
1939,Casimir Ninga,CHA,Angers,Ligue 1,2021,28.0,1993.0,4.5,5,1,1,4,0,2,5,40.0,3,2,0,2,1,6,0,0,FW,25-29,Forward,Chad,Africa
1941,Eddie Nketiah,ENG,Arsenal,Premier League,2021,22.0,1999.0,9.3,9,4,1,4,4,1,4,25.0,3,9,2,7,4,13,5,0,FW,20-24,Forward,England,Europe
1943,Christopher Nkunku,FRA,RB Leipzig,Bundesliga,2021,23.0,1997.0,30.3,23,10,10,11,2,9,35,25.7,26,23,2,21,15,38,15,0,"FW,MF",20-24,Forward,France,Europe
1944,Felix Nmecha,GER,Wolfsburg,Bundesliga,2021,20.0,2000.0,3.6,3,1,1,1,1,0,2,0.0,2,2,0,2,7,10,6,0,"MF,FW",20-24,Midfielder,Germany,Europe
1945,Lukas Nmecha,GER,Wolfsburg,Bundesliga,2021,22.0,1998.0,18.1,12,5,5,5,2,5,19,26.3,14,9,1,8,4,16,10,0,"FW,MF",20-24,Forward,Germany,Europe
1946,Mark Noble,ENG,West Ham,Premier League,2021,34.0,1987.0,3.7,8,2,7,1,0,5,11,45.5,6,4,1,3,4,12,2,1,MF,30-34,Midfielder,England,Europe
1949,Arnaud Nordin,FRA,Saint-Étienne,Ligue 1,2021,23.0,1998.0,20.8,21,11,8,8,5,8,22,36.4,14,19,0,19,6,27,8,0,"FW,MF",20-24,Forward,France,Europe
1954,Soma Novothny,HUN,Bochum,Bundesliga,2021,27.0,1994.0,0.9,1,1,1,0,0,0,1,0.0,1,1,0,1,0,1,2,0,"FW,MF",25-29,Forward,Hungary,Europe
1955,Jean-Pierre Nsame,CMR,Venezia,Serie A,2021,28.0,1993.0,2.7,1,1,0,0,1,0,0,,0,0,0,0,0,1,1,0,FW,25-29,Forward,Cameroon,Africa
1956,Randy Nteka,ANG,Rayo Vallecano,La Liga,2021,23.0,1997.0,16.2,24,13,9,11,4,8,19,42.1,11,21,1,20,8,32,12,0,"FW,MF",20-24,Forward,Angola,Africa
1957,Alexander Nübel,GER,Monaco,Ligue 1,2021,24.0,1996.0,38.0,0,0,0,0,0,0,1,0.0,1,0,0,0,0,0,11,1,GK,20-24,Goalkeeper,Germany,Europe
1964,Allan Nyom,CMR,Getafe,La Liga,2021,33.0,1988.0,2.7,3,1,2,1,0,2,2,100.0,0,2,1,1,2,5,7,0,DF,30-34,Defender,Cameroon,Africa
1965,M'Bala Nzola,ANG,Spezia,Serie A,2021,24.0,1996.0,11.9,2,2,0,0,2,1,6,16.7,5,8,0,8,0,2,13,0,FW,20-24,Forward,Angola,Africa
1966,Christian Nørgaard,DEN,Brentford,Premier League,2021,27.0,1994.0,33.9,109,60,42,58,9,52,101,51.5,49,48,9,39,64,173,58,1,MF,25-29,Midfielder,Denmark,Europe
1967,Adam Obert,SVK,Cagliari,Serie A,2021,18.0,2002.0,3.0,8,5,6,2,0,5,6,83.3,1,6,4,2,4,12,11,0,"DF,MF",Under 20,Defender,Slovakia,Europe
1968,Joel Obi,NGA,Salernitana,Serie A,2021,30.0,1991.0,12.7,23,14,5,14,4,5,12,41.7,7,17,6,11,10,33,7,0,"MF,DF",30-34,Midfielder,Nigeria,Africa
1970,Lucas Ocampos,ARG,Sevilla,La Liga,2021,27.0,1994.0,23.6,45,24,23,18,4,23,55,41.8,32,35,1,34,9,54,24,1,FW,25-29,Forward,Argentina,South America
1971,Bastian Oczipka,GER,Union Berlin,Bundesliga,2021,32.0,1989.0,10.4,24,15,15,7,2,10,13,76.9,3,10,2,8,12,36,21,0,DF,30-34,Defender,Germany,Europe
1972,Brian Oddei,ITA,Sassuolo,Serie A,2021,18.0,2002.0,0.1,0,0,0,0,0,0,0,,0,0,0,0,0,0,0,0,FW,Under 20,Forward,Italy,Europe
1974,Angelo Ogbonna,ITA,West Ham,Premier League,2021,33.0,1988.0,10.2,7,4,5,2,0,3,7,42.9,4,5,4,1,11,18,29,0,DF,30-34,Defender,Italy,Europe
1975,Florent Ogier,FRA,Clermont Foot,Ligue 1,2021,32.0,1989.0,27.0,31,17,18,12,1,17,31,54.8,14,41,27,14,37,68,89,0,DF,30-34,Defender,France,Europe
1978,Masaya Okugawa,JPN,Arminia,Bundesliga,2021,25.0,1996.0,28.1,46,25,18,22,6,12,37,32.4,25,29,1,28,20,66,13,0,"MF,FW",25-29,Midfielder,Japan,Asia
1981,Mathias Olesen,LUX,Köln,Bundesliga,2021,20.0,2001.0,0.2,0,0,0,0,0,0,0,,0,0,0,0,1,1,0,0,"MF,FW",20-24,Midfielder,Luxembourg,Europe
1982,Michael Olise,FRA,Crystal Palace,Premier League,2021,19.0,2001.0,12.7,22,18,8,11,3,7,24,29.2,17,17,0,17,6,28,6,0,"FW,MF",Under 20,Forward,France,Europe
1983,Christian Oliva,URU,Cagliari,Serie A,2021,25.0,1996.0,0.5,2,2,2,0,0,1,4,25.0,3,0,0,0,0,2,0,0,MF,25-29,Midfielder,Uruguay,South America
1986,Mathías Olivera,URU,Getafe,La Liga,2021,23.0,1997.0,31.1,79,47,39,34,6,40,69,58.0,29,45,4,41,55,134,67,1,DF,20-24,Defender,Uruguay,South America
1988,Robin Olsen,SWE,Aston Villa,Premier League,2021,31.0,1990.0,1.0,0,0,0,0,0,0,0,,0,0,0,0,0,0,0,0,GK,30-34,Goalkeeper,Sweden,Europe
1990,Jonas Omlin,SUI,Montpellier,Ligue 1,2021,27.0,1994.0,28.7,2,1,2,0,0,2,3,66.7,1,0,0,0,0,2,12,3,GK,25-29,Goalkeeper,Switzerland,Europe
1991,Andrew Omobamidele,IRL,Norwich City,Premier League,2021,19.0,2002.0,4.2,8,6,5,3,0,5,11,45.5,6,8,8,0,5,13,13,0,DF,Under 20,Defender,Republic of Ireland,Europe
1992,Amadou Onana,BEL,Lille,Ligue 1,2021,19.0,2001.0,15.1,48,31,17,27,4,18,25,72.0,7,10,3,7,30,78,19,0,MF,Under 20,Midfielder,Belgium,Europe
1993,Jean Onana,CMR,Bordeaux,Ligue 1,2021,21.0,2000.0,20.4,70,49,33,33,4,35,86,40.7,51,37,5,32,36,106,23,1,MF,20-24,Midfielder,Cameroon,Africa
1994,Karim Onisiwo,AUT,Mainz 05,Bundesliga,2021,29.0,1992.0,26.2,18,10,4,6,8,7,22,31.8,15,27,2,25,7,25,8,0,FW,25-29,Forward,Austria,Europe
1996,Tyler Onyango,ENG,Everton,Premier League,2021,18.0,2003.0,0.3,0,0,0,0,0,0,0,,0,0,0,0,0,0,1,0,MF,Under 20,Midfielder,England,Europe
1997,Frank Onyeka,NGA,Brentford,Premier League,2021,23.0,1998.0,11.6,25,17,13,9,3,8,27,29.6,19,16,2,14,14,39,13,0,MF,20-24,Midfielder,Nigeria,Africa
1999,Divock Origi,BEL,Liverpool,Premier League,2021,26.0,1995.0,1.5,0,0,0,0,0,0,2,0.0,2,1,0,1,1,1,2,0,FW,25-29,Forward,Belgium,Europe
2000,Riccardo Orsolini,ITA,Bologna,Serie A,2021,24.0,1997.0,19.8,21,13,9,11,1,13,29,44.8,16,9,4,5,5,26,14,0,"FW,MF",20-24,Forward,Italy,Europe
2001,Stefan Ortega,GER,Arminia,Bundesliga,2021,28.0,1992.0,33.0,1,0,1,0,0,1,2,50.0,1,2,0,2,0,1,5,1,GK,25-29,Goalkeeper,Germany,Europe
2005,David Ospina,COL,Napoli,Serie A,2021,32.0,1988.0,31.0,0,0,0,0,0,0,0,,0,0,0,0,1,1,11,1,GK,30-34,Goalkeeper,Colombia,South America
2006,Patrick Osterhage,GER,Bochum,Bundesliga,2021,21.0,2000.0,6.7,9,6,3,5,1,3,7,42.9,4,7,1,6,11,20,8,0,MF,20-24,Midfielder,Germany,Europe
2008,Otávio,BRA,Bordeaux,Ligue 1,2021,27.0,1994.0,12.7,36,23,13,21,2,16,39,41.0,23,9,3,6,18,54,11,0,MF,25-29,Midfielder,Brazil,South America
2008,Otávio,BRA,Bordeaux,Ligue 1,2021,27.0,1994.0,12.7,36,23,13,21,2,16,39,41.0,23,9,3,6,18,54,11,0,MF,25-29,Midfielder,Brazil,South America
2008,Otávio,BRA,Bordeaux,Ligue 1,2021,27.0,1994.0,12.7,36,23,13,21,2,16,39,41.0,23,9,3,6,18,54,11,0,MF,25-29,Midfielder,Brazil,South America
2008,Otávio,BRA,Bordeaux,Ligue 1,2021,27.0,1994.0,12.7,36,23,13,21,2,16,39,41.0,23,9,3,6,18,54,11,0,MF,25-29,Midfielder,Brazil,South America
2008,Otávio,BRA,Bordeaux,Ligue 1,2021,27.0,1994.0,12.7,36,23,13,21,2,16,39,41.0,23,9,3,6,18,54,11,0,MF,25-29,Midfielder,Brazil,South America
2008,Otávio,BRA,Bordeaux,Ligue 1,2021,27.0,1994.0,12.7,36,23,13,21,2,16,39,41.0,23,9,3,6,18,54,11,0,MF,25-29,Midfielder,Brazil,South America
2008,Otávio,BRA,Bordeaux,Ligue 1,2021,27.0,1994.0,12.7,36,23,13,21,2,16,39,41.0,23,9,3,6,18,54,11,0,MF,25-29,Midfielder,Brazil,South America
2008,Otávio,BRA,Bordeaux,Ligue 1,2021,27.0,1994.0,12.7,36,23,13,21,2,16,39,41.0,23,9,3,6,18,54,11,0,MF,25-29,Midfielder,Brazil,South America
2008,Otávio,BRA,Bordeaux,Ligue 1,2021,27.0,1994.0,12.7,36,23,13,21,2,16,39,41.0,23,9,3,6,18,54,11,0,MF,25-29,Midfielder,Brazil,South America
2009,Paulo Otávio,BRA,Wolfsburg,Bundesliga,2021,26.0,1994.0,4.0,14,10,7,4,3,8,15,53.3,7,11,6,5,4,18,9,0,"DF,MF",25-29,Defender,Brazil,South America
2010,Dango Ouattara,BFA,Lorient,Ligue 1,2021,19.0,2002.0,9.0,21,15,9,11,1,11,23,47.8,12,10,1,9,14,35,15,1,"MF,FW",Under 20,Midfielder,Burkina Faso,Africa
2012,Alexandre Oukidja,ALG,Metz,Ligue 1,2021,33.0,1988.0,20.8,0,0,0,0,0,0,1,0.0,1,1,0,1,1,1,17,2,GK,30-34,Goalkeeper,Algeria,Africa
2014,Adam Ounas,ALG,Napoli,Serie A,2021,24.0,1996.0,3.6,6,1,0,3,3,3,7,42.9,4,3,0,3,2,8,3,0,"MF,FW",20-24,Midfielder,Algeria,Africa
2015,Jesús Owono,EQG,Alavés,La Liga,2021,20.0,2001.0,1.0,0,0,0,0,0,0,0,,0,0,0,0,0,0,1,0,GK,20-24,Goalkeeper,Equatorial Guinea,Africa
2016,Reece Oxford,ENG,Augsburg,Bundesliga,2021,22.0,1998.0,29.9,27,14,16,9,2,15,31,48.4,16,42,33,9,72,99,172,1,DF,20-24,Defender,England,Europe
2019,Ambroise Oyongo,CMR,Montpellier,Ligue 1,2021,30.0,1991.0,7.3,13,4,7,4,2,9,15,60.0,6,5,1,4,6,19,17,0,DF,30-34,Defender,Cameroon,Africa
2020,Salih Özcan,TUR,Köln,Bundesliga,2021,23.0,1998.0,25.7,42,30,14,23,5,22,51,43.1,29,37,5,32,51,93,35,1,MF,20-24,Midfielder,Turkey,Asia
2024,Gonçalo Paciência,POR,Eint Frankfurt,Bundesliga,2021,26.0,1994.0,5.7,4,2,2,1,1,1,3,33.3,2,2,0,2,1,5,4,0,FW,25-29,Forward,Portugal,Europe
2025,Daniele Padelli,ITA,Udinese,Serie A,2021,35.0,1985.0,3.0,0,0,0,0,0,0,0,,0,0,0,0,0,0,2,1,GK,35-39,Goalkeeper,Italy,Europe
2027,Vincent Pajot,FRA,Metz,Ligue 1,2021,30.0,1990.0,25.7,86,56,35,47,4,20,46,43.5,26,33,6,27,51,137,38,0,MF,30-34,Midfielder,France,Europe
2028,Exequiel Palacios,ARG,Leverkusen,Bundesliga,2021,22.0,1998.0,12.2,30,19,12,14,4,15,38,39.5,23,20,1,19,28,58,11,2,MF,20-24,Midfielder,Argentina,South America
2029,Helibelton Palacios,COL,Elche,La Liga,2021,28.0,1993.0,21.5,69,38,56,10,3,37,55,67.3,18,21,8,13,18,87,61,0,DF,25-29,Defender,Colombia,South America
2031,Nicolas Pallois,FRA,Nantes,Ligue 1,2021,33.0,1987.0,27.2,51,33,40,11,0,34,59,57.6,25,40,19,21,53,104,116,1,DF,30-34,Defender,France,Europe
2032,Cole Palmer,ENG,Manchester City,Premier League,2021,19.0,2002.0,1.4,2,1,1,1,0,0,2,0.0,2,3,0,3,1,3,0,0,"FW,MF",Under 20,Forward,England,Europe
2037,Goran Pandev,MKD,Genoa,Serie A,2021,38.0,1983.0,9.4,2,0,1,0,1,0,9,0.0,9,3,1,2,2,4,0,0,"FW,MF",35-39,Forward,North Macedonia,Europe
2040,Antonios Papadopoulos,GER,Dortmund,Bundesliga,2021,21.0,1999.0,0.2,0,0,0,0,0,0,0,,0,1,0,1,0,0,0,0,"DF,MF",20-24,Defender,Germany,Europe
2041,Merveille Papela,GER,Mainz 05,Bundesliga,2021,20.0,2001.0,0.9,3,2,2,1,0,2,3,66.7,1,2,0,2,2,5,0,0,MF,20-24,Midfielder,Germany,Europe
2042,Lucas Paquetá,BRA,Lyon,Ligue 1,2021,23.0,1997.0,30.0,68,38,24,26,18,17,51,33.3,34,43,5,38,9,77,22,0,"MF,FW",20-24,Midfielder,Brazil,South America
2044,Kevin Paredes,USA,Wolfsburg,Bundesliga,2021,18.0,2003.0,0.2,1,0,0,0,1,0,0,,0,1,0,1,0,1,0,0,"FW,DF",Under 20,Forward,United States,North America
2045,Leandro Paredes,ARG,Paris S-G,Ligue 1,2021,27.0,1994.0,9.3,23,13,9,11,3,12,24,50.0,12,10,6,4,10,33,5,2,MF,25-29,Midfielder,Argentina,South America
2047,Fabiano Parisi,ITA,Empoli,Serie A,2021,20.0,2000.0,16.4,35,19,25,5,5,13,31,41.9,18,30,10,20,22,57,42,0,DF,20-24,Defender,Italy,Europe
23,Julen Agirrezabala,ESP,Athletic Club,La Liga,2021,20.0,2000.0,4.0,0,0,0,0,0,0,0,,0,0,0,0,0,0,2,0,GK,20-24,Goalkeeper,Spain,Europe
36,Kristoffer Ajer,NOR,Brentford,Premier League,2021,23.0,1998.0,22.2,29,18,21,6,2,13,21,61.9,8,19,11,8,26,55,74,0,DF,20-24,Defender,Norway,Europe
51,Jordi Alba,ESP,Barcelona,La Liga,2021,32.0,1989.0,29.4,47,34,12,26,9,27,47,57.4,20,26,6,20,33,80,41,1,DF,30-34,Defender,Spain,Europe
53,Luis Alberto,ESP,Lazio,Serie A,2021,28.0,1992.0,26.1,29,17,8,11,10,8,52,15.4,44,32,4,28,13,42,7,0,MF,25-29,Midfielder,Spain,Europe
54,Raúl Albiol,ESP,Villarreal,La Liga,2021,35.0,1985.0,27.4,26,15,20,5,1,14,18,77.8,4,24,15,9,21,47,126,1,DF,35-39,Defender,Spain,Europe
56,Paco Alcácer,ESP,Villarreal,La Liga,2021,27.0,1993.0,8.7,9,3,2,4,3,1,5,20.0,4,7,0,7,6,15,1,0,FW,25-29,Forward,Spain,Europe
57,Thiago Alcántara,ESP,Liverpool,Premier League,2021,30.0,1991.0,17.0,48,29,14,24,10,10,42,23.8,32,22,2,20,26,74,13,2,MF,30-34,Midfielder,Spain,Europe
58,Rubén Alcaraz,ESP,Cádiz,La Liga,2021,30.0,1991.0,12.3,41,20,14,24,3,22,45,48.9,23,10,2,8,13,54,14,0,MF,30-34,Midfielder,Spain,Europe
60,Iván Alejo,ESP,Cádiz,La Liga,2021,26.0,1995.0,11.8,33,15,21,10,2,15,44,34.1,29,12,0,12,8,41,17,0,"MF,FW",25-29,Midfielder,Spain,Europe
62,Carles Aleñá,ESP,Getafe,La Liga,2021,23.0,1998.0,25.8,27,19,11,13,3,9,48,18.8,39,21,2,19,15,42,16,0,MF,20-24,Midfielder,Spain,Europe
71,Marcos Alonso,ESP,Chelsea,Premier League,2021,30.0,1990.0,24.1,41,29,20,12,9,17,36,47.2,19,29,5,24,43,84,53,0,DF,30-34,Defender,Spain,Europe
74,Yeray Álvarez,ESP,Athletic Club,La Liga,2021,26.0,1995.0,20.7,24,14,15,8,1,10,18,55.6,8,21,16,5,45,69,97,0,DF,25-29,Defender,Spain,Europe
98,José Ángel,ESP,Osasuna,La Liga,2021,31.0,1989.0,12.0,20,13,9,9,2,9,14,64.3,5,6,1,5,10,30,21,0,DF,30-34,Defender,Spain,Europe
99,Angeliño,ESP,RB Leipzig,Bundesliga,2021,24.0,1997.0,25.5,28,21,14,13,1,14,30,46.7,16,24,3,21,29,57,40,0,DF,20-24,Defender,Spain,Europe
117,Jesús Areso,ESP,Osasuna,La Liga,2021,22.0,1999.0,2.1,3,3,2,1,0,0,2,0.0,2,0,0,0,0,3,2,1,DF,20-24,Defender,Spain,Europe
124,Kepa Arrizabalaga,ESP,Chelsea,Premier League,2021,26.0,1994.0,4.0,0,0,0,0,0,0,0,,0,0,0,0,0,0,4,0,GK,25-29,Goalkeeper,Spain,Europe
129,Sergio Asenjo,ESP,Villarreal,La Liga,2021,32.0,1989.0,6.0,0,0,0,0,0,0,1,0.0,1,0,0,0,1,1,6,0,GK,30-34,Goalkeeper,Spain,Europe
131,Marco Asensio,ESP,Real Madrid,La Liga,2021,25.0,1996.0,19.2,12,8,6,4,2,4,18,22.2,14,8,1,7,12,24,6,1,"FW,MF",25-29,Forward,Spain,Europe
133,Kristoffer Askildsen,NOR,Sampdoria,Serie A,2021,20.0,2001.0,8.4,18,6,7,11,0,9,19,47.4,10,14,7,7,15,33,15,0,MF,20-24,Midfielder,Norway,Europe
136,Iago Aspas,ESP,Celta Vigo,La Liga,2021,33.0,1987.0,34.3,14,7,1,5,8,4,24,16.7,20,23,2,21,11,25,19,0,FW,30-34,Forward,Spain,Europe
137,Lorenz Assignon,TOG,Rennes,Ligue 1,2021,21.0,2000.0,6.8,15,10,11,3,1,5,9,55.6,4,3,1,2,11,26,19,0,DF,20-24,Defender,Togo,Africa
155,César Azpilicueta,ESP,Chelsea,Premier League,2021,31.0,1989.0,23.0,51,28,18,27,6,16,35,45.7,19,32,9,23,23,74,65,1,DF,30-34,Defender,Spain,Europe
161,Édgar Badía,ESP,Elche,La Liga,2021,29.0,1992.0,24.0,0,0,0,0,0,0,0,,0,0,0,0,0,0,16,2,GK,25-29,Goalkeeper,Spain,Europe
180,Alejandro Balde,ESP,Barcelona,La Liga,2021,17.0,2003.0,2.1,2,1,1,0,1,0,0,,0,2,2,0,1,3,1,0,"DF,FW",Under 20,Defender,Spain,Europe
184,Mikel Balenziaga,ESP,Athletic Club,La Liga,2021,33.0,1988.0,22.5,33,24,15,15,3,25,43,58.1,18,27,4,23,21,54,79,0,DF,30-34,Defender,Spain,Europe
206,Kike Barja,ESP,Osasuna,La Liga,2021,24.0,1997.0,9.6,15,11,4,7,4,8,22,36.4,14,10,1,9,9,24,4,0,"MF,FW",20-24,Midfielder,Spain,Europe
211,Antonio Barragán,ESP,Elche,La Liga,2021,34.0,1987.0,11.3,21,14,13,7,1,11,17,64.7,6,5,3,2,17,38,34,0,DF,30-34,Defender,Spain,Europe
213,Ander Barrenetxea,ESP,Real Sociedad,La Liga,2021,19.0,2001.0,6.1,15,10,9,6,0,8,18,44.4,10,7,0,7,2,17,2,0,"FW,MF",Under 20,Forward,Spain,Europe
217,Marc Bartra,ESP,Betis,La Liga,2021,30.0,1991.0,22.1,39,14,18,17,4,19,35,54.3,16,39,22,17,33,72,105,1,DF,30-34,Defender,Spain,Europe
223,Álvaro Bastida,ESP,Cádiz,La Liga,2021,17.0,2004.0,2.2,7,4,2,4,1,4,5,80.0,1,1,0,1,3,10,1,0,MF,Under 20,Midfielder,Spain,Europe
233,Jon Bautista,ESP,Real Sociedad,La Liga,2021,26.0,1995.0,0.5,3,0,0,3,0,0,1,0.0,1,1,0,1,1,4,1,0,MF,25-29,Midfielder,Spain,Europe
237,Ihlas Bebou,TOG,Hoffenheim,Bundesliga,2021,27.0,1994.0,23.2,22,14,5,12,5,7,21,33.3,14,20,3,17,12,34,25,0,"FW,DF",25-29,Forward,Togo,Africa
241,Jan Bednarek,POL,Southampton,Premier League,2021,25.0,1996.0,29.2,32,15,18,13,1,19,33,57.6,14,48,27,21,72,104,141,0,DF,25-29,Defender,Poland,Europe
248,Vid Belec,SVN,Salernitana,Serie A,2021,31.0,1990.0,21.5,0,0,0,0,0,0,0,,0,0,0,0,0,0,9,1,GK,30-34,Goalkeeper,Slovenia,Europe
256,Héctor Bellerín,ESP,Betis,La Liga,2021,26.0,1995.0,22.0,52,32,29,20,3,31,44,70.5,13,11,2,9,23,75,57,1,DF,25-29,Defender,Spain,Europe
261,Fran Beltrán,ESP,Celta Vigo,La Liga,2021,22.0,1999.0,28.9,56,41,27,23,6,28,68,41.2,40,29,5,24,32,88,39,0,MF,20-24,Midfielder,Spain,Europe
271,Iker Benito,ESP,Osasuna,La Liga,2021,18.0,2002.0,1.3,2,1,1,0,1,0,1,0.0,1,2,0,2,0,2,2,0,"FW,MF",Under 20,Forward,Spain,Europe
273,Pedro Benito,ESP,Cádiz,La Liga,2021,21.0,2000.0,0.3,0,0,0,0,0,0,1,0.0,1,0,0,0,0,0,0,0,FW,20-24,Forward,Spain,Europe
286,Yuri Berchiche,ESP,Athletic Club,La Liga,2021,31.0,1990.0,11.3,25,11,10,11,4,7,14,50.0,7,19,6,13,13,38,25,0,DF,30-34,Defender,Spain,Europe
287,Álex Berenguer,ESP,Athletic Club,La Liga,2021,26.0,1995.0,24.1,45,26,23,14,8,11,51,21.6,40,40,2,38,16,61,20,0,MF,25-29,Midfielder,Spain,Europe
288,Bartosz Bereszyński,POL,Sampdoria,Serie A,2021,29.0,1992.0,32.7,64,38,34,25,5,37,80,46.3,43,38,12,26,42,106,73,1,DF,25-29,Defender,Poland,Europe
290,Patrick Berg,NOR,Lens,Ligue 1,2021,23.0,1997.0,3.4,14,6,6,8,0,0,4,0.0,4,2,1,1,4,18,3,0,MF,20-24,Midfielder,Norway,Europe
298,Juan Bernat,ESP,Paris S-G,Ligue 1,2021,28.0,1993.0,10.6,24,14,10,10,4,13,18,72.2,5,8,0,8,8,32,16,0,"DF,MF",25-29,Defender,Spain,Europe
310,Pedro Bigas,ESP,Elche,La Liga,2021,30.0,1990.0,17.2,24,10,16,8,0,9,20,45.0,11,21,16,5,18,42,77,1,DF,30-34,Defender,Spain,Europe
321,Antonio Blanco,ESP,Real Madrid,La Liga,2021,21.0,2000.0,0.3,2,0,1,1,0,0,0,,0,1,1,0,1,3,0,0,MF,20-24,Midfielder,Spain,Europe
333,Emil Bohinen,NOR,Salernitana,Serie A,2021,22.0,1999.0,7.8,15,9,4,9,2,10,20,50.0,10,17,3,14,12,27,14,0,MF,20-24,Midfielder,Norway,Europe
352,Ismaël Boura,COM,Lens,Ligue 1,2021,20.0,2000.0,1.1,2,2,1,1,0,0,0,,0,1,1,0,2,4,5,0,DF,20-24,Defender,Comoros,Africa
369,Iker Bravo,ESP,Leverkusen,Bundesliga,2021,16.0,2005.0,0.1,1,1,0,1,0,0,0,,0,0,0,0,0,1,0,0,FW,Under 20,Forward,Spain,Europe
400,Sergio Busquets,ESP,Barcelona,La Liga,2021,33.0,1988.0,35.5,93,49,31,48,14,46,83,55.4,37,44,8,36,45,138,31,0,MF,30-34,Midfielder,Spain,Europe
429,Fernando Calero,ESP,Espanyol,La Liga,2021,25.0,1995.0,12.1,17,10,12,5,0,8,13,61.5,5,7,2,5,16,33,63,1,DF,25-29,Defender,Spain,Europe
433,José Callejón,ESP,Fiorentina,Serie A,2021,34.0,1987.0,14.4,15,6,6,6,3,13,31,41.9,18,6,0,6,3,18,1,1,FW,30-34,Forward,Spain,Europe
438,Víctor Camarasa,ESP,Betis,La Liga,2021,27.0,1994.0,1.2,2,1,1,1,0,0,1,0.0,1,2,1,1,2,4,2,0,"MF,FW",25-29,Midfielder,Spain,Europe
442,José Campaña,ESP,Levante,La Liga,2021,28.0,1993.0,15.8,27,16,13,10,4,12,32,37.5,20,13,2,11,21,48,19,1,MF,25-29,Midfielder,Spain,Europe
445,Sergio Canales,ESP,Betis,La Liga,2021,30.0,1991.0,31.0,24,14,8,12,4,10,35,28.6,25,16,1,15,10,34,12,0,"FW,MF",30-34,Forward,Spain,Europe
450,Sergi Canós,ESP,Brentford,Premier League,2021,24.0,1997.0,23.1,56,25,32,15,9,33,60,55.0,27,32,3,29,22,78,38,0,"DF,FW",20-24,Defender,Spain,Europe
453,Ander Capa,ESP,Athletic Club,La Liga,2021,29.0,1992.0,0.0,0,0,0,0,0,0,0,,0,0,0,0,0,0,0,0,DF,25-29,Defender,Spain,Europe
475,Matty Cash,POL,Aston Villa,Premier League,2021,23.0,1997.0,37.5,89,50,52,34,3,47,78,60.3,31,54,16,38,49,138,100,2,DF,20-24,Defender,Poland,Europe
476,Kiko Casilla,ESP,Elche,La Liga,2021,34.0,1986.0,14.0,0,0,0,0,0,0,1,0.0,1,0,0,0,1,1,2,2,GK,30-34,Goalkeeper,Spain,Europe
482,Samu Castillejo,ESP,Milan,Serie A,2021,26.0,1995.0,1.4,4,2,0,2,2,1,8,12.5,7,4,1,3,2,6,1,0,"FW,MF",25-29,Forward,Spain,Europe
488,Craig Cathcart,NIR,Watford,Premier League,2021,32.0,1989.0,26.6,32,15,25,6,1,16,30,53.3,14,39,29,10,28,60,132,3,DF,30-34,Defender,Northern Ireland,Europe
490,Dani Ceballos,ESP,Real Madrid,La Liga,2021,24.0,1996.0,3.1,7,5,4,3,0,1,5,20.0,4,8,2,6,4,11,2,0,MF,20-24,Midfielder,Spain,Europe
524,Pedro Chirivella,ESP,Nantes,Ligue 1,2021,24.0,1997.0,29.3,49,31,14,26,9,25,70,35.7,45,23,2,21,37,86,11,0,MF,20-24,Midfielder,Spain,Europe
531,Víctor Chust,ESP,Cádiz,La Liga,2021,21.0,2000.0,20.3,19,10,14,4,1,11,17,64.7,6,20,8,12,16,35,87,0,DF,20-24,Defender,Spain,Europe
540,Carlos Clerc,ESP,Levante,La Liga,2021,29.0,1992.0,16.8,35,17,21,10,4,7,19,36.8,12,8,3,5,26,61,32,1,DF,25-29,Defender,Spain,Europe
545,Coke,ESP,Levante,La Liga,2021,34.0,1987.0,1.3,3,2,1,1,1,3,4,75.0,1,1,0,1,2,5,7,0,DF,30-34,Defender,Spain,Europe
547,Álex Collado,ESP,Granada,La Liga,2021,22.0,1999.0,11.3,27,12,6,16,5,12,31,38.7,19,28,2,26,6,33,11,0,"MF,FW",20-24,Midfielder,Spain,Europe
553,Santi Comesaña,ESP,Rayo Vallecano,La Liga,2021,24.0,1996.0,29.8,87,56,45,33,9,40,104,38.5,64,46,6,40,33,120,30,0,MF,20-24,Midfielder,Spain,Europe
554,Diego Conde,ESP,Getafe,La Liga,2021,22.0,1998.0,0.1,0,0,0,0,0,0,0,,0,0,0,0,0,0,0,0,GK,20-24,Goalkeeper,Spain,Europe
577,Jaume Costa,ESP,Mallorca,La Liga,2021,33.0,1988.0,20.3,35,26,23,7,5,23,31,74.2,8,22,7,15,23,58,55,0,DF,30-34,Defender,Spain,Europe
579,Vladimír Coufal,CZE,West Ham,Premier League,2021,28.0,1992.0,24.5,45,25,24,14,7,18,36,50.0,18,31,9,22,22,67,64,1,DF,25-29,Defender,Czech Republic,Europe
600,Marc Cucurella,ESP,Brighton,Premier League,2021,23.0,1998.0,34.3,93,62,43,32,18,44,71,62.0,27,42,14,28,30,123,74,0,DF,20-24,Defender,Spain,Europe
601,Marc Cucurella,ESP,Getafe,La Liga,2021,23.0,1998.0,0.3,0,0,0,0,0,0,0,,0,0,0,0,0,0,0,0,"MF,DF",20-24,Midfielder,Spain,Europe
602,Jorge Cuenca,ESP,Getafe,La Liga,2021,21.0,1999.0,29.8,46,32,30,15,1,21,28,75.0,7,29,14,15,39,85,155,0,DF,20-24,Defender,Spain,Europe
621,Stuart Dallas,NIR,Leeds United,Premier League,2021,30.0,1991.0,32.4,93,55,58,31,4,56,105,53.3,49,45,14,31,57,150,63,2,"DF,MF",30-34,Defender,Northern Ireland,Europe
631,Sergi Darder,ESP,Espanyol,La Liga,2021,27.0,1993.0,34.7,45,22,16,19,10,18,54,33.3,36,16,1,15,26,71,32,1,MF,25-29,Midfielder,Spain,Europe
641,Paweł Dawidowicz,POL,Hellas Verona,Serie A,2021,26.0,1995.0,13.3,30,18,16,10,4,16,25,64.0,9,14,11,3,21,51,53,0,DF,25-29,Defender,Poland,Europe
681,Gerard Deulofeu,ESP,Udinese,Serie A,2021,27.0,1994.0,29.1,11,6,2,3,6,7,29,24.1,22,14,0,14,9,20,4,0,"FW,MF",25-29,Forward,Spain,Europe
706,Víctor Díaz,ESP,Granada,La Liga,2021,33.0,1988.0,16.7,23,15,14,9,0,12,25,48.0,13,19,11,8,17,40,71,1,DF,30-34,Defender,Spain,Europe
730,Djené,TOG,Getafe,La Liga,2021,29.0,1991.0,34.6,44,26,24,16,4,23,34,67.6,11,24,5,19,59,103,109,2,DF,25-29,Defender,Togo,Africa
743,Jaume Doménech,ESP,Valencia,La Liga,2021,30.0,1990.0,3.8,0,0,0,0,0,0,0,,0,0,0,0,0,0,3,1,GK,30-34,Goalkeeper,Spain,Europe
771,Rubén Duarte,ESP,Alavés,La Liga,2021,25.0,1995.0,29.1,76,47,43,27,6,43,85,50.6,42,40,6,34,57,133,82,0,DF,25-29,Defender,Spain,Europe
777,Unai Dufur,ESP,Osasuna,La Liga,2021,22.0,1999.0,1.0,0,0,0,0,0,0,0,,0,1,0,1,4,4,4,0,DF,20-24,Defender,Spain,Europe
783,Hugo Duro,ESP,Getafe,La Liga,2021,21.0,1999.0,0.1,0,0,0,0,0,0,0,,0,0,0,0,0,0,0,0,"DF,MF",20-24,Defender,Spain,Europe
784,Hugo Duro,ESP,Valencia,La Liga,2021,21.0,1999.0,20.4,25,19,11,13,1,15,38,39.5,23,24,2,22,4,29,20,1,"FW,MF",20-24,Forward,Spain,Europe
803,Alberth Elis,HON,Bordeaux,Ligue 1,2021,25.0,1996.0,15.7,19,10,5,5,9,11,25,44.0,14,9,0,9,7,26,10,0,"FW,MF",25-29,Forward,Honduras,North America
807,Aritz Elustondo,ESP,Real Sociedad,La Liga,2021,27.0,1994.0,23.4,21,14,16,5,0,10,20,50.0,10,19,13,6,29,50,86,0,DF,25-29,Defender,Spain,Europe
822,Aarón Escandell,ESP,Granada,La Liga,2021,25.0,1995.0,3.2,0,0,0,0,0,0,1,0.0,1,0,0,0,0,0,4,0,GK,25-29,Goalkeeper,Spain,Europe
823,Sergio Escudero,ESP,Granada,La Liga,2021,31.0,1989.0,15.9,46,24,25,17,4,26,54,48.1,28,18,3,15,26,72,35,0,"DF,MF",30-34,Defender,Spain,Europe
830,Jonny Evans,NIR,Leicester City,Premier League,2021,33.0,1988.0,15.0,24,14,14,8,2,14,22,63.6,8,17,13,4,20,44,59,0,DF,30-34,Defender,Northern Ireland,Europe
836,Cesc Fàbregas,ESP,Monaco,Ligue 1,2021,34.0,1987.0,0.4,1,0,0,1,0,1,1,100.0,0,0,0,0,1,2,0,0,MF,30-34,Midfielder,Spain,Europe
844,Fali,ESP,Cádiz,La Liga,2021,27.0,1993.0,20.0,32,19,24,8,0,17,32,53.1,15,26,16,10,24,56,82,0,"DF,MF",25-29,Defender,Spain,Europe
853,Ansu Fati,ESP,Barcelona,La Liga,2021,18.0,2002.0,3.7,3,2,0,2,1,1,1,100.0,0,4,0,4,1,4,0,0,FW,Under 20,Forward,Spain,Europe
857,Aleix Febas,ESP,Mallorca,La Liga,2021,25.0,1996.0,1.3,4,1,0,4,0,2,4,50.0,2,0,0,0,0,4,0,0,MF,25-29,Midfielder,Spain,Europe
865,Kiko Femenía,ESP,Watford,Premier League,2021,30.0,1991.0,23.8,35,22,23,10,2,21,37,56.8,16,24,8,16,37,72,51,0,DF,30-34,Defender,Spain,Europe
870,Aitor Fernández,ESP,Levante,La Liga,2021,30.0,1991.0,13.0,2,1,2,0,0,2,2,100.0,0,0,0,0,0,2,7,0,GK,30-34,Goalkeeper,Spain,Europe
870,Aitor Fernández,ESP,Levante,La Liga,2021,30.0,1991.0,13.0,2,1,2,0,0,2,2,100.0,0,0,0,0,0,2,7,0,GK,30-34,Goalkeeper,Spain,Europe
870,Aitor Fernández,ESP,Levante,La Liga,2021,30.0,1991.0,13.0,2,1,2,0,0,2,2,100.0,0,0,0,0,0,2,7,0,GK,30-34,Goalkeeper,Spain,Europe
870,Aitor Fernández,ESP,Levante,La Liga,2021,30.0,1991.0,13.0,2,1,2,0,0,2,2,100.0,0,0,0,0,0,2,7,0,GK,30-34,Goalkeeper,Spain,Europe
871,Álex Fernández,ESP,Cádiz,La Liga,2021,28.0,1992.0,22.8,47,31,22,17,8,21,61,34.4,40,30,7,23,30,77,31,0,MF,25-29,Midfielder,Spain,Europe
872,Álvaro Fernández,ESP,Brentford,Premier League,2021,23.0,1998.0,12.0,0,0,0,0,0,0,0,,0,0,0,0,0,0,5,2,GK,20-24,Goalkeeper,Spain,Europe
872,Álvaro Fernández,ESP,Brentford,Premier League,2021,23.0,1998.0,12.0,0,0,0,0,0,0,0,,0,0,0,0,0,0,5,2,GK,20-24,Goalkeeper,Spain,Europe
872,Álvaro Fernández,ESP,Brentford,Premier League,2021,23.0,1998.0,12.0,0,0,0,0,0,0,0,,0,0,0,0,0,0,5,2,GK,20-24,Goalkeeper,Spain,Europe
872,Álvaro Fernández,ESP,Brentford,Premier League,2021,23.0,1998.0,12.0,0,0,0,0,0,0,0,,0,0,0,0,0,0,5,2,GK,20-24,Goalkeeper,Spain,Europe
880,Fidel,ESP,Elche,La Liga,2021,31.0,1989.0,25.1,44,23,18,17,9,14,57,24.6,43,9,1,8,7,51,20,0,MF,30-34,Midfielder,Spain,Europe
901,Pablo Fornals,ESP,West Ham,Premier League,2021,25.0,1996.0,31.1,54,28,21,21,12,22,84,26.2,62,49,2,47,27,81,16,1,"FW,MF",25-29,Forward,Spain,Europe
918,Enric Franquesa,ESP,Levante,La Liga,2021,24.0,1997.0,6.9,5,3,4,0,1,0,1,0.0,1,4,0,4,7,12,11,0,"DF,FW",20-24,Defender,Spain,Europe
930,Jorge de Frutos,ESP,Levante,La Liga,2021,24.0,1997.0,19.6,33,15,14,11,8,10,51,19.6,41,11,1,10,12,45,13,0,"MF,FW",20-24,Midfielder,Spain,Europe
931,Leo Fuhr Hjelde,NOR,Leeds United,Premier League,2021,17.0,2003.0,1.7,5,4,3,2,0,3,3,100.0,0,3,3,0,4,9,7,0,"MF,DF",Under 20,Midfielder,Norway,Europe
943,Javi Galán,ESP,Celta Vigo,La Liga,2021,26.0,1994.0,36.6,108,66,60,37,11,42,99,42.4,57,48,8,40,45,153,52,0,DF,25-29,Defender,Spain,Europe
944,Iñigo Ruiz de Galarreta,ESP,Mallorca,La Liga,2021,27.0,1993.0,15.3,40,21,14,21,5,14,30,46.7,16,16,2,14,20,60,21,0,MF,25-29,Midfielder,Spain,Europe
955,Álvaro García,ESP,Rayo Vallecano,La Liga,2021,28.0,1992.0,33.3,42,23,15,18,9,8,35,22.9,27,27,3,24,42,84,24,0,"FW,MF",25-29,Forward,Spain,Europe
955,Álvaro García,ESP,Rayo Vallecano,La Liga,2021,28.0,1992.0,33.3,42,23,15,18,9,8,35,22.9,27,27,3,24,42,84,24,0,"FW,MF",25-29,Forward,Spain,Europe
955,Álvaro García,ESP,Rayo Vallecano,La Liga,2021,28.0,1992.0,33.3,42,23,15,18,9,8,35,22.9,27,27,3,24,42,84,24,0,"FW,MF",25-29,Forward,Spain,Europe
955,Álvaro García,ESP,Rayo Vallecano,La Liga,2021,28.0,1992.0,33.3,42,23,15,18,9,8,35,22.9,27,27,3,24,42,84,24,0,"FW,MF",25-29,Forward,Spain,Europe
955,Álvaro García,ESP,Rayo Vallecano,La Liga,2021,28.0,1992.0,33.3,42,23,15,18,9,8,35,22.9,27,27,3,24,42,84,24,0,"FW,MF",25-29,Forward,Spain,Europe
955,Álvaro García,ESP,Rayo Vallecano,La Liga,2021,28.0,1992.0,33.3,42,23,15,18,9,8,35,22.9,27,27,3,24,42,84,24,0,"FW,MF",25-29,Forward,Spain,Europe
955,Álvaro García,ESP,Rayo Vallecano,La Liga,2021,28.0,1992.0,33.3,42,23,15,18,9,8,35,22.9,27,27,3,24,42,84,24,0,"FW,MF",25-29,Forward,Spain,Europe
955,Álvaro García,ESP,Rayo Vallecano,La Liga,2021,28.0,1992.0,33.3,42,23,15,18,9,8,35,22.9,27,27,3,24,42,84,24,0,"FW,MF",25-29,Forward,Spain,Europe
955,Álvaro García,ESP,Rayo Vallecano,La Liga,2021,28.0,1992.0,33.3,42,23,15,18,9,8,35,22.9,27,27,3,24,42,84,24,0,"FW,MF",25-29,Forward,Spain,Europe
955,Álvaro García,ESP,Rayo Vallecano,La Liga,2021,28.0,1992.0,33.3,42,23,15,18,9,8,35,22.9,27,27,3,24,42,84,24,0,"FW,MF",25-29,Forward,Spain,Europe
955,Álvaro García,ESP,Rayo Vallecano,La Liga,2021,28.0,1992.0,33.3,42,23,15,18,9,8,35,22.9,27,27,3,24,42,84,24,0,"FW,MF",25-29,Forward,Spain,Europe
955,Álvaro García,ESP,Rayo Vallecano,La Liga,2021,28.0,1992.0,33.3,42,23,15,18,9,8,35,22.9,27,27,3,24,42,84,24,0,"FW,MF",25-29,Forward,Spain,Europe
955,Álvaro García,ESP,Rayo Vallecano,La Liga,2021,28.0,1992.0,33.3,42,23,15,18,9,8,35,22.9,27,27,3,24,42,84,24,0,"FW,MF",25-29,Forward,Spain,Europe
955,Álvaro García,ESP,Rayo Vallecano,La Liga,2021,28.0,1992.0,33.3,42,23,15,18,9,8,35,22.9,27,27,3,24,42,84,24,0,"FW,MF",25-29,Forward,Spain,Europe
955,Álvaro García,ESP,Rayo Vallecano,La Liga,2021,28.0,1992.0,33.3,42,23,15,18,9,8,35,22.9,27,27,3,24,42,84,24,0,"FW,MF",25-29,Forward,Spain,Europe
955,Álvaro García,ESP,Rayo Vallecano,La Liga,2021,28.0,1992.0,33.3,42,23,15,18,9,8,35,22.9,27,27,3,24,42,84,24,0,"FW,MF",25-29,Forward,Spain,Europe
957,David García,ESP,Osasuna,La Liga,2021,27.0,1994.0,34.5,28,14,15,11,2,12,22,54.5,10,27,21,6,52,80,168,0,DF,25-29,Defender,Spain,Europe
957,David García,ESP,Osasuna,La Liga,2021,27.0,1994.0,34.5,28,14,15,11,2,12,22,54.5,10,27,21,6,52,80,168,0,DF,25-29,Defender,Spain,Europe
957,David García,ESP,Osasuna,La Liga,2021,27.0,1994.0,34.5,28,14,15,11,2,12,22,54.5,10,27,21,6,52,80,168,0,DF,25-29,Defender,Spain,Europe
957,David García,ESP,Osasuna,La Liga,2021,27.0,1994.0,34.5,28,14,15,11,2,12,22,54.5,10,27,21,6,52,80,168,0,DF,25-29,Defender,Spain,Europe
958,Eric García,ESP,Barcelona,La Liga,2021,20.0,2001.0,22.7,27,18,13,13,1,11,26,42.3,15,22,12,10,44,71,53,3,DF,20-24,Defender,Spain,Europe
960,Joan García,ESP,Espanyol,La Liga,2021,20.0,2001.0,1.2,0,0,0,0,0,0,0,,0,0,0,0,1,1,1,2,GK,20-24,Goalkeeper,Spain,Europe
961,Manu García,ESP,Alavés,La Liga,2021,23.0,1998.0,12.0,18,9,6,9,3,9,27,33.3,18,8,2,6,13,31,4,0,MF,20-24,Midfielder,Spain,Europe
961,Manu García,ESP,Alavés,La Liga,2021,23.0,1998.0,12.0,18,9,6,9,3,9,27,33.3,18,8,2,6,13,31,4,0,MF,20-24,Midfielder,Spain,Europe
961,Manu García,ESP,Alavés,La Liga,2021,23.0,1998.0,12.0,18,9,6,9,3,9,27,33.3,18,8,2,6,13,31,4,0,MF,20-24,Midfielder,Spain,Europe
961,Manu García,ESP,Alavés,La Liga,2021,23.0,1998.0,12.0,18,9,6,9,3,9,27,33.3,18,8,2,6,13,31,4,0,MF,20-24,Midfielder,Spain,Europe
962,Raúl García,ESP,Athletic Club,La Liga,2021,35.0,1986.0,20.0,27,17,6,11,10,8,36,22.2,28,30,4,26,9,36,21,0,FW,35-39,Forward,Spain,Europe
962,Raúl García,ESP,Athletic Club,La Liga,2021,35.0,1986.0,20.0,27,17,6,11,10,8,36,22.2,28,30,4,26,9,36,21,0,FW,35-39,Forward,Spain,Europe
962,Raúl García,ESP,Athletic Club,La Liga,2021,35.0,1986.0,20.0,27,17,6,11,10,8,36,22.2,28,30,4,26,9,36,21,0,FW,35-39,Forward,Spain,Europe
962,Raúl García,ESP,Athletic Club,La Liga,2021,35.0,1986.0,20.0,27,17,6,11,10,8,36,22.2,28,30,4,26,9,36,21,0,FW,35-39,Forward,Spain,Europe
963,Rubén García,ESP,Osasuna,La Liga,2021,28.0,1993.0,26.4,43,26,12,23,8,16,49,32.7,33,31,4,27,24,67,16,0,"MF,FW",25-29,Midfielder,Spain,Europe
963,Rubén García,ESP,Osasuna,La Liga,2021,28.0,1993.0,26.4,43,26,12,23,8,16,49,32.7,33,31,4,27,24,67,16,0,"MF,FW",25-29,Midfielder,Spain,Europe
963,Rubén García,ESP,Osasuna,La Liga,2021,28.0,1993.0,26.4,43,26,12,23,8,16,49,32.7,33,31,4,27,24,67,16,0,"MF,FW",25-29,Midfielder,Spain,Europe
963,Rubén García,ESP,Osasuna,La Liga,2021,28.0,1993.0,26.4,43,26,12,23,8,16,49,32.7,33,31,4,27,24,67,16,0,"MF,FW",25-29,Midfielder,Spain,Europe
964,Saúl García,ESP,Alavés,La Liga,2021,26.0,1994.0,0.0,1,1,1,0,0,0,0,,0,0,0,0,0,1,0,0,MF,25-29,Midfielder,Spain,Europe
965,Unai García,ESP,Osasuna,La Liga,2021,29.0,1992.0,15.6,21,12,14,6,1,14,17,82.4,3,19,11,8,22,43,78,0,DF,25-29,Defender,Spain,Europe
967,Mario Gaspar,ESP,Villarreal,La Liga,2021,30.0,1990.0,6.9,10,4,2,5,3,6,10,60.0,4,6,3,3,6,16,15,0,DF,30-34,Defender,Spain,Europe
970,Gavi,ESP,Barcelona,La Liga,2021,16.0,2004.0,25.7,38,18,13,18,7,9,33,27.3,24,36,0,36,25,63,13,0,"MF,FW",Under 20,Midfielder,Spain,Europe
973,David de Gea,ESP,Manchester Utd,Premier League,2021,30.0,1990.0,38.0,0,0,0,0,0,0,0,,0,0,0,0,0,0,11,2,GK,30-34,Goalkeeper,Spain,Europe
995,Bryan Gil,ESP,Tottenham,Premier League,2021,20.0,2001.0,1.0,3,0,1,0,2,1,2,50.0,1,2,0,2,0,3,0,0,"FW,MF",20-24,Forward,Spain,Europe
996,Bryan Gil,ESP,Valencia,La Liga,2021,20.0,2001.0,8.4,13,8,6,3,4,2,13,15.4,11,13,0,13,1,14,4,0,"MF,FW",20-24,Midfielder,Spain,Europe
997,Óscar Gil,ESP,Espanyol,La Liga,2021,24.0,1997.0,18.8,52,35,27,20,5,25,46,54.3,21,33,9,24,19,71,33,2,DF,20-24,Defender,Spain,Europe
997,Óscar Gil,ESP,Espanyol,La Liga,2021,24.0,1997.0,18.8,52,35,27,20,5,25,46,54.3,21,33,9,24,19,71,33,2,DF,20-24,Defender,Spain,Europe
997,Óscar Gil,ESP,Espanyol,La Liga,2021,24.0,1997.0,18.8,52,35,27,20,5,25,46,54.3,21,33,9,24,19,71,33,2,DF,20-24,Defender,Spain,Europe
997,Óscar Gil,ESP,Espanyol,La Liga,2021,24.0,1997.0,18.8,52,35,27,20,5,25,46,54.3,21,33,9,24,19,71,33,2,DF,20-24,Defender,Spain,Europe
998,Mario Gila,ESP,Real Madrid,La Liga,2021,20.0,2000.0,0.3,1,0,1,0,0,0,1,0.0,1,0,0,0,1,2,1,0,DF,20-24,Defender,Spain,Europe
1017,Dani Gómez,ESP,Levante,La Liga,2021,23.0,1998.0,11.8,7,4,3,2,2,4,12,33.3,8,3,0,3,3,10,5,0,FW,20-24,Forward,Spain,Europe
1020,Moi Gómez,ESP,Villarreal,La Liga,2021,27.0,1994.0,14.3,15,7,8,3,4,5,17,29.4,12,5,0,5,6,21,6,0,"MF,FW",25-29,Midfielder,Spain,Europe
1022,Sergi Gómez,ESP,Espanyol,La Liga,2021,29.0,1992.0,30.2,33,24,29,3,1,18,27,66.7,9,33,23,10,40,73,125,2,DF,25-29,Defender,Spain,Europe
1028,Álvaro González,ESP,Marseille,Ligue 1,2021,31.0,1990.0,5.0,1,1,1,0,0,1,1,100.0,0,0,0,0,1,2,9,0,DF,30-34,Defender,Spain,Europe
1028,Álvaro González,ESP,Marseille,Ligue 1,2021,31.0,1990.0,5.0,1,1,1,0,0,1,1,100.0,0,0,0,0,1,2,9,0,DF,30-34,Defender,Spain,Europe
1028,Álvaro González,ESP,Marseille,Ligue 1,2021,31.0,1990.0,5.0,1,1,1,0,0,1,1,100.0,0,0,0,0,1,2,9,0,DF,30-34,Defender,Spain,Europe
1028,Álvaro González,ESP,Marseille,Ligue 1,2021,31.0,1990.0,5.0,1,1,1,0,0,1,1,100.0,0,0,0,0,1,2,9,0,DF,30-34,Defender,Spain,Europe
1029,Diego González,ESP,Elche,La Liga,2021,26.0,1995.0,19.9,25,16,18,7,0,9,16,56.3,7,21,13,8,19,44,87,0,DF,25-29,Defender,Spain,Europe
1029,Diego González,ESP,Elche,La Liga,2021,26.0,1995.0,19.9,25,16,18,7,0,9,16,56.3,7,21,13,8,19,44,87,0,DF,25-29,Defender,Spain,Europe
1029,Diego González,ESP,Elche,La Liga,2021,26.0,1995.0,19.9,25,16,18,7,0,9,16,56.3,7,21,13,8,19,44,87,0,DF,25-29,Defender,Spain,Europe
1029,Diego González,ESP,Elche,La Liga,2021,26.0,1995.0,19.9,25,16,18,7,0,9,16,56.3,7,21,13,8,19,44,87,0,DF,25-29,Defender,Spain,Europe
1039,Gori,ESP,Espanyol,La Liga,2021,19.0,2002.0,0.1,0,0,0,0,0,0,0,,0,2,0,2,0,0,0,0,MF,Under 20,Midfielder,Spain,Europe
1040,Andoni Gorosabel,ESP,Real Sociedad,La Liga,2021,24.0,1996.0,25.4,47,31,32,9,6,25,47,53.2,22,16,3,13,18,65,49,0,DF,20-24,Defender,Spain,Europe
1072,Vicente Guaita,ESP,Crystal Palace,Premier League,2021,34.0,1987.0,29.5,1,0,1,0,0,1,1,100.0,0,0,0,0,1,2,8,1,GK,30-34,Goalkeeper,Spain,Europe
1074,Sergi Guardiola,ESP,Rayo Vallecano,La Liga,2021,30.0,1991.0,19.0,10,9,3,5,2,1,21,4.8,20,14,2,12,4,14,17,0,FW,30-34,Forward,Spain,Europe
1075,Nemanja Gudelj,SRB,Sevilla,La Liga,2021,29.0,1991.0,11.6,16,7,10,4,2,5,8,62.5,3,14,9,5,22,38,37,0,"DF,MF",25-29,Defender,Serbia,Europe
1084,Ander Guevara,ESP,Real Sociedad,La Liga,2021,24.0,1997.0,9.6,18,13,6,10,2,10,17,58.8,7,12,6,6,12,30,8,0,MF,20-24,Midfielder,Spain,Europe
1091,Hugo Guillamón,ESP,Valencia,La Liga,2021,21.0,2000.0,26.2,43,27,20,16,7,18,44,40.9,26,26,10,16,30,73,53,1,"MF,DF",20-24,Midfielder,Spain,Europe
1097,Gerard Gumbau,ESP,Elche,La Liga,2021,26.0,1994.0,21.0,46,19,22,19,5,22,51,43.1,29,18,4,14,23,69,25,0,MF,25-29,Midfielder,Spain,Europe
1098,Robert Gumny,POL,Augsburg,Bundesliga,2021,23.0,1998.0,25.2,48,29,25,20,3,25,43,58.1,18,24,7,17,28,76,57,3,DF,20-24,Defender,Poland,Europe
1104,Jon Guridi,ESP,Real Sociedad,La Liga,2021,26.0,1995.0,2.3,5,3,2,3,0,1,4,25.0,3,3,1,2,3,8,4,0,MF,25-29,Midfielder,Spain,Europe
1106,Raúl Guti,ESP,Elche,La Liga,2021,24.0,1996.0,18.1,25,15,7,14,4,10,30,33.3,20,9,3,6,25,50,7,0,MF,20-24,Midfielder,Spain,Europe
1108,Miguel Gutiérrez,ESP,Real Madrid,La Liga,2021,20.0,2001.0,2.9,7,5,5,0,2,3,5,60.0,2,0,0,0,2,9,2,0,DF,20-24,Defender,Spain,Europe
1113,Erling Haaland,NOR,Dortmund,Bundesliga,2021,21.0,2000.0,21.2,2,1,0,1,1,0,1,0.0,1,8,1,7,1,3,31,0,FW,20-24,Forward,Norway,Europe
1163,Kike Hermoso,ESP,Betis,La Liga,2021,21.0,1999.0,1.0,2,1,2,0,0,2,2,100.0,0,2,1,1,0,2,5,1,DF,20-24,Defender,Spain,Europe
1164,Mario Hermoso,ESP,Atlético Madrid,La Liga,2021,26.0,1995.0,20.7,30,15,23,4,3,20,38,52.6,18,18,3,15,29,59,49,2,DF,25-29,Defender,Spain,Europe
1165,Aridane Hernández,ESP,Osasuna,La Liga,2021,32.0,1989.0,12.9,12,9,10,2,0,3,13,23.1,10,11,9,2,20,32,71,0,DF,30-34,Defender,Spain,Europe
1167,Luis Hernández,ESP,Cádiz,La Liga,2021,32.0,1989.0,15.2,9,5,9,0,0,5,8,62.5,3,5,3,2,16,25,34,0,DF,30-34,Defender,Spain,Europe
1168,Mario Hernández,ESP,Rayo Vallecano,La Liga,2021,22.0,1999.0,4.4,10,4,7,3,0,5,9,55.6,4,1,0,1,4,14,7,0,"DF,FW",20-24,Defender,Spain,Europe
1171,Ander Herrera,ESP,Paris S-G,Ligue 1,2021,31.0,1989.0,12.1,29,17,7,16,6,14,39,35.9,25,22,8,14,14,43,8,0,MF,30-34,Midfielder,Spain,Europe
1173,Sergio Herrera,ESP,Osasuna,La Liga,2021,28.0,1993.0,36.0,3,2,3,0,0,3,6,50.0,3,1,0,1,1,4,18,0,GK,25-29,Goalkeeper,Spain,Europe
1220,Borja Iglesias,ESP,Betis,La Liga,2021,28.0,1993.0,17.5,6,4,1,2,3,0,8,0.0,8,11,1,10,4,10,7,0,FW,25-29,Forward,Spain,Europe
1228,Ivan Ilić,SRB,Hellas Verona,Serie A,2021,20.0,2001.0,28.1,39,18,16,19,4,20,54,37.0,34,34,12,22,22,61,55,0,MF,20-24,Midfielder,Serbia,Europe
1230,Asier Illarramendi,ESP,Real Sociedad,La Liga,2021,31.0,1990.0,4.2,9,5,5,3,1,1,10,10.0,9,5,1,4,4,13,12,0,MF,30-34,Midfielder,Spain,Europe
1242,Isco,ESP,Real Madrid,La Liga,2021,29.0,1992.0,3.7,9,5,4,4,1,5,12,41.7,7,1,0,1,2,11,1,0,"MF,FW",25-29,Midfielder,Spain,Europe
1262,Jakub Jankto,CZE,Getafe,La Liga,2021,25.0,1996.0,6.5,11,7,5,5,1,10,17,58.8,7,4,0,4,4,15,7,0,"DF,MF",25-29,Defender,Czech Republic,Europe
1270,Dennis Jastrzembski,POL,Hertha BSC,Bundesliga,2021,21.0,2000.0,2.5,2,1,1,1,0,2,8,25.0,6,1,0,1,5,7,3,0,"DF,FW",20-24,Defender,Poland,Europe
1279,Álvaro Jiménez,ESP,Cádiz,La Liga,2021,26.0,1995.0,2.6,6,3,3,2,1,4,7,57.1,3,3,0,3,3,9,0,0,"MF,FW",25-29,Midfielder,Spain,Europe
1282,Joaquín,ESP,Betis,La Liga,2021,40.0,1981.0,5.2,6,2,4,2,0,3,8,37.5,5,5,2,3,3,9,10,0,"FW,MF",Over 40,Forward,Spain,Europe
1286,Dennis Johnsen,NOR,Venezia,Serie A,2021,23.0,1998.0,16.1,14,10,8,4,2,6,18,33.3,12,14,1,13,5,19,3,0,"FW,MF",20-24,Forward,Norway,Europe
1292,Joan Jordán,ESP,Sevilla,La Liga,2021,27.0,1994.0,27.9,61,30,22,31,8,28,65,43.1,37,27,6,21,30,91,18,1,MF,25-29,Midfielder,Spain,Europe
1295,Josan,ESP,Elche,La Liga,2021,31.0,1989.0,13.5,36,22,23,9,4,26,44,59.1,18,11,4,7,10,46,21,0,"DF,MF",30-34,Defender,Spain,Europe
1297,Joselu,ESP,Alavés,La Liga,2021,31.0,1990.0,34.7,16,11,1,9,6,7,25,28.0,18,21,4,17,7,23,45,0,FW,30-34,Forward,Spain,Europe
1298,Josema,ESP,Elche,La Liga,2021,25.0,1996.0,2.0,3,2,1,1,1,0,2,0.0,2,1,1,0,0,3,11,0,DF,25-29,Defender,Spain,Europe
1302,Luka Jović,SRB,Real Madrid,La Liga,2021,23.0,1997.0,4.1,1,1,0,1,0,0,1,0.0,1,3,0,3,1,2,4,0,FW,20-24,Forward,Serbia,Europe
1305,Juanmi,ESP,Betis,La Liga,2021,28.0,1993.0,23.7,39,25,11,19,9,19,49,38.8,30,24,1,23,9,48,10,1,FW,25-29,Forward,Spain,Europe
1336,Kevin Kampl,SVN,RB Leipzig,Bundesliga,2021,30.0,1990.0,21.1,41,19,16,20,5,10,42,23.8,32,24,5,19,24,65,17,0,MF,30-34,Midfielder,Slovenia,Europe
1376,Joshua King,NOR,Watford,Premier League,2021,29.0,1992.0,25.0,19,15,7,6,6,4,17,23.5,13,15,4,11,8,27,31,0,FW,25-29,Forward,Norway,Europe
1377,Jakub Kiwior,POL,Spezia,Serie A,2021,21.0,2000.0,21.8,50,27,25,19,6,26,57,45.6,31,38,15,23,40,90,53,0,MF,20-24,Midfielder,Poland,Europe
1380,Kristoffer Klaesson,NOR,Leeds United,Premier League,2021,20.0,2000.0,0.4,0,0,0,0,0,0,0,,0,0,0,0,0,0,0,0,GK,20-24,Goalkeeper,Norway,Europe
1382,Mateusz Klich,POL,Leeds United,Premier League,2021,31.0,1990.0,23.0,47,25,18,23,6,25,66,37.9,41,22,4,18,11,58,20,0,MF,30-34,Midfielder,Poland,Europe
1398,Koke,ESP,Atlético Madrid,La Liga,2021,29.0,1992.0,27.9,55,30,19,29,7,26,63,41.3,37,21,5,16,24,79,31,1,MF,25-29,Midfielder,Spain,Europe
1400,Aleksandar Kolarov,SRB,Inter,Serie A,2021,35.0,1985.0,0.5,1,1,1,0,0,1,1,100.0,0,0,0,0,1,2,2,0,DF,35-39,Defender,Serbia,Europe
1426,Alex Král,CZE,West Ham,Premier League,2021,23.0,1998.0,0.0,0,0,0,0,0,0,0,,0,0,0,0,0,0,0,0,MF,20-24,Midfielder,Czech Republic,Europe
1430,Julian Kristoffersen,NOR,Salernitana,Serie A,2021,24.0,1997.0,0.1,0,0,0,0,0,0,0,,0,0,0,0,0,0,0,0,FW,20-24,Forward,Norway,Europe
1456,Víctor Laguardia,ESP,Alavés,La Liga,2021,31.0,1989.0,33.8,29,16,21,8,0,19,30,63.3,11,36,24,12,27,56,151,1,DF,30-34,Defender,Spain,Europe
1469,Aymeric Laporte,ESP,Manchester City,Premier League,2021,27.0,1994.0,31.4,33,15,22,10,1,14,20,70.0,6,15,10,5,20,53,64,2,DF,25-29,Defender,Spain,Europe
1476,Juanmi Latasa,ESP,Real Madrid,La Liga,2021,20.0,2001.0,0.1,0,0,0,0,0,0,0,,0,0,0,0,0,0,0,0,FW,20-24,Forward,Spain,Europe
1477,Toni Lato,ESP,Valencia,La Liga,2021,23.0,1997.0,6.6,17,12,12,3,2,9,16,56.3,7,6,0,6,8,25,14,0,DF,20-24,Defender,Spain,Europe
1479,Darko Lazović,SRB,Hellas Verona,Serie A,2021,30.0,1990.0,30.7,36,23,20,8,8,21,39,53.8,18,28,4,24,19,55,49,1,DF,30-34,Defender,Serbia,Europe
1486,Robin Le Normand,ESP,Real Sociedad,La Liga,2021,24.0,1996.0,37.0,49,32,36,8,5,28,36,77.8,8,34,22,12,48,97,125,0,DF,20-24,Defender,Spain,Europe
1496,Iñigo Lekue,ESP,Athletic Club,La Liga,2021,28.0,1993.0,21.4,32,23,16,12,4,22,44,50.0,22,37,12,25,23,55,63,0,DF,25-29,Defender,Spain,Europe
1509,Robert Lewandowski,POL,Bayern Munich,Bundesliga,2021,32.0,1988.0,32.7,10,3,0,6,4,5,17,29.4,12,17,2,15,6,16,8,0,FW,30-34,Forward,Poland,Europe
1511,Jamal Lewis,NIR,Newcastle Utd,Premier League,2021,23.0,1998.0,2.9,8,6,6,1,1,3,4,75.0,1,3,2,1,3,11,8,0,DF,20-24,Defender,Northern Ireland,Europe
1523,Karol Linetty,POL,Torino,Serie A,2021,26.0,1995.0,10.0,14,8,3,4,7,6,18,33.3,12,8,0,8,3,17,2,0,"MF,FW",25-29,Midfielder,Poland,Europe
1525,Pol Lirola,ESP,Marseille,Ligue 1,2021,23.0,1997.0,19.7,28,16,15,9,4,13,28,46.4,15,15,0,15,13,41,22,0,"DF,FW",20-24,Defender,Spain,Europe
1529,Diego Llorente,ESP,Leeds United,Premier League,2021,27.0,1993.0,26.0,53,31,32,19,2,33,47,70.2,14,35,17,18,40,93,77,2,DF,25-29,Defender,Spain,Europe
1529,Diego Llorente,ESP,Leeds United,Premier League,2021,27.0,1993.0,26.0,53,31,32,19,2,33,47,70.2,14,35,17,18,40,93,77,2,DF,25-29,Defender,Spain,Europe
1529,Diego Llorente,ESP,Leeds United,Premier League,2021,27.0,1993.0,26.0,53,31,32,19,2,33,47,70.2,14,35,17,18,40,93,77,2,DF,25-29,Defender,Spain,Europe
1529,Diego Llorente,ESP,Leeds United,Premier League,2021,27.0,1993.0,26.0,53,31,32,19,2,33,47,70.2,14,35,17,18,40,93,77,2,DF,25-29,Defender,Spain,Europe
1530,Marcos Llorente,ESP,Atlético Madrid,La Liga,2021,26.0,1995.0,27.2,51,23,25,22,4,28,43,65.1,15,33,10,23,27,78,44,0,"MF,DF",25-29,Midfielder,Spain,Europe
1547,David López,ESP,Espanyol,La Liga,2021,31.0,1989.0,8.3,18,13,9,8,1,9,16,56.3,7,10,8,2,10,28,25,2,"MF,DF",30-34,Midfielder,Spain,Europe
1547,David López,ESP,Espanyol,La Liga,2021,31.0,1989.0,8.3,18,13,9,8,1,9,16,56.3,7,10,8,2,10,28,25,2,"MF,DF",30-34,Midfielder,Spain,Europe
1547,David López,ESP,Espanyol,La Liga,2021,31.0,1989.0,8.3,18,13,9,8,1,9,16,56.3,7,10,8,2,10,28,25,2,"MF,DF",30-34,Midfielder,Spain,Europe
1547,David López,ESP,Espanyol,La Liga,2021,31.0,1989.0,8.3,18,13,9,8,1,9,16,56.3,7,10,8,2,10,28,25,2,"MF,DF",30-34,Midfielder,Spain,Europe
1548,Diego López,ESP,Espanyol,La Liga,2021,39.0,1981.0,35.3,0,0,0,0,0,0,2,0.0,2,0,0,0,1,1,21,1,GK,35-39,Goalkeeper,Spain,Europe
1548,Diego López,ESP,Espanyol,La Liga,2021,39.0,1981.0,35.3,0,0,0,0,0,0,2,0.0,2,0,0,0,1,1,21,1,GK,35-39,Goalkeeper,Spain,Europe
1548,Diego López,ESP,Espanyol,La Liga,2021,39.0,1981.0,35.3,0,0,0,0,0,0,2,0.0,2,0,0,0,1,1,21,1,GK,35-39,Goalkeeper,Spain,Europe
1548,Diego López,ESP,Espanyol,La Liga,2021,39.0,1981.0,35.3,0,0,0,0,0,0,2,0.0,2,0,0,0,1,1,21,1,GK,35-39,Goalkeeper,Spain,Europe
1548,Diego López,ESP,Espanyol,La Liga,2021,39.0,1981.0,35.3,0,0,0,0,0,0,2,0.0,2,0,0,0,1,1,21,1,GK,35-39,Goalkeeper,Spain,Europe
1548,Diego López,ESP,Espanyol,La Liga,2021,39.0,1981.0,35.3,0,0,0,0,0,0,2,0.0,2,0,0,0,1,1,21,1,GK,35-39,Goalkeeper,Spain,Europe
1548,Diego López,ESP,Espanyol,La Liga,2021,39.0,1981.0,35.3,0,0,0,0,0,0,2,0.0,2,0,0,0,1,1,21,1,GK,35-39,Goalkeeper,Spain,Europe
1548,Diego López,ESP,Espanyol,La Liga,2021,39.0,1981.0,35.3,0,0,0,0,0,0,2,0.0,2,0,0,0,1,1,21,1,GK,35-39,Goalkeeper,Spain,Europe
1548,Diego López,ESP,Espanyol,La Liga,2021,39.0,1981.0,35.3,0,0,0,0,0,0,2,0.0,2,0,0,0,1,1,21,1,GK,35-39,Goalkeeper,Spain,Europe
1549,Javi López,ESP,Alavés,La Liga,2021,19.0,2002.0,5.1,8,6,6,2,0,4,6,66.7,2,7,1,6,4,12,15,0,DF,Under 20,Defender,Spain,Europe
1549,Javi López,ESP,Alavés,La Liga,2021,19.0,2002.0,5.1,8,6,6,2,0,4,6,66.7,2,7,1,6,4,12,15,0,DF,Under 20,Defender,Spain,Europe
1549,Javi López,ESP,Alavés,La Liga,2021,19.0,2002.0,5.1,8,6,6,2,0,4,6,66.7,2,7,1,6,4,12,15,0,DF,Under 20,Defender,Spain,Europe
1549,Javi López,ESP,Alavés,La Liga,2021,19.0,2002.0,5.1,8,6,6,2,0,4,6,66.7,2,7,1,6,4,12,15,0,DF,Under 20,Defender,Spain,Europe
1551,Pau López,ESP,Marseille,Ligue 1,2021,26.0,1994.0,29.0,0,0,0,0,0,0,1,0.0,1,0,0,0,0,0,12,1,GK,25-29,Goalkeeper,Spain,Europe
1552,Unai López,ESP,Rayo Vallecano,La Liga,2021,25.0,1995.0,12.9,19,9,6,10,3,10,33,30.3,23,7,0,7,10,29,8,1,MF,25-29,Midfielder,Spain,Europe
1557,Marcel Lotka,POL,Hertha BSC,Bundesliga,2021,20.0,2001.0,9.8,1,0,1,0,0,1,1,100.0,0,0,0,0,1,2,3,3,GK,20-24,Goalkeeper,Poland,Europe
1572,José Luis Morales,ESP,Levante,La Liga,2021,34.0,1987.0,30.2,27,17,6,9,12,12,42,28.6,30,29,0,29,4,31,7,0,"FW,MF",30-34,Forward,Spain,Europe
1580,Saša Lukić,SRB,Torino,Serie A,2021,24.0,1996.0,33.1,51,34,17,27,7,19,43,44.2,24,34,6,28,24,75,41,0,MF,20-24,Midfielder,Serbia,Europe
1595,Pablo Maffeo,ESP,Mallorca,La Liga,2021,24.0,1997.0,32.7,84,47,48,28,8,38,69,55.1,31,30,13,17,46,130,74,0,DF,20-24,Defender,Spain,Europe
1618,Nikola Maksimović,SRB,Genoa,Serie A,2021,29.0,1991.0,12.4,14,6,10,4,0,7,9,77.8,2,17,11,6,12,26,61,1,DF,25-29,Defender,Serbia,Europe
1645,Javier Manquillo,ESP,Newcastle Utd,Premier League,2021,27.0,1994.0,14.0,39,29,28,10,1,21,36,58.3,15,15,6,9,10,49,32,0,DF,25-29,Defender,Spain,Europe
1658,Óscar de Marcos,ESP,Athletic Club,La Liga,2021,32.0,1989.0,18.7,50,37,24,19,7,28,43,65.1,15,20,3,17,19,69,27,0,DF,30-34,Defender,Spain,Europe
1660,José Mari,ESP,Cádiz,La Liga,2021,33.0,1987.0,4.3,14,7,3,10,1,7,8,87.5,1,4,1,3,7,21,2,0,MF,30-34,Midfielder,Spain,Europe
1661,Pablo Marí,ESP,Arsenal,Premier League,2021,27.0,1993.0,2.0,5,3,1,3,1,3,6,50.0,3,5,4,1,3,8,10,0,DF,25-29,Defender,Spain,Europe
1662,Pablo Marí,ESP,Udinese,Serie A,2021,27.0,1993.0,14.9,16,8,8,6,2,8,16,50.0,8,18,12,6,21,37,72,0,DF,25-29,Defender,Spain,Europe
1671,Roger Martí,ESP,Levante,La Liga,2021,30.0,1991.0,23.5,23,14,3,13,7,8,30,26.7,22,14,0,14,2,25,8,0,FW,30-34,Forward,Spain,Europe
1675,Aarón Martín,ESP,Mainz 05,Bundesliga,2021,24.0,1997.0,25.5,54,33,32,18,4,24,55,43.6,31,24,4,20,20,74,35,0,DF,20-24,Defender,Spain,Europe
1677,Andrés Martín,ESP,Rayo Vallecano,La Liga,2021,22.0,1999.0,2.1,0,0,0,0,0,0,1,0.0,1,1,0,1,0,0,0,0,"FW,MF",20-24,Forward,Spain,Europe
1679,Iván Martín,ESP,Alavés,La Liga,2021,22.0,1999.0,1.8,1,1,1,0,0,0,1,0.0,1,2,0,2,1,2,1,0,"MF,FW",20-24,Midfielder,Spain,Europe
1683,Iñigo Martínez,ESP,Athletic Club,La Liga,2021,30.0,1991.0,26.0,28,13,18,7,3,14,23,60.9,9,22,10,12,39,67,143,0,DF,30-34,Defender,Spain,Europe
1684,Javi Martínez,ESP,Osasuna,La Liga,2021,21.0,1999.0,9.8,21,14,8,11,2,10,29,34.5,19,6,0,6,9,30,10,0,"MF,FW",20-24,Midfielder,Spain,Europe
1684,Javi Martínez,ESP,Osasuna,La Liga,2021,21.0,1999.0,9.8,21,14,8,11,2,10,29,34.5,19,6,0,6,9,30,10,0,"MF,FW",20-24,Midfielder,Spain,Europe
1684,Javi Martínez,ESP,Osasuna,La Liga,2021,21.0,1999.0,9.8,21,14,8,11,2,10,29,34.5,19,6,0,6,9,30,10,0,"MF,FW",20-24,Midfielder,Spain,Europe
1684,Javi Martínez,ESP,Osasuna,La Liga,2021,21.0,1999.0,9.8,21,14,8,11,2,10,29,34.5,19,6,0,6,9,30,10,0,"MF,FW",20-24,Midfielder,Spain,Europe
1687,Pablo Martínez,ESP,Levante,La Liga,2021,23.0,1998.0,7.3,15,8,7,8,0,4,13,30.8,9,6,3,3,15,30,5,0,MF,20-24,Midfielder,Spain,Europe
1687,Pablo Martínez,ESP,Levante,La Liga,2021,23.0,1998.0,7.3,15,8,7,8,0,4,13,30.8,9,6,3,3,15,30,5,0,MF,20-24,Midfielder,Spain,Europe
1687,Pablo Martínez,ESP,Levante,La Liga,2021,23.0,1998.0,7.3,15,8,7,8,0,4,13,30.8,9,6,3,3,15,30,5,0,MF,20-24,Midfielder,Spain,Europe
1687,Pablo Martínez,ESP,Levante,La Liga,2021,23.0,1998.0,7.3,15,8,7,8,0,4,13,30.8,9,6,3,3,15,30,5,0,MF,20-24,Midfielder,Spain,Europe
1697,Jaime Mata,ESP,Getafe,La Liga,2021,32.0,1988.0,7.5,7,5,3,1,3,1,9,11.1,8,4,1,3,1,8,5,0,FW,30-34,Forward,Spain,Europe
1712,Borja Mayoral,ESP,Roma,Serie A,2021,24.0,1997.0,1.1,0,0,0,0,0,0,0,,0,0,0,0,0,0,0,0,"FW,DF",20-24,Forward,Spain,Europe
1713,Borja Mayoral,ESP,Getafe,La Liga,2021,24.0,1997.0,11.6,7,5,2,3,2,1,2,50.0,1,10,4,6,4,11,3,0,FW,20-24,Forward,Spain,Europe
1745,Óscar Melendo,ESP,Espanyol,La Liga,2021,23.0,1997.0,11.0,11,5,4,4,3,3,13,23.1,10,4,1,3,1,12,10,0,"MF,FW",20-24,Midfielder,Spain,Europe
1746,Gonzalo Melero,ESP,Levante,La Liga,2021,27.0,1994.0,18.8,29,16,10,15,4,16,36,44.4,20,21,8,13,7,36,22,0,MF,25-29,Midfielder,Spain,Europe
1755,Brais Méndez,ESP,Celta Vigo,La Liga,2021,24.0,1997.0,33.6,68,35,24,35,9,26,87,29.9,61,52,6,46,37,105,30,0,MF,20-24,Midfielder,Spain,Europe
1764,Jorge Meré,ESP,Köln,Bundesliga,2021,24.0,1997.0,5.4,9,6,3,6,0,4,7,57.1,3,6,4,2,10,19,19,0,DF,20-24,Defender,Spain,Europe
1766,Fran Mérida,ESP,Espanyol,La Liga,2021,31.0,1990.0,3.0,7,3,5,2,0,4,10,40.0,6,1,0,1,6,13,1,0,MF,30-34,Midfielder,Spain,Europe
1767,Mikel Merino,ESP,Real Sociedad,La Liga,2021,25.0,1996.0,32.1,71,38,21,40,10,26,67,38.8,41,50,10,40,21,92,56,2,MF,25-29,Midfielder,Spain,Europe
1769,Martín Merquelanz,ESP,Rayo Vallecano,La Liga,2021,26.0,1995.0,1.9,2,1,2,0,0,2,6,33.3,4,2,0,2,0,2,1,0,"FW,MF",25-29,Forward,Spain,Europe
1788,Nikola Milenković,SRB,Fiorentina,Serie A,2021,23.0,1997.0,32.5,54,32,31,20,3,29,34,85.3,5,30,15,15,39,93,94,0,DF,20-24,Defender,Serbia,Europe
1789,Arkadiusz Milik,POL,Marseille,Ligue 1,2021,27.0,1994.0,15.7,9,2,0,5,4,4,18,22.2,14,9,1,8,3,12,10,1,FW,25-29,Forward,Poland,Europe
1790,Sergej Milinković-Savić,SRB,Lazio,Serie A,2021,26.0,1995.0,34.4,67,44,20,32,15,29,67,43.3,38,50,9,41,34,101,43,1,MF,25-29,Midfielder,Serbia,Europe
1791,Vanja Milinković-Savić,SRB,Torino,Serie A,2021,24.0,1997.0,27.0,0,0,0,0,0,0,1,0.0,1,0,0,0,0,0,7,2,GK,20-24,Goalkeeper,Serbia,Europe
1794,Luis Milla,ESP,Granada,La Liga,2021,26.0,1994.0,30.8,59,29,25,30,4,25,64,39.1,39,28,4,24,25,84,34,0,MF,25-29,Midfielder,Spain,Europe
1795,Pere Milla,ESP,Elche,La Liga,2021,28.0,1992.0,18.3,20,15,14,5,1,8,44,18.2,36,21,1,20,5,25,21,0,"MF,FW",25-29,Midfielder,Spain,Europe
1798,Santi Mina,ESP,Celta Vigo,La Liga,2021,25.0,1995.0,26.3,27,17,8,15,4,5,32,15.6,27,28,2,26,6,33,22,0,FW,25-29,Forward,Spain,Europe
1802,Óscar Mingueza,ESP,Barcelona,La Liga,2021,22.0,1999.0,9.9,25,11,12,11,2,16,23,69.6,7,5,0,5,9,34,22,1,DF,20-24,Defender,Spain,Europe
1803,Rafa Mir,ESP,Sevilla,La Liga,2021,24.0,1997.0,20.1,4,3,1,1,2,0,11,0.0,11,4,3,1,0,4,17,0,FW,20-24,Forward,Spain,Europe
1804,Jorge Miramón,ESP,Levante,La Liga,2021,32.0,1989.0,22.0,36,19,16,12,8,15,44,34.1,29,15,3,12,35,71,58,0,DF,30-34,Defender,Spain,Europe
1806,Juan Miranda,ESP,Betis,La Liga,2021,21.0,2000.0,8.7,21,11,16,4,1,12,22,54.5,10,10,4,6,15,36,22,0,DF,20-24,Defender,Spain,Europe
1821,Jorge Molina,ESP,Granada,La Liga,2021,39.0,1982.0,21.8,4,2,2,1,1,2,18,11.1,16,13,2,11,6,10,11,0,FW,35-39,Forward,Spain,Europe
1825,Jon Moncayola,ESP,Osasuna,La Liga,2021,23.0,1998.0,32.4,40,20,18,18,4,17,44,38.6,27,26,9,17,20,60,43,0,MF,20-24,Midfielder,Spain,Europe
1830,Ángel Montoro,ESP,Granada,La Liga,2021,33.0,1988.0,14.8,26,13,16,7,3,17,27,63.0,10,11,1,10,11,37,29,1,MF,30-34,Midfielder,Spain,Europe
1835,Jon Morcillo,ESP,Athletic Club,La Liga,2021,22.0,1998.0,0.6,3,0,1,2,0,3,4,75.0,1,1,0,1,0,3,0,0,"MF,FW",20-24,Midfielder,Spain,Europe
1837,Alberto Moreno,ESP,Villarreal,La Liga,2021,29.0,1992.0,13.6,13,7,5,7,1,5,18,27.8,13,13,1,12,27,40,15,0,"MF,DF",25-29,Midfielder,Spain,Europe
1837,Alberto Moreno,ESP,Villarreal,La Liga,2021,29.0,1992.0,13.6,13,7,5,7,1,5,18,27.8,13,13,1,12,27,40,15,0,"MF,DF",25-29,Midfielder,Spain,Europe
1837,Alberto Moreno,ESP,Villarreal,La Liga,2021,29.0,1992.0,13.6,13,7,5,7,1,5,18,27.8,13,13,1,12,27,40,15,0,"MF,DF",25-29,Midfielder,Spain,Europe
1837,Alberto Moreno,ESP,Villarreal,La Liga,2021,29.0,1992.0,13.6,13,7,5,7,1,5,18,27.8,13,13,1,12,27,40,15,0,"MF,DF",25-29,Midfielder,Spain,Europe
1838,Álex Moreno,ESP,Betis,La Liga,2021,28.0,1993.0,26.7,76,40,53,15,8,33,60,55.0,27,28,6,22,34,110,82,1,DF,25-29,Defender,Spain,Europe
1839,Gerard Moreno,ESP,Villarreal,La Liga,2021,29.0,1992.0,13.2,5,2,2,2,1,1,7,14.3,6,6,1,5,6,11,14,0,FW,25-29,Forward,Spain,Europe
1840,Tete Morente,ESP,Elche,La Liga,2021,24.0,1996.0,18.1,21,14,13,7,1,7,28,25.0,21,30,1,29,12,33,12,0,MF,20-24,Midfielder,Spain,Europe
1843,Manu Morlanes,ESP,Espanyol,La Liga,2021,22.0,1999.0,12.7,36,15,16,17,3,18,43,41.9,25,24,5,19,13,49,17,0,MF,20-24,Midfielder,Spain,Europe
1844,Raúl Moro,ESP,Lazio,Serie A,2021,18.0,2002.0,2.2,3,3,0,2,1,1,5,20.0,4,2,0,2,0,3,0,0,FW,Under 20,Forward,Spain,Europe
1863,Toni Moya,ESP,Alavés,La Liga,2021,23.0,1998.0,15.4,23,10,7,13,3,13,43,30.2,30,18,5,13,20,43,18,0,MF,20-24,Midfielder,Spain,Europe
1871,Iker Muniain,ESP,Athletic Club,La Liga,2021,28.0,1992.0,30.9,32,10,8,19,5,12,40,30.0,28,20,1,19,17,49,8,1,MF,25-29,Midfielder,Spain,Europe
1872,Aihen Muñoz,ESP,Real Sociedad,La Liga,2021,23.0,1997.0,14.9,28,17,14,13,1,18,29,62.1,11,11,1,10,17,45,34,0,DF,20-24,Defender,Spain,Europe
1899,Matija Nastasić,SRB,Fiorentina,Serie A,2021,28.0,1993.0,2.4,1,1,1,0,0,1,1,100.0,0,1,1,0,5,6,11,0,DF,25-29,Defender,Serbia,Europe
1902,Jesús Navas,ESP,Sevilla,La Liga,2021,35.0,1985.0,19.8,18,13,11,5,2,9,17,52.9,8,15,2,13,17,35,26,1,DF,35-39,Defender,Spain,Europe
1910,Álvaro Negredo,ESP,Cádiz,La Liga,2021,35.0,1985.0,24.0,5,3,1,4,0,3,6,50.0,3,11,5,6,2,7,23,0,FW,35-39,Forward,Spain,Europe
1919,Carlos Neva,ESP,Granada,La Liga,2021,25.0,1996.0,23.4,31,19,24,7,0,16,28,57.1,12,27,9,18,32,63,81,0,DF,25-29,Defender,Spain,Europe
1935,Saúl Ñíguez,ESP,Chelsea,Premier League,2021,26.0,1994.0,5.3,20,9,11,9,0,9,16,56.3,7,14,3,11,7,27,10,1,"DF,MF",25-29,Defender,Spain,Europe
1936,Saúl Ñíguez,ESP,Atlético Madrid,La Liga,2021,26.0,1994.0,2.2,7,2,0,6,1,3,4,75.0,1,7,1,6,0,7,3,0,"FW,MF",25-29,Forward,Spain,Europe
1947,Peru Nolaskoain,ESP,Athletic Club,La Liga,2021,22.0,1998.0,0.0,0,0,0,0,0,0,0,,0,0,0,0,0,0,0,0,DF,20-24,Defender,Spain,Europe
1948,Nolito,ESP,Celta Vigo,La Liga,2021,34.0,1986.0,15.4,25,15,14,7,4,13,47,27.7,34,20,1,19,9,34,5,0,MF,30-34,Midfielder,Spain,Europe
1953,Hugo Novoa,ESP,RB Leipzig,Bundesliga,2021,18.0,2003.0,1.5,4,4,2,0,2,2,7,28.6,5,2,0,2,1,5,0,0,"MF,FW",Under 20,Midfielder,Spain,Europe
1959,Unai Núñez,ESP,Athletic Club,La Liga,2021,24.0,1997.0,6.9,4,4,2,2,0,3,6,50.0,3,9,8,1,8,12,26,2,DF,20-24,Defender,Spain,Europe
1969,Jan Oblak,SVN,Atlético Madrid,La Liga,2021,28.0,1993.0,38.0,0,0,0,0,0,0,0,,0,0,0,0,1,1,10,4,GK,25-29,Goalkeeper,Slovenia,Europe
1973,Álvaro Odriozola,ESP,Fiorentina,Serie A,2021,25.0,1995.0,19.3,25,15,12,6,7,15,32,46.9,17,17,6,11,8,33,25,2,DF,25-29,Defender,Spain,Europe
1980,Oier Olazábal,ESP,Espanyol,La Liga,2021,31.0,1989.0,1.5,0,0,0,0,0,0,0,,0,0,0,0,0,0,0,0,GK,30-34,Goalkeeper,Spain,Europe
1984,Brian Oliván,ESP,Mallorca,La Liga,2021,27.0,1994.0,24.3,33,20,22,9,2,12,23,52.2,11,17,7,10,28,61,63,0,DF,25-29,Defender,Spain,Europe
1987,Dani Olmo,ESP,RB Leipzig,Bundesliga,2021,23.0,1998.0,8.3,14,6,5,7,2,5,18,27.8,13,5,1,4,4,18,1,0,"MF,FW",20-24,Midfielder,Spain,Europe
1989,Warmed Omari,COM,Rennes,Ligue 1,2021,21.0,2000.0,31.1,33,17,22,10,1,15,23,65.2,8,20,13,7,31,64,94,5,DF,20-24,Defender,Comoros,Africa
2018,Mikel Oyarzabal,ESP,Real Sociedad,La Liga,2021,24.0,1997.0,18.6,18,10,7,7,4,7,21,33.3,14,18,2,16,10,28,16,1,"FW,MF",20-24,Forward,Spain,Europe
2022,Fernando Pacheco,ESP,Alavés,La Liga,2021,29.0,1992.0,33.9,2,1,2,0,0,2,2,100.0,0,0,0,0,0,2,18,1,GK,25-29,Goalkeeper,Spain,Europe
2022,Fernando Pacheco,ESP,Alavés,La Liga,2021,29.0,1992.0,33.9,2,1,2,0,0,2,2,100.0,0,0,0,0,0,2,18,1,GK,25-29,Goalkeeper,Spain,Europe
2022,Fernando Pacheco,ESP,Alavés,La Liga,2021,29.0,1992.0,33.9,2,1,2,0,0,2,2,100.0,0,0,0,0,0,2,18,1,GK,25-29,Goalkeeper,Spain,Europe
2022,Fernando Pacheco,ESP,Alavés,La Liga,2021,29.0,1992.0,33.9,2,1,2,0,0,2,2,100.0,0,0,0,0,0,2,18,1,GK,25-29,Goalkeeper,Spain,Europe
2023,Jon Pacheco,ESP,Real Sociedad,La Liga,2021,20.0,2001.0,4.2,6,4,4,2,0,3,3,100.0,0,6,4,2,6,12,18,0,DF,20-24,Defender,Spain,Europe
2036,Martin Palumbo,NOR,Juventus,Serie A,2021,19.0,2002.0,0.1,0,0,0,0,0,0,1,0.0,1,0,0,0,0,0,0,0,FW,Under 20,Forward,Norway,Europe
2049,Thomas Partey,GHA,Arsenal,Premier League,2021,28.0,1993.0,22.5,43,29,22,17,4,18,44,40.9,26,22,4,18,23,66,35,2,MF,25-29,Midfielder,Ghana,Africa
2051,Felix Passlack,GER,Dortmund,Bundesliga,2021,23.0,1998.0,5.2,13,9,8,4,1,6,12,50.0,6,5,1,4,4,17,7,0,DF,20-24,Defender,Germany,Europe
2052,Javier Pastore,ARG,Elche,La Liga,2021,32.0,1989.0,5.8,7,3,3,2,2,3,12,25.0,9,5,1,4,4,11,2,0,"MF,FW",30-34,Midfielder,Argentina,South America
2054,Rui Patrício,POR,Roma,Serie A,2021,33.0,1988.0,38.0,0,0,0,0,0,0,0,,0,1,0,1,0,0,10,3,GK,30-34,Goalkeeper,Portugal,Europe
2055,Paulinho,BRA,Leverkusen,Bundesliga,2021,21.0,2000.0,13.5,22,13,6,13,3,13,27,48.1,14,14,1,13,6,28,7,0,"FW,MF",20-24,Forward,Brazil,South America
2055,Paulinho,BRA,Leverkusen,Bundesliga,2021,21.0,2000.0,13.5,22,13,6,13,3,13,27,48.1,14,14,1,13,6,28,7,0,"FW,MF",20-24,Forward,Brazil,South America
2055,Paulinho,BRA,Leverkusen,Bundesliga,2021,21.0,2000.0,13.5,22,13,6,13,3,13,27,48.1,14,14,1,13,6,28,7,0,"FW,MF",20-24,Forward,Brazil,South America
2055,Paulinho,BRA,Leverkusen,Bundesliga,2021,21.0,2000.0,13.5,22,13,6,13,3,13,27,48.1,14,14,1,13,6,28,7,0,"FW,MF",20-24,Forward,Brazil,South America
2055,Paulinho,BRA,Leverkusen,Bundesliga,2021,21.0,2000.0,13.5,22,13,6,13,3,13,27,48.1,14,14,1,13,6,28,7,0,"FW,MF",20-24,Forward,Brazil,South America
2055,Paulinho,BRA,Leverkusen,Bundesliga,2021,21.0,2000.0,13.5,22,13,6,13,3,13,27,48.1,14,14,1,13,6,28,7,0,"FW,MF",20-24,Forward,Brazil,South America
2055,Paulinho,BRA,Leverkusen,Bundesliga,2021,21.0,2000.0,13.5,22,13,6,13,3,13,27,48.1,14,14,1,13,6,28,7,0,"FW,MF",20-24,Forward,Brazil,South America
2055,Paulinho,BRA,Leverkusen,Bundesliga,2021,21.0,2000.0,13.5,22,13,6,13,3,13,27,48.1,14,14,1,13,6,28,7,0,"FW,MF",20-24,Forward,Brazil,South America
2055,Paulinho,BRA,Leverkusen,Bundesliga,2021,21.0,2000.0,13.5,22,13,6,13,3,13,27,48.1,14,14,1,13,6,28,7,0,"FW,MF",20-24,Forward,Brazil,South America
2055,Paulinho,BRA,Leverkusen,Bundesliga,2021,21.0,2000.0,13.5,22,13,6,13,3,13,27,48.1,14,14,1,13,6,28,7,0,"FW,MF",20-24,Forward,Brazil,South America
2055,Paulinho,BRA,Leverkusen,Bundesliga,2021,21.0,2000.0,13.5,22,13,6,13,3,13,27,48.1,14,14,1,13,6,28,7,0,"FW,MF",20-24,Forward,Brazil,South America
2055,Paulinho,BRA,Leverkusen,Bundesliga,2021,21.0,2000.0,13.5,22,13,6,13,3,13,27,48.1,14,14,1,13,6,28,7,0,"FW,MF",20-24,Forward,Brazil,South America
2055,Paulinho,BRA,Leverkusen,Bundesliga,2021,21.0,2000.0,13.5,22,13,6,13,3,13,27,48.1,14,14,1,13,6,28,7,0,"FW,MF",20-24,Forward,Brazil,South America
2055,Paulinho,BRA,Leverkusen,Bundesliga,2021,21.0,2000.0,13.5,22,13,6,13,3,13,27,48.1,14,14,1,13,6,28,7,0,"FW,MF",20-24,Forward,Brazil,South America
2055,Paulinho,BRA,Leverkusen,Bundesliga,2021,21.0,2000.0,13.5,22,13,6,13,3,13,27,48.1,14,14,1,13,6,28,7,0,"FW,MF",20-24,Forward,Brazil,South America
2055,Paulinho,BRA,Leverkusen,Bundesliga,2021,21.0,2000.0,13.5,22,13,6,13,3,13,27,48.1,14,14,1,13,6,28,7,0,"FW,MF",20-24,Forward,Brazil,South America
2055,Paulinho,BRA,Leverkusen,Bundesliga,2021,21.0,2000.0,13.5,22,13,6,13,3,13,27,48.1,14,14,1,13,6,28,7,0,"FW,MF",20-24,Forward,Brazil,South America
2055,Paulinho,BRA,Leverkusen,Bundesliga,2021,21.0,2000.0,13.5,22,13,6,13,3,13,27,48.1,14,14,1,13,6,28,7,0,"FW,MF",20-24,Forward,Brazil,South America
2055,Paulinho,BRA,Leverkusen,Bundesliga,2021,21.0,2000.0,13.5,22,13,6,13,3,13,27,48.1,14,14,1,13,6,28,7,0,"FW,MF",20-24,Forward,Brazil,South America
2055,Paulinho,BRA,Leverkusen,Bundesliga,2021,21.0,2000.0,13.5,22,13,6,13,3,13,27,48.1,14,14,1,13,6,28,7,0,"FW,MF",20-24,Forward,Brazil,South America
2055,Paulinho,BRA,Leverkusen,Bundesliga,2021,21.0,2000.0,13.5,22,13,6,13,3,13,27,48.1,14,14,1,13,6,28,7,0,"FW,MF",20-24,Forward,Brazil,South America
2055,Paulinho,BRA,Leverkusen,Bundesliga,2021,21.0,2000.0,13.5,22,13,6,13,3,13,27,48.1,14,14,1,13,6,28,7,0,"FW,MF",20-24,Forward,Brazil,South America
2055,Paulinho,BRA,Leverkusen,Bundesliga,2021,21.0,2000.0,13.5,22,13,6,13,3,13,27,48.1,14,14,1,13,6,28,7,0,"FW,MF",20-24,Forward,Brazil,South America
2055,Paulinho,BRA,Leverkusen,Bundesliga,2021,21.0,2000.0,13.5,22,13,6,13,3,13,27,48.1,14,14,1,13,6,28,7,0,"FW,MF",20-24,Forward,Brazil,South America
2055,Paulinho,BRA,Leverkusen,Bundesliga,2021,21.0,2000.0,13.5,22,13,6,13,3,13,27,48.1,14,14,1,13,6,28,7,0,"FW,MF",20-24,Forward,Brazil,South America
2055,Paulinho,BRA,Leverkusen,Bundesliga,2021,21.0,2000.0,13.5,22,13,6,13,3,13,27,48.1,14,14,1,13,6,28,7,0,"FW,MF",20-24,Forward,Brazil,South America
2055,Paulinho,BRA,Leverkusen,Bundesliga,2021,21.0,2000.0,13.5,22,13,6,13,3,13,27,48.1,14,14,1,13,6,28,7,0,"FW,MF",20-24,Forward,Brazil,South America
2055,Paulinho,BRA,Leverkusen,Bundesliga,2021,21.0,2000.0,13.5,22,13,6,13,3,13,27,48.1,14,14,1,13,6,28,7,0,"FW,MF",20-24,Forward,Brazil,South America
2055,Paulinho,BRA,Leverkusen,Bundesliga,2021,21.0,2000.0,13.5,22,13,6,13,3,13,27,48.1,14,14,1,13,6,28,7,0,"FW,MF",20-24,Forward,Brazil,South America
2055,Paulinho,BRA,Leverkusen,Bundesliga,2021,21.0,2000.0,13.5,22,13,6,13,3,13,27,48.1,14,14,1,13,6,28,7,0,"FW,MF",20-24,Forward,Brazil,South America
2055,Paulinho,BRA,Leverkusen,Bundesliga,2021,21.0,2000.0,13.5,22,13,6,13,3,13,27,48.1,14,14,1,13,6,28,7,0,"FW,MF",20-24,Forward,Brazil,South America
2055,Paulinho,BRA,Leverkusen,Bundesliga,2021,21.0,2000.0,13.5,22,13,6,13,3,13,27,48.1,14,14,1,13,6,28,7,0,"FW,MF",20-24,Forward,Brazil,South America
2055,Paulinho,BRA,Leverkusen,Bundesliga,2021,21.0,2000.0,13.5,22,13,6,13,3,13,27,48.1,14,14,1,13,6,28,7,0,"FW,MF",20-24,Forward,Brazil,South America
2055,Paulinho,BRA,Leverkusen,Bundesliga,2021,21.0,2000.0,13.5,22,13,6,13,3,13,27,48.1,14,14,1,13,6,28,7,0,"FW,MF",20-24,Forward,Brazil,South America
2055,Paulinho,BRA,Leverkusen,Bundesliga,2021,21.0,2000.0,13.5,22,13,6,13,3,13,27,48.1,14,14,1,13,6,28,7,0,"FW,MF",20-24,Forward,Brazil,South America
2055,Paulinho,BRA,Leverkusen,Bundesliga,2021,21.0,2000.0,13.5,22,13,6,13,3,13,27,48.1,14,14,1,13,6,28,7,0,"FW,MF",20-24,Forward,Brazil,South America
2055,Paulinho,BRA,Leverkusen,Bundesliga,2021,21.0,2000.0,13.5,22,13,6,13,3,13,27,48.1,14,14,1,13,6,28,7,0,"FW,MF",20-24,Forward,Brazil,South America
2055,Paulinho,BRA,Leverkusen,Bundesliga,2021,21.0,2000.0,13.5,22,13,6,13,3,13,27,48.1,14,14,1,13,6,28,7,0,"FW,MF",20-24,Forward,Brazil,South America
2055,Paulinho,BRA,Leverkusen,Bundesliga,2021,21.0,2000.0,13.5,22,13,6,13,3,13,27,48.1,14,14,1,13,6,28,7,0,"FW,MF",20-24,Forward,Brazil,South America
2055,Paulinho,BRA,Leverkusen,Bundesliga,2021,21.0,2000.0,13.5,22,13,6,13,3,13,27,48.1,14,14,1,13,6,28,7,0,"FW,MF",20-24,Forward,Brazil,South America
2055,Paulinho,BRA,Leverkusen,Bundesliga,2021,21.0,2000.0,13.5,22,13,6,13,3,13,27,48.1,14,14,1,13,6,28,7,0,"FW,MF",20-24,Forward,Brazil,South America
2055,Paulinho,BRA,Leverkusen,Bundesliga,2021,21.0,2000.0,13.5,22,13,6,13,3,13,27,48.1,14,14,1,13,6,28,7,0,"FW,MF",20-24,Forward,Brazil,South America
2055,Paulinho,BRA,Leverkusen,Bundesliga,2021,21.0,2000.0,13.5,22,13,6,13,3,13,27,48.1,14,14,1,13,6,28,7,0,"FW,MF",20-24,Forward,Brazil,South America
2055,Paulinho,BRA,Leverkusen,Bundesliga,2021,21.0,2000.0,13.5,22,13,6,13,3,13,27,48.1,14,14,1,13,6,28,7,0,"FW,MF",20-24,Forward,Brazil,South America
2055,Paulinho,BRA,Leverkusen,Bundesliga,2021,21.0,2000.0,13.5,22,13,6,13,3,13,27,48.1,14,14,1,13,6,28,7,0,"FW,MF",20-24,Forward,Brazil,South America
2055,Paulinho,BRA,Leverkusen,Bundesliga,2021,21.0,2000.0,13.5,22,13,6,13,3,13,27,48.1,14,14,1,13,6,28,7,0,"FW,MF",20-24,Forward,Brazil,South America
2055,Paulinho,BRA,Leverkusen,Bundesliga,2021,21.0,2000.0,13.5,22,13,6,13,3,13,27,48.1,14,14,1,13,6,28,7,0,"FW,MF",20-24,Forward,Brazil,South America
2055,Paulinho,BRA,Leverkusen,Bundesliga,2021,21.0,2000.0,13.5,22,13,6,13,3,13,27,48.1,14,14,1,13,6,28,7,0,"FW,MF",20-24,Forward,Brazil,South America
2055,Paulinho,BRA,Leverkusen,Bundesliga,2021,21.0,2000.0,13.5,22,13,6,13,3,13,27,48.1,14,14,1,13,6,28,7,0,"FW,MF",20-24,Forward,Brazil,South America
2055,Paulinho,BRA,Leverkusen,Bundesliga,2021,21.0,2000.0,13.5,22,13,6,13,3,13,27,48.1,14,14,1,13,6,28,7,0,"FW,MF",20-24,Forward,Brazil,South America
2055,Paulinho,BRA,Leverkusen,Bundesliga,2021,21.0,2000.0,13.5,22,13,6,13,3,13,27,48.1,14,14,1,13,6,28,7,0,"FW,MF",20-24,Forward,Brazil,South America
2055,Paulinho,BRA,Leverkusen,Bundesliga,2021,21.0,2000.0,13.5,22,13,6,13,3,13,27,48.1,14,14,1,13,6,28,7,0,"FW,MF",20-24,Forward,Brazil,South America
2055,Paulinho,BRA,Leverkusen,Bundesliga,2021,21.0,2000.0,13.5,22,13,6,13,3,13,27,48.1,14,14,1,13,6,28,7,0,"FW,MF",20-24,Forward,Brazil,South America
2055,Paulinho,BRA,Leverkusen,Bundesliga,2021,21.0,2000.0,13.5,22,13,6,13,3,13,27,48.1,14,14,1,13,6,28,7,0,"FW,MF",20-24,Forward,Brazil,South America
2055,Paulinho,BRA,Leverkusen,Bundesliga,2021,21.0,2000.0,13.5,22,13,6,13,3,13,27,48.1,14,14,1,13,6,28,7,0,"FW,MF",20-24,Forward,Brazil,South America
2055,Paulinho,BRA,Leverkusen,Bundesliga,2021,21.0,2000.0,13.5,22,13,6,13,3,13,27,48.1,14,14,1,13,6,28,7,0,"FW,MF",20-24,Forward,Brazil,South America
2055,Paulinho,BRA,Leverkusen,Bundesliga,2021,21.0,2000.0,13.5,22,13,6,13,3,13,27,48.1,14,14,1,13,6,28,7,0,"FW,MF",20-24,Forward,Brazil,South America
2055,Paulinho,BRA,Leverkusen,Bundesliga,2021,21.0,2000.0,13.5,22,13,6,13,3,13,27,48.1,14,14,1,13,6,28,7,0,"FW,MF",20-24,Forward,Brazil,South America
2055,Paulinho,BRA,Leverkusen,Bundesliga,2021,21.0,2000.0,13.5,22,13,6,13,3,13,27,48.1,14,14,1,13,6,28,7,0,"FW,MF",20-24,Forward,Brazil,South America
2055,Paulinho,BRA,Leverkusen,Bundesliga,2021,21.0,2000.0,13.5,22,13,6,13,3,13,27,48.1,14,14,1,13,6,28,7,0,"FW,MF",20-24,Forward,Brazil,South America
2055,Paulinho,BRA,Leverkusen,Bundesliga,2021,21.0,2000.0,13.5,22,13,6,13,3,13,27,48.1,14,14,1,13,6,28,7,0,"FW,MF",20-24,Forward,Brazil,South America
2055,Paulinho,BRA,Leverkusen,Bundesliga,2021,21.0,2000.0,13.5,22,13,6,13,3,13,27,48.1,14,14,1,13,6,28,7,0,"FW,MF",20-24,Forward,Brazil,South America
2055,Paulinho,BRA,Leverkusen,Bundesliga,2021,21.0,2000.0,13.5,22,13,6,13,3,13,27,48.1,14,14,1,13,6,28,7,0,"FW,MF",20-24,Forward,Brazil,South America
2055,Paulinho,BRA,Leverkusen,Bundesliga,2021,21.0,2000.0,13.5,22,13,6,13,3,13,27,48.1,14,14,1,13,6,28,7,0,"FW,MF",20-24,Forward,Brazil,South America
2055,Paulinho,BRA,Leverkusen,Bundesliga,2021,21.0,2000.0,13.5,22,13,6,13,3,13,27,48.1,14,14,1,13,6,28,7,0,"FW,MF",20-24,Forward,Brazil,South America
2055,Paulinho,BRA,Leverkusen,Bundesliga,2021,21.0,2000.0,13.5,22,13,6,13,3,13,27,48.1,14,14,1,13,6,28,7,0,"FW,MF",20-24,Forward,Brazil,South America
2055,Paulinho,BRA,Leverkusen,Bundesliga,2021,21.0,2000.0,13.5,22,13,6,13,3,13,27,48.1,14,14,1,13,6,28,7,0,"FW,MF",20-24,Forward,Brazil,South America
2055,Paulinho,BRA,Leverkusen,Bundesliga,2021,21.0,2000.0,13.5,22,13,6,13,3,13,27,48.1,14,14,1,13,6,28,7,0,"FW,MF",20-24,Forward,Brazil,South America
2055,Paulinho,BRA,Leverkusen,Bundesliga,2021,21.0,2000.0,13.5,22,13,6,13,3,13,27,48.1,14,14,1,13,6,28,7,0,"FW,MF",20-24,Forward,Brazil,South America
2055,Paulinho,BRA,Leverkusen,Bundesliga,2021,21.0,2000.0,13.5,22,13,6,13,3,13,27,48.1,14,14,1,13,6,28,7,0,"FW,MF",20-24,Forward,Brazil,South America
2055,Paulinho,BRA,Leverkusen,Bundesliga,2021,21.0,2000.0,13.5,22,13,6,13,3,13,27,48.1,14,14,1,13,6,28,7,0,"FW,MF",20-24,Forward,Brazil,South America
2055,Paulinho,BRA,Leverkusen,Bundesliga,2021,21.0,2000.0,13.5,22,13,6,13,3,13,27,48.1,14,14,1,13,6,28,7,0,"FW,MF",20-24,Forward,Brazil,South America
2055,Paulinho,BRA,Leverkusen,Bundesliga,2021,21.0,2000.0,13.5,22,13,6,13,3,13,27,48.1,14,14,1,13,6,28,7,0,"FW,MF",20-24,Forward,Brazil,South America
2055,Paulinho,BRA,Leverkusen,Bundesliga,2021,21.0,2000.0,13.5,22,13,6,13,3,13,27,48.1,14,14,1,13,6,28,7,0,"FW,MF",20-24,Forward,Brazil,South America
2055,Paulinho,BRA,Leverkusen,Bundesliga,2021,21.0,2000.0,13.5,22,13,6,13,3,13,27,48.1,14,14,1,13,6,28,7,0,"FW,MF",20-24,Forward,Brazil,South America
2055,Paulinho,BRA,Leverkusen,Bundesliga,2021,21.0,2000.0,13.5,22,13,6,13,3,13,27,48.1,14,14,1,13,6,28,7,0,"FW,MF",20-24,Forward,Brazil,South America
2055,Paulinho,BRA,Leverkusen,Bundesliga,2021,21.0,2000.0,13.5,22,13,6,13,3,13,27,48.1,14,14,1,13,6,28,7,0,"FW,MF",20-24,Forward,Brazil,South America
2055,Paulinho,BRA,Leverkusen,Bundesliga,2021,21.0,2000.0,13.5,22,13,6,13,3,13,27,48.1,14,14,1,13,6,28,7,0,"FW,MF",20-24,Forward,Brazil,South America
2055,Paulinho,BRA,Leverkusen,Bundesliga,2021,21.0,2000.0,13.5,22,13,6,13,3,13,27,48.1,14,14,1,13,6,28,7,0,"FW,MF",20-24,Forward,Brazil,South America
2055,Paulinho,BRA,Leverkusen,Bundesliga,2021,21.0,2000.0,13.5,22,13,6,13,3,13,27,48.1,14,14,1,13,6,28,7,0,"FW,MF",20-24,Forward,Brazil,South America
2055,Paulinho,BRA,Leverkusen,Bundesliga,2021,21.0,2000.0,13.5,22,13,6,13,3,13,27,48.1,14,14,1,13,6,28,7,0,"FW,MF",20-24,Forward,Brazil,South America
2055,Paulinho,BRA,Leverkusen,Bundesliga,2021,21.0,2000.0,13.5,22,13,6,13,3,13,27,48.1,14,14,1,13,6,28,7,0,"FW,MF",20-24,Forward,Brazil,South America
2055,Paulinho,BRA,Leverkusen,Bundesliga,2021,21.0,2000.0,13.5,22,13,6,13,3,13,27,48.1,14,14,1,13,6,28,7,0,"FW,MF",20-24,Forward,Brazil,South America
2055,Paulinho,BRA,Leverkusen,Bundesliga,2021,21.0,2000.0,13.5,22,13,6,13,3,13,27,48.1,14,14,1,13,6,28,7,0,"FW,MF",20-24,Forward,Brazil,South America
2055,Paulinho,BRA,Leverkusen,Bundesliga,2021,21.0,2000.0,13.5,22,13,6,13,3,13,27,48.1,14,14,1,13,6,28,7,0,"FW,MF",20-24,Forward,Brazil,South America
2055,Paulinho,BRA,Leverkusen,Bundesliga,2021,21.0,2000.0,13.5,22,13,6,13,3,13,27,48.1,14,14,1,13,6,28,7,0,"FW,MF",20-24,Forward,Brazil,South America
2055,Paulinho,BRA,Leverkusen,Bundesliga,2021,21.0,2000.0,13.5,22,13,6,13,3,13,27,48.1,14,14,1,13,6,28,7,0,"FW,MF",20-24,Forward,Brazil,South America
2055,Paulinho,BRA,Leverkusen,Bundesliga,2021,21.0,2000.0,13.5,22,13,6,13,3,13,27,48.1,14,14,1,13,6,28,7,0,"FW,MF",20-24,Forward,Brazil,South America
2055,Paulinho,BRA,Leverkusen,Bundesliga,2021,21.0,2000.0,13.5,22,13,6,13,3,13,27,48.1,14,14,1,13,6,28,7,0,"FW,MF",20-24,Forward,Brazil,South America
2055,Paulinho,BRA,Leverkusen,Bundesliga,2021,21.0,2000.0,13.5,22,13,6,13,3,13,27,48.1,14,14,1,13,6,28,7,0,"FW,MF",20-24,Forward,Brazil,South America
2055,Paulinho,BRA,Leverkusen,Bundesliga,2021,21.0,2000.0,13.5,22,13,6,13,3,13,27,48.1,14,14,1,13,6,28,7,0,"FW,MF",20-24,Forward,Brazil,South America
2055,Paulinho,BRA,Leverkusen,Bundesliga,2021,21.0,2000.0,13.5,22,13,6,13,3,13,27,48.1,14,14,1,13,6,28,7,0,"FW,MF",20-24,Forward,Brazil,South America
2055,Paulinho,BRA,Leverkusen,Bundesliga,2021,21.0,2000.0,13.5,22,13,6,13,3,13,27,48.1,14,14,1,13,6,28,7,0,"FW,MF",20-24,Forward,Brazil,South America
2055,Paulinho,BRA,Leverkusen,Bundesliga,2021,21.0,2000.0,13.5,22,13,6,13,3,13,27,48.1,14,14,1,13,6,28,7,0,"FW,MF",20-24,Forward,Brazil,South America
2055,Paulinho,BRA,Leverkusen,Bundesliga,2021,21.0,2000.0,13.5,22,13,6,13,3,13,27,48.1,14,14,1,13,6,28,7,0,"FW,MF",20-24,Forward,Brazil,South America
2055,Paulinho,BRA,Leverkusen,Bundesliga,2021,21.0,2000.0,13.5,22,13,6,13,3,13,27,48.1,14,14,1,13,6,28,7,0,"FW,MF",20-24,Forward,Brazil,South America
2055,Paulinho,BRA,Leverkusen,Bundesliga,2021,21.0,2000.0,13.5,22,13,6,13,3,13,27,48.1,14,14,1,13,6,28,7,0,"FW,MF",20-24,Forward,Brazil,South America
2055,Paulinho,BRA,Leverkusen,Bundesliga,2021,21.0,2000.0,13.5,22,13,6,13,3,13,27,48.1,14,14,1,13,6,28,7,0,"FW,MF",20-24,Forward,Brazil,South America
2055,Paulinho,BRA,Leverkusen,Bundesliga,2021,21.0,2000.0,13.5,22,13,6,13,3,13,27,48.1,14,14,1,13,6,28,7,0,"FW,MF",20-24,Forward,Brazil,South America
2055,Paulinho,BRA,Leverkusen,Bundesliga,2021,21.0,2000.0,13.5,22,13,6,13,3,13,27,48.1,14,14,1,13,6,28,7,0,"FW,MF",20-24,Forward,Brazil,South America
2055,Paulinho,BRA,Leverkusen,Bundesliga,2021,21.0,2000.0,13.5,22,13,6,13,3,13,27,48.1,14,14,1,13,6,28,7,0,"FW,MF",20-24,Forward,Brazil,South America
2055,Paulinho,BRA,Leverkusen,Bundesliga,2021,21.0,2000.0,13.5,22,13,6,13,3,13,27,48.1,14,14,1,13,6,28,7,0,"FW,MF",20-24,Forward,Brazil,South America
2055,Paulinho,BRA,Leverkusen,Bundesliga,2021,21.0,2000.0,13.5,22,13,6,13,3,13,27,48.1,14,14,1,13,6,28,7,0,"FW,MF",20-24,Forward,Brazil,South America
2055,Paulinho,BRA,Leverkusen,Bundesliga,2021,21.0,2000.0,13.5,22,13,6,13,3,13,27,48.1,14,14,1,13,6,28,7,0,"FW,MF",20-24,Forward,Brazil,South America
2055,Paulinho,BRA,Leverkusen,Bundesliga,2021,21.0,2000.0,13.5,22,13,6,13,3,13,27,48.1,14,14,1,13,6,28,7,0,"FW,MF",20-24,Forward,Brazil,South America
2055,Paulinho,BRA,Leverkusen,Bundesliga,2021,21.0,2000.0,13.5,22,13,6,13,3,13,27,48.1,14,14,1,13,6,28,7,0,"FW,MF",20-24,Forward,Brazil,South America
2055,Paulinho,BRA,Leverkusen,Bundesliga,2021,21.0,2000.0,13.5,22,13,6,13,3,13,27,48.1,14,14,1,13,6,28,7,0,"FW,MF",20-24,Forward,Brazil,South America
2055,Paulinho,BRA,Leverkusen,Bundesliga,2021,21.0,2000.0,13.5,22,13,6,13,3,13,27,48.1,14,14,1,13,6,28,7,0,"FW,MF",20-24,Forward,Brazil,South America
2055,Paulinho,BRA,Leverkusen,Bundesliga,2021,21.0,2000.0,13.5,22,13,6,13,3,13,27,48.1,14,14,1,13,6,28,7,0,"FW,MF",20-24,Forward,Brazil,South America
2055,Paulinho,BRA,Leverkusen,Bundesliga,2021,21.0,2000.0,13.5,22,13,6,13,3,13,27,48.1,14,14,1,13,6,28,7,0,"FW,MF",20-24,Forward,Brazil,South America
2055,Paulinho,BRA,Leverkusen,Bundesliga,2021,21.0,2000.0,13.5,22,13,6,13,3,13,27,48.1,14,14,1,13,6,28,7,0,"FW,MF",20-24,Forward,Brazil,South America
2055,Paulinho,BRA,Leverkusen,Bundesliga,2021,21.0,2000.0,13.5,22,13,6,13,3,13,27,48.1,14,14,1,13,6,28,7,0,"FW,MF",20-24,Forward,Brazil,South America
2055,Paulinho,BRA,Leverkusen,Bundesliga,2021,21.0,2000.0,13.5,22,13,6,13,3,13,27,48.1,14,14,1,13,6,28,7,0,"FW,MF",20-24,Forward,Brazil,South America
2055,Paulinho,BRA,Leverkusen,Bundesliga,2021,21.0,2000.0,13.5,22,13,6,13,3,13,27,48.1,14,14,1,13,6,28,7,0,"FW,MF",20-24,Forward,Brazil,South America
2055,Paulinho,BRA,Leverkusen,Bundesliga,2021,21.0,2000.0,13.5,22,13,6,13,3,13,27,48.1,14,14,1,13,6,28,7,0,"FW,MF",20-24,Forward,Brazil,South America
2055,Paulinho,BRA,Leverkusen,Bundesliga,2021,21.0,2000.0,13.5,22,13,6,13,3,13,27,48.1,14,14,1,13,6,28,7,0,"FW,MF",20-24,Forward,Brazil,South America
2055,Paulinho,BRA,Leverkusen,Bundesliga,2021,21.0,2000.0,13.5,22,13,6,13,3,13,27,48.1,14,14,1,13,6,28,7,0,"FW,MF",20-24,Forward,Brazil,South America
2055,Paulinho,BRA,Leverkusen,Bundesliga,2021,21.0,2000.0,13.5,22,13,6,13,3,13,27,48.1,14,14,1,13,6,28,7,0,"FW,MF",20-24,Forward,Brazil,South America
2055,Paulinho,BRA,Leverkusen,Bundesliga,2021,21.0,2000.0,13.5,22,13,6,13,3,13,27,48.1,14,14,1,13,6,28,7,0,"FW,MF",20-24,Forward,Brazil,South America
2055,Paulinho,BRA,Leverkusen,Bundesliga,2021,21.0,2000.0,13.5,22,13,6,13,3,13,27,48.1,14,14,1,13,6,28,7,0,"FW,MF",20-24,Forward,Brazil,South America
2055,Paulinho,BRA,Leverkusen,Bundesliga,2021,21.0,2000.0,13.5,22,13,6,13,3,13,27,48.1,14,14,1,13,6,28,7,0,"FW,MF",20-24,Forward,Brazil,South America
2055,Paulinho,BRA,Leverkusen,Bundesliga,2021,21.0,2000.0,13.5,22,13,6,13,3,13,27,48.1,14,14,1,13,6,28,7,0,"FW,MF",20-24,Forward,Brazil,South America
2055,Paulinho,BRA,Leverkusen,Bundesliga,2021,21.0,2000.0,13.5,22,13,6,13,3,13,27,48.1,14,14,1,13,6,28,7,0,"FW,MF",20-24,Forward,Brazil,South America
2055,Paulinho,BRA,Leverkusen,Bundesliga,2021,21.0,2000.0,13.5,22,13,6,13,3,13,27,48.1,14,14,1,13,6,28,7,0,"FW,MF",20-24,Forward,Brazil,South America
2055,Paulinho,BRA,Leverkusen,Bundesliga,2021,21.0,2000.0,13.5,22,13,6,13,3,13,27,48.1,14,14,1,13,6,28,7,0,"FW,MF",20-24,Forward,Brazil,South America
2055,Paulinho,BRA,Leverkusen,Bundesliga,2021,21.0,2000.0,13.5,22,13,6,13,3,13,27,48.1,14,14,1,13,6,28,7,0,"FW,MF",20-24,Forward,Brazil,South America
2055,Paulinho,BRA,Leverkusen,Bundesliga,2021,21.0,2000.0,13.5,22,13,6,13,3,13,27,48.1,14,14,1,13,6,28,7,0,"FW,MF",20-24,Forward,Brazil,South America
2055,Paulinho,BRA,Leverkusen,Bundesliga,2021,21.0,2000.0,13.5,22,13,6,13,3,13,27,48.1,14,14,1,13,6,28,7,0,"FW,MF",20-24,Forward,Brazil,South America
2055,Paulinho,BRA,Leverkusen,Bundesliga,2021,21.0,2000.0,13.5,22,13,6,13,3,13,27,48.1,14,14,1,13,6,28,7,0,"FW,MF",20-24,Forward,Brazil,South America
2055,Paulinho,BRA,Leverkusen,Bundesliga,2021,21.0,2000.0,13.5,22,13,6,13,3,13,27,48.1,14,14,1,13,6,28,7,0,"FW,MF",20-24,Forward,Brazil,South America
2055,Paulinho,BRA,Leverkusen,Bundesliga,2021,21.0,2000.0,13.5,22,13,6,13,3,13,27,48.1,14,14,1,13,6,28,7,0,"FW,MF",20-24,Forward,Brazil,South America
2055,Paulinho,BRA,Leverkusen,Bundesliga,2021,21.0,2000.0,13.5,22,13,6,13,3,13,27,48.1,14,14,1,13,6,28,7,0,"FW,MF",20-24,Forward,Brazil,South America
2055,Paulinho,BRA,Leverkusen,Bundesliga,2021,21.0,2000.0,13.5,22,13,6,13,3,13,27,48.1,14,14,1,13,6,28,7,0,"FW,MF",20-24,Forward,Brazil,South America
2055,Paulinho,BRA,Leverkusen,Bundesliga,2021,21.0,2000.0,13.5,22,13,6,13,3,13,27,48.1,14,14,1,13,6,28,7,0,"FW,MF",20-24,Forward,Brazil,South America
2055,Paulinho,BRA,Leverkusen,Bundesliga,2021,21.0,2000.0,13.5,22,13,6,13,3,13,27,48.1,14,14,1,13,6,28,7,0,"FW,MF",20-24,Forward,Brazil,South America
2055,Paulinho,BRA,Leverkusen,Bundesliga,2021,21.0,2000.0,13.5,22,13,6,13,3,13,27,48.1,14,14,1,13,6,28,7,0,"FW,MF",20-24,Forward,Brazil,South America
2055,Paulinho,BRA,Leverkusen,Bundesliga,2021,21.0,2000.0,13.5,22,13,6,13,3,13,27,48.1,14,14,1,13,6,28,7,0,"FW,MF",20-24,Forward,Brazil,South America
2055,Paulinho,BRA,Leverkusen,Bundesliga,2021,21.0,2000.0,13.5,22,13,6,13,3,13,27,48.1,14,14,1,13,6,28,7,0,"FW,MF",20-24,Forward,Brazil,South America
2055,Paulinho,BRA,Leverkusen,Bundesliga,2021,21.0,2000.0,13.5,22,13,6,13,3,13,27,48.1,14,14,1,13,6,28,7,0,"FW,MF",20-24,Forward,Brazil,South America
2055,Paulinho,BRA,Leverkusen,Bundesliga,2021,21.0,2000.0,13.5,22,13,6,13,3,13,27,48.1,14,14,1,13,6,28,7,0,"FW,MF",20-24,Forward,Brazil,South America
2055,Paulinho,BRA,Leverkusen,Bundesliga,2021,21.0,2000.0,13.5,22,13,6,13,3,13,27,48.1,14,14,1,13,6,28,7,0,"FW,MF",20-24,Forward,Brazil,South America
2055,Paulinho,BRA,Leverkusen,Bundesliga,2021,21.0,2000.0,13.5,22,13,6,13,3,13,27,48.1,14,14,1,13,6,28,7,0,"FW,MF",20-24,Forward,Brazil,South America
2055,Paulinho,BRA,Leverkusen,Bundesliga,2021,21.0,2000.0,13.5,22,13,6,13,3,13,27,48.1,14,14,1,13,6,28,7,0,"FW,MF",20-24,Forward,Brazil,South America
2055,Paulinho,BRA,Leverkusen,Bundesliga,2021,21.0,2000.0,13.5,22,13,6,13,3,13,27,48.1,14,14,1,13,6,28,7,0,"FW,MF",20-24,Forward,Brazil,South America
2055,Paulinho,BRA,Leverkusen,Bundesliga,2021,21.0,2000.0,13.5,22,13,6,13,3,13,27,48.1,14,14,1,13,6,28,7,0,"FW,MF",20-24,Forward,Brazil,South America
2055,Paulinho,BRA,Leverkusen,Bundesliga,2021,21.0,2000.0,13.5,22,13,6,13,3,13,27,48.1,14,14,1,13,6,28,7,0,"FW,MF",20-24,Forward,Brazil,South America
2055,Paulinho,BRA,Leverkusen,Bundesliga,2021,21.0,2000.0,13.5,22,13,6,13,3,13,27,48.1,14,14,1,13,6,28,7,0,"FW,MF",20-24,Forward,Brazil,South America
2055,Paulinho,BRA,Leverkusen,Bundesliga,2021,21.0,2000.0,13.5,22,13,6,13,3,13,27,48.1,14,14,1,13,6,28,7,0,"FW,MF",20-24,Forward,Brazil,South America
2055,Paulinho,BRA,Leverkusen,Bundesliga,2021,21.0,2000.0,13.5,22,13,6,13,3,13,27,48.1,14,14,1,13,6,28,7,0,"FW,MF",20-24,Forward,Brazil,South America
2055,Paulinho,BRA,Leverkusen,Bundesliga,2021,21.0,2000.0,13.5,22,13,6,13,3,13,27,48.1,14,14,1,13,6,28,7,0,"FW,MF",20-24,Forward,Brazil,South America
2055,Paulinho,BRA,Leverkusen,Bundesliga,2021,21.0,2000.0,13.5,22,13,6,13,3,13,27,48.1,14,14,1,13,6,28,7,0,"FW,MF",20-24,Forward,Brazil,South America
2055,Paulinho,BRA,Leverkusen,Bundesliga,2021,21.0,2000.0,13.5,22,13,6,13,3,13,27,48.1,14,14,1,13,6,28,7,0,"FW,MF",20-24,Forward,Brazil,South America
2055,Paulinho,BRA,Leverkusen,Bundesliga,2021,21.0,2000.0,13.5,22,13,6,13,3,13,27,48.1,14,14,1,13,6,28,7,0,"FW,MF",20-24,Forward,Brazil,South America
2055,Paulinho,BRA,Leverkusen,Bundesliga,2021,21.0,2000.0,13.5,22,13,6,13,3,13,27,48.1,14,14,1,13,6,28,7,0,"FW,MF",20-24,Forward,Brazil,South America
2055,Paulinho,BRA,Leverkusen,Bundesliga,2021,21.0,2000.0,13.5,22,13,6,13,3,13,27,48.1,14,14,1,13,6,28,7,0,"FW,MF",20-24,Forward,Brazil,South America
2055,Paulinho,BRA,Leverkusen,Bundesliga,2021,21.0,2000.0,13.5,22,13,6,13,3,13,27,48.1,14,14,1,13,6,28,7,0,"FW,MF",20-24,Forward,Brazil,South America
2055,Paulinho,BRA,Leverkusen,Bundesliga,2021,21.0,2000.0,13.5,22,13,6,13,3,13,27,48.1,14,14,1,13,6,28,7,0,"FW,MF",20-24,Forward,Brazil,South America
2055,Paulinho,BRA,Leverkusen,Bundesliga,2021,21.0,2000.0,13.5,22,13,6,13,3,13,27,48.1,14,14,1,13,6,28,7,0,"FW,MF",20-24,Forward,Brazil,South America
2055,Paulinho,BRA,Leverkusen,Bundesliga,2021,21.0,2000.0,13.5,22,13,6,13,3,13,27,48.1,14,14,1,13,6,28,7,0,"FW,MF",20-24,Forward,Brazil,South America
2055,Paulinho,BRA,Leverkusen,Bundesliga,2021,21.0,2000.0,13.5,22,13,6,13,3,13,27,48.1,14,14,1,13,6,28,7,0,"FW,MF",20-24,Forward,Brazil,South America
2055,Paulinho,BRA,Leverkusen,Bundesliga,2021,21.0,2000.0,13.5,22,13,6,13,3,13,27,48.1,14,14,1,13,6,28,7,0,"FW,MF",20-24,Forward,Brazil,South America
2055,Paulinho,BRA,Leverkusen,Bundesliga,2021,21.0,2000.0,13.5,22,13,6,13,3,13,27,48.1,14,14,1,13,6,28,7,0,"FW,MF",20-24,Forward,Brazil,South America
2055,Paulinho,BRA,Leverkusen,Bundesliga,2021,21.0,2000.0,13.5,22,13,6,13,3,13,27,48.1,14,14,1,13,6,28,7,0,"FW,MF",20-24,Forward,Brazil,South America
2055,Paulinho,BRA,Leverkusen,Bundesliga,2021,21.0,2000.0,13.5,22,13,6,13,3,13,27,48.1,14,14,1,13,6,28,7,0,"FW,MF",20-24,Forward,Brazil,South America
2055,Paulinho,BRA,Leverkusen,Bundesliga,2021,21.0,2000.0,13.5,22,13,6,13,3,13,27,48.1,14,14,1,13,6,28,7,0,"FW,MF",20-24,Forward,Brazil,South America
2055,Paulinho,BRA,Leverkusen,Bundesliga,2021,21.0,2000.0,13.5,22,13,6,13,3,13,27,48.1,14,14,1,13,6,28,7,0,"FW,MF",20-24,Forward,Brazil,South America
2055,Paulinho,BRA,Leverkusen,Bundesliga,2021,21.0,2000.0,13.5,22,13,6,13,3,13,27,48.1,14,14,1,13,6,28,7,0,"FW,MF",20-24,Forward,Brazil,South America
2055,Paulinho,BRA,Leverkusen,Bundesliga,2021,21.0,2000.0,13.5,22,13,6,13,3,13,27,48.1,14,14,1,13,6,28,7,0,"FW,MF",20-24,Forward,Brazil,South America
2055,Paulinho,BRA,Leverkusen,Bundesliga,2021,21.0,2000.0,13.5,22,13,6,13,3,13,27,48.1,14,14,1,13,6,28,7,0,"FW,MF",20-24,Forward,Brazil,South America
2057,Benjamin Pavard,FRA,Bayern Munich,Bundesliga,2021,25.0,1996.0,23.1,35,20,21,13,1,19,29,65.5,10,28,16,12,36,71,50,1,DF,25-29,Defender,France,Europe
2059,Leonardo Pavoletti,ITA,Cagliari,Serie A,2021,32.0,1988.0,16.9,10,6,2,5,3,3,9,33.3,6,9,5,4,2,12,12,0,FW,30-34,Forward,Italy,Europe
2060,Dimitri Payet,FRA,Marseille,Ligue 1,2021,34.0,1987.0,28.8,16,8,4,10,2,7,31,22.6,24,9,0,9,9,25,3,0,"FW,MF",30-34,Forward,France,Europe
2061,Mads Pedersen,DEN,Augsburg,Bundesliga,2021,24.0,1996.0,15.5,28,21,8,15,5,12,27,44.4,15,13,4,9,15,43,30,0,"MF,DF",20-24,Midfielder,Denmark,Europe
2061,Mads Pedersen,DEN,Augsburg,Bundesliga,2021,24.0,1996.0,15.5,28,21,8,15,5,12,27,44.4,15,13,4,9,15,43,30,0,"MF,DF",20-24,Midfielder,Denmark,Europe
2061,Mads Pedersen,DEN,Augsburg,Bundesliga,2021,24.0,1996.0,15.5,28,21,8,15,5,12,27,44.4,15,13,4,9,15,43,30,0,"MF,DF",20-24,Midfielder,Denmark,Europe
2061,Mads Pedersen,DEN,Augsburg,Bundesliga,2021,24.0,1996.0,15.5,28,21,8,15,5,12,27,44.4,15,13,4,9,15,43,30,0,"MF,DF",20-24,Midfielder,Denmark,Europe
2065,João Pedro,ITA,Cagliari,Serie A,2021,29.0,1992.0,36.9,15,12,2,8,5,4,18,22.2,14,23,5,18,8,23,18,1,FW,25-29,Forward,Italy,Europe
2065,João Pedro,ITA,Cagliari,Serie A,2021,29.0,1992.0,36.9,15,12,2,8,5,4,18,22.2,14,23,5,18,8,23,18,1,FW,25-29,Forward,Italy,Europe
2065,João Pedro,ITA,Cagliari,Serie A,2021,29.0,1992.0,36.9,15,12,2,8,5,4,18,22.2,14,23,5,18,8,23,18,1,FW,25-29,Forward,Italy,Europe
2065,João Pedro,ITA,Cagliari,Serie A,2021,29.0,1992.0,36.9,15,12,2,8,5,4,18,22.2,14,23,5,18,8,23,18,1,FW,25-29,Forward,Italy,Europe
2065,João Pedro,ITA,Cagliari,Serie A,2021,29.0,1992.0,36.9,15,12,2,8,5,4,18,22.2,14,23,5,18,8,23,18,1,FW,25-29,Forward,Italy,Europe
2065,João Pedro,ITA,Cagliari,Serie A,2021,29.0,1992.0,36.9,15,12,2,8,5,4,18,22.2,14,23,5,18,8,23,18,1,FW,25-29,Forward,Italy,Europe
2065,João Pedro,ITA,Cagliari,Serie A,2021,29.0,1992.0,36.9,15,12,2,8,5,4,18,22.2,14,23,5,18,8,23,18,1,FW,25-29,Forward,Italy,Europe
2065,João Pedro,ITA,Cagliari,Serie A,2021,29.0,1992.0,36.9,15,12,2,8,5,4,18,22.2,14,23,5,18,8,23,18,1,FW,25-29,Forward,Italy,Europe
2065,João Pedro,ITA,Cagliari,Serie A,2021,29.0,1992.0,36.9,15,12,2,8,5,4,18,22.2,14,23,5,18,8,23,18,1,FW,25-29,Forward,Italy,Europe
2065,João Pedro,ITA,Cagliari,Serie A,2021,29.0,1992.0,36.9,15,12,2,8,5,4,18,22.2,14,23,5,18,8,23,18,1,FW,25-29,Forward,Italy,Europe
2065,João Pedro,ITA,Cagliari,Serie A,2021,29.0,1992.0,36.9,15,12,2,8,5,4,18,22.2,14,23,5,18,8,23,18,1,FW,25-29,Forward,Italy,Europe
2065,João Pedro,ITA,Cagliari,Serie A,2021,29.0,1992.0,36.9,15,12,2,8,5,4,18,22.2,14,23,5,18,8,23,18,1,FW,25-29,Forward,Italy,Europe
2065,João Pedro,ITA,Cagliari,Serie A,2021,29.0,1992.0,36.9,15,12,2,8,5,4,18,22.2,14,23,5,18,8,23,18,1,FW,25-29,Forward,Italy,Europe
2065,João Pedro,ITA,Cagliari,Serie A,2021,29.0,1992.0,36.9,15,12,2,8,5,4,18,22.2,14,23,5,18,8,23,18,1,FW,25-29,Forward,Italy,Europe
2065,João Pedro,ITA,Cagliari,Serie A,2021,29.0,1992.0,36.9,15,12,2,8,5,4,18,22.2,14,23,5,18,8,23,18,1,FW,25-29,Forward,Italy,Europe
2065,João Pedro,ITA,Cagliari,Serie A,2021,29.0,1992.0,36.9,15,12,2,8,5,4,18,22.2,14,23,5,18,8,23,18,1,FW,25-29,Forward,Italy,Europe
2065,João Pedro,ITA,Cagliari,Serie A,2021,29.0,1992.0,36.9,15,12,2,8,5,4,18,22.2,14,23,5,18,8,23,18,1,FW,25-29,Forward,Italy,Europe
2065,João Pedro,ITA,Cagliari,Serie A,2021,29.0,1992.0,36.9,15,12,2,8,5,4,18,22.2,14,23,5,18,8,23,18,1,FW,25-29,Forward,Italy,Europe
2065,João Pedro,ITA,Cagliari,Serie A,2021,29.0,1992.0,36.9,15,12,2,8,5,4,18,22.2,14,23,5,18,8,23,18,1,FW,25-29,Forward,Italy,Europe
2065,João Pedro,ITA,Cagliari,Serie A,2021,29.0,1992.0,36.9,15,12,2,8,5,4,18,22.2,14,23,5,18,8,23,18,1,FW,25-29,Forward,Italy,Europe
2065,João Pedro,ITA,Cagliari,Serie A,2021,29.0,1992.0,36.9,15,12,2,8,5,4,18,22.2,14,23,5,18,8,23,18,1,FW,25-29,Forward,Italy,Europe
2065,João Pedro,ITA,Cagliari,Serie A,2021,29.0,1992.0,36.9,15,12,2,8,5,4,18,22.2,14,23,5,18,8,23,18,1,FW,25-29,Forward,Italy,Europe
2065,João Pedro,ITA,Cagliari,Serie A,2021,29.0,1992.0,36.9,15,12,2,8,5,4,18,22.2,14,23,5,18,8,23,18,1,FW,25-29,Forward,Italy,Europe
2065,João Pedro,ITA,Cagliari,Serie A,2021,29.0,1992.0,36.9,15,12,2,8,5,4,18,22.2,14,23,5,18,8,23,18,1,FW,25-29,Forward,Italy,Europe
2065,João Pedro,ITA,Cagliari,Serie A,2021,29.0,1992.0,36.9,15,12,2,8,5,4,18,22.2,14,23,5,18,8,23,18,1,FW,25-29,Forward,Italy,Europe
2065,João Pedro,ITA,Cagliari,Serie A,2021,29.0,1992.0,36.9,15,12,2,8,5,4,18,22.2,14,23,5,18,8,23,18,1,FW,25-29,Forward,Italy,Europe
2065,João Pedro,ITA,Cagliari,Serie A,2021,29.0,1992.0,36.9,15,12,2,8,5,4,18,22.2,14,23,5,18,8,23,18,1,FW,25-29,Forward,Italy,Europe
2065,João Pedro,ITA,Cagliari,Serie A,2021,29.0,1992.0,36.9,15,12,2,8,5,4,18,22.2,14,23,5,18,8,23,18,1,FW,25-29,Forward,Italy,Europe
2065,João Pedro,ITA,Cagliari,Serie A,2021,29.0,1992.0,36.9,15,12,2,8,5,4,18,22.2,14,23,5,18,8,23,18,1,FW,25-29,Forward,Italy,Europe
2065,João Pedro,ITA,Cagliari,Serie A,2021,29.0,1992.0,36.9,15,12,2,8,5,4,18,22.2,14,23,5,18,8,23,18,1,FW,25-29,Forward,Italy,Europe
2065,João Pedro,ITA,Cagliari,Serie A,2021,29.0,1992.0,36.9,15,12,2,8,5,4,18,22.2,14,23,5,18,8,23,18,1,FW,25-29,Forward,Italy,Europe
2065,João Pedro,ITA,Cagliari,Serie A,2021,29.0,1992.0,36.9,15,12,2,8,5,4,18,22.2,14,23,5,18,8,23,18,1,FW,25-29,Forward,Italy,Europe
2065,João Pedro,ITA,Cagliari,Serie A,2021,29.0,1992.0,36.9,15,12,2,8,5,4,18,22.2,14,23,5,18,8,23,18,1,FW,25-29,Forward,Italy,Europe
2065,João Pedro,ITA,Cagliari,Serie A,2021,29.0,1992.0,36.9,15,12,2,8,5,4,18,22.2,14,23,5,18,8,23,18,1,FW,25-29,Forward,Italy,Europe
2065,João Pedro,ITA,Cagliari,Serie A,2021,29.0,1992.0,36.9,15,12,2,8,5,4,18,22.2,14,23,5,18,8,23,18,1,FW,25-29,Forward,Italy,Europe
2065,João Pedro,ITA,Cagliari,Serie A,2021,29.0,1992.0,36.9,15,12,2,8,5,4,18,22.2,14,23,5,18,8,23,18,1,FW,25-29,Forward,Italy,Europe
2065,João Pedro,ITA,Cagliari,Serie A,2021,29.0,1992.0,36.9,15,12,2,8,5,4,18,22.2,14,23,5,18,8,23,18,1,FW,25-29,Forward,Italy,Europe
2065,João Pedro,ITA,Cagliari,Serie A,2021,29.0,1992.0,36.9,15,12,2,8,5,4,18,22.2,14,23,5,18,8,23,18,1,FW,25-29,Forward,Italy,Europe
2065,João Pedro,ITA,Cagliari,Serie A,2021,29.0,1992.0,36.9,15,12,2,8,5,4,18,22.2,14,23,5,18,8,23,18,1,FW,25-29,Forward,Italy,Europe
2065,João Pedro,ITA,Cagliari,Serie A,2021,29.0,1992.0,36.9,15,12,2,8,5,4,18,22.2,14,23,5,18,8,23,18,1,FW,25-29,Forward,Italy,Europe
2065,João Pedro,ITA,Cagliari,Serie A,2021,29.0,1992.0,36.9,15,12,2,8,5,4,18,22.2,14,23,5,18,8,23,18,1,FW,25-29,Forward,Italy,Europe
2065,João Pedro,ITA,Cagliari,Serie A,2021,29.0,1992.0,36.9,15,12,2,8,5,4,18,22.2,14,23,5,18,8,23,18,1,FW,25-29,Forward,Italy,Europe
2065,João Pedro,ITA,Cagliari,Serie A,2021,29.0,1992.0,36.9,15,12,2,8,5,4,18,22.2,14,23,5,18,8,23,18,1,FW,25-29,Forward,Italy,Europe
2065,João Pedro,ITA,Cagliari,Serie A,2021,29.0,1992.0,36.9,15,12,2,8,5,4,18,22.2,14,23,5,18,8,23,18,1,FW,25-29,Forward,Italy,Europe
2065,João Pedro,ITA,Cagliari,Serie A,2021,29.0,1992.0,36.9,15,12,2,8,5,4,18,22.2,14,23,5,18,8,23,18,1,FW,25-29,Forward,Italy,Europe
2065,João Pedro,ITA,Cagliari,Serie A,2021,29.0,1992.0,36.9,15,12,2,8,5,4,18,22.2,14,23,5,18,8,23,18,1,FW,25-29,Forward,Italy,Europe
2065,João Pedro,ITA,Cagliari,Serie A,2021,29.0,1992.0,36.9,15,12,2,8,5,4,18,22.2,14,23,5,18,8,23,18,1,FW,25-29,Forward,Italy,Europe
2065,João Pedro,ITA,Cagliari,Serie A,2021,29.0,1992.0,36.9,15,12,2,8,5,4,18,22.2,14,23,5,18,8,23,18,1,FW,25-29,Forward,Italy,Europe
2065,João Pedro,ITA,Cagliari,Serie A,2021,29.0,1992.0,36.9,15,12,2,8,5,4,18,22.2,14,23,5,18,8,23,18,1,FW,25-29,Forward,Italy,Europe
2065,João Pedro,ITA,Cagliari,Serie A,2021,29.0,1992.0,36.9,15,12,2,8,5,4,18,22.2,14,23,5,18,8,23,18,1,FW,25-29,Forward,Italy,Europe
2065,João Pedro,ITA,Cagliari,Serie A,2021,29.0,1992.0,36.9,15,12,2,8,5,4,18,22.2,14,23,5,18,8,23,18,1,FW,25-29,Forward,Italy,Europe
2065,João Pedro,ITA,Cagliari,Serie A,2021,29.0,1992.0,36.9,15,12,2,8,5,4,18,22.2,14,23,5,18,8,23,18,1,FW,25-29,Forward,Italy,Europe
2065,João Pedro,ITA,Cagliari,Serie A,2021,29.0,1992.0,36.9,15,12,2,8,5,4,18,22.2,14,23,5,18,8,23,18,1,FW,25-29,Forward,Italy,Europe
2065,João Pedro,ITA,Cagliari,Serie A,2021,29.0,1992.0,36.9,15,12,2,8,5,4,18,22.2,14,23,5,18,8,23,18,1,FW,25-29,Forward,Italy,Europe
2065,João Pedro,ITA,Cagliari,Serie A,2021,29.0,1992.0,36.9,15,12,2,8,5,4,18,22.2,14,23,5,18,8,23,18,1,FW,25-29,Forward,Italy,Europe
2065,João Pedro,ITA,Cagliari,Serie A,2021,29.0,1992.0,36.9,15,12,2,8,5,4,18,22.2,14,23,5,18,8,23,18,1,FW,25-29,Forward,Italy,Europe
2065,João Pedro,ITA,Cagliari,Serie A,2021,29.0,1992.0,36.9,15,12,2,8,5,4,18,22.2,14,23,5,18,8,23,18,1,FW,25-29,Forward,Italy,Europe
2065,João Pedro,ITA,Cagliari,Serie A,2021,29.0,1992.0,36.9,15,12,2,8,5,4,18,22.2,14,23,5,18,8,23,18,1,FW,25-29,Forward,Italy,Europe
2065,João Pedro,ITA,Cagliari,Serie A,2021,29.0,1992.0,36.9,15,12,2,8,5,4,18,22.2,14,23,5,18,8,23,18,1,FW,25-29,Forward,Italy,Europe
2065,João Pedro,ITA,Cagliari,Serie A,2021,29.0,1992.0,36.9,15,12,2,8,5,4,18,22.2,14,23,5,18,8,23,18,1,FW,25-29,Forward,Italy,Europe
2065,João Pedro,ITA,Cagliari,Serie A,2021,29.0,1992.0,36.9,15,12,2,8,5,4,18,22.2,14,23,5,18,8,23,18,1,FW,25-29,Forward,Italy,Europe
2065,João Pedro,ITA,Cagliari,Serie A,2021,29.0,1992.0,36.9,15,12,2,8,5,4,18,22.2,14,23,5,18,8,23,18,1,FW,25-29,Forward,Italy,Europe
2065,João Pedro,ITA,Cagliari,Serie A,2021,29.0,1992.0,36.9,15,12,2,8,5,4,18,22.2,14,23,5,18,8,23,18,1,FW,25-29,Forward,Italy,Europe
2065,João Pedro,ITA,Cagliari,Serie A,2021,29.0,1992.0,36.9,15,12,2,8,5,4,18,22.2,14,23,5,18,8,23,18,1,FW,25-29,Forward,Italy,Europe
2065,João Pedro,ITA,Cagliari,Serie A,2021,29.0,1992.0,36.9,15,12,2,8,5,4,18,22.2,14,23,5,18,8,23,18,1,FW,25-29,Forward,Italy,Europe
2065,João Pedro,ITA,Cagliari,Serie A,2021,29.0,1992.0,36.9,15,12,2,8,5,4,18,22.2,14,23,5,18,8,23,18,1,FW,25-29,Forward,Italy,Europe
2065,João Pedro,ITA,Cagliari,Serie A,2021,29.0,1992.0,36.9,15,12,2,8,5,4,18,22.2,14,23,5,18,8,23,18,1,FW,25-29,Forward,Italy,Europe
2065,João Pedro,ITA,Cagliari,Serie A,2021,29.0,1992.0,36.9,15,12,2,8,5,4,18,22.2,14,23,5,18,8,23,18,1,FW,25-29,Forward,Italy,Europe
2065,João Pedro,ITA,Cagliari,Serie A,2021,29.0,1992.0,36.9,15,12,2,8,5,4,18,22.2,14,23,5,18,8,23,18,1,FW,25-29,Forward,Italy,Europe
2065,João Pedro,ITA,Cagliari,Serie A,2021,29.0,1992.0,36.9,15,12,2,8,5,4,18,22.2,14,23,5,18,8,23,18,1,FW,25-29,Forward,Italy,Europe
2065,João Pedro,ITA,Cagliari,Serie A,2021,29.0,1992.0,36.9,15,12,2,8,5,4,18,22.2,14,23,5,18,8,23,18,1,FW,25-29,Forward,Italy,Europe
2065,João Pedro,ITA,Cagliari,Serie A,2021,29.0,1992.0,36.9,15,12,2,8,5,4,18,22.2,14,23,5,18,8,23,18,1,FW,25-29,Forward,Italy,Europe
2065,João Pedro,ITA,Cagliari,Serie A,2021,29.0,1992.0,36.9,15,12,2,8,5,4,18,22.2,14,23,5,18,8,23,18,1,FW,25-29,Forward,Italy,Europe
2065,João Pedro,ITA,Cagliari,Serie A,2021,29.0,1992.0,36.9,15,12,2,8,5,4,18,22.2,14,23,5,18,8,23,18,1,FW,25-29,Forward,Italy,Europe
2065,João Pedro,ITA,Cagliari,Serie A,2021,29.0,1992.0,36.9,15,12,2,8,5,4,18,22.2,14,23,5,18,8,23,18,1,FW,25-29,Forward,Italy,Europe
2065,João Pedro,ITA,Cagliari,Serie A,2021,29.0,1992.0,36.9,15,12,2,8,5,4,18,22.2,14,23,5,18,8,23,18,1,FW,25-29,Forward,Italy,Europe
2065,João Pedro,ITA,Cagliari,Serie A,2021,29.0,1992.0,36.9,15,12,2,8,5,4,18,22.2,14,23,5,18,8,23,18,1,FW,25-29,Forward,Italy,Europe
2065,João Pedro,ITA,Cagliari,Serie A,2021,29.0,1992.0,36.9,15,12,2,8,5,4,18,22.2,14,23,5,18,8,23,18,1,FW,25-29,Forward,Italy,Europe
2065,João Pedro,ITA,Cagliari,Serie A,2021,29.0,1992.0,36.9,15,12,2,8,5,4,18,22.2,14,23,5,18,8,23,18,1,FW,25-29,Forward,Italy,Europe
2065,João Pedro,ITA,Cagliari,Serie A,2021,29.0,1992.0,36.9,15,12,2,8,5,4,18,22.2,14,23,5,18,8,23,18,1,FW,25-29,Forward,Italy,Europe
2065,João Pedro,ITA,Cagliari,Serie A,2021,29.0,1992.0,36.9,15,12,2,8,5,4,18,22.2,14,23,5,18,8,23,18,1,FW,25-29,Forward,Italy,Europe
2067,Gianluca Pegolo,ITA,Sassuolo,Serie A,2021,40.0,1981.0,1.0,0,0,0,0,0,0,0,,0,0,0,0,0,0,0,1,GK,Over 40,Goalkeeper,Italy,Europe
2069,Pietro Pellegri,ITA,Torino,Serie A,2021,20.0,2001.0,2.4,1,1,0,1,0,0,4,0.0,4,0,0,0,0,1,5,0,FW,20-24,Forward,Italy,Europe
2070,Pietro Pellegri,ITA,Milan,Serie A,2021,20.0,2001.0,1.5,2,2,0,1,1,0,1,0.0,1,0,0,0,0,2,1,0,FW,20-24,Forward,Italy,Europe
2071,Lorenzo Pellegrini,ITA,Roma,Serie A,2021,25.0,1996.0,25.4,35,14,10,17,8,16,60,26.7,44,29,1,28,27,62,20,0,MF,25-29,Midfielder,Italy,Europe
2072,Luca Pellegrini,ITA,Juventus,Serie A,2021,22.0,1999.0,12.3,23,10,13,5,5,12,19,63.2,7,9,1,8,5,28,23,0,DF,20-24,Defender,Italy,Europe
2074,Federico Peluso,ITA,Sassuolo,Serie A,2021,37.0,1984.0,0.1,1,1,0,1,0,1,1,100.0,0,0,0,0,0,1,0,0,DF,35-39,Defender,Italy,Europe
2077,Philipp Pentke,GER,Hoffenheim,Bundesliga,2021,36.0,1985.0,1.0,0,0,0,0,0,0,0,,0,0,0,0,0,0,0,0,GK,35-39,Goalkeeper,Germany,Europe
2078,Nicolas Pépé,CIV,Arsenal,Premier League,2021,26.0,1995.0,7.7,8,5,3,5,0,3,9,33.3,6,9,1,8,8,16,2,0,"FW,MF",25-29,Forward,Ivory Coast,Africa
2082,Danilo Pereira,POR,Paris S-G,Ligue 1,2021,29.0,1991.0,22.6,33,17,10,20,3,14,28,50.0,14,19,10,9,37,70,29,1,MF,25-29,Midfielder,Portugal,Europe
2083,Mathias Pereira Lage,POR,Angers,Ligue 1,2021,24.0,1996.0,11.6,21,7,10,7,4,8,30,26.7,22,18,7,11,21,42,22,0,DF,20-24,Defender,Portugal,Europe
2084,Ricardo Pereira,POR,Leicester City,Premier League,2021,27.0,1993.0,11.0,37,20,19,13,5,21,40,52.5,19,13,1,12,17,54,39,0,DF,25-29,Defender,Portugal,Europe
2085,Gastón Pereiro,URU,Cagliari,Serie A,2021,26.0,1995.0,10.8,13,5,7,4,2,5,18,27.8,13,12,1,11,1,14,8,0,"FW,MF",25-29,Forward,Uruguay,South America
2087,Dor Peretz,ISR,Venezia,Serie A,2021,26.0,1995.0,6.5,27,18,8,16,3,13,25,52.0,12,8,4,4,8,35,11,0,MF,25-29,Midfielder,Israel,Asia
2097,Mattia Perin,ITA,Juventus,Serie A,2021,28.0,1992.0,4.5,0,0,0,0,0,0,0,,0,0,0,0,0,0,3,0,GK,25-29,Goalkeeper,Italy,Europe
2099,Sonny Perkins,ENG,West Ham,Premier League,2021,17.0,2004.0,0.0,0,0,0,0,0,0,0,,0,0,0,0,0,0,0,0,MF,Under 20,Midfielder,England,Europe
2100,Diego Perotti,ARG,Salernitana,Serie A,2021,33.0,1988.0,3.2,11,5,7,1,3,4,13,30.8,9,1,0,1,2,13,6,0,"MF,FW",30-34,Midfielder,Argentina,South America
2101,Romain Perraud,FRA,Southampton,Premier League,2021,23.0,1997.0,18.0,34,22,18,14,2,16,29,55.2,13,24,6,18,17,51,42,0,DF,20-24,Defender,France,Europe
2104,Pavao Pervan,AUT,Wolfsburg,Bundesliga,2021,33.0,1987.0,6.0,0,0,0,0,0,0,0,,0,0,0,0,0,0,3,0,GK,30-34,Goalkeeper,Austria,Europe
2105,Matteo Pessina,ITA,Atalanta,Serie A,2021,24.0,1997.0,16.0,27,14,10,11,6,14,33,42.4,19,22,3,19,13,40,7,0,"MF,FW",20-24,Midfielder,Italy,Europe
2106,Andrea Petagna,ITA,Napoli,Serie A,2021,26.0,1995.0,6.5,3,3,0,3,0,1,4,25.0,3,1,0,1,0,3,5,0,FW,25-29,Forward,Italy,Europe
2107,Nils Petersen,GER,Freiburg,Bundesliga,2021,32.0,1988.0,6.4,5,3,2,3,0,1,13,7.7,12,7,0,7,2,7,17,0,FW,30-34,Forward,Germany,Europe
2109,Léo Pétrot,FRA,Lorient,Ligue 1,2021,24.0,1997.0,20.2,31,17,23,8,0,21,29,72.4,8,33,17,16,22,53,86,0,DF,20-24,Defender,France,Europe
2113,Germán Pezzella,ARG,Betis,La Liga,2021,30.0,1991.0,22.1,21,9,16,5,0,16,29,55.2,13,29,18,11,39,60,106,0,DF,30-34,Defender,Argentina,South America
2114,Giuseppe Pezzella,ITA,Atalanta,Serie A,2021,23.0,1997.0,11.9,28,13,15,7,6,8,18,44.4,10,13,5,8,9,37,16,0,"DF,MF",20-24,Defender,Italy,Europe
2115,Immanuel Pherai,SUR,Dortmund,Bundesliga,2021,20.0,2001.0,0.0,0,0,0,0,0,0,0,,0,0,0,0,0,0,0,0,MF,20-24,Midfielder,Suriname,South America
2116,Maximilian Philipp,GER,Wolfsburg,Bundesliga,2021,27.0,1994.0,10.7,15,11,6,7,2,5,21,23.8,16,12,1,11,4,19,5,0,MF,25-29,Midfielder,Germany,Europe
2117,Romain Philippoteaux,FRA,Brest,Ligue 1,2021,33.0,1988.0,0.3,1,1,0,1,0,0,0,,0,0,0,0,0,1,0,0,MF,30-34,Midfielder,France,Europe
2118,Kalvin Phillips,ENG,Leeds United,Premier League,2021,25.0,1995.0,17.7,54,25,24,25,5,24,57,42.1,33,37,9,28,24,78,18,0,MF,25-29,Midfielder,England,Europe
2120,Jérôme Phojo,FRA,Clermont Foot,Ligue 1,2021,28.0,1993.0,0.1,0,0,0,0,0,0,0,,0,0,0,0,0,0,1,0,DF,25-29,Defender,France,Europe
2123,Pablo Piatti,ARG,Elche,La Liga,2021,32.0,1989.0,3.5,9,4,5,3,1,3,8,37.5,5,5,1,4,2,11,3,0,"MF,FW",30-34,Midfielder,Argentina,South America
2124,Cristiano Piccini,ITA,Valencia,La Liga,2021,28.0,1992.0,3.6,14,8,9,5,0,5,7,71.4,2,3,2,1,1,15,11,0,DF,25-29,Defender,Italy,Europe
2125,Roberto Piccoli,ITA,Genoa,Serie A,2021,20.0,2001.0,2.4,1,1,0,1,0,0,0,,0,0,0,0,1,2,1,1,FW,20-24,Forward,Italy,Europe
2126,Roberto Piccoli,ITA,Atalanta,Serie A,2021,20.0,2001.0,2.2,2,0,0,0,2,0,2,0.0,2,1,0,1,0,2,0,0,FW,20-24,Forward,Italy,Europe
2127,Jordan Pickford,ENG,Everton,Premier League,2021,27.0,1994.0,35.0,1,1,1,0,0,0,1,0.0,1,1,0,1,1,2,14,1,GK,25-29,Goalkeeper,England,Europe
2128,Jérémy Pied,FRA,Lille,Ligue 1,2021,32.0,1989.0,0.1,0,0,0,0,0,0,0,,0,0,0,0,1,1,0,0,"DF,FW",30-34,Defender,France,Europe
2129,Amos Pieper,GER,Arminia,Bundesliga,2021,23.0,1998.0,26.4,58,29,38,19,1,32,51,62.7,19,37,23,14,50,108,132,1,DF,20-24,Defender,Germany,Europe
2130,Ronaël Pierre-Gabriel,FRA,Brest,Ligue 1,2021,23.0,1998.0,28.3,79,45,52,21,6,42,73,57.5,31,22,7,15,48,127,74,0,DF,20-24,Defender,France,Europe
2131,Erik Pieters,NED,Burnley,Premier League,2021,32.0,1988.0,8.1,28,15,15,11,2,17,28,60.7,11,18,7,11,10,38,38,0,DF,30-34,Defender,Netherlands,Europe
2133,Andrea Pinamonti,ITA,Empoli,Serie A,2021,22.0,1999.0,31.9,11,6,0,7,4,2,18,11.1,16,24,3,21,7,18,23,0,FW,20-24,Forward,Italy,Europe
2135,Ethan Pinnock,JAM,Brentford,Premier League,2021,28.0,1993.0,29.9,51,35,37,12,2,25,38,65.8,13,30,11,19,44,95,154,1,DF,25-29,Defender,Jamaica,North America
2137,Carlo Pinsoglio,ITA,Juventus,Serie A,2021,31.0,1990.0,0.5,0,0,0,0,0,0,0,,0,0,0,0,0,0,0,0,GK,30-34,Goalkeeper,Italy,Europe
2140,Marko Pjaca,CRO,Torino,Serie A,2021,26.0,1995.0,12.8,7,4,1,4,2,3,8,37.5,5,10,2,8,4,11,2,0,MF,25-29,Midfielder,Croatia,Europe
2141,Marvin Plattenhardt,GER,Hertha BSC,Bundesliga,2021,29.0,1992.0,18.2,25,11,18,6,1,15,27,55.6,12,18,3,15,17,42,52,0,DF,25-29,Defender,Germany,Europe
2142,Alassane Pléa,FRA,Gladbach,Bundesliga,2021,28.0,1993.0,23.0,18,14,6,9,3,7,20,35.0,13,9,1,8,4,22,9,0,"MF,FW",25-29,Midfielder,France,Europe
2143,Tommaso Pobega,ITA,Torino,Serie A,2021,22.0,1999.0,24.9,48,30,17,20,11,21,40,52.5,19,32,3,29,25,73,38,0,MF,20-24,Midfielder,Italy,Europe
2146,Paul Pogba,FRA,Manchester Utd,Premier League,2021,28.0,1993.0,15.0,13,9,5,7,1,6,28,21.4,22,11,0,11,13,26,16,0,"MF,FW",25-29,Midfielder,France,Europe
2147,Joel Pohjanpalo,FIN,Leverkusen,Bundesliga,2021,26.0,1994.0,0.1,0,0,0,0,0,0,0,,0,0,0,0,0,0,0,0,FW,25-29,Forward,Finland,Europe
2148,Matteo Politano,ITA,Napoli,Serie A,2021,27.0,1993.0,18.3,24,12,8,11,5,15,54,27.8,39,11,2,9,13,37,5,0,FW,25-29,Forward,Italy,Europe
2149,Julian Pollersbeck,GER,Lyon,Ligue 1,2021,26.0,1994.0,4.8,0,0,0,0,0,0,0,,0,0,0,0,1,1,1,0,GK,25-29,Goalkeeper,Germany,Europe
2150,Sebastian Polter,GER,Bochum,Bundesliga,2021,30.0,1991.0,26.0,9,3,1,4,4,2,11,18.2,9,15,5,10,2,11,24,0,FW,30-34,Forward,Germany,Europe
2152,Marin Pongračić,CRO,Dortmund,Bundesliga,2021,23.0,1997.0,9.2,17,10,13,4,0,6,10,60.0,4,11,5,6,17,34,32,2,DF,20-24,Defender,Croatia,Europe
2154,Nick Pope,ENG,Burnley,Premier League,2021,29.0,1992.0,36.0,0,0,0,0,0,0,2,0.0,2,0,0,0,2,2,30,3,GK,25-29,Goalkeeper,England,Europe
2155,Manolo Portanova,ITA,Genoa,Serie A,2021,21.0,2000.0,14.7,46,28,9,26,11,14,34,41.2,20,26,2,24,17,63,22,0,"FW,MF",20-24,Forward,Italy,Europe
2157,Stefan Posch,AUT,Hoffenheim,Bundesliga,2021,24.0,1997.0,24.4,48,30,20,26,2,22,39,56.4,17,43,18,25,28,76,71,2,DF,20-24,Defender,Austria,Europe
2159,Yussuf Poulsen,DEN,RB Leipzig,Bundesliga,2021,27.0,1994.0,12.0,13,4,3,6,4,3,13,23.1,10,13,0,13,3,16,9,0,"FW,MF",25-29,Forward,Denmark,Europe
2160,Gaëtan Poussin,FRA,Bordeaux,Ligue 1,2021,22.0,1999.0,13.0,1,1,1,0,0,1,1,100.0,0,0,0,0,0,1,15,1,GK,20-24,Goalkeeper,France,Europe
2167,Nicolas de Préville,FRA,Metz,Ligue 1,2021,30.0,1991.0,21.9,17,8,7,8,2,3,19,15.8,16,12,4,8,5,22,11,0,"FW,MF",30-34,Forward,France,Europe
2169,Manuel Prietl,AUT,Arminia,Bundesliga,2021,29.0,1991.0,23.6,59,26,23,31,5,23,60,38.3,37,28,3,25,39,98,33,0,MF,25-29,Midfielder,Austria,Europe
2171,Grischa Prömel,GER,Union Berlin,Bundesliga,2021,26.0,1995.0,26.9,36,22,14,17,5,22,52,42.3,30,18,3,15,23,59,22,0,MF,25-29,Midfielder,Germany,Europe
2172,Nick Proschwitz,GER,Hoffenheim,Bundesliga,2021,34.0,1986.0,0.3,0,0,0,0,0,0,0,,0,0,0,0,0,0,0,0,FW,30-34,Forward,Germany,Europe
2173,Ivan Provedel,ITA,Spezia,Serie A,2021,27.0,1994.0,30.7,0,0,0,0,0,0,1,0.0,1,0,0,0,2,2,10,2,GK,25-29,Goalkeeper,Italy,Europe
2178,Teemu Pukki,FIN,Norwich City,Premier League,2021,31.0,1990.0,36.1,23,11,2,14,7,6,29,20.7,23,21,1,20,4,27,3,0,FW,30-34,Forward,Finland,Europe
2179,Erick Pulgar,CHI,Fiorentina,Serie A,2021,27.0,1994.0,3.8,6,6,4,2,0,4,9,44.4,5,5,1,4,5,11,2,1,MF,25-29,Midfielder,Chile,South America
2180,Christian Pulisic,USA,Chelsea,Premier League,2021,22.0,1998.0,14.3,10,7,6,3,1,3,17,17.6,14,12,0,12,5,15,10,0,"MF,FW",20-24,Midfielder,United States,North America
2181,Afimico Pululu,FRA,Greuther Fürth,Bundesliga,2021,22.0,1999.0,0.8,1,0,1,0,0,1,2,50.0,1,1,0,1,0,1,0,0,"FW,MF",20-24,Forward,France,Europe
2182,Ignacio Pussetto,ARG,Udinese,Serie A,2021,25.0,1995.0,13.4,17,9,2,9,6,2,10,20.0,8,18,2,16,4,21,13,0,"FW,MF",25-29,Forward,Argentina,South America
2183,Niklas Pyyhtiä,FIN,Bologna,Serie A,2021,17.0,2003.0,0.2,0,0,0,0,0,0,1,0.0,1,0,0,0,0,0,0,0,MF,Under 20,Midfielder,Finland,Europe
2185,Yacine Qasmi,MAR,Rayo Vallecano,La Liga,2021,30.0,1991.0,0.0,0,0,0,0,0,0,0,,0,0,0,0,0,0,0,0,FW,30-34,Forward,Morocco,Africa
2186,Fabio Quagliarella,ITA,Sampdoria,Serie A,2021,38.0,1983.0,18.5,6,2,2,2,2,2,15,13.3,13,14,1,13,3,9,12,0,FW,35-39,Forward,Italy,Europe
2190,Adrien Rabiot,FRA,Juventus,Serie A,2021,26.0,1995.0,25.4,64,43,32,24,8,15,34,44.1,19,34,8,26,20,84,41,1,MF,25-29,Midfielder,France,Europe
2198,Sidney Raebiger,GER,RB Leipzig,Bundesliga,2021,16.0,2005.0,0.0,0,0,0,0,0,0,0,,0,0,0,0,0,0,0,0,MF,Under 20,Midfielder,Germany,Europe
2199,Rafinha,BRA,Real Sociedad,La Liga,2021,28.0,1993.0,11.7,43,27,17,20,6,16,28,57.1,12,21,2,19,12,55,4,0,MF,25-29,Midfielder,Brazil,South America
2199,Rafinha,BRA,Real Sociedad,La Liga,2021,28.0,1993.0,11.7,43,27,17,20,6,16,28,57.1,12,21,2,19,12,55,4,0,MF,25-29,Midfielder,Brazil,South America
2199,Rafinha,BRA,Real Sociedad,La Liga,2021,28.0,1993.0,11.7,43,27,17,20,6,16,28,57.1,12,21,2,19,12,55,4,0,MF,25-29,Midfielder,Brazil,South America
2199,Rafinha,BRA,Real Sociedad,La Liga,2021,28.0,1993.0,11.7,43,27,17,20,6,16,28,57.1,12,21,2,19,12,55,4,0,MF,25-29,Midfielder,Brazil,South America
2199,Rafinha,BRA,Real Sociedad,La Liga,2021,28.0,1993.0,11.7,43,27,17,20,6,16,28,57.1,12,21,2,19,12,55,4,0,MF,25-29,Midfielder,Brazil,South America
2199,Rafinha,BRA,Real Sociedad,La Liga,2021,28.0,1993.0,11.7,43,27,17,20,6,16,28,57.1,12,21,2,19,12,55,4,0,MF,25-29,Midfielder,Brazil,South America
2199,Rafinha,BRA,Real Sociedad,La Liga,2021,28.0,1993.0,11.7,43,27,17,20,6,16,28,57.1,12,21,2,19,12,55,4,0,MF,25-29,Midfielder,Brazil,South America
2199,Rafinha,BRA,Real Sociedad,La Liga,2021,28.0,1993.0,11.7,43,27,17,20,6,16,28,57.1,12,21,2,19,12,55,4,0,MF,25-29,Midfielder,Brazil,South America
2199,Rafinha,BRA,Real Sociedad,La Liga,2021,28.0,1993.0,11.7,43,27,17,20,6,16,28,57.1,12,21,2,19,12,55,4,0,MF,25-29,Midfielder,Brazil,South America
2199,Rafinha,BRA,Real Sociedad,La Liga,2021,28.0,1993.0,11.7,43,27,17,20,6,16,28,57.1,12,21,2,19,12,55,4,0,MF,25-29,Midfielder,Brazil,South America
2199,Rafinha,BRA,Real Sociedad,La Liga,2021,28.0,1993.0,11.7,43,27,17,20,6,16,28,57.1,12,21,2,19,12,55,4,0,MF,25-29,Midfielder,Brazil,South America
2199,Rafinha,BRA,Real Sociedad,La Liga,2021,28.0,1993.0,11.7,43,27,17,20,6,16,28,57.1,12,21,2,19,12,55,4,0,MF,25-29,Midfielder,Brazil,South America
2199,Rafinha,BRA,Real Sociedad,La Liga,2021,28.0,1993.0,11.7,43,27,17,20,6,16,28,57.1,12,21,2,19,12,55,4,0,MF,25-29,Midfielder,Brazil,South America
2199,Rafinha,BRA,Real Sociedad,La Liga,2021,28.0,1993.0,11.7,43,27,17,20,6,16,28,57.1,12,21,2,19,12,55,4,0,MF,25-29,Midfielder,Brazil,South America
2199,Rafinha,BRA,Real Sociedad,La Liga,2021,28.0,1993.0,11.7,43,27,17,20,6,16,28,57.1,12,21,2,19,12,55,4,0,MF,25-29,Midfielder,Brazil,South America
2199,Rafinha,BRA,Real Sociedad,La Liga,2021,28.0,1993.0,11.7,43,27,17,20,6,16,28,57.1,12,21,2,19,12,55,4,0,MF,25-29,Midfielder,Brazil,South America
2200,Rafinha,BRA,Paris S-G,Ligue 1,2021,28.0,1993.0,2.4,14,8,3,9,2,7,11,63.6,4,3,0,3,4,18,0,0,"FW,MF",25-29,Forward,Brazil,South America
2200,Rafinha,BRA,Paris S-G,Ligue 1,2021,28.0,1993.0,2.4,14,8,3,9,2,7,11,63.6,4,3,0,3,4,18,0,0,"FW,MF",25-29,Forward,Brazil,South America
2200,Rafinha,BRA,Paris S-G,Ligue 1,2021,28.0,1993.0,2.4,14,8,3,9,2,7,11,63.6,4,3,0,3,4,18,0,0,"FW,MF",25-29,Forward,Brazil,South America
2200,Rafinha,BRA,Paris S-G,Ligue 1,2021,28.0,1993.0,2.4,14,8,3,9,2,7,11,63.6,4,3,0,3,4,18,0,0,"FW,MF",25-29,Forward,Brazil,South America
2200,Rafinha,BRA,Paris S-G,Ligue 1,2021,28.0,1993.0,2.4,14,8,3,9,2,7,11,63.6,4,3,0,3,4,18,0,0,"FW,MF",25-29,Forward,Brazil,South America
2200,Rafinha,BRA,Paris S-G,Ligue 1,2021,28.0,1993.0,2.4,14,8,3,9,2,7,11,63.6,4,3,0,3,4,18,0,0,"FW,MF",25-29,Forward,Brazil,South America
2200,Rafinha,BRA,Paris S-G,Ligue 1,2021,28.0,1993.0,2.4,14,8,3,9,2,7,11,63.6,4,3,0,3,4,18,0,0,"FW,MF",25-29,Forward,Brazil,South America
2200,Rafinha,BRA,Paris S-G,Ligue 1,2021,28.0,1993.0,2.4,14,8,3,9,2,7,11,63.6,4,3,0,3,4,18,0,0,"FW,MF",25-29,Forward,Brazil,South America
2200,Rafinha,BRA,Paris S-G,Ligue 1,2021,28.0,1993.0,2.4,14,8,3,9,2,7,11,63.6,4,3,0,3,4,18,0,0,"FW,MF",25-29,Forward,Brazil,South America
2200,Rafinha,BRA,Paris S-G,Ligue 1,2021,28.0,1993.0,2.4,14,8,3,9,2,7,11,63.6,4,3,0,3,4,18,0,0,"FW,MF",25-29,Forward,Brazil,South America
2200,Rafinha,BRA,Paris S-G,Ligue 1,2021,28.0,1993.0,2.4,14,8,3,9,2,7,11,63.6,4,3,0,3,4,18,0,0,"FW,MF",25-29,Forward,Brazil,South America
2200,Rafinha,BRA,Paris S-G,Ligue 1,2021,28.0,1993.0,2.4,14,8,3,9,2,7,11,63.6,4,3,0,3,4,18,0,0,"FW,MF",25-29,Forward,Brazil,South America
2200,Rafinha,BRA,Paris S-G,Ligue 1,2021,28.0,1993.0,2.4,14,8,3,9,2,7,11,63.6,4,3,0,3,4,18,0,0,"FW,MF",25-29,Forward,Brazil,South America
2200,Rafinha,BRA,Paris S-G,Ligue 1,2021,28.0,1993.0,2.4,14,8,3,9,2,7,11,63.6,4,3,0,3,4,18,0,0,"FW,MF",25-29,Forward,Brazil,South America
2200,Rafinha,BRA,Paris S-G,Ligue 1,2021,28.0,1993.0,2.4,14,8,3,9,2,7,11,63.6,4,3,0,3,4,18,0,0,"FW,MF",25-29,Forward,Brazil,South America
2200,Rafinha,BRA,Paris S-G,Ligue 1,2021,28.0,1993.0,2.4,14,8,3,9,2,7,11,63.6,4,3,0,3,4,18,0,0,"FW,MF",25-29,Forward,Brazil,South America
2208,Adil Rami,FRA,Troyes,Ligue 1,2021,35.0,1985.0,13.0,10,9,6,4,0,7,8,87.5,1,17,9,8,16,26,43,0,DF,35-39,Defender,France,Europe
2212,Aaron Ramsdale,ENG,Arsenal,Premier League,2021,23.0,1998.0,34.0,2,1,2,0,0,1,2,50.0,1,0,0,0,0,2,26,3,GK,20-24,Goalkeeper,England,Europe
2213,Aaron Ramsey,WAL,Juventus,Serie A,2021,30.0,1990.0,1.1,0,0,0,0,0,0,0,,0,0,0,0,1,1,0,0,MF,30-34,Midfielder,Wales,Europe
2213,Aaron Ramsey,WAL,Juventus,Serie A,2021,30.0,1990.0,1.1,0,0,0,0,0,0,0,,0,0,0,0,1,1,0,0,MF,30-34,Midfielder,Wales,Europe
2213,Aaron Ramsey,WAL,Juventus,Serie A,2021,30.0,1990.0,1.1,0,0,0,0,0,0,0,,0,0,0,0,1,1,0,0,MF,30-34,Midfielder,Wales,Europe
2213,Aaron Ramsey,WAL,Juventus,Serie A,2021,30.0,1990.0,1.1,0,0,0,0,0,0,0,,0,0,0,0,1,1,0,0,MF,30-34,Midfielder,Wales,Europe
2214,Jacob Ramsey,ENG,Aston Villa,Premier League,2021,20.0,2001.0,27.4,67,44,31,28,8,30,69,43.5,39,36,7,29,24,91,28,0,MF,20-24,Midfielder,England,Europe
2215,Luca Ranieri,ITA,Salernitana,Serie A,2021,22.0,1999.0,23.4,38,21,23,11,4,19,33,57.6,14,18,8,10,22,60,67,0,DF,20-24,Defender,Italy,Europe
2216,Andrea Ranocchia,ITA,Inter,Serie A,2021,33.0,1988.0,3.8,8,4,5,1,2,1,3,33.3,2,4,3,1,4,12,16,0,DF,30-34,Defender,Italy,Europe
2217,Raphinha,BRA,Leeds United,Premier League,2021,24.0,1996.0,32.4,51,29,25,14,12,22,71,31.0,49,43,0,43,29,80,28,1,"FW,MF",20-24,Forward,Brazil,South America
2218,Tobias Raschl,GER,Greuther Fürth,Bundesliga,2021,21.0,2000.0,6.6,12,9,4,8,0,5,7,71.4,2,10,1,9,3,15,1,0,MF,20-24,Midfielder,Germany,Europe
2220,Marcus Rashford,ENG,Manchester Utd,Premier League,2021,23.0,1997.0,13.7,6,5,1,4,1,2,13,15.4,11,10,1,9,5,11,5,1,"FW,MF",20-24,Forward,England,Europe
2222,Giacomo Raspadori,ITA,Sassuolo,Serie A,2021,21.0,2000.0,30.4,29,18,5,15,9,11,38,28.9,27,29,3,26,9,38,11,0,"MF,FW",20-24,Midfielder,Italy,Europe
2224,David Raum,GER,Hoffenheim,Bundesliga,2021,23.0,1998.0,30.6,52,29,30,10,12,30,64,46.9,34,38,5,33,27,79,39,1,"DF,FW",20-24,Defender,Germany,Europe
2225,Nicola Ravaglia,ITA,Sampdoria,Serie A,2021,32.0,1988.0,0.1,0,0,0,0,0,0,0,,0,0,0,0,0,0,0,0,GK,30-34,Goalkeeper,Italy,Europe
2227,Ante Rebić,CRO,Milan,Serie A,2021,27.0,1993.0,9.9,14,8,3,6,5,7,20,35.0,13,14,0,14,3,17,3,1,FW,25-29,Forward,Croatia,Europe
2230,Nathan Redmond,ENG,Southampton,Premier League,2021,27.0,1994.0,20.4,22,14,9,9,4,7,30,23.3,23,21,2,19,8,30,16,0,"MF,FW",25-29,Midfielder,England,Europe
2234,Jeff Reine-Adélaïde,FRA,Lyon,Ligue 1,2021,23.0,1998.0,2.2,5,3,4,1,0,4,5,80.0,1,2,0,2,0,5,0,1,"MF,DF",20-24,Midfielder,France,Europe
2235,Reinier,BRA,Dortmund,Bundesliga,2021,19.0,2002.0,1.8,5,3,4,0,1,1,1,100.0,0,3,0,3,0,5,0,0,"FW,MF",Under 20,Forward,Brazil,South America
2236,Karim Rekik,NED,Sevilla,La Liga,2021,26.0,1994.0,12.2,11,8,4,6,1,2,9,22.2,7,11,6,5,9,20,19,0,DF,25-29,Defender,Netherlands,Europe
2240,Marco Reus,GER,Dortmund,Bundesliga,2021,32.0,1989.0,27.8,45,30,13,21,11,16,42,38.1,26,23,6,17,12,57,41,1,"MF,FW",30-34,Midfielder,Germany,Europe
2246,Franck Ribéry,FRA,Salernitana,Serie A,2021,38.0,1983.0,15.8,17,10,6,6,5,8,13,61.5,5,12,0,12,3,20,1,0,"MF,FW",35-39,Midfielder,France,Europe
2247,Samuele Ricci,ITA,Torino,Serie A,2021,19.0,2001.0,8.0,8,4,4,2,2,2,5,40.0,3,7,1,6,14,22,9,0,MF,Under 20,Midfielder,Italy,Europe
2248,Samuele Ricci,ITA,Empoli,Serie A,2021,19.0,2001.0,17.0,33,19,17,13,3,20,34,58.8,14,24,5,19,31,64,18,0,MF,Under 20,Midfielder,Italy,Europe
2249,Declan Rice,ENG,West Ham,Premier League,2021,22.0,1999.0,35.3,80,42,45,32,3,38,71,53.5,33,45,21,24,63,143,52,1,MF,20-24,Midfielder,England,Europe
2250,Chris Richards,USA,Hoffenheim,Bundesliga,2021,21.0,2000.0,14.5,26,15,10,15,1,11,18,61.1,7,21,9,12,22,48,50,1,DF,20-24,Defender,United States,North America
2251,Chris Richards,USA,Bayern Munich,Bundesliga,2021,21.0,2000.0,0.0,0,0,0,0,0,0,0,,0,1,0,1,0,0,0,0,DF,20-24,Defender,United States,North America
2253,Taylor Richards,ENG,Brighton,Premier League,2021,20.0,2000.0,0.3,1,0,0,1,0,1,2,50.0,1,0,0,0,0,1,0,0,MF,20-24,Midfielder,England,Europe
2254,Richarlison,BRA,Everton,Premier League,2021,24.0,1997.0,28.0,40,23,18,15,7,15,31,48.4,16,42,4,38,12,52,34,0,FW,20-24,Forward,Brazil,South America
2255,Marco Richter,GER,Hertha BSC,Bundesliga,2021,23.0,1997.0,18.9,30,16,14,10,6,13,36,36.1,23,30,4,26,16,46,24,0,"FW,MF",20-24,Forward,Germany,Europe
2260,Manuel Riemann,GER,Bochum,Bundesliga,2021,32.0,1988.0,31.0,1,0,1,0,0,1,4,25.0,3,0,0,0,1,2,12,3,GK,30-34,Goalkeeper,Germany,Europe
2261,Tomás Rincón,VEN,Torino,Serie A,2021,33.0,1988.0,1.8,2,2,2,0,0,0,3,0.0,3,3,1,2,2,4,4,0,MF,30-34,Midfielder,Venezuela,South America
2262,Tomás Rincón,VEN,Sampdoria,Serie A,2021,33.0,1988.0,13.0,22,13,9,10,3,13,34,38.2,21,15,2,13,18,40,11,0,MF,30-34,Midfielder,Venezuela,South America
2264,Renaud Ripart,FRA,Troyes,Ligue 1,2021,28.0,1993.0,21.0,38,21,18,15,5,18,50,36.0,32,21,1,20,19,57,21,1,"MF,FW",25-29,Midfielder,France,Europe
2266,Matt Ritchie,SCO,Newcastle Utd,Premier League,2021,31.0,1989.0,14.9,22,15,10,10,2,10,27,37.0,17,10,2,8,13,35,26,0,DF,30-34,Defender,Scotland,Europe
2267,Maxence Rivera,FRA,Saint-Étienne,Ligue 1,2021,19.0,2002.0,0.1,0,0,0,0,0,0,0,,0,0,0,0,0,0,0,0,FW,Under 20,Forward,France,Europe
2270,Connor Roberts,WAL,Burnley,Premier League,2021,25.0,1995.0,18.8,20,13,10,7,3,10,15,66.7,5,25,5,20,22,42,62,1,DF,25-29,Defender,Wales,Europe
2271,Patrick Roberts,ENG,Troyes,Ligue 1,2021,24.0,1997.0,0.2,0,0,0,0,0,0,0,,0,0,0,0,0,0,0,0,MF,20-24,Midfielder,England,Europe
2272,Tyler Roberts,WAL,Leeds United,Premier League,2021,22.0,1999.0,11.0,16,7,6,7,3,9,16,56.3,7,11,1,10,5,21,11,0,"MF,FW",20-24,Midfielder,Wales,Europe
2273,Andrew Robertson,SCO,Liverpool,Premier League,2021,27.0,1994.0,28.2,36,21,16,15,5,20,35,57.1,15,24,3,21,23,59,61,0,DF,25-29,Defender,Scotland,Europe
2276,Cimo Röcker,GER,Hertha BSC,Bundesliga,2021,27.0,1994.0,0.2,0,0,0,0,0,0,0,,0,0,0,0,2,2,0,0,DF,25-29,Defender,Germany,Europe
2277,Enzo Roco,CHI,Elche,La Liga,2021,28.0,1992.0,28.4,36,20,24,11,1,15,24,62.5,9,38,27,11,28,64,110,3,DF,25-29,Defender,Chile,South America
2279,Sebastian Rode,GER,Eint Frankfurt,Bundesliga,2021,30.0,1990.0,8.4,15,7,5,8,2,5,17,29.4,12,11,1,10,13,28,8,0,MF,30-34,Midfielder,Germany,Europe
2280,Joe Rodon,WAL,Tottenham,Premier League,2021,23.0,1997.0,1.0,0,0,0,0,0,0,0,,0,2,1,1,0,0,7,0,DF,20-24,Defender,Wales,Europe
2290,Guido Rodríguez,ARG,Betis,La Liga,2021,27.0,1994.0,28.1,97,53,46,45,6,54,98,55.1,44,55,12,43,31,128,56,0,MF,25-29,Midfielder,Argentina,South America
2292,Ricardo Rodríguez,SUI,Torino,Serie A,2021,28.0,1992.0,27.5,36,21,11,23,2,18,33,54.5,15,22,8,14,41,77,48,1,DF,25-29,Defender,Switzerland,Europe
2293,Rodrygo,BRA,Real Madrid,La Liga,2021,20.0,2001.0,16.9,18,14,7,4,7,3,18,16.7,15,21,0,21,11,29,3,0,FW,20-24,Forward,Brazil,South America
2294,Mads Roerslev,DEN,Brentford,Premier League,2021,22.0,1999.0,13.8,23,12,19,2,2,14,32,43.8,18,14,5,9,16,39,29,0,DF,20-24,Defender,Denmark,Europe
2295,Marko Rog,CRO,Cagliari,Serie A,2021,26.0,1995.0,3.5,5,3,1,2,2,1,8,12.5,7,6,1,5,1,6,3,0,MF,25-29,Midfielder,Croatia,Europe
2296,Rogério,BRA,Sassuolo,Serie A,2021,23.0,1998.0,19.2,21,13,12,5,4,15,22,68.2,7,20,8,12,18,39,42,1,DF,20-24,Defender,Brazil,South America
2296,Rogério,BRA,Sassuolo,Serie A,2021,23.0,1998.0,19.2,21,13,12,5,4,15,22,68.2,7,20,8,12,18,39,42,1,DF,20-24,Defender,Brazil,South America
2296,Rogério,BRA,Sassuolo,Serie A,2021,23.0,1998.0,19.2,21,13,12,5,4,15,22,68.2,7,20,8,12,18,39,42,1,DF,20-24,Defender,Brazil,South America
2296,Rogério,BRA,Sassuolo,Serie A,2021,23.0,1998.0,19.2,21,13,12,5,4,15,22,68.2,7,20,8,12,18,39,42,1,DF,20-24,Defender,Brazil,South America
2297,Alessio Romagnoli,ITA,Milan,Serie A,2021,26.0,1995.0,15.7,24,14,14,10,0,14,18,77.8,4,21,12,9,19,43,45,0,DF,25-29,Defender,Italy,Europe
2298,Simone Romagnoli,ITA,Empoli,Serie A,2021,31.0,1990.0,16.6,28,12,14,12,2,15,20,75.0,5,34,28,6,9,37,86,0,DF,30-34,Defender,Italy,Europe
2300,Cristian Romero,ARG,Tottenham,Premier League,2021,23.0,1998.0,20.5,62,39,39,21,2,22,34,64.7,12,46,21,25,33,95,74,1,DF,20-24,Defender,Argentina,South America
2302,Luka Romero,ARG,Lazio,Serie A,2021,16.0,2004.0,0.9,2,1,0,1,1,0,2,0.0,2,0,0,0,1,3,0,0,FW,Under 20,Forward,Argentina,South America
2303,Sergio Romero,ARG,Venezia,Serie A,2021,34.0,1987.0,16.0,2,2,2,0,0,2,2,100.0,0,0,0,0,1,3,10,0,GK,30-34,Goalkeeper,Argentina,South America
2305,Cristiano Ronaldo,POR,Manchester Utd,Premier League,2021,36.0,1985.0,27.3,8,6,1,5,2,2,6,33.3,4,8,0,8,2,10,29,0,FW,35-39,Forward,Portugal,Europe
2306,Cristiano Ronaldo,POR,Juventus,Serie A,2021,36.0,1985.0,0.3,1,0,0,1,0,1,1,100.0,0,0,0,0,0,1,0,0,FW,35-39,Forward,Portugal,Europe
2307,Salomón Rondón,VEN,Everton,Premier League,2021,31.0,1989.0,8.8,6,1,1,2,3,4,14,28.6,10,5,0,5,0,6,10,0,FW,30-34,Forward,Venezuela,South America
2308,Valentin Rongier,FRA,Marseille,Ligue 1,2021,26.0,1994.0,24.4,77,51,36,36,5,28,60,46.7,32,26,5,21,33,110,14,0,"MF,DF",25-29,Midfielder,France,Europe
2309,Marten de Roon,NED,Atalanta,Serie A,2021,30.0,1991.0,28.3,69,42,33,29,7,34,62,54.8,28,36,2,34,45,114,41,0,"MF,DF",30-34,Midfielder,Netherlands,Europe
2311,Pablo Rosario,NED,Nice,Ligue 1,2021,24.0,1997.0,30.3,59,37,18,32,9,26,66,39.4,40,33,7,26,38,97,43,0,MF,20-24,Midfielder,Netherlands,Europe
2312,Romario Rösch,GER,Mainz 05,Bundesliga,2021,22.0,1999.0,0.0,0,0,0,0,0,0,0,,0,0,0,0,0,0,0,0,MF,20-24,Midfielder,Germany,Europe
2313,Danny Rose,ENG,Watford,Premier League,2021,31.0,1990.0,7.7,16,10,11,4,1,10,24,41.7,14,8,5,3,14,30,11,1,DF,30-34,Defender,England,Europe
2314,Francesco Rossi,ITA,Atalanta,Serie A,2021,30.0,1991.0,0.4,0,0,0,0,0,0,0,,0,0,0,0,0,0,0,0,GK,30-34,Goalkeeper,Italy,Europe
2316,Jérôme Roussillon,FRA,Wolfsburg,Bundesliga,2021,28.0,1993.0,19.7,14,9,8,6,0,10,16,62.5,6,24,5,19,14,28,34,2,DF,25-29,Defender,France,Europe
2317,Nicolò Rovella,ITA,Genoa,Serie A,2021,19.0,2001.0,16.3,37,26,16,14,7,15,40,37.5,25,21,1,20,20,57,20,0,MF,Under 20,Midfielder,Italy,Europe
2322,John Ruddy,ENG,Wolves,Premier League,2021,34.0,1986.0,1.5,0,0,0,0,0,0,0,,0,0,0,0,0,0,3,0,GK,30-34,Goalkeeper,England,Europe
2323,Antonio Rüdiger,GER,Chelsea,Premier League,2021,28.0,1993.0,33.7,48,28,29,15,4,36,48,75.0,12,20,11,9,28,76,91,1,DF,25-29,Defender,Germany,Europe
2324,Sebastian Rudy,GER,Hoffenheim,Bundesliga,2021,31.0,1990.0,8.6,22,12,9,13,0,11,21,52.4,10,8,3,5,11,33,8,1,MF,30-34,Midfielder,Germany,Europe
2326,Matteo Ruggeri,ITA,Salernitana,Serie A,2021,19.0,2002.0,7.5,8,4,5,2,1,7,10,70.0,3,6,1,5,2,10,25,0,DF,Under 20,Defender,Italy,Europe
2327,Mário Rui,POR,Napoli,Serie A,2021,30.0,1991.0,33.2,68,43,32,28,8,39,84,46.4,45,31,7,24,40,108,50,0,DF,30-34,Defender,Portugal,Europe
2332,Gerónimo Rulli,ARG,Villarreal,La Liga,2021,29.0,1992.0,32.0,0,0,0,0,0,0,4,0.0,4,0,0,0,1,1,15,5,GK,25-29,Goalkeeper,Argentina,South America
2334,Alessandro Russo,ITA,Salernitana,Serie A,2021,17.0,2003.0,0.3,1,0,1,0,0,0,1,0.0,1,0,0,0,0,1,1,0,MF,Under 20,Midfielder,Italy,Europe
2334,Alessandro Russo,ITA,Salernitana,Serie A,2021,17.0,2003.0,0.3,1,0,1,0,0,0,1,0.0,1,0,0,0,0,1,1,0,MF,Under 20,Midfielder,Italy,Europe
2334,Alessandro Russo,ITA,Salernitana,Serie A,2021,17.0,2003.0,0.3,1,0,1,0,0,0,1,0.0,1,0,0,0,0,1,1,0,MF,Under 20,Midfielder,Italy,Europe
2334,Alessandro Russo,ITA,Salernitana,Serie A,2021,17.0,2003.0,0.3,1,0,1,0,0,0,1,0.0,1,0,0,0,0,1,1,0,MF,Under 20,Midfielder,Italy,Europe
2336,Georginio Rutter,FRA,Hoffenheim,Bundesliga,2021,19.0,2002.0,17.9,18,13,4,8,6,6,17,35.3,11,29,1,28,6,24,11,1,"FW,MF",Under 20,Forward,France,Europe
2337,Mathew Ryan,AUS,Real Sociedad,La Liga,2021,29.0,1992.0,3.0,0,0,0,0,0,0,0,,0,0,0,0,0,0,2,0,GK,25-29,Goalkeeper,Australia,Oceania
2340,José Sá,POR,Wolves,Premier League,2021,28.0,1993.0,36.5,2,1,2,0,0,2,4,50.0,2,0,0,0,2,4,19,5,GK,25-29,Goalkeeper,Portugal,Europe
2341,Roli Pereira de Sa,FRA,Nantes,Ligue 1,2021,24.0,1996.0,6.4,12,4,3,5,4,3,20,15.0,17,6,0,6,6,18,3,0,MF,20-24,Midfielder,France,Europe
2342,Youssouf Sabaly,SEN,Betis,La Liga,2021,28.0,1993.0,8.8,12,10,11,0,1,7,13,53.8,6,11,4,7,13,25,16,1,DF,25-29,Defender,Senegal,Africa
2343,Mathys Saban,FRA,Saint-Étienne,Ligue 1,2021,19.0,2002.0,0.8,4,2,2,2,0,1,1,100.0,0,1,0,1,0,4,0,0,"FW,MF",Under 20,Forward,France,Europe
2344,Stefano Sabelli,ITA,Genoa,Serie A,2021,28.0,1993.0,3.9,6,3,3,2,1,3,9,33.3,6,5,1,4,3,9,12,0,DF,25-29,Defender,Italy,Europe
2345,Abdelhamid Sabiri,MAR,Sampdoria,Serie A,2021,24.0,1996.0,9.9,34,18,10,15,9,7,25,28.0,18,10,2,8,7,41,3,0,"MF,FW",20-24,Midfielder,Morocco,Africa
2346,Marcel Sabitzer,AUT,RB Leipzig,Bundesliga,2021,27.0,1994.0,0.5,2,1,1,1,0,1,1,100.0,0,0,0,0,1,3,0,0,"MF,FW",25-29,Midfielder,Austria,Europe
2347,Marcel Sabitzer,AUT,Bayern Munich,Bundesliga,2021,27.0,1994.0,10.1,18,7,8,8,2,9,19,47.4,10,7,0,7,9,27,10,1,"MF,DF",25-29,Midfielder,Austria,Europe
2348,Falaye Sacko,MLI,Saint-Étienne,Ligue 1,2021,26.0,1995.0,7.4,15,10,14,1,0,13,16,81.3,3,11,7,4,4,19,18,2,DF,25-29,Defender,Mali,Africa
2349,Alexis Saelemaekers,BEL,Milan,Serie A,2021,22.0,1999.0,20.7,43,22,12,17,14,15,51,29.4,36,19,0,19,15,58,8,0,FW,20-24,Forward,Belgium,Europe
2351,Wesley Saïd,FRA,Lens,Ligue 1,2021,26.0,1995.0,7.3,10,5,1,8,1,1,9,11.1,8,4,0,4,2,12,0,0,"FW,MF",25-29,Forward,France,Europe
2354,Bukayo Saka,ENG,Arsenal,Premier League,2021,19.0,2001.0,33.1,40,21,12,17,11,13,39,33.3,26,28,2,26,22,62,23,0,"FW,MF",Under 20,Forward,England,Europe
2355,Mamadou Sakho,FRA,Montpellier,Ligue 1,2021,31.0,1990.0,28.6,34,22,26,8,0,16,26,61.5,10,41,34,7,41,75,134,4,DF,30-34,Defender,France,Europe
2357,Jacopo Sala,ITA,Spezia,Serie A,2021,29.0,1991.0,9.8,22,11,10,10,2,13,30,43.3,17,6,0,6,14,36,11,0,MF,25-29,Midfielder,Italy,Europe
2358,Mohamed Salah,EGY,Liverpool,Premier League,2021,29.0,1992.0,30.7,17,8,5,9,3,6,19,31.6,13,7,1,6,6,23,5,0,FW,25-29,Forward,Egypt,Africa
2360,William Saliba,FRA,Marseille,Ligue 1,2021,20.0,2001.0,36.0,54,32,36,16,2,27,35,77.1,8,24,16,8,48,102,85,0,DF,20-24,Defender,France,Europe
2361,Romain Salin,FRA,Rennes,Ligue 1,2021,37.0,1984.0,1.0,0,0,0,0,0,0,0,,0,0,0,0,0,0,0,0,GK,35-39,Goalkeeper,France,Europe
2362,Mohammed Salisu,GHA,Southampton,Premier League,2021,22.0,1999.0,33.0,80,47,54,22,4,40,65,61.5,25,49,26,23,78,158,158,4,DF,20-24,Defender,Ghana,Africa
2369,Albert Sambi Lokonga,BEL,Arsenal,Premier League,2021,21.0,1999.0,12.6,22,18,11,9,2,12,14,85.7,2,12,7,5,13,35,12,4,MF,20-24,Midfielder,Belgium,Europe
2370,Junior Sambia,FRA,Montpellier,Ligue 1,2021,24.0,1996.0,17.0,22,13,12,7,3,13,22,59.1,9,22,3,19,21,43,31,0,"DF,FW",20-24,Defender,France,Europe
2371,Luigi Samele,ITA,Sassuolo,Serie A,2021,19.0,2002.0,0.1,0,0,0,0,0,0,0,,0,0,0,0,0,0,1,0,FW,Under 20,Forward,Italy,Europe
2373,Antonio Sanabria,PAR,Torino,Serie A,2021,25.0,1996.0,20.0,3,2,0,1,2,1,4,25.0,3,11,4,7,2,5,10,0,FW,25-29,Forward,Paraguay,South America
2376,Alexis Sánchez,CHI,Inter,Serie A,2021,32.0,1988.0,9.8,9,8,0,6,3,2,11,18.2,9,4,0,4,2,11,3,0,FW,30-34,Forward,Chile,South America
2382,Jadon Sancho,ENG,Manchester Utd,Premier League,2021,21.0,2000.0,21.1,14,8,9,4,1,8,22,36.4,14,19,0,19,15,29,5,3,"FW,MF",20-24,Forward,England,Europe
2384,Alex Sandro,BRA,Juventus,Serie A,2021,30.0,1991.0,19.8,27,16,15,9,3,11,25,44.0,14,17,6,11,27,54,40,0,DF,30-34,Defender,Brazil,South America
2385,Leroy Sané,GER,Bayern Munich,Bundesliga,2021,25.0,1996.0,22.0,28,16,5,19,4,9,24,37.5,15,18,0,18,12,40,2,1,"FW,MF",25-29,Forward,Germany,Europe
2387,Mohamed Sankoh,NED,Stuttgart,Bundesliga,2021,17.0,2003.0,0.0,0,0,0,0,0,0,0,,0,0,0,0,0,0,0,0,FW,Under 20,Forward,Netherlands,Europe
2388,Morgan Sanson,FRA,Aston Villa,Premier League,2021,26.0,1994.0,4.0,12,8,7,2,3,3,7,42.9,4,13,0,13,10,22,2,1,MF,25-29,Midfielder,France,Europe
2389,Nicola Sansone,ITA,Bologna,Serie A,2021,29.0,1991.0,10.0,13,7,5,6,2,3,15,20.0,12,1,0,1,4,17,2,0,"FW,MF",25-29,Forward,Italy,Europe
2390,Baptiste Santamaria,FRA,Rennes,Ligue 1,2021,26.0,1995.0,28.0,52,27,15,31,6,24,44,54.5,20,33,12,21,33,85,42,0,"MF,DF",25-29,Midfielder,France,Europe
2391,Baptiste Santamaria,FRA,Freiburg,Bundesliga,2021,26.0,1995.0,0.2,0,0,0,0,0,0,1,0.0,1,0,0,0,1,1,1,0,MF,25-29,Midfielder,France,Europe
2392,Federico Santander,PAR,Bologna,Serie A,2021,30.0,1991.0,0.7,2,1,1,1,0,1,1,100.0,0,0,0,0,0,2,0,0,"FW,DF",30-34,Forward,Paraguay,South America
2400,Marcelo Saracchi,URU,Levante,La Liga,2021,23.0,1998.0,2.1,8,5,6,1,1,2,4,50.0,2,3,0,3,4,12,7,1,DF,20-24,Defender,Uruguay,South America
2401,Josh Sargent,USA,Norwich City,Premier League,2021,21.0,2000.0,17.5,26,14,15,7,4,14,39,35.9,25,29,2,27,11,37,18,2,"FW,MF",20-24,Forward,United States,North America
2402,Jeremy Sarmiento,ECU,Brighton,Premier League,2021,19.0,2002.0,0.5,1,1,0,0,1,0,2,0.0,2,2,0,2,0,1,0,0,"FW,MF",Under 20,Forward,Ecuador,South America
2403,Bouna Sarr,SEN,Bayern Munich,Bundesliga,2021,29.0,1992.0,0.7,4,4,2,1,1,4,5,80.0,1,2,1,1,6,10,1,0,DF,25-29,Defender,Senegal,Africa
2405,Malang Sarr,FRA,Chelsea,Premier League,2021,22.0,1999.0,6.1,14,7,10,2,2,7,12,58.3,5,6,3,3,11,25,20,0,DF,20-24,Defender,France,Europe
2407,Giacomo Satalino,ITA,Sassuolo,Serie A,2021,22.0,1999.0,0.1,0,0,0,0,0,0,0,,0,0,0,0,0,0,0,0,GK,20-24,Goalkeeper,Italy,Europe
2410,Téji Savanier,FRA,Montpellier,Ligue 1,2021,29.0,1991.0,26.8,46,27,18,19,9,21,59,35.6,38,23,1,22,25,71,12,1,MF,25-29,Midfielder,France,Europe
2411,Esteban Saveljich,MNE,Rayo Vallecano,La Liga,2021,30.0,1991.0,18.9,18,11,11,7,0,9,15,60.0,6,20,12,8,16,34,69,0,DF,30-34,Defender,Montenegro,Europe
2413,Joe Scally,USA,Gladbach,Bundesliga,2021,18.0,2002.0,21.2,40,30,21,14,5,17,41,41.5,24,27,4,23,22,62,38,0,DF,Under 20,Defender,United States,North America
2414,Giorgio Scalvini,ITA,Atalanta,Serie A,2021,17.0,2003.0,8.5,22,11,13,8,1,9,19,47.4,10,12,1,11,22,44,16,0,"DF,MF",Under 20,Defender,Italy,Europe
2415,Gianluca Scamacca,ITA,Sassuolo,Serie A,2021,22.0,1999.0,23.8,19,14,2,5,12,5,21,23.8,16,16,1,15,5,24,22,1,FW,20-24,Forward,Italy,Europe
2417,Kevin Schade,GER,Freiburg,Bundesliga,2021,19.0,2001.0,9.2,9,7,6,2,1,3,10,30.0,7,15,3,12,3,12,16,0,"MF,FW",Under 20,Midfielder,Germany,Europe
2418,András Schäfer,HUN,Union Berlin,Bundesliga,2021,22.0,1999.0,2.7,4,1,3,1,0,0,5,0.0,5,7,1,6,2,6,4,0,MF,20-24,Midfielder,Hungary,Europe
2419,Fabian Schär,SUI,Newcastle Utd,Premier League,2021,29.0,1991.0,24.0,16,11,11,3,2,8,16,50.0,8,27,18,9,32,48,95,2,DF,25-29,Defender,Switzerland,Europe
2420,Louis Schaub,AUT,Köln,Bundesliga,2021,26.0,1994.0,7.3,16,10,7,7,2,11,20,55.0,9,17,3,14,3,19,3,0,"MF,FW",25-29,Midfielder,Austria,Europe
2421,Andrea Schiavone,ITA,Salernitana,Serie A,2021,28.0,1993.0,6.3,14,8,5,9,0,10,23,43.5,13,13,3,10,8,22,12,0,MF,25-29,Midfielder,Italy,Europe
2424,Xaver Schlager,AUT,Wolfsburg,Bundesliga,2021,23.0,1997.0,11.6,43,20,20,20,3,20,49,40.8,29,25,2,23,9,52,14,0,MF,20-24,Midfielder,Austria,Europe
2425,Keven Schlotterbeck,GER,Freiburg,Bundesliga,2021,24.0,1997.0,3.5,11,5,6,5,0,5,6,83.3,1,7,4,3,11,22,24,1,"DF,FW",20-24,Defender,Germany,Europe
2426,Nico Schlotterbeck,GER,Freiburg,Bundesliga,2021,21.0,1999.0,30.9,72,43,36,34,2,33,48,68.8,15,41,32,9,56,128,154,1,DF,20-24,Defender,Germany,Europe
2429,Jonathan Schmid,FRA,Freiburg,Bundesliga,2021,31.0,1990.0,6.5,12,6,6,3,3,5,7,71.4,2,7,1,6,6,18,15,0,DF,30-34,Defender,France,Europe
2430,Benno Schmitz,GER,Köln,Bundesliga,2021,26.0,1994.0,26.9,57,37,21,27,9,42,86,48.8,44,44,8,36,39,96,39,0,DF,25-29,Defender,Germany,Europe
2431,David Schnegg,AUT,Venezia,Serie A,2021,22.0,1998.0,1.6,2,0,1,1,0,1,3,33.3,2,4,0,4,3,5,6,0,DF,20-24,Defender,Austria,Europe
2433,Alessandro Schöpf,AUT,Arminia,Bundesliga,2021,27.0,1994.0,26.6,40,22,19,16,5,14,30,46.7,16,31,5,26,30,70,21,1,MF,25-29,Midfielder,Austria,Europe
2435,Nico Schulz,GER,Dortmund,Bundesliga,2021,28.0,1993.0,9.3,21,12,9,7,5,9,21,42.9,12,8,1,7,11,32,8,0,DF,25-29,Defender,Germany,Europe
2436,Marvin Schwäbe,GER,Köln,Bundesliga,2021,26.0,1995.0,21.0,0,0,0,0,0,0,0,,0,0,0,0,0,0,8,1,GK,25-29,Goalkeeper,Germany,Europe
2437,Alexander Schwolow,GER,Hertha BSC,Bundesliga,2021,29.0,1992.0,24.2,0,0,0,0,0,0,1,0.0,1,0,0,0,2,2,18,3,GK,25-29,Goalkeeper,Germany,Europe
2439,Demba Seck,SEN,Torino,Serie A,2021,20.0,2001.0,1.6,2,1,0,2,0,0,0,,0,0,0,0,0,2,0,0,"MF,FW",20-24,Midfielder,Senegal,Africa
2441,Paul Seguin,GER,Greuther Fürth,Bundesliga,2021,26.0,1995.0,23.4,50,31,15,32,3,26,56,46.4,30,27,3,24,19,69,30,1,MF,25-29,Midfielder,Germany,Europe
2442,Alidu Seidu,GHA,Clermont Foot,Ligue 1,2021,21.0,2000.0,15.7,34,20,20,13,1,16,27,59.3,11,25,11,14,34,68,49,1,DF,20-24,Defender,Ghana,Africa
2443,Davie Selke,GER,Hertha BSC,Bundesliga,2021,26.0,1995.0,11.2,5,4,1,3,1,1,3,33.3,2,6,1,5,1,6,11,0,FW,25-29,Forward,Germany,Europe
2444,Matz Sels,BEL,Strasbourg,Ligue 1,2021,29.0,1992.0,37.0,1,1,1,0,0,0,0,,0,0,0,0,1,2,22,0,GK,25-29,Goalkeeper,Belgium,Europe
2445,Ken Sema,SWE,Watford,Premier League,2021,27.0,1993.0,9.5,16,6,11,4,1,9,20,45.0,11,10,0,10,5,21,11,0,"MF,FW",25-29,Midfielder,Sweden,Europe
2446,Nélson Semedo,POR,Wolves,Premier League,2021,27.0,1993.0,23.7,58,39,39,17,2,25,49,51.0,24,23,4,19,21,79,64,1,"MF,DF",25-29,Midfielder,Portugal,Europe
2449,Stefano Sensi,ITA,Sampdoria,Serie A,2021,25.0,1995.0,8.4,18,9,10,6,2,10,23,43.5,13,2,0,2,6,24,4,0,"MF,FW",25-29,Midfielder,Italy,Europe
2450,Stefano Sensi,ITA,Inter,Serie A,2021,25.0,1995.0,1.9,4,3,1,3,0,2,4,50.0,2,2,0,2,0,4,2,0,"MF,FW",25-29,Midfielder,Italy,Europe
2451,Luigi Sepe,ITA,Salernitana,Serie A,2021,30.0,1991.0,15.5,0,0,0,0,0,0,0,,0,0,0,0,1,1,3,0,GK,30-34,Goalkeeper,Italy,Europe
2452,Suat Serdar,GER,Hertha BSC,Bundesliga,2021,24.0,1997.0,24.6,64,30,24,29,11,25,55,45.5,30,32,3,29,20,84,14,0,"MF,FW",20-24,Midfielder,Germany,Europe
2453,Laurens Serpe,ITA,Genoa,Serie A,2021,20.0,2001.0,0.5,1,0,1,0,0,1,2,50.0,1,0,0,0,0,1,1,0,DF,20-24,Defender,Italy,Europe
2458,Ryan Sessegnon,ENG,Tottenham,Premier League,2021,21.0,2000.0,11.6,25,19,14,7,4,11,22,50.0,11,18,3,15,7,32,26,0,"DF,MF",20-24,Defender,England,Europe
2459,Nils Seufert,GER,Greuther Fürth,Bundesliga,2021,24.0,1997.0,1.1,3,2,1,1,1,0,1,0.0,1,0,0,0,0,3,0,0,MF,20-24,Midfielder,Germany,Europe
2461,Stephan El Shaarawy,ITA,Roma,Serie A,2021,28.0,1992.0,11.7,13,8,4,9,0,4,6,66.7,2,10,2,8,11,24,8,0,"FW,DF",25-29,Forward,Italy,Europe
2462,Jamie Shackleton,ENG,Leeds United,Premier League,2021,21.0,1999.0,7.9,27,16,19,7,1,13,25,52.0,12,11,7,4,8,35,12,1,"DF,MF",20-24,Defender,England,Europe
2463,Xherdan Shaqiri,SUI,Lyon,Ligue 1,2021,29.0,1991.0,7.5,7,3,0,5,2,2,10,20.0,8,2,0,2,2,9,2,0,"FW,MF",25-29,Forward,Switzerland,Europe
2464,Luke Shaw,ENG,Manchester Utd,Premier League,2021,26.0,1995.0,17.8,21,13,9,9,3,12,21,57.1,9,22,11,11,9,30,22,2,DF,25-29,Defender,England,Europe
2466,Aimar Sher,SWE,Spezia,Serie A,2021,18.0,2002.0,0.5,2,1,1,1,0,0,1,0.0,1,1,0,1,3,5,1,0,MF,Under 20,Midfielder,Sweden,Europe
2467,Eldor Shomurodov,UZB,Roma,Serie A,2021,26.0,1995.0,8.7,5,4,0,4,1,1,10,10.0,9,8,0,8,2,7,5,0,"FW,MF",25-29,Forward,Uzbekistan,Asia
2471,Alassane Sidibe,CIV,Atalanta,Serie A,2021,19.0,2002.0,0.1,1,1,1,0,0,0,0,,0,0,0,0,0,1,0,0,MF,Under 20,Midfielder,Ivory Coast,Africa
2472,Djibril Sidibé,FRA,Monaco,Ligue 1,2021,29.0,1992.0,10.5,24,13,13,8,3,9,24,37.5,15,10,1,9,16,40,13,0,DF,25-29,Defender,France,Europe
2474,Francisco Sierralta,CHI,Watford,Premier League,2021,24.0,1997.0,4.7,7,3,7,0,0,5,8,62.5,3,7,2,5,6,13,35,0,DF,20-24,Defender,Chile,South America
2476,Kiliann Sildillia,FRA,Freiburg,Bundesliga,2021,19.0,2002.0,1.9,7,3,3,4,0,3,6,50.0,3,1,0,1,2,9,7,1,"DF,MF",Under 20,Defender,France,Europe
2478,André Silva,POR,RB Leipzig,Bundesliga,2021,25.0,1995.0,23.1,13,9,2,3,8,4,13,30.8,9,20,2,18,2,15,15,0,FW,25-29,Forward,Portugal,Europe
2478,André Silva,POR,RB Leipzig,Bundesliga,2021,25.0,1995.0,23.1,13,9,2,3,8,4,13,30.8,9,20,2,18,2,15,15,0,FW,25-29,Forward,Portugal,Europe
2478,André Silva,POR,RB Leipzig,Bundesliga,2021,25.0,1995.0,23.1,13,9,2,3,8,4,13,30.8,9,20,2,18,2,15,15,0,FW,25-29,Forward,Portugal,Europe
2478,André Silva,POR,RB Leipzig,Bundesliga,2021,25.0,1995.0,23.1,13,9,2,3,8,4,13,30.8,9,20,2,18,2,15,15,0,FW,25-29,Forward,Portugal,Europe
2478,André Silva,POR,RB Leipzig,Bundesliga,2021,25.0,1995.0,23.1,13,9,2,3,8,4,13,30.8,9,20,2,18,2,15,15,0,FW,25-29,Forward,Portugal,Europe
2478,André Silva,POR,RB Leipzig,Bundesliga,2021,25.0,1995.0,23.1,13,9,2,3,8,4,13,30.8,9,20,2,18,2,15,15,0,FW,25-29,Forward,Portugal,Europe
2478,André Silva,POR,RB Leipzig,Bundesliga,2021,25.0,1995.0,23.1,13,9,2,3,8,4,13,30.8,9,20,2,18,2,15,15,0,FW,25-29,Forward,Portugal,Europe
2478,André Silva,POR,RB Leipzig,Bundesliga,2021,25.0,1995.0,23.1,13,9,2,3,8,4,13,30.8,9,20,2,18,2,15,15,0,FW,25-29,Forward,Portugal,Europe
2478,André Silva,POR,RB Leipzig,Bundesliga,2021,25.0,1995.0,23.1,13,9,2,3,8,4,13,30.8,9,20,2,18,2,15,15,0,FW,25-29,Forward,Portugal,Europe
2479,Bernardo Silva,POR,Manchester City,Premier League,2021,26.0,1994.0,31.7,57,29,19,19,19,31,67,46.3,36,24,2,22,20,77,19,0,"MF,FW",25-29,Midfielder,Portugal,Europe
2482,Fábio Silva,POR,Wolves,Premier League,2021,19.0,2002.0,6.4,3,2,0,2,1,0,8,0.0,8,2,0,2,1,4,1,0,FW,Under 20,Forward,Portugal,Europe
2483,Gabriel Silva,BRA,Saint-Étienne,Ligue 1,2021,30.0,1991.0,7.9,12,7,7,2,3,9,13,69.2,4,9,3,6,18,30,13,0,"DF,MF",30-34,Defender,Brazil,South America
2483,Gabriel Silva,BRA,Saint-Étienne,Ligue 1,2021,30.0,1991.0,7.9,12,7,7,2,3,9,13,69.2,4,9,3,6,18,30,13,0,"DF,MF",30-34,Defender,Brazil,South America
2483,Gabriel Silva,BRA,Saint-Étienne,Ligue 1,2021,30.0,1991.0,7.9,12,7,7,2,3,9,13,69.2,4,9,3,6,18,30,13,0,"DF,MF",30-34,Defender,Brazil,South America
2483,Gabriel Silva,BRA,Saint-Étienne,Ligue 1,2021,30.0,1991.0,7.9,12,7,7,2,3,9,13,69.2,4,9,3,6,18,30,13,0,"DF,MF",30-34,Defender,Brazil,South America
2484,Jonathan Silva,ARG,Getafe,La Liga,2021,27.0,1994.0,2.5,10,8,4,4,2,7,12,58.3,5,4,0,4,3,13,7,0,"DF,FW",25-29,Defender,Argentina,South America
2484,Jonathan Silva,ARG,Getafe,La Liga,2021,27.0,1994.0,2.5,10,8,4,4,2,7,12,58.3,5,4,0,4,3,13,7,0,"DF,FW",25-29,Defender,Argentina,South America
2484,Jonathan Silva,ARG,Getafe,La Liga,2021,27.0,1994.0,2.5,10,8,4,4,2,7,12,58.3,5,4,0,4,3,13,7,0,"DF,FW",25-29,Defender,Argentina,South America
2484,Jonathan Silva,ARG,Getafe,La Liga,2021,27.0,1994.0,2.5,10,8,4,4,2,7,12,58.3,5,4,0,4,3,13,7,0,"DF,FW",25-29,Defender,Argentina,South America
2486,Thiago Silva,BRA,Chelsea,Premier League,2021,36.0,1984.0,29.4,32,21,19,12,1,11,22,50.0,11,54,31,23,44,76,100,0,DF,35-39,Defender,Brazil,South America
2486,Thiago Silva,BRA,Chelsea,Premier League,2021,36.0,1984.0,29.4,32,21,19,12,1,11,22,50.0,11,54,31,23,44,76,100,0,DF,35-39,Defender,Brazil,South America
2486,Thiago Silva,BRA,Chelsea,Premier League,2021,36.0,1984.0,29.4,32,21,19,12,1,11,22,50.0,11,54,31,23,44,76,100,0,DF,35-39,Defender,Brazil,South America
2486,Thiago Silva,BRA,Chelsea,Premier League,2021,36.0,1984.0,29.4,32,21,19,12,1,11,22,50.0,11,54,31,23,44,76,100,0,DF,35-39,Defender,Brazil,South America
2487,Marco Silvestri,ITA,Udinese,Serie A,2021,30.0,1991.0,35.0,0,0,0,0,0,0,1,0.0,1,0,0,0,1,1,11,1,GK,30-34,Goalkeeper,Italy,Europe
2488,Mohamed Simakan,FRA,RB Leipzig,Bundesliga,2021,21.0,2000.0,22.3,48,27,25,21,2,27,41,65.9,14,22,11,11,40,88,46,1,DF,20-24,Defender,France,Europe
2489,Giovanni Simeone,ARG,Hellas Verona,Serie A,2021,26.0,1995.0,29.5,27,15,6,12,9,9,39,23.1,30,37,3,34,6,33,23,0,FW,25-29,Forward,Argentina,South America
2490,Giovanni Simeone,ARG,Cagliari,Serie A,2021,26.0,1995.0,0.1,0,0,0,0,0,0,0,,0,0,0,0,0,0,0,0,FW,25-29,Forward,Argentina,South America
2491,Giuliano Simeone,ARG,Atlético Madrid,La Liga,2021,18.0,2002.0,0.0,0,0,0,0,0,0,0,,0,0,0,0,0,0,0,0,MF,Under 20,Midfielder,Argentina,South America
2492,Ellis Simms,ENG,Everton,Premier League,2021,20.0,2001.0,0.7,0,0,0,0,0,0,0,,0,1,1,0,0,0,1,0,FW,20-24,Forward,England,Europe
2493,Moses Simon,NGA,Nantes,Ligue 1,2021,26.0,1995.0,25.9,17,11,6,5,6,11,23,47.8,12,14,3,11,12,29,5,0,"FW,MF",25-29,Forward,Nigeria,Africa
2495,Xavi Simons,NED,Paris S-G,Ligue 1,2021,18.0,2003.0,1.5,1,1,0,1,0,1,2,50.0,1,3,0,3,0,1,0,0,"MF,FW",Under 20,Midfielder,Netherlands,Europe
2496,Wilfried Singo,CIV,Torino,Serie A,2021,20.0,2000.0,29.0,55,35,24,24,7,24,34,70.6,10,26,6,20,23,78,47,0,DF,20-24,Defender,Ivory Coast,Africa
2498,Tobias Sippel,GER,Gladbach,Bundesliga,2021,33.0,1988.0,1.0,0,0,0,0,0,0,0,,0,0,0,0,0,0,0,0,GK,30-34,Goalkeeper,Germany,Europe
2501,Issouf Sissokho,MLI,Bordeaux,Ligue 1,2021,19.0,2002.0,4.8,17,8,2,13,2,8,17,47.1,9,8,1,7,7,24,0,0,MF,Under 20,Midfielder,Mali,Africa
2502,Ibrahima Sissoko,MLI,Strasbourg,Ligue 1,2021,23.0,1997.0,25.6,47,23,18,20,9,19,46,41.3,27,32,11,21,35,82,31,0,"MF,DF",20-24,Midfielder,Mali,Africa
2503,Moussa Sissoko,FRA,Watford,Premier League,2021,31.0,1989.0,35.8,53,27,27,20,6,28,42,66.7,14,42,13,29,30,83,64,0,MF,30-34,Midfielder,France,Europe
2507,Ellyes Skhiri,TUN,Köln,Bundesliga,2021,26.0,1995.0,20.2,55,33,25,26,4,22,41,53.7,19,41,7,34,37,92,35,1,MF,25-29,Midfielder,Tunisia,Africa
2508,Oliver Skipp,ENG,Tottenham,Premier League,2021,20.0,2000.0,15.0,33,19,14,18,1,15,31,48.4,16,19,7,12,12,45,10,1,MF,20-24,Midfielder,England,Europe
2511,Andreas Skov Olsen,DEN,Bologna,Serie A,2021,21.0,1999.0,8.3,12,10,4,4,4,5,11,45.5,6,9,1,8,3,15,11,0,"FW,DF",20-24,Forward,Denmark,Europe
2512,Robert Skov,DEN,Hoffenheim,Bundesliga,2021,25.0,1996.0,4.1,3,2,1,1,1,2,9,22.2,7,2,0,2,3,6,3,0,"FW,DF",25-29,Forward,Denmark,Europe
2516,Chris Smalling,ENG,Roma,Serie A,2021,31.0,1989.0,23.2,36,23,28,8,0,18,25,72.0,7,32,24,8,26,62,92,1,DF,30-34,Defender,England,Europe
2517,Emile Smith Rowe,ENG,Arsenal,Premier League,2021,21.0,2000.0,21.3,14,7,7,7,0,4,20,20.0,16,18,1,17,15,29,10,1,"MF,FW",20-24,Midfielder,England,Europe
2518,Cédric Soares,POR,Arsenal,Premier League,2021,29.0,1991.0,16.5,38,26,23,9,6,16,25,64.0,9,18,7,11,16,54,31,1,DF,25-29,Defender,Portugal,Europe
2519,Danilo Soares,BRA,Bochum,Bundesliga,2021,29.0,1991.0,28.5,109,71,61,39,9,56,84,66.7,28,63,9,54,62,171,65,2,DF,25-29,Defender,Brazil,South America
2523,Augusto Solari,ARG,Celta Vigo,La Liga,2021,29.0,1992.0,7.9,24,12,9,12,3,12,32,37.5,20,14,4,10,7,31,10,1,"MF,DF",25-29,Midfielder,Argentina,South America
2526,Yann Sommer,SUI,Gladbach,Bundesliga,2021,32.0,1988.0,33.0,0,0,0,0,0,0,2,0.0,2,0,0,0,3,3,8,3,GK,30-34,Goalkeeper,Switzerland,Europe
2528,Brandon Soppy,FRA,Udinese,Serie A,2021,19.0,2002.0,8.6,20,9,8,10,2,11,16,68.8,5,10,2,8,5,25,9,1,"DF,MF",Under 20,Defender,France,Europe
2530,Roberto Soriano,ITA,Bologna,Serie A,2021,30.0,1991.0,29.1,57,30,27,22,8,17,56,30.4,39,37,3,34,22,79,32,0,MF,30-34,Midfielder,Italy,Europe
2532,Borna Sosa,CRO,Stuttgart,Bundesliga,2021,23.0,1998.0,27.8,22,12,14,5,3,12,26,46.2,14,30,3,27,26,48,61,0,"DF,FW",20-24,Defender,Croatia,Europe
2534,Florian Sotoca,FRA,Lens,Ligue 1,2021,30.0,1990.0,27.6,31,19,7,20,4,12,51,23.5,39,31,4,27,25,56,41,0,"FW,MF",30-34,Forward,France,Europe
2535,Riccardo Sottil,ITA,Fiorentina,Serie A,2021,22.0,1999.0,13.8,9,4,4,4,1,3,9,33.3,6,3,0,3,1,10,2,0,FW,20-24,Forward,Italy,Europe
2539,Adama Soumaoro,FRA,Bologna,Serie A,2021,29.0,1992.0,25.2,15,5,5,8,2,4,9,44.4,5,22,16,6,34,49,95,0,DF,25-29,Defender,France,Europe
2540,Boubakary Soumaré,FRA,Leicester City,Premier League,2021,22.0,1999.0,12.2,19,13,10,8,1,8,17,47.1,9,13,1,12,14,33,18,0,MF,20-24,Midfielder,France,Europe
2541,Arnaud Souquet,FRA,Montpellier,Ligue 1,2021,29.0,1992.0,25.9,56,35,30,17,9,32,65,49.2,33,21,7,14,34,90,60,1,DF,25-29,Defender,France,Europe
2542,Djibril Sow,SUI,Eint Frankfurt,Bundesliga,2021,24.0,1997.0,26.8,57,33,28,25,4,22,60,36.7,38,35,8,27,50,107,20,1,MF,20-24,Midfielder,Switzerland,Europe
2545,Leonardo Spinazzola,ITA,Roma,Serie A,2021,28.0,1993.0,1.4,0,0,0,0,0,0,1,0.0,1,4,1,3,0,0,3,0,DF,25-29,Defender,Italy,Europe
2546,Marco Sportiello,ITA,Atalanta,Serie A,2021,29.0,1992.0,5.0,0,0,0,0,0,0,0,,0,0,0,0,0,0,2,0,GK,25-29,Goalkeeper,Italy,Europe
2549,Anton Stach,GER,Mainz 05,Bundesliga,2021,22.0,1998.0,20.7,28,19,14,13,1,15,38,39.5,23,24,5,19,51,79,25,0,MF,20-24,Midfielder,Germany,Europe
2551,Luca Stanga,ITA,Milan,Serie A,2021,19.0,2002.0,0.0,1,0,0,1,0,0,0,,0,0,0,0,0,1,0,0,DF,Under 20,Defender,Italy,Europe
2553,Niklas Stark,GER,Hertha BSC,Bundesliga,2021,26.0,1995.0,22.6,28,16,18,10,0,12,17,70.6,5,27,17,10,36,64,122,2,DF,25-29,Defender,Germany,Europe
2554,Jason Steele,ENG,Brighton,Premier League,2021,30.0,1990.0,1.0,0,0,0,0,0,0,0,,0,0,0,0,0,0,0,0,GK,30-34,Goalkeeper,England,Europe
2555,Jed Steer,ENG,Aston Villa,Premier League,2021,28.0,1992.0,1.0,0,0,0,0,0,0,0,,0,0,0,0,0,0,0,0,GK,25-29,Goalkeeper,England,Europe
2556,Renato Steffen,SUI,Wolfsburg,Bundesliga,2021,29.0,1991.0,10.7,20,16,10,10,0,9,16,56.3,7,7,0,7,13,33,14,0,"FW,MF",25-29,Forward,Switzerland,Europe
2557,Zack Steffen,USA,Manchester City,Premier League,2021,26.0,1995.0,1.0,0,0,0,0,0,0,0,,0,0,0,0,0,0,2,0,GK,25-29,Goalkeeper,United States,North America
2559,Pascal Stenzel,GER,Stuttgart,Bundesliga,2021,25.0,1996.0,10.0,24,11,15,5,4,17,33,51.5,16,13,3,10,11,35,25,0,DF,25-29,Defender,Germany,Europe
2560,Dale Stephens,ENG,Burnley,Premier League,2021,32.0,1989.0,1.4,4,1,0,3,1,3,8,37.5,5,4,1,3,1,5,1,0,MF,30-34,Midfielder,England,Europe
2561,Jack Stephens,ENG,Southampton,Premier League,2021,27.0,1994.0,9.0,19,12,13,5,1,6,16,37.5,10,12,7,5,19,38,42,0,DF,25-29,Defender,England,Europe
2562,Raheem Sterling,ENG,Manchester City,Premier League,2021,26.0,1994.0,23.6,23,10,3,11,9,10,23,43.5,13,12,0,12,12,35,3,0,FW,25-29,Forward,England,Europe
2564,Angelo Stiller,GER,Hoffenheim,Bundesliga,2021,20.0,2001.0,18.8,30,17,11,15,4,9,23,39.1,14,32,6,26,9,39,16,2,MF,20-24,Midfielder,Germany,Europe
2565,Lars Stindl,GER,Gladbach,Bundesliga,2021,32.0,1988.0,18.1,23,15,6,14,3,9,33,27.3,24,28,2,26,10,33,14,0,"MF,FW",30-34,Midfielder,Germany,Europe
2567,Kevin Stöger,AUT,Mainz 05,Bundesliga,2021,27.0,1993.0,4.7,10,5,5,5,0,4,10,40.0,6,6,0,6,5,15,1,1,MF,25-29,Midfielder,Austria,Europe
2569,John Stones,ENG,Manchester City,Premier League,2021,27.0,1994.0,12.4,5,3,3,2,0,2,3,66.7,1,3,3,0,11,16,27,1,DF,25-29,Defender,England,Europe
2573,Tobias Strobl,GER,Augsburg,Bundesliga,2021,31.0,1990.0,3.6,8,3,3,5,0,3,11,27.3,8,7,2,5,7,15,3,0,"MF,DF",30-34,Midfielder,Germany,Europe
2574,Kevin Strootman,NED,Cagliari,Serie A,2021,31.0,1990.0,7.1,8,4,2,4,2,5,12,41.7,7,11,2,9,10,18,15,0,MF,30-34,Midfielder,Netherlands,Europe
2575,Pascal Struijk,NED,Leeds United,Premier League,2021,21.0,1999.0,22.8,61,39,34,23,4,30,50,60.0,20,35,23,12,33,94,60,2,"DF,MF",20-24,Defender,Netherlands,Europe
2579,Damián Suárez,URU,Getafe,La Liga,2021,33.0,1988.0,30.1,74,47,34,30,10,42,91,46.2,49,46,5,41,31,105,30,0,DF,30-34,Defender,Uruguay,South America
2581,Luis Suárez,URU,Atlético Madrid,La Liga,2021,34.0,1987.0,20.4,8,5,2,4,2,2,10,20.0,8,8,1,7,1,9,14,0,FW,30-34,Forward,Uruguay,South America
2581,Luis Suárez,URU,Atlético Madrid,La Liga,2021,34.0,1987.0,20.4,8,5,2,4,2,2,10,20.0,8,8,1,7,1,9,14,0,FW,30-34,Forward,Uruguay,South America
2581,Luis Suárez,URU,Atlético Madrid,La Liga,2021,34.0,1987.0,20.4,8,5,2,4,2,2,10,20.0,8,8,1,7,1,9,14,0,FW,30-34,Forward,Uruguay,South America
2581,Luis Suárez,URU,Atlético Madrid,La Liga,2021,34.0,1987.0,20.4,8,5,2,4,2,2,10,20.0,8,8,1,7,1,9,14,0,FW,30-34,Forward,Uruguay,South America
2583,Isaac Success,NGA,Udinese,Serie A,2021,25.0,1996.0,10.1,5,2,0,3,2,1,5,20.0,4,2,0,2,2,7,6,0,"FW,MF",25-29,Forward,Nigeria,Africa
2584,Niklas Süle,GER,Bayern Munich,Bundesliga,2021,25.0,1995.0,20.4,29,23,21,7,1,18,24,75.0,6,16,12,4,28,57,49,0,DF,25-29,Defender,Germany,Europe
2585,Kamaldeen Sulemana,GHA,Rennes,Ligue 1,2021,19.0,2002.0,11.3,23,12,7,9,7,10,17,58.8,7,10,1,9,4,27,5,0,"MF,FW",Under 20,Midfielder,Ghana,Africa
2586,Crysencio Summerville,NED,Leeds United,Premier League,2021,19.0,2001.0,1.4,5,3,1,1,3,2,3,66.7,1,2,0,2,2,7,0,0,"MF,FW",Under 20,Midfielder,Netherlands,Europe
2590,Mattias Svanberg,SWE,Bologna,Serie A,2021,22.0,1999.0,28.5,39,15,15,16,8,16,54,29.6,38,31,9,22,28,67,34,0,MF,20-24,Midfielder,Sweden,Europe
2591,Michael Svoboda,AUT,Venezia,Serie A,2021,22.0,1998.0,13.7,33,17,26,6,1,18,32,56.3,14,27,15,12,10,43,61,5,DF,20-24,Defender,Austria,Europe
2593,Mamadou Sylla,SEN,Alavés,La Liga,2021,27.0,1994.0,4.4,2,2,0,1,1,0,1,0.0,1,0,0,0,1,3,5,0,"FW,MF",25-29,Forward,Senegal,Africa
2593,Mamadou Sylla,SEN,Alavés,La Liga,2021,27.0,1994.0,4.4,2,2,0,1,1,0,1,0.0,1,0,0,0,1,3,5,0,"FW,MF",25-29,Forward,Senegal,Africa
2593,Mamadou Sylla,SEN,Alavés,La Liga,2021,27.0,1994.0,4.4,2,2,0,1,1,0,1,0.0,1,0,0,0,1,3,5,0,"FW,MF",25-29,Forward,Senegal,Africa
2593,Mamadou Sylla,SEN,Alavés,La Liga,2021,27.0,1994.0,4.4,2,2,0,1,1,0,1,0.0,1,0,0,0,1,3,5,0,"FW,MF",25-29,Forward,Senegal,Africa
2594,Mamadou Sylla,SEN,Rayo Vallecano,La Liga,2021,27.0,1994.0,2.8,1,1,1,0,0,0,1,0.0,1,2,0,2,4,5,3,0,FW,25-29,Forward,Senegal,Africa
2594,Mamadou Sylla,SEN,Rayo Vallecano,La Liga,2021,27.0,1994.0,2.8,1,1,1,0,0,0,1,0.0,1,2,0,2,4,5,3,0,FW,25-29,Forward,Senegal,Africa
2594,Mamadou Sylla,SEN,Rayo Vallecano,La Liga,2021,27.0,1994.0,2.8,1,1,1,0,0,0,1,0.0,1,2,0,2,4,5,3,0,FW,25-29,Forward,Senegal,Africa
2594,Mamadou Sylla,SEN,Rayo Vallecano,La Liga,2021,27.0,1994.0,2.8,1,1,1,0,0,0,1,0.0,1,2,0,2,4,5,3,0,FW,25-29,Forward,Senegal,Africa
2595,Ádám Szalai,HUN,Mainz 05,Bundesliga,2021,33.0,1987.0,2.9,3,2,0,2,1,0,2,0.0,2,2,0,2,0,3,0,0,FW,30-34,Forward,Hungary,Europe
2597,Dominik Szoboszlai,HUN,RB Leipzig,Bundesliga,2021,20.0,2000.0,17.1,17,12,5,9,3,8,27,29.6,19,30,3,27,10,27,15,0,"MF,FW",20-24,Midfielder,Hungary,Europe
2601,Jonathan Tah,GER,Leverkusen,Bundesliga,2021,25.0,1996.0,32.0,25,18,19,5,1,17,33,51.5,16,31,20,11,43,68,156,0,DF,25-29,Defender,Germany,Europe
2605,Japhet Tanganga,ENG,Tottenham,Premier League,2021,22.0,1999.0,8.2,14,8,7,6,1,9,19,47.4,10,13,5,8,9,23,31,0,DF,20-24,Defender,England,Europe
2606,Renato Tapia,PER,Celta Vigo,La Liga,2021,26.0,1995.0,15.7,50,31,15,31,4,20,50,40.0,30,21,5,16,28,78,43,0,MF,25-29,Midfielder,Peru,South America
2607,Edmond Tapsoba,BFA,Leverkusen,Bundesliga,2021,22.0,1999.0,20.2,35,17,24,10,1,20,32,62.5,12,27,15,12,29,64,72,1,DF,20-24,Defender,Burkina Faso,Africa
2608,Florian Tardieu,FRA,Troyes,Ligue 1,2021,29.0,1992.0,29.2,58,25,31,21,6,31,71,43.7,40,31,9,22,42,100,38,0,MF,25-29,Midfielder,France,Europe
2609,Matt Targett,ENG,Aston Villa,Premier League,2021,25.0,1995.0,15.9,34,18,28,5,1,24,45,53.3,21,16,9,7,23,57,35,0,DF,25-29,Defender,England,Europe
2610,Matt Targett,ENG,Newcastle Utd,Premier League,2021,25.0,1995.0,16.0,41,26,26,14,1,24,37,64.9,13,15,4,11,25,66,39,1,DF,25-29,Defender,England,Europe
2612,James Tarkowski,ENG,Burnley,Premier League,2021,28.0,1992.0,34.5,65,45,47,17,1,33,47,70.2,14,75,61,14,48,113,186,4,DF,25-29,Defender,England,Europe
2614,Niklas Tauer,GER,Mainz 05,Bundesliga,2021,20.0,2001.0,5.4,16,9,9,7,0,9,14,64.3,5,6,2,4,9,25,14,0,"DF,MF",20-24,Defender,Germany,Europe
2615,Nuno Tavares,POR,Arsenal,Premier League,2021,21.0,2000.0,13.1,21,14,10,7,4,8,18,44.4,10,15,5,10,9,30,33,1,DF,20-24,Defender,Portugal,Europe
2616,Charlie Taylor,ENG,Burnley,Premier League,2021,27.0,1993.0,30.3,45,26,31,11,3,26,44,59.1,18,42,20,22,58,103,95,2,DF,25-29,Defender,England,Europe
2617,Loum Tchaouna,FRA,Rennes,Ligue 1,2021,17.0,2003.0,1.0,3,1,1,2,0,1,5,20.0,4,0,0,0,2,5,0,0,"FW,MF",Under 20,Forward,France,Europe
2619,Warren Tchimbembé,CGO,Metz,Ligue 1,2021,23.0,1998.0,2.3,1,1,0,1,0,0,1,0.0,1,2,1,1,2,3,2,0,MF,20-24,Midfielder,Congo,Africa
2620,Aurélien Tchouaméni,FRA,Monaco,Ligue 1,2021,21.0,2000.0,32.5,86,45,33,49,4,29,55,52.7,26,39,7,32,101,187,34,0,MF,20-24,Midfielder,France,Europe
2621,Mathys Tel,FRA,Rennes,Ligue 1,2021,16.0,2005.0,0.6,2,1,1,1,0,0,0,,0,0,0,0,1,3,2,0,"FW,MF",Under 20,Forward,France,Europe
2623,Nathan Tella,NGA,Southampton,Premier League,2021,22.0,1999.0,8.9,13,9,5,7,1,6,17,35.3,11,13,0,13,6,19,9,0,"MF,FW",20-24,Midfielder,Nigeria,Africa
2624,Alex Telles,BRA,Manchester Utd,Premier League,2021,28.0,1992.0,18.4,48,27,35,9,4,27,43,62.8,16,17,4,13,26,74,45,0,DF,25-29,Defender,Brazil,South America
2626,Nahuel Tenaglia,ARG,Alavés,La Liga,2021,25.0,1996.0,11.9,42,27,30,9,3,24,37,64.9,13,10,2,8,26,68,42,0,DF,25-29,Defender,Argentina,South America
2628,Marc-André ter Stegen,GER,Barcelona,La Liga,2021,29.0,1992.0,35.0,0,0,0,0,0,0,1,0.0,1,0,0,0,1,1,13,5,GK,25-29,Goalkeeper,Germany,Europe
2630,Pietro Terracciano,ITA,Fiorentina,Serie A,2021,31.0,1990.0,31.8,0,0,0,0,0,0,4,0.0,4,0,0,0,2,2,20,1,GK,30-34,Goalkeeper,Italy,Europe
2631,Martin Terrier,FRA,Rennes,Ligue 1,2021,24.0,1997.0,30.9,55,33,22,16,17,25,43,58.1,18,29,3,26,18,73,17,0,"FW,MF",20-24,Forward,France,Europe
2633,Robert Tesche,GER,Bochum,Bundesliga,2021,34.0,1987.0,3.9,6,4,4,1,1,5,7,71.4,2,6,2,4,5,11,5,1,MF,30-34,Midfielder,Germany,Europe
2634,Tanner Tessmann,USA,Venezia,Serie A,2021,19.0,2001.0,7.6,11,5,4,6,1,5,14,35.7,9,19,9,10,5,16,22,0,MF,Under 20,Midfielder,United States,North America
2636,Cedric Teuchert,GER,Union Berlin,Bundesliga,2021,24.0,1997.0,1.2,3,2,3,0,0,2,6,33.3,4,1,0,1,0,3,0,0,"MF,FW",20-24,Midfielder,Germany,Europe
2637,Arthur Theate,BEL,Bologna,Serie A,2021,21.0,2000.0,26.9,33,19,26,3,4,14,31,45.2,17,29,16,13,42,75,69,0,DF,20-24,Defender,Belgium,Europe
2638,Jan Thielmann,GER,Köln,Bundesliga,2021,19.0,2002.0,13.2,24,16,6,12,6,8,23,34.8,15,23,2,21,10,34,11,0,"MF,FW",Under 20,Midfielder,Germany,Europe
2639,Sada Thioub,SEN,Angers,Ligue 1,2021,26.0,1995.0,0.0,0,0,0,0,0,0,0,,0,0,0,0,0,0,0,0,FW,25-29,Forward,Senegal,Africa
2640,Sada Thioub,SEN,Saint-Étienne,Ligue 1,2021,26.0,1995.0,10.6,13,8,5,8,0,6,14,42.9,8,9,0,9,10,23,8,0,"DF,MF",25-29,Defender,Senegal,Africa
2641,Luke Thomas,ENG,Leicester City,Premier League,2021,20.0,2001.0,21.2,50,31,33,13,4,28,65,43.1,37,35,14,21,40,90,55,0,DF,20-24,Defender,England,Europe
2642,Romain Thomas,FRA,Angers,Ligue 1,2021,33.0,1988.0,28.5,49,37,28,21,0,30,57,52.6,27,35,19,16,44,93,126,0,DF,30-34,Defender,France,Europe
2643,Adrien Thomasson,FRA,Strasbourg,Ligue 1,2021,27.0,1993.0,26.5,64,31,18,27,19,30,93,32.3,63,56,4,52,29,93,16,1,MF,25-29,Midfielder,France,Europe
2644,Erik Thommy,GER,Stuttgart,Bundesliga,2021,26.0,1994.0,3.0,2,0,0,2,0,1,2,50.0,1,3,0,3,4,6,0,0,"FW,MF",25-29,Forward,Germany,Europe
2648,Khéphren Thuram,FRA,Nice,Ligue 1,2021,20.0,2001.0,21.1,33,19,11,18,4,17,35,48.6,18,31,11,20,28,61,19,0,MF,20-24,Midfielder,France,Europe
2649,Marcus Thuram,FRA,Gladbach,Bundesliga,2021,23.0,1997.0,10.9,6,5,0,5,1,1,4,25.0,3,5,0,5,5,11,5,0,FW,20-24,Forward,France,Europe
2652,Youri Tielemans,BEL,Leicester City,Premier League,2021,24.0,1997.0,29.2,74,38,23,45,6,42,100,42.0,58,47,13,34,21,95,41,3,MF,20-24,Midfielder,Belgium,Europe
2653,Kieran Tierney,SCO,Arsenal,Premier League,2021,24.0,1997.0,21.3,18,14,11,7,0,10,11,90.9,1,23,5,18,15,33,54,0,DF,20-24,Defender,Scotland,Europe
2654,Steffen Tigges,GER,Dortmund,Bundesliga,2021,23.0,1998.0,1.2,4,3,1,2,1,2,3,66.7,1,3,1,2,0,4,3,0,"FW,MF",20-24,Forward,Germany,Europe
2659,Jean-Clair Todibo,FRA,Nice,Ligue 1,2021,21.0,1999.0,34.6,59,37,43,15,1,39,60,65.0,21,45,21,24,51,110,130,2,DF,20-24,Defender,France,Europe
2661,Karl Toko Ekambi,CMR,Lyon,Ligue 1,2021,28.0,1992.0,25.5,13,7,4,6,3,4,21,19.0,17,26,0,26,20,33,5,0,FW,25-29,Forward,Cameroon,Africa
2662,Corentin Tolisso,FRA,Bayern Munich,Bundesliga,2021,26.0,1994.0,7.8,11,5,1,9,1,7,17,41.2,10,5,1,4,9,20,10,0,MF,25-29,Midfielder,France,Europe
2663,Jeremy Toljan,GER,Sassuolo,Serie A,2021,26.0,1994.0,15.5,18,10,12,4,2,13,20,65.0,7,12,5,7,12,30,41,0,DF,25-29,Defender,Germany,Europe
2664,Rafael Tolói,ITA,Atalanta,Serie A,2021,30.0,1990.0,16.0,38,15,12,15,11,24,39,61.5,15,23,11,12,26,64,35,0,DF,30-34,Defender,Italy,Europe
2666,Tiago Tomás,POR,Stuttgart,Bundesliga,2021,19.0,2002.0,11.9,8,4,0,7,1,0,6,0.0,6,3,0,3,4,12,1,0,FW,Under 20,Forward,Portugal,Europe
2667,Takehiro Tomiyasu,JPN,Arsenal,Premier League,2021,22.0,1998.0,18.7,35,17,19,13,3,21,32,65.6,11,22,3,19,24,59,64,2,DF,20-24,Defender,Japan,Asia
2668,Takehiro Tomiyasu,JPN,Bologna,Serie A,2021,22.0,1998.0,0.1,0,0,0,0,0,0,0,,0,1,0,1,1,1,0,0,DF,20-24,Defender,Japan,Asia
2669,James Tomkins,ENG,Crystal Palace,Premier League,2021,32.0,1989.0,6.1,8,3,6,2,0,6,8,75.0,2,8,8,0,4,12,18,0,DF,30-34,Defender,England,Europe
2670,Fikayo Tomori,ENG,Milan,Serie A,2021,23.0,1997.0,30.2,73,44,36,34,3,18,26,69.2,8,37,23,14,45,118,84,1,DF,20-24,Defender,England,Europe
2671,Sandro Tonali,ITA,Milan,Serie A,2021,21.0,2000.0,28.9,54,37,23,25,6,21,41,51.2,20,26,8,18,34,88,19,0,MF,20-24,Midfielder,Italy,Europe
2672,Lorenzo Tonelli,ITA,Empoli,Serie A,2021,31.0,1990.0,9.7,17,9,11,4,2,6,13,46.2,7,14,8,6,19,36,28,2,DF,30-34,Defender,Italy,Europe
2673,Ivan Toney,ENG,Brentford,Premier League,2021,25.0,1996.0,32.3,33,21,5,20,8,12,38,31.6,26,16,2,14,14,47,44,1,FW,25-29,Forward,England,Europe
2674,Ernesto Torregrossa,VEN,Sampdoria,Serie A,2021,29.0,1992.0,1.3,2,1,1,0,1,1,2,50.0,1,0,0,0,0,2,1,0,FW,25-29,Forward,Venezuela,South America
2685,Abdoulaye Touré,GUI,Genoa,Serie A,2021,27.0,1994.0,4.8,12,4,3,8,1,5,11,45.5,6,6,1,5,4,16,6,0,MF,25-29,Midfielder,Guinea,Africa
2685,Abdoulaye Touré,GUI,Genoa,Serie A,2021,27.0,1994.0,4.8,12,4,3,8,1,5,11,45.5,6,6,1,5,4,16,6,0,MF,25-29,Midfielder,Guinea,Africa
2685,Abdoulaye Touré,GUI,Genoa,Serie A,2021,27.0,1994.0,4.8,12,4,3,8,1,5,11,45.5,6,6,1,5,4,16,6,0,MF,25-29,Midfielder,Guinea,Africa
2685,Abdoulaye Touré,GUI,Genoa,Serie A,2021,27.0,1994.0,4.8,12,4,3,8,1,5,11,45.5,6,6,1,5,4,16,6,0,MF,25-29,Midfielder,Guinea,Africa
2686,Almamy Touré,MLI,Eint Frankfurt,Bundesliga,2021,25.0,1996.0,5.6,12,9,8,3,1,4,17,23.5,13,10,3,7,5,17,19,0,"DF,MF",25-29,Defender,Mali,Africa
2687,Lucas Tousart,FRA,Hertha BSC,Bundesliga,2021,24.0,1997.0,21.8,42,25,15,22,5,10,34,29.4,24,30,6,24,35,77,55,0,MF,20-24,Midfielder,France,Europe
2688,Yoann Touzghar,TUN,Troyes,Ligue 1,2021,34.0,1986.0,16.2,5,2,1,3,1,1,3,33.3,2,3,1,2,3,8,8,0,FW,30-34,Forward,Tunisia,Africa
2694,Boubacar Traoré,MLI,Metz,Ligue 1,2021,19.0,2001.0,19.2,43,26,18,23,2,10,39,25.6,29,29,5,24,25,68,11,1,MF,Under 20,Midfielder,Mali,Africa
2696,Hamari Traoré,MLI,Rennes,Ligue 1,2021,29.0,1992.0,32.1,63,36,25,26,12,41,59,69.5,18,29,8,21,37,100,81,1,DF,25-29,Defender,Mali,Africa
2697,Ismaël Traoré,CIV,Angers,Ligue 1,2021,34.0,1986.0,35.7,28,17,16,11,1,13,28,46.4,15,25,17,8,44,72,122,1,DF,30-34,Defender,Ivory Coast,Africa
2698,Kevin Trapp,GER,Eint Frankfurt,Bundesliga,2021,31.0,1990.0,32.0,0,0,0,0,0,0,1,0.0,1,0,0,0,1,1,13,2,GK,30-34,Goalkeeper,Germany,Europe
2699,Miguel Trauco,PER,Saint-Étienne,Ligue 1,2021,28.0,1992.0,12.4,25,18,16,8,1,12,22,54.5,10,13,4,9,23,48,17,0,"DF,MF",25-29,Defender,Peru,South America
2703,Simone Trimboli,ITA,Sampdoria,Serie A,2021,19.0,2002.0,0.7,2,1,2,0,0,2,2,100.0,0,0,0,0,2,4,0,0,MF,Under 20,Midfielder,Italy,Europe
2704,Christopher Trimmel,AUT,Union Berlin,Bundesliga,2021,34.0,1987.0,22.1,49,30,25,19,5,26,45,57.8,19,20,3,17,34,83,75,0,"DF,FW",30-34,Defender,Austria,Europe
2706,Kieran Trippier,ENG,Newcastle Utd,Premier League,2021,30.0,1990.0,4.8,17,10,8,8,1,10,16,62.5,6,10,3,7,10,27,10,0,DF,30-34,Defender,England,Europe
2707,Kieran Trippier,ENG,Atlético Madrid,La Liga,2021,30.0,1990.0,10.8,22,12,12,5,5,12,21,57.1,9,12,1,11,10,32,11,0,"DF,FW",30-34,Defender,England,Europe
2709,Leandro Trossard,BEL,Brighton,Premier League,2021,26.0,1994.0,31.2,34,20,12,9,13,4,31,12.9,27,33,4,29,15,49,10,0,"FW,MF",25-29,Forward,Belgium,Europe
2710,Adrien Truffert,FRA,Rennes,Ligue 1,2021,19.0,2001.0,18.2,29,21,17,9,3,11,24,45.8,13,25,5,20,19,48,30,0,DF,Under 20,Defender,France,Europe
2711,Philipp Tschauner,GER,RB Leipzig,Bundesliga,2021,35.0,1985.0,0.0,0,0,0,0,0,0,0,,0,0,0,0,0,0,0,0,GK,35-39,Goalkeeper,Germany,Europe
2713,Axel Tuanzebe,COD,Aston Villa,Premier League,2021,23.0,1997.0,5.6,5,3,3,2,0,2,5,40.0,3,5,4,1,5,10,12,1,DF,20-24,Defender,DR Congo,Africa
2714,Axel Tuanzebe,COD,Napoli,Serie A,2021,23.0,1997.0,0.1,0,0,0,0,0,0,0,,0,1,1,0,0,0,0,0,DF,20-24,Defender,DR Congo,Africa
2717,Tuta,BRA,Eint Frankfurt,Bundesliga,2021,22.0,1999.0,24.3,46,28,20,22,4,26,47,55.3,21,43,15,28,41,87,76,1,DF,20-24,Defender,Brazil,South America
2719,Destiny Udogie,ITA,Udinese,Serie A,2021,18.0,2002.0,27.5,64,40,30,27,7,33,60,55.0,27,39,6,33,27,91,42,0,DF,Under 20,Defender,Italy,Europe
2720,Matthieu Udol,FRA,Metz,Ligue 1,2021,25.0,1996.0,11.2,23,14,11,10,2,12,18,66.7,6,20,7,13,31,54,29,1,DF,25-29,Defender,France,Europe
2722,Lesley Ugochukwu,FRA,Rennes,Ligue 1,2021,17.0,2004.0,4.5,13,9,5,5,3,9,19,47.4,10,7,2,5,4,17,2,0,MF,Under 20,Midfielder,France,Europe
2724,Anthony Ujah,NGA,Union Berlin,Bundesliga,2021,30.0,1990.0,0.4,0,0,0,0,0,0,0,,0,0,0,0,0,0,0,0,"FW,MF",30-34,Forward,Nigeria,Africa
2725,Maximilian Ullmann,AUT,Venezia,Serie A,2021,25.0,1996.0,2.7,0,0,0,0,0,0,1,0.0,1,4,0,4,2,2,7,0,DF,25-29,Defender,Austria,Europe
2726,Sven Ulreich,GER,Bayern Munich,Bundesliga,2021,32.0,1988.0,6.0,0,0,0,0,0,0,0,,0,0,0,0,0,0,1,0,GK,30-34,Goalkeeper,Germany,Europe
2727,Samuel Umtiti,FRA,Barcelona,La Liga,2021,27.0,1993.0,1.0,2,2,2,0,0,1,2,50.0,1,1,1,0,0,2,4,0,DF,25-29,Defender,France,Europe
2728,Enes Ünal,TUR,Getafe,La Liga,2021,24.0,1997.0,31.1,37,22,2,18,17,5,42,11.9,37,25,5,20,5,42,36,0,FW,20-24,Forward,Turkey,Asia
2730,Dayot Upamecano,FRA,Bayern Munich,Bundesliga,2021,22.0,1998.0,24.6,66,42,42,21,3,24,36,66.7,12,20,10,10,32,98,71,6,DF,20-24,Defender,France,Europe
2731,Benjamin Uphoff,GER,Freiburg,Bundesliga,2021,27.0,1993.0,2.0,0,0,0,0,0,0,0,,0,0,0,0,0,0,2,2,GK,25-29,Goalkeeper,Germany,Europe
2733,Jere Uronen,FIN,Brest,Ligue 1,2021,27.0,1994.0,9.8,28,15,15,10,3,14,24,58.3,10,12,3,9,16,44,21,0,DF,25-29,Defender,Finland,Europe
2734,Mark Uth,GER,Köln,Bundesliga,2021,29.0,1991.0,22.5,32,20,9,14,9,15,49,30.6,34,27,1,26,14,46,13,0,"MF,FW",25-29,Midfielder,Germany,Europe
2735,Myrto Uzuni,ALB,Granada,La Liga,2021,26.0,1995.0,9.5,7,4,6,1,0,0,2,0.0,2,13,1,12,10,17,7,0,"FW,MF",25-29,Forward,Albania,Europe
2740,Yan Valery,TUN,Southampton,Premier League,2021,22.0,1999.0,4.1,8,6,4,3,1,4,9,44.4,5,6,3,3,6,14,19,1,DF,20-24,Defender,Tunisia,Africa
2741,Martin Valjent,SVK,Mallorca,La Liga,2021,25.0,1995.0,35.3,31,19,18,12,1,13,24,54.2,11,34,26,8,31,62,173,1,DF,25-29,Defender,Slovakia,Europe
2745,Federico Valverde,URU,Real Madrid,La Liga,2021,23.0,1998.0,20.4,36,16,11,16,9,12,31,38.7,19,23,5,18,24,60,12,0,MF,20-24,Midfielder,Uruguay,South America
2746,Virgil van Dijk,NED,Liverpool,Premier League,2021,30.0,1991.0,34.0,16,10,11,5,0,11,16,68.8,5,21,14,7,31,47,109,0,DF,30-34,Defender,Netherlands,Europe
2747,Vanderson,BRA,Monaco,Ligue 1,2021,20.0,2001.0,12.4,35,19,10,19,6,15,23,65.2,8,17,4,13,13,48,12,0,"FW,DF",20-24,Forward,Brazil,South America
2747,Vanderson,BRA,Monaco,Ligue 1,2021,20.0,2001.0,12.4,35,19,10,19,6,15,23,65.2,8,17,4,13,13,48,12,0,"FW,DF",20-24,Forward,Brazil,South America
2747,Vanderson,BRA,Monaco,Ligue 1,2021,20.0,2001.0,12.4,35,19,10,19,6,15,23,65.2,8,17,4,13,13,48,12,0,"FW,DF",20-24,Forward,Brazil,South America
2747,Vanderson,BRA,Monaco,Ligue 1,2021,20.0,2001.0,12.4,35,19,10,19,6,15,23,65.2,8,17,4,13,13,48,12,0,"FW,DF",20-24,Forward,Brazil,South America
2750,Raphaël Varane,FRA,Manchester Utd,Premier League,2021,28.0,1993.0,20.3,28,19,21,6,1,10,22,45.5,12,18,9,9,18,46,82,1,DF,25-29,Defender,France,Europe
2751,Jamie Vardy,ENG,Leicester City,Premier League,2021,34.0,1987.0,20.1,6,5,0,4,2,1,7,14.3,6,9,0,9,1,7,17,0,FW,30-34,Forward,England,Europe
2753,Sebastian Vasiliadis,GRE,Arminia,Bundesliga,2021,23.0,1997.0,13.3,31,17,12,15,4,15,42,35.7,27,15,2,13,25,56,31,1,MF,20-24,Midfielder,Greece,Europe
2754,Johan Vásquez,MEX,Genoa,Serie A,2021,22.0,1998.0,25.3,79,46,44,32,3,48,75,64.0,27,32,10,22,42,121,85,0,DF,20-24,Defender,Mexico,North America
2755,Denis Vavro,SVK,Lazio,Serie A,2021,25.0,1996.0,0.1,0,0,0,0,0,0,0,,0,0,0,0,0,0,0,0,DF,25-29,Defender,Slovakia,Europe
2760,Matías Vecino,URU,Inter,Serie A,2021,29.0,1991.0,4.2,7,5,2,3,2,3,9,33.3,6,10,1,9,4,11,7,0,MF,25-29,Midfielder,Uruguay,South America
2762,Miguel Veloso,POR,Hellas Verona,Serie A,2021,35.0,1986.0,14.9,23,15,4,17,2,10,16,62.5,6,18,5,13,11,34,18,1,MF,35-39,Midfielder,Portugal,Europe
2763,Joël Veltman,NED,Brighton,Premier League,2021,29.0,1992.0,31.9,74,48,47,21,6,21,53,39.6,32,46,16,30,45,119,89,0,DF,25-29,Defender,Netherlands,Europe
2764,Micky van de Ven,NED,Wolfsburg,Bundesliga,2021,20.0,2001.0,2.1,4,4,3,1,0,0,1,0.0,1,4,1,3,2,6,8,0,DF,20-24,Defender,Netherlands,Europe
2766,Lorenzo Venuti,ITA,Fiorentina,Serie A,2021,26.0,1995.0,17.5,25,10,13,10,2,14,24,58.3,10,13,4,9,5,30,27,0,DF,25-29,Defender,Italy,Europe
2767,Daniele Verde,ITA,Spezia,Serie A,2021,25.0,1996.0,21.7,11,4,8,2,1,9,20,45.0,11,17,2,15,18,29,8,0,"FW,MF",25-29,Forward,Italy,Europe
2768,Simone Verdi,ITA,Torino,Serie A,2021,29.0,1992.0,0.5,1,1,0,1,0,0,0,,0,0,0,0,0,1,0,0,"MF,FW",25-29,Midfielder,Italy,Europe
2769,Simone Verdi,ITA,Salernitana,Serie A,2021,29.0,1992.0,9.2,12,8,5,2,5,9,20,45.0,11,4,0,4,3,15,1,0,"FW,MF",25-29,Forward,Italy,Europe
2771,Jordan Veretout,FRA,Roma,Serie A,2021,28.0,1993.0,25.8,34,25,20,12,2,15,39,38.5,24,12,1,11,27,61,22,1,MF,25-29,Midfielder,France,Europe
2772,Edoardo Vergani,ITA,Salernitana,Serie A,2021,20.0,2001.0,1.1,2,2,2,0,0,0,0,,0,2,2,0,0,2,2,0,"FW,MF",20-24,Forward,Italy,Europe
2773,Vincent Vermeij,NED,Freiburg,Bundesliga,2021,26.0,1994.0,0.0,0,0,0,0,0,0,0,,0,1,0,1,0,0,0,0,MF,25-29,Midfielder,Netherlands,Europe
2774,Marco Verratti,ITA,Paris S-G,Ligue 1,2021,28.0,1992.0,21.5,60,40,16,30,14,32,64,50.0,32,36,10,26,18,78,14,2,MF,25-29,Midfielder,Italy,Europe
2775,Valerio Verre,ITA,Sampdoria,Serie A,2021,27.0,1994.0,4.7,7,5,1,4,2,4,9,44.4,5,7,0,7,0,7,5,0,"MF,FW",25-29,Midfielder,Italy,Europe
2776,Valerio Verre,ITA,Empoli,Serie A,2021,27.0,1994.0,3.4,4,2,3,1,0,2,7,28.6,5,2,0,2,1,5,0,0,MF,25-29,Midfielder,Italy,Europe
2779,Jannik Vestergaard,DEN,Leicester City,Premier League,2021,28.0,1992.0,6.3,15,10,12,3,0,8,15,53.3,7,10,8,2,7,22,36,0,DF,25-29,Defender,Denmark,Europe
2781,Guglielmo Vicario,ITA,Empoli,Serie A,2021,24.0,1996.0,38.0,1,1,1,0,0,1,1,100.0,0,1,0,1,1,2,21,1,GK,20-24,Goalkeeper,Italy,Europe
2783,Arturo Vidal,CHI,Inter,Serie A,2021,34.0,1987.0,8.2,26,10,16,9,1,9,26,34.6,17,13,5,8,7,33,7,1,MF,30-34,Midfielder,Chile,South America
2785,Gabriel Vidovic,CRO,Bayern Munich,Bundesliga,2021,17.0,2003.0,0.4,0,0,0,0,0,0,0,,0,0,0,0,0,0,0,0,"FW,MF",Under 20,Forward,Croatia,Europe
2786,Ronaldo Vieira,ENG,Sampdoria,Serie A,2021,23.0,1998.0,5.5,10,6,6,4,0,5,10,50.0,5,5,2,3,6,16,5,1,MF,20-24,Midfielder,England,Europe
2788,Luca Vignali,ITA,Spezia,Serie A,2021,25.0,1996.0,0.9,1,1,0,1,0,0,3,0.0,3,0,0,0,1,2,1,0,"DF,MF",25-29,Defender,Italy,Europe
2789,Emanuel Vignato,ITA,Bologna,Serie A,2021,20.0,2000.0,6.6,12,7,5,7,0,6,13,46.2,7,2,0,2,2,14,5,0,"MF,DF",20-24,Midfielder,Italy,Europe
2795,Matías Viña,URU,Roma,Serie A,2021,23.0,1997.0,17.4,46,30,27,14,5,29,59,49.2,30,26,3,23,25,71,33,0,"DF,FW",20-24,Defender,Uruguay,South America
2796,Nicolas Viola,ITA,Bologna,Serie A,2021,31.0,1989.0,1.1,2,2,1,1,0,1,2,50.0,1,1,1,0,0,2,1,0,MF,30-34,Midfielder,Italy,Europe
2797,Mattia Viti,ITA,Empoli,Serie A,2021,19.0,2002.0,16.6,28,16,16,9,3,15,24,62.5,9,28,25,3,29,57,69,1,DF,Under 20,Defender,Italy,Europe
2802,Nikola Vlašić,CRO,West Ham,Premier League,2021,23.0,1997.0,6.2,11,7,4,6,1,5,20,25.0,15,4,0,4,2,13,1,0,"FW,MF",20-24,Forward,Croatia,Europe
2803,Andreas Voglsammer,GER,Union Berlin,Bundesliga,2021,29.0,1992.0,9.8,14,9,8,3,3,6,14,42.9,8,9,2,7,2,16,7,0,"FW,MF",25-29,Forward,Germany,Europe
2804,Kevin Vogt,GER,Hoffenheim,Bundesliga,2021,29.0,1991.0,28.5,21,12,15,6,0,11,21,52.4,10,18,7,11,13,34,101,1,DF,25-29,Defender,Germany,Europe
2806,Kevin Volland,GER,Monaco,Ligue 1,2021,29.0,1992.0,27.1,24,10,2,18,4,6,31,19.4,25,20,0,20,3,27,9,0,"MF,FW",25-29,Midfielder,Germany,Europe
2808,Aster Vranckx,BEL,Wolfsburg,Bundesliga,2021,18.0,2002.0,12.7,34,13,14,16,4,14,26,53.8,12,19,7,12,13,47,16,0,MF,Under 20,Midfielder,Belgium,Europe
2809,Stefan de Vrij,NED,Inter,Serie A,2021,29.0,1992.0,26.8,38,29,22,16,0,12,17,70.6,5,17,8,9,32,70,52,0,DF,25-29,Defender,Netherlands,Europe
2813,Elye Wahi,FRA,Montpellier,Ligue 1,2021,18.0,2003.0,19.8,18,10,9,6,3,6,16,37.5,10,7,0,7,4,22,4,0,FW,Under 20,Forward,France,Europe
2814,Walace,BRA,Udinese,Serie A,2021,26.0,1995.0,33.0,83,49,37,38,8,50,113,44.2,63,51,5,46,54,137,32,1,MF,25-29,Midfielder,Brazil,South America
2815,Theo Walcott,ENG,Southampton,Premier League,2021,32.0,1989.0,4.2,4,2,2,0,2,1,5,20.0,4,3,0,3,5,9,2,0,"MF,FW",30-34,Midfielder,England,Europe
2816,Luca Waldschmidt,GER,Wolfsburg,Bundesliga,2021,25.0,1996.0,8.0,9,1,3,5,1,5,13,38.5,8,5,0,5,8,17,3,0,"MF,FW",25-29,Midfielder,Germany,Europe
2817,Kyle Walker,ENG,Manchester City,Premier League,2021,31.0,1990.0,19.5,15,6,7,7,1,8,17,47.1,9,14,4,10,14,29,16,1,DF,30-34,Defender,England,Europe
2818,Kyle Walker-Peters,ENG,Southampton,Premier League,2021,24.0,1997.0,29.3,57,33,28,21,8,26,38,68.4,12,29,8,21,37,94,53,1,DF,20-24,Defender,England,Europe
2820,Aaron Wan-Bissaka,ENG,Manchester Utd,Premier League,2021,23.0,1997.0,19.9,49,36,25,18,6,14,20,70.0,6,24,14,10,34,83,41,2,DF,20-24,Defender,England,Europe
2822,Danny Ward,WAL,Leicester City,Premier League,2021,28.0,1993.0,1.0,0,0,0,0,0,0,0,,0,0,0,0,0,0,1,0,GK,25-29,Goalkeeper,Wales,Europe
2822,Danny Ward,WAL,Leicester City,Premier League,2021,28.0,1993.0,1.0,0,0,0,0,0,0,0,,0,0,0,0,0,0,1,0,GK,25-29,Goalkeeper,Wales,Europe
2822,Danny Ward,WAL,Leicester City,Premier League,2021,28.0,1993.0,1.0,0,0,0,0,0,0,0,,0,0,0,0,0,0,1,0,GK,25-29,Goalkeeper,Wales,Europe
2822,Danny Ward,WAL,Leicester City,Premier League,2021,28.0,1993.0,1.0,0,0,0,0,0,0,0,,0,0,0,0,0,0,1,0,GK,25-29,Goalkeeper,Wales,Europe
2823,Joel Ward,ENG,Crystal Palace,Premier League,2021,31.0,1989.0,27.6,44,26,30,11,3,30,57,52.6,27,24,11,13,32,76,107,1,DF,30-34,Defender,England,Europe
2824,James Ward-Prowse,ENG,Southampton,Premier League,2021,26.0,1994.0,35.7,41,24,12,24,5,19,70,27.1,51,43,15,28,40,81,45,1,MF,25-29,Midfielder,England,Europe
2828,Ollie Watkins,ENG,Aston Villa,Premier League,2021,25.0,1995.0,32.8,17,13,2,7,8,2,15,13.3,13,25,3,22,12,29,27,0,FW,25-29,Forward,England,Europe
2829,Timothy Weah,USA,Lille,Ligue 1,2021,21.0,2000.0,18.0,19,7,8,8,3,10,20,50.0,10,16,1,15,10,29,7,0,"MF,FW",20-24,Midfielder,United States,North America
2830,Adam Webster,ENG,Brighton,Premier League,2021,26.0,1995.0,15.9,26,8,17,7,2,13,20,65.0,7,25,17,8,17,43,66,2,DF,25-29,Defender,England,Europe
2833,Noah Weißhaupt,GER,Freiburg,Bundesliga,2021,19.0,2001.0,1.1,1,1,1,0,0,1,2,50.0,1,2,0,2,1,2,1,1,"MF,FW",Under 20,Midfielder,Germany,Europe
2834,Danny Welbeck,ENG,Brighton,Premier League,2021,30.0,1990.0,16.4,14,7,2,8,4,3,10,30.0,7,18,2,16,5,19,18,0,"FW,MF",30-34,Forward,England,Europe
2835,Timo Werner,GER,Chelsea,Premier League,2021,25.0,1996.0,14.3,8,4,3,3,2,2,20,10.0,18,9,0,9,2,10,4,0,"FW,MF",25-29,Forward,Germany,Europe
2836,Ashley Westwood,ENG,Burnley,Premier League,2021,31.0,1990.0,25.4,21,12,8,12,1,10,31,32.3,21,21,9,12,30,51,16,1,MF,30-34,Midfielder,England,Europe
2837,Ben White,ENG,Arsenal,Premier League,2021,23.0,1997.0,32.0,44,23,30,8,6,28,45,62.2,17,42,24,18,42,86,102,0,DF,20-24,Defender,England,Europe
2838,Silvan Widmer,SUI,Mainz 05,Bundesliga,2021,28.0,1993.0,32.4,60,28,32,20,8,36,61,59.0,25,44,16,28,43,103,59,2,DF,25-29,Defender,Switzerland,Europe
2839,Georginio Wijnaldum,NED,Paris S-G,Ligue 1,2021,30.0,1990.0,18.4,15,9,2,12,1,11,19,57.9,8,13,3,10,9,24,7,0,MF,30-34,Midfielder,Netherlands,Europe
2841,Brandon Williams,ENG,Norwich City,Premier League,2021,20.0,2000.0,23.6,55,37,35,18,2,36,64,56.3,28,26,6,20,44,99,50,0,DF,20-24,Defender,England,Europe
2842,Iñaki Williams,GHA,Athletic Club,La Liga,2021,27.0,1994.0,30.9,14,5,1,6,7,5,17,29.4,12,18,3,15,3,17,20,0,FW,25-29,Forward,Ghana,Africa
2843,Neco Williams,WAL,Liverpool,Premier League,2021,20.0,2001.0,0.1,0,0,0,0,0,0,0,,0,0,0,0,0,0,0,0,DF,20-24,Defender,Wales,Europe
2845,Joe Willock,ENG,Newcastle Utd,Premier League,2021,21.0,1999.0,22.6,64,37,30,28,6,29,68,42.6,39,37,6,31,21,85,10,1,MF,20-24,Midfielder,England,Europe
2846,Callum Wilson,ENG,Newcastle Utd,Premier League,2021,29.0,1992.0,15.4,9,8,1,5,3,1,4,25.0,3,7,2,5,3,12,10,0,FW,25-29,Forward,England,Europe
2846,Callum Wilson,ENG,Newcastle Utd,Premier League,2021,29.0,1992.0,15.4,9,8,1,5,3,1,4,25.0,3,7,2,5,3,12,10,0,FW,25-29,Forward,England,Europe
2846,Callum Wilson,ENG,Newcastle Utd,Premier League,2021,29.0,1992.0,15.4,9,8,1,5,3,1,4,25.0,3,7,2,5,3,12,10,0,FW,25-29,Forward,England,Europe
2846,Callum Wilson,ENG,Newcastle Utd,Premier League,2021,29.0,1992.0,15.4,9,8,1,5,3,1,4,25.0,3,7,2,5,3,12,10,0,FW,25-29,Forward,England,Europe
2847,Patrick Wimmer,AUT,Arminia,Bundesliga,2021,20.0,2001.0,22.8,53,31,13,31,9,22,61,36.1,39,30,1,29,27,80,13,0,"FW,MF",20-24,Forward,Austria,Europe
2848,Jonas Wind,DEN,Wolfsburg,Bundesliga,2021,22.0,1999.0,13.1,10,6,1,7,2,1,4,25.0,3,8,3,5,6,16,13,0,"FW,MF",20-24,Forward,Denmark,Europe
2849,Marten Winkler,GER,Hertha BSC,Bundesliga,2021,18.0,2002.0,0.3,0,0,0,0,0,0,0,,0,0,0,0,0,0,0,0,MF,Under 20,Midfielder,Germany,Europe
2850,Harry Winks,ENG,Tottenham,Premier League,2021,25.0,1996.0,10.1,15,10,4,9,2,8,21,38.1,13,14,3,11,16,31,10,2,MF,25-29,Midfielder,England,Europe
2851,Frederik Winther,DEN,Augsburg,Bundesliga,2021,20.0,2001.0,3.6,7,2,7,0,0,5,6,83.3,1,4,1,3,8,15,21,0,DF,20-24,Defender,Denmark,Europe
2852,Florian Wirtz,GER,Leverkusen,Bundesliga,2021,18.0,2003.0,20.6,25,10,6,16,3,10,28,35.7,18,12,1,11,13,38,4,0,"MF,FW",Under 20,Midfielder,Germany,Europe
2853,Yoane Wissa,COD,Brentford,Premier League,2021,24.0,1996.0,14.3,12,6,5,4,3,1,16,6.3,15,12,5,7,8,20,6,0,FW,20-24,Forward,DR Congo,Africa
2854,Axel Witsel,BEL,Dortmund,Bundesliga,2021,32.0,1989.0,21.6,42,27,12,23,7,18,30,60.0,12,24,9,15,27,69,38,0,"MF,DF",30-34,Midfielder,Belgium,Europe
2855,Hannes Wolf,AUT,Gladbach,Bundesliga,2021,22.0,1999.0,3.4,23,12,4,13,6,10,20,50.0,10,10,0,10,2,25,1,0,"FW,MF",20-24,Forward,Austria,Europe
2856,Marius Wolf,GER,Dortmund,Bundesliga,2021,26.0,1995.0,14.7,26,10,13,9,4,12,24,50.0,12,14,1,13,13,39,8,0,"DF,FW",25-29,Defender,Germany,Europe
2859,Chris Wood,NZL,Burnley,Premier League,2021,29.0,1991.0,15.2,7,5,0,3,4,3,10,30.0,7,13,4,9,0,7,3,0,FW,25-29,Forward,New Zealand,Oceania
2860,Chris Wood,NZL,Newcastle Utd,Premier League,2021,29.0,1991.0,14.7,2,0,1,1,0,1,2,50.0,1,5,2,3,2,4,9,0,FW,25-29,Forward,New Zealand,Oceania
2861,Freddie Woodman,ENG,Newcastle Utd,Premier League,2021,24.0,1997.0,4.0,0,0,0,0,0,0,0,,0,0,0,0,0,0,0,1,GK,20-24,Goalkeeper,England,Europe
2862,Christopher Wooh,CMR,Lens,Ligue 1,2021,19.0,2001.0,11.7,29,11,20,8,1,11,18,61.1,7,21,14,7,21,50,40,1,DF,Under 20,Defender,Cameroon,Africa
2863,Joscha Wosz,GER,RB Leipzig,Bundesliga,2021,19.0,2002.0,0.1,0,0,0,0,0,0,0,,0,0,0,0,0,0,0,0,DF,Under 20,Defender,Germany,Europe
2865,Granit Xhaka,SUI,Arsenal,Premier League,2021,28.0,1992.0,25.9,32,18,16,12,4,16,41,39.0,25,21,6,15,21,53,31,0,"MF,DF",25-29,Midfielder,Switzerland,Europe
2869,Kelvin Yeboah,ITA,Genoa,Serie A,2021,21.0,2000.0,9.4,14,7,5,7,2,9,19,47.4,10,22,1,21,1,15,7,0,"FW,MF",20-24,Forward,Italy,Europe
2875,Maya Yoshida,JPN,Sampdoria,Serie A,2021,32.0,1988.0,20.3,17,10,8,9,0,8,15,53.3,7,27,20,7,28,45,72,1,DF,30-34,Defender,Japan,Asia
2876,Ashley Young,ENG,Aston Villa,Premier League,2021,36.0,1985.0,13.9,18,6,9,6,3,11,16,68.8,5,10,4,6,13,31,25,1,"DF,FW",35-39,Defender,England,Europe
2879,Mattia Zaccagni,ITA,Hellas Verona,Serie A,2021,26.0,1995.0,2.0,3,1,1,0,2,1,2,50.0,1,1,0,1,4,7,0,0,MF,25-29,Midfielder,Italy,Europe
2880,Mattia Zaccagni,ITA,Lazio,Serie A,2021,26.0,1995.0,20.8,33,16,10,13,10,11,19,57.9,8,17,2,15,20,53,5,0,FW,25-29,Forward,Italy,Europe
2881,Dan-Axel Zagadou,FRA,Dortmund,Bundesliga,2021,22.0,1999.0,10.6,13,7,11,1,1,7,10,70.0,3,14,4,10,15,28,38,2,DF,20-24,Defender,France,Europe
2883,Denis Zakaria,SUI,Juventus,Serie A,2021,24.0,1996.0,6.6,11,7,3,6,2,3,11,27.3,8,16,3,13,11,22,7,0,MF,20-24,Midfielder,Switzerland,Europe
2884,Denis Zakaria,SUI,Gladbach,Bundesliga,2021,24.0,1996.0,15.5,23,14,9,10,4,12,35,34.3,23,25,5,20,19,42,22,1,"MF,DF",20-24,Midfielder,Switzerland,Europe
2888,Nicolò Zaniolo,ITA,Roma,Serie A,2021,22.0,1999.0,21.9,24,15,0,15,9,6,28,21.4,22,19,0,19,7,31,6,0,"FW,MF",20-24,Forward,Italy,Europe
2889,Alessandro Zanoli,ITA,Napoli,Serie A,2021,20.0,2000.0,5.1,10,7,6,3,1,3,5,60.0,2,2,1,1,4,14,16,0,DF,20-24,Defender,Italy,Europe
2891,Duván Zapata,COL,Atalanta,Serie A,2021,30.0,1991.0,19.1,6,2,0,4,2,4,8,50.0,4,8,1,7,3,9,5,0,FW,30-34,Forward,Colombia,South America
2892,Gabriele Zappa,ITA,Cagliari,Serie A,2021,21.0,1999.0,12.7,21,9,12,6,3,6,24,25.0,18,15,5,10,14,35,28,0,DF,20-24,Defender,Italy,Europe
2893,Davide Zappacosta,ITA,Atalanta,Serie A,2021,29.0,1992.0,26.1,32,22,12,13,7,19,37,51.4,18,32,2,30,12,44,22,0,DF,25-29,Defender,Italy,Europe
2895,Simone Zaza,ITA,Torino,Serie A,2021,30.0,1991.0,1.4,2,2,1,1,0,1,1,100.0,0,3,0,3,0,2,3,0,"FW,DF",30-34,Forward,Italy,Europe
2896,Akim Zedadka,ALG,Clermont Foot,Ligue 1,2021,26.0,1995.0,37.1,72,44,34,29,9,37,71,52.1,34,32,8,24,58,130,48,0,DF,25-29,Defender,Algeria,Africa
2897,Deyovaisio Zeefuik,NED,Hertha BSC,Bundesliga,2021,23.0,1998.0,6.3,11,10,6,4,1,6,12,50.0,6,12,4,8,11,22,21,1,DF,20-24,Defender,Netherlands,Europe
2898,Marvin Zeegelaar,NED,Udinese,Serie A,2021,30.0,1990.0,7.1,15,11,6,8,1,5,14,35.7,9,12,4,8,12,27,22,1,DF,30-34,Defender,Netherlands,Europe
2900,Robin Zentner,GER,Mainz 05,Bundesliga,2021,26.0,1994.0,32.0,2,2,2,0,0,2,2,100.0,0,0,0,0,2,4,21,1,GK,25-29,Goalkeeper,Germany,Europe
2902,Mehdi Zerkane,ALG,Bordeaux,Ligue 1,2021,22.0,1999.0,0.9,0,0,0,0,0,0,1,0.0,1,1,1,0,2,2,0,0,"MF,DF",20-24,Midfielder,Algeria,Africa
2904,Luca Zidane,FRA,Rayo Vallecano,La Liga,2021,23.0,1998.0,7.2,0,0,0,0,0,0,1,0.0,1,0,0,0,0,0,1,1,GK,20-24,Goalkeeper,France,Europe
2907,Christoph Zimmermann,GER,Norwich City,Premier League,2021,28.0,1993.0,1.7,6,3,5,1,0,3,4,75.0,1,0,0,0,1,7,4,0,DF,25-29,Defender,Germany,Europe
2908,Oleksandr Zinchenko,UKR,Manchester City,Premier League,2021,24.0,1996.0,11.6,20,14,7,10,3,11,20,55.0,9,11,3,8,14,34,15,1,DF,20-24,Defender,Ukraine,Europe
2911,Simon Zoller,GER,Bochum,Bundesliga,2021,30.0,1991.0,6.6,4,2,2,1,1,1,3,33.3,2,3,0,3,4,8,2,0,FW,30-34,Forward,Germany,Europe
2912,Nadir Zortea,ITA,Salernitana,Serie A,2021,22.0,1999.0,15.7,21,15,9,7,5,11,19,57.9,8,14,2,12,7,28,33,0,"DF,MF",20-24,Defender,Italy,Europe
2913,Tanguy Zoukrou,FRA,Troyes,Ligue 1,2021,18.0,2003.0,0.9,1,0,1,0,0,1,2,50.0,1,0,0,0,0,1,2,0,DF,Under 20,Defender,France,Europe
2914,Kurt Zouma,FRA,West Ham,Premier League,2021,26.0,1994.0,23.1,11,6,8,3,0,4,7,57.1,3,31,26,5,34,45,132,0,DF,25-29,Defender,France,Europe
2915,Petar Zovko,BIH,Spezia,Serie A,2021,19.0,2002.0,0.3,0,0,0,0,0,0,0,,0,0,0,0,0,0,1,0,GK,Under 20,Goalkeeper,Bosnia and Herzegovina,Europe
2053,Patric,ESP,Lazio,Serie A,2021,28.0,1993.0,18.3,21,15,17,4,0,9,20,45.0,11,22,11,11,12,33,44,2,DF,25-29,Defender,Spain,Europe
2058,Strahinja Pavlović,SRB,Monaco,Ligue 1,2021,20.0,2001.0,5.0,23,16,8,13,2,8,12,66.7,4,5,3,2,9,32,15,0,DF,20-24,Defender,Serbia,Europe
2062,Alfonso Pedraza,ESP,Villarreal,La Liga,2021,25.0,1996.0,18.9,34,16,17,12,5,10,28,35.7,18,12,3,9,31,65,32,0,DF,25-29,Defender,Spain,Europe
2063,Pedri,ESP,Barcelona,La Liga,2021,18.0,2002.0,9.8,20,12,9,8,3,7,20,35.0,13,13,0,13,5,25,7,1,MF,Under 20,Midfielder,Spain,Europe
2064,Pedro,ESP,Lazio,Serie A,2021,34.0,1987.0,22.6,36,23,8,19,9,16,47,34.0,31,18,2,16,6,42,8,0,FW,30-34,Forward,Spain,Europe
2064,Pedro,ESP,Lazio,Serie A,2021,34.0,1987.0,22.6,36,23,8,19,9,16,47,34.0,31,18,2,16,6,42,8,0,FW,30-34,Forward,Spain,Europe
2064,Pedro,ESP,Lazio,Serie A,2021,34.0,1987.0,22.6,36,23,8,19,9,16,47,34.0,31,18,2,16,6,42,8,0,FW,30-34,Forward,Spain,Europe
2064,Pedro,ESP,Lazio,Serie A,2021,34.0,1987.0,22.6,36,23,8,19,9,16,47,34.0,31,18,2,16,6,42,8,0,FW,30-34,Forward,Spain,Europe
2064,Pedro,ESP,Lazio,Serie A,2021,34.0,1987.0,22.6,36,23,8,19,9,16,47,34.0,31,18,2,16,6,42,8,0,FW,30-34,Forward,Spain,Europe
2064,Pedro,ESP,Lazio,Serie A,2021,34.0,1987.0,22.6,36,23,8,19,9,16,47,34.0,31,18,2,16,6,42,8,0,FW,30-34,Forward,Spain,Europe
2064,Pedro,ESP,Lazio,Serie A,2021,34.0,1987.0,22.6,36,23,8,19,9,16,47,34.0,31,18,2,16,6,42,8,0,FW,30-34,Forward,Spain,Europe
2064,Pedro,ESP,Lazio,Serie A,2021,34.0,1987.0,22.6,36,23,8,19,9,16,47,34.0,31,18,2,16,6,42,8,0,FW,30-34,Forward,Spain,Europe
2064,Pedro,ESP,Lazio,Serie A,2021,34.0,1987.0,22.6,36,23,8,19,9,16,47,34.0,31,18,2,16,6,42,8,0,FW,30-34,Forward,Spain,Europe
2064,Pedro,ESP,Lazio,Serie A,2021,34.0,1987.0,22.6,36,23,8,19,9,16,47,34.0,31,18,2,16,6,42,8,0,FW,30-34,Forward,Spain,Europe
2064,Pedro,ESP,Lazio,Serie A,2021,34.0,1987.0,22.6,36,23,8,19,9,16,47,34.0,31,18,2,16,6,42,8,0,FW,30-34,Forward,Spain,Europe
2064,Pedro,ESP,Lazio,Serie A,2021,34.0,1987.0,22.6,36,23,8,19,9,16,47,34.0,31,18,2,16,6,42,8,0,FW,30-34,Forward,Spain,Europe
2064,Pedro,ESP,Lazio,Serie A,2021,34.0,1987.0,22.6,36,23,8,19,9,16,47,34.0,31,18,2,16,6,42,8,0,FW,30-34,Forward,Spain,Europe
2064,Pedro,ESP,Lazio,Serie A,2021,34.0,1987.0,22.6,36,23,8,19,9,16,47,34.0,31,18,2,16,6,42,8,0,FW,30-34,Forward,Spain,Europe
2064,Pedro,ESP,Lazio,Serie A,2021,34.0,1987.0,22.6,36,23,8,19,9,16,47,34.0,31,18,2,16,6,42,8,0,FW,30-34,Forward,Spain,Europe
2064,Pedro,ESP,Lazio,Serie A,2021,34.0,1987.0,22.6,36,23,8,19,9,16,47,34.0,31,18,2,16,6,42,8,0,FW,30-34,Forward,Spain,Europe
2066,Adrià Pedrosa,ESP,Espanyol,La Liga,2021,23.0,1998.0,30.2,58,30,38,14,6,26,57,45.6,31,25,7,18,25,83,92,2,DF,20-24,Defender,Spain,Europe
2076,Rubén Peña,ESP,Villarreal,La Liga,2021,30.0,1991.0,1.5,2,0,1,1,0,2,6,33.3,4,1,0,1,5,7,2,0,"MF,FW",30-34,Midfielder,Spain,Europe
2080,Alberto Perea,ESP,Cádiz,La Liga,2021,30.0,1990.0,8.6,19,9,7,9,3,6,20,30.0,14,15,1,14,9,28,4,0,MF,30-34,Midfielder,Spain,Europe
2089,Ayoze Pérez,ESP,Leicester City,Premier League,2021,28.0,1993.0,4.9,4,2,0,3,1,0,13,0.0,13,11,1,10,2,6,5,0,"MF,FW",25-29,Midfielder,Spain,Europe
2090,Carles Pérez,ESP,Roma,Serie A,2021,23.0,1998.0,6.2,8,3,3,1,4,3,12,25.0,9,10,0,10,2,10,2,0,"MF,FW",20-24,Midfielder,Spain,Europe
2091,Iñigo Pérez,ESP,Osasuna,La Liga,2021,33.0,1988.0,3.8,3,2,2,1,0,2,4,50.0,2,1,0,1,0,3,3,0,MF,30-34,Midfielder,Spain,Europe
2092,Juan Pérez,ESP,Osasuna,La Liga,2021,25.0,1996.0,2.0,0,0,0,0,0,0,1,0.0,1,0,0,0,0,0,1,1,GK,25-29,Goalkeeper,Spain,Europe
2093,Kike Pérez,ESP,Elche,La Liga,2021,24.0,1997.0,5.8,8,6,1,3,4,0,10,0.0,10,6,1,5,3,11,4,0,"MF,FW",20-24,Midfielder,Spain,Europe
2111,Jens Petter Hauge,NOR,Eint Frankfurt,Bundesliga,2021,21.0,1999.0,11.6,14,5,6,7,1,7,23,30.4,16,7,0,7,3,17,5,0,"MF,FW",20-24,Midfielder,Norway,Europe
2139,Gerard Piqué,ESP,Barcelona,La Liga,2021,34.0,1987.0,23.2,22,12,18,4,0,11,14,78.6,3,19,16,3,34,56,86,1,DF,30-34,Defender,Spain,Europe
2153,Pere Pons,ESP,Alavés,La Liga,2021,28.0,1993.0,15.2,26,18,4,20,2,7,21,33.3,14,10,1,9,6,32,11,0,MF,25-29,Midfielder,Spain,Europe
2156,Portu,ESP,Real Sociedad,La Liga,2021,29.0,1992.0,17.7,16,7,2,6,8,3,19,15.8,16,21,3,18,7,23,8,0,"FW,MF",25-29,Forward,Spain,Europe
2158,Sergio Postigo,ESP,Levante,La Liga,2021,32.0,1988.0,9.4,11,7,8,2,1,4,8,50.0,4,7,5,2,7,18,45,1,DF,30-34,Defender,Spain,Europe
2162,José Pozo,ESP,Rayo Vallecano,La Liga,2021,25.0,1996.0,0.8,2,2,0,2,0,2,3,66.7,1,1,0,1,0,2,1,0,"MF,DF",25-29,Midfielder,Spain,Europe
2164,Mateusz Praszelik,POL,Hellas Verona,Serie A,2021,20.0,2000.0,0.3,0,0,0,0,0,0,0,,0,0,0,0,0,0,0,0,MF,20-24,Midfielder,Poland,Europe
2165,Abdón Prats,ESP,Mallorca,La Liga,2021,28.0,1992.0,7.1,2,2,1,0,1,1,5,20.0,4,5,0,5,1,3,6,0,FW,25-29,Forward,Spain,Europe
2174,Javi Puado,ESP,Espanyol,La Liga,2021,23.0,1998.0,24.9,24,14,18,5,1,12,37,32.4,25,18,2,16,11,35,24,0,"MF,FW",20-24,Midfielder,Spain,Europe
2175,Marc Pubill,ESP,Levante,La Liga,2021,18.0,2003.0,5.7,12,6,10,2,0,4,8,50.0,4,7,2,5,4,16,8,2,"DF,MF",Under 20,Defender,Spain,Europe
2176,Antonio Puertas,ESP,Granada,La Liga,2021,29.0,1992.0,25.1,34,20,18,12,4,17,44,38.6,27,33,3,30,11,45,36,0,"MF,FW",25-29,Midfielder,Spain,Europe
2177,Riqui Puig,ESP,Barcelona,La Liga,2021,21.0,1999.0,5.4,6,3,2,4,0,2,14,14.3,12,5,0,5,3,9,0,0,MF,20-24,Midfielder,Spain,Europe
2188,Dani Raba,ESP,Villarreal,La Liga,2021,25.0,1995.0,1.0,1,0,0,1,0,1,2,50.0,1,2,0,2,0,1,2,0,"MF,FW",25-29,Midfielder,Spain,Europe
2189,Dani Raba,ESP,Granada,La Liga,2021,25.0,1995.0,0.3,2,2,1,0,1,2,3,66.7,1,0,0,0,1,3,0,0,"MF,FW",25-29,Midfielder,Spain,Europe
2192,Nemanja Radoja,SRB,Levante,La Liga,2021,28.0,1993.0,13.5,25,8,9,13,3,8,20,40.0,12,16,9,7,22,47,16,2,MF,25-29,Midfielder,Serbia,Europe
2193,Nemanja Radonjić,SRB,Marseille,Ligue 1,2021,25.0,1996.0,0.2,0,0,0,0,0,0,0,,0,0,0,0,0,0,0,0,FW,25-29,Forward,Serbia,Europe
2197,Boris Radunović,SRB,Cagliari,Serie A,2021,25.0,1996.0,3.0,0,0,0,0,0,0,0,,0,0,0,0,0,0,0,0,GK,25-29,Goalkeeper,Serbia,Europe
2203,Predrag Rajković,SRB,Reims,Ligue 1,2021,25.0,1995.0,38.0,2,2,2,0,0,2,3,66.7,1,1,0,1,1,3,21,1,GK,25-29,Goalkeeper,Serbia,Europe
2207,Jonás Ramalho,ESP,Osasuna,La Liga,2021,28.0,1993.0,2.7,4,2,2,2,0,2,3,66.7,1,4,1,3,3,7,9,0,DF,25-29,Defender,Spain,Europe
2209,Sandro Ramírez,ESP,Getafe,La Liga,2021,26.0,1995.0,16.2,7,3,1,3,3,1,12,8.3,11,14,3,11,2,9,3,0,FW,25-29,Forward,Spain,Europe
2211,Sergio Ramos,ESP,Paris S-G,Ligue 1,2021,35.0,1986.0,8.9,12,5,6,6,0,8,15,53.3,7,4,2,2,8,20,27,0,DF,35-39,Defender,Spain,Europe
2226,David Raya,ESP,Brentford,Premier League,2021,25.0,1995.0,24.0,0,0,0,0,0,0,0,,0,1,0,1,0,0,10,1,GK,25-29,Goalkeeper,Spain,Europe
2228,Arkadiusz Reca,POL,Spezia,Serie A,2021,26.0,1995.0,19.7,31,19,21,3,7,20,30,66.7,10,20,7,13,32,63,47,2,DF,25-29,Defender,Poland,Europe
2229,Lluís Recasens,ESP,Espanyol,La Liga,2021,19.0,2002.0,0.5,2,0,2,0,0,1,1,100.0,0,0,0,0,2,4,2,0,DF,Under 20,Defender,Spain,Europe
2231,Sergio Reguilón,ESP,Tottenham,Premier League,2021,24.0,1996.0,21.3,40,24,15,18,7,22,43,51.2,21,20,8,12,31,71,45,1,"DF,MF",20-24,Defender,Spain,Europe
2232,Manolo Reina,ESP,Mallorca,La Liga,2021,36.0,1985.0,21.0,0,0,0,0,0,0,0,,0,0,0,0,1,1,6,2,GK,35-39,Goalkeeper,Spain,Europe
2233,Pepe Reina,ESP,Lazio,Serie A,2021,38.0,1982.0,15.0,0,0,0,0,0,0,1,0.0,1,0,0,0,0,0,1,1,GK,35-39,Goalkeeper,Spain,Europe
2237,Álex Remiro,ESP,Real Sociedad,La Liga,2021,26.0,1995.0,35.0,0,0,0,0,0,0,0,,0,0,0,0,1,1,24,2,GK,25-29,Goalkeeper,Spain,Europe
2256,Diego Rico,ESP,Real Sociedad,La Liga,2021,28.0,1993.0,18.3,41,20,19,17,5,22,45,48.9,23,29,4,25,30,71,54,0,DF,25-29,Defender,Spain,Europe
2257,Sergio Rico,ESP,Mallorca,La Liga,2021,27.0,1993.0,14.0,0,0,0,0,0,0,0,,0,0,0,0,0,0,5,2,GK,25-29,Goalkeeper,Spain,Europe
2258,Sergio Rico,ESP,Paris S-G,Ligue 1,2021,27.0,1993.0,0.3,0,0,0,0,0,0,0,,0,0,0,0,0,0,1,0,GK,25-29,Goalkeeper,Spain,Europe
2263,Luis Rioja,ESP,Alavés,La Liga,2021,27.0,1993.0,34.6,28,15,11,10,7,14,58,24.1,44,22,1,21,25,53,20,0,"MF,FW",25-29,Midfielder,Spain,Europe
2269,Sergi Roberto,ESP,Barcelona,La Liga,2021,29.0,1992.0,4.4,5,1,2,3,0,3,5,60.0,2,2,0,2,4,9,6,0,"MF,DF",25-29,Midfielder,Spain,Europe
2274,Marc Roca,ESP,Bayern Munich,Bundesliga,2021,24.0,1996.0,4.2,9,7,2,4,3,2,8,25.0,6,6,0,6,6,15,4,0,MF,20-24,Midfielder,Spain,Europe
2275,Rubén Rochina,ESP,Granada,La Liga,2021,30.0,1991.0,8.3,21,13,7,8,6,8,28,28.6,20,11,1,10,6,27,5,1,"MF,FW",30-34,Midfielder,Spain,Europe
2281,Rodri,ESP,Manchester City,Premier League,2021,25.0,1996.0,32.0,72,43,24,38,10,32,59,54.2,27,28,5,23,28,100,45,0,MF,25-29,Midfielder,Spain,Europe
2281,Rodri,ESP,Manchester City,Premier League,2021,25.0,1996.0,32.0,72,43,24,38,10,32,59,54.2,27,28,5,23,28,100,45,0,MF,25-29,Midfielder,Spain,Europe
2281,Rodri,ESP,Manchester City,Premier League,2021,25.0,1996.0,32.0,72,43,24,38,10,32,59,54.2,27,28,5,23,28,100,45,0,MF,25-29,Midfielder,Spain,Europe
2281,Rodri,ESP,Manchester City,Premier League,2021,25.0,1996.0,32.0,72,43,24,38,10,32,59,54.2,27,28,5,23,28,100,45,0,MF,25-29,Midfielder,Spain,Europe
2282,Rodri,ESP,Betis,La Liga,2021,21.0,2000.0,9.8,10,7,4,5,1,5,22,22.7,17,11,0,11,3,13,4,0,FW,20-24,Forward,Spain,Europe
2282,Rodri,ESP,Betis,La Liga,2021,21.0,2000.0,9.8,10,7,4,5,1,5,22,22.7,17,11,0,11,3,13,4,0,FW,20-24,Forward,Spain,Europe
2282,Rodri,ESP,Betis,La Liga,2021,21.0,2000.0,9.8,10,7,4,5,1,5,22,22.7,17,11,0,11,3,13,4,0,FW,20-24,Forward,Spain,Europe
2282,Rodri,ESP,Betis,La Liga,2021,21.0,2000.0,9.8,10,7,4,5,1,5,22,22.7,17,11,0,11,3,13,4,0,FW,20-24,Forward,Spain,Europe
2283,Rodrigo,ESP,Leeds United,Premier League,2021,30.0,1991.0,25.2,20,9,7,6,7,4,32,12.5,28,12,0,12,11,31,27,1,"MF,FW",30-34,Midfielder,Spain,Europe
2286,Ángel Rodríguez,ESP,Mallorca,La Liga,2021,34.0,1987.0,17.2,15,9,6,7,2,4,21,19.0,17,15,1,14,3,18,13,0,"FW,MF",30-34,Forward,Spain,Europe
2289,Dani Rodríguez,ESP,Mallorca,La Liga,2021,33.0,1988.0,31.5,53,31,20,24,9,15,46,32.6,31,28,3,25,20,73,27,0,"MF,FW",30-34,Midfielder,Spain,Europe
2289,Dani Rodríguez,ESP,Mallorca,La Liga,2021,33.0,1988.0,31.5,53,31,20,24,9,15,46,32.6,31,28,3,25,20,73,27,0,"MF,FW",30-34,Midfielder,Spain,Europe
2289,Dani Rodríguez,ESP,Mallorca,La Liga,2021,33.0,1988.0,31.5,53,31,20,24,9,15,46,32.6,31,28,3,25,20,73,27,0,"MF,FW",30-34,Midfielder,Spain,Europe
2289,Dani Rodríguez,ESP,Mallorca,La Liga,2021,33.0,1988.0,31.5,53,31,20,24,9,15,46,32.6,31,28,3,25,20,73,27,0,"MF,FW",30-34,Midfielder,Spain,Europe
2299,Leo Román,ESP,Mallorca,La Liga,2021,21.0,2000.0,2.0,0,0,0,0,0,0,0,,0,0,0,0,0,0,2,0,GK,20-24,Goalkeeper,Spain,Europe
2301,Iván Romero,ESP,Sevilla,La Liga,2021,20.0,2001.0,2.0,2,2,0,2,0,0,0,,0,1,0,1,2,4,0,0,FW,20-24,Forward,Spain,Europe
2304,Oriol Romeu,ESP,Southampton,Premier League,2021,29.0,1991.0,32.1,77,39,25,45,7,28,73,38.4,45,39,8,31,51,128,43,0,MF,25-29,Midfielder,Spain,Europe
2328,Aitor Ruibal,ESP,Betis,La Liga,2021,25.0,1996.0,9.5,21,15,13,3,5,10,34,29.4,24,8,0,8,8,29,6,0,"FW,DF",25-29,Forward,Spain,Europe
2329,Isma Ruiz,ESP,Granada,La Liga,2021,20.0,2001.0,3.1,3,1,3,0,0,1,9,11.1,8,5,2,3,3,6,2,0,MF,20-24,Midfielder,Spain,Europe
2331,Víctor Ruiz,ESP,Betis,La Liga,2021,32.0,1989.0,15.8,11,9,7,2,2,6,9,66.7,3,18,13,5,29,40,71,1,DF,30-34,Defender,Spain,Europe
2338,Julian Ryerson,NOR,Union Berlin,Bundesliga,2021,23.0,1997.0,15.9,27,15,11,12,4,17,25,68.0,8,12,4,8,16,43,32,0,DF,20-24,Defender,Norway,Europe
2372,Fede San Emeterio,ESP,Cádiz,La Liga,2021,24.0,1997.0,9.2,16,5,5,8,3,5,15,33.3,10,5,0,5,8,24,6,0,MF,20-24,Midfielder,Spain,Europe
2374,Oihan Sancet,ESP,Athletic Club,La Liga,2021,21.0,2000.0,15.8,12,7,2,8,2,5,20,25.0,15,2,0,2,5,17,13,0,FW,20-24,Forward,Spain,Europe
2377,Antonio Sánchez,ESP,Mallorca,La Liga,2021,24.0,1997.0,18.0,53,24,29,17,7,19,49,38.8,30,32,2,30,32,85,32,1,"MF,FW",20-24,Midfielder,Spain,Europe
2379,Germán Sánchez,ESP,Granada,La Liga,2021,34.0,1986.0,25.5,27,19,18,9,0,11,20,55.0,9,19,16,3,28,55,137,0,DF,30-34,Defender,Spain,Europe
2380,Manu Sánchez,ESP,Osasuna,La Liga,2021,20.0,2000.0,25.1,72,34,41,22,9,43,79,54.4,36,28,3,25,18,90,43,0,DF,20-24,Defender,Spain,Europe
2381,Robert Sánchez,ESP,Brighton,Premier League,2021,23.0,1997.0,37.0,2,1,2,0,0,1,1,100.0,0,1,0,1,0,2,11,4,GK,20-24,Goalkeeper,Spain,Europe
2386,Oier Sanjurjo,ESP,Osasuna,La Liga,2021,35.0,1986.0,8.4,10,6,3,7,0,2,19,10.5,17,8,3,5,1,11,9,0,MF,35-39,Midfielder,Spain,Europe
2396,Sergio Santos,ESP,Real Madrid,La Liga,2021,20.0,2001.0,0.1,0,0,0,0,0,0,0,,0,0,0,0,0,0,0,0,DF,20-24,Defender,Spain,Europe
2399,Pablo Sarabia,ESP,Paris S-G,Ligue 1,2021,29.0,1992.0,0.2,0,0,0,0,0,0,1,0.0,1,0,0,0,0,0,0,0,FW,25-29,Forward,Spain,Europe
2422,Patrik Schick,CZE,Leverkusen,Bundesliga,2021,25.0,1996.0,23.1,5,2,2,2,1,1,9,11.1,8,6,1,5,3,8,28,0,FW,25-29,Forward,Czech Republic,Europe
2440,Aleksandar Sedlar,SRB,Mallorca,La Liga,2021,29.0,1991.0,4.5,5,3,4,1,0,3,5,60.0,2,4,4,0,5,10,19,0,"DF,MF",25-29,Defender,Serbia,Europe
2460,Salva Sevilla,ESP,Mallorca,La Liga,2021,37.0,1984.0,16.7,18,12,8,8,2,6,17,35.3,11,12,6,6,14,32,11,0,MF,35-39,Midfielder,Spain,Europe
2481,David Silva,ESP,Real Sociedad,La Liga,2021,35.0,1986.0,19.1,28,17,10,11,7,3,20,15.0,17,13,3,10,7,35,12,0,MF,35-39,Midfielder,Spain,Europe
2481,David Silva,ESP,Real Sociedad,La Liga,2021,35.0,1986.0,19.1,28,17,10,11,7,3,20,15.0,17,13,3,10,7,35,12,0,MF,35-39,Midfielder,Spain,Europe
2481,David Silva,ESP,Real Sociedad,La Liga,2021,35.0,1986.0,19.1,28,17,10,11,7,3,20,15.0,17,13,3,10,7,35,12,0,MF,35-39,Midfielder,Spain,Europe
2481,David Silva,ESP,Real Sociedad,La Liga,2021,35.0,1986.0,19.1,28,17,10,11,7,3,20,15.0,17,13,3,10,7,35,12,0,MF,35-39,Midfielder,Spain,Europe
2494,Unai Simón,ESP,Athletic Club,La Liga,2021,24.0,1997.0,34.0,0,0,0,0,0,0,0,,0,0,0,0,1,1,5,1,GK,20-24,Goalkeeper,Spain,Europe
2506,Antonio Sivera,ESP,Alavés,La Liga,2021,24.0,1996.0,3.1,0,0,0,0,0,0,1,0.0,1,0,0,0,0,0,0,0,GK,20-24,Goalkeeper,Spain,Europe
2520,Rubén Sobrino,ESP,Valencia,La Liga,2021,29.0,1992.0,0.2,1,1,1,0,0,1,1,100.0,0,1,0,1,2,3,0,0,MF,25-29,Midfielder,Spain,Europe
2521,Rubén Sobrino,ESP,Cádiz,La Liga,2021,29.0,1992.0,20.7,28,17,11,10,7,5,35,14.3,30,21,1,20,21,49,18,0,"FW,MF",25-29,Forward,Spain,Europe
2524,Roberto Soldado,ESP,Levante,La Liga,2021,36.0,1985.0,7.4,3,1,0,1,2,1,3,33.3,2,4,0,4,1,4,7,0,FW,35-39,Forward,Spain,Europe
2525,Carlos Soler,ESP,Valencia,La Liga,2021,24.0,1997.0,27.5,29,19,10,15,4,11,37,29.7,26,19,4,15,14,43,28,0,MF,20-24,Midfielder,Spain,Europe
2527,Son,ESP,Levante,La Liga,2021,27.0,1994.0,21.9,28,18,16,7,5,17,34,50.0,17,11,5,6,19,47,33,1,DF,25-29,Defender,Spain,Europe
2529,David Soria,ESP,Getafe,La Liga,2021,28.0,1993.0,37.9,1,0,1,0,0,1,2,50.0,1,0,0,0,0,1,22,2,GK,25-29,Goalkeeper,Spain,Europe
2531,Alberto Soro,ESP,Granada,La Liga,2021,22.0,1999.0,6.4,12,10,3,6,3,1,7,14.3,6,21,2,19,3,15,4,0,"MF,FW",20-24,Midfielder,Spain,Europe
2568,Petar Stojanović,SVN,Empoli,Serie A,2021,25.0,1995.0,30.4,96,63,55,32,9,59,114,51.8,55,39,13,26,27,123,65,1,DF,25-29,Defender,Slovenia,Europe
2571,Stefan Strandberg,NOR,Salernitana,Serie A,2021,31.0,1990.0,10.4,13,8,10,3,0,8,11,72.7,3,15,13,2,9,22,49,0,DF,30-34,Defender,Norway,Europe
2580,Denis Suárez,ESP,Celta Vigo,La Liga,2021,27.0,1994.0,31.3,61,29,20,33,8,25,82,30.5,57,32,4,28,16,77,11,0,MF,25-29,Midfielder,Spain,Europe
2582,Mario Suárez,ESP,Rayo Vallecano,La Liga,2021,34.0,1987.0,7.9,9,4,7,2,0,3,9,33.3,6,6,4,2,7,16,37,1,DF,30-34,Defender,Spain,Europe
2588,Suso,ESP,Sevilla,La Liga,2021,27.0,1993.0,4.3,4,3,1,3,0,3,13,23.1,10,4,0,4,0,4,0,0,FW,25-29,Forward,Spain,Europe
2599,Alexander Sørloth,NOR,Real Sociedad,La Liga,2021,25.0,1995.0,19.6,20,7,4,10,6,7,17,41.2,10,14,1,13,4,24,15,0,FW,25-29,Forward,Norway,Europe
2600,Tachi,ESP,Alavés,La Liga,2021,23.0,1997.0,2.7,6,3,3,3,0,5,7,71.4,2,4,3,1,1,7,9,0,DF,20-24,Defender,Spain,Europe
2625,Cristian Tello,ESP,Betis,La Liga,2021,29.0,1991.0,9.1,17,11,6,7,4,13,31,41.9,18,9,0,9,10,27,6,0,FW,25-29,Forward,Spain,Europe
2627,Marc Tenas,ESP,Alavés,La Liga,2021,20.0,2001.0,0.6,1,1,1,0,0,1,1,100.0,0,1,0,1,0,1,0,1,"FW,MF",20-24,Forward,Spain,Europe
2646,Morten Thorsby,NOR,Sampdoria,Serie A,2021,25.0,1996.0,32.7,46,26,15,23,8,28,56,50.0,28,37,12,25,25,71,39,0,MF,25-29,Midfielder,Norway,Europe
2657,David Timor,ESP,Getafe,La Liga,2021,31.0,1989.0,3.8,1,1,1,0,0,0,3,0.0,3,3,2,1,1,2,4,1,MF,30-34,Midfielder,Spain,Europe
2665,Raúl de Tomás,ESP,Espanyol,La Liga,2021,26.0,1994.0,32.4,15,11,6,7,2,6,17,35.3,11,12,3,9,6,21,42,1,FW,25-29,Forward,Spain,Europe
2676,Raúl Torrente,ESP,Granada,La Liga,2021,19.0,2001.0,14.2,31,21,18,11,2,16,29,55.2,13,14,9,5,12,43,69,0,DF,Under 20,Defender,Spain,Europe
2679,Óliver Torres,ESP,Sevilla,La Liga,2021,26.0,1994.0,11.2,22,12,8,7,7,8,25,32.0,17,10,1,9,6,28,4,0,"MF,FW",25-29,Midfielder,Spain,Europe
2680,Pau Torres,ESP,Villarreal,La Liga,2021,24.0,1997.0,31.7,32,19,23,7,2,18,25,72.0,7,32,23,9,19,51,105,2,DF,20-24,Defender,Spain,Europe
2681,Roberto Torres,ESP,Osasuna,La Liga,2021,32.0,1989.0,9.0,7,4,3,1,3,3,15,20.0,12,8,0,8,8,15,4,0,"MF,FW",30-34,Midfielder,Spain,Europe
2682,Lucas Torró,ESP,Osasuna,La Liga,2021,27.0,1994.0,30.3,71,40,25,38,8,29,57,50.9,28,32,11,21,47,118,55,0,MF,25-29,Midfielder,Spain,Europe
2690,Adama Traoré,ESP,Wolves,Premier League,2021,25.0,1996.0,11.9,8,3,6,0,2,3,7,42.9,4,4,1,3,2,10,1,0,"FW,MF",25-29,Forward,Spain,Europe
2690,Adama Traoré,ESP,Wolves,Premier League,2021,25.0,1996.0,11.9,8,3,6,0,2,3,7,42.9,4,4,1,3,2,10,1,0,"FW,MF",25-29,Forward,Spain,Europe
2690,Adama Traoré,ESP,Wolves,Premier League,2021,25.0,1996.0,11.9,8,3,6,0,2,3,7,42.9,4,4,1,3,2,10,1,0,"FW,MF",25-29,Forward,Spain,Europe
2690,Adama Traoré,ESP,Wolves,Premier League,2021,25.0,1996.0,11.9,8,3,6,0,2,3,7,42.9,4,4,1,3,2,10,1,0,"FW,MF",25-29,Forward,Spain,Europe
2690,Adama Traoré,ESP,Wolves,Premier League,2021,25.0,1996.0,11.9,8,3,6,0,2,3,7,42.9,4,4,1,3,2,10,1,0,"FW,MF",25-29,Forward,Spain,Europe
2690,Adama Traoré,ESP,Wolves,Premier League,2021,25.0,1996.0,11.9,8,3,6,0,2,3,7,42.9,4,4,1,3,2,10,1,0,"FW,MF",25-29,Forward,Spain,Europe
2690,Adama Traoré,ESP,Wolves,Premier League,2021,25.0,1996.0,11.9,8,3,6,0,2,3,7,42.9,4,4,1,3,2,10,1,0,"FW,MF",25-29,Forward,Spain,Europe
2690,Adama Traoré,ESP,Wolves,Premier League,2021,25.0,1996.0,11.9,8,3,6,0,2,3,7,42.9,4,4,1,3,2,10,1,0,"FW,MF",25-29,Forward,Spain,Europe
2690,Adama Traoré,ESP,Wolves,Premier League,2021,25.0,1996.0,11.9,8,3,6,0,2,3,7,42.9,4,4,1,3,2,10,1,0,"FW,MF",25-29,Forward,Spain,Europe
2690,Adama Traoré,ESP,Wolves,Premier League,2021,25.0,1996.0,11.9,8,3,6,0,2,3,7,42.9,4,4,1,3,2,10,1,0,"FW,MF",25-29,Forward,Spain,Europe
2690,Adama Traoré,ESP,Wolves,Premier League,2021,25.0,1996.0,11.9,8,3,6,0,2,3,7,42.9,4,4,1,3,2,10,1,0,"FW,MF",25-29,Forward,Spain,Europe
2690,Adama Traoré,ESP,Wolves,Premier League,2021,25.0,1996.0,11.9,8,3,6,0,2,3,7,42.9,4,4,1,3,2,10,1,0,"FW,MF",25-29,Forward,Spain,Europe
2690,Adama Traoré,ESP,Wolves,Premier League,2021,25.0,1996.0,11.9,8,3,6,0,2,3,7,42.9,4,4,1,3,2,10,1,0,"FW,MF",25-29,Forward,Spain,Europe
2690,Adama Traoré,ESP,Wolves,Premier League,2021,25.0,1996.0,11.9,8,3,6,0,2,3,7,42.9,4,4,1,3,2,10,1,0,"FW,MF",25-29,Forward,Spain,Europe
2690,Adama Traoré,ESP,Wolves,Premier League,2021,25.0,1996.0,11.9,8,3,6,0,2,3,7,42.9,4,4,1,3,2,10,1,0,"FW,MF",25-29,Forward,Spain,Europe
2690,Adama Traoré,ESP,Wolves,Premier League,2021,25.0,1996.0,11.9,8,3,6,0,2,3,7,42.9,4,4,1,3,2,10,1,0,"FW,MF",25-29,Forward,Spain,Europe
2691,Adama Traoré,ESP,Barcelona,La Liga,2021,25.0,1996.0,4.2,4,2,0,3,1,3,5,60.0,2,2,0,2,4,8,3,1,FW,25-29,Forward,Spain,Europe
2691,Adama Traoré,ESP,Barcelona,La Liga,2021,25.0,1996.0,4.2,4,2,0,3,1,3,5,60.0,2,2,0,2,4,8,3,1,FW,25-29,Forward,Spain,Europe
2691,Adama Traoré,ESP,Barcelona,La Liga,2021,25.0,1996.0,4.2,4,2,0,3,1,3,5,60.0,2,2,0,2,4,8,3,1,FW,25-29,Forward,Spain,Europe
2691,Adama Traoré,ESP,Barcelona,La Liga,2021,25.0,1996.0,4.2,4,2,0,3,1,3,5,60.0,2,2,0,2,4,8,3,1,FW,25-29,Forward,Spain,Europe
2691,Adama Traoré,ESP,Barcelona,La Liga,2021,25.0,1996.0,4.2,4,2,0,3,1,3,5,60.0,2,2,0,2,4,8,3,1,FW,25-29,Forward,Spain,Europe
2691,Adama Traoré,ESP,Barcelona,La Liga,2021,25.0,1996.0,4.2,4,2,0,3,1,3,5,60.0,2,2,0,2,4,8,3,1,FW,25-29,Forward,Spain,Europe
2691,Adama Traoré,ESP,Barcelona,La Liga,2021,25.0,1996.0,4.2,4,2,0,3,1,3,5,60.0,2,2,0,2,4,8,3,1,FW,25-29,Forward,Spain,Europe
2691,Adama Traoré,ESP,Barcelona,La Liga,2021,25.0,1996.0,4.2,4,2,0,3,1,3,5,60.0,2,2,0,2,4,8,3,1,FW,25-29,Forward,Spain,Europe
2691,Adama Traoré,ESP,Barcelona,La Liga,2021,25.0,1996.0,4.2,4,2,0,3,1,3,5,60.0,2,2,0,2,4,8,3,1,FW,25-29,Forward,Spain,Europe
2691,Adama Traoré,ESP,Barcelona,La Liga,2021,25.0,1996.0,4.2,4,2,0,3,1,3,5,60.0,2,2,0,2,4,8,3,1,FW,25-29,Forward,Spain,Europe
2691,Adama Traoré,ESP,Barcelona,La Liga,2021,25.0,1996.0,4.2,4,2,0,3,1,3,5,60.0,2,2,0,2,4,8,3,1,FW,25-29,Forward,Spain,Europe
2691,Adama Traoré,ESP,Barcelona,La Liga,2021,25.0,1996.0,4.2,4,2,0,3,1,3,5,60.0,2,2,0,2,4,8,3,1,FW,25-29,Forward,Spain,Europe
2691,Adama Traoré,ESP,Barcelona,La Liga,2021,25.0,1996.0,4.2,4,2,0,3,1,3,5,60.0,2,2,0,2,4,8,3,1,FW,25-29,Forward,Spain,Europe
2691,Adama Traoré,ESP,Barcelona,La Liga,2021,25.0,1996.0,4.2,4,2,0,3,1,3,5,60.0,2,2,0,2,4,8,3,1,FW,25-29,Forward,Spain,Europe
2691,Adama Traoré,ESP,Barcelona,La Liga,2021,25.0,1996.0,4.2,4,2,0,3,1,3,5,60.0,2,2,0,2,4,8,3,1,FW,25-29,Forward,Spain,Europe
2691,Adama Traoré,ESP,Barcelona,La Liga,2021,25.0,1996.0,4.2,4,2,0,3,1,3,5,60.0,2,2,0,2,4,8,3,1,FW,25-29,Forward,Spain,Europe
2702,Manu Trigueros,ESP,Villarreal,La Liga,2021,29.0,1991.0,24.2,45,25,16,18,11,23,66,34.8,43,19,3,16,13,58,17,0,"MF,FW",25-29,Midfielder,Spain,Europe
2716,Beñat Turrientes,ESP,Real Sociedad,La Liga,2021,19.0,2002.0,2.3,0,0,0,0,0,0,4,0.0,4,1,0,1,2,2,2,0,MF,Under 20,Midfielder,Spain,Europe
2732,Kacper Urbanski,POL,Bologna,Serie A,2021,16.0,2004.0,0.5,3,2,1,2,0,2,2,100.0,0,2,0,2,0,3,0,0,MF,Under 20,Midfielder,Poland,Europe
2737,Álvaro Vadillo,ESP,Espanyol,La Liga,2021,26.0,1994.0,0.1,1,1,1,0,0,1,2,50.0,1,0,0,0,0,1,1,0,"DF,MF",25-29,Defender,Spain,Europe
2738,Óscar Valentín,ESP,Rayo Vallecano,La Liga,2021,26.0,1994.0,28.5,102,53,46,51,5,44,105,41.9,61,56,10,46,39,141,43,0,MF,25-29,Midfielder,Spain,Europe
2739,Germán Valera,ESP,Real Sociedad,La Liga,2021,19.0,2002.0,0.6,3,2,3,0,0,1,1,100.0,0,0,0,0,0,3,1,0,FW,Under 20,Forward,Spain,Europe
2742,Jesús Vallejo,ESP,Real Madrid,La Liga,2021,24.0,1997.0,3.8,7,5,7,0,0,5,6,83.3,1,9,8,1,6,13,16,0,DF,20-24,Defender,Spain,Europe
2743,Manu Vallejo,ESP,Alavés,La Liga,2021,24.0,1997.0,4.1,8,2,1,4,3,4,13,30.8,9,7,0,7,0,8,4,0,"MF,FW",20-24,Midfielder,Spain,Europe
2744,Manu Vallejo,ESP,Valencia,La Liga,2021,24.0,1997.0,1.1,2,1,1,1,0,0,1,0.0,1,0,0,0,0,2,1,0,"FW,MF",20-24,Forward,Spain,Europe
2758,Kevin Vázquez,ESP,Celta Vigo,La Liga,2021,28.0,1993.0,14.8,34,24,12,13,9,14,28,50.0,14,20,7,13,36,70,34,0,DF,25-29,Defender,Spain,Europe
2759,Lucas Vázquez,ESP,Real Madrid,La Liga,2021,30.0,1991.0,20.4,43,22,24,9,10,17,35,48.6,18,25,7,18,20,63,41,1,DF,30-34,Defender,Spain,Europe
2770,Gonzalo Verdú,ESP,Elche,La Liga,2021,32.0,1988.0,15.5,19,9,15,4,0,8,16,50.0,8,20,14,6,13,32,59,1,DF,30-34,Defender,Spain,Europe
2778,Mikel Vesga,ESP,Athletic Club,La Liga,2021,28.0,1993.0,15.1,27,14,7,18,2,11,31,35.5,20,16,5,11,20,47,34,2,MF,25-29,Midfielder,Spain,Europe
2782,Aleix Vidal,ESP,Espanyol,La Liga,2021,31.0,1989.0,21.1,31,25,17,9,5,19,39,48.7,20,19,6,13,25,56,35,2,"DF,MF",30-34,Defender,Spain,Europe
2784,Nacho Vidal,ESP,Osasuna,La Liga,2021,26.0,1995.0,32.2,83,47,49,25,9,39,77,50.6,38,32,14,18,58,141,79,0,DF,25-29,Defender,Spain,Europe
2790,Dídac Vilà,ESP,Espanyol,La Liga,2021,32.0,1989.0,2.3,7,5,2,5,0,4,9,44.4,5,2,1,1,3,10,8,0,"DF,MF",30-34,Defender,Spain,Europe
2793,Asier Villalibre,ESP,Athletic Club,La Liga,2021,23.0,1997.0,6.1,4,3,2,1,1,1,2,50.0,1,3,1,2,1,5,7,0,FW,20-24,Forward,Spain,Europe
2794,Gonzalo Villar,ESP,Getafe,La Liga,2021,23.0,1998.0,3.3,5,3,4,1,0,2,5,40.0,3,4,1,3,1,6,1,0,MF,20-24,Midfielder,Spain,Europe
2798,Vitolo,ESP,Getafe,La Liga,2021,31.0,1989.0,2.5,3,2,1,1,1,2,5,40.0,3,3,0,3,1,4,1,0,MF,30-34,Midfielder,Spain,Europe
2798,Vitolo,ESP,Getafe,La Liga,2021,31.0,1989.0,2.5,3,2,1,1,1,2,5,40.0,3,3,0,3,1,4,1,0,MF,30-34,Midfielder,Spain,Europe
2798,Vitolo,ESP,Getafe,La Liga,2021,31.0,1989.0,2.5,3,2,1,1,1,2,5,40.0,3,3,0,3,1,4,1,0,MF,30-34,Midfielder,Spain,Europe
2798,Vitolo,ESP,Getafe,La Liga,2021,31.0,1989.0,2.5,3,2,1,1,1,2,5,40.0,3,3,0,3,1,4,1,0,MF,30-34,Midfielder,Spain,Europe
2800,Dušan Vlahović,SRB,Fiorentina,Serie A,2021,21.0,2000.0,20.6,5,0,0,2,3,2,11,18.2,9,6,2,4,1,6,16,0,FW,20-24,Forward,Serbia,Europe
2801,Dušan Vlahović,SRB,Juventus,Serie A,2021,21.0,2000.0,12.0,0,0,0,0,0,0,4,0.0,4,3,0,3,0,0,7,0,FW,20-24,Forward,Serbia,Europe
2819,Sebastian Walukiewicz,POL,Cagliari,Serie A,2021,21.0,2000.0,3.4,9,5,7,2,0,3,5,60.0,2,5,2,3,7,16,14,0,DF,20-24,Defender,Poland,Europe
2844,Nico Williams,ESP,Athletic Club,La Liga,2021,19.0,2002.0,14.9,20,10,6,11,3,10,31,32.3,21,18,2,16,5,25,9,0,MF,Under 20,Midfielder,Spain,Europe
2870,Gerard Yepes,ESP,Sampdoria,Serie A,2021,18.0,2002.0,0.2,1,0,0,1,0,1,1,100.0,0,1,0,1,0,1,0,0,"MF,DF",Under 20,Midfielder,Spain,Europe
2886,Nicola Zalewski,POL,Roma,Serie A,2021,19.0,2002.0,8.8,32,19,17,11,4,21,35,60.0,14,18,1,17,16,48,4,0,DF,Under 20,Defender,Poland,Europe
2894,Oier Zarraga,ESP,Athletic Club,La Liga,2021,22.0,1999.0,13.0,13,5,4,7,2,3,28,10.7,25,17,10,7,19,32,10,0,MF,20-24,Midfielder,Spain,Europe
2905,Piotr Zieliński,POL,Napoli,Serie A,2021,27.0,1994.0,23.2,19,12,5,9,5,6,21,28.6,15,13,2,11,8,27,4,0,MF,25-29,Midfielder,Poland,Europe
2906,David Zima,CZE,Torino,Serie A,2021,20.0,2000.0,14.6,20,12,8,11,1,9,20,45.0,11,15,13,2,23,43,42,0,DF,20-24,Defender,Czech Republic,Europe
2916,Igor Zubeldia,ESP,Real Sociedad,La Liga,2021,24.0,1997.0,18.3,20,10,12,8,0,12,18,66.7,6,16,6,10,27,47,53,0,DF,20-24,Defender,Spain,Europe
2917,Martín Zubimendi,ESP,Real Sociedad,La Liga,2021,22.0,1999.0,28.8,52,25,19,30,3,22,44,50.0,22,30,13,17,49,101,48,1,MF,20-24,Midfielder,Spain,Europe
2918,Szymon Żurkowski,POL,Empoli,Serie A,2021,23.0,1997.0,25.6,58,33,24,21,13,29,68,42.6,39,43,10,33,35,93,32,1,MF,20-24,Midfielder,Poland,Europe
2919,Martin Ødegaard,NOR,Arsenal,Premier League,2021,22.0,1998.0,30.9,49,21,6,24,19,22,61,36.1,39,18,1,17,11,60,11,1,"MF,FW",20-24,Midfielder,Norway,Europe
2221,Beñat Turrientes,ESP,Real Sociedad,La Liga,2024,22.0,2002.0,6.2,11,3,4,6,1,3,7,42.9,4,12,2,10,4,15,6,0,MF,20-24,Midfielder,Spain,Europe
2233,Kacper Urbanski,POL,Bologna,Serie A,2024,20.0,2004.0,2.7,5,2,4,0,1,4,6,66.7,2,5,1,4,2,7,5,0,MF,20-24,Midfielder,Poland,Europe
2237,Óscar Valentín,ESP,Rayo Vallecano,La Liga,2024,30.0,1994.0,13.2,36,28,14,14,8,20,40,50.0,20,23,3,20,18,54,38,0,MF,30-34,Midfielder,Spain,Europe
2241,Jesús Vallejo,ESP,Real Madrid,La Liga,2024,27.0,1997.0,0.1,0,0,0,0,0,0,0,,0,0,0,0,0,0,2,0,DF,25-29,Defender,Spain,Europe
2257,Lucas Vázquez,ESP,Real Madrid,La Liga,2024,33.0,1991.0,9.8,27,16,17,7,3,12,25,48.0,13,6,1,5,4,31,13,0,DF,30-34,Defender,Spain,Europe
2270,Mikel Vesga,ESP,Athletic Club,La Liga,2024,31.0,1993.0,4.4,9,5,2,7,0,4,12,33.3,8,6,0,6,7,16,6,0,MF,30-34,Midfielder,Spain,Europe
2274,Carlos Vicente,ESP,Alavés,La Liga,2024,25.0,1999.0,16.7,17,12,11,3,3,10,17,58.8,7,12,1,11,5,22,15,0,"FW,MF",25-29,Forward,Spain,Europe
2276,Nacho Vidal,ESP,Osasuna,La Liga,2024,29.0,1995.0,1.4,2,0,0,1,1,1,4,25.0,3,1,0,1,0,2,6,0,DF,25-29,Defender,Spain,Europe
2278,Fran Vieites,ESP,Betis,La Liga,2024,25.0,1999.0,3.0,0,0,0,0,0,0,0,,0,0,0,0,0,0,1,0,GK,25-29,Goalkeeper,Spain,Europe
2280,Asier Villalibre,ESP,Alavés,La Liga,2024,27.0,1997.0,2.4,0,0,0,0,0,0,0,,0,1,0,1,1,1,4,0,FW,25-29,Forward,Spain,Europe
2281,Iván Villar,ESP,Celta Vigo,La Liga,2024,27.0,1997.0,4.0,0,0,0,0,0,0,0,,0,0,0,0,0,0,3,0,GK,25-29,Goalkeeper,Spain,Europe
2289,Dušan Vlahović,SRB,Juventus,Serie A,2024,24.0,2000.0,13.8,2,1,0,1,1,1,2,50.0,1,5,3,2,1,3,8,1,FW,20-24,Forward,Serbia,Europe
2305,Sebastian Walukiewicz,POL,Torino,Serie A,2024,24.0,2000.0,10.1,15,8,8,5,2,10,15,66.7,5,13,3,10,13,28,33,0,DF,20-24,Defender,Poland,Europe
2306,Sebastian Walukiewicz,POL,Empoli,Serie A,2024,24.0,2000.0,2.0,1,0,1,0,0,0,1,0.0,1,3,3,0,1,2,15,0,DF,20-24,Defender,Poland,Europe
2331,Nico Williams,ESP,Athletic Club,La Liga,2024,22.0,2002.0,13.8,23,14,8,9,6,8,21,38.1,13,11,0,11,5,28,5,0,FW,20-24,Forward,Spain,Europe
2351,Lamine Yamal,ESP,Barcelona,La Liga,2024,17.0,2007.0,14.2,22,16,2,10,10,6,13,46.2,7,7,0,7,9,31,3,0,FW,Under 20,Forward,Spain,Europe
2367,Miha Zajc,SVN,Toulouse,Ligue 1,2024,30.0,1994.0,1.5,1,1,0,0,1,1,2,50.0,1,0,0,0,2,3,3,0,MF,30-34,Midfielder,Slovenia,Europe
52,Josué Albert,GUF,Clermont Foot,Ligue 1,2021,29.0,1992.0,0.2,0,0,0,0,0,0,0,,0,0,0,0,1,1,2,0,DF,25-29,Defender,France,Europe
294,Valon Berisha,KVX,Reims,Ligue 1,2021,28.0,1993.0,5.1,10,7,2,5,3,2,10,20.0,8,9,0,9,4,14,3,0,"MF,FW",25-29,Midfielder,Sweden,Europe
652,Grégoire Defrel,MTQ,Sassuolo,Serie A,2021,30.0,1991.0,15.1,15,9,4,8,3,6,16,37.5,10,11,1,10,4,19,11,0,FW,30-34,Forward,France,Europe
1343,Atakan Karazor,Türkiye,Stuttgart,Bundesliga,2021,24.0,1996.0,21.1,48,24,18,27,3,18,36,50.0,18,37,14,23,34,82,47,0,MF,20-24,Midfielder,Germany,Europe
2364,Yoann Salmier,GUF,Troyes,Ligue 1,2021,28.0,1992.0,29.6,58,33,44,11,3,26,34,76.5,8,30,14,16,40,98,94,0,DF,25-29,Defender,France,Europe
2749,Jonathan Varane,MTQ,Lens,Ligue 1,2021,19.0,2001.0,0.0,0,0,0,0,0,0,0,,0,0,0,0,0,0,0,0,MF,Under 20,Midfielder,France,Europe
2805,Mërgim Vojvoda,KVX,Torino,Serie A,2021,26.0,1995.0,22.0,38,23,23,11,4,20,36,55.6,16,27,8,19,20,58,51,0,DF,25-29,Defender,Germany,Europe
2903,Edon Zhegrova,KVX,Lille,Ligue 1,2021,22.0,1999.0,5.3,14,5,2,8,4,5,6,83.3,1,4,1,3,2,16,2,0,"MF,FW",20-24,Midfielder,Germany,Europe
