rk,player,nation,squad,comp,season,age,born,ninety_mins_played,tackles,tackles_won,def_third_tackles,mid_third_tackles,att_third_tackles,dribblers_tackled,dribblers_challenged,tackle_pct,challenges_lost,blocks,shots_blocked,passes_blocked,interceptions,tackles_interceptions,clearances,errors,position,age_range,general_position,country,continent
1,Ismael Aaneba,FRA,Strasbourg,Ligue 1,2020,21.0,1999.0,0.1,0,0,0,0,0,0,0,,0,0,0,0,1,1,1,0,DF,20-24,Defender,France,Europe
2,Patrick van Aanholt,NED,Crystal Palace,Premier League,2020,29.0,1990.0,19.7,35,22,18,17,0,19,43,44.2,24,18,6,12,30,65,40,2,DF,25-29,Defender,Netherlands,Europe
3,Yunis Abdelhamid,MAR,Reims,Ligue 1,2020,32.0,1987.0,32.1,59,37,36,23,0,26,42,61.9,16,34,15,19,61,120,132,0,DF,30-34,Defender,Morocco,Africa
4,Sabit Abdulai,GHA,Getafe,La Liga,2020,21.0,1999.0,0.7,2,0,1,1,0,1,3,33.3,2,0,0,0,0,2,0,0,MF,20-24,Midfielder,Ghana,Africa
5,Mehdi Abeid,ALG,Nantes,Ligue 1,2020,27.0,1992.0,14.7,34,19,16,14,4,15,30,50.0,15,9,2,7,20,54,10,0,MF,25-29,Midfielder,Algeria,Africa
6,Laurent Abergel,FRA,Lorient,Ligue 1,2020,27.0,1993.0,32.9,145,84,64,69,12,54,162,33.3,108,64,6,58,46,191,12,0,MF,25-29,Midfielder,France,Europe
7,Charles Abi,FRA,Saint-Étienne,Ligue 1,2020,20.0,2000.0,10.1,8,2,5,0,3,3,12,25.0,9,6,2,4,4,12,5,0,"FW,MF",20-24,Forward,France,Europe
8,Matthis Abline,FRA,Rennes,Ligue 1,2020,17.0,2003.0,0.0,0,0,0,0,0,0,0,,0,0,0,0,0,0,0,0,FW,Under 20,Forward,France,Europe
9,Pape Abou Cissé,SEN,Saint-Étienne,Ligue 1,2020,24.0,1995.0,14.0,15,13,10,5,0,6,10,60.0,4,7,4,3,27,42,87,0,DF,20-24,Defender,Senegal,Africa
10,David Abraham,ARG,Eint Frankfurt,Bundesliga,2020,34.0,1986.0,13.6,18,12,13,3,2,11,17,64.7,6,13,4,9,17,35,34,0,DF,30-34,Defender,Argentina,South America
11,Tammy Abraham,ENG,Chelsea,Premier League,2020,22.0,1997.0,11.6,7,5,3,3,1,1,7,14.3,6,6,0,6,5,12,17,0,FW,20-24,Forward,England,Europe
12,Amir Abrashi,ALB,Freiburg,Bundesliga,2020,30.0,1990.0,0.7,1,1,1,0,0,0,0,,0,1,1,0,2,3,1,0,"MF,DF",30-34,Midfielder,Albania,Europe
13,Gennaro Acampora,ITA,Spezia,Serie A,2020,26.0,1994.0,4.9,6,4,1,4,1,2,7,28.6,5,4,1,3,4,10,4,0,"MF,FW",25-29,Midfielder,Italy,Europe
14,Francesco Acerbi,ITA,Lazio,Serie A,2020,32.0,1988.0,31.3,51,32,34,13,4,18,40,45.0,22,24,15,9,76,127,121,2,DF,30-34,Defender,Italy,Europe
15,Ragnar Ache,GER,Eint Frankfurt,Bundesliga,2020,22.0,1998.0,1.1,2,0,0,1,1,0,0,,0,1,0,1,1,3,1,0,"FW,DF",20-24,Forward,Germany,Europe
16,Marcos Acuña,ARG,Sevilla,La Liga,2020,28.0,1991.0,25.9,62,42,34,20,8,23,41,56.1,18,23,2,21,23,85,30,1,DF,25-29,Defender,Argentina,South America
17,Che Adams,SCO,Southampton,Premier League,2020,24.0,1996.0,29.6,25,16,4,15,6,6,17,35.3,11,20,2,18,4,29,19,1,FW,20-24,Forward,Scotland,Europe
18,Tyler Adams,USA,RB Leipzig,Bundesliga,2020,21.0,1999.0,20.6,35,24,12,15,8,17,31,54.8,14,22,5,17,29,64,30,0,"MF,DF",20-24,Midfielder,United States,North America
19,Sargis Adamyan,ARM,Hoffenheim,Bundesliga,2020,27.0,1993.0,5.3,9,4,4,3,2,7,14,50.0,7,2,0,2,6,15,1,0,"FW,MF",25-29,Forward,Armenia,Asia
20,Tosin Adarabioyo,ENG,Fulham,Premier League,2020,22.0,1997.0,32.8,37,19,30,6,1,19,40,47.5,21,26,20,6,42,79,197,2,DF,20-24,Defender,England,Europe
21,Bobby Adekanye,NED,Cádiz,La Liga,2020,21.0,1999.0,0.4,0,0,0,0,0,0,1,0.0,1,0,0,0,0,0,1,0,"FW,MF",20-24,Forward,Netherlands,Europe
22,Yacine Adli,FRA,Bordeaux,Ligue 1,2020,20.0,2000.0,26.9,74,37,30,33,11,35,92,38.0,57,27,2,25,39,113,17,2,MF,20-24,Midfielder,France,Europe
23,Andrea Adorante,ITA,Parma,Serie A,2020,20.0,2000.0,0.1,0,0,0,0,0,0,0,,0,0,0,0,0,0,0,0,FW,20-24,Forward,Italy,Europe
26,Lucien Agoume,FRA,Spezia,Serie A,2020,18.0,2002.0,8.9,18,10,11,7,0,6,19,31.6,13,10,5,5,15,33,10,0,MF,Under 20,Midfielder,France,Europe
27,Felix Agu,GER,Werder Bremen,Bundesliga,2020,20.0,1999.0,7.8,20,9,10,9,1,10,18,55.6,8,14,3,11,12,32,18,0,DF,20-24,Defender,Germany,Europe
28,Kevin Agudelo,COL,Spezia,Serie A,2020,21.0,1998.0,15.1,39,28,9,15,15,12,34,35.3,22,30,0,30,10,49,2,0,FW,20-24,Forward,Colombia,South America
29,Nayef Aguerd,MAR,Rennes,Ligue 1,2020,24.0,1996.0,35.0,37,30,28,9,0,21,33,63.6,12,34,22,12,47,84,102,0,DF,20-24,Defender,Morocco,Africa
30,Sergio Agüero,ARG,Manchester City,Premier League,2020,32.0,1988.0,6.2,4,1,0,2,2,2,11,18.2,9,2,0,2,2,6,0,0,FW,30-34,Forward,Argentina,South America
31,Ruben Aguilar,FRA,Monaco,Ligue 1,2020,27.0,1993.0,24.7,63,37,32,21,10,32,52,61.5,20,30,3,27,47,110,43,1,"DF,MF",25-29,Defender,France,Europe
32,Naouirou Ahamada,FRA,Stuttgart,Bundesliga,2020,18.0,2002.0,2.8,4,1,3,1,0,1,1,100.0,0,2,0,2,1,5,1,0,MF,Under 20,Midfielder,France,Europe
33,Matteo Ahlinvi,BEN,Nîmes,Ligue 1,2020,21.0,1999.0,10.0,26,20,10,14,2,11,39,28.2,28,6,0,6,2,28,8,0,MF,20-24,Midfielder,Benin,Africa
34,Jean-Eudes Aholou,CIV,Strasbourg,Ligue 1,2020,26.0,1994.0,23.8,46,25,18,25,3,19,48,39.6,29,17,5,12,53,99,32,0,MF,25-29,Midfielder,Ivory Coast,Africa
35,Jean-Eudes Aholou,CIV,Monaco,Ligue 1,2020,26.0,1994.0,0.4,1,0,0,1,0,1,3,33.3,2,0,0,0,1,2,1,0,MF,25-29,Midfielder,Ivory Coast,Africa
36,Joseph Aidoo,GHA,Celta Vigo,La Liga,2020,24.0,1995.0,14.3,26,17,17,9,0,12,21,57.1,9,7,4,3,25,51,88,1,DF,20-24,Defender,Ghana,Africa
37,Ola Aina,NGA,Fulham,Premier League,2020,23.0,1996.0,29.6,37,20,22,7,8,21,43,48.8,22,22,6,16,45,82,94,2,DF,20-24,Defender,Nigeria,Africa
38,Rayan Aït-Nouri,ALG,Wolves,Premier League,2020,19.0,2001.0,15.6,29,16,18,10,1,13,27,48.1,14,14,1,13,15,44,25,0,DF,Under 20,Defender,Algeria,Africa
39,Rayan Aït-Nouri,ALG,Angers,Ligue 1,2020,19.0,2001.0,2.1,3,2,1,2,0,3,5,60.0,2,2,1,1,4,7,1,0,DF,Under 20,Defender,Algeria,Africa
40,Semi Ajayi,NGA,West Brom,Premier League,2020,26.0,1993.0,30.9,40,14,34,6,0,23,41,56.1,18,51,32,19,42,82,122,2,DF,25-29,Defender,Nigeria,Africa
41,Ludovic Ajorque,FRA,Strasbourg,Ligue 1,2020,26.0,1994.0,33.0,30,18,6,18,6,7,31,22.6,24,14,5,9,11,41,54,0,FW,25-29,Forward,France,Europe
42,Manuel Akanji,SUI,Dortmund,Bundesliga,2020,25.0,1995.0,26.1,41,22,23,12,6,19,31,61.3,12,23,10,13,49,90,70,1,DF,25-29,Defender,Switzerland,Europe
43,Carlos Akapo,EQG,Cádiz,La Liga,2020,27.0,1993.0,9.6,18,14,14,4,0,10,18,55.6,8,16,3,13,19,37,33,0,DF,25-29,Defender,Equatorial Guinea,Africa
44,Marley Aké,FRA,Marseille,Ligue 1,2020,19.0,2001.0,1.6,3,3,1,0,2,0,1,0.0,1,2,0,2,0,3,1,0,FW,Under 20,Forward,France,Europe
45,Nathan Aké,NED,Manchester City,Premier League,2020,25.0,1995.0,8.9,10,5,3,6,1,3,4,75.0,1,2,1,1,9,19,23,0,DF,25-29,Defender,Netherlands,Europe
46,Paul Akouokou,CIV,Betis,La Liga,2020,22.0,1997.0,4.2,11,8,2,8,1,5,8,62.5,3,3,1,2,6,17,7,0,MF,20-24,Midfielder,Ivory Coast,Africa
47,Jean-Daniel Akpa-Akpro,CIV,Lazio,Serie A,2020,27.0,1992.0,11.7,38,25,13,22,3,8,27,29.6,19,24,6,18,18,56,13,0,MF,25-29,Midfielder,Ivory Coast,Africa
48,Kevin Akpoguma,NGA,Hoffenheim,Bundesliga,2020,25.0,1995.0,13.2,18,12,11,6,1,8,14,57.1,6,28,15,13,13,31,32,2,DF,25-29,Defender,Nigeria,Africa
49,David Alaba,AUT,Bayern Munich,Bundesliga,2020,28.0,1992.0,29.7,37,21,14,19,4,17,32,53.1,15,29,13,16,43,80,60,0,"DF,MF",25-29,Defender,Austria,Europe
50,Sofiane Alakouch,MAR,Nîmes,Ligue 1,2020,22.0,1998.0,16.7,53,33,30,16,7,29,45,64.4,16,17,2,15,21,74,38,0,DF,20-24,Defender,Morocco,Africa
52,Lucas Alario,ARG,Leverkusen,Bundesliga,2020,27.0,1992.0,13.8,8,2,2,5,1,2,4,50.0,2,9,1,8,2,10,10,0,FW,25-29,Forward,Argentina,South America
56,Marc Albrighton,ENG,Leicester City,Premier League,2020,30.0,1989.0,19.4,33,19,14,15,4,16,45,35.6,29,29,3,26,17,50,27,1,"DF,FW",30-34,Defender,England,Europe
61,Omar Alderete,PAR,Hertha BSC,Bundesliga,2020,23.0,1996.0,14.4,16,10,11,5,0,7,16,43.8,9,14,10,4,21,37,61,1,DF,20-24,Defender,Paraguay,South America
62,Toby Alderweireld,BEL,Tottenham,Premier League,2020,31.0,1989.0,24.9,35,22,22,11,2,18,30,60.0,12,40,28,12,10,45,121,0,DF,30-34,Defender,Belgium,Europe
66,Rúnar Alex Rúnarsson,ISL,Arsenal,Premier League,2020,25.0,1995.0,0.2,0,0,0,0,0,0,0,,0,0,0,0,0,0,0,0,GK,25-29,Goalkeeper,Iceland,Europe
67,Trent Alexander-Arnold,ENG,Liverpool,Premier League,2020,21.0,1998.0,33.7,56,33,31,18,7,36,56,64.3,20,24,3,21,49,105,50,3,DF,20-24,Defender,England,Europe
69,Mohamed Ali Cho,FRA,Angers,Ligue 1,2020,16.0,2004.0,3.9,9,7,2,6,1,4,9,44.4,5,4,0,4,3,12,0,0,"FW,MF",Under 20,Forward,France,Europe
70,Ezgjan Alioski,MKD,Leeds United,Premier League,2020,28.0,1992.0,27.3,74,31,38,28,8,32,74,43.2,42,17,2,15,23,97,50,2,"DF,MF",25-29,Defender,North Macedonia,Europe
71,Rachid Alioui,MAR,Angers,Ligue 1,2020,28.0,1992.0,0.2,0,0,0,0,0,0,1,0.0,1,0,0,0,0,0,0,0,FW,25-29,Forward,Morocco,Africa
72,Alisson,BRA,Liverpool,Premier League,2020,27.0,1992.0,33.0,3,2,3,0,0,3,4,75.0,1,0,0,0,2,5,26,7,GK,25-29,Goalkeeper,Brazil,South America
72,Alisson,BRA,Liverpool,Premier League,2020,27.0,1992.0,33.0,3,2,3,0,0,3,4,75.0,1,0,0,0,2,5,26,7,GK,25-29,Goalkeeper,Brazil,South America
72,Alisson,BRA,Liverpool,Premier League,2020,27.0,1992.0,33.0,3,2,3,0,0,3,4,75.0,1,0,0,0,2,5,26,7,GK,25-29,Goalkeeper,Brazil,South America
72,Alisson,BRA,Liverpool,Premier League,2020,27.0,1992.0,33.0,3,2,3,0,0,3,4,75.0,1,0,0,0,2,5,26,7,GK,25-29,Goalkeeper,Brazil,South America
73,Saturnin Allagbé,BEN,Dijon,Ligue 1,2020,26.0,1993.0,12.0,0,0,0,0,0,0,1,0.0,1,0,0,0,0,0,9,3,GK,25-29,Goalkeeper,Benin,Africa
74,Allan,BRA,Everton,Premier League,2020,29.0,1991.0,22.8,80,45,39,37,4,28,95,29.5,67,31,12,19,19,99,25,1,MF,25-29,Midfielder,Brazil,South America
74,Allan,BRA,Everton,Premier League,2020,29.0,1991.0,22.8,80,45,39,37,4,28,95,29.5,67,31,12,19,19,99,25,1,MF,25-29,Midfielder,Brazil,South America
74,Allan,BRA,Everton,Premier League,2020,29.0,1991.0,22.8,80,45,39,37,4,28,95,29.5,67,31,12,19,19,99,25,1,MF,25-29,Midfielder,Brazil,South America
74,Allan,BRA,Everton,Premier League,2020,29.0,1991.0,22.8,80,45,39,37,4,28,95,29.5,67,31,12,19,19,99,25,1,MF,25-29,Midfielder,Brazil,South America
75,Dele Alli,ENG,Tottenham,Premier League,2020,24.0,1996.0,6.9,18,11,8,6,4,7,19,36.8,12,9,0,9,7,25,3,0,MF,20-24,Midfielder,England,Europe
76,Miguel Almirón,PAR,Newcastle Utd,Premier League,2020,26.0,1994.0,27.0,49,29,21,25,3,14,56,25.0,42,23,4,19,25,74,20,1,"MF,FW",25-29,Midfielder,Paraguay,South America
80,Bruno Alves,POR,Parma,Serie A,2020,38.0,1981.0,18.1,13,10,10,3,0,7,9,77.8,2,17,12,5,26,39,81,0,DF,35-39,Defender,Portugal,Europe
80,Bruno Alves,POR,Parma,Serie A,2020,38.0,1981.0,18.1,13,10,10,3,0,7,9,77.8,2,17,12,5,26,39,81,0,DF,35-39,Defender,Portugal,Europe
80,Bruno Alves,POR,Parma,Serie A,2020,38.0,1981.0,18.1,13,10,10,3,0,7,9,77.8,2,17,12,5,26,39,81,0,DF,35-39,Defender,Portugal,Europe
80,Bruno Alves,POR,Parma,Serie A,2020,38.0,1981.0,18.1,13,10,10,3,0,7,9,77.8,2,17,12,5,26,39,81,0,DF,35-39,Defender,Portugal,Europe
81,Steven Alzate,COL,Brighton,Premier League,2020,21.0,1998.0,10.0,17,8,10,4,3,6,15,40.0,9,8,1,7,8,25,10,0,MF,20-24,Midfielder,Colombia,South America
82,Ibrahim Amadou,FRA,Angers,Ligue 1,2020,27.0,1993.0,16.7,39,26,18,19,2,15,38,39.5,23,14,4,10,23,62,25,0,MF,25-29,Midfielder,France,Europe
83,Romain Amalfitano,FRA,Dijon,Ligue 1,2020,30.0,1989.0,1.3,4,2,3,1,0,1,3,33.3,2,2,1,1,1,5,1,0,"FW,DF",30-34,Forward,France,Europe
84,Emmanuel Amankwaa Akurugu,GHA,Getafe,La Liga,2020,18.0,2001.0,0.5,0,0,0,0,0,0,1,0.0,1,1,0,1,2,2,1,0,DF,Under 20,Defender,Ghana,Africa
85,Daniel Amartey,GHA,Leicester City,Premier League,2020,25.0,1994.0,8.0,11,7,6,4,1,8,12,66.7,4,8,4,4,12,23,26,0,DF,25-29,Defender,Ghana,Africa
86,Jordan Amavi,FRA,Marseille,Ligue 1,2020,26.0,1994.0,9.0,11,9,9,1,1,9,12,75.0,3,12,2,10,27,38,33,1,DF,25-29,Defender,France,Europe
88,Wisdom Amey,ITA,Bologna,Serie A,2020,14.0,2005.0,0.0,0,0,0,0,0,0,0,,0,0,0,0,0,0,0,0,DF,Under 20,Defender,Italy,Europe
89,Nadiem Amiri,GER,Leverkusen,Bundesliga,2020,23.0,1996.0,21.0,12,7,4,8,0,7,33,21.2,26,18,3,15,12,24,7,0,MF,20-24,Midfielder,Germany,Europe
90,Ethan Ampadu,WAL,Sheffield Utd,Premier League,2020,19.0,2000.0,23.2,57,36,31,24,2,20,46,43.5,26,40,19,21,49,106,87,3,"DF,MF",Under 20,Defender,Wales,Europe
91,Sofyan Amrabat,MAR,Fiorentina,Serie A,2020,23.0,1996.0,27.1,39,22,11,24,4,18,48,37.5,30,30,5,25,23,62,12,0,MF,20-24,Midfielder,Morocco,Africa
93,Joachim Andersen,DEN,Fulham,Premier League,2020,24.0,1996.0,30.3,33,19,18,11,4,15,28,53.6,13,24,13,11,44,77,151,1,DF,20-24,Defender,Denmark,Europe
94,Joachim Andersen,DEN,Lyon,Ligue 1,2020,24.0,1996.0,2.1,2,1,1,1,0,2,2,100.0,0,1,1,0,2,4,6,0,DF,20-24,Defender,Denmark,Europe
95,Djavan Anderson,NED,Lazio,Serie A,2020,25.0,1995.0,0.8,0,0,0,0,0,0,1,0.0,1,1,0,1,1,1,0,0,DF,25-29,Defender,Netherlands,Europe
96,Elliot Anderson,ENG,Newcastle Utd,Premier League,2020,17.0,2002.0,0.0,0,0,0,0,0,0,0,,0,0,0,0,0,0,0,0,MF,Under 20,Midfielder,England,Europe
97,Felipe Anderson,BRA,West Ham,Premier League,2020,27.0,1993.0,0.0,1,1,0,1,0,0,0,,0,0,0,0,0,1,0,0,"FW,MF",25-29,Forward,Brazil,South America
98,Sebastian Andersson,SWE,Köln,Bundesliga,2020,29.0,1991.0,12.5,3,2,0,3,0,1,8,12.5,7,10,3,7,2,5,9,0,FW,25-29,Forward,Sweden,Europe
99,Nícolas Andrade,BRA,Udinese,Serie A,2020,32.0,1988.0,2.0,0,0,0,0,0,0,0,,0,0,0,0,0,0,0,0,GK,30-34,Goalkeeper,Brazil,South America
100,Benjamin André,FRA,Lille,Ligue 1,2020,29.0,1990.0,32.1,114,68,47,61,6,53,122,43.4,69,39,10,29,76,190,49,0,MF,25-29,Midfielder,France,Europe
101,Marcos André,BRA,Valladolid,La Liga,2020,23.0,1996.0,13.1,8,2,2,2,4,0,8,0.0,8,15,2,13,2,10,9,0,FW,20-24,Forward,Brazil,South America
101,Marcos André,BRA,Valladolid,La Liga,2020,23.0,1996.0,13.1,8,2,2,2,4,0,8,0.0,8,15,2,13,2,10,9,0,FW,20-24,Forward,Brazil,South America
101,Marcos André,BRA,Valladolid,La Liga,2020,23.0,1996.0,13.1,8,2,2,2,4,0,8,0.0,8,15,2,13,2,10,9,0,FW,20-24,Forward,Brazil,South America
101,Marcos André,BRA,Valladolid,La Liga,2020,23.0,1996.0,13.1,8,2,2,2,4,0,8,0.0,8,15,2,13,2,10,9,0,FW,20-24,Forward,Brazil,South America
102,Robert Andrich,GER,Union Berlin,Bundesliga,2020,25.0,1994.0,28.1,51,24,22,27,2,24,53,45.3,29,40,6,34,51,102,31,2,MF,25-29,Midfielder,Germany,Europe
103,Victorien Angban,CIV,Metz,Ligue 1,2020,23.0,1996.0,18.6,36,24,17,15,4,17,42,40.5,25,17,4,13,19,55,9,1,MF,20-24,Midfielder,Ivory Coast,Africa
108,Davide Angelo Ghislandi,ITA,Atalanta,Serie A,2020,19.0,2001.0,0.1,0,0,0,0,0,0,0,,0,0,0,0,0,0,1,0,DF,Under 20,Defender,Italy,Europe
109,Philip Ankhrah,GHA,Hellas Verona,Serie A,2020,17.0,2002.0,0.1,0,0,0,0,0,0,0,,0,1,0,1,0,0,0,0,MF,Under 20,Midfielder,Ghana,Africa
110,Cristian Ansaldi,ARG,Torino,Serie A,2020,33.0,1986.0,21.6,48,33,25,14,9,24,38,63.2,14,21,7,14,16,64,38,0,"DF,FW",30-34,Defender,Argentina,South America
111,Waldemar Anton,GER,Stuttgart,Bundesliga,2020,24.0,1996.0,30.1,31,20,17,14,0,12,31,38.7,19,28,18,10,47,78,114,0,DF,20-24,Defender,Germany,Europe
112,Michail Antonio,JAM,West Ham,Premier League,2020,30.0,1990.0,21.9,7,4,1,5,1,1,7,14.3,6,20,3,17,7,14,7,0,FW,30-34,Forward,Jamaica,North America
113,José Antonio Miranda,EQG,Getafe,La Liga,2020,22.0,1998.0,0.3,0,0,0,0,0,0,1,0.0,1,1,0,1,0,0,0,0,"MF,DF",20-24,Midfielder,Equatorial Guinea,Africa
114,Valentin Antov,BUL,Bologna,Serie A,2020,19.0,2000.0,2.6,4,2,3,1,0,3,10,30.0,7,6,5,1,4,8,13,0,DF,Under 20,Defender,Bulgaria,Europe
115,Houssem Aouar,ALG,Lyon,Ligue 1,2020,22.0,1998.0,19.8,17,12,0,13,4,8,25,32.0,17,17,1,16,17,34,4,0,"MF,FW",20-24,Midfielder,Algeria,Africa
116,Adil Aouchiche,FRA,Saint-Étienne,Ligue 1,2020,18.0,2002.0,19.2,38,20,12,17,9,13,49,26.5,36,15,1,14,10,48,6,0,"MF,FW",Under 20,Midfielder,France,Europe
117,Dennis Appiah,FRA,Nantes,Ligue 1,2020,28.0,1992.0,17.3,55,34,33,15,7,32,59,54.2,27,23,6,17,25,80,43,0,DF,25-29,Defender,France,Europe
119,Mauro Arambarri,URU,Getafe,La Liga,2020,24.0,1995.0,33.1,64,39,22,35,7,23,80,28.8,57,40,5,35,42,106,28,0,MF,20-24,Midfielder,Uruguay,South America
120,Charles Aránguiz,CHI,Leverkusen,Bundesliga,2020,31.0,1989.0,18.5,41,23,16,21,4,17,43,39.5,26,32,4,28,33,74,17,0,MF,30-34,Midfielder,Chile,South America
121,Luiz Araújo,BRA,Lille,Ligue 1,2020,24.0,1996.0,16.6,38,25,12,18,8,8,28,28.6,20,23,1,22,11,49,3,0,MF,20-24,Midfielder,Brazil,South America
122,Néstor Araujo,MEX,Celta Vigo,La Liga,2020,28.0,1991.0,27.0,24,16,14,9,1,7,15,46.7,8,23,18,5,43,67,89,2,DF,25-29,Defender,Mexico,North America
123,Ronald Araújo,URU,Barcelona,La Liga,2020,21.0,1999.0,16.8,22,11,12,8,2,9,9,100.0,0,24,15,9,20,42,47,1,DF,20-24,Defender,Uruguay,South America
125,Alphonse Areola,FRA,Fulham,Premier League,2020,27.0,1993.0,36.0,1,0,1,0,0,1,5,20.0,4,0,0,0,1,2,13,3,GK,25-29,Goalkeeper,France,Europe
126,Santiago Arias,COL,Leverkusen,Bundesliga,2020,28.0,1992.0,1.0,2,1,0,1,1,1,1,100.0,0,0,0,0,1,3,4,0,DF,25-29,Defender,Colombia,South America
127,Karim Aribi,ALG,Nîmes,Ligue 1,2020,26.0,1994.0,3.3,2,2,0,1,1,0,5,0.0,5,1,0,1,0,2,3,0,FW,25-29,Forward,Algeria,Africa
129,Nicolò Armini,ITA,Lazio,Serie A,2020,19.0,2001.0,0.1,0,0,0,0,0,0,0,,0,0,0,0,0,0,0,0,DF,Under 20,Defender,Italy,Europe
130,Stuart Armstrong,SCO,Southampton,Premier League,2020,28.0,1992.0,30.7,60,41,19,32,9,27,75,36.0,48,26,1,25,24,84,19,0,MF,25-29,Midfielder,Scotland,Europe
131,Maximilian Arnold,GER,Wolfsburg,Bundesliga,2020,26.0,1994.0,28.7,47,32,20,26,1,18,49,36.7,31,24,3,21,49,96,57,0,MF,25-29,Midfielder,Germany,Europe
132,Tolu Arokodare,NGA,Köln,Bundesliga,2020,19.0,2000.0,1.2,1,1,0,0,1,0,0,,0,1,0,1,1,2,0,0,"FW,MF",Under 20,Forward,Nigeria,Africa
135,Tolgay Arslan,GER,Udinese,Serie A,2020,29.0,1990.0,20.2,52,32,24,24,4,25,54,46.3,29,22,2,20,22,74,15,1,MF,25-29,Midfielder,Germany,Europe
136,Kwadwo Asamoah,GHA,Cagliari,Serie A,2020,31.0,1988.0,2.5,4,3,2,2,0,2,3,66.7,1,5,1,4,4,8,2,1,"DF,MF",30-34,Defender,Ghana,Africa
137,Santiago Ascacíbar,ARG,Hertha BSC,Bundesliga,2020,23.0,1997.0,8.5,30,15,15,14,1,15,28,53.6,13,23,2,21,13,43,14,0,MF,20-24,Midfielder,Argentina,South America
142,Roger Assalé,CIV,Dijon,Ligue 1,2020,26.0,1993.0,9.2,10,8,3,5,2,4,12,33.3,8,7,3,4,2,12,2,0,"FW,MF",25-29,Forward,Ivory Coast,Africa
143,Youcef Atal,ALG,Nice,Ligue 1,2020,24.0,1996.0,10.6,25,12,11,14,0,13,26,50.0,13,10,2,8,26,51,12,0,"DF,FW",20-24,Defender,Algeria,Africa
145,Pierre-Emerick Aubameyang,GAB,Arsenal,Premier League,2020,31.0,1989.0,25.9,12,8,7,4,1,3,20,15.0,17,18,0,18,7,19,17,0,FW,30-34,Forward,Gabon,Africa
146,Emil Audero,ITA,Sampdoria,Serie A,2020,23.0,1997.0,37.0,1,1,1,0,0,1,2,50.0,1,0,0,0,1,2,16,0,GK,20-24,Goalkeeper,Italy,Europe
147,Tommaso Augello,ITA,Sampdoria,Serie A,2020,25.0,1994.0,35.7,42,30,27,10,5,23,39,59.0,16,22,2,20,32,74,76,1,DF,25-29,Defender,Italy,Europe
148,Jean-Kévin Augustin,FRA,Nantes,Ligue 1,2020,23.0,1997.0,0.4,2,0,0,2,0,2,2,100.0,0,0,0,0,0,2,0,0,FW,20-24,Forward,France,Europe
149,Ludwig Augustinsson,SWE,Werder Bremen,Bundesliga,2020,26.0,1994.0,21.7,37,20,19,14,4,17,29,58.6,12,21,7,14,20,57,62,0,"DF,FW",25-29,Defender,Sweden,Europe
150,Serge Aurier,CIV,Tottenham,Premier League,2020,27.0,1992.0,17.8,55,33,33,17,5,15,40,37.5,25,28,5,23,19,74,44,3,DF,25-29,Defender,Ivory Coast,Africa
151,Charlie Austin,ENG,West Brom,Premier League,2020,31.0,1989.0,1.5,4,2,1,2,1,1,3,33.3,2,0,0,0,3,7,4,0,"FW,MF",30-34,Forward,England,Europe
152,Ezequiel Ávila,ARG,Osasuna,La Liga,2020,26.0,1994.0,2.2,6,2,3,1,2,2,4,50.0,2,1,0,1,1,7,0,0,"FW,MF",25-29,Forward,Argentina,South America
153,Taiwo Awoniyi,NGA,Union Berlin,Bundesliga,2020,22.0,1997.0,15.1,5,3,2,3,0,1,14,7.1,13,9,0,9,3,8,4,0,FW,20-24,Forward,Nigeria,Africa
154,Mehmet Aydin,GER,Schalke 04,Bundesliga,2020,18.0,2002.0,5.6,15,7,9,6,0,4,10,40.0,6,6,1,5,6,21,16,0,DF,Under 20,Defender,Germany,Europe
155,Jordan Ayew,GHA,Crystal Palace,Premier League,2020,28.0,1991.0,23.3,38,26,8,16,14,16,44,36.4,28,28,2,26,16,54,12,0,"FW,MF",25-29,Forward,Ghana,Africa
156,Kaan Ayhan,TUR,Sassuolo,Serie A,2020,25.0,1994.0,8.8,15,9,8,5,2,8,13,61.5,5,9,5,4,16,31,33,0,DF,25-29,Defender,Turkey,Asia
157,Luke Ayling,ENG,Leeds United,Premier League,2020,28.0,1991.0,37.8,108,61,69,30,9,49,87,56.3,38,53,36,17,36,144,96,5,DF,25-29,Defender,England,Europe
158,Ramon Azeez,NGA,Granada,La Liga,2020,27.0,1992.0,1.1,1,1,0,1,0,0,0,,0,0,0,0,1,2,1,0,MF,25-29,Midfielder,Nigeria,Africa
161,Carlos Bacca,COL,Villarreal,La Liga,2020,33.0,1986.0,8.7,9,5,5,3,1,3,5,60.0,2,5,0,5,3,12,2,0,FW,30-34,Forward,Colombia,South America
162,Loïc Bade,FRA,Lens,Ligue 1,2020,20.0,2000.0,29.0,57,34,47,10,0,30,55,54.5,25,43,17,26,74,131,135,2,DF,20-24,Defender,France,Europe
163,Milan Badelj,CRO,Genoa,Serie A,2020,31.0,1989.0,26.8,56,27,27,22,7,26,84,31.0,58,51,10,41,87,143,45,1,MF,30-34,Midfielder,Croatia,Europe
165,Benoît Badiashile,FRA,Monaco,Ligue 1,2020,19.0,2001.0,31.9,24,17,15,9,0,13,28,46.4,15,21,12,9,58,82,102,4,DF,Under 20,Defender,France,Europe
168,Stéphane Bahoken,CMR,Angers,Ligue 1,2020,28.0,1992.0,18.0,9,6,1,7,1,4,12,33.3,8,9,0,9,9,18,9,0,FW,25-29,Forward,Cameroon,Africa
169,Leon Bailey,JAM,Leverkusen,Bundesliga,2020,22.0,1997.0,23.8,14,8,3,7,4,4,15,26.7,11,13,0,13,9,23,3,0,"FW,MF",20-24,Forward,Jamaica,North America
170,Eric Bailly,CIV,Manchester Utd,Premier League,2020,26.0,1994.0,10.2,5,5,3,1,1,0,1,0.0,1,13,11,2,13,18,36,2,DF,25-29,Defender,Ivory Coast,Africa
171,Stefan Bajic,FRA,Saint-Étienne,Ligue 1,2020,18.0,2001.0,1.0,0,0,0,0,0,0,0,,0,0,0,0,0,0,1,0,GK,Under 20,Goalkeeper,France,Europe
172,Tiemoué Bakayoko,FRA,Napoli,Serie A,2020,25.0,1994.0,21.8,69,41,21,41,7,23,40,57.5,17,24,2,22,36,105,13,2,MF,25-29,Midfielder,France,Europe
173,Mitchel Bakker,NED,Paris S-G,Ligue 1,2020,20.0,2000.0,18.8,38,30,15,14,9,17,26,65.4,9,22,2,20,22,60,20,0,DF,20-24,Defender,Netherlands,Europe
174,Ridle Baku,GER,Wolfsburg,Bundesliga,2020,22.0,1998.0,29.8,50,31,20,20,10,22,53,41.5,31,54,4,50,40,90,33,1,"FW,DF",20-24,Forward,Germany,Europe
175,Ridle Baku,GER,Mainz 05,Bundesliga,2020,22.0,1998.0,2.0,4,2,3,1,0,2,6,33.3,4,3,1,2,3,7,6,0,DF,20-24,Defender,Germany,Europe
176,Dilane Bakwa,FRA,Bordeaux,Ligue 1,2020,17.0,2002.0,0.6,2,2,1,1,0,0,1,0.0,1,2,0,2,1,3,0,0,"FW,MF",Under 20,Forward,France,Europe
177,Fabián Balbuena,PAR,West Ham,Premier League,2020,28.0,1991.0,13.3,24,12,23,1,0,14,23,60.9,9,23,6,17,25,49,63,0,DF,25-29,Defender,Paraguay,South America
178,Keita Baldé,SEN,Sampdoria,Serie A,2020,25.0,1995.0,13.3,9,6,2,6,1,4,10,40.0,6,10,1,9,0,9,3,0,FW,25-29,Forward,Senegal,Africa
179,George Baldock,GRE,Sheffield Utd,Premier League,2020,27.0,1993.0,31.0,47,34,28,14,5,21,50,42.0,29,26,7,19,25,72,70,1,DF,25-29,Defender,Greece,Europe
180,Gareth Bale,WAL,Tottenham,Premier League,2020,31.0,1989.0,10.2,17,10,4,9,4,7,14,50.0,7,13,2,11,8,25,16,0,FW,30-34,Forward,Wales,Europe
182,Leonardo Balerdi,ARG,Marseille,Ligue 1,2020,21.0,1999.0,18.2,29,18,19,7,3,14,31,45.2,17,17,9,8,28,57,65,3,DF,20-24,Defender,Argentina,South America
183,Fodé Ballo-Touré,SEN,Monaco,Ligue 1,2020,23.0,1997.0,7.4,21,17,9,11,1,6,13,46.2,7,7,0,7,6,27,11,1,DF,20-24,Defender,Senegal,Africa
184,Botond Balogh,HUN,Parma,Serie A,2020,18.0,2002.0,1.8,9,7,9,0,0,2,5,40.0,3,4,3,1,2,11,8,0,DF,Under 20,Defender,Hungary,Europe
185,Abdoulaye Bamba,CIV,Angers,Ligue 1,2020,30.0,1990.0,15.0,27,17,19,7,1,19,28,67.9,9,7,1,6,19,46,34,0,DF,30-34,Defender,Ivory Coast,Africa
186,Jonathan Bamba,CIV,Lille,Ligue 1,2020,24.0,1996.0,33.2,45,23,15,19,11,24,84,28.6,60,24,2,22,24,69,15,0,MF,20-24,Midfielder,Ivory Coast,Africa
187,Robson Bambu,BRA,Nice,Ligue 1,2020,22.0,1997.0,11.6,16,11,14,2,0,11,14,78.6,3,8,7,1,10,26,57,0,DF,20-24,Defender,Brazil,South America
188,Patrick Bamford,ENG,Leeds United,Premier League,2020,26.0,1993.0,33.9,21,9,2,11,8,8,27,29.6,19,14,4,10,10,31,37,0,FW,25-29,Forward,England,Europe
189,Mattia Bani,ITA,Genoa,Serie A,2020,26.0,1993.0,10.2,10,5,5,5,0,5,12,41.7,7,16,11,5,27,37,44,0,DF,25-29,Defender,Italy,Europe
190,Mattia Bani,ITA,Parma,Serie A,2020,26.0,1993.0,12.7,20,11,15,4,1,4,8,50.0,4,10,6,4,33,53,50,0,DF,25-29,Defender,Italy,Europe
191,Simon Banza,COD,Lens,Ligue 1,2020,23.0,1996.0,15.2,13,6,0,4,9,1,14,7.1,13,16,1,15,7,20,15,0,FW,20-24,Forward,DR Congo,Africa
193,Federico Barba,ITA,Benevento,Serie A,2020,26.0,1993.0,29.5,31,16,22,8,1,21,35,60.0,14,39,18,21,48,79,94,4,DF,25-29,Defender,Italy,Europe
194,Danilo Barbosa,BRA,Nice,Ligue 1,2020,24.0,1996.0,2.8,6,3,5,1,0,4,6,66.7,2,2,1,1,2,8,11,2,DF,20-24,Defender,Brazil,South America
196,Melvin Bard,FRA,Lyon,Ligue 1,2020,19.0,2000.0,4.8,12,8,7,4,1,6,11,54.5,5,10,2,8,6,18,14,0,DF,Under 20,Defender,France,Europe
197,Enis Bardhi,MKD,Levante,La Liga,2020,25.0,1995.0,18.7,28,12,8,16,4,10,36,27.8,26,8,2,6,21,49,14,0,MF,25-29,Midfielder,North Macedonia,Europe
198,Phil Bardsley,SCO,Burnley,Premier League,2020,35.0,1985.0,3.0,6,5,4,2,0,3,6,50.0,3,3,1,2,6,12,12,0,DF,35-39,Defender,Scotland,Europe
199,Nicolò Barella,ITA,Inter,Serie A,2020,23.0,1997.0,32.2,58,31,23,29,6,23,72,31.9,49,29,4,25,26,84,14,0,MF,20-24,Midfielder,Italy,Europe
200,Philipp Bargfrede,GER,Werder Bremen,Bundesliga,2020,31.0,1989.0,0.3,0,0,0,0,0,0,0,,0,0,0,0,0,0,3,0,MF,30-34,Midfielder,Germany,Europe
202,Ross Barkley,ENG,Aston Villa,Premier League,2020,26.0,1993.0,17.0,6,2,2,4,0,3,15,20.0,12,9,1,8,5,11,6,1,MF,25-29,Midfielder,England,Europe
203,Ross Barkley,ENG,Chelsea,Premier League,2020,26.0,1993.0,0.5,0,0,0,0,0,0,0,,0,0,0,0,0,0,0,0,"FW,MF",25-29,Forward,England,Europe
204,Aymen Barkok,MAR,Eint Frankfurt,Bundesliga,2020,22.0,1998.0,10.9,29,15,11,9,9,10,31,32.3,21,15,1,14,10,39,9,1,"MF,DF",20-24,Midfielder,Morocco,Africa
205,Ashley Barnes,ENG,Burnley,Premier League,2020,30.0,1989.0,14.8,12,6,2,6,4,3,13,23.1,10,14,2,12,5,17,11,0,FW,30-34,Forward,England,Europe
206,Harvey Barnes,ENG,Leicester City,Premier League,2020,22.0,1997.0,21.6,19,9,11,3,5,5,22,22.7,17,16,3,13,8,27,11,0,"FW,MF",20-24,Forward,England,Europe
209,Antonio Barreca,ITA,Fiorentina,Serie A,2020,25.0,1995.0,0.9,1,0,0,1,0,1,1,100.0,0,0,0,0,0,1,1,0,DF,25-29,Defender,Italy,Europe
210,Leandro Barreiro Martins,LUX,Mainz 05,Bundesliga,2020,20.0,2000.0,25.6,58,32,19,26,13,20,50,40.0,30,34,9,25,57,115,55,0,MF,20-24,Midfielder,Luxembourg,Europe
212,Jacob Barrett Laursen,DEN,Arminia,Bundesliga,2020,25.0,1994.0,12.3,23,12,13,8,2,10,16,62.5,6,14,4,10,24,47,37,0,DF,25-29,Defender,Denmark,Europe
213,Musa Barrow,GAM,Bologna,Serie A,2020,21.0,1998.0,32.5,26,10,8,10,8,10,25,40.0,15,37,2,35,11,37,15,0,"FW,MF",20-24,Forward,Gambia,Africa
214,Kyle Bartley,ENG,West Brom,Premier League,2020,29.0,1991.0,28.7,27,16,14,10,3,11,23,47.8,12,50,35,15,38,65,159,1,DF,25-29,Defender,England,Europe
215,Paolo Bartolomei,ITA,Spezia,Serie A,2020,30.0,1989.0,3.6,6,2,3,1,2,4,7,57.1,3,1,0,1,1,7,2,0,MF,30-34,Midfielder,Italy,Europe
217,Daniele Baselli,ITA,Torino,Serie A,2020,28.0,1992.0,4.4,12,7,3,6,3,6,10,60.0,4,2,0,2,9,21,5,0,MF,25-29,Midfielder,Italy,Europe
218,Chris Basham,ENG,Sheffield Utd,Premier League,2020,32.0,1988.0,28.6,69,42,41,23,5,41,67,61.2,26,36,15,21,49,118,105,1,"DF,MF",30-34,Defender,England,Europe
219,Toma Bašić,CRO,Bordeaux,Ligue 1,2020,23.0,1996.0,28.9,33,22,15,16,2,16,58,27.6,42,21,5,16,32,65,42,1,MF,20-24,Midfielder,Croatia,Europe
221,Alessandro Bastoni,ITA,Inter,Serie A,2020,21.0,1999.0,32.5,36,22,13,21,2,17,27,63.0,10,34,16,18,40,76,75,0,DF,20-24,Defender,Italy,Europe
222,Simone Bastoni,ITA,Spezia,Serie A,2020,23.0,1996.0,16.9,50,29,26,22,2,27,52,51.9,25,19,1,18,16,66,31,0,DF,20-24,Defender,Italy,Europe
223,Bastos,ANG,Lazio,Serie A,2020,29.0,1991.0,0.7,3,1,2,0,1,3,5,60.0,2,1,0,1,0,3,3,0,DF,25-29,Defender,Angola,Africa
224,Michy Batshuayi,BEL,Crystal Palace,Premier League,2020,26.0,1993.0,8.1,5,3,1,2,2,1,9,11.1,8,5,1,4,4,9,5,0,FW,25-29,Forward,Belgium,Europe
225,Rodrigo Battaglia,ARG,Alavés,La Liga,2020,29.0,1991.0,27.7,38,16,21,14,3,16,50,32.0,34,30,14,16,29,67,40,1,MF,25-29,Midfielder,Argentina,South America
226,Cristian Battocchio,ITA,Brest,Ligue 1,2020,28.0,1992.0,3.9,5,2,1,4,0,2,9,22.2,7,0,0,0,4,9,5,0,MF,25-29,Midfielder,Italy,Europe
227,Oliver Baumann,GER,Hoffenheim,Bundesliga,2020,30.0,1990.0,31.0,0,0,0,0,0,0,1,0.0,1,0,0,0,2,2,14,0,GK,30-34,Goalkeeper,Germany,Europe
228,Julian Baumgartlinger,AUT,Leverkusen,Bundesliga,2020,32.0,1988.0,11.9,43,20,14,26,3,16,31,51.6,15,12,0,12,12,55,10,1,MF,30-34,Midfielder,Austria,Europe
229,Christoph Baumgartner,AUT,Hoffenheim,Bundesliga,2020,20.0,1999.0,26.3,44,31,13,24,7,14,51,27.5,37,40,8,32,24,68,24,0,"MF,FW",20-24,Midfielder,Austria,Europe
231,Paul Baysse,FRA,Bordeaux,Ligue 1,2020,32.0,1988.0,29.0,35,18,21,13,1,16,21,76.2,5,33,24,9,52,87,123,1,DF,30-34,Defender,France,Europe
232,Noah Joel Sarenren Bazee,NGA,Augsburg,Bundesliga,2020,23.0,1996.0,0.4,0,0,0,0,0,0,1,0.0,1,0,0,0,1,1,0,0,"FW,MF",20-24,Forward,Nigeria,Africa
234,Rodrigo Becão,BRA,Udinese,Serie A,2020,24.0,1996.0,30.9,59,33,36,20,3,27,49,55.1,22,48,27,21,68,127,94,2,DF,20-24,Defender,Brazil,South America
235,Sheraldo Becker,SUR,Union Berlin,Bundesliga,2020,25.0,1995.0,12.3,5,4,2,2,1,3,5,60.0,2,4,0,4,6,11,7,0,"FW,MF",25-29,Forward,Suriname,South America
236,Timo Becker,GER,Schalke 04,Bundesliga,2020,23.0,1997.0,18.2,34,23,28,6,0,16,25,64.0,9,18,4,14,22,56,58,0,DF,20-24,Defender,Germany,Europe
238,Donny van de Beek,NED,Manchester Utd,Premier League,2020,23.0,1997.0,5.8,15,10,2,11,2,7,15,46.7,8,10,1,9,6,21,7,0,"MF,FW",20-24,Midfielder,Netherlands,Europe
239,Valon Behrami,SUI,Genoa,Serie A,2020,35.0,1985.0,9.9,21,9,9,10,2,9,26,34.6,17,13,5,8,9,30,13,0,MF,35-39,Midfielder,Switzerland,Europe
240,Brian Behrendt,GER,Arminia,Bundesliga,2020,28.0,1991.0,0.9,0,0,0,0,0,0,1,0.0,1,0,0,0,0,0,1,0,DF,25-29,Defender,Germany,Europe
241,Maximilian Beier,GER,Hoffenheim,Bundesliga,2020,17.0,2002.0,0.1,0,0,0,0,0,0,1,0.0,1,0,0,0,0,0,0,0,"FW,DF",Under 20,Forward,Germany,Europe
242,Ishak Belfodil,ALG,Hoffenheim,Bundesliga,2020,28.0,1992.0,6.6,3,2,0,0,3,0,2,0.0,2,1,0,1,1,4,3,0,"FW,MF",25-29,Forward,Algeria,Africa
243,Erwan Belhadji,FRA,Dijon,Ligue 1,2020,19.0,2001.0,0.3,3,0,3,0,0,3,5,60.0,2,1,0,1,0,3,0,0,MF,Under 20,Midfielder,France,Europe
244,Haris Belkebla,ALG,Brest,Ligue 1,2020,26.0,1994.0,30.3,69,39,32,28,9,31,66,47.0,35,26,5,21,57,126,34,0,MF,25-29,Midfielder,Algeria,Africa
245,Stefan Bell,GER,Mainz 05,Bundesliga,2020,28.0,1991.0,14.1,24,18,15,9,0,14,23,60.9,9,19,11,8,27,51,76,1,DF,25-29,Defender,Germany,Europe
246,Karim Bellarabi,GER,Leverkusen,Bundesliga,2020,30.0,1990.0,8.9,12,10,3,4,5,4,17,23.5,13,12,0,12,12,24,4,0,"FW,MF",30-34,Forward,Germany,Europe
247,Jean-Ricner Bellegarde,FRA,Strasbourg,Ligue 1,2020,22.0,1998.0,23.2,56,39,22,25,9,14,23,60.9,9,20,2,18,19,75,16,0,"MF,FW",20-24,Midfielder,France,Europe
249,Jude Bellingham,ENG,Dortmund,Bundesliga,2020,17.0,2003.0,18.9,49,31,11,29,9,19,46,41.3,27,37,5,32,24,73,13,0,MF,Under 20,Midfielder,England,Europe
250,Andrea Belotti,ITA,Torino,Serie A,2020,26.0,1993.0,32.1,30,18,4,16,10,11,35,31.4,24,27,4,23,12,42,21,0,FW,25-29,Forward,Italy,Europe
252,Sami Ben Amar,MAR,Nîmes,Ligue 1,2020,22.0,1998.0,0.1,0,0,0,0,0,0,0,,0,1,0,1,0,0,0,0,MF,20-24,Midfielder,Morocco,Africa
253,Hatem Ben Arfa,FRA,Bordeaux,Ligue 1,2020,33.0,1987.0,18.9,11,7,1,7,3,2,9,22.2,7,3,0,3,2,13,0,0,"MF,FW",30-34,Midfielder,France,Europe
254,Salim Ben Seghir,FRA,Nice,Ligue 1,2020,17.0,2003.0,0.1,0,0,0,0,0,0,0,,0,0,0,0,0,0,0,0,DF,Under 20,Defender,France,Europe
255,Wissam Ben Yedder,FRA,Monaco,Ligue 1,2020,29.0,1990.0,29.0,18,9,2,10,6,3,13,23.1,10,16,0,16,13,31,3,0,FW,25-29,Forward,France,Europe
256,Ahmad Benali,LBY,Crotone,Serie A,2020,28.0,1992.0,13.5,19,11,10,9,0,11,38,28.9,27,15,2,13,6,25,15,0,MF,25-29,Midfielder,Libya,Africa
257,Samy Benchamma,FRA,Montpellier,Ligue 1,2020,20.0,2000.0,0.5,1,1,1,0,0,0,0,,0,0,0,0,0,1,1,0,"DF,MF",20-24,Defender,France,Europe
258,Lars Bender,GER,Leverkusen,Bundesliga,2020,31.0,1989.0,10.4,19,13,12,6,1,9,21,42.9,12,19,5,14,16,35,19,0,DF,30-34,Defender,Germany,Europe
259,Sven Bender,GER,Leverkusen,Bundesliga,2020,31.0,1989.0,13.0,17,9,8,8,1,7,20,35.0,13,20,9,11,21,38,41,1,DF,30-34,Defender,Germany,Europe
260,Darío Benedetto,ARG,Marseille,Ligue 1,2020,30.0,1990.0,17.5,6,4,1,4,1,5,13,38.5,8,9,2,7,3,9,17,0,FW,30-34,Forward,Argentina,South America
261,László Bénes,SVK,Augsburg,Bundesliga,2020,22.0,1997.0,7.3,8,6,4,4,0,2,8,25.0,6,6,2,4,7,15,1,1,MF,20-24,Midfielder,Slovakia,Europe
262,László Bénes,SVK,Gladbach,Bundesliga,2020,22.0,1997.0,1.7,6,2,5,1,0,2,4,50.0,2,0,0,0,2,8,1,0,MF,20-24,Midfielder,Slovakia,Europe
263,Walter Benítez,ARG,Nice,Ligue 1,2020,27.0,1993.0,38.0,1,1,1,0,0,1,3,33.3,2,1,0,1,1,2,7,2,GK,25-29,Goalkeeper,Argentina,South America
264,Loris Benito,SUI,Bordeaux,Ligue 1,2020,28.0,1992.0,29.5,42,26,27,12,3,22,48,45.8,26,33,10,23,42,84,70,0,DF,25-29,Defender,Switzerland,Europe
266,Bilal Benkhedim,FRA,Saint-Étienne,Ligue 1,2020,19.0,2001.0,0.8,0,0,0,0,0,0,1,0.0,1,1,0,1,0,0,0,0,FW,Under 20,Forward,France,Europe
267,Djamel Benlamri,ALG,Lyon,Ligue 1,2020,30.0,1989.0,1.7,5,3,5,0,0,3,6,50.0,3,3,2,1,6,11,11,0,DF,30-34,Defender,Algeria,Africa
268,Ismaël Bennacer,ALG,Milan,Serie A,2020,22.0,1997.0,14.7,39,18,17,21,1,15,32,46.9,17,10,1,9,20,59,12,0,MF,20-24,Midfielder,Algeria,Africa
269,Saïd Benrahma,ALG,West Ham,Premier League,2020,24.0,1995.0,15.5,24,15,8,11,5,8,28,28.6,20,10,0,10,8,32,8,0,"FW,MF",20-24,Forward,Algeria,Africa
270,Yassine Benrahou,FRA,Nîmes,Ligue 1,2020,21.0,1999.0,13.8,16,9,8,6,2,7,25,28.0,18,9,0,9,4,20,5,1,MF,20-24,Midfielder,France,Europe
271,Ramy Bensebaini,ALG,Gladbach,Bundesliga,2020,25.0,1995.0,20.1,43,24,27,13,3,26,42,61.9,16,39,7,32,47,90,66,0,DF,25-29,Defender,Algeria,Africa
272,Josh Benson,ENG,Burnley,Premier League,2020,20.0,1999.0,2.9,5,1,3,0,2,1,6,16.7,5,3,0,3,3,8,2,0,MF,20-24,Midfielder,England,Europe
273,Nabil Bentaleb,ALG,Schalke 04,Bundesliga,2020,25.0,1994.0,6.1,14,8,7,6,1,4,15,26.7,11,5,2,3,6,20,8,0,MF,25-29,Midfielder,Algeria,Africa
274,Rodrigo Bentancur,URU,Juventus,Serie A,2020,23.0,1997.0,25.8,63,33,21,37,5,20,59,33.9,39,35,12,23,47,110,46,1,MF,20-24,Midfielder,Uruguay,South America
275,Christian Benteke,BEL,Crystal Palace,Premier League,2020,29.0,1990.0,20.2,15,7,1,7,7,2,9,22.2,7,17,6,11,4,19,39,0,FW,25-29,Forward,Belgium,Europe
276,Karim Benzema,FRA,Real Madrid,La Liga,2020,32.0,1987.0,32.2,8,6,4,2,2,5,15,33.3,10,9,2,7,8,16,24,0,FW,30-34,Forward,France,Europe
277,Yassine Benzia,ALG,Dijon,Ligue 1,2020,25.0,1994.0,4.5,10,5,5,3,2,2,10,20.0,8,3,0,3,6,16,2,0,"MF,FW",25-29,Midfielder,Algeria,Africa
278,Alessandro Berardi,ITA,Hellas Verona,Serie A,2020,29.0,1991.0,0.3,0,0,0,0,0,0,0,,0,0,0,0,0,0,0,0,GK,25-29,Goalkeeper,Italy,Europe
279,Domenico Berardi,ITA,Sassuolo,Serie A,2020,25.0,1994.0,27.5,42,22,17,11,14,21,62,33.9,41,23,1,22,26,68,34,0,FW,25-29,Forward,Italy,Europe
280,Gaetano Berardi,SUI,Leeds United,Premier League,2020,31.0,1988.0,1.3,2,2,1,0,1,0,0,,0,2,1,1,1,3,2,0,DF,30-34,Defender,Switzerland,Europe
285,Jóhann Berg Guðmundsson,ISL,Burnley,Premier League,2020,29.0,1990.0,15.1,19,11,6,9,4,11,23,47.8,12,11,2,9,17,36,19,0,MF,25-29,Midfielder,Iceland,Europe
287,Steven Bergwijn,NED,Tottenham,Premier League,2020,22.0,1997.0,13.4,15,7,8,3,4,7,20,35.0,13,7,1,6,5,20,9,0,"FW,MF",20-24,Forward,Netherlands,Europe
289,Bernard,BRA,Everton,Premier League,2020,27.0,1992.0,5.1,8,3,3,3,2,7,15,46.7,8,5,0,5,8,16,6,0,"MF,FW",25-29,Midfielder,Brazil,South America
290,Federico Bernardeschi,ITA,Juventus,Serie A,2020,26.0,1994.0,10.8,9,4,3,5,1,4,20,20.0,16,6,2,4,14,23,7,1,"MF,DF",25-29,Midfielder,Italy,Europe
291,Bernardo,BRA,Brighton,Premier League,2020,25.0,1995.0,2.3,10,8,8,1,1,4,6,66.7,2,2,0,2,1,11,1,0,"DF,MF",25-29,Defender,Brazil,South America
291,Bernardo,BRA,Brighton,Premier League,2020,25.0,1995.0,2.3,10,8,8,1,1,4,6,66.7,2,2,0,2,1,11,1,0,"DF,MF",25-29,Defender,Brazil,South America
291,Bernardo,BRA,Brighton,Premier League,2020,25.0,1995.0,2.3,10,8,8,1,1,4,6,66.7,2,2,0,2,1,11,1,0,"DF,MF",25-29,Defender,Brazil,South America
291,Bernardo,BRA,Brighton,Premier League,2020,25.0,1995.0,2.3,10,8,8,1,1,4,6,66.7,2,2,0,2,1,11,1,0,"DF,MF",25-29,Defender,Brazil,South America
292,Paul Bernardoni,FRA,Angers,Ligue 1,2020,23.0,1997.0,38.0,1,1,1,0,0,1,2,50.0,1,0,0,0,2,3,23,1,GK,20-24,Goalkeeper,France,Europe
294,Dimitry Bertaud,COD,Montpellier,Ligue 1,2020,22.0,1998.0,8.3,0,0,0,0,0,0,0,,0,0,0,0,1,1,2,0,GK,20-24,Goalkeeper,DR Congo,Africa
295,Marco Bertini,ITA,Lazio,Serie A,2020,17.0,2002.0,0.1,1,0,1,0,0,0,0,,0,0,0,0,0,1,0,0,MF,Under 20,Midfielder,Italy,Europe
296,Ryan Bertrand,ENG,Southampton,Premier League,2020,30.0,1989.0,28.9,60,32,26,27,7,30,48,62.5,18,19,1,18,30,90,41,1,DF,30-34,Defender,England,Europe
297,Daniel Bessa,ITA,Hellas Verona,Serie A,2020,27.0,1993.0,6.8,15,8,3,11,1,6,14,42.9,8,5,1,4,2,17,0,0,MF,25-29,Midfielder,Italy,Europe
299,Jordan Beyer,GER,Gladbach,Bundesliga,2020,20.0,2000.0,2.1,2,1,2,0,0,1,2,50.0,1,5,4,1,5,7,5,0,DF,20-24,Defender,Germany,Europe
300,Giulian Biancone,FRA,Monaco,Ligue 1,2020,20.0,2000.0,1.0,3,3,1,1,1,2,3,66.7,1,1,0,1,1,4,4,0,"DF,MF",20-24,Defender,France,Europe
302,Ermin Bičakčić,BIH,Hoffenheim,Bundesliga,2020,30.0,1990.0,1.4,1,1,0,1,0,1,1,100.0,0,1,1,0,3,4,9,0,DF,30-34,Defender,Bosnia and Herzegovina,Europe
304,El Bilal Touré,MLI,Reims,Ligue 1,2020,18.0,2001.0,13.8,22,12,3,16,3,8,18,44.4,10,8,3,5,6,28,10,1,FW,Under 20,Forward,Mali,Africa
305,Cristiano Biraghi,ITA,Fiorentina,Serie A,2020,27.0,1992.0,31.1,42,23,19,15,8,27,45,60.0,18,23,9,14,27,69,56,3,DF,25-29,Defender,Italy,Europe
306,Davide Biraschi,ITA,Genoa,Serie A,2020,26.0,1994.0,10.2,17,9,12,5,0,5,10,50.0,5,12,6,6,21,38,26,0,DF,25-29,Defender,Italy,Europe
307,Yves Bissouma,MLI,Brighton,Premier League,2020,23.0,1996.0,34.6,104,68,50,48,6,33,67,49.3,34,42,6,36,64,168,67,0,MF,20-24,Midfielder,Mali,Africa
308,Leonardo Bittencourt,GER,Werder Bremen,Bundesliga,2020,26.0,1993.0,16.8,58,32,24,28,6,16,51,31.4,35,29,2,27,13,71,10,0,"MF,FW",25-29,Midfielder,Germany,Europe
312,Ludovic Blas,FRA,Nantes,Ligue 1,2020,22.0,1997.0,31.0,58,30,18,37,3,23,54,42.6,31,33,4,29,21,79,19,0,"MF,FW",20-24,Midfielder,France,Europe
314,Jérôme Boateng,GER,Bayern Munich,Bundesliga,2020,31.0,1988.0,26.3,26,16,17,8,1,14,32,43.8,18,24,17,7,40,66,63,1,DF,30-34,Defender,Germany,Europe
315,Antonin Bobichon,FRA,Angers,Ligue 1,2020,24.0,1995.0,10.1,23,14,10,8,5,9,15,60.0,6,4,1,3,2,25,1,0,"MF,FW",20-24,Midfielder,France,Europe
316,Yann Bodiger,FRA,Cádiz,La Liga,2020,25.0,1995.0,2.8,2,2,1,1,0,1,6,16.7,5,7,3,4,8,10,4,0,MF,25-29,Midfielder,France,Europe
317,Jean-Paul Boëtius,NED,Mainz 05,Bundesliga,2020,26.0,1994.0,22.9,42,28,13,15,14,17,47,36.2,30,37,3,34,33,75,14,0,"MF,FW",25-29,Midfielder,Netherlands,Europe
318,Sacha Boey,FRA,Dijon,Ligue 1,2020,19.0,2000.0,20.7,54,40,30,23,1,27,55,49.1,28,25,5,20,41,95,62,0,DF,Under 20,Defender,France,Europe
319,Sacha Boey,FRA,Rennes,Ligue 1,2020,19.0,2000.0,1.4,3,3,2,1,0,3,4,75.0,1,0,0,0,2,5,2,0,DF,Under 20,Defender,France,Europe
320,Jeremie Boga,CIV,Sassuolo,Serie A,2020,23.0,1997.0,19.8,11,9,5,0,6,3,11,27.3,8,10,0,10,8,19,7,0,"FW,MF",20-24,Forward,Ivory Coast,Africa
321,Melayro Bogarde,NED,Hoffenheim,Bundesliga,2020,18.0,2002.0,3.1,7,3,3,3,1,5,9,55.6,4,0,0,0,5,12,1,0,"DF,MF",Under 20,Defender,Netherlands,Europe
322,Jayden Bogle,ENG,Sheffield Utd,Premier League,2020,20.0,2000.0,12.3,33,23,21,10,2,20,39,51.3,19,14,4,10,14,47,22,0,"DF,MF",20-24,Defender,England,Europe
323,Quentin Boisgard,FRA,Lorient,Ligue 1,2020,23.0,1997.0,14.6,24,17,3,15,6,11,24,45.8,13,17,2,15,15,39,1,0,"MF,FW",20-24,Midfielder,France,Europe
324,Willy Boly,CIV,Wolves,Premier League,2020,29.0,1991.0,20.9,33,20,26,7,0,13,24,54.2,11,18,12,6,32,65,84,1,DF,25-29,Defender,Ivory Coast,Africa
325,Giacomo Bonaventura,ITA,Fiorentina,Serie A,2020,30.0,1989.0,25.1,34,19,16,13,5,16,53,30.2,37,26,2,24,39,73,12,0,MF,30-34,Midfielder,Italy,Europe
326,Federico Bonazzoli,ITA,Torino,Serie A,2020,23.0,1997.0,6.3,6,4,0,4,2,2,13,15.4,11,3,0,3,2,8,3,0,FW,20-24,Forward,Italy,Europe
327,Federico Bonazzoli,ITA,Sampdoria,Serie A,2020,23.0,1997.0,1.5,0,0,0,0,0,0,0,,0,1,0,1,0,0,0,0,FW,20-24,Forward,Italy,Europe
328,Kevin Bonifazi,ITA,Udinese,Serie A,2020,24.0,1996.0,27.4,32,21,24,6,2,8,23,34.8,15,33,20,13,50,82,85,1,DF,20-24,Defender,Italy,Europe
329,Leonardo Bonucci,ITA,Juventus,Serie A,2020,33.0,1987.0,22.5,19,14,10,8,1,6,14,42.9,8,24,13,11,33,52,67,0,DF,30-34,Defender,Italy,Europe
330,Elias Bördner,GER,Eint Frankfurt,Bundesliga,2020,18.0,2002.0,1.0,1,0,1,0,0,1,1,100.0,0,0,0,0,2,3,1,0,GK,Under 20,Goalkeeper,Germany,Europe
331,Dennis Borkowski,GER,RB Leipzig,Bundesliga,2020,18.0,2002.0,0.1,0,0,0,0,0,0,0,,0,1,0,1,0,0,0,0,"MF,FW",Under 20,Midfielder,Germany,Europe
332,Sebastiaan Bornauw,BEL,Köln,Bundesliga,2020,21.0,1999.0,23.1,29,20,25,4,0,14,25,56.0,11,33,26,7,40,69,104,0,DF,20-24,Defender,Belgium,Europe
333,Sven Botman,NED,Lille,Ligue 1,2020,20.0,2000.0,36.8,31,21,18,12,1,14,26,53.8,12,31,21,10,57,88,126,2,DF,20-24,Defender,Netherlands,Europe
334,Denis Bouanga,GAB,Saint-Étienne,Ligue 1,2020,25.0,1994.0,30.2,52,28,22,24,6,16,58,27.6,42,32,3,29,20,72,36,0,"MF,FW",25-29,Midfielder,Gabon,Africa
335,Hicham Boudaoui,ALG,Nice,Ligue 1,2020,20.0,1999.0,19.3,52,35,20,24,8,26,68,38.2,42,14,4,10,23,75,26,1,MF,20-24,Midfielder,Algeria,Africa
336,Ryad Boudebouz,ALG,Saint-Étienne,Ligue 1,2020,30.0,1990.0,7.2,9,4,1,7,1,4,8,50.0,4,3,0,3,5,14,5,0,"MF,FW",30-34,Midfielder,Algeria,Africa
337,Sofiane Boufal,MAR,Angers,Ligue 1,2020,26.0,1993.0,8.1,17,11,8,6,3,8,28,28.6,20,8,0,8,3,20,1,0,"FW,MF",25-29,Forward,Morocco,Africa
338,Nassim Boujellab,MAR,Schalke 04,Bundesliga,2020,21.0,1999.0,6.7,13,9,2,10,1,2,12,16.7,10,10,3,7,7,20,9,0,"MF,FW",20-24,Midfielder,Morocco,Africa
339,Farid Boulaya,ALG,Metz,Ligue 1,2020,27.0,1993.0,31.3,24,16,4,17,3,13,51,25.5,38,19,3,16,12,36,7,0,"MF,FW",25-29,Midfielder,Algeria,Africa
340,Yassine Bounou,MAR,Sevilla,La Liga,2020,29.0,1991.0,33.0,1,1,1,0,0,0,2,0.0,2,0,0,0,0,1,12,2,GK,25-29,Goalkeeper,Morocco,Africa
342,Mehdi Bourabia,MAR,Sassuolo,Serie A,2020,28.0,1991.0,5.9,6,5,1,4,1,2,7,28.6,5,14,6,8,12,18,8,0,MF,25-29,Midfielder,Morocco,Africa
343,Benjamin Bourigeaud,FRA,Rennes,Ligue 1,2020,26.0,1994.0,28.4,40,23,17,16,7,21,71,29.6,50,37,1,36,19,59,25,0,"MF,FW",25-29,Midfielder,France,Europe
344,Edoardo Bove,ITA,Roma,Serie A,2020,18.0,2002.0,0.1,0,0,0,0,0,0,1,0.0,1,0,0,0,0,0,0,0,MF,Under 20,Midfielder,Italy,Europe
345,Jarrod Bowen,ENG,West Ham,Premier League,2020,23.0,1996.0,28.5,26,15,12,7,7,10,29,34.5,19,19,1,18,22,48,10,0,"FW,MF",20-24,Forward,England,Europe
346,Dedryck Boyata,BEL,Hertha BSC,Bundesliga,2020,29.0,1990.0,17.2,14,7,10,3,1,7,15,46.7,8,23,20,3,26,40,68,1,DF,25-29,Defender,Belgium,Europe
347,John Boye,GHA,Metz,Ligue 1,2020,33.0,1987.0,33.8,58,34,43,13,2,31,54,57.4,23,36,20,16,80,138,146,1,DF,30-34,Defender,Ghana,Africa
348,Lucas Boyé,ARG,Elche,La Liga,2020,24.0,1996.0,29.9,47,31,13,27,7,10,49,20.4,39,37,2,35,19,66,21,0,FW,20-24,Forward,Argentina,South America
349,Can Bozdogan,GER,Schalke 04,Bundesliga,2020,19.0,2001.0,7.2,13,5,6,6,1,4,15,26.7,11,10,2,8,7,20,5,0,"MF,FW",Under 20,Midfielder,Germany,Europe
350,Umut Bozok,TUR,Lorient,Ligue 1,2020,23.0,1996.0,0.7,0,0,0,0,0,0,2,0.0,2,0,0,0,0,0,0,0,"MF,FW",20-24,Midfielder,Turkey,Asia
351,Jayden Braaf,NED,Udinese,Serie A,2020,17.0,2002.0,1.3,0,0,0,0,0,0,1,0.0,1,0,0,0,0,0,0,0,FW,Under 20,Forward,Netherlands,Europe
352,Domagoj Bradarić,CRO,Lille,Ligue 1,2020,20.0,1999.0,14.0,28,18,11,13,4,12,27,44.4,15,14,4,10,26,54,21,0,DF,20-24,Defender,Croatia,Europe
353,Robbie Brady,IRL,Burnley,Premier League,2020,28.0,1992.0,11.7,22,15,12,6,4,12,35,34.3,23,16,0,16,9,31,29,1,MF,25-29,Midfielder,Republic of Ireland,Europe
354,Martin Braithwaite,DEN,Barcelona,La Liga,2020,29.0,1991.0,13.1,8,4,2,3,3,1,6,16.7,5,2,0,2,6,14,7,0,FW,25-29,Forward,Denmark,Europe
355,Julian Brandt,GER,Dortmund,Bundesliga,2020,24.0,1996.0,16.6,27,14,13,9,5,12,43,27.9,31,25,1,24,17,44,7,1,"FW,MF",20-24,Forward,Germany,Europe
357,Lilian Brassier,FRA,Brest,Ligue 1,2020,20.0,1999.0,10.7,19,10,12,4,3,7,11,63.6,4,13,6,7,23,42,38,1,DF,20-24,Defender,France,Europe
359,Claudio Bravo,CHI,Betis,La Liga,2020,37.0,1983.0,20.0,0,0,0,0,0,0,1,0.0,1,0,0,0,0,0,11,0,GK,35-39,Goalkeeper,Chile,South America
360,Fabian Bredlow,GER,Stuttgart,Bundesliga,2020,25.0,1995.0,1.0,0,0,0,0,0,0,0,,0,0,0,0,0,0,0,0,GK,25-29,Goalkeeper,Germany,Europe
361,Josip Brekalo,CRO,Wolfsburg,Bundesliga,2020,22.0,1998.0,20.2,22,10,10,7,5,8,29,27.6,21,18,0,18,17,39,3,1,FW,20-24,Forward,Croatia,Europe
362,Gleison Bremer,BRA,Torino,Serie A,2020,23.0,1997.0,32.6,51,34,36,14,1,21,36,58.3,15,54,21,33,70,121,142,1,DF,20-24,Defender,Brazil,South America
363,Joshua Brenet,CUW,Hoffenheim,Bundesliga,2020,26.0,1994.0,0.0,0,0,0,0,0,0,0,,0,0,0,0,0,0,0,0,DF,25-29,Defender,Curaçao,Europe
364,Rhian Brewster,ENG,Sheffield Utd,Premier League,2020,20.0,2000.0,12.5,8,5,1,4,3,1,13,7.7,12,15,2,13,5,13,5,0,"FW,MF",20-24,Forward,England,Europe
365,Anthony Briançon,FRA,Nîmes,Ligue 1,2020,25.0,1994.0,13.6,12,7,9,3,0,9,19,47.4,10,19,12,7,33,45,57,2,DF,25-29,Defender,France,Europe
366,Jimmy Briand,FRA,Bordeaux,Ligue 1,2020,34.0,1985.0,6.3,7,3,3,2,2,1,1,100.0,0,2,0,2,1,8,3,0,FW,30-34,Forward,France,Europe
367,Yan Brice Eteki,CMR,Granada,La Liga,2020,22.0,1997.0,14.7,23,15,10,12,1,8,19,42.1,11,13,3,10,13,36,16,1,MF,20-24,Midfielder,Cameroon,Africa
368,Nathan Broadhead,WAL,Everton,Premier League,2020,22.0,1998.0,0.0,1,1,0,1,0,0,0,,0,0,0,0,0,1,0,0,FW,20-24,Forward,Wales,Europe
369,Dylan Bronn,TUN,Metz,Ligue 1,2020,25.0,1995.0,37.9,57,37,38,19,0,24,44,54.5,20,31,14,17,44,101,112,0,DF,25-29,Defender,Tunisia,Africa
370,John Brooks,USA,Wolfsburg,Bundesliga,2020,27.0,1993.0,30.8,47,29,33,14,0,30,54,55.6,24,35,10,25,55,102,134,0,DF,25-29,Defender,United States,North America
371,Daniel Brosinski,GER,Mainz 05,Bundesliga,2020,32.0,1988.0,15.9,19,14,10,7,2,12,31,38.7,19,18,1,17,14,33,33,0,"DF,FW",30-34,Defender,Germany,Europe
372,Josh Brownhill,ENG,Burnley,Premier League,2020,24.0,1995.0,31.3,45,27,9,29,7,15,44,34.1,29,33,11,22,69,114,39,0,MF,20-24,Midfielder,England,Europe
373,Marcelo Brozović,CRO,Inter,Serie A,2020,27.0,1992.0,28.7,54,29,23,24,7,20,61,32.8,41,43,17,26,40,94,38,0,MF,25-29,Midfielder,Croatia,Europe
374,Gastón Brugman,URU,Parma,Serie A,2020,27.0,1992.0,18.0,35,19,18,15,2,11,44,25.0,33,33,4,29,45,80,34,0,MF,25-29,Midfielder,Uruguay,South America
375,Juan Brunet,ARG,Granada,La Liga,2020,22.0,1998.0,0.3,0,0,0,0,0,0,0,,0,0,0,0,0,0,1,0,MF,20-24,Midfielder,Argentina,South America
376,Juan Brunetta,ARG,Parma,Serie A,2020,23.0,1997.0,5.3,2,2,0,2,0,1,6,16.7,5,5,0,5,1,3,2,0,"FW,MF",20-24,Forward,Argentina,South America
377,Cédric Brunner,SUI,Arminia,Bundesliga,2020,26.0,1994.0,29.5,42,22,24,15,3,27,40,67.5,13,30,10,20,42,84,96,0,DF,25-29,Defender,Switzerland,Europe
378,Jacob Bruun Larsen,DEN,Hoffenheim,Bundesliga,2020,21.0,1998.0,1.0,0,0,0,0,0,0,0,,0,0,0,0,0,0,0,0,"MF,FW",20-24,Midfielder,Denmark,Europe
379,Joe Bryan,ENG,Fulham,Premier League,2020,26.0,1993.0,7.4,15,8,7,5,3,7,12,58.3,5,8,2,6,14,29,16,0,"DF,MF",25-29,Defender,England,Europe
380,Kean Bryan,ENG,Sheffield Utd,Premier League,2020,23.0,1996.0,11.2,20,10,9,11,0,9,19,47.4,10,16,10,6,13,33,39,1,DF,20-24,Defender,England,Europe
381,Lucas Buadés,FRA,Nîmes,Ligue 1,2020,22.0,1997.0,0.2,1,0,0,1,0,0,0,,0,0,0,0,0,1,0,0,MF,20-24,Midfielder,France,Europe
382,Ante Budimir,CRO,Osasuna,La Liga,2020,29.0,1991.0,18.1,20,12,2,11,7,4,15,26.7,11,17,4,13,2,22,17,1,FW,25-29,Forward,Croatia,Europe
383,Gianluigi Buffon,ITA,Juventus,Serie A,2020,42.0,1978.0,8.0,0,0,0,0,0,0,0,,0,0,0,0,0,0,3,1,GK,Over 40,Goalkeeper,Italy,Europe
384,Marius Bülter,GER,Union Berlin,Bundesliga,2020,27.0,1993.0,10.9,15,8,6,6,3,5,17,29.4,12,17,2,15,12,27,11,0,"FW,MF",25-29,Forward,Germany,Europe
385,Alessandro Buongiorno,ITA,Torino,Serie A,2020,21.0,1999.0,9.5,12,5,8,4,0,7,12,58.3,5,15,9,6,11,23,44,1,DF,20-24,Defender,Italy,Europe
386,Esteban Burgos,ARG,Eibar,La Liga,2020,28.0,1992.0,12.3,7,6,4,3,0,1,5,20.0,4,8,7,1,23,30,54,2,DF,25-29,Defender,Argentina,South America
388,Jonathan Burkardt,GER,Mainz 05,Bundesliga,2020,20.0,2000.0,15.3,27,13,15,10,2,11,19,57.9,8,20,3,17,8,35,15,0,"FW,MF",20-24,Forward,Germany,Europe
389,Nishan Burkart,SUI,Freiburg,Bundesliga,2020,20.0,2000.0,0.2,0,0,0,0,0,0,1,0.0,1,0,0,0,0,0,0,0,MF,20-24,Midfielder,Switzerland,Europe
390,Oliver Burke,SCO,Sheffield Utd,Premier League,2020,23.0,1997.0,14.1,16,8,6,9,1,5,24,20.8,19,24,0,24,2,18,6,0,FW,20-24,Forward,Scotland,Europe
391,Roman Bürki,SUI,Dortmund,Bundesliga,2020,29.0,1990.0,18.5,0,0,0,0,0,0,0,,0,0,0,0,0,0,5,1,GK,25-29,Goalkeeper,Switzerland,Europe
392,Dan Burn,ENG,Brighton,Premier League,2020,28.0,1992.0,22.9,50,26,33,14,3,27,53,50.9,26,30,7,23,31,81,75,0,DF,25-29,Defender,England,Europe
395,Maxime Busi,BEL,Parma,Serie A,2020,20.0,1999.0,13.3,23,13,19,3,1,11,28,39.3,17,14,1,13,16,39,32,0,DF,20-24,Defender,Belgium,Europe
397,Jack Butland,ENG,Crystal Palace,Premier League,2020,27.0,1993.0,1.0,0,0,0,0,0,0,0,,0,0,0,0,0,0,0,0,GK,25-29,Goalkeeper,England,Europe
398,David Button,ENG,West Brom,Premier League,2020,31.0,1989.0,1.0,0,0,0,0,0,0,0,,0,0,0,0,0,0,0,0,GK,30-34,Goalkeeper,England,Europe
399,Oskar Buur,DEN,Wolves,Premier League,2020,22.0,1998.0,0.2,0,0,0,0,0,0,2,0.0,2,0,0,0,0,0,0,0,DF,20-24,Defender,Denmark,Europe
401,Erick Cabaco,URU,Getafe,La Liga,2020,25.0,1995.0,14.7,24,14,11,12,1,12,22,54.5,10,8,6,2,13,37,51,1,DF,25-29,Defender,Uruguay,South America
402,Willy Caballero,ARG,Chelsea,Premier League,2020,38.0,1981.0,1.0,0,0,0,0,0,0,0,,0,0,0,0,0,0,0,0,GK,35-39,Goalkeeper,Argentina,South America
403,Jimmy Cabot,FRA,Angers,Ligue 1,2020,26.0,1994.0,10.5,26,13,8,14,4,11,36,30.6,25,8,0,8,12,38,6,0,"FW,MF",25-29,Forward,France,Europe
404,Martín Cáceres,URU,Fiorentina,Serie A,2020,33.0,1987.0,24.9,28,12,16,11,1,15,35,42.9,20,20,14,6,14,42,52,1,DF,30-34,Defender,Uruguay,South America
405,Anthony Caci,FRA,Strasbourg,Ligue 1,2020,23.0,1997.0,31.1,80,46,47,27,6,35,69,50.7,34,30,4,26,55,135,65,1,DF,20-24,Defender,France,Europe
406,Mathieu Cafaro,FRA,Reims,Ligue 1,2020,23.0,1997.0,23.0,40,17,15,19,6,13,43,30.2,30,11,0,11,17,57,12,0,"MF,FW",20-24,Midfielder,France,Europe
407,Gary Cahill,ENG,Crystal Palace,Premier League,2020,34.0,1985.0,20.0,13,9,10,3,0,7,11,63.6,4,27,22,5,13,26,88,0,DF,30-34,Defender,England,Europe
408,Yannick Cahuzac,FRA,Lens,Ligue 1,2020,35.0,1985.0,25.0,26,12,12,10,4,9,27,33.3,18,18,5,13,33,59,72,0,MF,35-39,Midfielder,France,Europe
409,Felipe Caicedo,ECU,Lazio,Serie A,2020,31.0,1988.0,10.3,10,7,4,4,2,1,8,12.5,7,7,0,7,4,14,2,0,FW,30-34,Forward,Ecuador,South America
410,Marc-Aurèle Caillard,FRA,Metz,Ligue 1,2020,26.0,1994.0,4.0,0,0,0,0,0,0,0,,0,0,0,0,0,0,2,0,GK,25-29,Goalkeeper,France,Europe
411,Tom Cairney,SCO,Fulham,Premier League,2020,29.0,1991.0,8.4,9,3,1,4,4,1,4,25.0,3,6,0,6,0,9,3,0,MF,25-29,Midfielder,Scotland,Europe
413,Arturo Calabresi,ITA,Bologna,Serie A,2020,24.0,1996.0,0.2,0,0,0,0,0,0,0,,0,0,0,0,0,0,2,0,"DF,FW",20-24,Defender,Italy,Europe
414,Arturo Calabresi,ITA,Cagliari,Serie A,2020,24.0,1996.0,0.2,0,0,0,0,0,0,1,0.0,1,0,0,0,0,0,0,0,DF,20-24,Defender,Italy,Europe
415,Davide Calabria,ITA,Milan,Serie A,2020,23.0,1996.0,29.4,101,64,61,32,8,54,90,60.0,36,42,9,33,37,138,82,1,DF,20-24,Defender,Italy,Europe
416,Riccardo Calafiori,ITA,Roma,Serie A,2020,18.0,2002.0,0.7,1,0,1,0,0,1,4,25.0,3,1,0,1,0,1,0,0,DF,Under 20,Defender,Italy,Europe
417,Mattia Caldara,ITA,Atalanta,Serie A,2020,26.0,1994.0,1.2,1,0,0,1,0,1,1,100.0,0,3,2,1,4,5,3,0,DF,25-29,Defender,Italy,Europe
418,Luca Caldirola,ITA,Benevento,Serie A,2020,29.0,1991.0,17.5,21,13,13,6,2,10,22,45.5,12,20,15,5,20,41,56,0,DF,25-29,Defender,Italy,Europe
419,Duje Ćaleta-Car,CRO,Marseille,Ligue 1,2020,23.0,1996.0,31.3,29,17,19,9,1,17,30,56.7,13,29,22,7,44,73,130,0,DF,20-24,Defender,Croatia,Europe
420,Hakan Çalhanoğlu,TUR,Milan,Serie A,2020,26.0,1994.0,29.0,26,7,3,17,6,7,28,25.0,21,21,6,15,15,41,24,1,"MF,FW",25-29,Midfielder,Turkey,Asia
421,Kerim Calhanoglu,GER,Schalke 04,Bundesliga,2020,17.0,2002.0,3.3,3,3,1,1,1,0,3,0.0,3,4,0,4,7,10,6,0,DF,Under 20,Defender,Germany,Europe
422,Fabrizio Caligara,ITA,Cagliari,Serie A,2020,20.0,2000.0,2.0,6,4,2,2,2,6,9,66.7,3,9,2,7,3,9,3,0,"MF,FW",20-24,Midfielder,Italy,Europe
423,Daniel Caligiuri,ITA,Augsburg,Bundesliga,2020,32.0,1988.0,29.6,71,46,29,31,11,29,92,31.5,63,45,6,39,38,109,41,0,"MF,FW",30-34,Midfielder,Italy,Europe
425,Jonathan Calleri,ARG,Osasuna,La Liga,2020,26.0,1993.0,17.2,15,6,2,4,9,3,17,17.6,14,18,2,16,1,16,10,1,FW,25-29,Forward,Argentina,South America
426,Dominic Calvert-Lewin,ENG,Everton,Premier League,2020,23.0,1997.0,31.9,17,8,1,8,8,6,12,50.0,6,22,6,16,6,23,33,0,FW,20-24,Forward,England,Europe
428,Drissa Camara,CIV,Parma,Serie A,2020,18.0,2002.0,0.2,0,0,0,0,0,0,0,,0,0,0,0,0,0,0,0,MF,Under 20,Midfielder,Ivory Coast,Africa
429,Mahdi Camara,FRA,Saint-Étienne,Ligue 1,2020,22.0,1998.0,36.6,99,67,43,46,10,33,60,55.0,27,50,12,38,78,177,51,0,"MF,DF",20-24,Midfielder,France,Europe
430,Eduardo Camavinga,FRA,Rennes,Ligue 1,2020,17.0,2002.0,26.7,98,58,39,48,11,38,77,49.4,39,36,2,34,23,121,15,1,MF,Under 20,Midfielder,France,Europe
432,Emre Can,GER,Dortmund,Bundesliga,2020,26.0,1994.0,23.7,43,34,20,20,3,20,37,54.1,17,35,10,25,48,91,52,0,"DF,MF",25-29,Defender,Germany,Europe
434,João Cancelo,POR,Manchester City,Premier League,2020,26.0,1994.0,25.5,68,41,42,19,7,43,83,51.8,40,23,2,21,41,109,33,2,"DF,MF",25-29,Defender,Portugal,Europe
435,Antonio Candreva,ITA,Sampdoria,Serie A,2020,33.0,1987.0,27.8,28,19,17,9,2,21,53,39.6,32,24,3,21,9,37,27,1,MF,30-34,Midfielder,Italy,Europe
438,Pierrick Capelle,FRA,Angers,Ligue 1,2020,33.0,1987.0,22.8,53,28,24,17,12,31,79,39.2,48,25,1,24,47,100,32,0,"MF,DF",30-34,Midfielder,France,Europe
439,Étienne Capoue,FRA,Villarreal,La Liga,2020,32.0,1988.0,13.2,20,10,14,6,0,8,18,44.4,10,7,1,6,20,40,23,0,MF,30-34,Midfielder,France,Europe
440,Elio Capradossi,UGA,Spezia,Serie A,2020,24.0,1996.0,1.0,2,1,2,0,0,2,2,100.0,0,0,0,0,1,3,5,0,DF,20-24,Defender,Uganda,Africa
441,Gianluca Caprari,ITA,Benevento,Serie A,2020,27.0,1993.0,20.7,16,11,5,5,6,6,31,19.4,25,19,1,18,18,34,8,0,"MF,FW",25-29,Midfielder,Italy,Europe
442,Francesco Caputo,ITA,Sassuolo,Serie A,2020,32.0,1987.0,18.9,0,0,0,0,0,0,2,0.0,2,4,0,4,1,1,3,0,FW,30-34,Forward,Italy,Europe
443,Maxence Caqueret,FRA,Lyon,Ligue 1,2020,20.0,2000.0,19.6,72,45,17,39,16,35,106,33.0,71,35,3,32,23,95,5,2,MF,20-24,Midfielder,France,Europe
444,Andrea Carboni,ITA,Cagliari,Serie A,2020,19.0,2001.0,12.1,34,23,23,11,0,15,28,53.6,13,15,4,11,14,48,52,0,DF,Under 20,Defender,Italy,Europe
447,Irvin Cardona,FRA,Brest,Ligue 1,2020,22.0,1997.0,22.5,10,5,3,6,1,4,22,18.2,18,17,3,14,9,19,23,2,FW,20-24,Forward,France,Europe
449,Diego Carlos,BRA,Sevilla,La Liga,2020,27.0,1993.0,31.0,22,13,17,4,1,8,16,50.0,8,35,27,8,31,53,114,1,DF,25-29,Defender,Brazil,South America
451,Lionel Carole,FRA,Strasbourg,Ligue 1,2020,29.0,1991.0,14.9,37,25,18,14,5,16,29,55.2,13,3,1,2,38,75,28,0,DF,25-29,Defender,France,Europe
452,Yannick Carrasco,BEL,Atlético Madrid,La Liga,2020,26.0,1993.0,24.2,27,15,14,6,7,15,34,44.1,19,24,0,24,17,44,16,1,"DF,MF",25-29,Defender,Belgium,Europe
454,Guido Carrillo,ARG,Elche,La Liga,2020,29.0,1991.0,11.1,9,8,1,7,1,2,8,25.0,6,2,1,1,4,13,14,0,FW,25-29,Forward,Argentina,South America
455,Andy Carroll,ENG,Newcastle Utd,Premier League,2020,31.0,1989.0,4.4,3,1,1,1,1,1,8,12.5,7,1,0,1,0,3,14,0,FW,30-34,Forward,England,Europe
456,Scott Carson,ENG,Manchester City,Premier League,2020,34.0,1985.0,1.0,0,0,0,0,0,0,0,,0,0,0,0,0,0,0,0,GK,30-34,Goalkeeper,England,Europe
458,Fabio Carvalho,POR,Fulham,Premier League,2020,17.0,2002.0,2.8,9,6,4,4,1,5,9,55.6,4,2,0,2,1,10,1,1,"MF,FW",Under 20,Midfielder,Portugal,Europe
459,William Carvalho,POR,Betis,La Liga,2020,28.0,1992.0,13.6,19,12,7,11,1,5,21,23.8,16,11,3,8,11,30,14,1,MF,25-29,Midfielder,Portugal,Europe
460,Casemiro,BRA,Real Madrid,La Liga,2020,28.0,1992.0,32.2,84,49,50,30,4,33,73,45.2,40,50,17,33,70,154,62,0,MF,25-29,Midfielder,Brazil,South America
463,Giuseppe Caso,ITA,Genoa,Serie A,2020,21.0,1998.0,0.6,0,0,0,0,0,0,0,,0,0,0,0,0,0,0,0,"DF,FW",20-24,Defender,Italy,Europe
464,Moreto Cassamã,GNB,Reims,Ligue 1,2020,22.0,1998.0,22.6,49,36,24,23,2,27,49,55.1,22,19,6,13,36,85,33,4,MF,20-24,Midfielder,Guinea-Bissau,Africa
465,Francesco Cassata,ITA,Genoa,Serie A,2020,23.0,1997.0,2.5,7,6,7,0,0,4,7,57.1,3,0,0,0,3,10,1,0,"DF,FW",20-24,Defender,Italy,Europe
466,Timothy Castagne,BEL,Leicester City,Premier League,2020,24.0,1995.0,26.1,52,32,29,18,5,24,44,54.5,20,29,5,24,29,81,62,1,DF,20-24,Defender,Belgium,Europe
467,Koen Casteels,BEL,Wolfsburg,Bundesliga,2020,28.0,1992.0,32.0,0,0,0,0,0,0,1,0.0,1,1,0,1,2,2,9,2,GK,25-29,Goalkeeper,Belgium,Europe
468,Jean-Charles Castelletto,CMR,Nantes,Ligue 1,2020,25.0,1995.0,21.6,32,18,20,11,1,18,31,58.1,13,25,19,6,42,74,79,0,DF,25-29,Defender,Cameroon,Africa
470,Gonzalo Castro,GER,Stuttgart,Bundesliga,2020,33.0,1987.0,19.2,21,7,6,9,6,8,23,34.8,15,16,3,13,8,29,12,0,MF,30-34,Midfielder,Germany,Europe
472,Gaetano Castrovilli,ITA,Fiorentina,Serie A,2020,23.0,1997.0,25.9,33,19,15,11,7,11,42,26.2,31,25,2,23,34,67,14,0,MF,20-24,Midfielder,Italy,Europe
473,Danilo Cataldi,ITA,Lazio,Serie A,2020,25.0,1994.0,6.3,7,2,1,5,1,4,18,22.2,14,3,1,2,9,16,7,0,MF,25-29,Midfielder,Italy,Europe
474,Ivan Cavaleiro,POR,Fulham,Premier League,2020,26.0,1993.0,27.5,23,14,9,11,3,12,34,35.3,22,25,1,24,19,42,14,0,FW,25-29,Forward,Portugal,Europe
475,Edinson Cavani,URU,Manchester Utd,Premier League,2020,33.0,1987.0,15.3,12,8,1,8,3,2,13,15.4,11,2,0,2,6,18,11,0,FW,30-34,Forward,Uruguay,South America
477,Federico Ceccherini,ITA,Hellas Verona,Serie A,2020,28.0,1992.0,19.3,16,12,10,6,0,2,7,28.6,5,15,8,7,40,56,60,0,DF,25-29,Defender,Italy,Europe
478,Federico Ceccherini,ITA,Fiorentina,Serie A,2020,28.0,1992.0,3.0,4,1,1,3,0,1,1,100.0,0,6,5,1,7,11,15,0,DF,25-29,Defender,Italy,Europe
479,Zeki Çelik,TUR,Lille,Ligue 1,2020,23.0,1997.0,26.5,72,33,30,30,12,44,81,54.3,37,32,6,26,38,110,52,0,DF,20-24,Defender,Turkey,Asia
481,Fabien Centonze,FRA,Metz,Ligue 1,2020,24.0,1996.0,35.8,104,68,64,30,10,43,73,58.9,30,62,17,45,112,216,119,1,DF,20-24,Defender,France,Europe
482,Luca Ceppitelli,ITA,Cagliari,Serie A,2020,30.0,1989.0,16.3,25,19,13,10,2,14,26,53.8,12,23,12,11,25,50,58,1,DF,30-34,Defender,Italy,Europe
483,Alberto Cerri,ITA,Cagliari,Serie A,2020,24.0,1996.0,4.1,3,2,0,2,1,0,5,0.0,5,4,2,2,2,5,6,0,FW,20-24,Forward,Italy,Europe
485,Julian Chabot,GER,Spezia,Serie A,2020,22.0,1998.0,18.4,48,34,28,16,4,23,37,62.2,14,25,13,12,37,85,43,1,DF,20-24,Defender,Germany,Europe
486,Nassim Chadli,FRA,Nîmes,Ligue 1,2020,19.0,2001.0,0.3,2,1,2,0,0,0,1,0.0,1,1,0,1,0,2,0,0,"FW,MF",Under 20,Forward,France,Europe
487,Fouad Chafik,MAR,Dijon,Ligue 1,2020,33.0,1986.0,18.0,39,24,29,8,2,16,35,45.7,19,19,10,9,21,60,41,0,DF,30-34,Defender,Morocco,Africa
488,Mehdi Chahiri,MAR,Strasbourg,Ligue 1,2020,24.0,1996.0,8.9,18,8,7,5,6,8,20,40.0,12,9,0,9,6,24,5,0,"FW,MF",20-24,Forward,Morocco,Africa
489,Sofian Chakla,MAR,Villarreal,La Liga,2020,26.0,1993.0,0.1,0,0,0,0,0,0,0,,0,0,0,0,0,0,0,0,DF,25-29,Defender,Morocco,Africa
490,Sofian Chakla,MAR,Getafe,La Liga,2020,26.0,1993.0,10.0,12,8,10,1,1,5,7,71.4,2,3,2,1,14,26,48,1,DF,25-29,Defender,Morocco,Africa
491,Aníbal Chalá,ECU,Dijon,Ligue 1,2020,24.0,1996.0,8.3,10,7,6,3,1,6,12,50.0,6,5,3,2,14,24,15,1,DF,20-24,Defender,Ecuador,South America
492,Trevoh Chalobah,ENG,Lorient,Ligue 1,2020,21.0,1999.0,24.9,45,26,32,13,0,24,50,48.0,26,20,7,13,69,114,56,0,"DF,MF",20-24,Defender,England,Europe
493,Calum Chambers,ENG,Arsenal,Premier League,2020,25.0,1995.0,8.4,7,3,3,2,2,3,8,37.5,5,6,2,4,10,17,37,0,DF,25-29,Defender,England,Europe
494,Timothy Chandler,USA,Eint Frankfurt,Bundesliga,2020,30.0,1990.0,4.8,4,0,2,1,1,1,4,25.0,3,5,2,3,3,7,5,0,DF,30-34,Defender,United States,North America
495,Kwon Chang-hoon,KOR,Freiburg,Bundesliga,2020,26.0,1994.0,2.4,3,1,1,0,2,1,3,33.3,2,3,1,2,7,10,2,1,"MF,FW",25-29,Midfielder,South Korea,Asia
496,Gaëtan Charbonnier,FRA,Brest,Ligue 1,2020,31.0,1988.0,17.4,24,15,6,11,7,12,32,37.5,20,15,1,14,9,33,19,0,"MF,FW",30-34,Midfielder,France,Europe
497,Brendan Chardonnet,FRA,Brest,Ligue 1,2020,25.0,1994.0,30.2,51,29,31,19,1,27,41,65.9,14,54,41,13,64,115,151,0,DF,25-29,Defender,France,Europe
498,Xavier Chavalerin,FRA,Reims,Ligue 1,2020,29.0,1991.0,28.3,92,50,47,38,7,26,74,35.1,48,43,9,34,43,135,29,1,MF,25-29,Midfielder,France,Europe
499,Pape Cheikh Diop,SEN,Dijon,Ligue 1,2020,22.0,1997.0,12.1,24,14,15,6,3,13,33,39.4,20,14,2,12,6,30,6,0,MF,20-24,Midfielder,Senegal,Africa
501,Rayan Cherki,FRA,Lyon,Ligue 1,2020,16.0,2003.0,7.8,5,3,0,3,2,1,11,9.1,10,3,0,3,4,9,0,0,"FW,MF",Under 20,Forward,France,Europe
502,Denis Cheryshev,RUS,Valencia,La Liga,2020,29.0,1990.0,12.2,19,15,6,7,6,6,26,23.1,20,15,1,14,12,31,15,0,MF,25-29,Midfielder,Russia,Europe
503,Giorgio Chiellini,ITA,Juventus,Serie A,2020,35.0,1984.0,15.4,12,9,9,3,0,5,11,45.5,6,18,13,5,27,39,56,0,DF,35-39,Defender,Italy,Europe
504,Federico Chiesa,ITA,Fiorentina,Serie A,2020,22.0,1997.0,2.7,6,2,2,2,2,3,8,37.5,5,3,1,2,1,7,3,0,DF,20-24,Defender,Italy,Europe
505,Federico Chiesa,ITA,Juventus,Serie A,2020,22.0,1997.0,24.6,47,26,21,14,12,19,50,38.0,31,23,1,22,12,59,16,0,"MF,DF",20-24,Midfielder,Italy,Europe
506,Ben Chilwell,ENG,Chelsea,Premier League,2020,23.0,1996.0,25.4,42,22,16,22,4,15,33,45.5,18,28,3,25,24,66,58,0,DF,20-24,Defender,England,Europe
507,Vlad Chiricheș,ROU,Sassuolo,Serie A,2020,30.0,1989.0,20.4,38,23,34,3,1,21,35,60.0,14,31,21,10,50,88,59,2,DF,30-34,Defender,Romania,Europe
509,Tahith Chong,NED,Werder Bremen,Bundesliga,2020,20.0,1999.0,4.3,11,6,1,9,1,4,8,50.0,4,4,0,4,5,16,1,0,"MF,FW",20-24,Midfielder,Netherlands,Europe
510,Joris Chotard,FRA,Montpellier,Ligue 1,2020,18.0,2001.0,12.9,12,8,5,6,1,6,31,19.4,25,12,3,9,11,23,15,0,MF,Under 20,Midfielder,France,Europe
511,Hamza Choudhury,ENG,Leicester City,Premier League,2020,22.0,1997.0,3.5,8,7,3,5,0,4,10,40.0,6,4,1,3,4,12,9,1,MF,20-24,Midfielder,England,Europe
512,Mounir Chouiar,FRA,Dijon,Ligue 1,2020,21.0,1999.0,14.3,22,12,10,9,3,6,18,33.3,12,10,0,10,11,33,8,0,"FW,MF",20-24,Forward,France,Europe
513,Andreas Christensen,DEN,Chelsea,Premier League,2020,24.0,1996.0,15.2,11,6,8,3,0,0,8,0.0,8,19,14,5,20,31,51,1,DF,20-24,Defender,Denmark,Europe
514,Carney Chukwuemeka,ENG,Aston Villa,Premier League,2020,16.0,2003.0,0.2,2,2,1,0,1,1,3,33.3,2,0,0,0,0,2,0,0,"MF,FW",Under 20,Midfielder,England,Europe
515,Samuel Chukwueze,NGA,Villarreal,La Liga,2020,21.0,1999.0,15.2,12,7,4,4,4,3,17,17.6,14,8,0,8,10,22,3,0,"MF,FW",20-24,Midfielder,Nigeria,Africa
516,Darko Churlinov,MKD,Stuttgart,Bundesliga,2020,20.0,2000.0,2.4,2,2,2,0,0,1,3,33.3,2,5,1,4,0,2,2,0,"DF,MF",20-24,Defender,North Macedonia,Europe
518,Sébastien Cibois,FRA,Brest,Ligue 1,2020,22.0,1998.0,3.0,0,0,0,0,0,0,0,,0,0,0,0,0,0,0,1,GK,20-24,Goalkeeper,France,Europe
521,Luca Cigarini,ITA,Crotone,Serie A,2020,34.0,1986.0,10.3,26,14,11,12,3,12,28,42.9,16,10,1,9,12,38,9,0,MF,30-34,Midfielder,Italy,Europe
522,Jasper Cillessen,NED,Valencia,La Liga,2020,31.0,1989.0,10.0,0,0,0,0,0,0,0,,0,0,0,0,0,0,0,0,GK,30-34,Goalkeeper,Netherlands,Europe
523,Antonio Cioffi,ITA,Napoli,Serie A,2020,17.0,2002.0,0.1,0,0,0,0,0,0,0,,0,1,0,1,1,1,0,0,FW,Under 20,Forward,Italy,Europe
524,Tim Civeja,ALB,Augsburg,Bundesliga,2020,18.0,2002.0,0.4,0,0,0,0,0,0,1,0.0,1,0,0,0,3,3,0,0,MF,Under 20,Midfielder,Albania,Europe
525,Ciaran Clark,IRL,Newcastle Utd,Premier League,2020,30.0,1989.0,21.0,24,14,15,6,3,6,13,46.2,7,27,20,7,29,53,104,1,DF,30-34,Defender,Republic of Ireland,Europe
526,Alexis Claude-Maurice,FRA,Nice,Ligue 1,2020,22.0,1998.0,21.2,40,19,17,14,9,14,48,29.2,34,16,2,14,14,54,3,0,"MF,FW",20-24,Midfielder,France,Europe
527,Jonathan Clauss,FRA,Lens,Ligue 1,2020,27.0,1992.0,28.0,43,20,12,20,11,17,38,44.7,21,24,1,23,45,88,46,0,DF,25-29,Defender,France,Europe
529,Nathaniel Clyne,ENG,Crystal Palace,Premier League,2020,29.0,1991.0,12.7,17,10,8,8,1,9,16,56.3,7,7,2,5,18,35,25,1,DF,25-29,Defender,England,Europe
530,Conor Coady,ENG,Wolves,Premier League,2020,27.0,1993.0,36.7,35,23,25,10,0,19,35,54.3,16,40,32,8,27,62,134,2,DF,25-29,Defender,England,Europe
531,Marcus Coco,FRA,Nantes,Ligue 1,2020,24.0,1996.0,16.4,36,21,17,15,4,16,36,44.4,20,16,3,13,20,56,17,0,"MF,FW",20-24,Midfielder,France,Europe
533,Séamus Coleman,IRL,Everton,Premier League,2020,31.0,1988.0,17.9,39,26,21,14,4,21,30,70.0,9,22,6,16,13,52,37,2,"DF,MF",30-34,Defender,Republic of Ireland,Europe
534,Ebrima Colley,GAM,Hellas Verona,Serie A,2020,20.0,2000.0,8.2,11,4,2,6,3,3,11,27.3,8,6,0,6,6,17,1,0,"MF,FW",20-24,Midfielder,Gambia,Africa
535,Omar Colley,GAM,Sampdoria,Serie A,2020,27.0,1992.0,28.8,28,16,19,8,1,13,23,56.5,10,43,29,14,68,96,133,1,DF,25-29,Defender,Gambia,Africa
536,Simone Colombi,ITA,Parma,Serie A,2020,29.0,1991.0,2.0,0,0,0,0,0,0,0,,0,0,0,0,0,0,2,0,GK,25-29,Goalkeeper,Italy,Europe
537,Lorenzo Colombo,ITA,Milan,Serie A,2020,18.0,2002.0,1.0,2,1,1,1,0,0,3,0.0,3,0,0,0,0,2,3,0,FW,Under 20,Forward,Italy,Europe
538,Racine Coly,SEN,Nice,Ligue 1,2020,24.0,1995.0,0.2,0,0,0,0,0,0,0,,0,0,0,0,0,0,0,0,MF,20-24,Midfielder,Senegal,Africa
539,Kingsley Coman,FRA,Bayern Munich,Bundesliga,2020,24.0,1996.0,19.5,14,8,6,7,1,2,21,9.5,19,22,0,22,4,18,3,0,"FW,MF",20-24,Forward,France,Europe
540,Daniel Congré,FRA,Montpellier,Ligue 1,2020,35.0,1985.0,36.6,59,35,45,12,2,36,70,51.4,34,50,33,17,69,128,144,3,DF,35-39,Defender,France,Europe
541,Aaron Connolly,IRL,Brighton,Premier League,2020,20.0,2000.0,8.8,6,3,1,3,2,0,2,0.0,2,4,0,4,0,6,2,0,FW,20-24,Forward,Republic of Ireland,Europe
542,Andrea Consigli,ITA,Sassuolo,Serie A,2020,33.0,1987.0,37.0,2,2,2,0,0,2,2,100.0,0,0,0,0,0,2,14,4,GK,30-34,Goalkeeper,Italy,Europe
543,Andrea Conti,ITA,Milan,Serie A,2020,26.0,1994.0,0.3,1,1,1,0,0,0,1,0.0,1,0,0,0,1,2,0,0,DF,25-29,Defender,Italy,Europe
544,Andrea Conti,ITA,Parma,Serie A,2020,26.0,1994.0,9.0,21,10,16,4,1,13,26,50.0,13,13,4,9,16,37,23,0,DF,25-29,Defender,Italy,Europe
545,Liam Cooper,SCO,Leeds United,Premier League,2020,28.0,1991.0,24.3,68,45,39,27,2,37,59,62.7,22,39,32,7,61,129,70,1,DF,25-29,Defender,Scotland,Europe
546,Francis Coquelin,FRA,Villarreal,La Liga,2020,29.0,1991.0,8.2,19,14,4,12,3,8,19,42.1,11,8,2,6,21,40,11,1,MF,25-29,Midfielder,France,Europe
547,Theo Corbeanu,CAN,Wolves,Premier League,2020,18.0,2002.0,0.1,2,1,0,2,0,1,1,100.0,0,0,0,0,1,3,0,0,FW,Under 20,Forward,Canada,North America
548,Sébastien Corchia,FRA,Nantes,Ligue 1,2020,29.0,1990.0,23.0,55,30,29,17,9,33,60,55.0,27,28,10,18,38,93,40,1,DF,25-29,Defender,France,Europe
549,Alex Cordaz,ITA,Crotone,Serie A,2020,37.0,1983.0,36.0,0,0,0,0,0,0,0,,0,0,0,0,1,1,7,2,GK,35-39,Goalkeeper,Italy,Europe
552,Jhon Córdoba,COL,Hertha BSC,Bundesliga,2020,27.0,1993.0,17.1,9,4,1,5,3,2,4,50.0,2,13,2,11,6,15,4,0,FW,25-29,Forward,Colombia,South America
553,Sergio Córdova,VEN,Arminia,Bundesliga,2020,22.0,1997.0,12.1,16,8,0,10,6,2,15,13.3,13,14,3,11,9,25,9,0,"FW,MF",20-24,Forward,Venezuela,South America
554,Jack Cork,ENG,Burnley,Premier League,2020,31.0,1989.0,15.0,26,10,5,17,4,11,31,35.5,20,15,4,11,16,42,20,0,MF,30-34,Midfielder,England,Europe
555,Andreas Cornelius,DEN,Parma,Serie A,2020,27.0,1993.0,21.1,11,4,1,5,5,2,12,16.7,10,9,2,7,1,12,25,1,FW,25-29,Forward,Denmark,Europe
556,Maxwel Cornet,CIV,Lyon,Ligue 1,2020,23.0,1996.0,27.2,70,41,39,24,7,33,58,56.9,25,23,5,18,43,113,47,2,"DF,FW",20-24,Defender,Ivory Coast,Africa
557,Ángel Correa,ARG,Atlético Madrid,La Liga,2020,25.0,1995.0,26.6,38,21,10,23,5,15,45,33.3,30,18,1,17,22,60,16,0,"FW,MF",25-29,Forward,Argentina,South America
558,Joaquín Correa,ARG,Lazio,Serie A,2020,25.0,1994.0,21.5,21,12,6,11,4,7,25,28.0,18,14,0,14,7,28,12,0,FW,25-29,Forward,Argentina,South America
560,Félix Correia,POR,Juventus,Serie A,2020,19.0,2001.0,0.1,0,0,0,0,0,0,0,,0,0,0,0,0,0,1,0,MF,Under 20,Midfielder,Portugal,Europe
561,Thierry Correia,POR,Valencia,La Liga,2020,21.0,1999.0,23.7,47,27,32,10,5,21,43,48.8,22,24,6,18,42,89,63,1,DF,20-24,Defender,Portugal,Europe
562,Danny da Costa,GER,Mainz 05,Bundesliga,2020,27.0,1993.0,13.4,22,16,6,9,7,13,27,48.1,14,17,2,15,17,39,27,0,"DF,FW",25-29,Defender,Germany,Europe
563,Danny da Costa,GER,Eint Frankfurt,Bundesliga,2020,27.0,1993.0,1.2,0,0,0,0,0,0,1,0.0,1,3,1,2,0,0,4,0,DF,25-29,Defender,Germany,Europe
564,David Costa,POR,Lens,Ligue 1,2020,19.0,2001.0,1.7,4,4,1,2,1,2,3,66.7,1,2,0,2,0,4,4,0,"MF,FW",Under 20,Midfielder,Portugal,Europe
566,Douglas Costa,BRA,Juventus,Serie A,2020,29.0,1990.0,0.5,1,0,1,0,0,1,3,33.3,2,0,0,0,0,1,0,0,"MF,FW",25-29,Midfielder,Brazil,South America
567,Douglas Costa,BRA,Bayern Munich,Bundesliga,2020,29.0,1990.0,3.6,2,1,1,1,0,1,3,33.3,2,7,0,7,2,4,1,0,"FW,MF",25-29,Forward,Brazil,South America
568,Hélder Costa,ANG,Leeds United,Premier League,2020,26.0,1994.0,12.8,25,11,12,5,8,11,32,34.4,21,11,0,11,3,28,5,1,"MF,FW",25-29,Midfielder,Angola,Africa
570,Angelo da Costa Júnior,BRA,Bologna,Serie A,2020,36.0,1983.0,6.0,0,0,0,0,0,0,0,,0,0,0,0,0,0,2,3,GK,35-39,Goalkeeper,Brazil,South America
571,Charles Costes,FRA,Dijon,Ligue 1,2020,17.0,2002.0,0.0,0,0,0,0,0,0,0,,0,0,0,0,0,0,0,0,MF,Under 20,Midfielder,France,Europe
572,Benoît Costil,FRA,Bordeaux,Ligue 1,2020,33.0,1987.0,38.0,1,1,1,0,0,1,3,33.3,2,1,0,1,1,2,17,0,GK,30-34,Goalkeeper,France,Europe
574,Kalifa Coulibaly,MLI,Nantes,Ligue 1,2020,28.0,1991.0,10.9,3,1,0,1,2,2,8,25.0,6,3,1,2,2,5,12,0,FW,25-29,Forward,Mali,Africa
575,Lassana Coulibaly,MLI,Angers,Ligue 1,2020,24.0,1996.0,18.7,78,41,33,34,11,39,75,52.0,36,29,4,25,33,111,17,0,MF,20-24,Midfielder,Mali,Africa
576,Mamadou Coulibaly,SEN,Udinese,Serie A,2020,21.0,1999.0,2.0,10,8,5,5,0,0,0,,0,2,0,2,1,11,0,0,MF,20-24,Midfielder,Senegal,Africa
576,Mamadou Coulibaly,SEN,Udinese,Serie A,2020,21.0,1999.0,2.0,10,8,5,5,0,0,0,,0,2,0,2,1,11,0,0,MF,20-24,Midfielder,Senegal,Africa
576,Mamadou Coulibaly,SEN,Udinese,Serie A,2020,21.0,1999.0,2.0,10,8,5,5,0,0,0,,0,2,0,2,1,11,0,0,MF,20-24,Midfielder,Senegal,Africa
576,Mamadou Coulibaly,SEN,Udinese,Serie A,2020,21.0,1999.0,2.0,10,8,5,5,0,0,0,,0,2,0,2,1,11,0,0,MF,20-24,Midfielder,Senegal,Africa
577,Senou Coulibaly,MLI,Dijon,Ligue 1,2020,25.0,1994.0,21.5,33,21,23,10,0,12,24,50.0,12,18,12,6,30,63,89,0,DF,25-29,Defender,Mali,Africa
578,Tanguy Coulibaly,FRA,Stuttgart,Bundesliga,2020,19.0,2001.0,16.7,26,15,10,7,9,11,23,47.8,12,20,0,20,10,36,11,0,"DF,FW",Under 20,Defender,France,Europe
579,Thibaut Courtois,BEL,Real Madrid,La Liga,2020,28.0,1992.0,38.0,0,0,0,0,0,0,1,0.0,1,1,0,1,1,1,17,2,GK,25-29,Goalkeeper,Belgium,Europe
580,Philippe Coutinho,BRA,Barcelona,La Liga,2020,28.0,1992.0,7.3,8,6,2,5,1,3,9,33.3,6,7,0,7,2,10,1,0,"MF,FW",25-29,Midfielder,Brazil,South America
581,Nicolas Cozza,FRA,Montpellier,Ligue 1,2020,21.0,1999.0,15.2,39,30,27,11,1,20,40,50.0,20,20,11,9,26,65,62,0,DF,20-24,Defender,France,Europe
582,Alessio Cragno,ITA,Cagliari,Serie A,2020,26.0,1994.0,34.0,0,0,0,0,0,0,1,0.0,1,0,0,0,1,1,10,0,GK,25-29,Goalkeeper,Italy,Europe
583,Gian Crespi,ITA,Crotone,Serie A,2020,19.0,2001.0,1.0,0,0,0,0,0,0,0,,0,0,0,0,0,0,0,0,GK,Under 20,Goalkeeper,Italy,Europe
584,Aaron Cresswell,ENG,West Ham,Premier League,2020,30.0,1989.0,35.2,32,13,15,15,2,18,32,56.3,14,29,14,15,32,64,79,2,DF,30-34,Defender,England,Europe
585,Domenico Criscito,ITA,Genoa,Serie A,2020,33.0,1986.0,19.2,43,22,29,11,3,22,39,56.4,17,27,14,13,44,87,51,0,DF,30-34,Defender,Italy,Europe
586,Bryan Cristante,ITA,Roma,Serie A,2020,25.0,1995.0,23.9,27,20,10,14,3,10,28,35.7,18,21,7,14,40,67,61,1,"DF,MF",25-29,Defender,Italy,Europe
587,Giovanni Crociata,ITA,Crotone,Serie A,2020,22.0,1997.0,0.3,1,0,0,1,0,0,1,0.0,1,1,0,1,0,1,0,0,DF,20-24,Defender,Italy,Europe
589,Juan Cuadrado,COL,Juventus,Serie A,2020,32.0,1988.0,24.2,43,25,22,15,6,29,60,48.3,31,16,2,14,43,86,22,2,"DF,MF",30-34,Defender,Colombia,South America
590,Andrés Cubas,PAR,Nîmes,Ligue 1,2020,24.0,1996.0,24.9,80,47,30,44,6,33,74,44.6,41,37,10,27,50,130,29,3,MF,20-24,Midfielder,Paraguay,South America
592,Cucho,COL,Getafe,La Liga,2020,21.0,1999.0,16.3,19,10,1,14,4,2,23,8.7,21,18,1,17,6,25,8,0,"FW,MF",20-24,Forward,Colombia,South America
594,Mickaël Cuisance,FRA,Marseille,Ligue 1,2020,20.0,1999.0,11.4,24,11,2,15,7,10,33,30.3,23,13,1,12,3,27,4,0,MF,20-24,Midfielder,France,Europe
595,Mickaël Cuisance,FRA,Bayern Munich,Bundesliga,2020,20.0,1999.0,0.2,0,0,0,0,0,0,0,,0,1,0,1,0,0,0,0,FW,20-24,Forward,France,Europe
596,Matheus Cunha,BRA,Hertha BSC,Bundesliga,2020,21.0,1999.0,23.9,36,16,10,19,7,13,49,26.5,36,29,2,27,31,67,9,0,"FW,MF",20-24,Forward,Brazil,South America
597,Giuseppe Cuomo,ITA,Crotone,Serie A,2020,22.0,1998.0,8.9,26,19,17,9,0,9,14,64.3,5,10,2,8,18,44,19,1,DF,20-24,Defender,Italy,Europe
598,Patrick Cutrone,ITA,Wolves,Premier League,2020,22.0,1998.0,0.3,0,0,0,0,0,0,0,,0,0,0,0,0,0,0,0,FW,20-24,Forward,Italy,Europe
599,Patrick Cutrone,ITA,Fiorentina,Serie A,2020,22.0,1998.0,2.2,4,3,1,2,1,1,2,50.0,1,1,0,1,1,5,0,0,FW,20-24,Forward,Italy,Europe
600,Patrick Cutrone,ITA,Valencia,La Liga,2020,22.0,1998.0,1.2,0,0,0,0,0,0,1,0.0,1,0,0,0,1,1,0,0,FW,20-24,Forward,Italy,Europe
601,Wylan Cyprien,FRA,Parma,Serie A,2020,25.0,1995.0,4.6,9,4,5,3,1,2,4,50.0,2,13,8,5,5,14,6,1,MF,25-29,Midfielder,France,Europe
602,Rafael Czichos,GER,Köln,Bundesliga,2020,30.0,1990.0,25.1,48,24,33,13,2,23,42,54.8,19,25,9,16,53,101,109,0,DF,30-34,Defender,Germany,Europe
603,Lennart-Marten Czyborra,GER,Genoa,Serie A,2020,21.0,1999.0,13.0,19,10,7,7,5,11,19,57.9,8,6,1,5,17,36,27,0,DF,20-24,Defender,Germany,Europe
604,Danilo D'Ambrosio,ITA,Inter,Serie A,2020,31.0,1988.0,7.8,15,9,6,7,2,6,15,40.0,9,9,7,2,4,19,15,0,DF,30-34,Defender,Italy,Europe
605,Damien Da Silva,FRA,Rennes,Ligue 1,2020,32.0,1988.0,29.6,22,13,13,8,1,12,18,66.7,6,17,13,4,44,66,99,1,DF,30-34,Defender,France,Europe
606,Moanes Dabbur,ISR,Hoffenheim,Bundesliga,2020,28.0,1992.0,11.1,6,3,3,1,2,1,13,7.7,12,6,0,6,9,15,7,0,"FW,MF",25-29,Forward,Israel,Asia
607,Bryan Dabo,BFA,Benevento,Serie A,2020,28.0,1992.0,12.4,11,8,5,3,3,5,16,31.3,11,7,1,6,13,24,16,0,MF,25-29,Midfielder,Burkina Faso,Africa
608,Colin Dagba,FRA,Paris S-G,Ligue 1,2020,21.0,1998.0,15.1,23,11,4,17,2,14,19,73.7,5,18,5,13,16,39,18,1,DF,20-24,Defender,France,Europe
609,Finn Dahmen,GER,Mainz 05,Bundesliga,2020,22.0,1998.0,3.0,0,0,0,0,0,0,1,0.0,1,0,0,0,0,0,1,0,GK,20-24,Goalkeeper,Germany,Europe
610,Mahmoud Dahoud,GER,Dortmund,Bundesliga,2020,24.0,1996.0,14.0,30,18,9,20,1,14,38,36.8,24,23,5,18,18,48,11,1,MF,20-24,Midfielder,Germany,Europe
611,Leon Dajaku,GER,Union Berlin,Bundesliga,2020,19.0,2001.0,0.4,0,0,0,0,0,0,0,,0,0,0,0,0,0,0,0,FW,Under 20,Forward,Germany,Europe
613,Diogo Dalot,POR,Milan,Serie A,2020,21.0,1999.0,12.1,32,17,23,6,3,17,34,50.0,17,18,5,13,25,57,42,0,DF,20-24,Defender,Portugal,Europe
614,Mikkel Damsgaard,DEN,Sampdoria,Serie A,2020,20.0,2000.0,19.7,42,21,14,20,8,22,70,31.4,48,40,4,36,24,66,17,0,"MF,FW",20-24,Midfielder,Denmark,Europe
615,Flavius Daniliuc,AUT,Nice,Ligue 1,2020,19.0,2001.0,16.4,23,15,15,5,3,10,21,47.6,11,17,6,11,14,37,32,0,DF,Under 20,Defender,Austria,Europe
616,Danilo,BRA,Juventus,Serie A,2020,29.0,1991.0,32.4,62,31,37,16,9,35,66,53.0,31,32,12,20,66,128,68,2,"DF,MF",25-29,Defender,Brazil,South America
616,Danilo,BRA,Juventus,Serie A,2020,29.0,1991.0,32.4,62,31,37,16,9,35,66,53.0,31,32,12,20,66,128,68,2,"DF,MF",25-29,Defender,Brazil,South America
616,Danilo,BRA,Juventus,Serie A,2020,29.0,1991.0,32.4,62,31,37,16,9,35,66,53.0,31,32,12,20,66,128,68,2,"DF,MF",25-29,Defender,Brazil,South America
616,Danilo,BRA,Juventus,Serie A,2020,29.0,1991.0,32.4,62,31,37,16,9,35,66,53.0,31,32,12,20,66,128,68,2,"DF,MF",25-29,Defender,Brazil,South America
616,Danilo,BRA,Juventus,Serie A,2020,29.0,1991.0,32.4,62,31,37,16,9,35,66,53.0,31,32,12,20,66,128,68,2,"DF,MF",25-29,Defender,Brazil,South America
616,Danilo,BRA,Juventus,Serie A,2020,29.0,1991.0,32.4,62,31,37,16,9,35,66,53.0,31,32,12,20,66,128,68,2,"DF,MF",25-29,Defender,Brazil,South America
616,Danilo,BRA,Juventus,Serie A,2020,29.0,1991.0,32.4,62,31,37,16,9,35,66,53.0,31,32,12,20,66,128,68,2,"DF,MF",25-29,Defender,Brazil,South America
616,Danilo,BRA,Juventus,Serie A,2020,29.0,1991.0,32.4,62,31,37,16,9,35,66,53.0,31,32,12,20,66,128,68,2,"DF,MF",25-29,Defender,Brazil,South America
616,Danilo,BRA,Juventus,Serie A,2020,29.0,1991.0,32.4,62,31,37,16,9,35,66,53.0,31,32,12,20,66,128,68,2,"DF,MF",25-29,Defender,Brazil,South America
616,Danilo,BRA,Juventus,Serie A,2020,29.0,1991.0,32.4,62,31,37,16,9,35,66,53.0,31,32,12,20,66,128,68,2,"DF,MF",25-29,Defender,Brazil,South America
616,Danilo,BRA,Juventus,Serie A,2020,29.0,1991.0,32.4,62,31,37,16,9,35,66,53.0,31,32,12,20,66,128,68,2,"DF,MF",25-29,Defender,Brazil,South America
616,Danilo,BRA,Juventus,Serie A,2020,29.0,1991.0,32.4,62,31,37,16,9,35,66,53.0,31,32,12,20,66,128,68,2,"DF,MF",25-29,Defender,Brazil,South America
616,Danilo,BRA,Juventus,Serie A,2020,29.0,1991.0,32.4,62,31,37,16,9,35,66,53.0,31,32,12,20,66,128,68,2,"DF,MF",25-29,Defender,Brazil,South America
616,Danilo,BRA,Juventus,Serie A,2020,29.0,1991.0,32.4,62,31,37,16,9,35,66,53.0,31,32,12,20,66,128,68,2,"DF,MF",25-29,Defender,Brazil,South America
616,Danilo,BRA,Juventus,Serie A,2020,29.0,1991.0,32.4,62,31,37,16,9,35,66,53.0,31,32,12,20,66,128,68,2,"DF,MF",25-29,Defender,Brazil,South America
616,Danilo,BRA,Juventus,Serie A,2020,29.0,1991.0,32.4,62,31,37,16,9,35,66,53.0,31,32,12,20,66,128,68,2,"DF,MF",25-29,Defender,Brazil,South America
616,Danilo,BRA,Juventus,Serie A,2020,29.0,1991.0,32.4,62,31,37,16,9,35,66,53.0,31,32,12,20,66,128,68,2,"DF,MF",25-29,Defender,Brazil,South America
616,Danilo,BRA,Juventus,Serie A,2020,29.0,1991.0,32.4,62,31,37,16,9,35,66,53.0,31,32,12,20,66,128,68,2,"DF,MF",25-29,Defender,Brazil,South America
616,Danilo,BRA,Juventus,Serie A,2020,29.0,1991.0,32.4,62,31,37,16,9,35,66,53.0,31,32,12,20,66,128,68,2,"DF,MF",25-29,Defender,Brazil,South America
616,Danilo,BRA,Juventus,Serie A,2020,29.0,1991.0,32.4,62,31,37,16,9,35,66,53.0,31,32,12,20,66,128,68,2,"DF,MF",25-29,Defender,Brazil,South America
616,Danilo,BRA,Juventus,Serie A,2020,29.0,1991.0,32.4,62,31,37,16,9,35,66,53.0,31,32,12,20,66,128,68,2,"DF,MF",25-29,Defender,Brazil,South America
616,Danilo,BRA,Juventus,Serie A,2020,29.0,1991.0,32.4,62,31,37,16,9,35,66,53.0,31,32,12,20,66,128,68,2,"DF,MF",25-29,Defender,Brazil,South America
616,Danilo,BRA,Juventus,Serie A,2020,29.0,1991.0,32.4,62,31,37,16,9,35,66,53.0,31,32,12,20,66,128,68,2,"DF,MF",25-29,Defender,Brazil,South America
616,Danilo,BRA,Juventus,Serie A,2020,29.0,1991.0,32.4,62,31,37,16,9,35,66,53.0,31,32,12,20,66,128,68,2,"DF,MF",25-29,Defender,Brazil,South America
616,Danilo,BRA,Juventus,Serie A,2020,29.0,1991.0,32.4,62,31,37,16,9,35,66,53.0,31,32,12,20,66,128,68,2,"DF,MF",25-29,Defender,Brazil,South America
616,Danilo,BRA,Juventus,Serie A,2020,29.0,1991.0,32.4,62,31,37,16,9,35,66,53.0,31,32,12,20,66,128,68,2,"DF,MF",25-29,Defender,Brazil,South America
616,Danilo,BRA,Juventus,Serie A,2020,29.0,1991.0,32.4,62,31,37,16,9,35,66,53.0,31,32,12,20,66,128,68,2,"DF,MF",25-29,Defender,Brazil,South America
616,Danilo,BRA,Juventus,Serie A,2020,29.0,1991.0,32.4,62,31,37,16,9,35,66,53.0,31,32,12,20,66,128,68,2,"DF,MF",25-29,Defender,Brazil,South America
616,Danilo,BRA,Juventus,Serie A,2020,29.0,1991.0,32.4,62,31,37,16,9,35,66,53.0,31,32,12,20,66,128,68,2,"DF,MF",25-29,Defender,Brazil,South America
616,Danilo,BRA,Juventus,Serie A,2020,29.0,1991.0,32.4,62,31,37,16,9,35,66,53.0,31,32,12,20,66,128,68,2,"DF,MF",25-29,Defender,Brazil,South America
616,Danilo,BRA,Juventus,Serie A,2020,29.0,1991.0,32.4,62,31,37,16,9,35,66,53.0,31,32,12,20,66,128,68,2,"DF,MF",25-29,Defender,Brazil,South America
616,Danilo,BRA,Juventus,Serie A,2020,29.0,1991.0,32.4,62,31,37,16,9,35,66,53.0,31,32,12,20,66,128,68,2,"DF,MF",25-29,Defender,Brazil,South America
616,Danilo,BRA,Juventus,Serie A,2020,29.0,1991.0,32.4,62,31,37,16,9,35,66,53.0,31,32,12,20,66,128,68,2,"DF,MF",25-29,Defender,Brazil,South America
616,Danilo,BRA,Juventus,Serie A,2020,29.0,1991.0,32.4,62,31,37,16,9,35,66,53.0,31,32,12,20,66,128,68,2,"DF,MF",25-29,Defender,Brazil,South America
616,Danilo,BRA,Juventus,Serie A,2020,29.0,1991.0,32.4,62,31,37,16,9,35,66,53.0,31,32,12,20,66,128,68,2,"DF,MF",25-29,Defender,Brazil,South America
616,Danilo,BRA,Juventus,Serie A,2020,29.0,1991.0,32.4,62,31,37,16,9,35,66,53.0,31,32,12,20,66,128,68,2,"DF,MF",25-29,Defender,Brazil,South America
616,Danilo,BRA,Juventus,Serie A,2020,29.0,1991.0,32.4,62,31,37,16,9,35,66,53.0,31,32,12,20,66,128,68,2,"DF,MF",25-29,Defender,Brazil,South America
616,Danilo,BRA,Juventus,Serie A,2020,29.0,1991.0,32.4,62,31,37,16,9,35,66,53.0,31,32,12,20,66,128,68,2,"DF,MF",25-29,Defender,Brazil,South America
616,Danilo,BRA,Juventus,Serie A,2020,29.0,1991.0,32.4,62,31,37,16,9,35,66,53.0,31,32,12,20,66,128,68,2,"DF,MF",25-29,Defender,Brazil,South America
616,Danilo,BRA,Juventus,Serie A,2020,29.0,1991.0,32.4,62,31,37,16,9,35,66,53.0,31,32,12,20,66,128,68,2,"DF,MF",25-29,Defender,Brazil,South America
616,Danilo,BRA,Juventus,Serie A,2020,29.0,1991.0,32.4,62,31,37,16,9,35,66,53.0,31,32,12,20,66,128,68,2,"DF,MF",25-29,Defender,Brazil,South America
616,Danilo,BRA,Juventus,Serie A,2020,29.0,1991.0,32.4,62,31,37,16,9,35,66,53.0,31,32,12,20,66,128,68,2,"DF,MF",25-29,Defender,Brazil,South America
616,Danilo,BRA,Juventus,Serie A,2020,29.0,1991.0,32.4,62,31,37,16,9,35,66,53.0,31,32,12,20,66,128,68,2,"DF,MF",25-29,Defender,Brazil,South America
616,Danilo,BRA,Juventus,Serie A,2020,29.0,1991.0,32.4,62,31,37,16,9,35,66,53.0,31,32,12,20,66,128,68,2,"DF,MF",25-29,Defender,Brazil,South America
616,Danilo,BRA,Juventus,Serie A,2020,29.0,1991.0,32.4,62,31,37,16,9,35,66,53.0,31,32,12,20,66,128,68,2,"DF,MF",25-29,Defender,Brazil,South America
616,Danilo,BRA,Juventus,Serie A,2020,29.0,1991.0,32.4,62,31,37,16,9,35,66,53.0,31,32,12,20,66,128,68,2,"DF,MF",25-29,Defender,Brazil,South America
616,Danilo,BRA,Juventus,Serie A,2020,29.0,1991.0,32.4,62,31,37,16,9,35,66,53.0,31,32,12,20,66,128,68,2,"DF,MF",25-29,Defender,Brazil,South America
616,Danilo,BRA,Juventus,Serie A,2020,29.0,1991.0,32.4,62,31,37,16,9,35,66,53.0,31,32,12,20,66,128,68,2,"DF,MF",25-29,Defender,Brazil,South America
616,Danilo,BRA,Juventus,Serie A,2020,29.0,1991.0,32.4,62,31,37,16,9,35,66,53.0,31,32,12,20,66,128,68,2,"DF,MF",25-29,Defender,Brazil,South America
617,Scott Dann,ENG,Crystal Palace,Premier League,2020,33.0,1987.0,15.0,6,4,5,1,0,4,11,36.4,7,16,14,2,18,24,59,1,DF,30-34,Defender,England,Europe
618,Tiago Dantas,POR,Bayern Munich,Bundesliga,2020,19.0,2000.0,0.8,1,1,0,0,1,0,0,,0,0,0,0,0,1,0,0,MF,Under 20,Midfielder,Portugal,Europe
619,Dante,BRA,Nice,Ligue 1,2020,36.0,1983.0,8.6,10,5,6,4,0,3,7,42.9,4,6,4,2,10,20,20,0,DF,35-39,Defender,Brazil,South America
620,Andrea Danzi,ITA,Hellas Verona,Serie A,2020,21.0,1999.0,1.2,0,0,0,0,0,0,1,0.0,1,0,0,0,3,3,1,0,DF,20-24,Defender,Italy,Europe
621,Ebrima Darboe,GAM,Roma,Serie A,2020,19.0,2001.0,3.6,5,2,3,1,1,3,10,30.0,7,3,0,3,8,13,0,1,MF,Under 20,Midfielder,Gambia,Africa
622,Márton Dárdai,HUN,Hertha BSC,Bundesliga,2020,18.0,2002.0,9.1,17,10,10,6,1,9,16,56.3,7,7,3,4,16,33,31,0,"DF,MF",Under 20,Defender,Hungary,Europe
624,Karl Darlow,WAL,Newcastle Utd,Premier League,2020,29.0,1990.0,25.0,0,0,0,0,0,0,0,,0,0,0,0,0,0,17,0,GK,25-29,Goalkeeper,Wales,Europe
625,Matteo Darmian,ITA,Parma,Serie A,2020,30.0,1989.0,2.3,6,5,3,3,0,4,7,57.1,3,2,0,2,6,12,7,0,DF,30-34,Defender,Italy,Europe
626,Matteo Darmian,ITA,Inter,Serie A,2020,30.0,1989.0,12.9,30,16,12,7,11,16,28,57.1,12,9,2,7,17,47,35,0,DF,30-34,Defender,Italy,Europe
627,Jonathan David,CAN,Lille,Ligue 1,2020,20.0,2000.0,26.2,17,10,5,5,7,9,24,37.5,15,19,1,18,3,20,9,0,FW,20-24,Forward,Canada,North America
628,Alphonso Davies,CAN,Bayern Munich,Bundesliga,2020,19.0,2000.0,19.6,39,27,16,17,6,28,40,70.0,12,21,1,20,28,67,33,1,DF,Under 20,Defender,Canada,North America
629,Ben Davies,WAL,Tottenham,Premier League,2020,27.0,1993.0,15.0,27,17,10,11,6,13,30,43.3,17,10,5,5,18,45,49,2,DF,25-29,Defender,Wales,Europe
629,Ben Davies,WAL,Tottenham,Premier League,2020,27.0,1993.0,15.0,27,17,10,11,6,13,30,43.3,17,10,5,5,18,45,49,2,DF,25-29,Defender,Wales,Europe
629,Ben Davies,WAL,Tottenham,Premier League,2020,27.0,1993.0,15.0,27,17,10,11,6,13,30,43.3,17,10,5,5,18,45,49,2,DF,25-29,Defender,Wales,Europe
629,Ben Davies,WAL,Tottenham,Premier League,2020,27.0,1993.0,15.0,27,17,10,11,6,13,30,43.3,17,10,5,5,18,45,49,2,DF,25-29,Defender,Wales,Europe
630,Tom Davies,ENG,Everton,Premier League,2020,22.0,1998.0,15.8,31,18,17,12,2,16,39,41.0,23,15,9,6,34,65,21,2,MF,20-24,Midfielder,England,Europe
630,Tom Davies,ENG,Everton,Premier League,2020,22.0,1998.0,15.8,31,18,17,12,2,16,39,41.0,23,15,9,6,34,65,21,2,MF,20-24,Midfielder,England,Europe
630,Tom Davies,ENG,Everton,Premier League,2020,22.0,1998.0,15.8,31,18,17,12,2,16,39,41.0,23,15,9,6,34,65,21,2,MF,20-24,Midfielder,England,Europe
630,Tom Davies,ENG,Everton,Premier League,2020,22.0,1998.0,15.8,31,18,17,12,2,16,39,41.0,23,15,9,6,34,65,21,2,MF,20-24,Midfielder,England,Europe
631,Keinan Davis,ENG,Aston Villa,Premier League,2020,22.0,1998.0,3.1,2,1,1,0,1,0,1,0.0,1,1,0,1,0,2,2,0,"FW,MF",20-24,Forward,England,Europe
632,Leif Davis,ENG,Leeds United,Premier League,2020,20.0,2000.0,0.4,0,0,0,0,0,0,3,0.0,3,1,0,1,1,1,0,0,DF,20-24,Defender,England,Europe
634,Craig Dawson,ENG,West Ham,Premier League,2020,30.0,1990.0,21.4,11,8,7,4,0,5,12,41.7,7,26,22,4,32,43,88,3,DF,30-34,Defender,England,Europe
635,Kevin De Bruyne,BEL,Manchester City,Premier League,2020,29.0,1991.0,22.2,34,21,6,18,10,13,48,27.1,35,26,1,25,9,43,10,0,MF,25-29,Midfielder,Belgium,Europe
636,Sebastien De Maio,FRA,Udinese,Serie A,2020,33.0,1987.0,9.5,15,10,6,9,0,4,5,80.0,1,16,9,7,18,33,41,0,DF,30-34,Defender,France,Europe
637,Rodrigo De Paul,ARG,Udinese,Serie A,2020,26.0,1994.0,35.6,41,24,17,22,2,15,60,25.0,45,32,1,31,17,58,20,1,MF,25-29,Midfielder,Argentina,South America
638,Mattia De Sciglio,ITA,Juventus,Serie A,2020,27.0,1992.0,0.3,0,0,0,0,0,0,0,,0,0,0,0,0,0,1,0,DF,25-29,Defender,Italy,Europe
639,Mattia De Sciglio,ITA,Lyon,Ligue 1,2020,27.0,1992.0,16.3,29,17,15,11,3,18,27,66.7,9,13,4,9,27,56,44,0,DF,25-29,Defender,Italy,Europe
640,Lorenzo De Silvestri,ITA,Bologna,Serie A,2020,32.0,1988.0,23.8,34,24,18,13,3,16,37,43.2,21,37,10,27,30,64,62,3,DF,30-34,Defender,Italy,Europe
641,Thibault De Smet,BEL,Reims,Ligue 1,2020,22.0,1998.0,5.5,11,6,8,3,0,6,15,40.0,9,8,1,7,6,17,16,0,DF,20-24,Defender,Belgium,Europe
642,Lucas Deaux,FRA,Nîmes,Ligue 1,2020,31.0,1988.0,19.5,47,32,20,22,5,16,49,32.7,33,20,3,17,20,67,30,4,"MF,DF",30-34,Midfielder,France,Europe
643,Mathieu Debuchy,FRA,Saint-Étienne,Ligue 1,2020,35.0,1985.0,23.4,58,33,37,17,4,40,62,64.5,22,27,9,18,45,103,61,0,DF,35-39,Defender,France,Europe
645,Alessandro Deiola,ITA,Spezia,Serie A,2020,24.0,1995.0,4.0,6,3,2,3,1,5,13,38.5,8,3,1,2,3,9,1,0,MF,20-24,Midfielder,Italy,Europe
646,Alessandro Deiola,ITA,Cagliari,Serie A,2020,24.0,1995.0,6.8,13,5,5,4,4,8,23,34.8,15,7,2,5,11,24,11,0,MF,20-24,Midfielder,Italy,Europe
647,Romain Del Castillo,FRA,Rennes,Ligue 1,2020,24.0,1996.0,7.2,30,11,5,14,11,5,25,20.0,20,6,0,6,3,33,4,1,"MF,FW",20-24,Midfielder,France,Europe
648,Lorenzo Del Pinto,ITA,Benevento,Serie A,2020,30.0,1990.0,0.1,0,0,0,0,0,0,2,0.0,2,0,0,0,0,0,0,0,MF,30-34,Midfielder,Italy,Europe
649,Thomas Delaine,FRA,Metz,Ligue 1,2020,28.0,1992.0,19.8,32,18,19,11,2,20,35,57.1,15,22,5,17,24,56,30,1,"DF,FW",25-29,Defender,France,Europe
650,Thomas Delaney,DEN,Dortmund,Bundesliga,2020,28.0,1991.0,14.3,40,30,15,20,5,11,31,35.5,20,28,10,18,22,62,15,1,MF,25-29,Midfielder,Denmark,Europe
651,Liam Delap,ENG,Manchester City,Premier League,2020,17.0,2003.0,0.4,0,0,0,0,0,0,0,,0,0,0,0,0,0,0,0,FW,Under 20,Forward,England,Europe
652,Jonathan Delaplace,FRA,Lorient,Ligue 1,2020,34.0,1986.0,10.1,8,5,5,1,2,7,13,53.8,6,12,5,7,17,25,19,1,DF,30-34,Defender,France,Europe
653,Sacha Delaye,FRA,Montpellier,Ligue 1,2020,18.0,2002.0,0.1,0,0,0,0,0,0,1,0.0,1,0,0,0,1,1,1,0,MF,Under 20,Midfielder,France,Europe
654,Cristian Dell'Orco,ITA,Spezia,Serie A,2020,26.0,1994.0,2.9,1,0,1,0,0,1,3,33.3,2,8,5,3,7,8,9,1,DF,25-29,Defender,Italy,Europe
655,Andy Delort,ALG,Montpellier,Ligue 1,2020,28.0,1991.0,27.6,12,7,1,9,2,8,18,44.4,10,11,1,10,4,16,34,0,FW,25-29,Forward,Algeria,Africa
656,Fabian Delph,ENG,Everton,Premier League,2020,30.0,1989.0,3.0,5,2,3,2,0,1,3,33.3,2,2,0,2,4,9,8,1,"MF,DF",30-34,Midfielder,England,Europe
657,Moussa Dembélé,FRA,Atlético Madrid,La Liga,2020,24.0,1996.0,1.1,0,0,0,0,0,0,1,0.0,1,0,0,0,1,1,0,0,FW,20-24,Forward,France,Europe
658,Moussa Dembélé,FRA,Lyon,Ligue 1,2020,24.0,1996.0,7.5,2,2,0,1,1,0,4,0.0,4,4,2,2,5,7,9,0,FW,20-24,Forward,France,Europe
659,Ousmane Dembélé,FRA,Barcelona,La Liga,2020,23.0,1997.0,19.7,14,9,4,9,1,6,17,35.3,11,10,0,10,9,23,3,1,FW,20-24,Forward,France,Europe
660,Merih Demiral,TUR,Juventus,Serie A,2020,22.0,1998.0,10.4,12,9,8,4,0,5,13,38.5,8,16,9,7,21,33,40,0,DF,20-24,Defender,Turkey,Asia
661,Kerem Demirbay,GER,Leverkusen,Bundesliga,2020,27.0,1993.0,19.4,46,31,15,26,5,19,38,50.0,19,21,4,17,8,54,6,1,MF,25-29,Midfielder,Germany,Europe
662,Ermedin Demirović,BIH,Freiburg,Bundesliga,2020,22.0,1998.0,16.6,15,9,4,6,5,2,16,12.5,14,29,5,24,0,15,27,0,FW,20-24,Forward,Bosnia and Herzegovina,Europe
663,Diego Demme,GER,Napoli,Serie A,2020,28.0,1991.0,17.7,56,32,26,22,8,23,63,36.5,40,14,1,13,11,67,15,1,MF,25-29,Midfielder,Germany,Europe
664,Jason Denayer,BEL,Lyon,Ligue 1,2020,25.0,1995.0,29.0,25,16,16,9,0,6,13,46.2,7,36,25,11,27,52,91,1,DF,25-29,Defender,Belgium,Europe
665,Leander Dendoncker,BEL,Wolves,Premier League,2020,25.0,1995.0,27.8,54,29,29,22,3,31,60,51.7,29,38,15,23,27,81,52,2,"MF,DF",25-29,Midfielder,Belgium,Europe
667,Emmanuel Dennis,NGA,Köln,Bundesliga,2020,22.0,1997.0,5.3,13,7,6,5,2,1,6,16.7,5,6,0,6,0,13,0,1,FW,20-24,Forward,Nigeria,Africa
668,Stefano Denswil,SUR,Bologna,Serie A,2020,27.0,1993.0,1.3,2,1,1,1,0,0,1,0.0,1,1,0,1,1,3,1,0,DF,25-29,Defender,Suriname,South America
669,Fabio Depaoli,ITA,Benevento,Serie A,2020,23.0,1997.0,12.4,25,13,15,6,4,15,32,46.9,17,16,4,12,12,37,38,0,DF,20-24,Defender,Italy,Europe
670,Fabio Depaoli,ITA,Sampdoria,Serie A,2020,23.0,1997.0,0.9,1,0,0,1,0,0,2,0.0,2,0,0,0,1,2,1,0,MF,20-24,Midfielder,Italy,Europe
671,Fabio Depaoli,ITA,Atalanta,Serie A,2020,23.0,1997.0,2.1,3,2,0,1,2,1,2,50.0,1,4,0,4,3,6,2,0,DF,20-24,Defender,Italy,Europe
672,Clément Depres,FRA,Nîmes,Ligue 1,2020,25.0,1994.0,0.2,0,0,0,0,0,0,0,,0,0,0,0,0,0,0,0,FW,25-29,Forward,France,Europe
673,Mike van der Hoorn,NED,Arminia,Bundesliga,2020,27.0,1992.0,15.1,8,4,3,5,0,1,3,33.3,2,12,8,4,27,35,73,0,DF,25-29,Defender,Netherlands,Europe
674,Kastriot Dermaku,ALB,Parma,Serie A,2020,28.0,1992.0,1.1,1,1,1,0,0,0,0,,0,2,1,1,2,3,8,0,DF,25-29,Defender,Albania,Europe
675,Kiril Despodov,BUL,Cagliari,Serie A,2020,23.0,1996.0,0.1,1,1,0,1,0,1,1,100.0,0,0,0,0,0,1,0,0,FW,20-24,Forward,Bulgaria,Europe
676,Sergiño Dest,USA,Barcelona,La Liga,2020,19.0,2000.0,21.2,31,16,23,6,2,18,32,56.3,14,25,4,21,10,41,24,1,"DF,FW",Under 20,Defender,United States,North America
677,Mattia Destro,ITA,Genoa,Serie A,2020,29.0,1991.0,17.8,6,3,0,3,3,2,9,22.2,7,11,0,11,4,10,8,0,FW,25-29,Forward,Italy,Europe
679,Deyverson,BRA,Alavés,La Liga,2020,29.0,1991.0,9.7,6,4,3,1,2,2,13,15.4,11,9,0,9,9,15,13,0,FW,25-29,Forward,Brazil,South America
680,Jacopo Dezi,ITA,Parma,Serie A,2020,28.0,1992.0,0.9,4,3,0,2,2,3,6,50.0,3,2,0,2,0,4,0,0,"FW,MF",25-29,Forward,Italy,Europe
681,Samuel Di Carmine,ITA,Hellas Verona,Serie A,2020,31.0,1988.0,5.6,1,2,0,1,0,0,3,0.0,3,1,0,1,0,1,5,0,FW,30-34,Forward,Italy,Europe
682,Samuel Di Carmine,ITA,Crotone,Serie A,2020,31.0,1988.0,5.3,2,2,1,0,1,1,3,33.3,2,2,0,2,0,2,5,0,FW,30-34,Forward,Italy,Europe
683,Giovanni Di Lorenzo,ITA,Napoli,Serie A,2020,26.0,1993.0,36.0,79,50,54,21,4,43,75,57.3,32,37,13,24,35,114,64,1,DF,25-29,Defender,Italy,Europe
684,Ángel Di María,ARG,Paris S-G,Ligue 1,2020,32.0,1988.0,20.6,26,17,6,8,12,11,45,24.4,34,14,1,13,6,32,7,0,"FW,MF",30-34,Forward,Argentina,South America
685,Alessandro Di Pardo,ITA,Juventus,Serie A,2020,21.0,1999.0,0.2,0,0,0,0,0,0,0,,0,1,1,0,0,0,0,0,"FW,DF",20-24,Forward,Italy,Europe
686,Giuseppe Di Serio,ITA,Benevento,Serie A,2020,19.0,2001.0,3.2,2,2,1,1,0,0,4,0.0,4,5,0,5,0,2,4,0,"FW,MF",Under 20,Forward,Italy,Europe
687,Boulaye Dia,SEN,Reims,Ligue 1,2020,23.0,1996.0,32.6,23,12,3,11,9,4,22,18.2,18,19,5,14,12,35,37,1,"FW,MF",20-24,Forward,Senegal,Africa
688,Abdoulay Diaby,MLI,Getafe,La Liga,2020,29.0,1991.0,0.2,2,0,0,2,0,0,0,,0,2,0,2,0,2,0,0,DF,25-29,Defender,Mali,Africa
689,Moussa Diaby,FRA,Leverkusen,Bundesliga,2020,21.0,1999.0,26.5,10,6,4,5,1,6,20,30.0,14,11,0,11,12,22,5,0,"FW,MF",20-24,Forward,France,Europe
690,Mbaye Diagne,SEN,West Brom,Premier League,2020,28.0,1991.0,13.2,4,3,3,0,1,1,4,25.0,3,2,1,1,1,5,16,0,FW,25-29,Forward,Senegal,Africa
691,Mouctar Diakhaby,GUI,Valencia,La Liga,2020,23.0,1996.0,23.1,16,8,10,6,0,8,12,66.7,4,28,21,7,27,43,102,1,DF,20-24,Defender,Guinea,Africa
692,Abdou Diallo,SEN,Paris S-G,Ligue 1,2020,24.0,1996.0,16.6,16,11,9,5,2,8,13,61.5,5,15,8,7,25,41,36,0,DF,20-24,Defender,Senegal,Africa
693,Amad Diallo,CIV,Manchester Utd,Premier League,2020,18.0,2002.0,1.8,3,3,1,2,0,0,0,,0,2,1,1,0,3,1,0,FW,Under 20,Forward,Ivory Coast,Africa
694,Amad Diallo,CIV,Atalanta,Serie A,2020,18.0,2002.0,0.2,0,0,0,0,0,0,0,,0,0,0,0,0,0,0,0,MF,Under 20,Midfielder,Ivory Coast,Africa
695,Habib Diallo,SEN,Strasbourg,Ligue 1,2020,25.0,1995.0,25.8,11,6,3,6,2,7,18,38.9,11,12,2,10,13,24,12,0,FW,25-29,Forward,Senegal,Africa
696,Habib Diallo,SEN,Metz,Ligue 1,2020,25.0,1995.0,1.6,1,1,0,1,0,1,1,100.0,0,0,0,0,0,1,5,0,"FW,MF",25-29,Forward,Senegal,Africa
697,Ibrahima Diallo,FRA,Southampton,Premier League,2020,21.0,1999.0,11.3,29,16,11,17,1,9,16,56.3,7,10,1,9,10,39,12,2,MF,20-24,Midfielder,France,Europe
697,Ibrahima Diallo,FRA,Southampton,Premier League,2020,21.0,1999.0,11.3,29,16,11,17,1,9,16,56.3,7,10,1,9,10,39,12,2,MF,20-24,Midfielder,France,Europe
697,Ibrahima Diallo,FRA,Southampton,Premier League,2020,21.0,1999.0,11.3,29,16,11,17,1,9,16,56.3,7,10,1,9,10,39,12,2,MF,20-24,Midfielder,France,Europe
697,Ibrahima Diallo,FRA,Southampton,Premier League,2020,21.0,1999.0,11.3,29,16,11,17,1,9,16,56.3,7,10,1,9,10,39,12,2,MF,20-24,Midfielder,France,Europe
697,Ibrahima Diallo,FRA,Southampton,Premier League,2020,21.0,1999.0,11.3,29,16,11,17,1,9,16,56.3,7,10,1,9,10,39,12,2,MF,20-24,Midfielder,France,Europe
697,Ibrahima Diallo,FRA,Southampton,Premier League,2020,21.0,1999.0,11.3,29,16,11,17,1,9,16,56.3,7,10,1,9,10,39,12,2,MF,20-24,Midfielder,France,Europe
697,Ibrahima Diallo,FRA,Southampton,Premier League,2020,21.0,1999.0,11.3,29,16,11,17,1,9,16,56.3,7,10,1,9,10,39,12,2,MF,20-24,Midfielder,France,Europe
697,Ibrahima Diallo,FRA,Southampton,Premier League,2020,21.0,1999.0,11.3,29,16,11,17,1,9,16,56.3,7,10,1,9,10,39,12,2,MF,20-24,Midfielder,France,Europe
697,Ibrahima Diallo,FRA,Southampton,Premier League,2020,21.0,1999.0,11.3,29,16,11,17,1,9,16,56.3,7,10,1,9,10,39,12,2,MF,20-24,Midfielder,France,Europe
698,Ibrahima Diallo,FRA,Brest,Ligue 1,2020,21.0,1999.0,4.9,14,9,2,9,3,4,8,50.0,4,4,0,4,3,17,3,0,MF,20-24,Midfielder,France,Europe
698,Ibrahima Diallo,FRA,Brest,Ligue 1,2020,21.0,1999.0,4.9,14,9,2,9,3,4,8,50.0,4,4,0,4,3,17,3,0,MF,20-24,Midfielder,France,Europe
698,Ibrahima Diallo,FRA,Brest,Ligue 1,2020,21.0,1999.0,4.9,14,9,2,9,3,4,8,50.0,4,4,0,4,3,17,3,0,MF,20-24,Midfielder,France,Europe
698,Ibrahima Diallo,FRA,Brest,Ligue 1,2020,21.0,1999.0,4.9,14,9,2,9,3,4,8,50.0,4,4,0,4,3,17,3,0,MF,20-24,Midfielder,France,Europe
698,Ibrahima Diallo,FRA,Brest,Ligue 1,2020,21.0,1999.0,4.9,14,9,2,9,3,4,8,50.0,4,4,0,4,3,17,3,0,MF,20-24,Midfielder,France,Europe
698,Ibrahima Diallo,FRA,Brest,Ligue 1,2020,21.0,1999.0,4.9,14,9,2,9,3,4,8,50.0,4,4,0,4,3,17,3,0,MF,20-24,Midfielder,France,Europe
698,Ibrahima Diallo,FRA,Brest,Ligue 1,2020,21.0,1999.0,4.9,14,9,2,9,3,4,8,50.0,4,4,0,4,3,17,3,0,MF,20-24,Midfielder,France,Europe
698,Ibrahima Diallo,FRA,Brest,Ligue 1,2020,21.0,1999.0,4.9,14,9,2,9,3,4,8,50.0,4,4,0,4,3,17,3,0,MF,20-24,Midfielder,France,Europe
698,Ibrahima Diallo,FRA,Brest,Ligue 1,2020,21.0,1999.0,4.9,14,9,2,9,3,4,8,50.0,4,4,0,4,3,17,3,0,MF,20-24,Midfielder,France,Europe
699,Amadou Diambo,GHA,Benevento,Serie A,2020,19.0,2001.0,0.0,0,0,0,0,0,0,0,,0,0,0,0,0,0,0,0,FW,Under 20,Forward,Ghana,Africa
700,Grady Diangana,COD,West Brom,Premier League,2020,22.0,1998.0,13.7,35,19,19,9,7,19,43,44.2,24,16,2,14,16,51,9,0,"MF,FW",20-24,Midfielder,DR Congo,Africa
701,Stéphane Diarra,FRA,Lorient,Ligue 1,2020,21.0,1998.0,2.2,0,0,0,0,0,0,7,0.0,7,6,1,5,4,4,1,0,"MF,FW",20-24,Midfielder,France,Europe
702,Rúben Dias,POR,Manchester City,Premier League,2020,23.0,1997.0,31.6,24,13,13,8,3,4,16,25.0,12,31,23,8,35,59,92,0,DF,20-24,Defender,Portugal,Europe
703,Krépin Diatta,SEN,Monaco,Ligue 1,2020,21.0,1999.0,4.3,4,3,1,1,2,1,3,33.3,2,5,1,4,4,8,1,0,"MF,DF",20-24,Midfielder,Senegal,Africa
704,Amadou Diawara,GUI,Roma,Serie A,2020,23.0,1997.0,7.3,10,8,4,6,0,2,8,25.0,6,11,2,9,12,22,4,0,MF,20-24,Midfielder,Guinea,Africa
705,Brahim Díaz,MAR,Milan,Serie A,2020,20.0,1999.0,13.6,18,10,7,7,4,10,23,43.5,13,10,0,10,2,20,2,0,"MF,FW",20-24,Midfielder,Morocco,Africa
707,Daniel Didavi,GER,Stuttgart,Bundesliga,2020,30.0,1990.0,10.8,16,6,2,9,5,7,12,58.3,5,10,0,10,3,19,8,0,"MF,FW",30-34,Midfielder,Germany,Europe
708,Bamba Dieng,SEN,Marseille,Ligue 1,2020,20.0,2000.0,1.4,5,3,3,2,0,2,4,50.0,2,2,0,2,0,5,0,0,"FW,DF",20-24,Forward,Senegal,Africa
709,Eric Dier,ENG,Tottenham,Premier League,2020,26.0,1994.0,28.0,23,14,13,10,0,11,18,61.1,7,37,31,6,23,46,123,3,DF,25-29,Defender,England,Europe
710,Daan Dierckx,BEL,Parma,Serie A,2020,17.0,2003.0,5.2,5,4,5,0,0,3,5,60.0,2,10,6,4,13,18,21,0,DF,Under 20,Defender,Belgium,Europe
711,Lucas Digne,FRA,Everton,Premier League,2020,27.0,1993.0,29.8,63,38,40,16,7,29,54,53.7,25,42,4,38,31,94,87,0,"DF,MF",25-29,Defender,France,Europe
712,Mitchell Dijks,NED,Bologna,Serie A,2020,27.0,1993.0,16.5,21,14,15,5,1,12,21,57.1,9,17,2,15,17,38,35,0,DF,25-29,Defender,Netherlands,Europe
713,Javairô Dilrosun,NED,Hertha BSC,Bundesliga,2020,22.0,1998.0,5.9,5,3,2,2,1,1,6,16.7,5,5,0,5,4,9,3,0,"FW,MF",20-24,Forward,Netherlands,Europe
714,Federico Dimarco,ITA,Hellas Verona,Serie A,2020,22.0,1997.0,29.0,32,19,23,7,2,13,28,46.4,15,18,9,9,47,79,50,1,DF,20-24,Defender,Italy,Europe
715,Junior Dina Ebimbe,FRA,Dijon,Ligue 1,2020,19.0,2000.0,23.8,38,25,14,19,5,15,45,33.3,30,17,1,16,14,52,9,0,"FW,MF",Under 20,Forward,France,Europe
716,Tristan Dingomé,CMR,Reims,Ligue 1,2020,29.0,1991.0,0.2,0,0,0,0,0,0,1,0.0,1,0,0,0,0,0,0,0,MF,25-29,Midfielder,Cameroon,Africa
717,Eren Dinkçi,GER,Werder Bremen,Bundesliga,2020,18.0,2001.0,1.2,1,1,1,0,0,0,1,0.0,1,4,0,4,2,3,1,0,"MF,FW",Under 20,Midfielder,Germany,Europe
718,Sinaly Diomande,CIV,Lyon,Ligue 1,2020,19.0,2001.0,12.6,10,7,8,1,1,5,14,35.7,9,19,15,4,33,43,53,1,DF,Under 20,Defender,Ivory Coast,Africa
719,Lois Diony,FRA,Angers,Ligue 1,2020,27.0,1992.0,19.4,15,10,3,9,3,4,18,22.2,14,6,3,3,5,20,16,0,FW,25-29,Forward,France,Europe
720,Issa Diop,FRA,West Ham,Premier League,2020,23.0,1997.0,15.3,20,14,12,8,0,7,18,38.9,11,32,22,10,22,42,59,0,DF,20-24,Defender,France,Europe
721,Papakouli Diop,SEN,Eibar,La Liga,2020,34.0,1986.0,25.8,43,29,15,22,6,12,41,29.3,29,23,5,18,39,82,34,1,MF,30-34,Midfielder,Senegal,Africa
722,Sofiane Diop,FRA,Monaco,Ligue 1,2020,20.0,2000.0,22.5,49,34,17,25,7,18,53,34.0,35,25,1,24,31,80,15,0,"MF,FW",20-24,Midfielder,France,Europe
723,Andy Diouf,FRA,Rennes,Ligue 1,2020,17.0,2003.0,0.1,0,0,0,0,0,0,0,,0,0,0,0,0,0,0,0,FW,Under 20,Forward,France,Europe
724,Yehvann Diouf,FRA,Reims,Ligue 1,2020,20.0,1999.0,1.5,0,0,0,0,0,0,0,,0,0,0,0,0,0,0,0,GK,20-24,Goalkeeper,France,Europe
725,Assane Dioussé,SEN,Saint-Étienne,Ligue 1,2020,22.0,1997.0,0.0,0,0,0,0,0,0,0,,0,0,0,0,0,0,0,0,DF,20-24,Defender,Senegal,Africa
726,Jonas Dirkner,GER,Hertha BSC,Bundesliga,2020,18.0,2002.0,0.2,0,0,0,0,0,0,0,,0,0,0,0,0,0,0,0,MF,Under 20,Midfielder,Germany,Europe
727,Axel Disasi,FRA,Monaco,Ligue 1,2020,22.0,1998.0,22.3,29,20,17,12,0,20,35,57.1,15,18,11,7,26,55,66,1,DF,20-24,Defender,France,Europe
728,Tiago Djaló,POR,Lille,Ligue 1,2020,20.0,2000.0,9.7,22,13,14,5,3,15,23,65.2,8,10,4,6,9,31,23,0,DF,20-24,Defender,Portugal,Europe
730,Moussa Djenepo,MLI,Southampton,Premier League,2020,22.0,1998.0,13.8,52,27,27,17,8,28,63,44.4,35,24,2,22,10,62,14,0,MF,20-24,Midfielder,Mali,Africa
731,Koffi Djidji,CIV,Crotone,Serie A,2020,27.0,1992.0,16.9,39,28,30,8,1,10,20,50.0,10,35,20,15,28,67,73,0,DF,25-29,Defender,Ivory Coast,Africa
732,Alexander Djiku,GHA,Strasbourg,Ligue 1,2020,25.0,1994.0,28.4,60,41,45,13,2,32,52,61.5,20,28,10,18,91,151,104,0,"DF,MF",25-29,Defender,Ghana,Africa
733,Berat Djimsiti,ALB,Atalanta,Serie A,2020,27.0,1993.0,29.2,41,29,27,12,2,17,34,50.0,17,34,20,14,62,103,89,1,DF,25-29,Defender,Albania,Europe
735,Ritsu Doan,JPN,Arminia,Bundesliga,2020,22.0,1998.0,30.8,53,31,22,19,12,19,52,36.5,33,42,1,41,31,84,11,0,"MF,FW",20-24,Midfielder,Japan,Asia
736,Mihai Dobre,ROU,Dijon,Ligue 1,2020,21.0,1998.0,5.9,12,5,6,2,4,7,14,50.0,7,5,0,5,10,22,3,0,FW,20-24,Forward,Romania,Europe
737,Matt Doherty,IRL,Tottenham,Premier League,2020,28.0,1992.0,13.8,29,15,15,10,4,13,33,39.4,20,20,5,15,23,52,46,0,DF,25-29,Defender,Republic of Ireland,Europe
738,Jeremy Doku,BEL,Rennes,Ligue 1,2020,18.0,2002.0,25.7,44,25,9,24,11,11,26,42.3,15,18,1,17,11,55,1,0,"MF,FW",Under 20,Midfielder,Belgium,Europe
739,Kasper Dolberg,DEN,Nice,Ligue 1,2020,22.0,1997.0,21.4,6,2,1,3,2,2,11,18.2,9,11,2,9,6,12,19,1,FW,20-24,Forward,Denmark,Europe
740,Keagan Dolly,RSA,Montpellier,Ligue 1,2020,27.0,1993.0,5.0,7,2,6,0,1,4,8,50.0,4,3,0,3,5,12,2,0,MF,25-29,Midfielder,South Africa,Africa
743,Nicolás Domínguez,ARG,Bologna,Serie A,2020,22.0,1998.0,13.9,48,28,26,17,5,15,37,40.5,22,26,7,19,24,72,20,0,MF,20-24,Midfielder,Argentina,South America
745,Ji Dong-won,KOR,Mainz 05,Bundesliga,2020,29.0,1991.0,0.7,1,1,1,0,0,0,0,,0,1,0,1,2,3,0,0,FW,25-29,Forward,South Korea,Asia
746,Anastasios Donis,GRE,Reims,Ligue 1,2020,23.0,1996.0,1.1,4,1,2,0,2,1,1,100.0,0,0,0,0,0,4,0,0,MF,20-24,Midfielder,Greece,Europe
747,Gianluigi Donnarumma,ITA,Milan,Serie A,2020,21.0,1999.0,37.0,0,0,0,0,0,0,1,0.0,1,1,0,1,1,1,23,2,GK,20-24,Goalkeeper,Italy,Europe
748,Bas Dost,NED,Eint Frankfurt,Bundesliga,2020,31.0,1989.0,9.1,3,2,1,1,1,2,5,40.0,3,5,1,4,2,5,8,0,FW,30-34,Forward,Netherlands,Europe
749,Abdoulaye Doucouré,MLI,Everton,Premier League,2020,27.0,1993.0,27.1,52,32,25,19,8,14,43,32.6,29,24,7,17,39,91,31,1,MF,25-29,Midfielder,Mali,Africa
750,Cheick Doucouré,MLI,Lens,Ligue 1,2020,20.0,2000.0,29.2,87,47,40,42,5,32,65,49.2,33,20,4,16,52,139,26,1,MF,20-24,Midfielder,Mali,Africa
751,Fodé Doucouré,MLI,Reims,Ligue 1,2020,19.0,2001.0,3.7,11,8,7,4,0,4,9,44.4,5,2,0,2,4,15,11,0,DF,Under 20,Defender,Mali,Africa
752,Mahamadou Doucouré,MLI,Nîmes,Ligue 1,2020,20.0,2000.0,0.5,1,1,1,0,0,1,1,100.0,0,0,0,0,0,1,0,0,"FW,MF",20-24,Forward,Mali,Africa
753,Cheick Doukouré,CIV,Levante,La Liga,2020,27.0,1992.0,1.1,5,4,2,1,2,3,4,75.0,1,2,0,2,3,8,0,0,"MF,FW",25-29,Midfielder,Ivory Coast,Africa
754,Idrissa Doumbia,CIV,Huesca,La Liga,2020,22.0,1998.0,8.7,15,8,6,7,2,5,13,38.5,8,6,3,3,7,22,9,0,MF,20-24,Midfielder,Ivory Coast,Africa
755,Moussa Doumbia,MLI,Reims,Ligue 1,2020,25.0,1994.0,10.0,10,6,4,4,2,4,22,18.2,18,5,1,4,10,20,4,0,"MF,FW",25-29,Midfielder,Mali,Africa
756,Souleyman Doumbia,CIV,Angers,Ligue 1,2020,23.0,1996.0,24.7,48,33,25,19,4,22,36,61.1,14,18,4,14,42,90,50,0,DF,20-24,Defender,Ivory Coast,Africa
757,Aleksandar Dragović,AUT,Leverkusen,Bundesliga,2020,29.0,1991.0,12.6,11,7,5,5,1,9,13,69.2,4,17,5,12,13,24,33,0,DF,25-29,Defender,Austria,Europe
759,Denis Drăguș,ROU,Crotone,Serie A,2020,21.0,1999.0,2.0,3,1,0,0,3,0,4,0.0,4,4,0,4,1,4,0,0,"FW,MF",20-24,Forward,Romania,Europe
760,Radu Drăgușin,ROU,Juventus,Serie A,2020,18.0,2002.0,0.0,0,0,0,0,0,0,0,,0,0,0,0,0,0,0,0,DF,Under 20,Defender,Romania,Europe
761,Mouhamadou Drammeh,FRA,Reims,Ligue 1,2020,21.0,1999.0,1.9,0,0,0,0,0,0,2,0.0,2,0,0,0,2,2,7,0,MF,20-24,Midfielder,France,Europe
762,Julian Draxler,GER,Paris S-G,Ligue 1,2020,26.0,1993.0,11.8,13,6,5,6,2,5,20,25.0,15,4,0,4,14,27,0,0,"MF,FW",25-29,Midfielder,Germany,Europe
763,Dominick Drexler,GER,Köln,Bundesliga,2020,30.0,1990.0,13.7,36,26,15,18,3,12,30,40.0,18,5,1,4,14,50,15,0,"MF,FW",30-34,Midfielder,Germany,Europe
764,Matthieu Dreyer,FRA,Lorient,Ligue 1,2020,31.0,1989.0,15.0,0,0,0,0,0,0,0,,0,0,0,0,0,0,4,2,GK,30-34,Goalkeeper,France,Europe
765,Domingos Duarte,POR,Granada,La Liga,2020,25.0,1995.0,26.3,32,20,18,12,2,14,21,66.7,7,29,20,9,29,61,86,0,DF,25-29,Defender,Portugal,Europe
766,Léo Duarte,BRA,Milan,Serie A,2020,24.0,1996.0,0.2,1,1,0,1,0,0,0,,0,0,0,0,1,2,0,0,DF,20-24,Defender,Brazil,South America
767,Óscar Duarte,CRC,Levante,La Liga,2020,31.0,1989.0,22.9,22,13,17,5,0,10,18,55.6,8,23,15,8,36,58,97,1,DF,30-34,Defender,Costa Rica,North America
769,Leo Dubois,FRA,Lyon,Ligue 1,2020,25.0,1994.0,32.3,38,26,19,16,3,18,36,50.0,18,27,9,18,31,69,69,2,DF,25-29,Defender,France,Europe
770,Martin Dúbravka,SVK,Newcastle Utd,Premier League,2020,31.0,1989.0,13.0,0,0,0,0,0,0,0,,0,0,0,0,0,0,3,0,GK,30-34,Goalkeeper,Slovakia,Europe
771,Ondrej Duda,SVK,Köln,Bundesliga,2020,25.0,1994.0,28.2,36,14,13,18,5,8,39,20.5,31,28,2,26,19,55,20,0,"FW,MF",25-29,Forward,Slovakia,Europe
773,Haris Duljević,BIH,Nîmes,Ligue 1,2020,26.0,1993.0,8.6,15,9,4,7,4,6,22,27.3,16,3,0,3,8,23,1,0,"MF,FW",25-29,Midfielder,Bosnia and Herzegovina,Europe
774,Paul Dummett,WAL,Newcastle Utd,Premier League,2020,28.0,1991.0,13.9,16,7,11,5,0,13,21,61.9,8,12,7,5,16,32,74,0,DF,25-29,Defender,Wales,Europe
775,Alfred Duncan,GHA,Fiorentina,Serie A,2020,27.0,1993.0,1.8,3,0,1,1,1,0,2,0.0,2,2,0,2,2,5,0,0,MF,25-29,Midfielder,Ghana,Africa
776,Alfred Duncan,GHA,Cagliari,Serie A,2020,27.0,1993.0,11.9,18,10,8,9,1,4,21,19.0,17,8,0,8,16,34,8,1,MF,25-29,Midfielder,Ghana,Africa
777,Lewis Dunk,ENG,Brighton,Premier League,2020,28.0,1991.0,32.6,30,15,20,8,2,16,23,69.6,7,29,20,9,32,62,106,0,DF,25-29,Defender,England,Europe
778,Jimmy Dunne,IRL,Burnley,Premier League,2020,22.0,1997.0,3.0,3,3,2,1,0,1,2,50.0,1,3,2,1,6,9,16,1,DF,20-24,Defender,Republic of Ireland,Europe
779,Erik Durm,GER,Eint Frankfurt,Bundesliga,2020,28.0,1992.0,16.4,17,13,7,9,1,8,21,38.1,13,19,5,14,29,46,26,0,DF,25-29,Defender,Germany,Europe
781,Jean-Kevin Duverne,HAI,Brest,Ligue 1,2020,23.0,1997.0,22.5,38,21,24,14,0,15,32,46.9,17,24,16,8,30,68,70,0,DF,20-24,Defender,Haiti,North America
782,Paulo Dybala,ARG,Juventus,Serie A,2020,26.0,1993.0,12.6,14,8,3,4,7,2,14,14.3,12,15,0,15,1,15,1,0,FW,25-29,Forward,Argentina,South America
783,Edin Džeko,BIH,Roma,Serie A,2020,34.0,1986.0,20.3,8,6,2,3,3,3,9,33.3,6,9,4,5,1,9,11,0,FW,30-34,Forward,Bosnia and Herzegovina,Europe
784,Steeve-Mike Ebongue,FRA,Genoa,Serie A,2020,19.0,2001.0,0.6,2,1,1,0,1,0,3,0.0,3,1,0,1,0,2,0,0,MF,Under 20,Midfielder,France,Europe
785,Enzo Ebosse,CMR,Angers,Ligue 1,2020,21.0,1999.0,2.9,5,3,5,0,0,3,4,75.0,1,1,1,0,2,7,13,0,DF,20-24,Defender,Cameroon,Africa
786,Bruno Ecuele Manga,GAB,Dijon,Ligue 1,2020,32.0,1988.0,38.0,52,38,46,6,0,29,40,72.5,11,50,33,17,57,109,165,3,DF,30-34,Defender,Gabon,Africa
787,Simone Edera,ITA,Torino,Serie A,2020,23.0,1997.0,0.6,3,1,2,1,0,3,4,75.0,1,0,0,0,1,4,1,0,"DF,MF",20-24,Defender,Italy,Europe
788,Ederson,BRA,Manchester City,Premier League,2020,26.0,1993.0,36.0,3,1,3,0,0,3,4,75.0,1,0,0,0,0,3,11,4,GK,25-29,Goalkeeper,Brazil,South America
788,Ederson,BRA,Manchester City,Premier League,2020,26.0,1993.0,36.0,3,1,3,0,0,3,4,75.0,1,0,0,0,0,3,11,4,GK,25-29,Goalkeeper,Brazil,South America
788,Ederson,BRA,Manchester City,Premier League,2020,26.0,1993.0,36.0,3,1,3,0,0,3,4,75.0,1,0,0,0,0,3,11,4,GK,25-29,Goalkeeper,Brazil,South America
788,Ederson,BRA,Manchester City,Premier League,2020,26.0,1993.0,36.0,3,1,3,0,0,3,4,75.0,1,0,0,0,0,3,11,4,GK,25-29,Goalkeeper,Brazil,South America
789,Kyle Edwards,ENG,West Brom,Premier League,2020,22.0,1998.0,1.3,3,2,1,1,1,0,0,,0,2,0,2,1,4,0,0,"MF,FW",20-24,Midfielder,England,Europe
790,John Egan,IRL,Sheffield Utd,Premier League,2020,27.0,1992.0,29.2,41,21,29,12,0,22,39,56.4,17,43,31,12,41,82,131,0,DF,25-29,Defender,Republic of Ireland,Europe
791,Johannes Eggestein,GER,Werder Bremen,Bundesliga,2020,22.0,1998.0,0.4,0,0,0,0,0,0,1,0.0,1,0,0,0,1,1,2,0,"FW,MF",20-24,Forward,Germany,Europe
792,Maximilian Eggestein,GER,Werder Bremen,Bundesliga,2020,23.0,1996.0,32.7,57,42,22,29,6,21,46,45.7,25,30,5,25,43,100,36,0,MF,20-24,Midfielder,Germany,Europe
793,Lilian Egloff,GER,Stuttgart,Bundesliga,2020,17.0,2002.0,0.2,0,0,0,0,0,0,0,,0,0,0,0,0,0,0,0,MF,Under 20,Midfielder,Germany,Europe
794,Kingsley Ehizibue,NED,Köln,Bundesliga,2020,25.0,1995.0,12.6,32,19,22,9,1,10,17,58.8,7,19,5,14,18,50,42,0,DF,25-29,Defender,Netherlands,Europe
795,Albin Ekdal,SWE,Sampdoria,Serie A,2020,31.0,1989.0,25.5,56,29,21,32,3,23,65,35.4,42,31,12,19,49,105,35,0,MF,30-34,Midfielder,Sweden,Europe
796,Hugo Ekitike,FRA,Reims,Ligue 1,2020,18.0,2002.0,1.0,1,1,0,0,1,0,1,0.0,1,0,0,0,0,1,0,0,"FW,MF",Under 20,Forward,France,Europe
797,Anthony Elanga,SWE,Manchester Utd,Premier League,2020,18.0,2002.0,1.7,4,2,3,1,0,4,5,80.0,1,1,1,0,1,5,1,0,FW,Under 20,Forward,Sweden,Europe
798,Niclas Eliasson,SWE,Nîmes,Ligue 1,2020,24.0,1995.0,20.0,28,14,9,12,7,11,24,45.8,13,20,1,19,23,51,16,0,"MF,FW",20-24,Midfielder,Sweden,Europe
799,Elif Elmas,MKD,Napoli,Serie A,2020,20.0,1999.0,8.2,15,4,3,6,6,7,12,58.3,5,11,1,10,2,17,10,0,"MF,FW",20-24,Midfielder,North Macedonia,Europe
800,Ahmed Elmohamady,EGY,Aston Villa,Premier League,2020,32.0,1987.0,9.3,17,13,12,4,1,9,14,64.3,5,6,3,3,17,34,26,0,DF,30-34,Defender,Egypt,Africa
801,Mohamed Elneny,EGY,Arsenal,Premier League,2020,28.0,1992.0,17.2,14,6,7,7,0,7,28,25.0,21,11,4,7,24,38,20,2,MF,25-29,Midfielder,Egypt,Africa
803,Nico Elvedi,SUI,Gladbach,Bundesliga,2020,23.0,1996.0,28.2,49,35,36,12,1,25,37,67.6,12,38,22,16,65,114,123,0,DF,20-24,Defender,Switzerland,Europe
804,Rodrigo Ely,BRA,Alavés,La Liga,2020,26.0,1993.0,5.2,5,2,3,2,0,3,4,75.0,1,2,1,1,7,12,23,1,DF,25-29,Defender,Brazil,South America
805,Breel Embolo,SUI,Gladbach,Bundesliga,2020,23.0,1997.0,16.0,15,10,1,13,1,0,6,0.0,6,16,1,15,8,23,8,0,"FW,MF",20-24,Forward,Switzerland,Europe
806,Emerson,BRA,Betis,La Liga,2020,21.0,1999.0,33.2,91,52,62,25,4,43,78,55.1,35,33,6,27,61,152,102,2,DF,20-24,Defender,Brazil,South America
807,Renaud Emond,BEL,Nantes,Ligue 1,2020,28.0,1991.0,3.9,0,0,0,0,0,0,1,0.0,1,2,0,2,0,0,1,0,"FW,MF",25-29,Forward,Belgium,Europe
808,Alan Empereur,BRA,Hellas Verona,Serie A,2020,26.0,1994.0,2.4,0,0,0,0,0,0,0,,0,1,1,0,6,6,7,1,DF,25-29,Defender,Brazil,South America
809,Youssef En-Nesyri,MAR,Sevilla,La Liga,2020,23.0,1997.0,25.7,17,11,2,9,6,4,21,19.0,17,15,0,15,8,25,23,0,FW,20-24,Forward,Morocco,Africa
810,Keita Endo,JPN,Union Berlin,Bundesliga,2020,22.0,1997.0,5.1,8,3,1,5,2,3,9,33.3,6,5,2,3,6,14,4,0,"MF,FW",20-24,Midfielder,Japan,Asia
811,Wataru Endo,JPN,Stuttgart,Bundesliga,2020,27.0,1993.0,32.8,65,44,25,34,6,29,71,40.8,42,53,14,39,51,116,59,0,MF,25-29,Midfielder,Japan,Asia
813,Christian Eriksen,DEN,Inter,Serie A,2020,28.0,1992.0,15.4,12,6,6,4,2,7,20,35.0,13,16,1,15,9,21,13,1,MF,25-29,Midfielder,Denmark,Europe
814,Martin Erlic,CRO,Spezia,Serie A,2020,22.0,1998.0,20.0,23,14,16,6,1,11,20,55.0,9,22,16,6,41,64,71,2,DF,20-24,Defender,Croatia,Europe
815,Patrick Erras,GER,Werder Bremen,Bundesliga,2020,25.0,1995.0,0.3,0,0,0,0,0,0,1,0.0,1,0,0,0,0,0,0,0,"FW,MF",25-29,Forward,Germany,Europe
816,Gonzalo Escalante,ARG,Lazio,Serie A,2020,27.0,1993.0,8.1,26,13,11,14,1,8,28,28.6,20,10,3,7,19,45,13,0,MF,25-29,Midfielder,Argentina,South America
820,Alfonso Espino,URU,Cádiz,La Liga,2020,28.0,1992.0,28.9,92,48,63,28,1,43,85,50.6,42,30,5,25,41,133,74,0,DF,25-29,Defender,Uruguay,South America
822,Nahuel Estévez,ARG,Spezia,Serie A,2020,24.0,1995.0,19.6,13,5,4,6,3,5,32,15.6,27,23,5,18,20,33,22,1,MF,20-24,Midfielder,Argentina,South America
823,Pervis Estupiñán,ECU,Villarreal,La Liga,2020,22.0,1998.0,13.0,37,17,23,12,2,14,23,60.9,9,10,2,8,35,72,14,2,DF,20-24,Defender,Ecuador,South America
824,Yoann Etienne,FRA,Lorient,Ligue 1,2020,23.0,1997.0,1.0,2,0,1,1,0,1,1,100.0,0,1,0,1,1,3,2,0,DF,20-24,Defender,France,Europe
828,Valentin Eysseric,FRA,Fiorentina,Serie A,2020,28.0,1992.0,8.1,14,8,6,7,1,5,11,45.5,6,11,0,11,7,21,8,0,"MF,FW",25-29,Midfielder,France,Europe
829,Eberechi Eze,ENG,Crystal Palace,Premier League,2020,22.0,1998.0,28.4,27,14,11,13,3,16,35,45.7,19,19,3,16,24,51,9,1,MF,20-24,Midfielder,England,Europe
832,Fabinho,BRA,Liverpool,Premier League,2020,26.0,1993.0,28.5,58,31,21,29,8,27,54,50.0,27,28,10,18,44,102,66,1,"DF,MF",25-29,Defender,Brazil,South America
832,Fabinho,BRA,Liverpool,Premier League,2020,26.0,1993.0,28.5,58,31,21,29,8,27,54,50.0,27,28,10,18,44,102,66,1,"DF,MF",25-29,Defender,Brazil,South America
832,Fabinho,BRA,Liverpool,Premier League,2020,26.0,1993.0,28.5,58,31,21,29,8,27,54,50.0,27,28,10,18,44,102,66,1,"DF,MF",25-29,Defender,Brazil,South America
832,Fabinho,BRA,Liverpool,Premier League,2020,26.0,1993.0,28.5,58,31,21,29,8,27,54,50.0,27,28,10,18,44,102,66,1,"DF,MF",25-29,Defender,Brazil,South America
832,Fabinho,BRA,Liverpool,Premier League,2020,26.0,1993.0,28.5,58,31,21,29,8,27,54,50.0,27,28,10,18,44,102,66,1,"DF,MF",25-29,Defender,Brazil,South America
832,Fabinho,BRA,Liverpool,Premier League,2020,26.0,1993.0,28.5,58,31,21,29,8,27,54,50.0,27,28,10,18,44,102,66,1,"DF,MF",25-29,Defender,Brazil,South America
832,Fabinho,BRA,Liverpool,Premier League,2020,26.0,1993.0,28.5,58,31,21,29,8,27,54,50.0,27,28,10,18,44,102,66,1,"DF,MF",25-29,Defender,Brazil,South America
832,Fabinho,BRA,Liverpool,Premier League,2020,26.0,1993.0,28.5,58,31,21,29,8,27,54,50.0,27,28,10,18,44,102,66,1,"DF,MF",25-29,Defender,Brazil,South America
832,Fabinho,BRA,Liverpool,Premier League,2020,26.0,1993.0,28.5,58,31,21,29,8,27,54,50.0,27,28,10,18,44,102,66,1,"DF,MF",25-29,Defender,Brazil,South America
832,Fabinho,BRA,Liverpool,Premier League,2020,26.0,1993.0,28.5,58,31,21,29,8,27,54,50.0,27,28,10,18,44,102,66,1,"DF,MF",25-29,Defender,Brazil,South America
832,Fabinho,BRA,Liverpool,Premier League,2020,26.0,1993.0,28.5,58,31,21,29,8,27,54,50.0,27,28,10,18,44,102,66,1,"DF,MF",25-29,Defender,Brazil,South America
832,Fabinho,BRA,Liverpool,Premier League,2020,26.0,1993.0,28.5,58,31,21,29,8,27,54,50.0,27,28,10,18,44,102,66,1,"DF,MF",25-29,Defender,Brazil,South America
832,Fabinho,BRA,Liverpool,Premier League,2020,26.0,1993.0,28.5,58,31,21,29,8,27,54,50.0,27,28,10,18,44,102,66,1,"DF,MF",25-29,Defender,Brazil,South America
832,Fabinho,BRA,Liverpool,Premier League,2020,26.0,1993.0,28.5,58,31,21,29,8,27,54,50.0,27,28,10,18,44,102,66,1,"DF,MF",25-29,Defender,Brazil,South America
832,Fabinho,BRA,Liverpool,Premier League,2020,26.0,1993.0,28.5,58,31,21,29,8,27,54,50.0,27,28,10,18,44,102,66,1,"DF,MF",25-29,Defender,Brazil,South America
832,Fabinho,BRA,Liverpool,Premier League,2020,26.0,1993.0,28.5,58,31,21,29,8,27,54,50.0,27,28,10,18,44,102,66,1,"DF,MF",25-29,Defender,Brazil,South America
832,Fabinho,BRA,Liverpool,Premier League,2020,26.0,1993.0,28.5,58,31,21,29,8,27,54,50.0,27,28,10,18,44,102,66,1,"DF,MF",25-29,Defender,Brazil,South America
832,Fabinho,BRA,Liverpool,Premier League,2020,26.0,1993.0,28.5,58,31,21,29,8,27,54,50.0,27,28,10,18,44,102,66,1,"DF,MF",25-29,Defender,Brazil,South America
832,Fabinho,BRA,Liverpool,Premier League,2020,26.0,1993.0,28.5,58,31,21,29,8,27,54,50.0,27,28,10,18,44,102,66,1,"DF,MF",25-29,Defender,Brazil,South America
832,Fabinho,BRA,Liverpool,Premier League,2020,26.0,1993.0,28.5,58,31,21,29,8,27,54,50.0,27,28,10,18,44,102,66,1,"DF,MF",25-29,Defender,Brazil,South America
832,Fabinho,BRA,Liverpool,Premier League,2020,26.0,1993.0,28.5,58,31,21,29,8,27,54,50.0,27,28,10,18,44,102,66,1,"DF,MF",25-29,Defender,Brazil,South America
832,Fabinho,BRA,Liverpool,Premier League,2020,26.0,1993.0,28.5,58,31,21,29,8,27,54,50.0,27,28,10,18,44,102,66,1,"DF,MF",25-29,Defender,Brazil,South America
832,Fabinho,BRA,Liverpool,Premier League,2020,26.0,1993.0,28.5,58,31,21,29,8,27,54,50.0,27,28,10,18,44,102,66,1,"DF,MF",25-29,Defender,Brazil,South America
832,Fabinho,BRA,Liverpool,Premier League,2020,26.0,1993.0,28.5,58,31,21,29,8,27,54,50.0,27,28,10,18,44,102,66,1,"DF,MF",25-29,Defender,Brazil,South America
832,Fabinho,BRA,Liverpool,Premier League,2020,26.0,1993.0,28.5,58,31,21,29,8,27,54,50.0,27,28,10,18,44,102,66,1,"DF,MF",25-29,Defender,Brazil,South America
833,Fábio,BRA,Nantes,Ligue 1,2020,30.0,1990.0,16.7,62,37,37,23,2,35,61,57.4,26,29,8,21,37,99,49,0,DF,30-34,Defender,Brazil,South America
835,Bandiougou Fadiga,FRA,Paris S-G,Ligue 1,2020,19.0,2001.0,0.7,1,0,1,0,0,0,0,,0,0,0,0,0,1,0,0,"FW,MF",Under 20,Forward,France,Europe
836,Bandiougou Fadiga,FRA,Brest,Ligue 1,2020,19.0,2001.0,0.5,0,0,0,0,0,0,2,0.0,2,0,0,0,0,0,0,0,"MF,FW",Under 20,Midfielder,France,Europe
837,Wout Faes,BEL,Reims,Ligue 1,2020,22.0,1998.0,32.2,35,22,26,9,0,20,39,51.3,19,40,31,9,68,103,144,1,DF,20-24,Defender,Belgium,Europe
838,Nicolò Fagioli,ITA,Juventus,Serie A,2020,19.0,2001.0,0.2,0,0,0,0,0,0,0,,0,0,0,0,0,0,1,0,MF,Under 20,Midfielder,Italy,Europe
839,Ralf Fährmann,GER,Schalke 04,Bundesliga,2020,31.0,1988.0,20.8,2,1,2,0,0,1,2,50.0,1,0,0,0,1,3,9,3,GK,30-34,Goalkeeper,Germany,Europe
840,Romain Faivre,FRA,Brest,Ligue 1,2020,22.0,1998.0,32.1,54,27,26,23,5,21,54,38.9,33,30,0,30,30,84,18,0,"MF,FW",20-24,Midfielder,France,Europe
843,Andri Fannar Baldursson,ISL,Bologna,Serie A,2020,18.0,2002.0,2.4,6,6,1,2,3,1,3,33.3,2,3,1,2,3,9,7,0,MF,Under 20,Midfielder,Iceland,Europe
844,Paolo Faragò,ITA,Bologna,Serie A,2020,27.0,1993.0,0.3,1,1,1,0,0,1,2,50.0,1,1,0,1,0,1,0,0,DF,25-29,Defender,Italy,Europe
845,Paolo Faragò,ITA,Cagliari,Serie A,2020,27.0,1993.0,4.1,13,9,10,3,0,9,20,45.0,11,3,2,1,6,19,15,0,DF,25-29,Defender,Italy,Europe
846,Davide Faraoni,ITA,Hellas Verona,Serie A,2020,28.0,1991.0,32.1,62,33,36,19,7,28,51,54.9,23,48,17,31,49,111,83,1,DF,25-29,Defender,Italy,Europe
847,Mohamed Fares,ALG,Lazio,Serie A,2020,24.0,1996.0,12.7,20,15,9,7,4,11,19,57.9,8,14,1,13,16,36,21,0,DF,20-24,Defender,Algeria,Africa
848,Diego Farias,BRA,Spezia,Serie A,2020,30.0,1990.0,16.8,9,5,4,1,4,4,21,19.0,17,12,0,12,13,22,3,0,FW,30-34,Forward,Brazil,South America
849,Wuilker Faríñez,VEN,Lens,Ligue 1,2020,22.0,1998.0,1.2,0,0,0,0,0,0,0,,0,0,0,0,0,0,1,0,GK,20-24,Goalkeeper,Venezuela,South America
850,Noah Fatar,FRA,Angers,Ligue 1,2020,18.0,2002.0,0.2,1,0,0,0,1,0,0,,0,0,0,0,0,1,0,0,"FW,MF",Under 20,Forward,France,Europe
852,Julien Faussurier,FRA,Brest,Ligue 1,2020,33.0,1987.0,10.6,16,11,6,8,2,11,25,44.0,14,12,4,8,9,25,10,0,DF,30-34,Defender,France,Europe
853,Andrea Favilli,ITA,Hellas Verona,Serie A,2020,23.0,1997.0,3.8,3,1,0,1,2,2,3,66.7,1,2,0,2,0,3,2,0,FW,20-24,Forward,Italy,Europe
854,Federico Fazio,ARG,Roma,Serie A,2020,33.0,1987.0,4.5,3,2,3,0,0,3,4,75.0,1,3,3,0,7,10,18,1,DF,30-34,Defender,Argentina,South America
855,Nabil Fekir,FRA,Betis,La Liga,2020,27.0,1993.0,29.1,45,23,9,22,14,7,43,16.3,36,31,2,29,8,53,2,0,"MF,FW",25-29,Midfielder,France,Europe
856,Felipe,BRA,Atlético Madrid,La Liga,2020,31.0,1989.0,22.9,29,17,19,10,0,18,23,78.3,5,30,15,15,36,65,128,2,DF,30-34,Defender,Brazil,South America
856,Felipe,BRA,Atlético Madrid,La Liga,2020,31.0,1989.0,22.9,29,17,19,10,0,18,23,78.3,5,30,15,15,36,65,128,2,DF,30-34,Defender,Brazil,South America
856,Felipe,BRA,Atlético Madrid,La Liga,2020,31.0,1989.0,22.9,29,17,19,10,0,18,23,78.3,5,30,15,15,36,65,128,2,DF,30-34,Defender,Brazil,South America
856,Felipe,BRA,Atlético Madrid,La Liga,2020,31.0,1989.0,22.9,29,17,19,10,0,18,23,78.3,5,30,15,15,36,65,128,2,DF,30-34,Defender,Brazil,South America
857,Luiz Felipe,ITA,Lazio,Serie A,2020,23.0,1997.0,10.1,32,20,19,11,2,16,24,66.7,8,20,9,11,21,53,29,1,DF,20-24,Defender,Italy,Europe
857,Luiz Felipe,ITA,Lazio,Serie A,2020,23.0,1997.0,10.1,32,20,19,11,2,16,24,66.7,8,20,9,11,21,53,29,1,DF,20-24,Defender,Italy,Europe
857,Luiz Felipe,ITA,Lazio,Serie A,2020,23.0,1997.0,10.1,32,20,19,11,2,16,24,66.7,8,20,9,11,21,53,29,1,DF,20-24,Defender,Italy,Europe
857,Luiz Felipe,ITA,Lazio,Serie A,2020,23.0,1997.0,10.1,32,20,19,11,2,16,24,66.7,8,20,9,11,21,53,29,1,DF,20-24,Defender,Italy,Europe
858,João Félix,POR,Atlético Madrid,La Liga,2020,20.0,1999.0,17.5,8,4,1,6,1,4,17,23.5,13,3,0,3,5,13,2,0,"FW,MF",20-24,Forward,Portugal,Europe
859,Ohis Felix Uduokhai,GER,Augsburg,Bundesliga,2020,22.0,1997.0,29.0,33,24,19,10,4,18,27,66.7,9,48,25,23,54,87,164,2,DF,20-24,Defender,Germany,Europe
860,Zinedine Ferhat,ALG,Nîmes,Ligue 1,2020,27.0,1993.0,32.9,36,21,18,9,9,18,39,46.2,21,22,0,22,32,68,38,0,"FW,MF",25-29,Forward,Algeria,Africa
861,Bruno Fernandes,POR,Manchester Utd,Premier League,2020,25.0,1994.0,34.4,57,30,16,29,12,26,100,26.0,74,38,0,38,26,83,29,0,MF,25-29,Midfielder,Portugal,Europe
862,Edimilson Fernandes,SUI,Mainz 05,Bundesliga,2020,24.0,1996.0,9.3,8,4,4,4,0,4,7,57.1,3,12,4,8,29,37,25,0,"MF,FW",20-24,Midfielder,Switzerland,Europe
867,Augusto Fernández,ARG,Cádiz,La Liga,2020,34.0,1986.0,4.1,11,3,5,6,0,2,13,15.4,11,5,1,4,9,20,5,0,MF,30-34,Midfielder,Argentina,South America
870,Federico Fernández,ARG,Newcastle Utd,Premier League,2020,31.0,1989.0,23.1,29,22,23,5,1,17,21,81.0,4,41,31,10,17,46,147,0,DF,30-34,Defender,Argentina,South America
872,Fernandinho,BRA,Manchester City,Premier League,2020,35.0,1985.0,13.2,31,17,8,14,9,20,43,46.5,23,11,2,9,23,54,17,0,MF,35-39,Midfielder,Brazil,South America
872,Fernandinho,BRA,Manchester City,Premier League,2020,35.0,1985.0,13.2,31,17,8,14,9,20,43,46.5,23,11,2,9,23,54,17,0,MF,35-39,Midfielder,Brazil,South America
872,Fernandinho,BRA,Manchester City,Premier League,2020,35.0,1985.0,13.2,31,17,8,14,9,20,43,46.5,23,11,2,9,23,54,17,0,MF,35-39,Midfielder,Brazil,South America
872,Fernandinho,BRA,Manchester City,Premier League,2020,35.0,1985.0,13.2,31,17,8,14,9,20,43,46.5,23,11,2,9,23,54,17,0,MF,35-39,Midfielder,Brazil,South America
872,Fernandinho,BRA,Manchester City,Premier League,2020,35.0,1985.0,13.2,31,17,8,14,9,20,43,46.5,23,11,2,9,23,54,17,0,MF,35-39,Midfielder,Brazil,South America
872,Fernandinho,BRA,Manchester City,Premier League,2020,35.0,1985.0,13.2,31,17,8,14,9,20,43,46.5,23,11,2,9,23,54,17,0,MF,35-39,Midfielder,Brazil,South America
872,Fernandinho,BRA,Manchester City,Premier League,2020,35.0,1985.0,13.2,31,17,8,14,9,20,43,46.5,23,11,2,9,23,54,17,0,MF,35-39,Midfielder,Brazil,South America
872,Fernandinho,BRA,Manchester City,Premier League,2020,35.0,1985.0,13.2,31,17,8,14,9,20,43,46.5,23,11,2,9,23,54,17,0,MF,35-39,Midfielder,Brazil,South America
872,Fernandinho,BRA,Manchester City,Premier League,2020,35.0,1985.0,13.2,31,17,8,14,9,20,43,46.5,23,11,2,9,23,54,17,0,MF,35-39,Midfielder,Brazil,South America
872,Fernandinho,BRA,Manchester City,Premier League,2020,35.0,1985.0,13.2,31,17,8,14,9,20,43,46.5,23,11,2,9,23,54,17,0,MF,35-39,Midfielder,Brazil,South America
872,Fernandinho,BRA,Manchester City,Premier League,2020,35.0,1985.0,13.2,31,17,8,14,9,20,43,46.5,23,11,2,9,23,54,17,0,MF,35-39,Midfielder,Brazil,South America
872,Fernandinho,BRA,Manchester City,Premier League,2020,35.0,1985.0,13.2,31,17,8,14,9,20,43,46.5,23,11,2,9,23,54,17,0,MF,35-39,Midfielder,Brazil,South America
872,Fernandinho,BRA,Manchester City,Premier League,2020,35.0,1985.0,13.2,31,17,8,14,9,20,43,46.5,23,11,2,9,23,54,17,0,MF,35-39,Midfielder,Brazil,South America
872,Fernandinho,BRA,Manchester City,Premier League,2020,35.0,1985.0,13.2,31,17,8,14,9,20,43,46.5,23,11,2,9,23,54,17,0,MF,35-39,Midfielder,Brazil,South America
872,Fernandinho,BRA,Manchester City,Premier League,2020,35.0,1985.0,13.2,31,17,8,14,9,20,43,46.5,23,11,2,9,23,54,17,0,MF,35-39,Midfielder,Brazil,South America
872,Fernandinho,BRA,Manchester City,Premier League,2020,35.0,1985.0,13.2,31,17,8,14,9,20,43,46.5,23,11,2,9,23,54,17,0,MF,35-39,Midfielder,Brazil,South America
873,Fernando,BRA,Sevilla,La Liga,2020,33.0,1987.0,28.3,54,28,24,25,5,23,43,53.5,20,25,11,14,41,95,70,0,MF,30-34,Midfielder,Brazil,South America
873,Fernando,BRA,Sevilla,La Liga,2020,33.0,1987.0,28.3,54,28,24,25,5,23,43,53.5,20,25,11,14,41,95,70,0,MF,30-34,Midfielder,Brazil,South America
873,Fernando,BRA,Sevilla,La Liga,2020,33.0,1987.0,28.3,54,28,24,25,5,23,43,53.5,20,25,11,14,41,95,70,0,MF,30-34,Midfielder,Brazil,South America
873,Fernando,BRA,Sevilla,La Liga,2020,33.0,1987.0,28.3,54,28,24,25,5,23,43,53.5,20,25,11,14,41,95,70,0,MF,30-34,Midfielder,Brazil,South America
873,Fernando,BRA,Sevilla,La Liga,2020,33.0,1987.0,28.3,54,28,24,25,5,23,43,53.5,20,25,11,14,41,95,70,0,MF,30-34,Midfielder,Brazil,South America
873,Fernando,BRA,Sevilla,La Liga,2020,33.0,1987.0,28.3,54,28,24,25,5,23,43,53.5,20,25,11,14,41,95,70,0,MF,30-34,Midfielder,Brazil,South America
873,Fernando,BRA,Sevilla,La Liga,2020,33.0,1987.0,28.3,54,28,24,25,5,23,43,53.5,20,25,11,14,41,95,70,0,MF,30-34,Midfielder,Brazil,South America
873,Fernando,BRA,Sevilla,La Liga,2020,33.0,1987.0,28.3,54,28,24,25,5,23,43,53.5,20,25,11,14,41,95,70,0,MF,30-34,Midfielder,Brazil,South America
873,Fernando,BRA,Sevilla,La Liga,2020,33.0,1987.0,28.3,54,28,24,25,5,23,43,53.5,20,25,11,14,41,95,70,0,MF,30-34,Midfielder,Brazil,South America
873,Fernando,BRA,Sevilla,La Liga,2020,33.0,1987.0,28.3,54,28,24,25,5,23,43,53.5,20,25,11,14,41,95,70,0,MF,30-34,Midfielder,Brazil,South America
873,Fernando,BRA,Sevilla,La Liga,2020,33.0,1987.0,28.3,54,28,24,25,5,23,43,53.5,20,25,11,14,41,95,70,0,MF,30-34,Midfielder,Brazil,South America
873,Fernando,BRA,Sevilla,La Liga,2020,33.0,1987.0,28.3,54,28,24,25,5,23,43,53.5,20,25,11,14,41,95,70,0,MF,30-34,Midfielder,Brazil,South America
873,Fernando,BRA,Sevilla,La Liga,2020,33.0,1987.0,28.3,54,28,24,25,5,23,43,53.5,20,25,11,14,41,95,70,0,MF,30-34,Midfielder,Brazil,South America
873,Fernando,BRA,Sevilla,La Liga,2020,33.0,1987.0,28.3,54,28,24,25,5,23,43,53.5,20,25,11,14,41,95,70,0,MF,30-34,Midfielder,Brazil,South America
873,Fernando,BRA,Sevilla,La Liga,2020,33.0,1987.0,28.3,54,28,24,25,5,23,43,53.5,20,25,11,14,41,95,70,0,MF,30-34,Midfielder,Brazil,South America
873,Fernando,BRA,Sevilla,La Liga,2020,33.0,1987.0,28.3,54,28,24,25,5,23,43,53.5,20,25,11,14,41,95,70,0,MF,30-34,Midfielder,Brazil,South America
874,Alex Ferrari,ITA,Sampdoria,Serie A,2020,26.0,1994.0,9.8,27,15,16,9,2,15,24,62.5,9,18,6,12,23,50,26,0,DF,25-29,Defender,Italy,Europe
877,Facundo Ferreyra,ARG,Celta Vigo,La Liga,2020,29.0,1991.0,3.3,4,3,1,2,1,0,2,0.0,2,5,0,5,2,6,2,0,FW,25-29,Forward,Argentina,South America
878,Jordan Ferri,FRA,Montpellier,Ligue 1,2020,28.0,1992.0,28.6,58,40,34,22,2,31,103,30.1,72,30,5,25,8,66,18,1,MF,25-29,Midfielder,France,Europe
879,Marco Festa,ITA,Crotone,Serie A,2020,28.0,1992.0,1.0,0,0,0,0,0,0,0,,0,0,0,0,0,0,0,0,GK,25-29,Goalkeeper,Italy,Europe
881,Sam Field,ENG,West Brom,Premier League,2020,22.0,1998.0,0.7,5,5,3,2,0,0,0,,0,4,1,3,2,7,4,0,MF,20-24,Midfielder,England,Europe
882,Alfreð Finnbogason,ISL,Augsburg,Bundesliga,2020,31.0,1989.0,6.0,2,1,0,1,1,0,1,0.0,1,7,1,6,1,3,4,0,FW,30-34,Forward,Iceland,Europe
883,Roberto Firmino,BRA,Liverpool,Premier League,2020,28.0,1991.0,31.5,33,15,3,17,13,6,32,18.8,26,42,5,37,11,44,12,0,FW,25-29,Forward,Brazil,South America
884,Junior Firpo,DOM,Barcelona,La Liga,2020,23.0,1996.0,3.2,1,1,1,0,0,0,1,0.0,1,5,3,2,4,5,7,0,"DF,MF",20-24,Defender,Dominican Republic,North America
885,Will Fish,ENG,Manchester Utd,Premier League,2020,17.0,2003.0,0.0,0,0,0,0,0,0,0,,0,0,0,0,0,0,0,0,FW,Under 20,Forward,England,Europe
886,John Fleck,SCO,Sheffield Utd,Premier League,2020,28.0,1991.0,28.6,51,33,28,18,5,26,83,31.3,57,26,4,22,28,79,12,1,MF,25-29,Midfielder,Scotland,Europe
887,Mark Flekken,NED,Freiburg,Bundesliga,2020,27.0,1993.0,3.0,0,0,0,0,0,0,0,,0,0,0,0,0,0,1,0,GK,25-29,Goalkeeper,Netherlands,Europe
888,Florian Flick,GER,Schalke 04,Bundesliga,2020,20.0,2000.0,4.0,10,7,4,6,0,7,16,43.8,9,4,3,1,7,17,5,1,MF,20-24,Midfielder,Germany,Europe
889,Alexis Flips,FRA,Reims,Ligue 1,2020,20.0,2000.0,0.5,0,0,0,0,0,0,2,0.0,2,0,0,0,0,0,1,0,"MF,FW",20-24,Midfielder,France,Europe
890,Alessandro Florenzi,ITA,Paris S-G,Ligue 1,2020,29.0,1991.0,17.1,24,16,9,9,6,12,29,41.4,17,7,1,6,17,41,25,0,DF,25-29,Defender,Italy,Europe
891,Kingsley Fobi,GHA,Granada,La Liga,2020,21.0,1998.0,0.5,0,0,0,0,0,0,0,,0,0,0,0,1,1,1,0,DF,20-24,Defender,Ghana,Africa
892,Phil Foden,ENG,Manchester City,Premier League,2020,20.0,2000.0,18.0,22,11,12,8,2,9,23,39.1,14,9,0,9,11,33,11,0,"FW,MF",20-24,Forward,England,Europe
893,Mamadou Fofana,MLI,Metz,Ligue 1,2020,22.0,1998.0,11.9,25,11,17,8,0,7,31,22.6,24,14,2,12,18,43,36,0,"MF,DF",20-24,Midfielder,Mali,Africa
894,Seko Fofana,CIV,Lens,Ligue 1,2020,25.0,1995.0,25.7,16,8,3,10,3,4,26,15.4,22,16,5,11,34,50,23,1,MF,25-29,Midfielder,Ivory Coast,Africa
895,Wesley Fofana,FRA,Leicester City,Premier League,2020,19.0,2000.0,25.1,51,37,27,22,2,31,46,67.4,15,28,16,12,61,112,94,0,DF,Under 20,Defender,France,Europe
896,Wesley Fofana,FRA,Saint-Étienne,Ligue 1,2020,19.0,2000.0,3.5,6,4,6,0,0,3,4,75.0,1,3,3,0,8,14,14,1,DF,Under 20,Defender,France,Europe
897,Youssouf Fofana,FRA,Monaco,Ligue 1,2020,21.0,1999.0,31.9,90,51,31,51,8,42,82,51.2,40,43,7,36,34,124,14,2,MF,20-24,Midfielder,France,Europe
898,Thomas Foket,BEL,Reims,Ligue 1,2020,25.0,1994.0,36.9,77,43,50,20,7,40,69,58.0,29,28,7,21,69,146,92,2,DF,25-29,Defender,Belgium,Europe
900,Lamine Fomba,FRA,Nîmes,Ligue 1,2020,22.0,1998.0,24.2,66,36,30,25,11,30,65,46.2,35,48,19,29,59,125,39,2,MF,20-24,Midfielder,France,Europe
901,Thomas Fontaine,MAD,Lorient,Ligue 1,2020,29.0,1991.0,3.6,5,2,5,0,0,2,2,100.0,0,3,2,1,5,10,14,0,DF,25-29,Defender,Madagascar,Africa
903,José Fonte,POR,Lille,Ligue 1,2020,36.0,1983.0,35.4,40,29,28,10,2,27,33,81.8,6,36,23,13,36,76,137,1,DF,35-39,Defender,Portugal,Europe
904,Fernando Forestieri,ITA,Udinese,Serie A,2020,30.0,1990.0,6.1,9,7,4,4,1,3,7,42.9,4,7,0,7,2,11,0,0,"FW,MF",30-34,Forward,Italy,Europe
906,Emil Forsberg,SWE,RB Leipzig,Bundesliga,2020,28.0,1991.0,17.1,11,6,1,6,4,5,27,18.5,22,10,1,9,11,22,4,0,"FW,MF",25-29,Forward,Sweden,Europe
907,Fraser Forster,ENG,Southampton,Premier League,2020,32.0,1988.0,8.0,1,0,1,0,0,1,2,50.0,1,0,0,0,0,1,9,0,GK,30-34,Goalkeeper,England,Europe
908,Philipp Förster,GER,Stuttgart,Bundesliga,2020,25.0,1995.0,16.8,22,13,7,12,3,6,25,24.0,19,18,1,17,15,37,2,0,MF,25-29,Midfielder,Germany,Europe
909,Steven Fortes,CPV,Lens,Ligue 1,2020,28.0,1992.0,15.9,33,20,20,10,3,16,22,72.7,6,25,10,15,27,60,52,0,DF,25-29,Defender,Cape Verde,Africa
910,Yassin Fortune,FRA,Angers,Ligue 1,2020,21.0,1999.0,0.2,0,0,0,0,0,0,0,,0,0,0,0,0,0,0,0,FW,20-24,Forward,France,Europe
911,Timothy Fosu-Mensah,NED,Manchester Utd,Premier League,2020,22.0,1998.0,0.9,2,0,1,1,0,1,1,100.0,0,0,0,0,3,5,1,0,DF,20-24,Defender,Netherlands,Europe
912,Timothy Fosu-Mensah,NED,Leverkusen,Bundesliga,2020,22.0,1998.0,4.5,4,2,1,2,1,2,4,50.0,2,7,3,4,7,11,4,0,DF,20-24,Defender,Netherlands,Europe
913,Daam Foulon,BEL,Benevento,Serie A,2020,21.0,1999.0,11.3,26,15,21,5,0,16,28,57.1,12,12,3,9,14,40,34,0,DF,20-24,Defender,Belgium,Europe
914,Dimitri Foulquier,FRA,Granada,La Liga,2020,27.0,1993.0,29.6,35,21,20,12,3,15,26,57.7,11,24,7,17,26,61,60,0,DF,25-29,Defender,France,Europe
915,Juan Foyth,ARG,Villarreal,La Liga,2020,22.0,1998.0,13.0,40,22,22,14,4,12,29,41.4,17,21,6,15,19,59,24,1,"DF,MF",20-24,Defender,Argentina,South America
916,Gianluca Frabotta,ITA,Juventus,Serie A,2020,21.0,1999.0,7.7,7,4,5,0,2,5,12,41.7,7,9,1,8,14,21,15,0,"DF,MF",20-24,Defender,Italy,Europe
917,Raphael Framberger,GER,Augsburg,Bundesliga,2020,24.0,1995.0,17.1,42,23,26,11,5,19,25,76.0,6,24,2,22,36,78,62,1,DF,20-24,Defender,Germany,Europe
918,Tyrese Francois,AUS,Fulham,Premier League,2020,20.0,2000.0,0.2,0,0,0,0,0,0,0,,0,0,0,0,0,0,0,0,DF,20-24,Defender,Australia,Oceania
919,Ryan Fraser,SCO,Newcastle Utd,Premier League,2020,26.0,1994.0,10.3,4,1,3,1,0,2,5,40.0,3,1,0,1,6,10,7,0,"FW,MF",25-29,Forward,Scotland,Europe
920,Fred,BRA,Manchester Utd,Premier League,2020,27.0,1993.0,26.6,81,39,39,38,4,29,89,32.6,60,49,9,40,45,126,26,1,MF,25-29,Midfielder,Brazil,South America
921,Ryan Fredericks,ENG,West Ham,Premier League,2020,27.0,1992.0,6.3,9,5,5,4,0,3,7,42.9,4,6,2,4,11,20,20,0,"DF,FW",25-29,Defender,England,Europe
922,Remo Freuler,SUI,Atalanta,Serie A,2020,28.0,1992.0,30.1,63,39,17,38,8,32,76,42.1,44,52,4,48,39,102,27,2,MF,25-29,Midfielder,Switzerland,Europe
923,Marco Friedl,AUT,Werder Bremen,Bundesliga,2020,22.0,1998.0,30.9,50,34,31,17,2,30,62,48.4,32,38,17,21,55,105,118,1,DF,20-24,Defender,Austria,Europe
924,Marvin Friedrich,GER,Union Berlin,Bundesliga,2020,24.0,1995.0,34.0,47,29,35,11,1,18,32,56.3,14,38,18,20,52,99,109,0,DF,20-24,Defender,Germany,Europe
925,Jeremie Frimpong,NED,Leverkusen,Bundesliga,2020,19.0,2000.0,4.8,7,4,4,3,0,4,8,50.0,4,4,0,4,1,8,7,0,"DF,FW",Under 20,Defender,Netherlands,Europe
927,Christian Fuchs,AUT,Leicester City,Premier League,2020,34.0,1986.0,7.8,18,7,15,2,1,8,15,53.3,7,6,4,2,16,34,34,1,DF,30-34,Defender,Austria,Europe
928,Angelo Fulgini,FRA,Angers,Ligue 1,2020,23.0,1996.0,30.3,22,13,4,12,6,12,34,35.3,22,17,0,17,15,37,9,0,MF,20-24,Midfielder,France,Europe
929,Niclas Füllkrug,GER,Werder Bremen,Bundesliga,2020,27.0,1993.0,9.7,7,3,2,4,1,1,13,7.7,12,10,4,6,3,10,13,0,FW,25-29,Forward,Germany,Europe
930,Ramiro Funes Mori,ARG,Villarreal,La Liga,2020,29.0,1991.0,8.1,12,8,7,5,0,7,11,63.6,4,7,5,2,8,20,42,1,DF,25-29,Defender,Argentina,South America
931,Darnell Furlong,ENG,West Brom,Premier League,2020,24.0,1995.0,32.6,45,27,27,12,6,21,44,47.7,23,39,16,23,49,94,90,0,DF,20-24,Defender,England,Europe
932,Daniel Fuzato,BRA,Roma,Serie A,2020,23.0,1997.0,5.0,0,0,0,0,0,0,0,,0,1,0,1,0,0,1,1,GK,20-24,Goalkeeper,Brazil,South America
933,Baptiste Gabard,FRA,Saint-Étienne,Ligue 1,2020,20.0,2000.0,1.5,4,3,1,3,0,1,5,20.0,4,4,0,4,1,5,0,0,MF,20-24,Midfielder,France,Europe
934,Matteo Gabbia,ITA,Milan,Serie A,2020,20.0,1999.0,6.2,9,5,3,6,0,2,2,100.0,0,8,6,2,3,12,21,0,DF,20-24,Defender,Italy,Europe
935,Manolo Gabbiadini,ITA,Sampdoria,Serie A,2020,28.0,1991.0,9.7,2,2,0,2,0,0,1,0.0,1,3,1,2,3,5,5,0,FW,25-29,Forward,Italy,Europe
937,Roberto Gagliardini,ITA,Inter,Serie A,2020,26.0,1994.0,13.7,30,17,17,8,5,5,28,17.9,23,15,3,12,19,49,16,0,MF,25-29,Midfielder,Italy,Europe
938,Riccardo Gagliolo,SWE,Parma,Serie A,2020,30.0,1990.0,21.7,45,18,35,8,2,28,45,62.2,17,34,7,27,36,81,64,1,DF,30-34,Defender,Sweden,Europe
939,Adolfo Gaich,ARG,Benevento,Serie A,2020,21.0,1999.0,8.5,9,4,1,7,1,1,13,7.7,12,4,0,4,2,11,4,0,FW,20-24,Forward,Argentina,South America
940,Andrey Galabinov,BUL,Spezia,Serie A,2020,31.0,1988.0,4.8,2,1,1,1,0,1,3,33.3,2,2,0,2,0,2,5,0,FW,30-34,Forward,Bulgaria,Europe
942,Conor Gallagher,ENG,West Brom,Premier League,2020,20.0,2000.0,28.1,81,41,30,39,12,29,97,29.9,68,47,8,39,27,108,31,0,MF,20-24,Midfielder,England,Europe
944,Kévin Gameiro,FRA,Valencia,La Liga,2020,33.0,1987.0,12.0,7,4,3,2,2,3,11,27.3,8,10,0,10,0,7,3,0,FW,30-34,Forward,France,Europe
945,Idrissa Gana Gueye,SEN,Paris S-G,Ligue 1,2020,30.0,1989.0,17.6,63,35,20,34,9,26,50,52.0,24,26,7,19,20,83,9,3,MF,30-34,Midfielder,Senegal,Africa
946,Ignatius Ganago,CMR,Lens,Ligue 1,2020,21.0,1999.0,14.5,4,3,0,2,2,3,12,25.0,9,7,1,6,6,10,3,0,FW,20-24,Forward,Cameroon,Africa
959,Manuel Gasparini,ITA,Udinese,Serie A,2020,18.0,2002.0,0.0,0,0,0,0,0,0,0,,0,0,0,0,0,0,0,0,GK,Under 20,Goalkeeper,Italy,Europe
960,Dwight Gayle,ENG,Newcastle Utd,Premier League,2020,29.0,1990.0,5.7,2,0,1,1,0,0,7,0.0,7,3,1,2,1,3,2,0,"FW,MF",25-29,Forward,England,Europe
961,Paulo Gazzaniga,ARG,Elche,La Liga,2020,28.0,1992.0,8.0,1,1,1,0,0,0,0,,0,0,0,0,1,2,4,0,GK,25-29,Goalkeeper,Argentina,South America
962,Jean-Philippe Gbamin,CIV,Everton,Premier League,2020,24.0,1995.0,0.1,1,0,0,1,0,0,0,,0,1,0,1,0,1,1,0,MF,20-24,Midfielder,Ivory Coast,Africa
963,Yann Gboho,FRA,Rennes,Ligue 1,2020,19.0,2001.0,3.4,6,3,3,1,2,3,8,37.5,5,1,0,1,1,7,3,1,"MF,FW",Under 20,Midfielder,France,Europe
965,Christian Gebauer,AUT,Arminia,Bundesliga,2020,26.0,1993.0,7.6,9,4,2,5,2,4,11,36.4,7,4,1,3,6,15,14,0,"MF,FW",25-29,Midfielder,Austria,Europe
967,Emrehan Gedikli,GER,Leverkusen,Bundesliga,2020,17.0,2003.0,0.3,0,0,0,0,0,0,0,,0,0,0,0,0,0,0,0,FW,Under 20,Forward,Germany,Europe
968,Dennis Geiger,GER,Hoffenheim,Bundesliga,2020,22.0,1998.0,7.3,13,10,3,8,2,5,8,62.5,3,10,0,10,3,16,0,0,MF,20-24,Midfielder,Germany,Europe
969,Christian Gentner,GER,Union Berlin,Bundesliga,2020,34.0,1985.0,11.5,17,8,9,5,3,5,18,27.8,13,13,1,12,17,34,16,0,MF,30-34,Midfielder,Germany,Europe
970,Yannick Gerhardt,GER,Wolfsburg,Bundesliga,2020,26.0,1994.0,21.5,52,32,14,32,6,21,52,40.4,31,34,4,30,21,73,30,0,"MF,FW",25-29,Midfielder,Germany,Europe
971,Valère Germain,FRA,Marseille,Ligue 1,2020,30.0,1990.0,9.5,8,6,2,4,2,3,11,27.3,8,7,2,5,11,19,22,0,"FW,MF",30-34,Forward,France,Europe
972,Gervinho,CIV,Parma,Serie A,2020,33.0,1987.0,22.5,5,1,2,2,1,1,14,7.1,13,11,1,10,10,15,3,0,FW,30-34,Forward,Ivory Coast,Africa
973,Willem Geubbels,FRA,Monaco,Ligue 1,2020,18.0,2001.0,3.3,12,8,5,7,0,5,13,38.5,8,9,0,9,3,15,5,0,"MF,FW",Under 20,Midfielder,France,Europe
974,Hamadi Al Ghaddioui,MAR,Stuttgart,Bundesliga,2020,29.0,1990.0,0.5,0,0,0,0,0,0,1,0.0,1,0,0,0,0,0,0,0,FW,25-29,Forward,Morocco,Africa
975,Anwar El Ghazi,NED,Aston Villa,Premier League,2020,25.0,1995.0,17.9,16,13,6,7,3,7,23,30.4,16,11,0,11,6,22,11,0,FW,25-29,Forward,Netherlands,Europe
976,Paolo Ghiglione,ITA,Genoa,Serie A,2020,23.0,1997.0,15.1,27,15,17,8,2,13,28,46.4,15,14,2,12,13,40,25,0,"DF,MF",20-24,Defender,Italy,Europe
977,Faouzi Ghoulam,ALG,Napoli,Serie A,2020,29.0,1991.0,3.2,6,5,3,2,1,0,1,0.0,1,4,2,2,3,9,1,0,"DF,FW",25-29,Defender,Algeria,Africa
978,Kieran Gibbs,ENG,West Brom,Premier League,2020,30.0,1989.0,9.0,15,11,11,3,1,8,10,80.0,2,8,6,2,16,31,30,1,DF,30-34,Defender,England,Europe
979,Morgan Gibbs-White,ENG,Wolves,Premier League,2020,20.0,2000.0,4.6,9,7,3,4,2,5,12,41.7,7,6,0,6,3,12,1,0,"MF,FW",20-24,Midfielder,England,Europe
980,Niko Gießelmann,GER,Union Berlin,Bundesliga,2020,28.0,1991.0,4.8,12,9,7,4,1,5,8,62.5,3,9,3,6,8,20,13,1,DF,25-29,Defender,Germany,Europe
985,Billy Gilmour,SCO,Chelsea,Premier League,2020,19.0,2001.0,2.9,4,2,1,2,1,2,7,28.6,5,3,2,1,3,7,1,0,MF,Under 20,Midfielder,Scotland,Europe
987,Daniel Ginczek,GER,Wolfsburg,Bundesliga,2020,29.0,1991.0,2.4,2,2,1,1,0,2,8,25.0,6,2,0,2,1,3,2,0,"FW,MF",25-29,Forward,Germany,Europe
988,Matthias Ginter,GER,Gladbach,Bundesliga,2020,26.0,1994.0,34.0,26,16,15,10,1,14,24,58.3,10,43,32,11,51,77,121,0,DF,25-29,Defender,Germany,Europe
989,Andrei Girotto,BRA,Nantes,Ligue 1,2020,28.0,1992.0,29.6,65,41,50,15,0,39,70,55.7,31,34,15,19,59,124,103,0,"DF,MF",25-29,Defender,Brazil,South America
990,Olivier Giroud,FRA,Chelsea,Premier League,2020,33.0,1986.0,8.3,4,2,0,1,3,1,7,14.3,6,4,1,3,5,9,10,0,FW,30-34,Forward,France,Europe
991,Robert Glatzel,GER,Mainz 05,Bundesliga,2020,26.0,1994.0,4.0,1,0,1,0,0,0,2,0.0,2,2,0,2,0,1,2,0,FW,25-29,Forward,Germany,Europe
993,Serge Gnabry,GER,Bayern Munich,Bundesliga,2020,25.0,1995.0,18.3,39,19,7,19,13,12,32,37.5,20,17,0,17,26,65,3,0,"FW,MF",25-29,Forward,Germany,Europe
994,Ben Godfrey,ENG,Everton,Premier League,2020,22.0,1998.0,29.8,55,33,37,15,3,27,41,65.9,14,56,37,19,33,88,120,0,DF,20-24,Defender,England,Europe
995,Diego Godín,URU,Cagliari,Serie A,2020,34.0,1986.0,27.9,60,32,51,9,0,24,39,61.5,15,41,24,17,56,116,117,0,DF,30-34,Defender,Uruguay,South America
996,Akaki Gogia,GER,Union Berlin,Bundesliga,2020,28.0,1992.0,1.6,1,0,0,1,0,0,2,0.0,2,0,0,0,1,2,0,0,"FW,MF",25-29,Forward,Germany,Europe
997,Amer Gojak,BIH,Torino,Serie A,2020,23.0,1997.0,5.3,1,0,1,0,0,1,7,14.3,6,5,0,5,3,4,1,0,"MF,FW",20-24,Midfielder,Bosnia and Herzegovina,Europe
998,Edoardo Goldaniga,ITA,Genoa,Serie A,2020,26.0,1993.0,20.6,28,18,21,7,0,14,23,60.9,9,17,7,10,38,66,62,1,DF,25-29,Defender,Italy,Europe
1000,Pierluigi Gollini,ITA,Atalanta,Serie A,2020,25.0,1995.0,24.0,1,0,1,0,0,1,2,50.0,1,1,0,1,1,2,11,0,GK,25-29,Goalkeeper,Italy,Europe
1001,Aleksandr Golovin,RUS,Monaco,Ligue 1,2020,24.0,1996.0,11.9,28,16,6,18,4,8,39,20.5,31,21,0,21,11,39,3,0,"MF,FW",20-24,Midfielder,Russia,Europe
1002,Tomislav Gomelt,CRO,Crotone,Serie A,2020,25.0,1995.0,0.2,1,1,0,1,0,0,0,,0,0,0,0,1,2,0,0,MF,25-29,Midfielder,Croatia,Europe
1003,André Gomes,POR,Everton,Premier League,2020,27.0,1993.0,17.4,35,23,16,16,3,17,58,29.3,41,19,1,18,10,45,12,1,MF,25-29,Midfielder,Portugal,Europe
1003,André Gomes,POR,Everton,Premier League,2020,27.0,1993.0,17.4,35,23,16,16,3,17,58,29.3,41,19,1,18,10,45,12,1,MF,25-29,Midfielder,Portugal,Europe
1003,André Gomes,POR,Everton,Premier League,2020,27.0,1993.0,17.4,35,23,16,16,3,17,58,29.3,41,19,1,18,10,45,12,1,MF,25-29,Midfielder,Portugal,Europe
1003,André Gomes,POR,Everton,Premier League,2020,27.0,1993.0,17.4,35,23,16,16,3,17,58,29.3,41,19,1,18,10,45,12,1,MF,25-29,Midfielder,Portugal,Europe
1006,Joe Gomez,ENG,Liverpool,Premier League,2020,23.0,1997.0,6.6,3,2,1,1,1,0,4,0.0,4,3,2,1,4,7,29,0,DF,20-24,Defender,England,Europe
1007,Maxi Gómez,URU,Valencia,La Liga,2020,23.0,1996.0,29.9,11,9,3,7,1,3,14,21.4,11,13,3,10,2,13,34,0,FW,20-24,Forward,Uruguay,South America
1009,Papu Gómez,ARG,Atalanta,Serie A,2020,32.0,1988.0,7.4,3,2,2,1,0,2,8,25.0,6,8,1,7,1,4,1,0,"MF,FW",30-34,Midfielder,Argentina,South America
1010,Papu Gómez,ARG,Sevilla,La Liga,2020,32.0,1988.0,10.2,9,6,2,4,3,2,12,16.7,10,13,2,11,7,16,6,0,"MF,FW",30-34,Midfielder,Argentina,South America
1013,Alfred Gomis,SEN,Dijon,Ligue 1,2020,26.0,1993.0,5.0,1,0,1,0,0,1,2,50.0,1,0,0,0,1,2,7,0,GK,25-29,Goalkeeper,Senegal,Africa
1014,Alfred Gomis,SEN,Rennes,Ligue 1,2020,26.0,1993.0,22.0,1,1,1,0,0,1,1,100.0,0,0,0,0,3,4,10,1,GK,25-29,Goalkeeper,Senegal,Africa
1015,Maxime Gonalons,FRA,Granada,La Liga,2020,31.0,1989.0,16.4,53,37,18,33,2,15,37,40.5,22,17,0,17,25,78,21,1,MF,30-34,Midfielder,France,Europe
1016,Vagner Gonçalves,CPV,Metz,Ligue 1,2020,24.0,1996.0,10.7,16,9,5,5,6,2,15,13.3,13,6,0,6,4,20,1,1,"FW,MF",20-24,Forward,Cape Verde,Africa
1020,Nicolás González,ARG,Stuttgart,Bundesliga,2020,22.0,1998.0,10.4,5,5,1,2,2,0,6,0.0,6,10,3,7,4,9,6,0,"FW,MF",20-24,Forward,Argentina,South America
1023,Anthony Gordon,ENG,Everton,Premier League,2020,19.0,2001.0,1.0,3,3,3,0,0,0,2,0.0,2,1,0,1,1,4,3,0,"FW,MF",Under 20,Forward,England,Europe
1024,Leon Goretzka,GER,Bayern Munich,Bundesliga,2020,25.0,1995.0,18.9,37,23,12,21,4,16,39,41.0,23,30,2,28,44,81,11,0,MF,25-29,Midfielder,Germany,Europe
1026,Robin Gosens,GER,Atalanta,Serie A,2020,26.0,1994.0,28.0,46,35,20,15,11,17,41,41.5,24,50,7,43,41,87,34,0,DF,25-29,Defender,Germany,Europe
1027,Amine Gouiri,ALG,Nice,Ligue 1,2020,20.0,2000.0,30.5,31,18,7,16,8,10,41,24.4,31,22,6,16,17,48,23,0,"FW,MF",20-24,Forward,Algeria,Africa
1028,Lucas Gourna-Douath,FRA,Saint-Étienne,Ligue 1,2020,16.0,2003.0,14.7,32,22,18,11,3,15,28,53.6,13,10,0,10,24,56,18,0,MF,Under 20,Midfielder,France,Europe
1029,Jeffrey Gouweleeuw,NED,Augsburg,Bundesliga,2020,29.0,1991.0,31.5,36,20,24,11,1,16,33,48.5,17,37,18,19,69,105,149,2,DF,25-29,Defender,Netherlands,Europe
1030,Jonathan Gradit,FRA,Lens,Ligue 1,2020,27.0,1992.0,31.4,60,39,26,28,6,22,38,57.9,16,37,19,18,56,116,81,1,DF,25-29,Defender,France,Europe
1031,Karlan Grant,ENG,West Brom,Premier League,2020,22.0,1997.0,12.5,5,3,3,2,0,2,4,50.0,2,7,0,7,5,10,17,0,"FW,MF",20-24,Forward,England,Europe
1032,Alberto Grassi,ITA,Parma,Serie A,2020,25.0,1995.0,13.1,30,11,14,13,3,8,29,27.6,21,22,9,13,26,56,32,0,"MF,DF",25-29,Midfielder,Italy,Europe
1034,Demarai Gray,JAM,Leicester City,Premier League,2020,24.0,1996.0,0.2,1,1,1,0,0,0,0,,0,0,0,0,0,1,0,0,FW,20-24,Forward,Jamaica,North America
1035,Demarai Gray,JAM,Leverkusen,Bundesliga,2020,24.0,1996.0,4.9,3,2,1,2,0,1,1,100.0,0,3,0,3,4,7,3,0,FW,20-24,Forward,Jamaica,North America
1036,Adrian Grbić,AUT,Lorient,Ligue 1,2020,23.0,1996.0,10.7,6,4,2,2,2,1,7,14.3,6,6,0,6,5,11,7,0,FW,20-24,Forward,Austria,Europe
1037,Jack Grealish,ENG,Aston Villa,Premier League,2020,24.0,1995.0,24.3,31,14,8,16,7,15,24,62.5,9,20,3,17,12,43,5,3,"FW,MF",20-24,Forward,England,Europe
1038,Etienne Green,ENG,Saint-Étienne,Ligue 1,2020,20.0,2000.0,8.0,0,0,0,0,0,0,0,,0,0,0,0,0,0,3,0,GK,20-24,Goalkeeper,England,Europe
1039,Mason Greenwood,ENG,Manchester Utd,Premier League,2020,18.0,2001.0,20.2,13,10,6,4,3,5,22,22.7,17,9,0,9,5,18,1,0,FW,Under 20,Forward,England,Europe
1040,Michael Gregoritsch,AUT,Augsburg,Bundesliga,2020,26.0,1994.0,9.3,13,10,6,7,0,3,10,30.0,7,2,0,2,3,16,17,0,"FW,MF",25-29,Forward,Austria,Europe
1041,Clément Grenier,FRA,Rennes,Ligue 1,2020,29.0,1991.0,12.0,20,8,9,8,3,7,31,22.6,24,7,0,7,5,25,3,0,"MF,FW",25-29,Midfielder,France,Europe
1042,Sebastian Griesbeck,GER,Union Berlin,Bundesliga,2020,29.0,1990.0,9.9,20,9,8,11,1,8,19,42.1,11,13,3,10,5,25,8,0,MF,25-29,Midfielder,Germany,Europe
1043,Antoine Griezmann,FRA,Barcelona,La Liga,2020,29.0,1991.0,28.9,37,22,10,18,9,12,40,30.0,28,20,1,19,12,49,11,0,"FW,MF",25-29,Forward,France,Europe
1044,Vincenzo Grifo,ITA,Freiburg,Bundesliga,2020,27.0,1993.0,25.7,18,7,6,7,5,14,34,41.2,20,13,0,13,27,45,18,1,"MF,FW",25-29,Midfielder,Italy,Europe
1045,Lennart Grill,GER,Leverkusen,Bundesliga,2020,21.0,1999.0,4.0,0,0,0,0,0,0,0,,0,0,0,0,0,0,2,0,GK,20-24,Goalkeeper,Germany,Europe
1046,Florian Grillitsch,AUT,Hoffenheim,Bundesliga,2020,24.0,1995.0,20.9,37,21,21,13,3,19,52,36.5,33,38,7,31,51,88,47,1,"MF,DF",20-24,Midfielder,Austria,Europe
1047,Christian Groß,GER,Werder Bremen,Bundesliga,2020,31.0,1989.0,16.3,44,28,17,25,2,15,37,40.5,22,12,2,10,24,68,37,0,"MF,DF",30-34,Midfielder,Germany,Europe
1048,Pascal Groß,GER,Brighton,Premier League,2020,29.0,1991.0,27.6,45,24,24,15,6,24,53,45.3,29,25,4,21,23,68,18,1,"MF,DF",25-29,Midfielder,Germany,Europe
1050,Ilia Gruev,BUL,Werder Bremen,Bundesliga,2020,20.0,2000.0,0.0,0,0,0,0,0,0,0,,0,0,0,0,0,0,0,0,FW,20-24,Forward,Bulgaria,Europe
1051,Carlos Gruezo,ECU,Augsburg,Bundesliga,2020,25.0,1995.0,23.2,57,32,20,32,5,20,52,38.5,32,32,5,27,35,92,29,1,MF,25-29,Midfielder,Ecuador,South America
1053,Andrés Guardado,MEX,Betis,La Liga,2020,33.0,1986.0,14.6,25,12,10,11,4,10,25,40.0,15,13,3,10,18,43,19,0,MF,30-34,Midfielder,Mexico,North America
1056,Gonçalo Guedes,POR,Valencia,La Liga,2020,23.0,1996.0,25.4,18,12,8,7,3,10,45,22.2,35,24,1,23,8,26,7,0,"MF,FW",20-24,Midfielder,Portugal,Europe
1057,Mattéo Guendouzi,FRA,Hertha BSC,Bundesliga,2020,21.0,1999.0,20.2,24,13,10,12,2,9,25,36.0,16,15,4,11,21,45,24,1,MF,20-24,Midfielder,France,Europe
1058,Raphaël Guerreiro,POR,Dortmund,Bundesliga,2020,26.0,1993.0,24.6,30,13,14,8,8,16,31,51.6,15,21,4,17,28,58,31,1,DF,25-29,Defender,Portugal,Europe
1059,Evann Guessand,CIV,Nice,Ligue 1,2020,19.0,2001.0,0.3,0,0,0,0,0,0,1,0.0,1,1,1,0,1,1,1,0,FW,Under 20,Forward,Ivory Coast,Africa
1060,Kelyan Guessoum,FRA,Nîmes,Ligue 1,2020,21.0,1999.0,12.5,13,7,11,1,1,11,16,68.8,5,8,6,2,24,37,51,0,DF,20-24,Defender,France,Europe
1062,Lamine Gueye,SEN,Metz,Ligue 1,2020,22.0,1998.0,16.2,18,9,4,11,3,7,24,29.2,17,7,2,5,21,39,5,0,"FW,MF",20-24,Forward,Senegal,Africa
1063,Pape Gueye,SEN,Marseille,Ligue 1,2020,21.0,1999.0,22.9,49,21,25,19,5,15,45,33.3,30,25,6,19,47,96,34,0,MF,20-24,Midfielder,Senegal,Africa
1064,John Guidetti,SWE,Alavés,La Liga,2020,28.0,1992.0,2.3,2,2,0,2,0,0,2,0.0,2,0,0,0,1,3,2,0,FW,25-29,Forward,Sweden,Europe
1065,Josuha Guilavogui,FRA,Wolfsburg,Bundesliga,2020,29.0,1990.0,8.3,17,9,9,8,0,5,12,41.7,7,12,5,7,29,46,25,0,"MF,DF",25-29,Midfielder,France,Europe
1066,Frederic Guilbert,FRA,Strasbourg,Ligue 1,2020,25.0,1994.0,12.4,37,19,23,11,3,21,34,61.8,13,14,1,13,33,70,32,0,DF,25-29,Defender,France,Europe
1068,Bruno Guimarães,BRA,Lyon,Ligue 1,2020,22.0,1997.0,19.5,76,34,26,41,9,30,64,46.9,34,24,4,20,14,90,13,0,MF,20-24,Midfielder,Brazil,South America
1069,Serhou Guirassy,GUI,Rennes,Ligue 1,2020,24.0,1996.0,19.6,4,1,1,3,0,1,3,33.3,2,10,1,9,5,9,17,0,FW,20-24,Forward,Guinea,Africa
1070,Péter Gulácsi,HUN,RB Leipzig,Bundesliga,2020,30.0,1990.0,33.0,1,0,1,0,0,1,2,50.0,1,0,0,0,2,3,7,0,GK,30-34,Goalkeeper,Hungary,Europe
1071,Manuel Gulde,GER,Freiburg,Bundesliga,2020,29.0,1991.0,21.7,27,15,12,12,3,5,21,23.8,16,25,15,10,37,64,64,0,DF,25-29,Defender,Germany,Europe
1073,İlkay Gündoğan,GER,Manchester City,Premier League,2020,29.0,1990.0,22.5,25,15,8,12,5,10,39,25.6,29,13,4,9,20,45,9,0,MF,25-29,Midfielder,Germany,Europe
1074,Christian Günter,GER,Freiburg,Bundesliga,2020,27.0,1993.0,34.0,34,19,18,13,3,15,43,34.9,28,38,9,29,29,63,40,0,"DF,MF",25-29,Defender,Germany,Europe
1075,Koray Günter,GER,Hellas Verona,Serie A,2020,25.0,1994.0,19.6,20,10,10,9,1,4,9,44.4,5,27,21,6,70,90,87,0,DF,25-29,Defender,Germany,Europe
1077,Malo Gusto,FRA,Lyon,Ligue 1,2020,17.0,2003.0,0.0,0,0,0,0,0,0,0,,0,0,0,0,0,0,0,0,"DF,MF",Under 20,Defender,France,Europe
1079,Marcos Mauro López Gutiérrez,ARG,Cádiz,La Liga,2020,29.0,1991.0,20.3,23,15,15,8,0,15,24,62.5,9,18,12,6,22,45,78,0,DF,25-29,Defender,Argentina,South America
1081,Manu Gyabuaa,ITA,Atalanta,Serie A,2020,18.0,2001.0,0.0,0,0,0,0,0,0,0,,0,0,0,0,0,0,0,0,MF,Under 20,Midfielder,Italy,Europe
1082,Emmanuel Gyasi,GHA,Spezia,Serie A,2020,26.0,1994.0,31.7,30,16,16,10,4,9,31,29.0,22,13,2,11,14,44,8,0,FW,25-29,Forward,Ghana,Africa
1084,Janik Haberer,GER,Freiburg,Bundesliga,2020,26.0,1994.0,5.4,7,4,4,3,0,3,15,20.0,12,4,1,3,7,14,9,0,"MF,FW",25-29,Midfielder,Germany,Europe
1085,Alexander Hack,GER,Mainz 05,Bundesliga,2020,26.0,1993.0,15.2,32,21,23,8,1,18,31,58.1,13,26,17,9,41,73,91,2,DF,25-29,Defender,Germany,Europe
1086,Antwoine Hackford,ENG,Sheffield Utd,Premier League,2020,16.0,2004.0,0.1,0,0,0,0,0,0,0,,0,0,0,0,0,0,0,0,DF,Under 20,Defender,England,Europe
1087,Munir El Haddadi,MAR,Sevilla,La Liga,2020,24.0,1995.0,9.4,12,8,5,5,2,2,12,16.7,10,6,0,6,5,17,6,0,FW,20-24,Forward,Morocco,Africa
1088,André Hahn,GER,Augsburg,Bundesliga,2020,29.0,1990.0,22.6,31,17,14,13,4,9,44,20.5,35,35,3,32,14,45,24,0,"FW,MF",25-29,Forward,Germany,Europe
1089,Amadou Haidara,MLI,RB Leipzig,Bundesliga,2020,22.0,1998.0,21.2,50,28,20,21,9,11,36,30.6,25,33,1,32,30,80,24,0,"MF,FW",20-24,Midfielder,Mali,Africa
1090,Massadio Haïdara,MLI,Lens,Ligue 1,2020,27.0,1992.0,23.7,48,32,21,21,6,23,37,62.2,14,29,6,23,35,83,60,0,DF,25-29,Defender,Mali,Africa
1091,Achraf Hakimi,MAR,Inter,Serie A,2020,21.0,1998.0,29.6,53,32,23,19,11,23,48,47.9,25,31,1,30,22,75,23,1,DF,20-24,Defender,Morocco,Africa
1092,Sébastien Haller,CIV,West Ham,Premier League,2020,26.0,1994.0,10.4,14,9,1,6,7,4,20,20.0,16,7,1,6,5,19,7,0,FW,25-29,Forward,Ivory Coast,Africa
1093,Marcel Halstenberg,GER,RB Leipzig,Bundesliga,2020,28.0,1991.0,18.3,29,18,20,8,1,19,41,46.3,22,15,3,12,16,45,35,0,DF,25-29,Defender,Germany,Europe
1094,Pierre-Yves Hamel,FRA,Lorient,Ligue 1,2020,26.0,1994.0,9.4,15,8,3,9,3,1,6,16.7,5,12,1,11,10,25,6,0,FW,25-29,Forward,France,Europe
1095,Romain Hamouma,FRA,Saint-Étienne,Ligue 1,2020,33.0,1987.0,19.7,12,7,5,6,1,4,24,16.7,20,17,1,16,7,19,11,0,"FW,MF",30-34,Forward,France,Europe
1097,Lukáš Haraslín,SVK,Sassuolo,Serie A,2020,24.0,1996.0,3.7,8,4,2,5,1,2,5,40.0,3,1,0,1,0,8,2,0,"FW,MF",20-24,Forward,Slovakia,Europe
1098,Amine Harit,MAR,Schalke 04,Bundesliga,2020,23.0,1997.0,23.3,22,13,8,11,3,10,23,43.5,13,9,1,8,17,39,7,1,"MF,FW",20-24,Midfielder,Morocco,Africa
1099,Rekeem Harper,ENG,West Brom,Premier League,2020,20.0,2000.0,0.4,0,0,0,0,0,0,0,,0,2,0,2,1,1,0,0,MF,20-24,Midfielder,England,Europe
1100,Jack Harrison,ENG,Leeds United,Premier League,2020,23.0,1996.0,31.6,63,38,20,30,13,26,59,44.1,33,30,2,28,15,78,21,0,"MF,FW",20-24,Midfielder,England,Europe
1101,Marcel Hartel,GER,Arminia,Bundesliga,2020,24.0,1996.0,18.7,35,19,15,18,2,20,40,50.0,20,17,4,13,26,61,16,1,MF,20-24,Midfielder,Germany,Europe
1102,Makoto Hasebe,JPN,Eint Frankfurt,Bundesliga,2020,36.0,1984.0,25.4,43,29,21,20,2,25,51,49.0,26,31,12,19,31,74,68,2,"DF,MF",35-39,Defender,Japan,Asia
1103,Hans Hateboer,NED,Atalanta,Serie A,2020,26.0,1994.0,19.6,28,17,12,14,2,13,23,56.5,10,8,1,7,17,45,9,0,DF,25-29,Defender,Netherlands,Europe
1104,Kortney Hause,ENG,Aston Villa,Premier League,2020,25.0,1995.0,7.0,4,2,3,1,0,0,3,0.0,3,4,2,2,8,12,53,0,DF,25-29,Defender,England,Europe
1105,Kai Havertz,GER,Chelsea,Premier League,2020,21.0,1999.0,16.9,18,9,6,10,2,6,27,22.2,21,25,0,25,4,22,22,1,"MF,FW",20-24,Midfielder,Germany,Europe
1106,Isaac Hayden,ENG,Newcastle Utd,Premier League,2020,25.0,1995.0,21.6,52,29,23,22,7,14,35,40.0,21,32,9,23,43,95,47,0,"MF,DF",25-29,Midfielder,England,Europe
1107,Eden Hazard,BEL,Real Madrid,La Liga,2020,29.0,1991.0,5.9,3,2,1,2,0,0,3,0.0,3,3,0,3,3,6,0,0,"FW,MF",25-29,Forward,Belgium,Europe
1108,Thorgan Hazard,BEL,Dortmund,Bundesliga,2020,27.0,1993.0,7.3,8,2,6,1,1,3,13,23.1,10,4,0,4,10,18,1,0,"MF,FW",25-29,Midfielder,Belgium,Europe
1109,Jonas Hector,GER,Köln,Bundesliga,2020,30.0,1990.0,14.3,34,22,8,21,5,15,35,42.9,20,24,5,19,19,53,20,1,"MF,FW",30-34,Midfielder,Germany,Europe
1110,Michael Hector,JAM,Fulham,Premier League,2020,28.0,1992.0,2.9,3,2,1,2,0,1,6,16.7,5,4,2,2,0,3,6,0,DF,25-29,Defender,Jamaica,North America
1111,Hwang Hee-chan,KOR,RB Leipzig,Bundesliga,2020,24.0,1996.0,5.1,3,2,1,0,2,1,7,14.3,6,4,0,4,1,4,1,0,"FW,MF",20-24,Forward,South Korea,Asia
1112,Ahmed Hegazi,EGY,West Brom,Premier League,2020,29.0,1991.0,1.0,0,0,0,0,0,0,0,,0,2,0,2,1,1,7,0,DF,25-29,Defender,Egypt,Africa
1113,Dominique Heintz,GER,Freiburg,Bundesliga,2020,26.0,1993.0,15.2,22,11,19,3,0,10,19,52.6,9,10,8,2,35,57,49,0,DF,25-29,Defender,Germany,Europe
1114,Dean Henderson,ENG,Manchester Utd,Premier League,2020,23.0,1997.0,12.5,1,1,1,0,0,1,2,50.0,1,0,0,0,0,1,3,2,GK,20-24,Goalkeeper,England,Europe
1115,Jordan Henderson,ENG,Liverpool,Premier League,2020,30.0,1990.0,18.9,24,15,12,9,3,10,26,38.5,16,12,1,11,34,58,30,0,"MF,DF",30-34,Midfielder,England,Europe
1116,Jeff Hendrick,IRL,Newcastle Utd,Premier League,2020,28.0,1992.0,15.8,8,3,5,3,0,1,13,7.7,12,14,9,5,19,27,18,0,MF,25-29,Midfielder,Republic of Ireland,Europe
1117,Benjamin Henrichs,GER,RB Leipzig,Bundesliga,2020,23.0,1997.0,6.0,12,7,4,5,3,2,9,22.2,7,9,1,8,8,20,8,0,"DF,MF",20-24,Defender,Germany,Europe
1118,Dalbert Henrique,BRA,Rennes,Ligue 1,2020,26.0,1993.0,4.1,7,6,4,2,1,6,8,75.0,2,8,2,6,5,12,8,0,DF,25-29,Defender,Brazil,South America
1119,Eduardo Henrique,BRA,Crotone,Serie A,2020,25.0,1995.0,10.3,5,2,1,4,0,3,12,25.0,9,6,1,5,7,12,7,1,MF,25-29,Midfielder,Brazil,South America
1120,Luis Henrique,BRA,Marseille,Ligue 1,2020,18.0,2001.0,7.5,5,4,3,1,1,4,9,44.4,5,5,1,4,7,12,4,0,"FW,DF",Under 20,Forward,Brazil,South America
1120,Luis Henrique,BRA,Marseille,Ligue 1,2020,18.0,2001.0,7.5,5,4,3,1,1,4,9,44.4,5,5,1,4,7,12,4,0,"FW,DF",Under 20,Forward,Brazil,South America
1120,Luis Henrique,BRA,Marseille,Ligue 1,2020,18.0,2001.0,7.5,5,4,3,1,1,4,9,44.4,5,5,1,4,7,12,4,0,"FW,DF",Under 20,Forward,Brazil,South America
1120,Luis Henrique,BRA,Marseille,Ligue 1,2020,18.0,2001.0,7.5,5,4,3,1,1,4,9,44.4,5,5,1,4,7,12,4,0,"FW,DF",Under 20,Forward,Brazil,South America
1122,Jérôme Hergault,FRA,Lorient,Ligue 1,2020,34.0,1986.0,18.1,38,23,22,10,6,17,31,54.8,14,16,2,14,22,60,34,0,"DF,MF",30-34,Defender,France,Europe
1125,Lucas Hernández,FRA,Bayern Munich,Bundesliga,2020,24.0,1996.0,17.7,41,31,16,17,8,17,31,54.8,14,24,6,18,19,60,38,0,DF,20-24,Defender,France,Europe
1127,Theo Hernández,FRA,Milan,Serie A,2020,22.0,1997.0,32.6,48,29,22,21,5,19,38,50.0,19,29,6,23,34,82,64,5,DF,20-24,Defender,France,Europe
1128,Hernani,BRA,Parma,Serie A,2020,26.0,1994.0,24.3,51,25,21,27,3,29,66,43.9,37,35,4,31,31,82,40,1,MF,25-29,Midfielder,Brazil,South America
1130,Héctor Herrera,MEX,Atlético Madrid,La Liga,2020,30.0,1990.0,7.6,12,7,5,6,1,7,13,53.8,6,7,2,5,14,26,8,0,MF,30-34,Midfielder,Mexico,North America
1132,Yangel Herrera,VEN,Granada,La Liga,2020,22.0,1998.0,25.7,59,26,19,32,8,11,41,26.8,30,53,17,36,26,85,32,1,MF,20-24,Midfielder,Venezuela,South America
1133,Patrick Herrmann,GER,Gladbach,Bundesliga,2020,29.0,1991.0,9.7,9,6,4,3,2,2,14,14.3,12,16,0,16,10,19,8,0,"FW,MF",25-29,Forward,Germany,Europe
1135,Përparim Hetemaj,FIN,Benevento,Serie A,2020,33.0,1986.0,24.6,44,27,21,18,5,26,61,42.6,35,41,5,36,22,66,24,1,MF,30-34,Midfielder,Finland,Europe
1136,Son Heung-min,KOR,Tottenham,Premier League,2020,28.0,1992.0,34.6,32,18,11,14,7,18,72,25.0,54,28,3,25,14,46,8,0,FW,25-29,Forward,South Korea,Asia
1137,Aaron Hickey,SCO,Bologna,Serie A,2020,18.0,2002.0,8.4,12,8,10,2,0,7,17,41.2,10,6,1,5,15,27,15,1,DF,Under 20,Defender,Scotland,Europe
1138,Vitorino Hilton,BRA,Montpellier,Ligue 1,2020,42.0,1977.0,23.5,15,10,10,4,1,3,14,21.4,11,34,26,8,38,53,104,3,DF,Over 40,Defender,Brazil,South America
1139,Martin Hinteregger,AUT,Eint Frankfurt,Bundesliga,2020,27.0,1992.0,28.1,77,49,53,22,2,37,63,58.7,26,31,12,19,44,121,92,0,DF,25-29,Defender,Austria,Europe
1140,Marwin Hitz,SUI,Dortmund,Bundesliga,2020,32.0,1987.0,15.5,1,1,1,0,0,1,1,100.0,0,0,0,0,0,1,7,1,GK,30-34,Goalkeeper,Switzerland,Europe
1141,Wesley Hoedt,NED,Lazio,Serie A,2020,26.0,1994.0,10.6,22,16,18,4,0,10,17,58.8,7,9,5,4,17,39,48,1,DF,25-29,Defender,Netherlands,Europe
1142,Ki-Jana Hoever,NED,Wolves,Premier League,2020,18.0,2002.0,6.4,14,6,11,2,1,10,22,45.5,12,2,0,2,9,23,23,0,"DF,MF",Under 20,Defender,Netherlands,Europe
1143,Nicolas Höfler,GER,Freiburg,Bundesliga,2020,30.0,1990.0,30.3,54,28,16,31,7,23,59,39.0,36,34,10,24,66,120,41,2,MF,30-34,Midfielder,Germany,Europe
1144,Jonas Hofmann,GER,Gladbach,Bundesliga,2020,28.0,1992.0,20.2,26,20,12,12,2,10,53,18.9,43,27,2,25,27,53,9,0,"FW,MF",25-29,Forward,Germany,Europe
1144,Jonas Hofmann,GER,Gladbach,Bundesliga,2020,28.0,1992.0,20.2,26,20,12,12,2,10,53,18.9,43,27,2,25,27,53,9,0,"FW,MF",25-29,Forward,Germany,Europe
1144,Jonas Hofmann,GER,Gladbach,Bundesliga,2020,28.0,1992.0,20.2,26,20,12,12,2,10,53,18.9,43,27,2,25,27,53,9,0,"FW,MF",25-29,Forward,Germany,Europe
1144,Jonas Hofmann,GER,Gladbach,Bundesliga,2020,28.0,1992.0,20.2,26,20,12,12,2,10,53,18.9,43,27,2,25,27,53,9,0,"FW,MF",25-29,Forward,Germany,Europe
1145,Marco Höger,GER,Köln,Bundesliga,2020,30.0,1989.0,0.6,1,0,0,1,0,1,2,50.0,1,2,0,2,2,3,1,0,"DF,MF",30-34,Defender,Germany,Europe
1146,Rob Holding,ENG,Arsenal,Premier League,2020,24.0,1995.0,28.4,43,20,28,13,2,17,35,48.6,18,37,27,10,24,67,120,0,DF,20-24,Defender,England,Europe
1147,Lucas Höler,GER,Freiburg,Bundesliga,2020,26.0,1994.0,23.2,36,24,13,19,4,12,32,37.5,20,19,2,17,16,52,14,0,"FW,MF",25-29,Forward,Germany,Europe
1148,Mason Holgate,ENG,Everton,Premier League,2020,23.0,1996.0,25.4,56,36,31,18,7,20,50,40.0,30,37,13,24,35,91,90,3,DF,20-24,Defender,England,Europe
1149,Jordan Holsgrove,SCO,Celta Vigo,La Liga,2020,20.0,1999.0,1.6,6,4,4,1,1,5,8,62.5,3,2,0,2,2,8,1,0,MF,20-24,Midfielder,Scotland,Europe
1150,Franck Honorat,FRA,Brest,Ligue 1,2020,23.0,1996.0,27.3,28,13,12,10,6,14,37,37.8,23,15,3,12,11,39,24,0,"MF,FW",20-24,Midfielder,France,Europe
1151,Matthew Hoppe,USA,Schalke 04,Bundesliga,2020,19.0,2001.0,14.5,6,6,1,3,2,2,12,16.7,10,8,2,6,4,10,15,0,FW,Under 20,Forward,United States,North America
1152,Jannes Horn,GER,Köln,Bundesliga,2020,23.0,1997.0,19.6,35,19,23,11,1,23,31,74.2,8,19,2,17,10,45,45,0,DF,20-24,Defender,Germany,Europe
1153,Timo Horn,GER,Köln,Bundesliga,2020,27.0,1993.0,33.4,1,0,1,0,0,1,4,25.0,3,1,0,1,0,1,11,2,GK,25-29,Goalkeeper,Germany,Europe
1154,Fraser Hornby,SCO,Reims,Ligue 1,2020,20.0,1999.0,0.4,0,0,0,0,0,0,0,,0,0,0,0,1,1,0,0,"FW,MF",20-24,Forward,Scotland,Europe
1155,Conor Hourihane,IRL,Aston Villa,Premier League,2020,29.0,1991.0,2.5,0,0,0,0,0,0,2,0.0,2,3,0,3,0,0,2,0,MF,25-29,Midfielder,Republic of Ireland,Europe
1156,Lukáš Hrádecký,FIN,Leverkusen,Bundesliga,2020,30.0,1989.0,28.5,0,0,0,0,0,0,1,0.0,1,0,0,0,1,1,11,3,GK,30-34,Goalkeeper,Finland,Europe
1157,Ajdin Hrustic,AUS,Eint Frankfurt,Bundesliga,2020,24.0,1996.0,3.0,6,5,2,3,1,3,10,30.0,7,2,0,2,4,10,3,0,"MF,DF",20-24,Midfielder,Australia,Oceania
1158,Florian Hübner,GER,Union Berlin,Bundesliga,2020,29.0,1991.0,5.8,10,5,7,3,0,7,15,46.7,8,7,3,4,13,23,21,0,DF,25-29,Defender,Germany,Europe
1159,Callum Hudson-Odoi,ENG,Chelsea,Premier League,2020,19.0,2000.0,11.8,23,15,11,7,5,8,21,38.1,13,15,1,14,6,29,6,0,"FW,DF",Under 20,Forward,England,Europe
1160,Niall Huggins,WAL,Leeds United,Premier League,2020,19.0,2000.0,0.4,0,0,0,0,0,0,1,0.0,1,0,0,0,0,0,1,0,DF,Under 20,Defender,Wales,Europe
1161,Mats Hummels,GER,Dortmund,Bundesliga,2020,31.0,1988.0,31.3,58,40,34,18,6,26,42,61.9,16,31,22,9,73,131,122,2,DF,30-34,Defender,Germany,Europe
1162,Adrien Hunou,FRA,Rennes,Ligue 1,2020,26.0,1994.0,6.5,6,3,2,2,2,2,8,25.0,6,7,0,7,1,7,2,0,"FW,MF",25-29,Forward,France,Europe
1163,Klaas-Jan Huntelaar,NED,Schalke 04,Bundesliga,2020,36.0,1983.0,6.5,4,2,0,2,2,0,2,0.0,2,3,1,2,2,6,3,0,FW,35-39,Forward,Netherlands,Europe
1164,Elseid Hysaj,ALB,Napoli,Serie A,2020,26.0,1994.0,19.6,29,17,16,11,2,17,33,51.5,16,18,4,14,30,59,52,0,DF,25-29,Defender,Albania,Europe
1165,Pierre Højbjerg,DEN,Tottenham,Premier League,2020,24.0,1995.0,38.0,98,51,45,42,11,54,129,41.9,75,51,9,42,48,146,66,0,MF,20-24,Midfielder,Denmark,Europe
1166,Simone Iacoponi,ITA,Parma,Serie A,2020,33.0,1987.0,13.3,22,12,16,5,1,13,26,50.0,13,9,4,5,11,33,42,1,DF,30-34,Defender,Italy,Europe
1167,Iago,BRA,Augsburg,Bundesliga,2020,23.0,1997.0,17.3,37,27,21,13,3,17,29,58.6,12,17,5,12,22,59,55,0,DF,20-24,Defender,Brazil,South America
1168,Roger Ibanez,BRA,Roma,Serie A,2020,21.0,1998.0,26.6,59,37,28,25,6,25,45,55.6,20,38,17,21,68,127,78,3,DF,20-24,Defender,Brazil,South America
1169,Vedad Ibišević,BIH,Schalke 04,Bundesliga,2020,35.0,1984.0,1.7,0,0,0,0,0,0,0,,0,1,0,1,1,1,1,0,FW,35-39,Forward,Bosnia and Herzegovina,Europe
1171,Didier Ibrahim Ndong,GAB,Dijon,Ligue 1,2020,26.0,1994.0,29.0,53,32,22,30,1,25,70,35.7,45,35,7,28,37,90,40,0,MF,25-29,Midfielder,Gabon,Africa
1172,Zlatan Ibrahimović,SWE,Milan,Serie A,2020,38.0,1981.0,16.6,5,4,0,4,1,3,6,50.0,3,5,3,2,6,11,27,1,FW,35-39,Forward,Sweden,Europe
1173,Mauro Icardi,ARG,Paris S-G,Ligue 1,2020,27.0,1993.0,12.0,6,2,1,2,3,4,13,30.8,9,3,1,2,3,9,7,0,FW,25-29,Forward,Argentina,South America
1174,Oussama Idrissi,MAR,Sevilla,La Liga,2020,24.0,1996.0,0.3,1,1,0,1,0,1,2,50.0,1,2,0,2,1,2,0,0,"FW,MF",20-24,Forward,Morocco,Africa
1176,Odion Ighalo,NGA,Manchester Utd,Premier League,2020,31.0,1989.0,0.1,0,0,0,0,0,0,1,0.0,1,0,0,0,0,0,0,0,FW,30-34,Forward,Nigeria,Africa
1179,Igor,BRA,Fiorentina,Serie A,2020,22.0,1998.0,13.0,15,9,9,6,0,7,12,58.3,5,17,9,8,23,38,34,0,DF,20-24,Defender,Brazil,South America
1179,Igor,BRA,Fiorentina,Serie A,2020,22.0,1998.0,13.0,15,9,9,6,0,7,12,58.3,5,17,9,8,23,38,34,0,DF,20-24,Defender,Brazil,South America
1179,Igor,BRA,Fiorentina,Serie A,2020,22.0,1998.0,13.0,15,9,9,6,0,7,12,58.3,5,17,9,8,23,38,34,0,DF,20-24,Defender,Brazil,South America
1179,Igor,BRA,Fiorentina,Serie A,2020,22.0,1998.0,13.0,15,9,9,6,0,7,12,58.3,5,17,9,8,23,38,34,0,DF,20-24,Defender,Brazil,South America
1180,Kelechi Iheanacho,NGA,Leicester City,Premier League,2020,23.0,1996.0,16.2,12,5,2,4,6,4,17,23.5,13,14,0,14,2,14,1,1,FW,20-24,Forward,Nigeria,Africa
1181,Jonathan Ikone,FRA,Lille,Ligue 1,2020,22.0,1998.0,24.2,18,12,3,8,7,9,22,40.9,13,16,1,15,7,25,9,0,"MF,FW",20-24,Midfielder,France,Europe
1182,Yun Il-lok,KOR,Montpellier,Ligue 1,2020,28.0,1992.0,3.5,0,0,0,0,0,0,4,0.0,4,0,0,0,5,5,1,0,"MF,FW",25-29,Midfielder,South Korea,Asia
1186,Stefan Ilsanker,AUT,Eint Frankfurt,Bundesliga,2020,31.0,1989.0,17.5,33,20,17,15,1,21,42,50.0,21,30,8,22,30,63,51,2,"MF,DF",30-34,Midfielder,Austria,Europe
1187,Ciro Immobile,ITA,Lazio,Serie A,2020,30.0,1990.0,31.7,14,13,4,6,4,7,22,31.8,15,13,1,12,6,20,9,0,FW,30-34,Forward,Italy,Europe
1188,Riccardo Improta,ITA,Benevento,Serie A,2020,26.0,1993.0,25.9,39,23,25,8,6,21,45,46.7,24,23,4,19,28,67,47,0,"DF,MF",25-29,Defender,Italy,Europe
1189,Roberto Inglese,ITA,Parma,Serie A,2020,28.0,1991.0,6.4,5,2,1,2,2,2,11,18.2,9,10,0,10,0,5,3,0,FW,25-29,Forward,Italy,Europe
1190,Danny Ings,ENG,Southampton,Premier League,2020,28.0,1992.0,24.1,22,13,3,16,3,12,28,42.9,16,39,2,37,3,25,27,1,FW,25-29,Forward,England,Europe
1191,Marcus Ingvartsen,DEN,Union Berlin,Bundesliga,2020,24.0,1996.0,21.8,17,11,5,6,6,8,26,30.8,18,22,0,22,18,35,10,0,"MF,FW",20-24,Midfielder,Denmark,Europe
1192,Lorenzo Insigne,ITA,Napoli,Serie A,2020,29.0,1991.0,31.8,26,18,8,12,6,13,72,18.1,59,30,1,29,37,63,6,1,FW,25-29,Forward,Italy,Europe
1193,Roberto Insigne,ITA,Benevento,Serie A,2020,26.0,1994.0,17.8,16,10,8,3,5,7,27,25.9,20,10,0,10,7,23,9,0,"MF,FW",25-29,Midfielder,Italy,Europe
1195,Takashi Inui,JPN,Eibar,La Liga,2020,32.0,1988.0,20.2,13,8,6,3,4,3,12,25.0,9,19,0,19,12,25,7,0,"MF,FW",30-34,Midfielder,Japan,Asia
1196,Artur Ioniță,MDA,Benevento,Serie A,2020,29.0,1990.0,31.5,47,22,11,31,5,17,63,27.0,46,38,14,24,19,66,28,0,MF,25-29,Midfielder,Moldova,Europe
1197,Alexander Isak,SWE,Real Sociedad,La Liga,2020,20.0,1999.0,26.0,9,5,0,3,6,3,8,37.5,5,17,1,16,3,12,7,0,FW,20-24,Forward,Sweden,Europe
1199,Ardian Ismajli,ALB,Spezia,Serie A,2020,23.0,1996.0,14.4,19,9,10,8,1,8,13,61.5,5,10,7,3,23,42,52,1,DF,20-24,Defender,Albania,Europe
1200,Abass Issah,GHA,Mainz 05,Bundesliga,2020,21.0,1998.0,0.2,0,0,0,0,0,0,0,,0,0,0,0,0,0,0,0,"DF,FW",20-24,Defender,Ghana,Africa
1202,Alex Iwobi,NGA,Everton,Premier League,2020,24.0,1996.0,17.1,27,10,10,14,3,13,25,52.0,12,20,1,19,16,43,14,0,"FW,MF",20-24,Forward,Nigeria,Africa
1204,José Izquierdo,COL,Brighton,Premier League,2020,28.0,1992.0,0.1,0,0,0,0,0,0,0,,0,0,0,0,0,0,0,0,DF,25-29,Defender,Colombia,South America
1205,Armando Izzo,ITA,Torino,Serie A,2020,28.0,1992.0,22.3,30,16,13,13,4,13,33,39.4,20,22,9,13,53,83,62,0,DF,25-29,Defender,Italy,Europe
1206,Phil Jagielka,ENG,Sheffield Utd,Premier League,2020,37.0,1982.0,5.8,5,4,4,0,1,2,7,28.6,5,11,5,6,10,15,26,2,DF,35-39,Defender,England,Europe
1207,Alireza Jahanbakhsh,IRN,Brighton,Premier League,2020,26.0,1993.0,5.9,9,7,3,5,1,2,12,16.7,10,8,0,8,8,17,1,0,"FW,MF",25-29,Forward,Iran,Asia
1208,Mato Jajalo,BIH,Udinese,Serie A,2020,32.0,1988.0,0.4,1,1,1,0,0,1,1,100.0,0,1,0,1,2,3,0,0,MF,30-34,Midfielder,Bosnia and Herzegovina,Europe
1209,Ismail Jakobs,SEN,Köln,Bundesliga,2020,20.0,1999.0,19.2,25,10,17,4,4,11,21,52.4,10,18,1,17,16,41,36,0,"MF,FW",20-24,Midfielder,Senegal,Africa
1210,Daniel James,WAL,Manchester Utd,Premier League,2020,22.0,1997.0,10.1,15,9,4,7,4,3,18,16.7,15,10,1,9,0,15,6,0,FW,20-24,Forward,Wales,Europe
1211,Reece James,ENG,Chelsea,Premier League,2020,20.0,1999.0,26.4,55,35,24,22,9,21,44,47.7,23,36,7,29,17,72,52,0,DF,20-24,Defender,England,Europe
1211,Reece James,ENG,Chelsea,Premier League,2020,20.0,1999.0,26.4,55,35,24,22,9,21,44,47.7,23,36,7,29,17,72,52,0,DF,20-24,Defender,England,Europe
1211,Reece James,ENG,Chelsea,Premier League,2020,20.0,1999.0,26.4,55,35,24,22,9,21,44,47.7,23,36,7,29,17,72,52,0,DF,20-24,Defender,England,Europe
1211,Reece James,ENG,Chelsea,Premier League,2020,20.0,1999.0,26.4,55,35,24,22,9,21,44,47.7,23,36,7,29,17,72,52,0,DF,20-24,Defender,England,Europe
1212,Alexandre Jankewitz,SUI,Southampton,Premier League,2020,18.0,2001.0,0.0,2,1,2,0,0,1,1,100.0,0,0,0,0,0,2,0,0,MF,Under 20,Midfielder,Switzerland,Europe
1213,Saidy Janko,GAM,Valladolid,La Liga,2020,24.0,1995.0,13.6,19,10,12,5,2,8,14,57.1,6,9,1,8,18,37,47,0,DF,20-24,Defender,Gambia,Africa
1215,Tony Jantschke,GER,Gladbach,Bundesliga,2020,30.0,1990.0,3.0,2,2,1,1,0,1,3,33.3,2,6,4,2,4,6,7,0,DF,30-34,Defender,Germany,Europe
1216,Adnan Januzaj,BEL,Real Sociedad,La Liga,2020,25.0,1995.0,11.3,9,8,0,6,3,3,8,37.5,5,7,2,5,3,12,4,0,"FW,MF",25-29,Forward,Belgium,Europe
1219,Luis Javier Suárez,COL,Granada,La Liga,2020,22.0,1997.0,18.5,19,11,5,7,7,6,17,35.3,11,10,1,9,8,27,11,0,"FW,MF",20-24,Forward,Colombia,South America
1220,Corentin Jean,FRA,Lens,Ligue 1,2020,25.0,1995.0,6.4,4,3,1,1,2,0,5,0.0,5,4,0,4,2,6,2,0,"FW,MF",25-29,Forward,France,Europe
1221,Daniel Jebbison,ENG,Sheffield Utd,Premier League,2020,16.0,2003.0,3.2,6,2,1,3,2,3,7,42.9,4,6,1,5,1,7,0,0,FW,Under 20,Forward,England,Europe
1222,Tin Jedvaj,CRO,Leverkusen,Bundesliga,2020,24.0,1995.0,1.7,5,2,2,3,0,1,3,33.3,2,2,1,1,2,7,9,0,DF,20-24,Defender,Croatia,Europe
1223,Fredrik Jensen,FIN,Augsburg,Bundesliga,2020,22.0,1997.0,4.2,3,2,1,2,0,3,6,50.0,3,4,1,3,2,5,6,0,"FW,MF",20-24,Forward,Finland,Europe
1225,Gabriel Jesus,BRA,Manchester City,Premier League,2020,23.0,1997.0,22.9,17,6,5,5,7,11,28,39.3,17,16,0,16,15,32,5,0,FW,20-24,Forward,Brazil,South America
1226,Juan Jesus,BRA,Roma,Serie A,2020,29.0,1991.0,1.7,3,1,2,1,0,2,4,50.0,2,1,0,1,2,5,5,0,DF,25-29,Defender,Brazil,South America
1227,Raúl Jiménez,MEX,Wolves,Premier League,2020,29.0,1991.0,9.1,3,2,1,2,0,0,7,0.0,7,2,0,2,8,11,12,0,FW,25-29,Forward,Mexico,North America
1229,John Joe,IRL,Getafe,La Liga,2020,16.0,2003.0,0.7,2,0,0,2,0,0,0,,0,0,0,0,0,2,0,0,"MF,FW",Under 20,Midfielder,Republic of Ireland,Europe
1230,Joelinton,BRA,Newcastle Utd,Premier League,2020,23.0,1996.0,22.0,33,21,7,21,5,14,37,37.8,23,30,2,28,9,42,24,0,"FW,MF",20-24,Forward,Brazil,South America
1231,Marco John,GER,Hoffenheim,Bundesliga,2020,18.0,2002.0,11.1,21,15,9,5,7,10,22,45.5,12,18,1,17,16,37,21,0,DF,Under 20,Defender,Germany,Europe
1232,Ben Johnson,ENG,West Ham,Premier League,2020,20.0,2000.0,5.8,11,5,5,3,3,7,9,77.8,2,5,1,4,11,22,9,0,"DF,FW",20-24,Defender,England,Europe
1233,Sam Johnstone,ENG,West Brom,Premier League,2020,27.0,1993.0,37.0,0,0,0,0,0,0,0,,0,0,0,0,2,2,15,2,GK,25-29,Goalkeeper,England,Europe
1234,Curtis Jones,ENG,Liverpool,Premier League,2020,19.0,2001.0,13.1,16,6,6,7,3,12,25,48.0,13,13,0,13,19,35,11,1,MF,Under 20,Midfielder,England,Europe
1235,Frenkie de Jong,NED,Barcelona,La Liga,2020,23.0,1997.0,35.0,44,27,21,19,4,15,35,42.9,20,20,4,16,38,82,29,2,"MF,DF",20-24,Midfielder,Netherlands,Europe
1236,Luuk de Jong,NED,Sevilla,La Liga,2020,29.0,1990.0,14.1,9,5,3,2,4,1,7,14.3,6,11,3,8,5,14,15,0,FW,25-29,Forward,Netherlands,Europe
1239,Jorginho,ITA,Chelsea,Premier League,2020,28.0,1991.0,22.3,57,30,22,31,4,31,76,40.8,45,33,5,28,40,97,21,3,MF,25-29,Midfielder,Italy,Europe
1239,Jorginho,ITA,Chelsea,Premier League,2020,28.0,1991.0,22.3,57,30,22,31,4,31,76,40.8,45,33,5,28,40,97,21,3,MF,25-29,Midfielder,Italy,Europe
1239,Jorginho,ITA,Chelsea,Premier League,2020,28.0,1991.0,22.3,57,30,22,31,4,31,76,40.8,45,33,5,28,40,97,21,3,MF,25-29,Midfielder,Italy,Europe
1239,Jorginho,ITA,Chelsea,Premier League,2020,28.0,1991.0,22.3,57,30,22,31,4,31,76,40.8,45,33,5,28,40,97,21,3,MF,25-29,Midfielder,Italy,Europe
1239,Jorginho,ITA,Chelsea,Premier League,2020,28.0,1991.0,22.3,57,30,22,31,4,31,76,40.8,45,33,5,28,40,97,21,3,MF,25-29,Midfielder,Italy,Europe
1239,Jorginho,ITA,Chelsea,Premier League,2020,28.0,1991.0,22.3,57,30,22,31,4,31,76,40.8,45,33,5,28,40,97,21,3,MF,25-29,Midfielder,Italy,Europe
1239,Jorginho,ITA,Chelsea,Premier League,2020,28.0,1991.0,22.3,57,30,22,31,4,31,76,40.8,45,33,5,28,40,97,21,3,MF,25-29,Midfielder,Italy,Europe
1239,Jorginho,ITA,Chelsea,Premier League,2020,28.0,1991.0,22.3,57,30,22,31,4,31,76,40.8,45,33,5,28,40,97,21,3,MF,25-29,Midfielder,Italy,Europe
1239,Jorginho,ITA,Chelsea,Premier League,2020,28.0,1991.0,22.3,57,30,22,31,4,31,76,40.8,45,33,5,28,40,97,21,3,MF,25-29,Midfielder,Italy,Europe
1239,Jorginho,ITA,Chelsea,Premier League,2020,28.0,1991.0,22.3,57,30,22,31,4,31,76,40.8,45,33,5,28,40,97,21,3,MF,25-29,Midfielder,Italy,Europe
1239,Jorginho,ITA,Chelsea,Premier League,2020,28.0,1991.0,22.3,57,30,22,31,4,31,76,40.8,45,33,5,28,40,97,21,3,MF,25-29,Midfielder,Italy,Europe
1239,Jorginho,ITA,Chelsea,Premier League,2020,28.0,1991.0,22.3,57,30,22,31,4,31,76,40.8,45,33,5,28,40,97,21,3,MF,25-29,Midfielder,Italy,Europe
1239,Jorginho,ITA,Chelsea,Premier League,2020,28.0,1991.0,22.3,57,30,22,31,4,31,76,40.8,45,33,5,28,40,97,21,3,MF,25-29,Midfielder,Italy,Europe
1239,Jorginho,ITA,Chelsea,Premier League,2020,28.0,1991.0,22.3,57,30,22,31,4,31,76,40.8,45,33,5,28,40,97,21,3,MF,25-29,Midfielder,Italy,Europe
1239,Jorginho,ITA,Chelsea,Premier League,2020,28.0,1991.0,22.3,57,30,22,31,4,31,76,40.8,45,33,5,28,40,97,21,3,MF,25-29,Midfielder,Italy,Europe
1239,Jorginho,ITA,Chelsea,Premier League,2020,28.0,1991.0,22.3,57,30,22,31,4,31,76,40.8,45,33,5,28,40,97,21,3,MF,25-29,Midfielder,Italy,Europe
1241,Willian José,BRA,Wolves,Premier League,2020,28.0,1991.0,12.3,2,1,1,1,0,1,4,25.0,3,6,1,5,1,3,12,0,FW,25-29,Forward,Brazil,South America
1242,Willian José,BRA,Real Sociedad,La Liga,2020,28.0,1991.0,7.7,3,1,0,3,0,1,3,33.3,2,3,1,2,0,3,8,0,FW,25-29,Forward,Brazil,South America
1245,Jota,POR,Valladolid,La Liga,2020,21.0,1999.0,7.4,7,3,1,4,2,5,10,50.0,5,4,0,4,6,13,5,1,"MF,FW",20-24,Midfielder,Portugal,Europe
1245,Jota,POR,Valladolid,La Liga,2020,21.0,1999.0,7.4,7,3,1,4,2,5,10,50.0,5,4,0,4,6,13,5,1,"MF,FW",20-24,Midfielder,Portugal,Europe
1245,Jota,POR,Valladolid,La Liga,2020,21.0,1999.0,7.4,7,3,1,4,2,5,10,50.0,5,4,0,4,6,13,5,1,"MF,FW",20-24,Midfielder,Portugal,Europe
1245,Jota,POR,Valladolid,La Liga,2020,21.0,1999.0,7.4,7,3,1,4,2,5,10,50.0,5,4,0,4,6,13,5,1,"MF,FW",20-24,Midfielder,Portugal,Europe
1245,Jota,POR,Valladolid,La Liga,2020,21.0,1999.0,7.4,7,3,1,4,2,5,10,50.0,5,4,0,4,6,13,5,1,"MF,FW",20-24,Midfielder,Portugal,Europe
1245,Jota,POR,Valladolid,La Liga,2020,21.0,1999.0,7.4,7,3,1,4,2,5,10,50.0,5,4,0,4,6,13,5,1,"MF,FW",20-24,Midfielder,Portugal,Europe
1245,Jota,POR,Valladolid,La Liga,2020,21.0,1999.0,7.4,7,3,1,4,2,5,10,50.0,5,4,0,4,6,13,5,1,"MF,FW",20-24,Midfielder,Portugal,Europe
1245,Jota,POR,Valladolid,La Liga,2020,21.0,1999.0,7.4,7,3,1,4,2,5,10,50.0,5,4,0,4,6,13,5,1,"MF,FW",20-24,Midfielder,Portugal,Europe
1245,Jota,POR,Valladolid,La Liga,2020,21.0,1999.0,7.4,7,3,1,4,2,5,10,50.0,5,4,0,4,6,13,5,1,"MF,FW",20-24,Midfielder,Portugal,Europe
1247,Diogo Jota,POR,Liverpool,Premier League,2020,23.0,1996.0,12.4,12,6,4,7,1,2,29,6.9,27,9,0,9,5,17,3,0,FW,20-24,Forward,Portugal,Europe
1248,Stevan Jovetić,MNE,Monaco,Ligue 1,2020,30.0,1989.0,8.9,8,4,2,3,3,3,13,23.1,10,1,0,1,3,11,3,0,"FW,MF",30-34,Forward,Montenegro,Europe
1252,Hamed Junior Traorè,CIV,Sassuolo,Serie A,2020,20.0,2000.0,19.9,29,17,10,10,9,14,35,40.0,21,27,3,24,18,47,9,0,"MF,FW",20-24,Midfielder,Ivory Coast,Africa
1253,Vinicius Júnior,BRA,Real Madrid,La Liga,2020,20.0,2000.0,21.9,32,22,14,10,8,11,43,25.6,32,28,0,28,7,39,4,0,FW,20-24,Forward,Brazil,South America
1254,James Justin,ENG,Leicester City,Premier League,2020,22.0,1998.0,23.0,61,37,38,18,5,20,41,48.8,21,36,10,26,30,91,58,1,DF,20-24,Defender,England,Europe
1255,Musa Juwara,GAM,Bologna,Serie A,2020,18.0,2001.0,0.5,2,2,2,0,0,1,3,33.3,2,1,0,1,0,2,0,0,"MF,DF",Under 20,Midfielder,Gambia,Africa
1256,Jens Jønsson,DEN,Cádiz,La Liga,2020,27.0,1993.0,29.1,55,29,25,25,5,22,52,42.3,30,39,7,32,51,106,45,0,MF,25-29,Midfielder,Denmark,Europe
1257,Ozan Kabak,TUR,Liverpool,Premier League,2020,20.0,2000.0,8.9,19,10,11,4,4,6,9,66.7,3,2,2,0,12,31,28,1,DF,20-24,Defender,Turkey,Asia
1258,Ozan Kabak,TUR,Schalke 04,Bundesliga,2020,20.0,2000.0,13.8,17,9,11,5,1,6,13,46.2,7,20,11,9,13,30,57,0,DF,20-24,Defender,Turkey,Asia
1259,Abdoul Kader Bamba,FRA,Nantes,Ligue 1,2020,26.0,1994.0,10.2,18,3,7,8,3,11,18,61.1,7,10,0,10,7,25,4,1,"FW,MF",25-29,Forward,France,Europe
1261,Tino Kadewere,ZIM,Lyon,Ligue 1,2020,24.0,1996.0,22.3,35,22,12,16,7,17,49,34.7,32,16,3,13,21,56,31,0,FW,20-24,Forward,Zimbabwe,Africa
1263,Florian Kainz,AUT,Köln,Bundesliga,2020,27.0,1992.0,5.0,4,2,0,4,0,2,8,25.0,6,7,0,7,3,7,3,0,"MF,FW",25-29,Midfielder,Austria,Europe
1264,Gaël Kakuta,COD,Lens,Ligue 1,2020,29.0,1991.0,26.6,38,23,10,18,10,8,44,18.2,36,24,3,21,17,55,4,0,"MF,FW",25-29,Midfielder,DR Congo,Africa
1265,Sasa Kalajdzic,AUT,Stuttgart,Bundesliga,2020,23.0,1997.0,23.7,16,12,4,5,7,2,17,11.8,15,10,1,9,9,25,21,0,FW,20-24,Forward,Austria,Europe
1266,Arnaud Kalimuendo,FRA,Paris S-G,Ligue 1,2020,18.0,2002.0,0.8,0,0,0,0,0,0,0,,0,0,0,0,0,0,0,0,FW,Under 20,Forward,France,Europe
1267,Arnaud Kalimuendo,FRA,Lens,Ligue 1,2020,18.0,2002.0,13.5,8,2,2,2,4,1,7,14.3,6,11,0,11,2,10,2,0,"FW,MF",Under 20,Forward,France,Europe
1268,Nikola Kalinić,CRO,Hellas Verona,Serie A,2020,32.0,1988.0,11.8,5,1,2,2,1,0,3,0.0,3,6,0,6,1,6,7,0,FW,30-34,Forward,Croatia,Europe
1269,Yayah Kallon,SLE,Genoa,Serie A,2020,19.0,2001.0,0.5,0,0,0,0,0,0,0,,0,0,0,0,0,0,0,0,FW,Under 20,Forward,Sierra Leone,Africa
1270,Samuel Kalu,NGA,Bordeaux,Ligue 1,2020,22.0,1997.0,10.7,21,12,11,8,2,4,13,30.8,9,14,0,14,9,30,2,0,"FW,MF",20-24,Forward,Nigeria,Africa
1271,Pierre Kalulu,FRA,Milan,Serie A,2020,20.0,2000.0,8.1,18,14,11,6,1,10,14,71.4,4,9,3,6,19,37,20,0,DF,20-24,Defender,France,Europe
1272,Daichi Kamada,JPN,Eint Frankfurt,Bundesliga,2020,23.0,1996.0,26.2,48,28,21,16,11,16,49,32.7,33,18,1,17,14,62,22,0,MF,20-24,Midfielder,Japan,Asia
1273,Aboubakar Kamara,MTN,Fulham,Premier League,2020,25.0,1995.0,3.5,2,2,1,1,0,0,5,0.0,5,6,0,6,1,3,0,0,"FW,MF",25-29,Forward,Mauritania,Africa
1274,Aboubakar Kamara,MTN,Dijon,Ligue 1,2020,25.0,1995.0,6.2,3,1,0,2,1,1,7,14.3,6,1,0,1,0,3,2,0,"FW,MF",25-29,Forward,Mauritania,Africa
1275,Bingourou Kamara,SEN,Strasbourg,Ligue 1,2020,23.0,1996.0,8.0,1,1,1,0,0,1,3,33.3,2,0,0,0,1,2,2,1,GK,20-24,Goalkeeper,Senegal,Africa
1276,Boubacar Kamara,FRA,Marseille,Ligue 1,2020,20.0,1999.0,32.2,88,51,31,49,8,40,74,54.1,34,36,13,23,34,122,51,0,MF,20-24,Midfielder,France,Europe
1277,Hassane Kamara,CIV,Nice,Ligue 1,2020,26.0,1994.0,32.9,65,39,40,16,9,27,49,55.1,22,39,12,27,55,120,61,1,"DF,FW",25-29,Defender,Ivory Coast,Africa
1280,Harry Kane,ENG,Tottenham,Premier League,2020,27.0,1993.0,34.2,22,12,1,17,4,8,26,30.8,18,28,11,17,11,33,40,0,FW,25-29,Forward,England,Europe
1281,Lee Kang-in,KOR,Valencia,La Liga,2020,19.0,2001.0,14.0,15,11,8,4,3,3,31,9.7,28,12,0,12,2,17,0,0,"FW,MF",Under 20,Forward,South Korea,Asia
1282,Wilfried Kanga,CIV,Angers,Ligue 1,2020,22.0,1998.0,1.5,0,0,0,0,0,0,1,0.0,1,1,0,1,0,0,2,0,FW,20-24,Forward,Ivory Coast,Africa
1283,N'Golo Kanté,FRA,Chelsea,Premier League,2020,29.0,1991.0,23.8,79,42,39,35,5,27,56,48.2,29,42,4,38,59,138,34,0,MF,25-29,Midfielder,France,Europe
1284,Jimmy Kaparos,GER,Schalke 04,Bundesliga,2020,18.0,2001.0,0.2,0,0,0,0,0,0,1,0.0,1,0,0,0,0,0,0,0,MF,Under 20,Midfielder,Germany,Europe
1285,Yann Karamoh,FRA,Parma,Serie A,2020,22.0,1998.0,14.4,27,17,8,12,7,11,31,35.5,20,6,0,6,4,31,11,0,"FW,MF",20-24,Forward,France,Europe
1286,Isaac Karamoko,FRA,Sassuolo,Serie A,2020,18.0,2002.0,0.0,1,0,0,0,1,1,1,100.0,0,0,0,0,0,1,0,0,DF,Under 20,Defender,France,Europe
1288,Augustus Kargbo,SLE,Crotone,Serie A,2020,20.0,1999.0,0.4,0,0,0,0,0,0,0,,0,0,0,0,0,0,0,0,FW,20-24,Forward,Sierra Leone,Africa
1289,Loris Karius,GER,Union Berlin,Bundesliga,2020,27.0,1993.0,3.2,0,0,0,0,0,0,0,,0,0,0,0,0,0,2,0,GK,25-29,Goalkeeper,Germany,Europe
1290,Rick Karsdorp,NED,Roma,Serie A,2020,25.0,1995.0,28.3,36,23,19,12,5,21,48,43.8,27,18,1,17,30,66,32,0,DF,25-29,Defender,Netherlands,Europe
1291,Silas Katompa,COD,Stuttgart,Bundesliga,2020,21.0,1998.0,21.3,48,29,19,19,10,21,44,47.7,23,29,1,28,22,70,11,2,"DF,FW",20-24,Defender,DR Congo,Africa
1292,Noah Katterbach,GER,Köln,Bundesliga,2020,19.0,2001.0,12.3,18,11,11,6,1,13,21,61.9,8,7,3,4,23,41,22,0,"DF,MF",Under 20,Defender,Germany,Europe
1293,Eiji Kawashima,JPN,Strasbourg,Ligue 1,2020,37.0,1983.0,24.0,1,0,1,0,0,1,1,100.0,0,0,0,0,0,1,4,2,GK,35-39,Goalkeeper,Japan,Asia
1294,Moise Kean,ITA,Everton,Premier League,2020,20.0,2000.0,0.2,0,0,0,0,0,0,0,,0,0,0,0,0,0,0,0,"FW,MF",20-24,Forward,Italy,Europe
1295,Moise Kean,ITA,Paris S-G,Ligue 1,2020,20.0,2000.0,18.9,11,8,2,6,3,3,12,25.0,9,7,1,6,8,19,10,0,FW,20-24,Forward,Italy,Europe
1296,Michael Keane,ENG,Everton,Premier League,2020,27.0,1993.0,33.2,28,15,20,8,0,14,31,45.2,17,46,33,13,51,79,161,0,DF,25-29,Defender,England,Europe
1297,Neeskens Kebano,COD,Fulham,Premier League,2020,28.0,1992.0,1.3,0,0,0,0,0,0,1,0.0,1,3,0,3,0,0,0,0,"FW,MF",25-29,Forward,DR Congo,Africa
1298,Thilo Kehrer,GER,Paris S-G,Ligue 1,2020,23.0,1996.0,18.0,31,26,17,11,3,10,26,38.5,16,16,4,12,15,46,37,1,DF,20-24,Defender,Germany,Europe
1299,Habib Keita,MLI,Lyon,Ligue 1,2020,18.0,2002.0,0.1,0,0,0,0,0,0,0,,0,0,0,0,0,0,0,0,MF,Under 20,Midfielder,Mali,Africa
1300,Naby Keïta,GUI,Liverpool,Premier League,2020,25.0,1995.0,5.8,11,5,1,8,2,7,17,41.2,10,10,0,10,9,20,6,0,MF,25-29,Midfielder,Guinea,Africa
1301,Yannik Keitel,GER,Freiburg,Bundesliga,2020,20.0,2000.0,5.5,12,8,7,4,1,7,9,77.8,2,9,3,6,10,22,8,0,MF,20-24,Midfielder,Germany,Europe
1302,Caoimhín Kelleher,IRL,Liverpool,Premier League,2020,21.0,1998.0,2.0,0,0,0,0,0,0,0,,0,0,0,0,0,0,2,0,GK,20-24,Goalkeeper,Republic of Ireland,Europe
1303,Stephane Keller,CMR,Alavés,La Liga,2020,18.0,2001.0,0.2,1,0,1,0,0,1,1,100.0,0,0,0,0,0,1,0,0,DF,Under 20,Defender,Cameroon,Africa
1304,Martin Kelly,ENG,Crystal Palace,Premier League,2020,30.0,1990.0,0.0,1,0,1,0,0,1,1,100.0,0,0,0,0,0,1,0,0,DF,30-34,Defender,England,Europe
1305,Marc-Oliver Kempf,GER,Stuttgart,Bundesliga,2020,25.0,1995.0,30.3,49,26,28,18,3,29,49,59.2,20,40,25,15,68,117,103,1,DF,25-29,Defender,Germany,Europe
1306,Kenedy,BRA,Granada,La Liga,2020,24.0,1996.0,16.3,22,12,10,7,5,5,25,20.0,20,21,4,17,26,48,15,1,"FW,MF",20-24,Forward,Brazil,South America
1307,Jonjoe Kenny,ENG,Everton,Premier League,2020,23.0,1997.0,0.9,2,1,1,0,1,2,2,100.0,0,0,0,0,1,3,3,0,DF,20-24,Defender,England,Europe
1308,Franck Kessié,CIV,Milan,Serie A,2020,23.0,1996.0,35.8,53,30,28,19,6,20,38,52.6,18,47,15,32,46,99,51,0,MF,20-24,Midfielder,Ivory Coast,Africa
1309,Reda Khadra,GER,Brighton,Premier League,2020,19.0,2001.0,0.1,0,0,0,0,0,0,0,,0,0,0,0,0,0,0,0,MF,Under 20,Midfielder,Germany,Europe
1310,Omar Khailoti,ITA,Bologna,Serie A,2020,18.0,2001.0,0.3,0,0,0,0,0,0,0,,0,2,0,2,1,1,0,0,DF,Under 20,Defender,Italy,Europe
1311,Saîf-Eddine Khaoui,TUN,Marseille,Ligue 1,2020,25.0,1995.0,6.7,19,11,7,6,6,7,16,43.8,9,8,0,8,12,31,1,0,"FW,DF",25-29,Forward,Tunisia,Africa
1312,Wahbi Khazri,TUN,Saint-Étienne,Ligue 1,2020,29.0,1991.0,13.1,24,15,12,7,5,12,24,50.0,12,10,1,9,4,28,11,0,FW,25-29,Forward,Tunisia,Africa
1313,Rani Khedira,GER,Augsburg,Bundesliga,2020,26.0,1994.0,20.2,29,10,13,15,1,10,20,50.0,10,14,5,9,31,60,47,0,MF,25-29,Midfielder,Germany,Europe
1314,Sami Khedira,GER,Hertha BSC,Bundesliga,2020,33.0,1987.0,4.4,11,6,3,7,1,6,12,50.0,6,4,0,4,9,20,7,0,MF,30-34,Midfielder,Germany,Europe
1316,Luca Kilian,GER,Mainz 05,Bundesliga,2020,20.0,1999.0,4.2,14,7,10,4,0,9,17,52.9,8,3,1,2,13,27,12,0,DF,20-24,Defender,Germany,Europe
1317,Max Kilman,ENG,Wolves,Premier League,2020,23.0,1997.0,14.6,21,14,13,4,4,8,14,57.1,6,17,8,9,19,40,46,0,DF,20-24,Defender,England,Europe
1318,Joshua Kimmich,GER,Bayern Munich,Bundesliga,2020,25.0,1995.0,24.4,40,28,16,19,5,10,53,18.9,43,25,5,20,36,76,19,0,MF,25-29,Midfielder,Germany,Europe
1319,Presnel Kimpembe,FRA,Paris S-G,Ligue 1,2020,24.0,1995.0,25.6,46,28,23,19,4,24,34,70.6,10,19,11,8,30,76,61,4,DF,20-24,Defender,France,Europe
1321,Simon Kjær,DEN,Milan,Serie A,2020,31.0,1989.0,26.6,45,26,23,20,2,18,30,60.0,12,42,26,16,42,87,125,0,DF,30-34,Defender,Denmark,Europe
1322,Davy Klaassen,NED,Werder Bremen,Bundesliga,2020,27.0,1993.0,2.5,3,1,0,1,2,0,5,0.0,5,5,1,4,3,6,4,0,MF,25-29,Midfielder,Netherlands,Europe
1323,Felix Klaus,GER,Wolfsburg,Bundesliga,2020,27.0,1992.0,1.5,7,4,3,4,0,4,5,80.0,1,4,0,4,2,9,4,0,"DF,MF",25-29,Defender,Germany,Europe
1324,Klauss,BRA,Hoffenheim,Bundesliga,2020,23.0,1997.0,0.6,1,0,0,0,1,0,1,0.0,1,0,0,0,0,1,0,0,"MF,FW",20-24,Midfielder,Brazil,South America
1325,Ragnar Klavan,EST,Cagliari,Serie A,2020,34.0,1985.0,8.6,15,9,9,5,1,7,11,63.6,4,9,4,5,8,23,34,0,DF,30-34,Defender,Estonia,Europe
1326,Philipp Klement,GER,Stuttgart,Bundesliga,2020,27.0,1992.0,4.7,7,3,6,0,1,3,7,42.9,4,9,2,7,6,13,7,0,"MF,FW",25-29,Midfielder,Germany,Europe
1328,Mateo Klimowicz,GER,Stuttgart,Bundesliga,2020,20.0,2000.0,13.3,20,15,6,10,4,5,18,27.8,13,5,1,4,2,22,2,0,"MF,FW",20-24,Midfielder,Germany,Europe
1329,Fabian Klos,GER,Arminia,Bundesliga,2020,32.0,1987.0,30.1,24,13,9,11,4,7,26,26.9,19,20,6,14,4,28,29,0,FW,30-34,Forward,Germany,Europe
1330,Lukas Klostermann,GER,RB Leipzig,Bundesliga,2020,24.0,1996.0,16.1,23,19,8,12,3,11,18,61.1,7,16,6,10,18,41,44,1,DF,20-24,Defender,Germany,Europe
1331,Justin Kluivert,NED,Roma,Serie A,2020,21.0,1999.0,0.2,0,0,0,0,0,0,0,,0,0,0,0,0,0,0,0,MF,20-24,Midfielder,Netherlands,Europe
1332,Justin Kluivert,NED,RB Leipzig,Bundesliga,2020,21.0,1999.0,9.0,2,1,1,1,0,0,2,0.0,2,4,0,4,5,7,3,0,"FW,MF",20-24,Forward,Netherlands,Europe
1333,Lukas Klünter,GER,Hertha BSC,Bundesliga,2020,24.0,1996.0,11.0,10,5,6,4,0,5,10,50.0,5,3,1,2,11,21,29,1,DF,20-24,Defender,Germany,Europe
1334,Ansgar Knauff,GER,Dortmund,Bundesliga,2020,18.0,2002.0,0.8,0,0,0,0,0,0,1,0.0,1,3,1,2,0,0,0,0,"MF,FW",Under 20,Midfielder,Germany,Europe
1335,Robin Knoche,GER,Union Berlin,Bundesliga,2020,28.0,1992.0,33.8,44,29,30,12,2,23,39,59.0,16,43,27,16,49,93,118,2,DF,25-29,Defender,Germany,Europe
1336,Gregor Kobel,SUI,Stuttgart,Bundesliga,2020,22.0,1997.0,33.0,2,2,2,0,0,2,2,100.0,0,0,0,0,2,4,8,1,GK,20-24,Goalkeeper,Switzerland,Europe
1337,Robin Koch,GER,Leeds United,Premier League,2020,24.0,1996.0,12.6,27,16,17,10,0,10,19,52.6,9,18,12,6,27,54,34,2,"DF,MF",20-24,Defender,Germany,Europe
1338,Giorgi Kochorashvili,GEO,Levante,La Liga,2020,21.0,1999.0,0.3,1,0,1,0,0,0,0,,0,0,0,0,0,1,0,0,MF,20-24,Midfielder,Georgia,Asia
1339,Kenan Kodro,BIH,Valladolid,La Liga,2020,26.0,1993.0,5.1,0,0,0,0,0,0,2,0.0,2,2,1,1,2,2,6,0,"FW,MF",25-29,Forward,Bosnia and Herzegovina,Europe
1340,Kenan Kodro,BIH,Athletic Club,La Liga,2020,26.0,1993.0,0.5,0,0,0,0,0,0,1,0.0,1,0,0,0,0,0,0,0,"FW,MF",25-29,Forward,Bosnia and Herzegovina,Europe
1341,Dominik Kohr,GER,Mainz 05,Bundesliga,2020,26.0,1994.0,14.1,47,31,14,26,7,20,39,51.3,19,18,5,13,27,74,15,0,MF,25-29,Midfielder,Germany,Europe
1342,Dominik Kohr,GER,Eint Frankfurt,Bundesliga,2020,26.0,1994.0,2.9,11,7,0,7,4,4,9,44.4,5,5,1,4,9,20,9,0,"MF,DF",25-29,Midfielder,Germany,Europe
1343,Koba Koindredi,FRA,Valencia,La Liga,2020,18.0,2001.0,0.2,1,1,1,0,0,0,1,0.0,1,0,0,0,0,1,0,0,MF,Under 20,Midfielder,France,Europe
1345,Aleksandr Kokorin,RUS,Fiorentina,Serie A,2020,29.0,1991.0,1.0,1,0,0,1,0,0,1,0.0,1,1,0,1,0,1,0,0,"FW,MF",25-29,Forward,Russia,Europe
1347,Sead Kolašinac,BIH,Arsenal,Premier League,2020,27.0,1993.0,1.0,0,0,0,0,0,0,0,,0,0,0,0,1,1,0,0,DF,25-29,Defender,Bosnia and Herzegovina,Europe
1348,Sead Kolašinac,BIH,Schalke 04,Bundesliga,2020,27.0,1993.0,15.8,20,17,10,7,3,8,18,44.4,10,17,5,12,20,40,17,0,"DF,MF",25-29,Defender,Bosnia and Herzegovina,Europe
1349,Randal Kolo Muani,FRA,Nantes,Ligue 1,2020,21.0,1998.0,33.7,22,14,1,13,8,7,27,25.9,20,15,2,13,8,30,26,0,FW,20-24,Forward,France,Europe
1350,Timothée Kolodziejczak,FRA,Saint-Étienne,Ligue 1,2020,28.0,1991.0,22.6,28,15,23,5,0,19,27,70.4,8,24,15,9,36,64,80,1,DF,25-29,Defender,France,Europe
1351,Ghislain Konan,CIV,Reims,Ligue 1,2020,24.0,1995.0,29.0,57,32,35,17,5,32,56,57.1,24,25,11,14,30,87,67,0,DF,20-24,Defender,Ivory Coast,Africa
1352,Ibrahima Konaté,FRA,RB Leipzig,Bundesliga,2020,21.0,1999.0,7.7,6,4,2,3,1,2,8,25.0,6,6,3,3,8,14,24,0,DF,20-24,Defender,France,Europe
1353,Moussa Konaté,SEN,Dijon,Ligue 1,2020,27.0,1993.0,13.3,5,3,1,2,2,2,11,18.2,9,4,1,3,5,10,8,0,FW,25-29,Forward,Senegal,Africa
1354,Geoffrey Kondogbia,CTA,Valencia,La Liga,2020,27.0,1993.0,4.9,16,9,9,4,3,7,19,36.8,12,6,1,5,8,24,8,0,MF,25-29,Midfielder,Central African Republic,Africa
1355,Geoffrey Kondogbia,CTA,Atlético Madrid,La Liga,2020,27.0,1993.0,6.8,30,20,12,16,2,11,20,55.0,9,11,5,6,11,41,8,1,MF,25-29,Midfielder,Central African Republic,Africa
1356,Lamine Koné,CIV,Strasbourg,Ligue 1,2020,31.0,1989.0,11.6,9,6,5,4,0,5,8,62.5,3,4,3,1,15,24,36,0,DF,30-34,Defender,Ivory Coast,Africa
1357,Moussa Koné,SEN,Nîmes,Ligue 1,2020,23.0,1996.0,19.5,13,6,1,8,4,2,9,22.2,7,7,1,6,2,15,7,0,FW,20-24,Forward,Senegal,Africa
1357,Moussa Koné,SEN,Nîmes,Ligue 1,2020,23.0,1996.0,19.5,13,6,1,8,4,2,9,22.2,7,7,1,6,2,15,7,0,FW,20-24,Forward,Senegal,Africa
1357,Moussa Koné,SEN,Nîmes,Ligue 1,2020,23.0,1996.0,19.5,13,6,1,8,4,2,9,22.2,7,7,1,6,2,15,7,0,FW,20-24,Forward,Senegal,Africa
1357,Moussa Koné,SEN,Nîmes,Ligue 1,2020,23.0,1996.0,19.5,13,6,1,8,4,2,9,22.2,7,7,1,6,2,15,7,0,FW,20-24,Forward,Senegal,Africa
1358,Youssouf Koné,MLI,Elche,La Liga,2020,25.0,1995.0,0.8,2,0,1,0,1,0,1,0.0,1,0,0,0,0,2,0,0,"DF,MF",25-29,Defender,Mali,Africa
1359,Terence Kongolo,NED,Fulham,Premier League,2020,26.0,1994.0,1.0,3,2,1,2,0,1,1,100.0,0,0,0,0,2,5,3,0,DF,25-29,Defender,Netherlands,Europe
1360,Ezri Konsa,ENG,Aston Villa,Premier League,2020,22.0,1997.0,35.5,25,13,18,6,1,9,13,69.2,4,53,47,6,29,54,162,1,DF,20-24,Defender,England,Europe
1361,Laurent Koscielny,FRA,Bordeaux,Ligue 1,2020,34.0,1985.0,24.6,29,17,18,11,0,16,24,66.7,8,44,34,10,54,83,115,1,DF,30-34,Defender,France,Europe
1363,Márk Kosznovszky,HUN,Parma,Serie A,2020,18.0,2002.0,1.0,2,2,1,1,0,1,4,25.0,3,2,0,2,1,3,1,0,MF,Under 20,Midfielder,Hungary,Europe
1364,Christian Kouamé,CIV,Fiorentina,Serie A,2020,22.0,1997.0,11.1,9,4,2,4,3,4,12,33.3,8,9,1,8,5,14,4,0,FW,20-24,Forward,Ivory Coast,Africa
1365,Kalidou Koulibaly,SEN,Napoli,Serie A,2020,29.0,1991.0,24.5,36,24,25,7,4,19,32,59.4,13,46,26,20,29,65,64,2,DF,25-29,Defender,Senegal,Africa
1366,Jules Koundé,FRA,Sevilla,La Liga,2020,21.0,1998.0,33.1,27,15,14,11,2,10,24,41.7,14,24,16,8,40,67,104,0,DF,20-24,Defender,France,Europe
1367,Boubakar Kouyaté,MLI,Metz,Ligue 1,2020,23.0,1997.0,21.8,60,35,45,15,0,32,58,55.2,26,44,27,17,60,120,132,1,DF,20-24,Defender,Mali,Africa
1368,Cheikhou Kouyaté,SEN,Crystal Palace,Premier League,2020,30.0,1989.0,34.7,58,37,44,12,2,25,43,58.1,18,42,26,16,32,90,125,2,DF,30-34,Defender,Senegal,Africa
1369,Mateo Kovačić,CRO,Chelsea,Premier League,2020,26.0,1994.0,20.2,46,28,19,24,3,17,32,53.1,15,18,1,17,15,61,11,2,MF,25-29,Midfielder,Croatia,Europe
1370,Viktor Kovalenko,UKR,Atalanta,Serie A,2020,24.0,1996.0,0.0,0,0,0,0,0,0,0,,0,0,0,0,0,0,1,0,FW,20-24,Forward,Ukraine,Europe
1371,Emil Krafth,SWE,Newcastle Utd,Premier League,2020,25.0,1994.0,14.3,19,8,9,9,1,12,25,48.0,13,15,9,6,15,34,52,2,DF,25-29,Defender,Sweden,Europe
1372,Andrej Kramarić,CRO,Hoffenheim,Bundesliga,2020,29.0,1991.0,26.4,7,4,4,0,3,3,8,37.5,5,8,1,7,7,14,5,1,"FW,MF",25-29,Forward,Croatia,Europe
1373,Christoph Kramer,GER,Gladbach,Bundesliga,2020,29.0,1991.0,22.6,55,37,22,28,5,28,58,48.3,30,32,11,21,34,89,39,0,MF,25-29,Midfielder,Germany,Europe
1374,Jean-Philippe Krasso,CIV,Saint-Étienne,Ligue 1,2020,23.0,1997.0,2.5,5,3,1,4,0,2,4,50.0,2,5,0,5,1,6,3,0,FW,20-24,Forward,Ivory Coast,Africa
1375,Toni Kroos,GER,Real Madrid,La Liga,2020,30.0,1990.0,23.5,42,22,15,15,12,11,44,25.0,33,26,6,20,15,57,10,3,MF,30-34,Midfielder,Germany,Europe
1376,Filip Krovinović,CRO,West Brom,Premier League,2020,24.0,1995.0,6.1,13,10,6,5,2,6,18,33.3,12,2,0,2,4,17,2,0,MF,20-24,Midfielder,Croatia,Europe
1377,Rade Krunić,BIH,Milan,Serie A,2020,26.0,1993.0,8.0,15,12,6,6,3,7,17,41.2,10,12,2,10,10,25,9,0,"MF,FW",25-29,Midfielder,Bosnia and Herzegovina,Europe
1378,Max Kruse,GER,Union Berlin,Bundesliga,2020,32.0,1988.0,18.1,7,3,1,5,1,2,9,22.2,7,11,0,11,3,10,3,0,"FW,MF",30-34,Forward,Germany,Europe
1379,Lukas Kübler,GER,Freiburg,Bundesliga,2020,27.0,1992.0,9.8,15,8,9,5,1,9,14,64.3,5,9,3,6,21,36,31,0,"DF,MF",25-29,Defender,Germany,Europe
1380,Takefusa Kubo,JPN,Villarreal,La Liga,2020,19.0,2001.0,3.3,1,1,0,0,1,1,5,20.0,4,2,0,2,1,2,2,0,"MF,FW",Under 20,Midfielder,Japan,Asia
1381,Takefusa Kubo,JPN,Getafe,La Liga,2020,19.0,2001.0,8.9,7,4,2,3,2,1,14,7.1,13,14,0,14,14,21,4,0,"MF,FW",Under 20,Midfielder,Japan,Asia
1382,Juraj Kucka,SVK,Parma,Serie A,2020,33.0,1987.0,25.9,67,36,21,37,9,26,74,35.1,48,25,3,22,28,95,25,0,"MF,FW",30-34,Midfielder,Slovakia,Europe
1384,Dejan Kulusevski,SWE,Juventus,Serie A,2020,20.0,2000.0,21.4,33,19,12,10,11,14,43,32.6,29,22,0,22,9,42,2,1,"MF,FW",20-24,Midfielder,Sweden,Europe
1385,Marash Kumbulla,ALB,Roma,Serie A,2020,20.0,2000.0,15.1,16,11,8,7,1,5,17,29.4,12,12,5,7,24,40,38,1,DF,20-24,Defender,Albania,Europe
1386,Pierre Kunde,CMR,Mainz 05,Bundesliga,2020,25.0,1995.0,5.7,8,4,1,5,2,2,9,22.2,7,6,0,6,10,18,9,0,MF,25-29,Midfielder,Cameroon,Africa
1387,Fabian Kunze,GER,Arminia,Bundesliga,2020,22.0,1998.0,14.1,38,26,19,15,4,19,42,45.2,23,19,3,16,18,56,22,1,MF,20-24,Midfielder,Germany,Europe
1389,Layvin Kurzawa,FRA,Paris S-G,Ligue 1,2020,27.0,1992.0,14.2,26,19,10,10,6,9,28,32.1,19,20,5,15,28,54,26,1,DF,25-29,Defender,France,Europe
1390,Dereck Kutesa,SUI,Reims,Ligue 1,2020,22.0,1997.0,7.6,15,7,7,3,5,5,14,35.7,9,7,1,6,7,22,3,0,"MF,FW",20-24,Midfielder,Switzerland,Europe
1391,Ahmed Kutucu,TUR,Schalke 04,Bundesliga,2020,20.0,2000.0,1.2,1,0,0,0,1,1,2,50.0,1,1,0,1,0,1,0,0,"FW,MF",20-24,Forward,Turkey,Asia
1392,Enock Kwateng,FRA,Bordeaux,Ligue 1,2020,23.0,1997.0,11.5,21,12,15,4,2,14,27,51.9,13,15,3,12,26,47,27,0,DF,20-24,Defender,France,Europe
1393,Giorgos Kyriakopoulos,GRE,Sassuolo,Serie A,2020,24.0,1996.0,16.2,35,18,17,12,6,8,28,28.6,20,16,5,11,15,50,42,0,DF,20-24,Defender,Greece,Europe
1394,Antonino La Gumina,ITA,Sampdoria,Serie A,2020,24.0,1996.0,3.8,3,2,0,1,2,0,3,0.0,3,5,1,4,3,6,5,0,FW,20-24,Forward,Italy,Europe
1395,Gaëtan Laborde,FRA,Montpellier,Ligue 1,2020,26.0,1994.0,36.2,43,22,21,17,5,16,60,26.7,44,29,3,26,16,59,25,1,"FW,MF",25-29,Forward,France,Europe
1396,Alexandre Lacazette,FRA,Arsenal,Premier League,2020,29.0,1991.0,21.4,18,10,4,11,3,4,22,18.2,18,20,1,19,12,30,13,0,FW,25-29,Forward,France,Europe
1397,Tom Lacoux,FRA,Bordeaux,Ligue 1,2020,18.0,2002.0,5.8,22,14,10,11,1,9,21,42.9,12,12,3,9,12,34,7,0,MF,Under 20,Midfielder,France,Europe
1398,Maxence Lacroix,FRA,Wolfsburg,Bundesliga,2020,20.0,2000.0,28.8,49,29,37,12,0,24,45,53.3,21,51,21,30,65,114,140,1,DF,20-24,Defender,France,Europe
1399,Alban Lafont,FRA,Nantes,Ligue 1,2020,21.0,1999.0,38.0,1,0,1,0,0,1,1,100.0,0,1,0,1,0,1,14,0,GK,20-24,Goalkeeper,France,Europe
1401,Konrad Laimer,AUT,RB Leipzig,Bundesliga,2020,23.0,1997.0,0.9,2,0,0,1,1,0,4,0.0,4,2,0,2,1,3,0,0,"DF,MF",20-24,Defender,Austria,Europe
1402,Stefan Lainer,AUT,Gladbach,Bundesliga,2020,27.0,1992.0,30.8,62,37,30,22,10,27,60,45.0,33,34,5,29,35,97,85,1,DF,25-29,Defender,Austria,Europe
1403,Diego Lainez,MEX,Betis,La Liga,2020,20.0,2000.0,9.6,9,4,3,5,1,6,16,37.5,10,15,0,15,11,20,6,0,"FW,MF",20-24,Forward,Mexico,North America
1404,Kenny Lala,MAD,Strasbourg,Ligue 1,2020,28.0,1991.0,20.4,22,13,13,8,1,11,22,50.0,11,12,6,6,23,45,33,1,DF,25-29,Defender,Madagascar,Africa
1405,Adam Lallana,ENG,Brighton,Premier League,2020,32.0,1988.0,17.7,28,13,11,13,4,8,39,20.5,31,18,3,15,15,43,13,0,"MF,FW",30-34,Midfielder,England,Europe
1406,Érik Lamela,ARG,Tottenham,Premier League,2020,28.0,1992.0,8.0,17,9,1,11,5,8,21,38.1,13,11,1,10,6,23,2,0,"FW,MF",25-29,Forward,Argentina,South America
1407,Sam Lammers,NED,Atalanta,Serie A,2020,23.0,1997.0,3.2,2,0,0,2,0,0,6,0.0,6,0,0,0,0,2,3,0,"FW,MF",20-24,Forward,Netherlands,Europe
1408,Tariq Lamptey,GHA,Brighton,Premier League,2020,19.0,2000.0,9.8,17,9,7,6,4,6,13,46.2,7,8,1,7,19,36,12,1,"DF,MF",Under 20,Defender,Ghana,Africa
1409,Loïck Landre,FRA,Nîmes,Ligue 1,2020,28.0,1992.0,18.1,14,7,9,5,0,13,28,46.4,15,22,19,3,31,45,52,0,DF,25-29,Defender,France,Europe
1410,Michael Langer,AUT,Schalke 04,Bundesliga,2020,35.0,1985.0,2.7,0,0,0,0,0,0,0,,0,0,0,0,0,0,3,0,GK,35-39,Goalkeeper,Austria,Europe
1411,Manuel Lanzini,ARG,West Ham,Premier League,2020,27.0,1993.0,6.3,9,2,3,4,2,3,10,30.0,7,9,0,9,7,16,5,0,"MF,FW",25-29,Midfielder,Argentina,South America
1412,Gianluca Lapadula,PER,Benevento,Serie A,2020,30.0,1990.0,28.5,22,12,3,13,6,6,25,24.0,19,18,3,15,5,27,16,0,FW,30-34,Forward,Peru,South America
1414,Julien Laporte,FRA,Lorient,Ligue 1,2020,26.0,1993.0,29.5,65,39,48,16,1,42,74,56.8,32,34,23,11,65,130,125,0,DF,25-29,Defender,France,Europe
1415,Danilo Larangeira,BRA,Bologna,Serie A,2020,36.0,1984.0,34.8,33,24,23,10,0,8,29,27.6,21,58,36,22,51,84,127,2,DF,35-39,Defender,Brazil,South America
1416,Gautier Larsonneur,FRA,Brest,Ligue 1,2020,23.0,1997.0,35.0,1,1,1,0,0,1,1,100.0,0,2,0,2,0,1,16,3,GK,20-24,Goalkeeper,France,Europe
1417,Kevin Lasagna,ITA,Udinese,Serie A,2020,27.0,1992.0,12.3,6,1,2,3,1,3,14,21.4,11,11,0,11,6,12,7,0,FW,25-29,Forward,Italy,Europe
1418,Kevin Lasagna,ITA,Hellas Verona,Serie A,2020,27.0,1992.0,14.1,7,3,0,5,2,1,5,20.0,4,12,1,11,1,8,11,0,FW,25-29,Forward,Italy,Europe
1419,Jamaal Lascelles,ENG,Newcastle Utd,Premier League,2020,26.0,1993.0,18.1,14,7,5,9,0,3,6,50.0,3,27,17,10,12,26,86,0,DF,25-29,Defender,England,Europe
1420,Paul Lasne,FRA,Brest,Ligue 1,2020,31.0,1989.0,18.7,46,26,25,19,2,17,40,42.5,23,25,5,20,47,93,17,2,MF,30-34,Midfielder,France,Europe
1422,Danny Latza,GER,Mainz 05,Bundesliga,2020,30.0,1989.0,20.0,43,26,12,19,12,23,70,32.9,47,39,3,36,27,70,23,0,MF,30-34,Midfielder,Germany,Europe
1423,Armand Lauriente,FRA,Lorient,Ligue 1,2020,21.0,1998.0,18.0,30,10,10,19,1,7,26,26.9,19,21,0,21,15,45,4,0,"MF,FW",20-24,Midfielder,France,Europe
1424,Vincent Laurini,FRA,Parma,Serie A,2020,31.0,1989.0,9.7,16,11,8,6,2,7,9,77.8,2,8,4,4,17,33,22,1,DF,30-34,Defender,France,Europe
1425,Lauti,URU,Celta Vigo,La Liga,2020,19.0,2001.0,0.2,0,0,0,0,0,0,0,,0,0,0,0,0,0,1,0,MF,Under 20,Midfielder,Uruguay,South America
1426,Wesley Lautoa,NCL,Dijon,Ligue 1,2020,32.0,1987.0,17.9,36,20,20,13,3,11,37,29.7,26,17,8,9,29,65,33,1,"MF,DF",30-34,Midfielder,New Caledonia,Oceania
1427,Valentino Lazaro,AUT,Gladbach,Bundesliga,2020,24.0,1996.0,13.8,17,11,7,5,5,12,19,63.2,7,18,1,17,15,32,20,0,"DF,FW",20-24,Defender,Austria,Europe
1429,Manuel Lazzari,ITA,Lazio,Serie A,2020,26.0,1993.0,29.0,24,14,15,4,5,14,39,35.9,25,22,3,19,18,42,28,0,DF,25-29,Defender,Italy,Europe
1430,Jérémy Le Douaron,FRA,Brest,Ligue 1,2020,22.0,1998.0,9.1,15,10,9,4,2,7,21,33.3,14,14,1,13,8,23,11,0,"FW,MF",20-24,Forward,France,Europe
1431,Enzo Le Fée,FRA,Lorient,Ligue 1,2020,20.0,2000.0,20.2,51,28,23,23,5,27,73,37.0,46,30,6,24,25,76,10,0,MF,20-24,Midfielder,France,Europe
1432,Vincent Le Goff,FRA,Lorient,Ligue 1,2020,30.0,1989.0,25.6,42,29,16,24,2,18,49,36.7,31,27,5,22,44,86,44,0,DF,30-34,Defender,France,Europe
1433,Maxime Le Marchand,FRA,Fulham,Premier League,2020,30.0,1989.0,1.4,2,2,2,0,0,2,2,100.0,0,0,0,0,0,2,3,0,DF,30-34,Defender,France,Europe
1435,Damien Le Tallec,FRA,Montpellier,Ligue 1,2020,30.0,1990.0,13.6,16,10,10,4,2,10,30,33.3,20,15,8,7,25,41,21,2,"MF,DF",30-34,Midfielder,France,Europe
1436,James Lea Siliki,CMR,Rennes,Ligue 1,2020,24.0,1996.0,2.8,5,2,1,3,1,2,2,100.0,0,3,0,3,1,6,1,1,MF,20-24,Midfielder,Cameroon,Africa
1437,Rafael Leão,POR,Milan,Serie A,2020,21.0,1999.0,21.4,13,6,4,7,2,6,15,40.0,9,17,0,17,4,17,14,1,FW,20-24,Forward,Portugal,Europe
1438,Jean-Louis Leca,FRA,Lens,Ligue 1,2020,34.0,1985.0,36.8,3,2,3,0,0,3,5,60.0,2,0,0,0,1,4,14,4,GK,30-34,Goalkeeper,France,Europe
1439,Mathew Leckie,AUS,Hertha BSC,Bundesliga,2020,29.0,1991.0,5.6,12,3,5,5,2,4,11,36.4,7,8,0,8,13,25,9,0,"FW,DF",25-29,Forward,Australia,Oceania
1440,Benjamin Lecomte,FRA,Monaco,Ligue 1,2020,29.0,1991.0,28.0,0,0,0,0,0,0,2,0.0,2,1,0,1,2,2,20,1,GK,25-29,Goalkeeper,France,Europe
1441,Jeremías Ledesma,ARG,Cádiz,La Liga,2020,27.0,1993.0,32.0,1,0,1,0,0,1,1,100.0,0,1,0,1,0,1,22,6,GK,25-29,Goalkeeper,Argentina,South America
1442,Pierre Lees-Melou,FRA,Nice,Ligue 1,2020,27.0,1993.0,22.9,67,39,33,31,3,25,83,30.1,58,50,14,36,29,96,31,1,MF,25-29,Midfielder,France,Europe
1443,Lucas Leiva,BRA,Lazio,Serie A,2020,33.0,1987.0,23.7,68,32,38,28,2,30,86,34.9,56,21,0,21,57,125,21,0,MF,30-34,Midfielder,Brazil,South America
1444,Florian Lejeune,FRA,Alavés,La Liga,2020,29.0,1991.0,33.5,43,32,36,7,0,21,35,60.0,14,38,24,14,51,94,149,1,DF,25-29,Defender,France,Europe
1446,Thomas Lemar,FRA,Atlético Madrid,La Liga,2020,24.0,1995.0,15.2,30,17,9,17,4,11,24,45.8,13,22,1,21,11,41,10,0,MF,20-24,Midfielder,France,Europe
1447,Mario Lemina,GAB,Fulham,Premier League,2020,26.0,1993.0,18.9,62,35,25,30,7,23,44,52.3,21,26,5,21,30,92,21,0,MF,25-29,Midfielder,Gabon,Africa
1448,Fabien Lemoine,FRA,Lorient,Ligue 1,2020,33.0,1987.0,21.5,74,45,39,33,2,36,89,40.4,53,25,1,24,27,101,35,0,MF,30-34,Midfielder,France,Europe
1449,Clément Lenglet,FRA,Barcelona,La Liga,2020,25.0,1995.0,27.5,36,21,23,10,3,19,28,67.9,9,26,12,14,33,69,71,1,DF,25-29,Defender,France,Europe
1450,Bernd Leno,GER,Arsenal,Premier League,2020,28.0,1992.0,34.8,1,0,1,0,0,1,1,100.0,0,1,0,1,0,1,11,2,GK,25-29,Goalkeeper,Germany,Europe
1451,Christopher Lenz,GER,Union Berlin,Bundesliga,2020,25.0,1994.0,25.0,74,41,39,30,5,35,71,49.3,36,34,5,29,35,109,50,0,"DF,FW",25-29,Defender,Germany,Europe
1454,Lukas Lerager,DEN,Genoa,Serie A,2020,27.0,1993.0,12.9,24,13,14,9,1,11,30,36.7,19,13,3,10,14,38,25,1,MF,25-29,Midfielder,Denmark,Europe
1455,Mehdi Léris,ALG,Sampdoria,Serie A,2020,22.0,1998.0,4.3,11,5,6,4,1,6,16,37.5,10,12,2,10,12,23,15,0,"DF,MF",20-24,Defender,Algeria,Africa
1456,Khanya Leshabela,RSA,Leicester City,Premier League,2020,20.0,1999.0,0.1,0,0,0,0,0,0,0,,0,0,0,0,0,0,0,0,MF,20-24,Midfielder,South Africa,Africa
1457,Karlo Letica,CRO,Sampdoria,Serie A,2020,23.0,1997.0,1.0,0,0,0,0,0,0,0,,0,0,0,0,0,0,2,0,GK,20-24,Goalkeeper,Croatia,Europe
1458,Gaetano Letizia,ITA,Benevento,Serie A,2020,30.0,1990.0,17.4,36,25,19,13,4,17,36,47.2,19,15,3,12,20,56,42,1,DF,30-34,Defender,Italy,Europe
1461,Aaron Leya Iseka,BEL,Metz,Ligue 1,2020,22.0,1997.0,11.2,6,4,2,3,1,0,4,0.0,4,4,2,2,0,6,6,0,FW,20-24,Forward,Belgium,Europe
1462,Yanis Lhery,FRA,Saint-Étienne,Ligue 1,2020,17.0,2003.0,0.3,0,0,0,0,0,0,0,,0,0,0,0,0,0,0,0,MF,Under 20,Midfielder,France,Europe
1463,Dimitri Liénard,FRA,Strasbourg,Ligue 1,2020,32.0,1988.0,20.3,39,27,17,19,3,24,55,43.6,31,23,1,22,18,57,10,0,MF,30-34,Midfielder,France,Europe
1464,Philipp Lienhart,AUT,Freiburg,Bundesliga,2020,24.0,1996.0,33.3,21,13,12,7,2,9,20,45.0,11,30,21,9,42,63,100,0,DF,20-24,Defender,Austria,Europe
1465,Matthijs de Ligt,NED,Juventus,Serie A,2020,20.0,1999.0,24.7,37,19,20,16,1,18,28,64.3,10,42,21,21,31,68,64,0,DF,20-24,Defender,Netherlands,Europe
1466,Isaac Lihadji,FRA,Lille,Ligue 1,2020,18.0,2002.0,2.2,11,4,2,6,3,4,5,80.0,1,5,1,4,1,12,0,1,"MF,FW",Under 20,Midfielder,France,Europe
1467,Dimitris Limnios,GRE,Köln,Bundesliga,2020,22.0,1998.0,4.2,9,6,3,5,1,5,6,83.3,1,5,0,5,2,11,1,0,"MF,FW",20-24,Midfielder,Greece,Europe
1468,Victor Lindelöf,SWE,Manchester Utd,Premier League,2020,26.0,1994.0,28.7,22,10,12,10,0,12,24,50.0,12,22,14,8,30,52,95,1,DF,25-29,Defender,Sweden,Europe
1470,Jesse Lingard,ENG,West Ham,Premier League,2020,27.0,1992.0,15.8,12,6,4,8,0,5,14,35.7,9,7,1,6,4,16,0,0,"MF,FW",25-29,Midfielder,England,Europe
1473,Jake Livermore,ENG,West Brom,Premier League,2020,30.0,1989.0,13.8,33,18,14,16,3,14,31,45.2,17,21,6,15,16,49,26,0,MF,30-34,Midfielder,England,Europe
1479,Hugo Lloris,FRA,Tottenham,Premier League,2020,33.0,1986.0,38.0,0,0,0,0,0,0,1,0.0,1,0,0,0,0,0,10,1,GK,30-34,Goalkeeper,France,Europe
1480,Giovani Lo Celso,ARG,Tottenham,Premier League,2020,24.0,1996.0,10.5,28,22,12,11,5,10,29,34.5,19,12,1,11,7,35,5,0,MF,20-24,Midfielder,Argentina,South America
1481,Stanislav Lobotka,SVK,Napoli,Serie A,2020,25.0,1994.0,1.7,1,1,0,1,0,0,1,0.0,1,1,1,0,0,1,1,1,MF,25-29,Midfielder,Slovakia,Europe
1482,Manuel Locatelli,ITA,Sassuolo,Serie A,2020,22.0,1998.0,32.0,81,47,43,28,10,29,56,51.8,27,35,15,20,51,132,65,1,MF,20-24,Midfielder,Italy,Europe
1483,Renan Lodi,BRA,Atlético Madrid,La Liga,2020,22.0,1998.0,12.5,30,17,13,12,5,17,26,65.4,9,15,0,15,16,46,18,0,"DF,FW",20-24,Defender,Brazil,South America
1484,Ruben Loftus-Cheek,ENG,Chelsea,Premier League,2020,24.0,1996.0,0.7,0,0,0,0,0,0,0,,0,0,0,0,0,0,0,0,FW,20-24,Forward,England,Europe
1485,Ruben Loftus-Cheek,ENG,Fulham,Premier League,2020,24.0,1996.0,21.2,25,14,7,15,3,7,23,30.4,16,20,2,18,7,32,18,0,"MF,FW",20-24,Midfielder,England,Europe
1486,Niklas Lomb,GER,Leverkusen,Bundesliga,2020,27.0,1993.0,1.5,0,0,0,0,0,0,0,,0,0,0,0,0,0,0,2,GK,25-29,Goalkeeper,Germany,Europe
1487,Kevin Long,IRL,Burnley,Premier League,2020,29.0,1990.0,7.1,11,6,9,2,0,7,9,77.8,2,11,7,4,6,17,24,0,DF,25-29,Defender,Republic of Ireland,Europe
1488,Shane Long,IRL,Southampton,Premier League,2020,33.0,1987.0,2.3,2,1,0,0,2,2,3,66.7,1,0,0,0,3,5,1,0,FW,30-34,Forward,Republic of Ireland,Europe
1489,Matthew Longstaff,ENG,Newcastle Utd,Premier League,2020,20.0,2000.0,4.2,3,2,2,1,0,2,8,25.0,6,7,0,7,7,10,2,0,MF,20-24,Midfielder,England,Europe
1490,Sean Longstaff,ENG,Newcastle Utd,Premier League,2020,22.0,1997.0,15.7,31,14,13,15,3,18,42,42.9,24,26,5,21,19,50,14,2,MF,20-24,Midfielder,England,Europe
1491,Ademola Lookman,NGA,Fulham,Premier League,2020,22.0,1997.0,30.5,35,11,18,9,8,13,44,29.5,31,31,1,30,20,55,9,0,"FW,MF",20-24,Forward,Nigeria,Africa
1492,Anthony Lopes,POR,Lyon,Ligue 1,2020,29.0,1990.0,38.0,1,1,1,0,0,1,2,50.0,1,1,0,1,1,2,20,1,GK,25-29,Goalkeeper,Portugal,Europe
1493,Rony Lopes,POR,Nice,Ligue 1,2020,24.0,1995.0,19.8,20,14,4,13,3,6,27,22.2,21,14,3,11,8,28,6,0,"FW,MF",20-24,Forward,Portugal,Europe
1496,Maxime Lopez,FRA,Sassuolo,Serie A,2020,22.0,1997.0,20.7,24,13,15,6,3,14,41,34.1,27,9,0,9,16,40,10,1,MF,20-24,Midfielder,France,Europe
1497,Maxime Lopez,FRA,Marseille,Ligue 1,2020,22.0,1997.0,1.5,1,1,1,0,0,0,2,0.0,2,0,0,0,2,3,2,0,"FW,MF",20-24,Forward,France,Europe
1502,Dion Lopy,SEN,Reims,Ligue 1,2020,18.0,2002.0,2.8,1,1,0,1,0,0,0,,0,0,0,0,2,3,1,0,MF,Under 20,Midfielder,Senegal,Africa
1503,Jordan Lotomba,SUI,Nice,Ligue 1,2020,21.0,1998.0,23.6,35,25,19,11,5,20,34,58.8,14,19,7,12,33,68,52,1,"DF,MF",20-24,Defender,Switzerland,Europe
1504,Adrien Louveau,FRA,Lens,Ligue 1,2020,20.0,2000.0,0.1,0,0,0,0,0,0,0,,0,0,0,0,0,0,1,0,MF,20-24,Midfielder,France,Europe
1505,Imran Louza,MAR,Nantes,Ligue 1,2020,21.0,1999.0,26.4,55,28,25,26,4,21,69,30.4,48,20,4,16,33,88,15,2,MF,20-24,Midfielder,Morocco,Africa
1506,Matteo Lovato,ITA,Hellas Verona,Serie A,2020,20.0,2000.0,15.4,21,12,14,5,2,10,21,47.6,11,20,10,10,37,58,48,1,DF,20-24,Defender,Italy,Europe
1507,Max Lowe,ENG,Sheffield Utd,Premier League,2020,23.0,1997.0,6.1,26,11,18,6,2,9,21,42.9,12,12,4,8,5,31,11,0,DF,20-24,Defender,England,Europe
1508,Eduard Löwen,GER,Hertha BSC,Bundesliga,2020,23.0,1997.0,0.9,5,1,3,1,1,2,5,40.0,3,1,0,1,1,6,1,0,"MF,DF",20-24,Midfielder,Germany,Europe
1509,Matthew Lowton,ENG,Burnley,Premier League,2020,31.0,1989.0,34.0,54,32,31,22,1,32,73,43.8,41,36,13,23,56,110,91,1,DF,30-34,Defender,England,Europe
1511,Hirving Lozano,MEX,Napoli,Serie A,2020,25.0,1995.0,21.8,29,18,10,13,6,10,36,27.8,26,37,1,36,18,47,14,0,FW,25-29,Forward,Mexico,North America
1512,Jan Luca Schuler,GER,Schalke 04,Bundesliga,2020,21.0,1999.0,0.4,2,2,1,1,0,0,1,0.0,1,1,0,1,0,2,0,0,FW,20-24,Forward,Germany,Europe
1513,Jean Lucas,BRA,Lyon,Ligue 1,2020,22.0,1998.0,1.9,3,2,2,1,0,1,4,25.0,3,3,1,2,2,5,1,0,MF,20-24,Midfielder,Brazil,South America
1514,Jean Lucas,BRA,Brest,Ligue 1,2020,22.0,1998.0,11.2,19,13,10,9,0,8,29,27.6,21,7,0,7,8,27,10,1,"MF,FW",20-24,Midfielder,Brazil,South America
1515,Anderson Lucoqui,ANG,Arminia,Bundesliga,2020,23.0,1997.0,17.8,40,25,23,17,0,20,40,50.0,20,30,7,23,27,67,53,0,DF,20-24,Defender,Angola,Africa
1516,Jeison Lucumí,COL,Elche,La Liga,2020,25.0,1995.0,0.5,1,1,0,1,0,0,0,,0,1,0,1,0,1,0,0,MF,25-29,Midfielder,Colombia,South America
1517,Kilian Ludewig,GER,Schalke 04,Bundesliga,2020,20.0,2000.0,5.8,16,6,10,5,1,8,25,32.0,17,7,0,7,3,19,14,0,"DF,FW",20-24,Defender,Germany,Europe
1518,Florentino Luís,POR,Monaco,Ligue 1,2020,20.0,1999.0,2.7,7,2,4,2,1,6,10,60.0,4,1,0,1,6,13,2,1,MF,20-24,Midfielder,Portugal,Europe
1521,José Luis Palomino,ARG,Atalanta,Serie A,2020,30.0,1990.0,27.0,67,33,41,19,7,24,48,50.0,24,30,16,14,79,146,60,2,DF,30-34,Defender,Argentina,South America
1522,Luisinho,POR,Huesca,La Liga,2020,35.0,1985.0,2.0,3,3,2,1,0,1,3,33.3,2,3,0,3,4,7,7,0,DF,35-39,Defender,Portugal,Europe
1524,David Luiz,BRA,Arsenal,Premier League,2020,33.0,1987.0,15.5,12,9,5,7,0,4,4,100.0,0,16,9,7,16,28,50,2,DF,30-34,Defender,Brazil,South America
1525,Douglas Luiz,BRA,Aston Villa,Premier League,2020,22.0,1998.0,30.9,49,18,22,26,1,20,58,34.5,38,52,17,35,43,92,44,2,MF,20-24,Midfielder,Brazil,South America
1526,Romelu Lukaku,BEL,Inter,Serie A,2020,27.0,1993.0,32.0,11,1,1,6,4,6,14,42.9,8,11,1,10,3,14,34,0,FW,25-29,Forward,Belgium,Europe
1527,Dodi Lukebakio,BEL,Hertha BSC,Bundesliga,2020,22.0,1997.0,20.6,21,14,13,5,3,9,20,45.0,11,14,1,13,12,33,8,0,"FW,MF",20-24,Forward,Belgium,Europe
1529,Senad Lulić,BIH,Lazio,Serie A,2020,34.0,1986.0,8.0,14,7,6,5,3,7,15,46.7,8,10,1,9,4,18,13,0,DF,30-34,Defender,Bosnia and Herzegovina,Europe
1530,John Lundstram,ENG,Sheffield Utd,Premier League,2020,26.0,1994.0,22.6,25,16,12,11,2,13,47,27.7,34,26,8,18,14,39,29,1,MF,25-29,Midfielder,England,Europe
1531,Sebastiano Luperto,ITA,Crotone,Serie A,2020,23.0,1996.0,20.9,38,20,28,8,2,16,27,59.3,11,17,7,10,27,65,74,1,DF,20-24,Defender,Italy,Europe
1532,Andreas Luthe,GER,Union Berlin,Bundesliga,2020,33.0,1987.0,30.8,1,1,1,0,0,1,3,33.3,2,1,0,1,0,1,8,3,GK,30-34,Goalkeeper,Germany,Europe
1533,Lyanco,BRA,Torino,Serie A,2020,23.0,1997.0,21.8,21,14,13,6,2,8,14,57.1,6,36,26,10,46,67,76,0,DF,20-24,Defender,Brazil,South America
1534,Charalambos Lykogiannis,GRE,Cagliari,Serie A,2020,26.0,1993.0,26.9,34,21,22,9,3,22,38,57.9,16,34,13,21,32,66,94,0,DF,25-29,Defender,Greece,Europe
1535,Yann M'Vila,FRA,Saint-Étienne,Ligue 1,2020,30.0,1990.0,0.2,0,0,0,0,0,0,2,0.0,2,0,0,0,1,1,0,0,MF,30-34,Midfielder,France,Europe
1536,Alexis Mac Allister,ARG,Brighton,Premier League,2020,21.0,1998.0,12.4,26,12,6,16,4,11,38,28.9,27,25,4,21,9,35,4,0,"MF,FW",20-24,Midfielder,Argentina,South America
1537,Darwin Machís,VEN,Granada,La Liga,2020,27.0,1993.0,22.5,30,17,12,10,8,6,19,31.6,13,21,2,19,22,52,13,0,"FW,MF",25-29,Forward,Venezuela,South America
1538,Tim Maciejewski,GER,Union Berlin,Bundesliga,2020,19.0,2001.0,0.1,0,0,0,0,0,0,0,,0,0,0,0,0,0,0,0,FW,Under 20,Forward,Germany,Europe
1539,Luca Mack,GER,Stuttgart,Bundesliga,2020,20.0,2000.0,0.1,0,0,0,0,0,0,0,,0,0,0,0,0,0,1,0,MF,20-24,Midfielder,Germany,Europe
1540,Yvann Macon,FRA,Saint-Étienne,Ligue 1,2020,21.0,1998.0,6.0,30,20,20,8,2,7,19,36.8,12,6,2,4,9,39,13,0,DF,20-24,Defender,France,Europe
1541,James Maddison,ENG,Leicester City,Premier League,2020,23.0,1996.0,23.3,32,16,5,16,11,14,41,34.1,27,14,1,13,9,41,5,0,MF,20-24,Midfielder,England,Europe
1544,Gabriel Magalhães,BRA,Arsenal,Premier League,2020,22.0,1997.0,22.2,25,15,19,5,1,13,19,68.4,6,27,19,8,26,51,74,2,DF,20-24,Defender,Brazil,South America
1545,Lisandro Magallán,ARG,Crotone,Serie A,2020,26.0,1993.0,24.2,54,31,28,24,2,17,42,40.5,25,29,15,14,44,98,78,1,DF,25-29,Defender,Argentina,South America
1546,Christian Maggio,ITA,Benevento,Serie A,2020,38.0,1982.0,3.3,9,4,2,7,0,3,9,33.3,6,4,1,3,2,11,6,0,DF,35-39,Defender,Italy,Europe
1547,Giulio Maggiore,ITA,Spezia,Serie A,2020,22.0,1998.0,24.6,61,36,26,28,7,21,53,39.6,32,33,6,27,19,80,25,1,MF,20-24,Midfielder,Italy,Europe
1548,Francesco Magnanelli,ITA,Sassuolo,Serie A,2020,35.0,1984.0,4.9,7,5,2,5,0,3,10,30.0,7,6,2,4,13,20,10,0,MF,35-39,Midfielder,Italy,Europe
1549,Giangiacomo Magnani,ITA,Hellas Verona,Serie A,2020,24.0,1995.0,16.8,26,15,14,9,3,9,16,56.3,7,25,16,9,44,70,105,1,DF,20-24,Defender,Italy,Europe
1550,Hugo Magnetti,FRA,Brest,Ligue 1,2020,22.0,1998.0,6.7,24,12,10,13,1,20,40,50.0,20,6,1,5,14,38,8,0,MF,20-24,Midfielder,France,Europe
1551,Harry Maguire,ENG,Manchester Utd,Premier League,2020,27.0,1993.0,33.9,29,17,19,10,0,18,29,62.1,11,28,23,5,60,89,122,4,DF,25-29,Defender,England,Europe
1552,Abdallahi Mahmoud,MTN,Alavés,La Liga,2020,20.0,2000.0,0.7,2,2,1,1,0,0,1,0.0,1,0,0,0,1,3,0,0,MF,20-24,Midfielder,Mauritania,Africa
1553,Hicham Mahou,FRA,Nice,Ligue 1,2020,21.0,1999.0,0.4,1,1,1,0,0,1,2,50.0,1,2,0,2,1,2,0,0,FW,20-24,Forward,France,Europe
1554,Riyad Mahrez,ALG,Manchester City,Premier League,2020,29.0,1991.0,21.7,20,5,2,10,8,6,30,20.0,24,19,0,19,8,28,4,0,FW,25-29,Forward,Algeria,Africa
1555,Arne Maier,GER,Arminia,Bundesliga,2020,21.0,1999.0,11.5,13,9,5,7,1,4,11,36.4,7,10,3,7,8,21,11,1,MF,20-24,Midfielder,Germany,Europe
1556,Arne Maier,GER,Hertha BSC,Bundesliga,2020,21.0,1999.0,0.3,1,1,0,1,0,0,1,0.0,1,0,0,0,0,1,0,0,MF,20-24,Midfielder,Germany,Europe
1557,Habib Maïga,CIV,Metz,Ligue 1,2020,24.0,1996.0,29.9,81,52,36,40,5,42,85,49.4,43,37,6,31,49,130,36,0,MF,20-24,Midfielder,Ivory Coast,Africa
1558,Mike Maignan,FRA,Lille,Ligue 1,2020,25.0,1995.0,38.0,0,0,0,0,0,0,0,,0,0,0,0,0,0,7,2,GK,25-29,Goalkeeper,France,Europe
1559,Ainsley Maitland-Niles,ENG,Arsenal,Premier League,2020,22.0,1997.0,5.4,11,7,6,5,0,8,12,66.7,4,12,2,10,14,25,7,1,"MF,DF",20-24,Midfielder,England,Europe
1560,Ainsley Maitland-Niles,ENG,West Brom,Premier League,2020,22.0,1997.0,13.7,22,10,7,8,7,9,28,32.1,19,12,1,11,17,39,24,0,MF,20-24,Midfielder,England,Europe
1561,Josh Maja,NGA,Fulham,Premier League,2020,21.0,1998.0,9.0,7,4,0,3,4,4,10,40.0,6,3,1,2,4,11,1,0,FW,20-24,Forward,Nigeria,Africa
1562,Josh Maja,NGA,Bordeaux,Ligue 1,2020,21.0,1998.0,8.9,8,2,3,3,2,3,14,21.4,11,3,0,3,6,14,9,0,FW,20-24,Forward,Nigeria,Africa
1564,Abdul Majeed Waris,GHA,Strasbourg,Ligue 1,2020,28.0,1991.0,6.1,1,1,1,0,0,1,6,16.7,5,0,0,0,2,3,2,0,"FW,MF",25-29,Forward,Ghana,Africa
1565,Marco Majouga,CTA,Nîmes,Ligue 1,2020,19.0,2001.0,1.4,1,1,1,0,0,1,3,33.3,2,0,0,0,0,1,0,0,"FW,MF",Under 20,Forward,Central African Republic,Africa
1566,Jean-Victor Makengo,FRA,Udinese,Serie A,2020,22.0,1998.0,5.8,8,7,5,3,0,3,13,23.1,10,7,1,6,5,13,7,0,MF,20-24,Midfielder,France,Europe
1570,Kévin Malcuit,MAR,Fiorentina,Serie A,2020,29.0,1991.0,2.3,5,3,2,2,1,0,1,0.0,1,5,0,5,3,8,6,0,DF,25-29,Defender,Morocco,Africa
1571,Kévin Malcuit,MAR,Napoli,Serie A,2020,29.0,1991.0,0.4,2,1,2,0,0,0,1,0.0,1,0,0,0,2,4,2,0,"FW,MF",25-29,Forward,Morocco,Africa
1572,Daniel Maldini,ITA,Milan,Serie A,2020,18.0,2001.0,0.3,1,0,0,1,0,0,2,0.0,2,0,0,0,0,1,0,0,"FW,DF",Under 20,Forward,Italy,Europe
1573,Ruslan Malinovskyi,UKR,Atalanta,Serie A,2020,27.0,1993.0,20.8,19,8,2,13,4,8,23,34.8,15,16,1,15,2,21,4,0,"MF,FW",25-29,Midfielder,Ukraine,Europe
1574,Yunus Mallı,TUR,Wolfsburg,Bundesliga,2020,28.0,1992.0,0.6,1,0,0,1,0,1,1,100.0,0,0,0,0,0,1,0,0,MF,25-29,Midfielder,Turkey,Asia
1577,Dennis Man,ROU,Parma,Serie A,2020,21.0,1998.0,7.8,12,6,6,4,2,6,21,28.6,15,5,0,5,2,14,6,0,"FW,MF",20-24,Forward,Romania,Europe
1578,Hianga Mananga Mbock,FRA,Brest,Ligue 1,2020,20.0,1999.0,5.1,4,3,2,2,0,2,9,22.2,7,2,0,2,3,7,6,0,"MF,FW",20-24,Midfielder,France,Europe
1579,Vincent Manceau,FRA,Angers,Ligue 1,2020,31.0,1989.0,25.7,42,27,23,17,2,30,63,47.6,33,23,2,21,35,77,61,0,DF,30-34,Defender,France,Europe
1580,Gianluca Mancini,ITA,Roma,Serie A,2020,24.0,1996.0,31.7,50,29,29,19,2,18,31,58.1,13,38,18,20,72,122,77,3,DF,20-24,Defender,Italy,Europe
1581,Steve Mandanda,FRA,Marseille,Ligue 1,2020,35.0,1985.0,37.0,0,0,0,0,0,0,1,0.0,1,0,0,0,2,2,8,6,GK,35-39,Goalkeeper,France,Europe
1582,Reinildo Mandava,MOZ,Lille,Ligue 1,2020,26.0,1994.0,24.2,79,43,39,32,8,35,58,60.3,23,26,3,23,45,124,53,0,DF,25-29,Defender,Mozambique,Africa
1583,Aïssa Mandi,ALG,Betis,La Liga,2020,28.0,1991.0,26.6,30,17,20,10,0,10,16,62.5,6,21,13,8,39,69,90,0,DF,25-29,Defender,Algeria,Africa
1584,Rolando Mandragora,ITA,Udinese,Serie A,2020,23.0,1997.0,4.4,8,5,3,4,1,3,10,30.0,7,10,3,7,6,14,5,0,MF,20-24,Midfielder,Italy,Europe
1585,Rolando Mandragora,ITA,Torino,Serie A,2020,23.0,1997.0,16.9,19,4,4,9,6,7,30,23.3,23,19,6,13,20,39,19,0,MF,20-24,Midfielder,Italy,Europe
1586,Mario Mandžukić,CRO,Milan,Serie A,2020,34.0,1986.0,2.4,7,6,2,4,1,2,3,66.7,1,0,0,0,2,9,3,0,FW,30-34,Forward,Croatia,Europe
1587,Sadio Mané,SEN,Liverpool,Premier League,2020,28.0,1992.0,31.2,48,30,6,22,20,12,33,36.4,21,30,0,30,15,63,11,0,FW,25-29,Forward,Senegal,Africa
1588,Niccolò Manfredini,ITA,Benevento,Serie A,2020,32.0,1988.0,1.0,0,0,0,0,0,0,0,,0,0,0,0,0,0,2,1,GK,30-34,Goalkeeper,Italy,Europe
1589,Eliaquim Mangala,FRA,Valencia,La Liga,2020,29.0,1991.0,3.6,0,0,0,0,0,0,1,0.0,1,8,6,2,6,6,12,0,DF,25-29,Defender,France,Europe
1590,Orel Mangala,BEL,Stuttgart,Bundesliga,2020,22.0,1998.0,23.4,27,15,13,11,3,17,28,60.7,11,27,10,17,26,53,30,0,MF,20-24,Midfielder,Belgium,Europe
1591,Thomas Mangani,FRA,Angers,Ligue 1,2020,33.0,1987.0,29.9,54,37,25,26,3,30,90,33.3,60,31,8,23,38,92,39,0,MF,30-34,Midfielder,France,Europe
1592,Vito Mannone,ITA,Monaco,Ligue 1,2020,32.0,1988.0,9.0,0,0,0,0,0,0,0,,0,0,0,0,0,0,3,1,GK,30-34,Goalkeeper,Italy,Europe
1593,Kostas Manolas,GRE,Napoli,Serie A,2020,29.0,1991.0,25.5,31,18,24,7,0,17,24,70.8,7,22,13,9,23,54,82,2,DF,25-29,Defender,Greece,Europe
1595,Juan Manuel Ramos,URU,Spezia,Serie A,2020,23.0,1996.0,3.3,5,0,3,0,2,4,7,57.1,3,1,0,1,2,7,6,0,DF,20-24,Defender,Uruguay,South America
1597,Faitout Maouassa,FRA,Rennes,Ligue 1,2020,22.0,1998.0,13.0,20,11,10,8,2,11,19,57.9,8,9,1,8,17,37,36,0,DF,20-24,Defender,France,Europe
1598,Sekou Mara,FRA,Bordeaux,Ligue 1,2020,18.0,2002.0,2.5,5,3,1,3,1,2,10,20.0,8,0,0,0,1,6,1,0,"FW,MF",Under 20,Forward,France,Europe
1599,Fernando Marçal,BRA,Wolves,Premier League,2020,31.0,1989.0,6.9,13,5,6,7,0,6,11,54.5,5,11,2,9,12,25,25,0,"DF,MF",30-34,Defender,Brazil,South America
1600,Fernando Marçal,BRA,Lyon,Ligue 1,2020,31.0,1989.0,0.9,1,0,0,1,0,0,0,,0,0,0,0,2,3,0,0,DF,30-34,Defender,Brazil,South America
1601,Marcelo,BRA,Real Madrid,La Liga,2020,32.0,1988.0,11.7,25,21,11,6,8,11,24,45.8,13,13,1,12,10,35,15,0,"DF,MF",30-34,Defender,Brazil,South America
1601,Marcelo,BRA,Real Madrid,La Liga,2020,32.0,1988.0,11.7,25,21,11,6,8,11,24,45.8,13,13,1,12,10,35,15,0,"DF,MF",30-34,Defender,Brazil,South America
1601,Marcelo,BRA,Real Madrid,La Liga,2020,32.0,1988.0,11.7,25,21,11,6,8,11,24,45.8,13,13,1,12,10,35,15,0,"DF,MF",30-34,Defender,Brazil,South America
1601,Marcelo,BRA,Real Madrid,La Liga,2020,32.0,1988.0,11.7,25,21,11,6,8,11,24,45.8,13,13,1,12,10,35,15,0,"DF,MF",30-34,Defender,Brazil,South America
1601,Marcelo,BRA,Real Madrid,La Liga,2020,32.0,1988.0,11.7,25,21,11,6,8,11,24,45.8,13,13,1,12,10,35,15,0,"DF,MF",30-34,Defender,Brazil,South America
1601,Marcelo,BRA,Real Madrid,La Liga,2020,32.0,1988.0,11.7,25,21,11,6,8,11,24,45.8,13,13,1,12,10,35,15,0,"DF,MF",30-34,Defender,Brazil,South America
1601,Marcelo,BRA,Real Madrid,La Liga,2020,32.0,1988.0,11.7,25,21,11,6,8,11,24,45.8,13,13,1,12,10,35,15,0,"DF,MF",30-34,Defender,Brazil,South America
1601,Marcelo,BRA,Real Madrid,La Liga,2020,32.0,1988.0,11.7,25,21,11,6,8,11,24,45.8,13,13,1,12,10,35,15,0,"DF,MF",30-34,Defender,Brazil,South America
1601,Marcelo,BRA,Real Madrid,La Liga,2020,32.0,1988.0,11.7,25,21,11,6,8,11,24,45.8,13,13,1,12,10,35,15,0,"DF,MF",30-34,Defender,Brazil,South America
1602,Marcelo,BRA,Lyon,Ligue 1,2020,33.0,1987.0,32.3,44,29,30,12,2,26,37,70.3,11,35,25,10,49,93,122,2,DF,30-34,Defender,Brazil,South America
1602,Marcelo,BRA,Lyon,Ligue 1,2020,33.0,1987.0,32.3,44,29,30,12,2,26,37,70.3,11,35,25,10,49,93,122,2,DF,30-34,Defender,Brazil,South America
1602,Marcelo,BRA,Lyon,Ligue 1,2020,33.0,1987.0,32.3,44,29,30,12,2,26,37,70.3,11,35,25,10,49,93,122,2,DF,30-34,Defender,Brazil,South America
1602,Marcelo,BRA,Lyon,Ligue 1,2020,33.0,1987.0,32.3,44,29,30,12,2,26,37,70.3,11,35,25,10,49,93,122,2,DF,30-34,Defender,Brazil,South America
1602,Marcelo,BRA,Lyon,Ligue 1,2020,33.0,1987.0,32.3,44,29,30,12,2,26,37,70.3,11,35,25,10,49,93,122,2,DF,30-34,Defender,Brazil,South America
1602,Marcelo,BRA,Lyon,Ligue 1,2020,33.0,1987.0,32.3,44,29,30,12,2,26,37,70.3,11,35,25,10,49,93,122,2,DF,30-34,Defender,Brazil,South America
1602,Marcelo,BRA,Lyon,Ligue 1,2020,33.0,1987.0,32.3,44,29,30,12,2,26,37,70.3,11,35,25,10,49,93,122,2,DF,30-34,Defender,Brazil,South America
1602,Marcelo,BRA,Lyon,Ligue 1,2020,33.0,1987.0,32.3,44,29,30,12,2,26,37,70.3,11,35,25,10,49,93,122,2,DF,30-34,Defender,Brazil,South America
1602,Marcelo,BRA,Lyon,Ligue 1,2020,33.0,1987.0,32.3,44,29,30,12,2,26,37,70.3,11,35,25,10,49,93,122,2,DF,30-34,Defender,Brazil,South America
1603,Solly March,ENG,Brighton,Premier League,2020,26.0,1994.0,18.6,49,23,24,15,10,18,34,52.9,16,30,5,25,22,71,30,0,"DF,MF",25-29,Defender,England,Europe
1604,Federico Marchetti,ITA,Genoa,Serie A,2020,37.0,1983.0,3.7,1,0,1,0,0,1,1,100.0,0,0,0,0,0,1,2,1,GK,35-39,Goalkeeper,Italy,Europe
1605,Riccardo Marchizza,ITA,Spezia,Serie A,2020,22.0,1998.0,17.3,20,11,12,5,3,12,21,57.1,9,13,4,9,11,31,27,0,DF,20-24,Defender,Italy,Europe
1606,Gian Marco Ferrari,ITA,Sassuolo,Serie A,2020,28.0,1992.0,33.5,32,20,15,14,3,10,23,43.5,13,46,37,9,50,82,100,1,DF,25-29,Defender,Italy,Europe
1607,Iván Marcone,ARG,Elche,La Liga,2020,30.0,1990.0,29.4,64,41,42,17,5,35,84,41.7,49,27,8,19,36,100,33,3,MF,30-34,Midfielder,Argentina,South America
1609,Dario Maresic,AUT,Reims,Ligue 1,2020,20.0,1999.0,5.7,12,7,8,4,0,8,14,57.1,6,7,2,5,10,22,17,1,DF,20-24,Defender,Austria,Europe
1612,José María Giménez,URU,Atlético Madrid,La Liga,2020,25.0,1995.0,19.6,20,7,14,5,1,12,17,70.6,5,17,11,6,21,41,65,0,DF,25-29,Defender,Uruguay,South America
1613,Mariano,DOM,Real Madrid,La Liga,2020,26.0,1993.0,5.7,4,2,2,1,1,0,9,0.0,9,3,1,2,0,4,3,0,FW,25-29,Forward,Dominican Republic,North America
1614,Jordan Marié,FRA,Dijon,Ligue 1,2020,28.0,1991.0,15.9,34,17,9,23,2,23,56,41.1,33,14,5,9,23,57,12,2,MF,25-29,Midfielder,France,Europe
1617,Răzvan Marin,ROU,Cagliari,Serie A,2020,24.0,1996.0,32.9,54,33,26,22,6,27,53,50.9,26,29,10,19,29,83,15,0,MF,20-24,Midfielder,Romania,Europe
1618,Guillermo Maripán,CHI,Monaco,Ligue 1,2020,26.0,1994.0,23.2,26,11,17,9,0,15,27,55.6,12,18,11,7,27,53,66,1,DF,25-29,Defender,Chile,South America
1619,Marlon,BRA,Sassuolo,Serie A,2020,24.0,1995.0,19.4,19,13,13,6,0,13,18,72.2,5,23,17,6,27,46,44,2,DF,20-24,Defender,Brazil,South America
1619,Marlon,BRA,Sassuolo,Serie A,2020,24.0,1995.0,19.4,19,13,13,6,0,13,18,72.2,5,23,17,6,27,46,44,2,DF,20-24,Defender,Brazil,South America
1619,Marlon,BRA,Sassuolo,Serie A,2020,24.0,1995.0,19.4,19,13,13,6,0,13,18,72.2,5,23,17,6,27,46,44,2,DF,20-24,Defender,Brazil,South America
1619,Marlon,BRA,Sassuolo,Serie A,2020,24.0,1995.0,19.4,19,13,13,6,0,13,18,72.2,5,23,17,6,27,46,44,2,DF,20-24,Defender,Brazil,South America
1619,Marlon,BRA,Sassuolo,Serie A,2020,24.0,1995.0,19.4,19,13,13,6,0,13,18,72.2,5,23,17,6,27,46,44,2,DF,20-24,Defender,Brazil,South America
1619,Marlon,BRA,Sassuolo,Serie A,2020,24.0,1995.0,19.4,19,13,13,6,0,13,18,72.2,5,23,17,6,27,46,44,2,DF,20-24,Defender,Brazil,South America
1619,Marlon,BRA,Sassuolo,Serie A,2020,24.0,1995.0,19.4,19,13,13,6,0,13,18,72.2,5,23,17,6,27,46,44,2,DF,20-24,Defender,Brazil,South America
1619,Marlon,BRA,Sassuolo,Serie A,2020,24.0,1995.0,19.4,19,13,13,6,0,13,18,72.2,5,23,17,6,27,46,44,2,DF,20-24,Defender,Brazil,South America
1619,Marlon,BRA,Sassuolo,Serie A,2020,24.0,1995.0,19.4,19,13,13,6,0,13,18,72.2,5,23,17,6,27,46,44,2,DF,20-24,Defender,Brazil,South America
1620,Omar Marmoush,EGY,Wolfsburg,Bundesliga,2020,21.0,1999.0,0.0,0,0,0,0,0,0,0,,0,0,0,0,0,0,0,0,FW,20-24,Forward,Egypt,Africa
1621,Marquinhos,BRA,Paris S-G,Ligue 1,2020,26.0,1994.0,23.6,27,21,14,10,3,15,26,57.7,11,21,9,12,27,54,75,2,DF,25-29,Defender,Brazil,South America
1621,Marquinhos,BRA,Paris S-G,Ligue 1,2020,26.0,1994.0,23.6,27,21,14,10,3,15,26,57.7,11,21,9,12,27,54,75,2,DF,25-29,Defender,Brazil,South America
1621,Marquinhos,BRA,Paris S-G,Ligue 1,2020,26.0,1994.0,23.6,27,21,14,10,3,15,26,57.7,11,21,9,12,27,54,75,2,DF,25-29,Defender,Brazil,South America
1621,Marquinhos,BRA,Paris S-G,Ligue 1,2020,26.0,1994.0,23.6,27,21,14,10,3,15,26,57.7,11,21,9,12,27,54,75,2,DF,25-29,Defender,Brazil,South America
1621,Marquinhos,BRA,Paris S-G,Ligue 1,2020,26.0,1994.0,23.6,27,21,14,10,3,15,26,57.7,11,21,9,12,27,54,75,2,DF,25-29,Defender,Brazil,South America
1621,Marquinhos,BRA,Paris S-G,Ligue 1,2020,26.0,1994.0,23.6,27,21,14,10,3,15,26,57.7,11,21,9,12,27,54,75,2,DF,25-29,Defender,Brazil,South America
1621,Marquinhos,BRA,Paris S-G,Ligue 1,2020,26.0,1994.0,23.6,27,21,14,10,3,15,26,57.7,11,21,9,12,27,54,75,2,DF,25-29,Defender,Brazil,South America
1621,Marquinhos,BRA,Paris S-G,Ligue 1,2020,26.0,1994.0,23.6,27,21,14,10,3,15,26,57.7,11,21,9,12,27,54,75,2,DF,25-29,Defender,Brazil,South America
1621,Marquinhos,BRA,Paris S-G,Ligue 1,2020,26.0,1994.0,23.6,27,21,14,10,3,15,26,57.7,11,21,9,12,27,54,75,2,DF,25-29,Defender,Brazil,South America
1622,Luca Marrone,ITA,Crotone,Serie A,2020,30.0,1990.0,17.6,25,18,16,9,0,13,21,61.9,8,22,11,11,26,51,56,1,DF,30-34,Defender,Italy,Europe
1624,Anthony Martial,FRA,Manchester Utd,Premier League,2020,24.0,1995.0,16.4,2,1,1,1,0,0,10,0.0,10,17,3,14,1,3,8,0,FW,20-24,Forward,France,Europe
1628,Jonas Martin,FRA,Rennes,Ligue 1,2020,30.0,1990.0,5.4,11,9,5,4,2,5,14,35.7,9,11,2,9,13,24,2,1,MF,30-34,Midfielder,France,Europe
1629,Gabriel Martinelli,BRA,Arsenal,Premier League,2020,19.0,2001.0,6.5,7,1,2,3,2,4,10,40.0,6,6,0,6,8,15,4,0,FW,Under 20,Forward,Brazil,South America
1630,Emiliano Martínez,ARG,Aston Villa,Premier League,2020,27.0,1992.0,38.0,3,3,3,0,0,3,4,75.0,1,0,0,0,2,5,10,2,GK,25-29,Goalkeeper,Argentina,South America
1630,Emiliano Martínez,ARG,Aston Villa,Premier League,2020,27.0,1992.0,38.0,3,3,3,0,0,3,4,75.0,1,0,0,0,2,5,10,2,GK,25-29,Goalkeeper,Argentina,South America
1630,Emiliano Martínez,ARG,Aston Villa,Premier League,2020,27.0,1992.0,38.0,3,3,3,0,0,3,4,75.0,1,0,0,0,2,5,10,2,GK,25-29,Goalkeeper,Argentina,South America
1630,Emiliano Martínez,ARG,Aston Villa,Premier League,2020,27.0,1992.0,38.0,3,3,3,0,0,3,4,75.0,1,0,0,0,2,5,10,2,GK,25-29,Goalkeeper,Argentina,South America
1635,Lautaro Martínez,ARG,Inter,Serie A,2020,22.0,1997.0,28.5,25,12,5,11,9,7,24,29.2,17,31,1,30,27,52,16,0,FW,20-24,Forward,Argentina,South America
1636,Pablo Martinez,FRA,Nîmes,Ligue 1,2020,31.0,1989.0,6.0,10,7,7,3,0,7,7,100.0,0,6,4,2,11,21,28,0,DF,30-34,Defender,France,Europe
1637,Lucas Martínez Quarta,ARG,Fiorentina,Serie A,2020,24.0,1996.0,16.5,32,20,17,11,4,18,41,43.9,23,27,9,18,39,71,48,0,DF,20-24,Defender,Argentina,South America
1638,Gelson Martins,POR,Monaco,Ligue 1,2020,25.0,1995.0,17.2,41,26,12,16,13,15,37,40.5,22,20,0,20,13,54,8,0,"MF,FW",25-29,Midfielder,Portugal,Europe
1639,Adam Marušić,MNE,Lazio,Serie A,2020,27.0,1992.0,33.0,38,22,22,15,1,20,40,50.0,20,38,6,32,40,78,54,0,DF,25-29,Defender,Montenegro,Europe
1640,Sylvain Marveaux,FRA,Lorient,Ligue 1,2020,34.0,1986.0,2.2,6,3,1,4,1,3,3,100.0,0,2,0,2,1,7,2,0,"MF,FW",30-34,Midfielder,France,Europe
1642,Omar Mascarell,EQG,Schalke 04,Bundesliga,2020,27.0,1993.0,19.6,41,24,15,19,7,21,54,38.9,33,40,14,26,37,78,32,1,MF,25-29,Midfielder,Equatorial Guinea,Africa
1643,Andrea Masiello,ITA,Genoa,Serie A,2020,34.0,1986.0,28.5,38,22,29,6,3,23,48,47.9,25,32,13,19,53,91,107,3,DF,30-34,Defender,Italy,Europe
1645,Roberto Massimo,GER,Stuttgart,Bundesliga,2020,19.0,2000.0,8.4,21,11,13,5,3,11,24,45.8,13,5,1,4,11,32,13,0,"DF,FW",Under 20,Defender,Germany,Europe
1646,Giuseppe Mastinu,ITA,Spezia,Serie A,2020,28.0,1991.0,0.4,1,1,0,0,1,1,1,100.0,0,1,0,1,0,1,0,0,FW,25-29,Forward,Italy,Europe
1647,Arthur Masuaku,COD,West Ham,Premier League,2020,26.0,1993.0,11.2,20,12,14,6,0,11,34,32.4,23,12,0,12,8,28,28,2,"DF,MF",25-29,Defender,DR Congo,Africa
1650,Pape Matar Sarr,SEN,Metz,Ligue 1,2020,17.0,2002.0,17.7,45,29,19,21,5,20,38,52.6,18,24,4,20,27,72,16,0,MF,Under 20,Midfielder,Senegal,Africa
1651,Eliot Matazo,BEL,Monaco,Ligue 1,2020,18.0,2002.0,3.5,11,5,6,5,0,3,7,42.9,4,1,0,1,1,12,2,0,MF,Under 20,Midfielder,Belgium,Europe
1652,Jean-Philippe Mateta,FRA,Crystal Palace,Premier League,2020,23.0,1997.0,2.5,1,1,0,1,0,1,3,33.3,2,1,0,1,0,1,2,0,FW,20-24,Forward,France,Europe
1653,Jean-Philippe Mateta,FRA,Mainz 05,Bundesliga,2020,23.0,1997.0,11.1,6,3,1,3,2,0,3,0.0,3,3,1,2,4,10,6,0,FW,20-24,Forward,France,Europe
1655,Joël Matip,CMR,Liverpool,Premier League,2020,28.0,1991.0,7.7,14,9,7,7,0,7,8,87.5,1,6,0,6,7,21,22,0,DF,25-29,Defender,Cameroon,Africa
1656,Rabbi Matondo,WAL,Schalke 04,Bundesliga,2020,19.0,2000.0,2.4,3,2,0,3,0,2,3,66.7,1,1,0,1,1,4,1,0,"FW,MF",Under 20,Forward,Wales,Europe
1657,Ryder Matos,BRA,Udinese,Serie A,2020,27.0,1993.0,0.1,0,0,0,0,0,0,0,,0,0,0,0,0,0,0,0,MF,25-29,Midfielder,Brazil,South America
1658,Henning Matriciani,GER,Schalke 04,Bundesliga,2020,20.0,2000.0,0.3,1,1,1,0,0,1,1,100.0,0,1,0,1,0,1,1,0,DF,20-24,Defender,Germany,Europe
1659,Chrislain Matsima,FRA,Monaco,Ligue 1,2020,18.0,2002.0,3.9,5,4,3,2,0,4,7,57.1,3,3,0,3,4,9,12,0,"DF,FW",Under 20,Defender,France,Europe
1660,Federico Mattiello,ITA,Spezia,Serie A,2020,25.0,1995.0,0.4,0,0,0,0,0,0,0,,0,0,0,0,0,0,0,0,DF,25-29,Defender,Italy,Europe
1661,Neal Maupay,FRA,Brighton,Premier League,2020,23.0,1996.0,27.9,20,8,9,7,4,4,24,16.7,20,20,0,20,13,33,6,0,"FW,MF",20-24,Forward,France,Europe
1662,Tony Mauricio,FRA,Lens,Ligue 1,2020,26.0,1994.0,5.6,19,12,7,8,4,11,17,64.7,6,8,1,7,3,22,4,0,MF,25-29,Midfielder,France,Europe
1663,Stephy Mavididi,ENG,Montpellier,Ligue 1,2020,22.0,1998.0,22.6,18,5,7,10,1,8,23,34.8,15,12,0,12,14,32,6,0,"FW,MF",20-24,Forward,England,Europe
1664,Konstantinos Mavropanos,GRE,Stuttgart,Bundesliga,2020,22.0,1997.0,16.3,42,29,29,12,1,27,46,58.7,19,25,10,15,59,101,66,1,DF,20-24,Defender,Greece,Europe
1665,Eric Maxim Choupo-Moting,CMR,Bayern Munich,Bundesliga,2020,31.0,1989.0,9.1,8,2,0,5,3,1,4,25.0,3,6,0,6,2,10,7,0,"FW,MF",30-34,Forward,Cameroon,Africa
1668,Youssef Maziz,FRA,Metz,Ligue 1,2020,22.0,1998.0,2.9,2,0,1,1,0,1,5,20.0,4,1,0,1,6,8,1,0,"MF,FW",20-24,Midfielder,France,Europe
1669,Antonio Mazzotta,ITA,Crotone,Serie A,2020,30.0,1989.0,0.6,1,1,0,1,0,0,0,,0,0,0,0,0,1,1,0,DF,30-34,Defender,Italy,Europe
1670,Kevin Mbabu,SUI,Wolfsburg,Bundesliga,2020,25.0,1995.0,18.2,51,33,27,17,7,24,35,68.6,11,28,7,21,22,73,59,1,DF,25-29,Defender,Switzerland,Europe
1671,Kylian Mbappé,FRA,Paris S-G,Ligue 1,2020,21.0,1998.0,26.4,4,2,0,1,3,2,9,22.2,7,7,1,6,3,7,4,1,FW,20-24,Forward,France,Europe
1672,Ibrahima Mbaye,SEN,Bologna,Serie A,2020,25.0,1994.0,4.8,6,5,5,1,0,3,5,60.0,2,5,3,2,1,7,10,0,DF,25-29,Defender,Senegal,Africa
1673,Jean-Manuel Mbom,GER,Werder Bremen,Bundesliga,2020,20.0,2000.0,12.9,19,13,14,3,2,8,27,29.6,19,17,6,11,13,32,27,0,"MF,DF",20-24,Midfielder,Germany,Europe
1674,Nathanael Mbuku,COD,Reims,Ligue 1,2020,18.0,2002.0,24.6,33,19,9,13,11,8,28,28.6,20,17,0,17,14,47,10,0,"MF,FW",Under 20,Midfielder,DR Congo,Africa
1675,James McArthur,SCO,Crystal Palace,Premier League,2020,32.0,1987.0,16.3,57,32,25,27,5,15,39,38.5,24,28,3,25,23,80,31,0,MF,30-34,Midfielder,Scotland,Europe
1676,Oliver McBurnie,SCO,Sheffield Utd,Premier League,2020,24.0,1996.0,14.7,15,7,7,7,1,5,17,29.4,12,10,3,7,6,21,30,0,FW,20-24,Forward,Scotland,Europe
1677,Alex McCarthy,ENG,Southampton,Premier League,2020,30.0,1989.0,30.0,1,0,1,0,0,1,4,25.0,3,0,0,0,0,1,11,1,GK,30-34,Goalkeeper,England,Europe
1678,James McCarthy,IRL,Crystal Palace,Premier League,2020,29.0,1990.0,9.1,16,12,9,7,0,8,21,38.1,13,15,7,8,8,24,12,0,MF,25-29,Midfielder,Republic of Ireland,Europe
1679,John McGinn,SCO,Aston Villa,Premier League,2020,25.0,1994.0,37.0,61,37,23,31,7,27,84,32.1,57,38,6,32,43,104,23,2,MF,25-29,Midfielder,Scotland,Europe
1680,David McGoldrick,IRL,Sheffield Utd,Premier League,2020,32.0,1987.0,26.6,33,21,8,15,10,13,31,41.9,18,19,3,16,2,35,25,0,"FW,MF",30-34,Forward,Republic of Ireland,Europe
1681,Weston McKennie,USA,Juventus,Serie A,2020,21.0,1998.0,18.9,34,19,9,20,5,12,33,36.4,21,21,3,18,28,62,26,0,MF,20-24,Midfielder,United States,North America
1682,Dwight McNeil,ENG,Burnley,Premier League,2020,20.0,1999.0,34.1,47,24,24,18,5,18,56,32.1,38,44,6,38,32,79,32,1,MF,20-24,Midfielder,England,Europe
1683,Scott McTominay,SCO,Manchester Utd,Premier League,2020,23.0,1996.0,23.7,51,24,23,25,3,23,36,63.9,13,35,10,25,29,80,46,0,MF,20-24,Midfielder,Scotland,Europe
1684,Gary Medel,CHI,Bologna,Serie A,2020,32.0,1987.0,5.7,12,9,6,5,1,4,10,40.0,6,8,6,2,7,19,10,0,"DF,MF",30-34,Defender,Chile,South America
1685,Facundo Medina,ARG,Lens,Ligue 1,2020,21.0,1999.0,22.3,39,22,22,15,2,24,38,63.2,14,25,9,16,39,78,51,3,DF,20-24,Defender,Argentina,South America
1686,Nathan de Medina,BEL,Arminia,Bundesliga,2020,22.0,1997.0,7.1,16,10,9,6,1,3,10,30.0,7,12,2,10,11,27,22,0,DF,20-24,Defender,Belgium,Europe
1687,Ben Mee,ENG,Burnley,Premier League,2020,30.0,1989.0,29.9,32,15,16,14,2,14,29,48.3,15,54,45,9,43,75,148,2,DF,30-34,Defender,England,Europe
1688,Joshua Mees,GER,Union Berlin,Bundesliga,2020,24.0,1996.0,0.1,0,0,0,0,0,0,0,,0,0,0,0,0,0,0,0,FW,20-24,Forward,Germany,Europe
1689,Admir Mehmedi,SUI,Wolfsburg,Bundesliga,2020,29.0,1991.0,9.1,17,9,6,7,4,6,16,37.5,10,7,0,7,5,22,1,0,"MF,FW",25-29,Midfielder,Switzerland,Europe
1690,Soualiho Meïté,FRA,Torino,Serie A,2020,26.0,1994.0,10.2,11,7,6,4,1,5,16,31.3,11,18,1,17,10,21,9,1,MF,25-29,Midfielder,France,Europe
1691,Soualiho Meïté,FRA,Milan,Serie A,2020,26.0,1994.0,6.5,18,10,10,6,2,8,17,47.1,9,9,2,7,8,26,16,0,MF,25-29,Midfielder,France,Europe
1692,Hannibal Mejbri,TUN,Manchester Utd,Premier League,2020,17.0,2003.0,0.1,0,0,0,0,0,0,0,,0,0,0,0,0,0,0,0,MF,Under 20,Midfielder,Tunisia,Africa
1693,Farid El Melali,ALG,Angers,Ligue 1,2020,23.0,1997.0,4.6,9,5,5,4,0,2,13,15.4,11,12,0,12,6,15,2,0,"FW,MF",20-24,Forward,Algeria,Africa
1694,Filippo Melegoni,ITA,Genoa,Serie A,2020,21.0,1999.0,4.3,7,6,2,5,0,3,6,50.0,3,5,0,5,5,12,8,0,"MF,DF",20-24,Midfielder,Italy,Europe
1697,Arthur Melo,BRA,Juventus,Serie A,2020,23.0,1996.0,12.9,17,9,7,10,0,12,31,38.7,19,6,1,5,18,35,9,1,MF,20-24,Midfielder,Brazil,South America
1698,Memphis,NED,Lyon,Ligue 1,2020,26.0,1994.0,32.5,4,3,0,3,1,1,20,5.0,19,11,1,10,5,9,3,0,FW,25-29,Forward,Netherlands,Europe
1699,Houboulang Mendes,GNB,Lorient,Ligue 1,2020,22.0,1998.0,14.4,28,19,19,5,4,16,28,57.1,12,14,2,12,14,42,35,0,DF,20-24,Defender,Guinea-Bissau,Africa
1700,Pedro Mendes,POR,Montpellier,Ligue 1,2020,29.0,1990.0,18.1,21,19,16,5,0,14,21,66.7,7,23,13,10,34,55,58,0,DF,25-29,Defender,Portugal,Europe
1700,Pedro Mendes,POR,Montpellier,Ligue 1,2020,29.0,1990.0,18.1,21,19,16,5,0,14,21,66.7,7,23,13,10,34,55,58,0,DF,25-29,Defender,Portugal,Europe
1700,Pedro Mendes,POR,Montpellier,Ligue 1,2020,29.0,1990.0,18.1,21,19,16,5,0,14,21,66.7,7,23,13,10,34,55,58,0,DF,25-29,Defender,Portugal,Europe
1700,Pedro Mendes,POR,Montpellier,Ligue 1,2020,29.0,1990.0,18.1,21,19,16,5,0,14,21,66.7,7,23,13,10,34,55,58,0,DF,25-29,Defender,Portugal,Europe
1700,Pedro Mendes,POR,Montpellier,Ligue 1,2020,29.0,1990.0,18.1,21,19,16,5,0,14,21,66.7,7,23,13,10,34,55,58,0,DF,25-29,Defender,Portugal,Europe
1700,Pedro Mendes,POR,Montpellier,Ligue 1,2020,29.0,1990.0,18.1,21,19,16,5,0,14,21,66.7,7,23,13,10,34,55,58,0,DF,25-29,Defender,Portugal,Europe
1700,Pedro Mendes,POR,Montpellier,Ligue 1,2020,29.0,1990.0,18.1,21,19,16,5,0,14,21,66.7,7,23,13,10,34,55,58,0,DF,25-29,Defender,Portugal,Europe
1700,Pedro Mendes,POR,Montpellier,Ligue 1,2020,29.0,1990.0,18.1,21,19,16,5,0,14,21,66.7,7,23,13,10,34,55,58,0,DF,25-29,Defender,Portugal,Europe
1700,Pedro Mendes,POR,Montpellier,Ligue 1,2020,29.0,1990.0,18.1,21,19,16,5,0,14,21,66.7,7,23,13,10,34,55,58,0,DF,25-29,Defender,Portugal,Europe
1701,Thiago Mendes,BRA,Lyon,Ligue 1,2020,28.0,1992.0,24.9,37,22,13,20,4,18,38,47.4,20,33,7,26,39,76,21,2,MF,25-29,Midfielder,Brazil,South America
1705,Batista Mendy,FRA,Nantes,Ligue 1,2020,20.0,2000.0,0.8,1,1,0,1,0,0,1,0.0,1,3,1,2,1,2,1,0,MF,20-24,Midfielder,France,Europe
1706,Benjamin Mendy,FRA,Manchester City,Premier League,2020,26.0,1994.0,10.6,13,9,1,8,4,5,21,23.8,16,12,5,7,5,18,14,1,DF,25-29,Defender,France,Europe
1707,Edouard Mendy,SEN,Chelsea,Premier League,2020,28.0,1992.0,30.5,0,0,0,0,0,0,1,0.0,1,0,0,0,1,1,9,3,GK,25-29,Goalkeeper,Senegal,Africa
1708,Edouard Mendy,SEN,Rennes,Ligue 1,2020,28.0,1992.0,1.0,0,0,0,0,0,0,0,,0,0,0,0,0,0,0,0,GK,25-29,Goalkeeper,Senegal,Africa
1709,Ferland Mendy,FRA,Real Madrid,La Liga,2020,25.0,1995.0,24.5,26,16,17,6,3,12,24,50.0,12,16,4,12,26,52,32,1,DF,25-29,Defender,France,Europe
1710,Nampalys Mendy,SEN,Leicester City,Premier League,2020,28.0,1992.0,16.2,26,17,18,6,2,7,20,35.0,13,12,1,11,14,40,8,0,MF,25-29,Midfielder,Senegal,Africa
1711,Hamza Mendyl,MAR,Schalke 04,Bundesliga,2020,22.0,1997.0,1.1,2,2,2,0,0,0,2,0.0,2,2,0,2,0,2,2,0,"FW,DF",20-24,Forward,Morocco,Africa
1712,Levent Mercan,GER,Schalke 04,Bundesliga,2020,19.0,2000.0,0.1,0,0,0,0,0,0,0,,0,0,0,0,0,0,0,0,FW,Under 20,Forward,Germany,Europe
1714,Alex Meret,ITA,Napoli,Serie A,2020,23.0,1997.0,22.0,0,0,0,0,0,0,1,0.0,1,0,0,0,0,0,5,0,GK,20-24,Goalkeeper,Italy,Europe
1717,Yıldırım Mert Çetin,TUR,Hellas Verona,Serie A,2020,23.0,1997.0,4.6,8,4,3,5,0,2,6,33.3,4,7,5,2,14,22,11,1,DF,20-24,Defender,Turkey,Asia
1718,Dries Mertens,BEL,Napoli,Serie A,2020,33.0,1987.0,16.2,16,14,4,7,5,5,25,20.0,20,7,1,6,9,25,3,1,"FW,MF",30-34,Forward,Belgium,Europe
1720,Illan Meslier,FRA,Leeds United,Premier League,2020,20.0,2000.0,35.0,0,0,0,0,0,0,1,0.0,1,0,0,0,0,0,17,8,GK,20-24,Goalkeeper,France,Europe
1721,Lionel Messi,ARG,Barcelona,La Liga,2020,33.0,1987.0,33.6,18,10,3,9,6,6,17,35.3,11,12,0,12,6,24,0,2,"FW,MF",30-34,Forward,Argentina,South America
1722,Junior Messias,BRA,Crotone,Serie A,2020,29.0,1991.0,35.7,60,35,26,24,10,22,70,31.4,48,32,12,20,35,95,40,0,"MF,FW",25-29,Midfielder,Brazil,South America
1723,Thomas Meunier,BEL,Dortmund,Bundesliga,2020,28.0,1991.0,16.4,30,21,19,6,5,20,29,69.0,9,16,6,10,18,48,29,2,DF,25-29,Defender,Belgium,Europe
1724,Mexer,MOZ,Bordeaux,Ligue 1,2020,31.0,1988.0,7.9,9,6,8,0,1,5,10,50.0,5,8,5,3,17,26,22,0,DF,30-34,Defender,Mozambique,Africa
1725,Max Meyer,GER,Köln,Bundesliga,2020,24.0,1995.0,3.9,7,4,3,3,1,4,8,50.0,4,4,1,3,3,10,1,0,MF,20-24,Midfielder,Germany,Europe
1726,Omenuke Mfulu,COD,Elche,La Liga,2020,26.0,1994.0,8.8,18,12,10,8,0,5,15,33.3,10,7,1,6,11,29,18,0,MF,25-29,Midfielder,DR Congo,Africa
1728,Jonas Michelbrink,GER,Hertha BSC,Bundesliga,2020,19.0,2001.0,0.4,0,0,0,0,0,0,0,,0,0,0,0,0,0,0,0,MF,Under 20,Midfielder,Germany,Europe
1729,Clément Michelin,FRA,Lens,Ligue 1,2020,23.0,1997.0,12.8,25,19,13,9,3,9,16,56.3,7,13,4,9,25,50,32,0,DF,20-24,Defender,France,Europe
1730,Edouard Michut,FRA,Paris S-G,Ligue 1,2020,17.0,2003.0,0.0,0,0,0,0,0,0,0,,0,0,0,0,0,0,0,0,MF,Under 20,Midfielder,France,Europe
1732,Florian Miguel,FRA,Nîmes,Ligue 1,2020,23.0,1996.0,17.1,14,13,12,2,0,9,17,52.9,8,21,13,8,45,59,66,1,DF,20-24,Defender,France,Europe
1733,Valentin Mihaila,ROU,Parma,Serie A,2020,20.0,2000.0,7.8,2,1,1,1,0,0,10,0.0,10,8,1,7,5,7,8,0,"FW,MF",20-24,Forward,Romania,Europe
1738,Éder Militão,BRA,Real Madrid,La Liga,2020,22.0,1998.0,12.6,20,8,13,6,1,8,14,57.1,6,19,6,13,19,39,42,0,DF,20-24,Defender,Brazil,South America
1743,Vincenzo Millico,ITA,Torino,Serie A,2020,19.0,2000.0,0.2,0,0,0,0,0,0,0,,0,0,0,0,0,0,0,0,"FW,MF",Under 20,Forward,Italy,Europe
1744,Enzo Millot,FRA,Monaco,Ligue 1,2020,18.0,2002.0,0.5,2,0,0,1,1,1,1,100.0,0,0,0,0,2,4,0,0,MF,Under 20,Midfielder,France,Europe
1745,James Milner,ENG,Liverpool,Premier League,2020,34.0,1986.0,11.9,26,19,9,14,3,11,33,33.3,22,30,3,27,14,40,16,1,"MF,DF",30-34,Midfielder,England,Europe
1747,Yerry Mina,COL,Everton,Premier League,2020,25.0,1994.0,21.5,21,14,17,4,0,8,12,66.7,4,30,23,7,24,45,110,1,DF,25-29,Defender,Colombia,South America
1748,Takumi Minamino,JPN,Southampton,Premier League,2020,25.0,1995.0,7.9,7,3,2,5,0,2,19,10.5,17,13,1,12,4,11,9,0,MF,25-29,Midfielder,Japan,Asia
1749,Takumi Minamino,JPN,Liverpool,Premier League,2020,25.0,1995.0,3.3,4,3,1,2,1,0,12,0.0,12,1,0,1,2,6,3,0,"MF,FW",25-29,Midfielder,Japan,Asia
1750,Tyrone Mings,ENG,Aston Villa,Premier League,2020,27.0,1993.0,35.5,32,16,23,7,2,16,24,66.7,8,59,40,19,41,73,172,3,DF,25-29,Defender,England,Europe
1754,Aleksei Miranchuk,RUS,Atalanta,Serie A,2020,24.0,1995.0,7.5,24,13,8,9,7,6,9,66.7,3,1,0,1,3,27,1,0,"MF,FW",20-24,Midfielder,Russia,Europe
1756,Antonio Mirante,ITA,Roma,Serie A,2020,37.0,1983.0,12.8,0,0,0,0,0,0,1,0.0,1,1,0,1,0,0,7,2,GK,35-39,Goalkeeper,Italy,Europe
1757,Tyrick Mitchell,ENG,Crystal Palace,Premier League,2020,20.0,1999.0,19.0,64,35,48,9,7,23,40,57.5,17,29,10,19,21,85,62,1,DF,20-24,Defender,England,Europe
1760,Maximilian Mittelstädt,GER,Hertha BSC,Bundesliga,2020,23.0,1997.0,20.0,66,39,42,21,3,35,72,48.6,37,34,5,29,55,121,61,1,"DF,FW",20-24,Defender,Germany,Europe
1761,Henrikh Mkhitaryan,ARM,Roma,Serie A,2020,31.0,1989.0,30.5,58,24,13,27,18,13,62,21.0,49,34,0,34,39,97,10,0,"MF,FW",30-34,Midfielder,Armenia,Asia
1763,Anthony Modeste,FRA,Saint-Étienne,Ligue 1,2020,32.0,1988.0,3.3,2,1,0,2,0,1,4,25.0,3,3,1,2,0,2,3,0,"FW,MF",30-34,Forward,France,Europe
1764,Anthony Modeste,FRA,Köln,Bundesliga,2020,32.0,1988.0,2.5,2,0,0,2,0,0,1,0.0,1,0,0,0,0,2,2,0,FW,30-34,Forward,France,Europe
1765,Luka Modrić,CRO,Real Madrid,La Liga,2020,34.0,1985.0,30.4,37,23,18,16,3,13,36,36.1,23,14,2,12,48,85,14,1,MF,30-34,Midfielder,Croatia,Europe
1766,Terem Moffi,NGA,Lorient,Ligue 1,2020,21.0,1999.0,23.0,13,8,0,8,5,4,19,21.1,15,5,2,3,4,17,8,0,FW,20-24,Forward,Nigeria,Africa
1767,Kevin Möhwald,GER,Werder Bremen,Bundesliga,2020,27.0,1993.0,17.3,15,9,9,5,1,4,18,22.2,14,10,3,7,32,47,19,2,MF,25-29,Midfielder,Germany,Europe
1768,Niklas Moisander,FIN,Werder Bremen,Bundesliga,2020,34.0,1985.0,13.6,14,11,11,3,0,8,14,57.1,6,15,8,7,22,36,61,0,DF,30-34,Defender,Finland,Europe
1769,Dion Moise Sahi,CIV,Strasbourg,Ligue 1,2020,18.0,2001.0,1.0,1,0,0,1,0,1,1,100.0,0,1,0,1,0,1,0,0,"FW,MF",Under 20,Forward,Ivory Coast,Africa
1770,Johan Mojica,COL,Atalanta,Serie A,2020,27.0,1992.0,3.3,4,4,3,1,0,2,3,66.7,1,3,0,3,7,11,6,0,DF,25-29,Defender,Colombia,South America
1771,Johan Mojica,COL,Elche,La Liga,2020,27.0,1992.0,13.4,21,10,15,5,1,8,18,44.4,10,15,4,11,15,36,27,0,DF,25-29,Defender,Colombia,South America
1774,Nahuel Molina,ARG,Udinese,Serie A,2020,22.0,1998.0,20.3,27,18,13,10,4,16,42,38.1,26,26,4,22,21,48,49,1,DF,20-24,Defender,Argentina,South America
1775,Salvatore Molina,ITA,Crotone,Serie A,2020,28.0,1992.0,25.7,39,22,18,14,7,29,45,64.4,16,30,8,22,17,56,41,0,"MF,DF",25-29,Midfielder,Italy,Europe
1777,Florent Mollet,FRA,Montpellier,Ligue 1,2020,28.0,1991.0,26.2,20,15,7,11,2,12,47,25.5,35,18,4,14,32,52,9,1,MF,25-29,Midfielder,France,Europe
1778,Jayson Molumby,IRL,Brighton,Premier League,2020,20.0,1999.0,0.0,0,0,0,0,0,0,0,,0,0,0,0,0,0,0,0,MF,20-24,Midfielder,Republic of Ireland,Europe
1779,Alkhaly Momo Cissé,GUI,Stuttgart,Bundesliga,2020,17.0,2002.0,0.4,1,1,1,0,0,0,0,,0,1,0,1,0,1,0,0,"FW,DF",Under 20,Forward,Guinea,Africa
1781,Gabriele Moncini,ITA,Benevento,Serie A,2020,24.0,1996.0,4.0,2,1,2,0,0,0,1,0.0,1,2,0,2,2,4,4,0,"FW,MF",20-24,Forward,Italy,Europe
1782,Thomas Monconduit,FRA,Lorient,Ligue 1,2020,29.0,1991.0,12.8,28,15,9,16,3,15,41,36.6,26,10,3,7,13,41,21,1,MF,25-29,Midfielder,France,Europe
1783,Kévin Monnet-Paquet,FRA,Saint-Étienne,Ligue 1,2020,31.0,1988.0,6.3,11,7,7,2,2,5,10,50.0,5,5,0,5,6,17,7,0,"MF,FW",30-34,Midfielder,France,Europe
1786,Lorenzo Montipò,ITA,Benevento,Serie A,2020,24.0,1996.0,37.0,0,0,0,0,0,0,0,,0,1,0,1,0,0,16,3,GK,20-24,Goalkeeper,Italy,Europe
1789,Emre Mor,TUR,Celta Vigo,La Liga,2020,23.0,1997.0,5.6,8,4,1,3,4,0,3,0.0,3,5,0,5,5,13,0,0,"FW,MF",20-24,Forward,Turkey,Asia
1790,Luca Mora,ITA,Spezia,Serie A,2020,32.0,1988.0,1.3,3,1,1,2,0,2,4,50.0,2,2,1,1,0,3,2,0,MF,30-34,Midfielder,Italy,Europe
1791,Wesley Moraes,BRA,Aston Villa,Premier League,2020,23.0,1996.0,0.2,0,0,0,0,0,0,1,0.0,1,0,0,0,0,0,0,0,FW,20-24,Forward,Brazil,South America
1795,Jérémy Morel,MAD,Lorient,Ligue 1,2020,36.0,1984.0,27.7,31,19,21,10,0,20,39,51.3,19,26,11,15,44,75,81,1,DF,35-39,Defender,Madagascar,Africa
1801,Wes Morgan,JAM,Leicester City,Premier League,2020,36.0,1984.0,0.2,0,0,0,0,0,0,0,,0,0,0,0,0,0,1,0,DF,35-39,Defender,Jamaica,North America
1802,Ilaix Moriba,GUI,Barcelona,La Liga,2020,17.0,2003.0,6.0,14,6,5,7,2,5,10,50.0,5,16,1,15,5,19,4,1,MF,Under 20,Midfielder,Guinea,Africa
1806,Aimen Moueffek,FRA,Saint-Étienne,Ligue 1,2020,19.0,2001.0,8.3,25,15,16,6,3,13,32,40.6,19,17,2,15,9,34,18,0,"DF,MF",Under 20,Defender,France,Europe
1807,Youssoufa Moukoko,GER,Dortmund,Bundesliga,2020,15.0,2004.0,4.7,3,2,1,1,1,0,0,,0,3,0,3,0,3,2,0,"FW,MF",Under 20,Forward,Germany,Europe
1808,Harold Moukoudi,CMR,Saint-Étienne,Ligue 1,2020,22.0,1997.0,25.3,46,27,37,8,1,28,38,73.7,10,24,10,14,42,88,78,1,DF,20-24,Defender,Cameroon,Africa
1809,Jessy Moulin,FRA,Saint-Étienne,Ligue 1,2020,34.0,1986.0,29.0,2,1,2,0,0,2,3,66.7,1,0,0,0,2,4,9,2,GK,30-34,Goalkeeper,France,Europe
1810,Steve Mounié,BEN,Brest,Ligue 1,2020,25.0,1994.0,29.8,15,11,3,11,1,3,28,10.7,25,18,3,15,12,27,40,0,FW,25-29,Forward,Benin,Africa
1811,Mason Mount,ENG,Chelsea,Premier League,2020,21.0,1999.0,32.1,75,35,22,38,15,25,69,36.2,44,40,2,38,31,106,14,0,MF,20-24,Midfielder,England,Europe
1812,Lucas Moura,BRA,Tottenham,Premier League,2020,27.0,1992.0,15.7,32,16,12,16,4,8,29,27.6,21,12,0,12,18,50,10,0,"FW,MF",25-29,Forward,Brazil,South America
1813,Lys Mousset,FRA,Sheffield Utd,Premier League,2020,24.0,1996.0,3.3,1,0,0,0,1,0,2,0.0,2,1,0,1,0,1,1,1,"FW,MF",20-24,Forward,France,Europe
1814,João Moutinho,POR,Wolves,Premier League,2020,33.0,1986.0,28.1,75,40,34,35,6,35,91,38.5,56,18,3,15,47,122,28,0,MF,30-34,Midfielder,Portugal,Europe
1814,João Moutinho,POR,Wolves,Premier League,2020,33.0,1986.0,28.1,75,40,34,35,6,35,91,38.5,56,18,3,15,47,122,28,0,MF,30-34,Midfielder,Portugal,Europe
1814,João Moutinho,POR,Wolves,Premier League,2020,33.0,1986.0,28.1,75,40,34,35,6,35,91,38.5,56,18,3,15,47,122,28,0,MF,30-34,Midfielder,Portugal,Europe
1814,João Moutinho,POR,Wolves,Premier League,2020,33.0,1986.0,28.1,75,40,34,35,6,35,91,38.5,56,18,3,15,47,122,28,0,MF,30-34,Midfielder,Portugal,Europe
1815,Samuel Moutoussamy,COD,Nantes,Ligue 1,2020,23.0,1996.0,0.9,0,0,0,0,0,0,1,0.0,1,1,0,1,0,0,0,0,FW,20-24,Forward,DR Congo,Africa
1816,Loris Mouyokolo,FRA,Lorient,Ligue 1,2020,19.0,2001.0,0.2,1,1,1,0,0,1,1,100.0,0,1,1,0,0,1,1,0,DF,Under 20,Defender,France,Europe
1818,Nordi Mukiele,FRA,RB Leipzig,Bundesliga,2020,22.0,1997.0,18.6,44,30,14,28,2,21,37,56.8,16,33,1,32,23,67,33,2,DF,20-24,Defender,France,Europe
1819,Mert Müldür,TUR,Sassuolo,Serie A,2020,21.0,1999.0,18.6,43,20,26,9,8,27,53,50.9,26,17,1,16,36,79,41,0,DF,20-24,Defender,Turkey,Asia
1820,Florian Müller,GER,Freiburg,Bundesliga,2020,22.0,1997.0,31.0,0,0,0,0,0,0,3,0.0,3,1,0,1,2,2,10,1,GK,20-24,Goalkeeper,Germany,Europe
1821,Sebastian Müller,GER,Arminia,Bundesliga,2020,19.0,2001.0,0.0,0,0,0,0,0,0,0,,0,0,0,0,0,0,0,0,"MF,DF",Under 20,Midfielder,Germany,Europe
1822,Thomas Müller,GER,Bayern Munich,Bundesliga,2020,30.0,1989.0,29.7,49,22,11,23,15,24,73,32.9,49,43,3,40,21,70,18,1,MF,30-34,Midfielder,Germany,Europe
1823,Joel Mumbongo,SWE,Burnley,Premier League,2020,21.0,1999.0,0.4,0,0,0,0,0,0,0,,0,1,0,1,0,0,0,0,FW,20-24,Forward,Sweden,Europe
1824,Marshall Munetsi,ZIM,Reims,Ligue 1,2020,24.0,1996.0,21.4,35,19,19,14,2,21,41,51.2,20,33,25,8,57,92,85,3,"MF,DF",20-24,Midfielder,Zimbabwe,Africa
1828,Luis Muriel,COL,Atalanta,Serie A,2020,29.0,1991.0,16.0,20,9,4,8,8,9,26,34.6,17,17,0,17,7,27,4,0,FW,25-29,Forward,Colombia,South America
1829,Jeison Murillo,COL,Celta Vigo,La Liga,2020,28.0,1992.0,30.0,45,21,35,9,1,24,44,54.5,20,29,17,12,36,81,100,2,DF,25-29,Defender,Colombia,South America
1831,Jacob Murphy,ENG,Newcastle Utd,Premier League,2020,25.0,1995.0,18.1,39,24,25,12,2,24,49,49.0,25,27,3,24,14,53,29,0,"DF,MF",25-29,Defender,England,Europe
1832,Nicola Murru,ITA,Torino,Serie A,2020,25.0,1994.0,6.3,9,6,1,5,3,3,5,60.0,2,11,1,10,12,21,24,0,DF,25-29,Defender,Italy,Europe
1833,Petar Musa,CRO,Union Berlin,Bundesliga,2020,22.0,1998.0,7.9,12,8,3,6,3,4,8,50.0,4,10,0,10,4,16,5,0,FW,20-24,Forward,Croatia,Europe
1834,Mateo Musacchio,ARG,Lazio,Serie A,2020,29.0,1990.0,2.5,1,1,1,0,0,0,0,,0,5,2,3,2,3,5,0,DF,25-29,Defender,Argentina,South America
1835,Mateo Musacchio,ARG,Milan,Serie A,2020,29.0,1990.0,0.4,2,1,2,0,0,2,3,66.7,1,1,0,1,3,5,0,0,DF,25-29,Defender,Argentina,South America
1836,Yunus Musah,USA,Valencia,La Liga,2020,17.0,2002.0,17.0,21,18,12,3,6,8,24,33.3,16,20,0,20,15,36,12,1,MF,Under 20,Midfielder,United States,North America
1837,Jamal Musiala,GER,Bayern Munich,Bundesliga,2020,17.0,2003.0,9.8,20,12,5,7,8,7,22,31.8,15,17,2,15,14,34,3,0,"FW,MF",Under 20,Forward,Germany,Europe
1838,Juan Musso,ARG,Udinese,Serie A,2020,26.0,1994.0,35.0,1,1,1,0,0,1,1,100.0,0,0,0,0,1,2,8,1,GK,25-29,Goalkeeper,Argentina,South America
1839,Shkodran Mustafi,GER,Arsenal,Premier League,2020,28.0,1992.0,0.5,1,1,1,0,0,1,1,100.0,0,1,0,1,0,1,3,0,DF,25-29,Defender,Germany,Europe
1840,Shkodran Mustafi,GER,Schalke 04,Bundesliga,2020,28.0,1992.0,11.5,16,5,15,1,0,3,12,25.0,9,20,15,5,32,48,76,1,DF,25-29,Defender,Germany,Europe
1841,Yoshinori Mutō,JPN,Eibar,La Liga,2020,28.0,1992.0,12.5,12,7,1,4,7,3,8,37.5,5,5,0,5,3,15,2,0,"FW,MF",25-29,Forward,Japan,Asia
1842,Phillipp Mwene,AUT,Mainz 05,Bundesliga,2020,26.0,1994.0,18.6,36,23,21,11,4,19,38,50.0,19,26,3,23,24,60,33,0,"DF,MF",25-29,Defender,Austria,Europe
1843,Joakim Mæhle,DEN,Atalanta,Serie A,2020,23.0,1997.0,13.5,18,10,7,5,6,8,19,42.1,11,17,2,15,11,29,5,0,DF,20-24,Defender,Denmark,Europe
1844,Obite N'Dicka,CIV,Eint Frankfurt,Bundesliga,2020,20.0,1999.0,22.7,31,23,16,15,0,16,28,57.1,12,27,6,21,47,78,85,0,DF,20-24,Defender,Ivory Coast,Africa
1845,Kévin N'Doram,FRA,Metz,Ligue 1,2020,24.0,1996.0,3.4,3,2,0,3,0,1,3,33.3,2,0,0,0,6,9,2,0,MF,20-24,Midfielder,France,Europe
1846,Stanley N'Soki,FRA,Nice,Ligue 1,2020,21.0,1999.0,13.8,27,19,15,9,3,13,22,59.1,9,17,4,13,26,53,38,2,DF,20-24,Defender,France,Europe
1849,Yuto Nagatomo,JPN,Marseille,Ligue 1,2020,33.0,1986.0,17.7,23,16,12,8,3,9,18,50.0,9,14,3,11,29,52,43,0,DF,30-34,Defender,Japan,Asia
1850,Kenny Nagera,FRA,Paris S-G,Ligue 1,2020,18.0,2002.0,0.0,0,0,0,0,0,0,0,,0,0,0,0,0,0,0,0,FW,Under 20,Forward,France,Europe
1851,Radja Nainggolan,BEL,Cagliari,Serie A,2020,32.0,1988.0,20.5,41,26,22,14,5,19,34,55.9,15,18,0,18,15,56,15,1,MF,30-34,Midfielder,Belgium,Europe
1852,Radja Nainggolan,BEL,Inter,Serie A,2020,32.0,1988.0,0.5,0,0,0,0,0,0,0,,0,0,0,0,1,1,0,0,MF,30-34,Midfielder,Belgium,Europe
1853,Marvelous Nakamba,ZIM,Aston Villa,Premier League,2020,26.0,1994.0,8.3,22,14,10,11,1,7,12,58.3,5,16,5,11,17,39,9,1,MF,25-29,Midfielder,Zimbabwe,Africa
1854,Nahitan Nández,URU,Cagliari,Serie A,2020,24.0,1995.0,30.4,56,28,23,23,10,25,68,36.8,43,26,4,22,23,79,49,0,"MF,DF",20-24,Midfielder,Uruguay,South America
1856,Paul Nardi,FRA,Lorient,Ligue 1,2020,26.0,1994.0,23.0,0,0,0,0,0,0,1,0.0,1,1,0,1,0,0,15,2,GK,25-29,Goalkeeper,France,Europe
1861,Keylor Navas,CRC,Paris S-G,Ligue 1,2020,33.0,1986.0,28.0,0,0,0,0,0,0,0,,0,0,0,0,0,0,10,0,GK,30-34,Goalkeeper,Costa Rica,North America
1863,Papa Ndiaga Yade,MTN,Metz,Ligue 1,2020,20.0,2000.0,11.1,15,8,9,2,4,7,20,35.0,13,9,0,9,4,19,6,0,"FW,MF",20-24,Forward,Mauritania,Africa
1864,Iliman Ndiaye,SEN,Sheffield Utd,Premier League,2020,20.0,2000.0,0.1,1,1,0,1,0,1,1,100.0,0,0,0,0,0,1,0,0,MF,20-24,Midfielder,Senegal,Africa
1865,Wilfred Ndidi,NGA,Leicester City,Premier League,2020,23.0,1996.0,24.2,96,63,45,44,7,26,66,39.4,40,38,11,27,61,157,55,0,"MF,DF",20-24,Midfielder,Nigeria,Africa
1866,Bridge Ndilu,FRA,Nantes,Ligue 1,2020,20.0,2000.0,0.5,0,0,0,0,0,0,2,0.0,2,2,0,2,0,0,0,0,"FW,MF",20-24,Forward,France,Europe
1867,Tanguy Ndombele,FRA,Tottenham,Premier League,2020,23.0,1996.0,23.2,41,20,11,21,9,18,44,40.9,26,28,4,24,19,60,15,0,MF,20-24,Midfielder,France,Europe
1868,Dan Ndoye,SUI,Nice,Ligue 1,2020,19.0,2000.0,6.1,7,6,3,4,0,1,8,12.5,7,4,0,4,7,14,4,0,"FW,MF",Under 20,Forward,Switzerland,Europe
1869,Paul Nebel,GER,Mainz 05,Bundesliga,2020,17.0,2002.0,0.6,1,1,0,1,0,0,1,0.0,1,0,0,0,2,3,0,0,"MF,FW",Under 20,Midfielder,Germany,Europe
1871,Reiss Nelson,ENG,Arsenal,Premier League,2020,20.0,1999.0,0.8,1,0,0,0,1,0,0,,0,0,0,0,1,2,1,0,"FW,MF",20-24,Forward,England,Europe
1872,Ilija Nestorovski,MKD,Udinese,Serie A,2020,30.0,1990.0,7.8,6,4,2,3,1,2,13,15.4,11,5,0,5,1,7,7,0,"FW,MF",30-34,Forward,North Macedonia,Europe
1873,Neto,BRA,Barcelona,La Liga,2020,31.0,1989.0,7.0,0,0,0,0,0,0,1,0.0,1,0,0,0,0,0,3,1,GK,30-34,Goalkeeper,Brazil,South America
1873,Neto,BRA,Barcelona,La Liga,2020,31.0,1989.0,7.0,0,0,0,0,0,0,1,0.0,1,0,0,0,0,0,3,1,GK,30-34,Goalkeeper,Brazil,South America
1873,Neto,BRA,Barcelona,La Liga,2020,31.0,1989.0,7.0,0,0,0,0,0,0,1,0.0,1,0,0,0,0,0,3,1,GK,30-34,Goalkeeper,Brazil,South America
1873,Neto,BRA,Barcelona,La Liga,2020,31.0,1989.0,7.0,0,0,0,0,0,0,1,0.0,1,0,0,0,0,0,3,1,GK,30-34,Goalkeeper,Brazil,South America
1873,Neto,BRA,Barcelona,La Liga,2020,31.0,1989.0,7.0,0,0,0,0,0,0,1,0.0,1,0,0,0,0,0,3,1,GK,30-34,Goalkeeper,Brazil,South America
1873,Neto,BRA,Barcelona,La Liga,2020,31.0,1989.0,7.0,0,0,0,0,0,0,1,0.0,1,0,0,0,0,0,3,1,GK,30-34,Goalkeeper,Brazil,South America
1873,Neto,BRA,Barcelona,La Liga,2020,31.0,1989.0,7.0,0,0,0,0,0,0,1,0.0,1,0,0,0,0,0,3,1,GK,30-34,Goalkeeper,Brazil,South America
1873,Neto,BRA,Barcelona,La Liga,2020,31.0,1989.0,7.0,0,0,0,0,0,0,1,0.0,1,0,0,0,0,0,3,1,GK,30-34,Goalkeeper,Brazil,South America
1873,Neto,BRA,Barcelona,La Liga,2020,31.0,1989.0,7.0,0,0,0,0,0,0,1,0.0,1,0,0,0,0,0,3,1,GK,30-34,Goalkeeper,Brazil,South America
1874,Pedro Neto,POR,Wolves,Premier League,2020,20.0,2000.0,28.3,16,9,4,6,6,6,28,21.4,22,18,2,16,31,47,8,0,"FW,MF",20-24,Forward,Portugal,Europe
1875,Luca Netz,GER,Hertha BSC,Bundesliga,2020,17.0,2003.0,3.4,14,8,12,2,0,6,17,35.3,11,3,0,3,6,20,8,0,"DF,FW",Under 20,Defender,Germany,Europe
1876,Manuel Neuer,GER,Bayern Munich,Bundesliga,2020,34.0,1986.0,33.0,0,0,0,0,0,0,1,0.0,1,0,0,0,2,2,12,3,GK,30-34,Goalkeeper,Germany,Europe
1877,Florian Neuhaus,GER,Gladbach,Bundesliga,2020,23.0,1997.0,29.1,48,28,19,26,3,19,63,30.2,44,35,7,28,50,98,20,1,MF,20-24,Midfielder,Germany,Europe
1879,Rúben Neves,POR,Wolves,Premier League,2020,23.0,1997.0,29.7,86,46,42,38,6,36,88,40.9,52,55,11,44,65,151,46,2,MF,20-24,Midfielder,Portugal,Europe
1880,Neymar,BRA,Paris S-G,Ligue 1,2020,28.0,1992.0,15.7,14,11,1,6,7,8,37,21.6,29,8,0,8,9,23,0,0,"MF,FW",25-29,Midfielder,Brazil,South America
1881,Yvan Neyou,CMR,Saint-Étienne,Ligue 1,2020,23.0,1997.0,27.1,58,31,24,33,1,25,60,41.7,35,34,5,29,31,89,13,1,MF,20-24,Midfielder,Cameroon,Africa
1882,Jessic Ngankam,GER,Hertha BSC,Bundesliga,2020,20.0,2000.0,3.3,5,2,1,2,2,1,3,33.3,2,6,1,5,0,5,1,0,FW,20-24,Forward,Germany,Europe
1883,Muzinga Ngonda,COD,Dijon,Ligue 1,2020,25.0,1994.0,25.6,59,40,37,21,1,30,50,60.0,20,28,3,25,72,131,58,0,DF,25-29,Defender,DR Congo,Africa
1884,Ahmad Ngouyamsa,CHA,Dijon,Ligue 1,2020,19.0,2000.0,1.7,6,4,5,1,0,4,8,50.0,4,2,1,1,2,8,8,0,DF,Under 20,Defender,Chad,Africa
1885,Opa Nguette,SEN,Metz,Ligue 1,2020,26.0,1994.0,12.6,15,8,2,8,5,3,10,30.0,7,14,2,12,1,16,1,0,"FW,MF",25-29,Forward,Senegal,Africa
1886,Moussa Niakhate,SEN,Mainz 05,Bundesliga,2020,24.0,1996.0,31.8,42,22,28,13,1,14,29,48.3,15,31,15,16,49,91,79,0,DF,20-24,Defender,Senegal,Africa
1887,Ibrahima Niane,SEN,Metz,Ligue 1,2020,21.0,1999.0,7.4,1,1,0,0,1,1,2,50.0,1,3,0,3,0,1,8,0,FW,20-24,Forward,Senegal,Africa
1888,M'Baye Niang,SEN,Rennes,Ligue 1,2020,25.0,1994.0,4.7,3,2,2,1,0,0,0,,0,2,0,2,1,4,2,0,FW,25-29,Forward,Senegal,Africa
1889,Mamor Niang,SEN,Getafe,La Liga,2020,18.0,2002.0,0.2,1,1,0,1,0,0,0,,0,1,0,1,0,1,0,0,"MF,FW",Under 20,Midfielder,Senegal,Africa
1890,Tanguy Nianzou,FRA,Bayern Munich,Bundesliga,2020,18.0,2002.0,1.3,3,1,3,0,0,1,1,100.0,0,0,0,0,3,6,1,0,"DF,FW",Under 20,Defender,France,Europe
1891,Florian Niederlechner,GER,Augsburg,Bundesliga,2020,29.0,1990.0,19.3,7,5,1,4,2,0,10,0.0,10,8,3,5,10,17,18,0,FW,25-29,Forward,Germany,Europe
1894,Joakim Nilsson,SWE,Arminia,Bundesliga,2020,26.0,1994.0,24.0,36,24,23,12,1,14,23,60.9,9,29,22,7,39,75,111,0,DF,25-29,Defender,Sweden,Europe
1895,Casimir Ninga,CHA,Angers,Ligue 1,2020,27.0,1993.0,0.3,0,0,0,0,0,0,0,,0,0,0,0,0,0,1,0,FW,25-29,Forward,Chad,Africa
1898,Eddie Nketiah,ENG,Arsenal,Premier League,2020,21.0,1999.0,4.7,3,1,0,2,1,0,2,0.0,2,6,0,6,0,3,5,0,FW,20-24,Forward,England,Europe
1899,Nicolas Nkoulou,CMR,Torino,Serie A,2020,30.0,1990.0,15.1,14,9,11,3,0,7,12,58.3,5,28,14,14,33,47,71,1,DF,30-34,Defender,Cameroon,Africa
1900,Niels Nkounkou,FRA,Everton,Premier League,2020,19.0,2000.0,0.9,4,3,1,2,1,3,8,37.5,5,4,0,4,0,4,4,0,"DF,FW",Under 20,Defender,France,Europe
1901,Christopher Nkunku,FRA,RB Leipzig,Bundesliga,2020,22.0,1997.0,21.0,16,11,3,7,6,8,18,44.4,10,27,1,26,9,25,14,0,"FW,MF",20-24,Forward,France,Europe
1902,Dan Nlundulu,ENG,Southampton,Premier League,2020,21.0,1999.0,1.2,0,0,0,0,0,0,1,0.0,1,2,0,2,0,0,2,0,"FW,MF",20-24,Forward,England,Europe
1903,Mark Noble,ENG,West Ham,Premier League,2020,33.0,1987.0,7.9,8,4,2,5,1,4,14,28.6,10,7,3,4,13,21,3,0,MF,30-34,Midfielder,England,Europe
1905,Arnaud Nordin,FRA,Saint-Étienne,Ligue 1,2020,22.0,1998.0,19.7,14,8,5,5,4,6,21,28.6,15,13,2,11,9,23,10,0,"MF,FW",20-24,Midfielder,France,Europe
1907,Will Norris,ENG,Burnley,Premier League,2020,26.0,1993.0,2.0,0,0,0,0,0,0,0,,0,0,0,0,0,0,0,0,GK,25-29,Goalkeeper,England,Europe
1909,Olivier Ntcham,CMR,Marseille,Ligue 1,2020,24.0,1996.0,1.3,1,0,0,1,0,1,3,33.3,2,3,1,2,2,3,3,0,MF,20-24,Midfielder,Cameroon,Africa
1910,Alexander Nübel,GER,Bayern Munich,Bundesliga,2020,23.0,1996.0,1.0,0,0,0,0,0,0,0,,0,0,0,0,0,0,1,0,GK,20-24,Goalkeeper,Germany,Europe
1911,Kasim Nuhu,GHA,Hoffenheim,Bundesliga,2020,25.0,1995.0,11.0,13,7,9,4,0,6,10,60.0,4,8,3,5,15,28,38,0,DF,25-29,Defender,Ghana,Africa
1913,Bram Nuytinck,NED,Udinese,Serie A,2020,30.0,1990.0,18.2,21,15,10,9,2,13,20,65.0,7,30,17,13,25,46,77,0,DF,30-34,Defender,Netherlands,Europe
1914,Kelechi Nwakali,NGA,Huesca,La Liga,2020,22.0,1998.0,1.6,4,3,1,2,1,0,4,0.0,4,1,0,1,1,5,1,0,"MF,FW",20-24,Midfielder,Nigeria,Africa
1915,Simeon Nwankwo,NGA,Crotone,Serie A,2020,28.0,1992.0,32.7,9,2,2,6,1,3,22,13.6,19,21,5,16,6,15,51,0,FW,25-29,Forward,Nigeria,Africa
1916,Gerzino Nyamsi,FRA,Rennes,Ligue 1,2020,23.0,1997.0,9.7,12,10,2,8,2,4,6,66.7,2,8,5,3,10,22,32,1,DF,20-24,Defender,France,Europe
1917,Allan Nyom,CMR,Getafe,La Liga,2020,32.0,1988.0,25.8,38,23,14,19,5,15,30,50.0,15,16,2,14,22,60,42,0,"MF,DF",30-34,Midfielder,Cameroon,Africa
1918,M'Bala Nzola,ANG,Spezia,Serie A,2020,23.0,1996.0,21.1,12,5,2,6,4,4,7,57.1,3,15,1,14,3,15,20,0,FW,20-24,Forward,Angola,Africa
1919,Steven Nzonzi,FRA,Rennes,Ligue 1,2020,31.0,1988.0,32.3,34,16,15,16,3,12,31,38.7,19,24,10,14,16,50,26,0,MF,30-34,Midfielder,France,Europe
1920,Jack O'Connell,ENG,Sheffield Utd,Premier League,2020,26.0,1994.0,2.0,3,1,1,1,1,0,1,0.0,1,4,3,1,2,5,7,0,DF,25-29,Defender,England,Europe
1921,Dara O'Shea,IRL,West Brom,Premier League,2020,21.0,1999.0,23.4,45,25,30,13,2,21,45,46.7,24,32,17,15,45,90,108,0,DF,20-24,Defender,Republic of Ireland,Europe
1922,Michael Obafemi,IRL,Southampton,Premier League,2020,20.0,2000.0,0.7,1,0,0,1,0,0,1,0.0,1,1,0,1,0,1,0,0,FW,20-24,Forward,Republic of Ireland,Europe
1923,Pedro Obiang,EQG,Sassuolo,Serie A,2020,28.0,1992.0,16.3,35,22,17,15,3,12,35,34.3,23,26,7,19,22,57,27,0,MF,25-29,Midfielder,Equatorial Guinea,Africa
1925,Lucas Ocampos,ARG,Sevilla,La Liga,2020,26.0,1994.0,29.2,36,24,12,16,8,13,37,35.1,24,33,1,32,19,55,30,1,FW,25-29,Forward,Argentina,South America
1926,Bastian Oczipka,GER,Schalke 04,Bundesliga,2020,31.0,1989.0,21.4,33,20,22,10,1,7,21,33.3,14,22,4,18,24,57,41,0,"DF,FW",30-34,Defender,Germany,Europe
1927,Brian Oddei,ITA,Sassuolo,Serie A,2020,17.0,2002.0,0.5,2,1,1,1,0,2,3,66.7,1,1,0,1,0,2,1,0,"FW,MF",Under 20,Forward,Italy,Europe
1928,Denis Odoi,GHA,Fulham,Premier League,2020,32.0,1988.0,3.0,3,3,2,1,0,1,4,25.0,3,3,1,2,5,8,5,0,DF,30-34,Defender,Ghana,Africa
1930,Angelo Ogbonna,ITA,West Ham,Premier League,2020,32.0,1988.0,27.7,26,13,20,5,1,9,17,52.9,8,25,11,14,30,56,119,0,DF,30-34,Defender,Italy,Europe
1931,Stefano Okaka,ITA,Udinese,Serie A,2020,30.0,1989.0,16.5,10,7,2,5,3,2,10,20.0,8,7,1,6,2,12,19,0,FW,30-34,Forward,Italy,Europe
1932,Shinji Okazaki,JPN,Huesca,La Liga,2020,34.0,1986.0,12.5,7,5,5,0,2,0,5,0.0,5,5,0,5,4,11,6,0,"FW,MF",30-34,Forward,Japan,Asia
1933,Masaya Okugawa,JPN,Arminia,Bundesliga,2020,24.0,1996.0,10.2,17,8,5,11,1,6,14,42.9,8,17,2,15,8,25,5,0,MF,20-24,Midfielder,Japan,Asia
1934,Lucas Olaza,URU,Valladolid,La Liga,2020,26.0,1994.0,14.0,20,9,11,7,2,9,17,52.9,8,15,7,8,15,35,38,0,DF,25-29,Defender,Uruguay,South America
1935,Lucas Olaza,URU,Celta Vigo,La Liga,2020,26.0,1994.0,17.9,25,16,12,12,1,10,18,55.6,8,15,1,14,24,49,34,0,DF,25-29,Defender,Uruguay,South America
1936,Christian Oliva,URU,Cagliari,Serie A,2020,24.0,1996.0,4.3,10,4,6,3,1,6,17,35.3,11,11,1,10,8,18,7,0,MF,20-24,Midfielder,Uruguay,South America
1937,Christian Oliva,URU,Valencia,La Liga,2020,24.0,1996.0,2.2,2,0,1,1,0,1,6,16.7,5,1,0,1,6,8,0,0,MF,20-24,Midfielder,Uruguay,South America
1939,Paulo Oliveira,POR,Eibar,La Liga,2020,28.0,1992.0,29.3,42,21,32,8,2,19,36,52.8,17,39,14,25,59,101,112,0,DF,25-29,Defender,Portugal,Europe
1940,Mathías Olivera,URU,Getafe,La Liga,2020,22.0,1997.0,29.0,61,33,31,21,9,32,56,57.1,24,33,3,30,31,92,55,0,DF,20-24,Defender,Uruguay,South America
1941,Maximiliano Olivera,URU,Fiorentina,Serie A,2020,28.0,1992.0,1.0,2,0,1,1,0,1,1,100.0,0,3,1,2,0,2,8,0,DF,25-29,Defender,Uruguay,South America
1943,Robin Olsen,SWE,Everton,Premier League,2020,30.0,1990.0,7.0,0,0,0,0,0,0,0,,0,0,0,0,0,0,4,1,GK,30-34,Goalkeeper,Sweden,Europe
1944,Jonas Omlin,SUI,Montpellier,Ligue 1,2020,26.0,1994.0,29.7,1,1,1,0,0,1,4,25.0,3,0,0,0,0,1,9,1,GK,25-29,Goalkeeper,Switzerland,Europe
1945,Jérôme Onguéné,CMR,Genoa,Serie A,2020,22.0,1997.0,2.0,2,1,2,0,0,2,7,28.6,5,2,0,2,2,4,8,0,DF,20-24,Defender,Cameroon,Africa
1946,Karim Onisiwo,AUT,Mainz 05,Bundesliga,2020,28.0,1992.0,20.5,31,20,7,15,9,14,23,60.9,9,20,1,19,5,36,12,0,"FW,MF",25-29,Forward,Austria,Europe
1947,Josh Onomah,ENG,Fulham,Premier League,2020,23.0,1997.0,4.2,11,8,1,6,4,0,5,0.0,5,4,2,2,2,13,1,0,MF,20-24,Midfielder,England,Europe
1949,Henry Onyekuru,NGA,Monaco,Ligue 1,2020,23.0,1997.0,1.6,1,0,1,0,0,1,4,25.0,3,1,0,1,0,1,0,0,FW,20-24,Forward,Nigeria,Africa
1950,Willi Orban,HUN,RB Leipzig,Bundesliga,2020,27.0,1992.0,26.3,40,26,19,15,6,23,37,62.2,14,29,20,9,40,80,74,0,DF,25-29,Defender,Hungary,Europe
1951,Fabián Orellana,CHI,Valladolid,La Liga,2020,34.0,1986.0,23.8,33,19,12,14,7,12,55,21.8,43,18,0,18,15,48,9,0,"MF,FW",30-34,Midfielder,Chile,South America
1952,Divock Origi,BEL,Liverpool,Premier League,2020,25.0,1995.0,2.1,3,2,0,2,1,1,3,33.3,2,5,1,4,1,4,2,0,FW,25-29,Forward,Belgium,Europe
1953,Riccardo Orsolini,ITA,Bologna,Serie A,2020,23.0,1997.0,19.5,37,18,13,12,12,16,39,41.0,23,22,3,19,10,47,22,0,"FW,MF",20-24,Forward,Italy,Europe
1954,Stefan Ortega,GER,Arminia,Bundesliga,2020,27.0,1992.0,34.0,2,1,2,0,0,2,6,33.3,4,0,0,0,0,2,12,3,GK,25-29,Goalkeeper,Germany,Europe
1955,Yuya Osako,JPN,Werder Bremen,Bundesliga,2020,30.0,1990.0,8.5,12,8,2,5,5,2,9,22.2,7,6,1,5,5,17,7,0,"MF,FW",30-34,Midfielder,Japan,Asia
1956,Ben Osborn,ENG,Sheffield Utd,Premier League,2020,25.0,1994.0,17.8,33,18,15,10,8,13,40,32.5,27,20,3,17,12,45,17,0,"MF,DF",25-29,Midfielder,England,Europe
1957,Victor Osimhen,NGA,Napoli,Serie A,2020,21.0,1998.0,17.5,22,15,2,6,14,3,15,20.0,12,6,0,6,7,29,10,0,FW,20-24,Forward,Nigeria,Africa
1958,Yordan Osorio,VEN,Parma,Serie A,2020,26.0,1994.0,20.1,22,14,13,9,0,9,24,37.5,15,30,18,12,53,75,77,1,DF,25-29,Defender,Venezuela,South America
1959,David Ospina,COL,Napoli,Serie A,2020,31.0,1988.0,16.0,0,0,0,0,0,0,0,,0,0,0,0,0,0,4,0,GK,30-34,Goalkeeper,Colombia,South America
1960,Owen Otasowie,USA,Wolves,Premier League,2020,19.0,2001.0,2.1,5,5,3,2,0,1,2,50.0,1,1,1,0,3,8,4,0,"MF,FW",Under 20,Midfielder,United States,North America
1961,Otávio,BRA,Bordeaux,Ligue 1,2020,26.0,1994.0,17.3,54,31,33,19,2,26,55,47.3,29,20,5,15,26,80,36,0,MF,25-29,Midfielder,Brazil,South America
1961,Otávio,BRA,Bordeaux,Ligue 1,2020,26.0,1994.0,17.3,54,31,33,19,2,26,55,47.3,29,20,5,15,26,80,36,0,MF,25-29,Midfielder,Brazil,South America
1961,Otávio,BRA,Bordeaux,Ligue 1,2020,26.0,1994.0,17.3,54,31,33,19,2,26,55,47.3,29,20,5,15,26,80,36,0,MF,25-29,Midfielder,Brazil,South America
1961,Otávio,BRA,Bordeaux,Ligue 1,2020,26.0,1994.0,17.3,54,31,33,19,2,26,55,47.3,29,20,5,15,26,80,36,0,MF,25-29,Midfielder,Brazil,South America
1961,Otávio,BRA,Bordeaux,Ligue 1,2020,26.0,1994.0,17.3,54,31,33,19,2,26,55,47.3,29,20,5,15,26,80,36,0,MF,25-29,Midfielder,Brazil,South America
1961,Otávio,BRA,Bordeaux,Ligue 1,2020,26.0,1994.0,17.3,54,31,33,19,2,26,55,47.3,29,20,5,15,26,80,36,0,MF,25-29,Midfielder,Brazil,South America
1961,Otávio,BRA,Bordeaux,Ligue 1,2020,26.0,1994.0,17.3,54,31,33,19,2,26,55,47.3,29,20,5,15,26,80,36,0,MF,25-29,Midfielder,Brazil,South America
1961,Otávio,BRA,Bordeaux,Ligue 1,2020,26.0,1994.0,17.3,54,31,33,19,2,26,55,47.3,29,20,5,15,26,80,36,0,MF,25-29,Midfielder,Brazil,South America
1961,Otávio,BRA,Bordeaux,Ligue 1,2020,26.0,1994.0,17.3,54,31,33,19,2,26,55,47.3,29,20,5,15,26,80,36,0,MF,25-29,Midfielder,Brazil,South America
1962,Paulo Otávio,BRA,Wolfsburg,Bundesliga,2020,25.0,1994.0,19.3,60,40,32,22,6,34,62,54.8,28,51,7,44,42,102,59,0,DF,25-29,Defender,Brazil,South America
1963,Remi Oudin,FRA,Bordeaux,Ligue 1,2020,23.0,1996.0,26.9,34,16,22,7,5,15,36,41.7,21,22,2,20,51,85,40,1,"FW,MF",20-24,Forward,France,Europe
1964,Alexandre Oukidja,ALG,Metz,Ligue 1,2020,32.0,1988.0,34.0,0,0,0,0,0,0,1,0.0,1,1,0,1,0,0,17,3,GK,30-34,Goalkeeper,Algeria,Africa
1965,Zinédine Ould Khaled,FRA,Angers,Ligue 1,2020,20.0,2000.0,0.4,0,0,0,0,0,0,0,,0,0,0,0,1,1,0,0,MF,20-24,Midfielder,France,Europe
1966,Adam Ounas,ALG,Crotone,Serie A,2020,23.0,1996.0,13.3,9,4,4,4,1,0,7,0.0,7,12,1,11,3,12,4,0,"FW,MF",20-24,Forward,Algeria,Africa
1967,Adam Ounas,ALG,Cagliari,Serie A,2020,23.0,1996.0,3.4,3,2,3,0,0,0,11,0.0,11,5,0,5,3,6,0,0,"MF,FW",20-24,Midfielder,Algeria,Africa
1968,Thomas Ouwejan,NED,Udinese,Serie A,2020,23.0,1996.0,4.6,4,1,0,3,1,2,9,22.2,7,4,0,4,5,9,6,0,DF,20-24,Defender,Netherlands,Europe
1969,Reece Oxford,ENG,Augsburg,Bundesliga,2020,21.0,1998.0,15.1,26,18,15,11,0,10,17,58.8,7,28,22,6,29,55,89,0,DF,20-24,Defender,England,Europe
1970,Alex Oxlade-Chamberlain,ENG,Liverpool,Premier League,2020,26.0,1993.0,2.8,4,0,0,3,1,0,2,0.0,2,1,0,1,2,6,0,0,"MF,FW",25-29,Midfielder,England,Europe
1972,Ambroise Oyongo,CMR,Montpellier,Ligue 1,2020,29.0,1991.0,6.2,13,6,10,3,0,9,15,60.0,6,3,2,1,8,21,26,1,DF,25-29,Defender,Cameroon,Africa
1973,Salih Özcan,TUR,Köln,Bundesliga,2020,22.0,1998.0,15.2,21,13,11,10,0,12,33,36.4,21,11,2,9,20,41,14,1,MF,20-24,Midfielder,Turkey,Asia
1974,Levin Öztunalı,GER,Mainz 05,Bundesliga,2020,24.0,1996.0,8.4,24,18,14,8,2,8,17,47.1,9,15,0,15,15,39,16,0,"DF,FW",20-24,Defender,Germany,Europe
1975,Pablo,BRA,Bordeaux,Ligue 1,2020,29.0,1991.0,12.0,17,11,13,4,0,8,14,57.1,6,17,12,5,25,42,46,1,DF,25-29,Defender,Brazil,South America
1975,Pablo,BRA,Bordeaux,Ligue 1,2020,29.0,1991.0,12.0,17,11,13,4,0,8,14,57.1,6,17,12,5,25,42,46,1,DF,25-29,Defender,Brazil,South America
1975,Pablo,BRA,Bordeaux,Ligue 1,2020,29.0,1991.0,12.0,17,11,13,4,0,8,14,57.1,6,17,12,5,25,42,46,1,DF,25-29,Defender,Brazil,South America
1975,Pablo,BRA,Bordeaux,Ligue 1,2020,29.0,1991.0,12.0,17,11,13,4,0,8,14,57.1,6,17,12,5,25,42,46,1,DF,25-29,Defender,Brazil,South America
1975,Pablo,BRA,Bordeaux,Ligue 1,2020,29.0,1991.0,12.0,17,11,13,4,0,8,14,57.1,6,17,12,5,25,42,46,1,DF,25-29,Defender,Brazil,South America
1975,Pablo,BRA,Bordeaux,Ligue 1,2020,29.0,1991.0,12.0,17,11,13,4,0,8,14,57.1,6,17,12,5,25,42,46,1,DF,25-29,Defender,Brazil,South America
1975,Pablo,BRA,Bordeaux,Ligue 1,2020,29.0,1991.0,12.0,17,11,13,4,0,8,14,57.1,6,17,12,5,25,42,46,1,DF,25-29,Defender,Brazil,South America
1975,Pablo,BRA,Bordeaux,Ligue 1,2020,29.0,1991.0,12.0,17,11,13,4,0,8,14,57.1,6,17,12,5,25,42,46,1,DF,25-29,Defender,Brazil,South America
1975,Pablo,BRA,Bordeaux,Ligue 1,2020,29.0,1991.0,12.0,17,11,13,4,0,8,14,57.1,6,17,12,5,25,42,46,1,DF,25-29,Defender,Brazil,South America
1978,Gonçalo Paciência,POR,Schalke 04,Bundesliga,2020,25.0,1994.0,8.3,8,3,4,1,3,4,16,25.0,12,4,1,3,1,9,3,0,FW,25-29,Forward,Portugal,Europe
1979,Daniele Padelli,ITA,Inter,Serie A,2020,34.0,1985.0,0.5,0,0,0,0,0,0,0,,0,0,0,0,0,0,0,0,GK,30-34,Goalkeeper,Italy,Europe
1980,Mattia Pagliuca,ITA,Bologna,Serie A,2020,18.0,2002.0,0.1,0,0,0,0,0,0,0,,0,0,0,0,1,1,0,0,MF,Under 20,Midfielder,Italy,Europe
1981,Vincent Pajot,FRA,Metz,Ligue 1,2020,29.0,1990.0,10.2,35,20,19,11,5,10,18,55.6,8,9,2,7,42,77,11,0,MF,25-29,Midfielder,France,Europe
1982,Rodrigo Palacio,ARG,Bologna,Serie A,2020,38.0,1982.0,27.8,13,6,2,3,8,1,15,6.7,14,18,0,18,7,20,29,0,FW,35-39,Forward,Argentina,South America
1983,Exequiel Palacios,ARG,Leverkusen,Bundesliga,2020,21.0,1998.0,6.4,31,17,12,16,3,17,30,56.7,13,13,0,13,12,43,7,0,MF,20-24,Midfielder,Argentina,South America
1984,Helibelton Palacios,COL,Elche,La Liga,2020,27.0,1993.0,8.3,20,10,16,3,1,8,13,61.5,5,9,1,8,5,25,21,0,DF,25-29,Defender,Colombia,South America
1985,Ante Palaversa,CRO,Getafe,La Liga,2020,20.0,2000.0,0.1,0,0,0,0,0,0,1,0.0,1,0,0,0,0,0,0,0,MF,20-24,Midfielder,Croatia,Europe
1986,Alberto Paleari,ITA,Genoa,Serie A,2020,27.0,1992.0,2.3,0,0,0,0,0,0,0,,0,0,0,0,0,0,1,0,GK,25-29,Goalkeeper,Italy,Europe
1987,Nicolas Pallois,FRA,Nantes,Ligue 1,2020,32.0,1987.0,30.8,58,36,42,14,2,38,72,52.8,34,44,20,24,37,95,155,1,DF,30-34,Defender,France,Europe
1988,Emerson Palmieri,ITA,Chelsea,Premier League,2020,25.0,1994.0,1.0,3,3,2,0,1,1,3,33.3,2,0,0,0,1,4,6,0,DF,25-29,Defender,Italy,Europe
1989,Antonio Palumbo,ITA,Sampdoria,Serie A,2020,23.0,1996.0,0.1,0,0,0,0,0,0,1,0.0,1,0,0,0,0,0,0,0,MF,20-24,Midfielder,Italy,Europe
1991,Goran Pandev,MKD,Genoa,Serie A,2020,37.0,1983.0,15.6,9,5,1,6,2,4,10,40.0,6,6,0,6,2,11,7,1,"FW,MF",35-39,Forward,North Macedonia,Europe
1992,Ivor Pandur,CRO,Hellas Verona,Serie A,2020,20.0,2000.0,3.7,0,0,0,0,0,0,0,,0,0,0,0,0,0,0,0,GK,20-24,Goalkeeper,Croatia,Europe
1993,Jonathan Panzo,ENG,Dijon,Ligue 1,2020,19.0,2000.0,20.0,17,12,13,4,0,8,11,72.7,3,27,13,14,59,76,91,2,DF,Under 20,Defender,England,Europe
1994,Merveille Papela,GER,Mainz 05,Bundesliga,2020,19.0,2001.0,0.0,0,0,0,0,0,0,1,0.0,1,0,0,0,0,0,0,0,DF,Under 20,Defender,Germany,Europe
1995,Lucas Paquetá,BRA,Lyon,Ligue 1,2020,22.0,1997.0,25.3,70,36,30,28,12,23,66,34.8,43,28,3,25,20,90,16,1,MF,20-24,Midfielder,Brazil,South America
1996,Gaëtan Paquiez,FRA,Nîmes,Ligue 1,2020,26.0,1994.0,11.6,21,12,12,7,2,12,29,41.4,17,10,3,7,16,37,28,0,DF,25-29,Defender,France,Europe
1998,Leandro Paredes,ARG,Paris S-G,Ligue 1,2020,26.0,1994.0,14.5,30,18,12,15,3,19,39,48.7,20,17,5,12,17,47,13,1,MF,25-29,Midfielder,Argentina,South America
2000,Vittorio Parigini,ITA,Genoa,Serie A,2020,24.0,1996.0,0.6,5,2,4,0,1,0,1,0.0,1,0,0,0,0,5,0,0,"MF,DF",20-24,Midfielder,Italy,Europe
2001,Marco Parolo,ITA,Lazio,Serie A,2020,35.0,1985.0,7.3,21,8,8,11,2,8,20,40.0,12,20,6,14,14,35,31,0,"DF,MF",35-39,Defender,Italy,Europe
2002,Thomas Partey,GHA,Arsenal,Premier League,2020,27.0,1993.0,17.0,44,21,16,24,4,24,56,42.9,32,17,5,12,23,67,18,0,MF,25-29,Midfielder,Ghana,Africa
2003,Thomas Partey,GHA,Atlético Madrid,La Liga,2020,27.0,1993.0,2.2,7,4,4,3,0,5,8,62.5,3,4,1,3,2,9,1,0,MF,25-29,Midfielder,Ghana,Africa
2004,Mario Pašalić,CRO,Atalanta,Serie A,2020,25.0,1995.0,12.5,26,15,5,17,4,12,19,63.2,7,12,1,11,8,34,6,0,MF,25-29,Midfielder,Croatia,Europe
2005,Felix Passlack,GER,Dortmund,Bundesliga,2020,22.0,1998.0,4.0,9,6,4,2,3,4,8,50.0,4,11,1,10,3,12,2,0,DF,20-24,Defender,Germany,Europe
2006,Christian Pastina,ITA,Benevento,Serie A,2020,19.0,2001.0,1.3,0,0,0,0,0,0,1,0.0,1,1,0,1,1,1,8,0,DF,Under 20,Defender,Italy,Europe
2007,Javier Pastore,ARG,Roma,Serie A,2020,31.0,1989.0,0.9,2,2,2,0,0,2,2,100.0,0,0,0,0,0,2,0,0,"MF,FW",30-34,Midfielder,Argentina,South America
2009,Rui Patrício,POR,Wolves,Premier League,2020,32.0,1988.0,37.0,0,0,0,0,0,0,1,0.0,1,0,0,0,1,1,3,3,GK,30-34,Goalkeeper,Portugal,Europe
2010,Paulinho,BRA,Leverkusen,Bundesliga,2020,20.0,2000.0,0.7,0,0,0,0,0,0,0,,0,0,0,0,0,0,0,0,FW,20-24,Forward,Brazil,South America
2010,Paulinho,BRA,Leverkusen,Bundesliga,2020,20.0,2000.0,0.7,0,0,0,0,0,0,0,,0,0,0,0,0,0,0,0,FW,20-24,Forward,Brazil,South America
2010,Paulinho,BRA,Leverkusen,Bundesliga,2020,20.0,2000.0,0.7,0,0,0,0,0,0,0,,0,0,0,0,0,0,0,0,FW,20-24,Forward,Brazil,South America
2010,Paulinho,BRA,Leverkusen,Bundesliga,2020,20.0,2000.0,0.7,0,0,0,0,0,0,0,,0,0,0,0,0,0,0,0,FW,20-24,Forward,Brazil,South America
2010,Paulinho,BRA,Leverkusen,Bundesliga,2020,20.0,2000.0,0.7,0,0,0,0,0,0,0,,0,0,0,0,0,0,0,0,FW,20-24,Forward,Brazil,South America
2010,Paulinho,BRA,Leverkusen,Bundesliga,2020,20.0,2000.0,0.7,0,0,0,0,0,0,0,,0,0,0,0,0,0,0,0,FW,20-24,Forward,Brazil,South America
2010,Paulinho,BRA,Leverkusen,Bundesliga,2020,20.0,2000.0,0.7,0,0,0,0,0,0,0,,0,0,0,0,0,0,0,0,FW,20-24,Forward,Brazil,South America
2010,Paulinho,BRA,Leverkusen,Bundesliga,2020,20.0,2000.0,0.7,0,0,0,0,0,0,0,,0,0,0,0,0,0,0,0,FW,20-24,Forward,Brazil,South America
2010,Paulinho,BRA,Leverkusen,Bundesliga,2020,20.0,2000.0,0.7,0,0,0,0,0,0,0,,0,0,0,0,0,0,0,0,FW,20-24,Forward,Brazil,South America
2010,Paulinho,BRA,Leverkusen,Bundesliga,2020,20.0,2000.0,0.7,0,0,0,0,0,0,0,,0,0,0,0,0,0,0,0,FW,20-24,Forward,Brazil,South America
2010,Paulinho,BRA,Leverkusen,Bundesliga,2020,20.0,2000.0,0.7,0,0,0,0,0,0,0,,0,0,0,0,0,0,0,0,FW,20-24,Forward,Brazil,South America
2010,Paulinho,BRA,Leverkusen,Bundesliga,2020,20.0,2000.0,0.7,0,0,0,0,0,0,0,,0,0,0,0,0,0,0,0,FW,20-24,Forward,Brazil,South America
2010,Paulinho,BRA,Leverkusen,Bundesliga,2020,20.0,2000.0,0.7,0,0,0,0,0,0,0,,0,0,0,0,0,0,0,0,FW,20-24,Forward,Brazil,South America
2010,Paulinho,BRA,Leverkusen,Bundesliga,2020,20.0,2000.0,0.7,0,0,0,0,0,0,0,,0,0,0,0,0,0,0,0,FW,20-24,Forward,Brazil,South America
2010,Paulinho,BRA,Leverkusen,Bundesliga,2020,20.0,2000.0,0.7,0,0,0,0,0,0,0,,0,0,0,0,0,0,0,0,FW,20-24,Forward,Brazil,South America
2010,Paulinho,BRA,Leverkusen,Bundesliga,2020,20.0,2000.0,0.7,0,0,0,0,0,0,0,,0,0,0,0,0,0,0,0,FW,20-24,Forward,Brazil,South America
2010,Paulinho,BRA,Leverkusen,Bundesliga,2020,20.0,2000.0,0.7,0,0,0,0,0,0,0,,0,0,0,0,0,0,0,0,FW,20-24,Forward,Brazil,South America
2010,Paulinho,BRA,Leverkusen,Bundesliga,2020,20.0,2000.0,0.7,0,0,0,0,0,0,0,,0,0,0,0,0,0,0,0,FW,20-24,Forward,Brazil,South America
2010,Paulinho,BRA,Leverkusen,Bundesliga,2020,20.0,2000.0,0.7,0,0,0,0,0,0,0,,0,0,0,0,0,0,0,0,FW,20-24,Forward,Brazil,South America
2010,Paulinho,BRA,Leverkusen,Bundesliga,2020,20.0,2000.0,0.7,0,0,0,0,0,0,0,,0,0,0,0,0,0,0,0,FW,20-24,Forward,Brazil,South America
2010,Paulinho,BRA,Leverkusen,Bundesliga,2020,20.0,2000.0,0.7,0,0,0,0,0,0,0,,0,0,0,0,0,0,0,0,FW,20-24,Forward,Brazil,South America
2010,Paulinho,BRA,Leverkusen,Bundesliga,2020,20.0,2000.0,0.7,0,0,0,0,0,0,0,,0,0,0,0,0,0,0,0,FW,20-24,Forward,Brazil,South America
2010,Paulinho,BRA,Leverkusen,Bundesliga,2020,20.0,2000.0,0.7,0,0,0,0,0,0,0,,0,0,0,0,0,0,0,0,FW,20-24,Forward,Brazil,South America
2010,Paulinho,BRA,Leverkusen,Bundesliga,2020,20.0,2000.0,0.7,0,0,0,0,0,0,0,,0,0,0,0,0,0,0,0,FW,20-24,Forward,Brazil,South America
2010,Paulinho,BRA,Leverkusen,Bundesliga,2020,20.0,2000.0,0.7,0,0,0,0,0,0,0,,0,0,0,0,0,0,0,0,FW,20-24,Forward,Brazil,South America
2010,Paulinho,BRA,Leverkusen,Bundesliga,2020,20.0,2000.0,0.7,0,0,0,0,0,0,0,,0,0,0,0,0,0,0,0,FW,20-24,Forward,Brazil,South America
2010,Paulinho,BRA,Leverkusen,Bundesliga,2020,20.0,2000.0,0.7,0,0,0,0,0,0,0,,0,0,0,0,0,0,0,0,FW,20-24,Forward,Brazil,South America
2010,Paulinho,BRA,Leverkusen,Bundesliga,2020,20.0,2000.0,0.7,0,0,0,0,0,0,0,,0,0,0,0,0,0,0,0,FW,20-24,Forward,Brazil,South America
2010,Paulinho,BRA,Leverkusen,Bundesliga,2020,20.0,2000.0,0.7,0,0,0,0,0,0,0,,0,0,0,0,0,0,0,0,FW,20-24,Forward,Brazil,South America
2010,Paulinho,BRA,Leverkusen,Bundesliga,2020,20.0,2000.0,0.7,0,0,0,0,0,0,0,,0,0,0,0,0,0,0,0,FW,20-24,Forward,Brazil,South America
2010,Paulinho,BRA,Leverkusen,Bundesliga,2020,20.0,2000.0,0.7,0,0,0,0,0,0,0,,0,0,0,0,0,0,0,0,FW,20-24,Forward,Brazil,South America
2010,Paulinho,BRA,Leverkusen,Bundesliga,2020,20.0,2000.0,0.7,0,0,0,0,0,0,0,,0,0,0,0,0,0,0,0,FW,20-24,Forward,Brazil,South America
2010,Paulinho,BRA,Leverkusen,Bundesliga,2020,20.0,2000.0,0.7,0,0,0,0,0,0,0,,0,0,0,0,0,0,0,0,FW,20-24,Forward,Brazil,South America
2010,Paulinho,BRA,Leverkusen,Bundesliga,2020,20.0,2000.0,0.7,0,0,0,0,0,0,0,,0,0,0,0,0,0,0,0,FW,20-24,Forward,Brazil,South America
2010,Paulinho,BRA,Leverkusen,Bundesliga,2020,20.0,2000.0,0.7,0,0,0,0,0,0,0,,0,0,0,0,0,0,0,0,FW,20-24,Forward,Brazil,South America
2010,Paulinho,BRA,Leverkusen,Bundesliga,2020,20.0,2000.0,0.7,0,0,0,0,0,0,0,,0,0,0,0,0,0,0,0,FW,20-24,Forward,Brazil,South America
2010,Paulinho,BRA,Leverkusen,Bundesliga,2020,20.0,2000.0,0.7,0,0,0,0,0,0,0,,0,0,0,0,0,0,0,0,FW,20-24,Forward,Brazil,South America
2010,Paulinho,BRA,Leverkusen,Bundesliga,2020,20.0,2000.0,0.7,0,0,0,0,0,0,0,,0,0,0,0,0,0,0,0,FW,20-24,Forward,Brazil,South America
2010,Paulinho,BRA,Leverkusen,Bundesliga,2020,20.0,2000.0,0.7,0,0,0,0,0,0,0,,0,0,0,0,0,0,0,0,FW,20-24,Forward,Brazil,South America
2010,Paulinho,BRA,Leverkusen,Bundesliga,2020,20.0,2000.0,0.7,0,0,0,0,0,0,0,,0,0,0,0,0,0,0,0,FW,20-24,Forward,Brazil,South America
2010,Paulinho,BRA,Leverkusen,Bundesliga,2020,20.0,2000.0,0.7,0,0,0,0,0,0,0,,0,0,0,0,0,0,0,0,FW,20-24,Forward,Brazil,South America
2010,Paulinho,BRA,Leverkusen,Bundesliga,2020,20.0,2000.0,0.7,0,0,0,0,0,0,0,,0,0,0,0,0,0,0,0,FW,20-24,Forward,Brazil,South America
2010,Paulinho,BRA,Leverkusen,Bundesliga,2020,20.0,2000.0,0.7,0,0,0,0,0,0,0,,0,0,0,0,0,0,0,0,FW,20-24,Forward,Brazil,South America
2010,Paulinho,BRA,Leverkusen,Bundesliga,2020,20.0,2000.0,0.7,0,0,0,0,0,0,0,,0,0,0,0,0,0,0,0,FW,20-24,Forward,Brazil,South America
2010,Paulinho,BRA,Leverkusen,Bundesliga,2020,20.0,2000.0,0.7,0,0,0,0,0,0,0,,0,0,0,0,0,0,0,0,FW,20-24,Forward,Brazil,South America
2010,Paulinho,BRA,Leverkusen,Bundesliga,2020,20.0,2000.0,0.7,0,0,0,0,0,0,0,,0,0,0,0,0,0,0,0,FW,20-24,Forward,Brazil,South America
2010,Paulinho,BRA,Leverkusen,Bundesliga,2020,20.0,2000.0,0.7,0,0,0,0,0,0,0,,0,0,0,0,0,0,0,0,FW,20-24,Forward,Brazil,South America
2010,Paulinho,BRA,Leverkusen,Bundesliga,2020,20.0,2000.0,0.7,0,0,0,0,0,0,0,,0,0,0,0,0,0,0,0,FW,20-24,Forward,Brazil,South America
2010,Paulinho,BRA,Leverkusen,Bundesliga,2020,20.0,2000.0,0.7,0,0,0,0,0,0,0,,0,0,0,0,0,0,0,0,FW,20-24,Forward,Brazil,South America
2010,Paulinho,BRA,Leverkusen,Bundesliga,2020,20.0,2000.0,0.7,0,0,0,0,0,0,0,,0,0,0,0,0,0,0,0,FW,20-24,Forward,Brazil,South America
2010,Paulinho,BRA,Leverkusen,Bundesliga,2020,20.0,2000.0,0.7,0,0,0,0,0,0,0,,0,0,0,0,0,0,0,0,FW,20-24,Forward,Brazil,South America
2010,Paulinho,BRA,Leverkusen,Bundesliga,2020,20.0,2000.0,0.7,0,0,0,0,0,0,0,,0,0,0,0,0,0,0,0,FW,20-24,Forward,Brazil,South America
2010,Paulinho,BRA,Leverkusen,Bundesliga,2020,20.0,2000.0,0.7,0,0,0,0,0,0,0,,0,0,0,0,0,0,0,0,FW,20-24,Forward,Brazil,South America
2010,Paulinho,BRA,Leverkusen,Bundesliga,2020,20.0,2000.0,0.7,0,0,0,0,0,0,0,,0,0,0,0,0,0,0,0,FW,20-24,Forward,Brazil,South America
2010,Paulinho,BRA,Leverkusen,Bundesliga,2020,20.0,2000.0,0.7,0,0,0,0,0,0,0,,0,0,0,0,0,0,0,0,FW,20-24,Forward,Brazil,South America
2010,Paulinho,BRA,Leverkusen,Bundesliga,2020,20.0,2000.0,0.7,0,0,0,0,0,0,0,,0,0,0,0,0,0,0,0,FW,20-24,Forward,Brazil,South America
2010,Paulinho,BRA,Leverkusen,Bundesliga,2020,20.0,2000.0,0.7,0,0,0,0,0,0,0,,0,0,0,0,0,0,0,0,FW,20-24,Forward,Brazil,South America
2010,Paulinho,BRA,Leverkusen,Bundesliga,2020,20.0,2000.0,0.7,0,0,0,0,0,0,0,,0,0,0,0,0,0,0,0,FW,20-24,Forward,Brazil,South America
2010,Paulinho,BRA,Leverkusen,Bundesliga,2020,20.0,2000.0,0.7,0,0,0,0,0,0,0,,0,0,0,0,0,0,0,0,FW,20-24,Forward,Brazil,South America
2010,Paulinho,BRA,Leverkusen,Bundesliga,2020,20.0,2000.0,0.7,0,0,0,0,0,0,0,,0,0,0,0,0,0,0,0,FW,20-24,Forward,Brazil,South America
2010,Paulinho,BRA,Leverkusen,Bundesliga,2020,20.0,2000.0,0.7,0,0,0,0,0,0,0,,0,0,0,0,0,0,0,0,FW,20-24,Forward,Brazil,South America
2010,Paulinho,BRA,Leverkusen,Bundesliga,2020,20.0,2000.0,0.7,0,0,0,0,0,0,0,,0,0,0,0,0,0,0,0,FW,20-24,Forward,Brazil,South America
2010,Paulinho,BRA,Leverkusen,Bundesliga,2020,20.0,2000.0,0.7,0,0,0,0,0,0,0,,0,0,0,0,0,0,0,0,FW,20-24,Forward,Brazil,South America
2010,Paulinho,BRA,Leverkusen,Bundesliga,2020,20.0,2000.0,0.7,0,0,0,0,0,0,0,,0,0,0,0,0,0,0,0,FW,20-24,Forward,Brazil,South America
2010,Paulinho,BRA,Leverkusen,Bundesliga,2020,20.0,2000.0,0.7,0,0,0,0,0,0,0,,0,0,0,0,0,0,0,0,FW,20-24,Forward,Brazil,South America
2010,Paulinho,BRA,Leverkusen,Bundesliga,2020,20.0,2000.0,0.7,0,0,0,0,0,0,0,,0,0,0,0,0,0,0,0,FW,20-24,Forward,Brazil,South America
2010,Paulinho,BRA,Leverkusen,Bundesliga,2020,20.0,2000.0,0.7,0,0,0,0,0,0,0,,0,0,0,0,0,0,0,0,FW,20-24,Forward,Brazil,South America
2010,Paulinho,BRA,Leverkusen,Bundesliga,2020,20.0,2000.0,0.7,0,0,0,0,0,0,0,,0,0,0,0,0,0,0,0,FW,20-24,Forward,Brazil,South America
2010,Paulinho,BRA,Leverkusen,Bundesliga,2020,20.0,2000.0,0.7,0,0,0,0,0,0,0,,0,0,0,0,0,0,0,0,FW,20-24,Forward,Brazil,South America
2010,Paulinho,BRA,Leverkusen,Bundesliga,2020,20.0,2000.0,0.7,0,0,0,0,0,0,0,,0,0,0,0,0,0,0,0,FW,20-24,Forward,Brazil,South America
2010,Paulinho,BRA,Leverkusen,Bundesliga,2020,20.0,2000.0,0.7,0,0,0,0,0,0,0,,0,0,0,0,0,0,0,0,FW,20-24,Forward,Brazil,South America
2010,Paulinho,BRA,Leverkusen,Bundesliga,2020,20.0,2000.0,0.7,0,0,0,0,0,0,0,,0,0,0,0,0,0,0,0,FW,20-24,Forward,Brazil,South America
2010,Paulinho,BRA,Leverkusen,Bundesliga,2020,20.0,2000.0,0.7,0,0,0,0,0,0,0,,0,0,0,0,0,0,0,0,FW,20-24,Forward,Brazil,South America
2010,Paulinho,BRA,Leverkusen,Bundesliga,2020,20.0,2000.0,0.7,0,0,0,0,0,0,0,,0,0,0,0,0,0,0,0,FW,20-24,Forward,Brazil,South America
2010,Paulinho,BRA,Leverkusen,Bundesliga,2020,20.0,2000.0,0.7,0,0,0,0,0,0,0,,0,0,0,0,0,0,0,0,FW,20-24,Forward,Brazil,South America
2010,Paulinho,BRA,Leverkusen,Bundesliga,2020,20.0,2000.0,0.7,0,0,0,0,0,0,0,,0,0,0,0,0,0,0,0,FW,20-24,Forward,Brazil,South America
2010,Paulinho,BRA,Leverkusen,Bundesliga,2020,20.0,2000.0,0.7,0,0,0,0,0,0,0,,0,0,0,0,0,0,0,0,FW,20-24,Forward,Brazil,South America
2010,Paulinho,BRA,Leverkusen,Bundesliga,2020,20.0,2000.0,0.7,0,0,0,0,0,0,0,,0,0,0,0,0,0,0,0,FW,20-24,Forward,Brazil,South America
2010,Paulinho,BRA,Leverkusen,Bundesliga,2020,20.0,2000.0,0.7,0,0,0,0,0,0,0,,0,0,0,0,0,0,0,0,FW,20-24,Forward,Brazil,South America
2010,Paulinho,BRA,Leverkusen,Bundesliga,2020,20.0,2000.0,0.7,0,0,0,0,0,0,0,,0,0,0,0,0,0,0,0,FW,20-24,Forward,Brazil,South America
2010,Paulinho,BRA,Leverkusen,Bundesliga,2020,20.0,2000.0,0.7,0,0,0,0,0,0,0,,0,0,0,0,0,0,0,0,FW,20-24,Forward,Brazil,South America
2010,Paulinho,BRA,Leverkusen,Bundesliga,2020,20.0,2000.0,0.7,0,0,0,0,0,0,0,,0,0,0,0,0,0,0,0,FW,20-24,Forward,Brazil,South America
2010,Paulinho,BRA,Leverkusen,Bundesliga,2020,20.0,2000.0,0.7,0,0,0,0,0,0,0,,0,0,0,0,0,0,0,0,FW,20-24,Forward,Brazil,South America
2010,Paulinho,BRA,Leverkusen,Bundesliga,2020,20.0,2000.0,0.7,0,0,0,0,0,0,0,,0,0,0,0,0,0,0,0,FW,20-24,Forward,Brazil,South America
2010,Paulinho,BRA,Leverkusen,Bundesliga,2020,20.0,2000.0,0.7,0,0,0,0,0,0,0,,0,0,0,0,0,0,0,0,FW,20-24,Forward,Brazil,South America
2010,Paulinho,BRA,Leverkusen,Bundesliga,2020,20.0,2000.0,0.7,0,0,0,0,0,0,0,,0,0,0,0,0,0,0,0,FW,20-24,Forward,Brazil,South America
2010,Paulinho,BRA,Leverkusen,Bundesliga,2020,20.0,2000.0,0.7,0,0,0,0,0,0,0,,0,0,0,0,0,0,0,0,FW,20-24,Forward,Brazil,South America
2010,Paulinho,BRA,Leverkusen,Bundesliga,2020,20.0,2000.0,0.7,0,0,0,0,0,0,0,,0,0,0,0,0,0,0,0,FW,20-24,Forward,Brazil,South America
2010,Paulinho,BRA,Leverkusen,Bundesliga,2020,20.0,2000.0,0.7,0,0,0,0,0,0,0,,0,0,0,0,0,0,0,0,FW,20-24,Forward,Brazil,South America
2010,Paulinho,BRA,Leverkusen,Bundesliga,2020,20.0,2000.0,0.7,0,0,0,0,0,0,0,,0,0,0,0,0,0,0,0,FW,20-24,Forward,Brazil,South America
2010,Paulinho,BRA,Leverkusen,Bundesliga,2020,20.0,2000.0,0.7,0,0,0,0,0,0,0,,0,0,0,0,0,0,0,0,FW,20-24,Forward,Brazil,South America
2010,Paulinho,BRA,Leverkusen,Bundesliga,2020,20.0,2000.0,0.7,0,0,0,0,0,0,0,,0,0,0,0,0,0,0,0,FW,20-24,Forward,Brazil,South America
2010,Paulinho,BRA,Leverkusen,Bundesliga,2020,20.0,2000.0,0.7,0,0,0,0,0,0,0,,0,0,0,0,0,0,0,0,FW,20-24,Forward,Brazil,South America
2010,Paulinho,BRA,Leverkusen,Bundesliga,2020,20.0,2000.0,0.7,0,0,0,0,0,0,0,,0,0,0,0,0,0,0,0,FW,20-24,Forward,Brazil,South America
2010,Paulinho,BRA,Leverkusen,Bundesliga,2020,20.0,2000.0,0.7,0,0,0,0,0,0,0,,0,0,0,0,0,0,0,0,FW,20-24,Forward,Brazil,South America
2010,Paulinho,BRA,Leverkusen,Bundesliga,2020,20.0,2000.0,0.7,0,0,0,0,0,0,0,,0,0,0,0,0,0,0,0,FW,20-24,Forward,Brazil,South America
2010,Paulinho,BRA,Leverkusen,Bundesliga,2020,20.0,2000.0,0.7,0,0,0,0,0,0,0,,0,0,0,0,0,0,0,0,FW,20-24,Forward,Brazil,South America
2010,Paulinho,BRA,Leverkusen,Bundesliga,2020,20.0,2000.0,0.7,0,0,0,0,0,0,0,,0,0,0,0,0,0,0,0,FW,20-24,Forward,Brazil,South America
2010,Paulinho,BRA,Leverkusen,Bundesliga,2020,20.0,2000.0,0.7,0,0,0,0,0,0,0,,0,0,0,0,0,0,0,0,FW,20-24,Forward,Brazil,South America
2010,Paulinho,BRA,Leverkusen,Bundesliga,2020,20.0,2000.0,0.7,0,0,0,0,0,0,0,,0,0,0,0,0,0,0,0,FW,20-24,Forward,Brazil,South America
2010,Paulinho,BRA,Leverkusen,Bundesliga,2020,20.0,2000.0,0.7,0,0,0,0,0,0,0,,0,0,0,0,0,0,0,0,FW,20-24,Forward,Brazil,South America
2010,Paulinho,BRA,Leverkusen,Bundesliga,2020,20.0,2000.0,0.7,0,0,0,0,0,0,0,,0,0,0,0,0,0,0,0,FW,20-24,Forward,Brazil,South America
2010,Paulinho,BRA,Leverkusen,Bundesliga,2020,20.0,2000.0,0.7,0,0,0,0,0,0,0,,0,0,0,0,0,0,0,0,FW,20-24,Forward,Brazil,South America
2010,Paulinho,BRA,Leverkusen,Bundesliga,2020,20.0,2000.0,0.7,0,0,0,0,0,0,0,,0,0,0,0,0,0,0,0,FW,20-24,Forward,Brazil,South America
2010,Paulinho,BRA,Leverkusen,Bundesliga,2020,20.0,2000.0,0.7,0,0,0,0,0,0,0,,0,0,0,0,0,0,0,0,FW,20-24,Forward,Brazil,South America
2010,Paulinho,BRA,Leverkusen,Bundesliga,2020,20.0,2000.0,0.7,0,0,0,0,0,0,0,,0,0,0,0,0,0,0,0,FW,20-24,Forward,Brazil,South America
2010,Paulinho,BRA,Leverkusen,Bundesliga,2020,20.0,2000.0,0.7,0,0,0,0,0,0,0,,0,0,0,0,0,0,0,0,FW,20-24,Forward,Brazil,South America
2010,Paulinho,BRA,Leverkusen,Bundesliga,2020,20.0,2000.0,0.7,0,0,0,0,0,0,0,,0,0,0,0,0,0,0,0,FW,20-24,Forward,Brazil,South America
2010,Paulinho,BRA,Leverkusen,Bundesliga,2020,20.0,2000.0,0.7,0,0,0,0,0,0,0,,0,0,0,0,0,0,0,0,FW,20-24,Forward,Brazil,South America
2010,Paulinho,BRA,Leverkusen,Bundesliga,2020,20.0,2000.0,0.7,0,0,0,0,0,0,0,,0,0,0,0,0,0,0,0,FW,20-24,Forward,Brazil,South America
2010,Paulinho,BRA,Leverkusen,Bundesliga,2020,20.0,2000.0,0.7,0,0,0,0,0,0,0,,0,0,0,0,0,0,0,0,FW,20-24,Forward,Brazil,South America
2010,Paulinho,BRA,Leverkusen,Bundesliga,2020,20.0,2000.0,0.7,0,0,0,0,0,0,0,,0,0,0,0,0,0,0,0,FW,20-24,Forward,Brazil,South America
2010,Paulinho,BRA,Leverkusen,Bundesliga,2020,20.0,2000.0,0.7,0,0,0,0,0,0,0,,0,0,0,0,0,0,0,0,FW,20-24,Forward,Brazil,South America
2010,Paulinho,BRA,Leverkusen,Bundesliga,2020,20.0,2000.0,0.7,0,0,0,0,0,0,0,,0,0,0,0,0,0,0,0,FW,20-24,Forward,Brazil,South America
2010,Paulinho,BRA,Leverkusen,Bundesliga,2020,20.0,2000.0,0.7,0,0,0,0,0,0,0,,0,0,0,0,0,0,0,0,FW,20-24,Forward,Brazil,South America
2010,Paulinho,BRA,Leverkusen,Bundesliga,2020,20.0,2000.0,0.7,0,0,0,0,0,0,0,,0,0,0,0,0,0,0,0,FW,20-24,Forward,Brazil,South America
2010,Paulinho,BRA,Leverkusen,Bundesliga,2020,20.0,2000.0,0.7,0,0,0,0,0,0,0,,0,0,0,0,0,0,0,0,FW,20-24,Forward,Brazil,South America
2010,Paulinho,BRA,Leverkusen,Bundesliga,2020,20.0,2000.0,0.7,0,0,0,0,0,0,0,,0,0,0,0,0,0,0,0,FW,20-24,Forward,Brazil,South America
2010,Paulinho,BRA,Leverkusen,Bundesliga,2020,20.0,2000.0,0.7,0,0,0,0,0,0,0,,0,0,0,0,0,0,0,0,FW,20-24,Forward,Brazil,South America
2010,Paulinho,BRA,Leverkusen,Bundesliga,2020,20.0,2000.0,0.7,0,0,0,0,0,0,0,,0,0,0,0,0,0,0,0,FW,20-24,Forward,Brazil,South America
2010,Paulinho,BRA,Leverkusen,Bundesliga,2020,20.0,2000.0,0.7,0,0,0,0,0,0,0,,0,0,0,0,0,0,0,0,FW,20-24,Forward,Brazil,South America
2010,Paulinho,BRA,Leverkusen,Bundesliga,2020,20.0,2000.0,0.7,0,0,0,0,0,0,0,,0,0,0,0,0,0,0,0,FW,20-24,Forward,Brazil,South America
2010,Paulinho,BRA,Leverkusen,Bundesliga,2020,20.0,2000.0,0.7,0,0,0,0,0,0,0,,0,0,0,0,0,0,0,0,FW,20-24,Forward,Brazil,South America
2010,Paulinho,BRA,Leverkusen,Bundesliga,2020,20.0,2000.0,0.7,0,0,0,0,0,0,0,,0,0,0,0,0,0,0,0,FW,20-24,Forward,Brazil,South America
2010,Paulinho,BRA,Leverkusen,Bundesliga,2020,20.0,2000.0,0.7,0,0,0,0,0,0,0,,0,0,0,0,0,0,0,0,FW,20-24,Forward,Brazil,South America
2010,Paulinho,BRA,Leverkusen,Bundesliga,2020,20.0,2000.0,0.7,0,0,0,0,0,0,0,,0,0,0,0,0,0,0,0,FW,20-24,Forward,Brazil,South America
2010,Paulinho,BRA,Leverkusen,Bundesliga,2020,20.0,2000.0,0.7,0,0,0,0,0,0,0,,0,0,0,0,0,0,0,0,FW,20-24,Forward,Brazil,South America
2010,Paulinho,BRA,Leverkusen,Bundesliga,2020,20.0,2000.0,0.7,0,0,0,0,0,0,0,,0,0,0,0,0,0,0,0,FW,20-24,Forward,Brazil,South America
2010,Paulinho,BRA,Leverkusen,Bundesliga,2020,20.0,2000.0,0.7,0,0,0,0,0,0,0,,0,0,0,0,0,0,0,0,FW,20-24,Forward,Brazil,South America
2010,Paulinho,BRA,Leverkusen,Bundesliga,2020,20.0,2000.0,0.7,0,0,0,0,0,0,0,,0,0,0,0,0,0,0,0,FW,20-24,Forward,Brazil,South America
2010,Paulinho,BRA,Leverkusen,Bundesliga,2020,20.0,2000.0,0.7,0,0,0,0,0,0,0,,0,0,0,0,0,0,0,0,FW,20-24,Forward,Brazil,South America
2010,Paulinho,BRA,Leverkusen,Bundesliga,2020,20.0,2000.0,0.7,0,0,0,0,0,0,0,,0,0,0,0,0,0,0,0,FW,20-24,Forward,Brazil,South America
2010,Paulinho,BRA,Leverkusen,Bundesliga,2020,20.0,2000.0,0.7,0,0,0,0,0,0,0,,0,0,0,0,0,0,0,0,FW,20-24,Forward,Brazil,South America
2010,Paulinho,BRA,Leverkusen,Bundesliga,2020,20.0,2000.0,0.7,0,0,0,0,0,0,0,,0,0,0,0,0,0,0,0,FW,20-24,Forward,Brazil,South America
2010,Paulinho,BRA,Leverkusen,Bundesliga,2020,20.0,2000.0,0.7,0,0,0,0,0,0,0,,0,0,0,0,0,0,0,0,FW,20-24,Forward,Brazil,South America
2010,Paulinho,BRA,Leverkusen,Bundesliga,2020,20.0,2000.0,0.7,0,0,0,0,0,0,0,,0,0,0,0,0,0,0,0,FW,20-24,Forward,Brazil,South America
2010,Paulinho,BRA,Leverkusen,Bundesliga,2020,20.0,2000.0,0.7,0,0,0,0,0,0,0,,0,0,0,0,0,0,0,0,FW,20-24,Forward,Brazil,South America
2010,Paulinho,BRA,Leverkusen,Bundesliga,2020,20.0,2000.0,0.7,0,0,0,0,0,0,0,,0,0,0,0,0,0,0,0,FW,20-24,Forward,Brazil,South America
2010,Paulinho,BRA,Leverkusen,Bundesliga,2020,20.0,2000.0,0.7,0,0,0,0,0,0,0,,0,0,0,0,0,0,0,0,FW,20-24,Forward,Brazil,South America
2010,Paulinho,BRA,Leverkusen,Bundesliga,2020,20.0,2000.0,0.7,0,0,0,0,0,0,0,,0,0,0,0,0,0,0,0,FW,20-24,Forward,Brazil,South America
2010,Paulinho,BRA,Leverkusen,Bundesliga,2020,20.0,2000.0,0.7,0,0,0,0,0,0,0,,0,0,0,0,0,0,0,0,FW,20-24,Forward,Brazil,South America
2010,Paulinho,BRA,Leverkusen,Bundesliga,2020,20.0,2000.0,0.7,0,0,0,0,0,0,0,,0,0,0,0,0,0,0,0,FW,20-24,Forward,Brazil,South America
2010,Paulinho,BRA,Leverkusen,Bundesliga,2020,20.0,2000.0,0.7,0,0,0,0,0,0,0,,0,0,0,0,0,0,0,0,FW,20-24,Forward,Brazil,South America
2010,Paulinho,BRA,Leverkusen,Bundesliga,2020,20.0,2000.0,0.7,0,0,0,0,0,0,0,,0,0,0,0,0,0,0,0,FW,20-24,Forward,Brazil,South America
2010,Paulinho,BRA,Leverkusen,Bundesliga,2020,20.0,2000.0,0.7,0,0,0,0,0,0,0,,0,0,0,0,0,0,0,0,FW,20-24,Forward,Brazil,South America
2010,Paulinho,BRA,Leverkusen,Bundesliga,2020,20.0,2000.0,0.7,0,0,0,0,0,0,0,,0,0,0,0,0,0,0,0,FW,20-24,Forward,Brazil,South America
2010,Paulinho,BRA,Leverkusen,Bundesliga,2020,20.0,2000.0,0.7,0,0,0,0,0,0,0,,0,0,0,0,0,0,0,0,FW,20-24,Forward,Brazil,South America
2010,Paulinho,BRA,Leverkusen,Bundesliga,2020,20.0,2000.0,0.7,0,0,0,0,0,0,0,,0,0,0,0,0,0,0,0,FW,20-24,Forward,Brazil,South America
2010,Paulinho,BRA,Leverkusen,Bundesliga,2020,20.0,2000.0,0.7,0,0,0,0,0,0,0,,0,0,0,0,0,0,0,0,FW,20-24,Forward,Brazil,South America
2010,Paulinho,BRA,Leverkusen,Bundesliga,2020,20.0,2000.0,0.7,0,0,0,0,0,0,0,,0,0,0,0,0,0,0,0,FW,20-24,Forward,Brazil,South America
2010,Paulinho,BRA,Leverkusen,Bundesliga,2020,20.0,2000.0,0.7,0,0,0,0,0,0,0,,0,0,0,0,0,0,0,0,FW,20-24,Forward,Brazil,South America
2010,Paulinho,BRA,Leverkusen,Bundesliga,2020,20.0,2000.0,0.7,0,0,0,0,0,0,0,,0,0,0,0,0,0,0,0,FW,20-24,Forward,Brazil,South America
2010,Paulinho,BRA,Leverkusen,Bundesliga,2020,20.0,2000.0,0.7,0,0,0,0,0,0,0,,0,0,0,0,0,0,0,0,FW,20-24,Forward,Brazil,South America
2010,Paulinho,BRA,Leverkusen,Bundesliga,2020,20.0,2000.0,0.7,0,0,0,0,0,0,0,,0,0,0,0,0,0,0,0,FW,20-24,Forward,Brazil,South America
2010,Paulinho,BRA,Leverkusen,Bundesliga,2020,20.0,2000.0,0.7,0,0,0,0,0,0,0,,0,0,0,0,0,0,0,0,FW,20-24,Forward,Brazil,South America
2010,Paulinho,BRA,Leverkusen,Bundesliga,2020,20.0,2000.0,0.7,0,0,0,0,0,0,0,,0,0,0,0,0,0,0,0,FW,20-24,Forward,Brazil,South America
2010,Paulinho,BRA,Leverkusen,Bundesliga,2020,20.0,2000.0,0.7,0,0,0,0,0,0,0,,0,0,0,0,0,0,0,0,FW,20-24,Forward,Brazil,South America
2010,Paulinho,BRA,Leverkusen,Bundesliga,2020,20.0,2000.0,0.7,0,0,0,0,0,0,0,,0,0,0,0,0,0,0,0,FW,20-24,Forward,Brazil,South America
2010,Paulinho,BRA,Leverkusen,Bundesliga,2020,20.0,2000.0,0.7,0,0,0,0,0,0,0,,0,0,0,0,0,0,0,0,FW,20-24,Forward,Brazil,South America
2010,Paulinho,BRA,Leverkusen,Bundesliga,2020,20.0,2000.0,0.7,0,0,0,0,0,0,0,,0,0,0,0,0,0,0,0,FW,20-24,Forward,Brazil,South America
2010,Paulinho,BRA,Leverkusen,Bundesliga,2020,20.0,2000.0,0.7,0,0,0,0,0,0,0,,0,0,0,0,0,0,0,0,FW,20-24,Forward,Brazil,South America
2010,Paulinho,BRA,Leverkusen,Bundesliga,2020,20.0,2000.0,0.7,0,0,0,0,0,0,0,,0,0,0,0,0,0,0,0,FW,20-24,Forward,Brazil,South America
2010,Paulinho,BRA,Leverkusen,Bundesliga,2020,20.0,2000.0,0.7,0,0,0,0,0,0,0,,0,0,0,0,0,0,0,0,FW,20-24,Forward,Brazil,South America
2010,Paulinho,BRA,Leverkusen,Bundesliga,2020,20.0,2000.0,0.7,0,0,0,0,0,0,0,,0,0,0,0,0,0,0,0,FW,20-24,Forward,Brazil,South America
2010,Paulinho,BRA,Leverkusen,Bundesliga,2020,20.0,2000.0,0.7,0,0,0,0,0,0,0,,0,0,0,0,0,0,0,0,FW,20-24,Forward,Brazil,South America
2010,Paulinho,BRA,Leverkusen,Bundesliga,2020,20.0,2000.0,0.7,0,0,0,0,0,0,0,,0,0,0,0,0,0,0,0,FW,20-24,Forward,Brazil,South America
2010,Paulinho,BRA,Leverkusen,Bundesliga,2020,20.0,2000.0,0.7,0,0,0,0,0,0,0,,0,0,0,0,0,0,0,0,FW,20-24,Forward,Brazil,South America
2010,Paulinho,BRA,Leverkusen,Bundesliga,2020,20.0,2000.0,0.7,0,0,0,0,0,0,0,,0,0,0,0,0,0,0,0,FW,20-24,Forward,Brazil,South America
2010,Paulinho,BRA,Leverkusen,Bundesliga,2020,20.0,2000.0,0.7,0,0,0,0,0,0,0,,0,0,0,0,0,0,0,0,FW,20-24,Forward,Brazil,South America
2011,Gabriel Paulista,BRA,Valencia,La Liga,2020,29.0,1990.0,30.2,17,11,9,5,3,6,17,35.3,11,32,27,5,59,76,132,3,DF,25-29,Defender,Brazil,South America
2012,Benjamin Pavard,FRA,Bayern Munich,Bundesliga,2020,24.0,1996.0,21.6,44,27,20,16,8,23,40,57.5,17,29,5,24,48,92,31,1,DF,20-24,Defender,France,Europe
2014,Vasileios Pavlidis,GRE,Schalke 04,Bundesliga,2020,17.0,2002.0,0.0,0,0,0,0,0,0,0,,0,0,0,0,0,0,0,0,FW,Under 20,Forward,Greece,Europe
2015,Mateo Pavlović,BIH,Angers,Ligue 1,2020,30.0,1990.0,12.3,11,6,8,3,0,8,23,34.8,15,13,11,2,21,32,40,0,DF,30-34,Defender,Bosnia and Herzegovina,Europe
2017,Leonardo Pavoletti,ITA,Cagliari,Serie A,2020,31.0,1988.0,17.6,7,3,2,5,0,1,20,5.0,19,4,2,2,4,11,32,0,FW,30-34,Forward,Italy,Europe
2018,Dimitri Payet,FRA,Marseille,Ligue 1,2020,33.0,1987.0,26.9,27,17,4,16,7,17,40,42.5,23,19,2,17,8,35,10,0,"FW,MF",30-34,Forward,France,Europe
2019,Nehuén Paz,ARG,Bologna,Serie A,2020,27.0,1993.0,4.0,9,4,4,5,0,6,7,85.7,1,4,2,2,11,20,16,0,DF,25-29,Defender,Argentina,South America
2021,Mads Pedersen,DEN,Augsburg,Bundesliga,2020,23.0,1996.0,9.9,25,16,20,3,2,10,22,45.5,12,13,3,10,15,40,32,0,DF,20-24,Defender,Denmark,Europe
2021,Mads Pedersen,DEN,Augsburg,Bundesliga,2020,23.0,1996.0,9.9,25,16,20,3,2,10,22,45.5,12,13,3,10,15,40,32,0,DF,20-24,Defender,Denmark,Europe
2021,Mads Pedersen,DEN,Augsburg,Bundesliga,2020,23.0,1996.0,9.9,25,16,20,3,2,10,22,45.5,12,13,3,10,15,40,32,0,DF,20-24,Defender,Denmark,Europe
2021,Mads Pedersen,DEN,Augsburg,Bundesliga,2020,23.0,1996.0,9.9,25,16,20,3,2,10,22,45.5,12,13,3,10,15,40,32,0,DF,20-24,Defender,Denmark,Europe
2025,João Pedro,ITA,Cagliari,Serie A,2020,28.0,1992.0,36.1,13,6,2,6,5,2,27,7.4,25,32,6,26,13,26,28,0,"FW,MF",25-29,Forward,Italy,Europe
2025,João Pedro,ITA,Cagliari,Serie A,2020,28.0,1992.0,36.1,13,6,2,6,5,2,27,7.4,25,32,6,26,13,26,28,0,"FW,MF",25-29,Forward,Italy,Europe
2025,João Pedro,ITA,Cagliari,Serie A,2020,28.0,1992.0,36.1,13,6,2,6,5,2,27,7.4,25,32,6,26,13,26,28,0,"FW,MF",25-29,Forward,Italy,Europe
2025,João Pedro,ITA,Cagliari,Serie A,2020,28.0,1992.0,36.1,13,6,2,6,5,2,27,7.4,25,32,6,26,13,26,28,0,"FW,MF",25-29,Forward,Italy,Europe
2025,João Pedro,ITA,Cagliari,Serie A,2020,28.0,1992.0,36.1,13,6,2,6,5,2,27,7.4,25,32,6,26,13,26,28,0,"FW,MF",25-29,Forward,Italy,Europe
2025,João Pedro,ITA,Cagliari,Serie A,2020,28.0,1992.0,36.1,13,6,2,6,5,2,27,7.4,25,32,6,26,13,26,28,0,"FW,MF",25-29,Forward,Italy,Europe
2025,João Pedro,ITA,Cagliari,Serie A,2020,28.0,1992.0,36.1,13,6,2,6,5,2,27,7.4,25,32,6,26,13,26,28,0,"FW,MF",25-29,Forward,Italy,Europe
2025,João Pedro,ITA,Cagliari,Serie A,2020,28.0,1992.0,36.1,13,6,2,6,5,2,27,7.4,25,32,6,26,13,26,28,0,"FW,MF",25-29,Forward,Italy,Europe
2025,João Pedro,ITA,Cagliari,Serie A,2020,28.0,1992.0,36.1,13,6,2,6,5,2,27,7.4,25,32,6,26,13,26,28,0,"FW,MF",25-29,Forward,Italy,Europe
2025,João Pedro,ITA,Cagliari,Serie A,2020,28.0,1992.0,36.1,13,6,2,6,5,2,27,7.4,25,32,6,26,13,26,28,0,"FW,MF",25-29,Forward,Italy,Europe
2025,João Pedro,ITA,Cagliari,Serie A,2020,28.0,1992.0,36.1,13,6,2,6,5,2,27,7.4,25,32,6,26,13,26,28,0,"FW,MF",25-29,Forward,Italy,Europe
2025,João Pedro,ITA,Cagliari,Serie A,2020,28.0,1992.0,36.1,13,6,2,6,5,2,27,7.4,25,32,6,26,13,26,28,0,"FW,MF",25-29,Forward,Italy,Europe
2025,João Pedro,ITA,Cagliari,Serie A,2020,28.0,1992.0,36.1,13,6,2,6,5,2,27,7.4,25,32,6,26,13,26,28,0,"FW,MF",25-29,Forward,Italy,Europe
2025,João Pedro,ITA,Cagliari,Serie A,2020,28.0,1992.0,36.1,13,6,2,6,5,2,27,7.4,25,32,6,26,13,26,28,0,"FW,MF",25-29,Forward,Italy,Europe
2025,João Pedro,ITA,Cagliari,Serie A,2020,28.0,1992.0,36.1,13,6,2,6,5,2,27,7.4,25,32,6,26,13,26,28,0,"FW,MF",25-29,Forward,Italy,Europe
2025,João Pedro,ITA,Cagliari,Serie A,2020,28.0,1992.0,36.1,13,6,2,6,5,2,27,7.4,25,32,6,26,13,26,28,0,"FW,MF",25-29,Forward,Italy,Europe
2025,João Pedro,ITA,Cagliari,Serie A,2020,28.0,1992.0,36.1,13,6,2,6,5,2,27,7.4,25,32,6,26,13,26,28,0,"FW,MF",25-29,Forward,Italy,Europe
2025,João Pedro,ITA,Cagliari,Serie A,2020,28.0,1992.0,36.1,13,6,2,6,5,2,27,7.4,25,32,6,26,13,26,28,0,"FW,MF",25-29,Forward,Italy,Europe
2025,João Pedro,ITA,Cagliari,Serie A,2020,28.0,1992.0,36.1,13,6,2,6,5,2,27,7.4,25,32,6,26,13,26,28,0,"FW,MF",25-29,Forward,Italy,Europe
2025,João Pedro,ITA,Cagliari,Serie A,2020,28.0,1992.0,36.1,13,6,2,6,5,2,27,7.4,25,32,6,26,13,26,28,0,"FW,MF",25-29,Forward,Italy,Europe
2025,João Pedro,ITA,Cagliari,Serie A,2020,28.0,1992.0,36.1,13,6,2,6,5,2,27,7.4,25,32,6,26,13,26,28,0,"FW,MF",25-29,Forward,Italy,Europe
2025,João Pedro,ITA,Cagliari,Serie A,2020,28.0,1992.0,36.1,13,6,2,6,5,2,27,7.4,25,32,6,26,13,26,28,0,"FW,MF",25-29,Forward,Italy,Europe
2025,João Pedro,ITA,Cagliari,Serie A,2020,28.0,1992.0,36.1,13,6,2,6,5,2,27,7.4,25,32,6,26,13,26,28,0,"FW,MF",25-29,Forward,Italy,Europe
2025,João Pedro,ITA,Cagliari,Serie A,2020,28.0,1992.0,36.1,13,6,2,6,5,2,27,7.4,25,32,6,26,13,26,28,0,"FW,MF",25-29,Forward,Italy,Europe
2025,João Pedro,ITA,Cagliari,Serie A,2020,28.0,1992.0,36.1,13,6,2,6,5,2,27,7.4,25,32,6,26,13,26,28,0,"FW,MF",25-29,Forward,Italy,Europe
2025,João Pedro,ITA,Cagliari,Serie A,2020,28.0,1992.0,36.1,13,6,2,6,5,2,27,7.4,25,32,6,26,13,26,28,0,"FW,MF",25-29,Forward,Italy,Europe
2025,João Pedro,ITA,Cagliari,Serie A,2020,28.0,1992.0,36.1,13,6,2,6,5,2,27,7.4,25,32,6,26,13,26,28,0,"FW,MF",25-29,Forward,Italy,Europe
2025,João Pedro,ITA,Cagliari,Serie A,2020,28.0,1992.0,36.1,13,6,2,6,5,2,27,7.4,25,32,6,26,13,26,28,0,"FW,MF",25-29,Forward,Italy,Europe
2025,João Pedro,ITA,Cagliari,Serie A,2020,28.0,1992.0,36.1,13,6,2,6,5,2,27,7.4,25,32,6,26,13,26,28,0,"FW,MF",25-29,Forward,Italy,Europe
2025,João Pedro,ITA,Cagliari,Serie A,2020,28.0,1992.0,36.1,13,6,2,6,5,2,27,7.4,25,32,6,26,13,26,28,0,"FW,MF",25-29,Forward,Italy,Europe
2025,João Pedro,ITA,Cagliari,Serie A,2020,28.0,1992.0,36.1,13,6,2,6,5,2,27,7.4,25,32,6,26,13,26,28,0,"FW,MF",25-29,Forward,Italy,Europe
2025,João Pedro,ITA,Cagliari,Serie A,2020,28.0,1992.0,36.1,13,6,2,6,5,2,27,7.4,25,32,6,26,13,26,28,0,"FW,MF",25-29,Forward,Italy,Europe
2025,João Pedro,ITA,Cagliari,Serie A,2020,28.0,1992.0,36.1,13,6,2,6,5,2,27,7.4,25,32,6,26,13,26,28,0,"FW,MF",25-29,Forward,Italy,Europe
2025,João Pedro,ITA,Cagliari,Serie A,2020,28.0,1992.0,36.1,13,6,2,6,5,2,27,7.4,25,32,6,26,13,26,28,0,"FW,MF",25-29,Forward,Italy,Europe
2025,João Pedro,ITA,Cagliari,Serie A,2020,28.0,1992.0,36.1,13,6,2,6,5,2,27,7.4,25,32,6,26,13,26,28,0,"FW,MF",25-29,Forward,Italy,Europe
2025,João Pedro,ITA,Cagliari,Serie A,2020,28.0,1992.0,36.1,13,6,2,6,5,2,27,7.4,25,32,6,26,13,26,28,0,"FW,MF",25-29,Forward,Italy,Europe
2025,João Pedro,ITA,Cagliari,Serie A,2020,28.0,1992.0,36.1,13,6,2,6,5,2,27,7.4,25,32,6,26,13,26,28,0,"FW,MF",25-29,Forward,Italy,Europe
2025,João Pedro,ITA,Cagliari,Serie A,2020,28.0,1992.0,36.1,13,6,2,6,5,2,27,7.4,25,32,6,26,13,26,28,0,"FW,MF",25-29,Forward,Italy,Europe
2025,João Pedro,ITA,Cagliari,Serie A,2020,28.0,1992.0,36.1,13,6,2,6,5,2,27,7.4,25,32,6,26,13,26,28,0,"FW,MF",25-29,Forward,Italy,Europe
2025,João Pedro,ITA,Cagliari,Serie A,2020,28.0,1992.0,36.1,13,6,2,6,5,2,27,7.4,25,32,6,26,13,26,28,0,"FW,MF",25-29,Forward,Italy,Europe
2025,João Pedro,ITA,Cagliari,Serie A,2020,28.0,1992.0,36.1,13,6,2,6,5,2,27,7.4,25,32,6,26,13,26,28,0,"FW,MF",25-29,Forward,Italy,Europe
2025,João Pedro,ITA,Cagliari,Serie A,2020,28.0,1992.0,36.1,13,6,2,6,5,2,27,7.4,25,32,6,26,13,26,28,0,"FW,MF",25-29,Forward,Italy,Europe
2025,João Pedro,ITA,Cagliari,Serie A,2020,28.0,1992.0,36.1,13,6,2,6,5,2,27,7.4,25,32,6,26,13,26,28,0,"FW,MF",25-29,Forward,Italy,Europe
2025,João Pedro,ITA,Cagliari,Serie A,2020,28.0,1992.0,36.1,13,6,2,6,5,2,27,7.4,25,32,6,26,13,26,28,0,"FW,MF",25-29,Forward,Italy,Europe
2025,João Pedro,ITA,Cagliari,Serie A,2020,28.0,1992.0,36.1,13,6,2,6,5,2,27,7.4,25,32,6,26,13,26,28,0,"FW,MF",25-29,Forward,Italy,Europe
2025,João Pedro,ITA,Cagliari,Serie A,2020,28.0,1992.0,36.1,13,6,2,6,5,2,27,7.4,25,32,6,26,13,26,28,0,"FW,MF",25-29,Forward,Italy,Europe
2025,João Pedro,ITA,Cagliari,Serie A,2020,28.0,1992.0,36.1,13,6,2,6,5,2,27,7.4,25,32,6,26,13,26,28,0,"FW,MF",25-29,Forward,Italy,Europe
2025,João Pedro,ITA,Cagliari,Serie A,2020,28.0,1992.0,36.1,13,6,2,6,5,2,27,7.4,25,32,6,26,13,26,28,0,"FW,MF",25-29,Forward,Italy,Europe
2025,João Pedro,ITA,Cagliari,Serie A,2020,28.0,1992.0,36.1,13,6,2,6,5,2,27,7.4,25,32,6,26,13,26,28,0,"FW,MF",25-29,Forward,Italy,Europe
2025,João Pedro,ITA,Cagliari,Serie A,2020,28.0,1992.0,36.1,13,6,2,6,5,2,27,7.4,25,32,6,26,13,26,28,0,"FW,MF",25-29,Forward,Italy,Europe
2025,João Pedro,ITA,Cagliari,Serie A,2020,28.0,1992.0,36.1,13,6,2,6,5,2,27,7.4,25,32,6,26,13,26,28,0,"FW,MF",25-29,Forward,Italy,Europe
2025,João Pedro,ITA,Cagliari,Serie A,2020,28.0,1992.0,36.1,13,6,2,6,5,2,27,7.4,25,32,6,26,13,26,28,0,"FW,MF",25-29,Forward,Italy,Europe
2025,João Pedro,ITA,Cagliari,Serie A,2020,28.0,1992.0,36.1,13,6,2,6,5,2,27,7.4,25,32,6,26,13,26,28,0,"FW,MF",25-29,Forward,Italy,Europe
2025,João Pedro,ITA,Cagliari,Serie A,2020,28.0,1992.0,36.1,13,6,2,6,5,2,27,7.4,25,32,6,26,13,26,28,0,"FW,MF",25-29,Forward,Italy,Europe
2025,João Pedro,ITA,Cagliari,Serie A,2020,28.0,1992.0,36.1,13,6,2,6,5,2,27,7.4,25,32,6,26,13,26,28,0,"FW,MF",25-29,Forward,Italy,Europe
2025,João Pedro,ITA,Cagliari,Serie A,2020,28.0,1992.0,36.1,13,6,2,6,5,2,27,7.4,25,32,6,26,13,26,28,0,"FW,MF",25-29,Forward,Italy,Europe
2025,João Pedro,ITA,Cagliari,Serie A,2020,28.0,1992.0,36.1,13,6,2,6,5,2,27,7.4,25,32,6,26,13,26,28,0,"FW,MF",25-29,Forward,Italy,Europe
2025,João Pedro,ITA,Cagliari,Serie A,2020,28.0,1992.0,36.1,13,6,2,6,5,2,27,7.4,25,32,6,26,13,26,28,0,"FW,MF",25-29,Forward,Italy,Europe
2025,João Pedro,ITA,Cagliari,Serie A,2020,28.0,1992.0,36.1,13,6,2,6,5,2,27,7.4,25,32,6,26,13,26,28,0,"FW,MF",25-29,Forward,Italy,Europe
2025,João Pedro,ITA,Cagliari,Serie A,2020,28.0,1992.0,36.1,13,6,2,6,5,2,27,7.4,25,32,6,26,13,26,28,0,"FW,MF",25-29,Forward,Italy,Europe
2025,João Pedro,ITA,Cagliari,Serie A,2020,28.0,1992.0,36.1,13,6,2,6,5,2,27,7.4,25,32,6,26,13,26,28,0,"FW,MF",25-29,Forward,Italy,Europe
2025,João Pedro,ITA,Cagliari,Serie A,2020,28.0,1992.0,36.1,13,6,2,6,5,2,27,7.4,25,32,6,26,13,26,28,0,"FW,MF",25-29,Forward,Italy,Europe
2025,João Pedro,ITA,Cagliari,Serie A,2020,28.0,1992.0,36.1,13,6,2,6,5,2,27,7.4,25,32,6,26,13,26,28,0,"FW,MF",25-29,Forward,Italy,Europe
2025,João Pedro,ITA,Cagliari,Serie A,2020,28.0,1992.0,36.1,13,6,2,6,5,2,27,7.4,25,32,6,26,13,26,28,0,"FW,MF",25-29,Forward,Italy,Europe
2025,João Pedro,ITA,Cagliari,Serie A,2020,28.0,1992.0,36.1,13,6,2,6,5,2,27,7.4,25,32,6,26,13,26,28,0,"FW,MF",25-29,Forward,Italy,Europe
2025,João Pedro,ITA,Cagliari,Serie A,2020,28.0,1992.0,36.1,13,6,2,6,5,2,27,7.4,25,32,6,26,13,26,28,0,"FW,MF",25-29,Forward,Italy,Europe
2025,João Pedro,ITA,Cagliari,Serie A,2020,28.0,1992.0,36.1,13,6,2,6,5,2,27,7.4,25,32,6,26,13,26,28,0,"FW,MF",25-29,Forward,Italy,Europe
2025,João Pedro,ITA,Cagliari,Serie A,2020,28.0,1992.0,36.1,13,6,2,6,5,2,27,7.4,25,32,6,26,13,26,28,0,"FW,MF",25-29,Forward,Italy,Europe
2025,João Pedro,ITA,Cagliari,Serie A,2020,28.0,1992.0,36.1,13,6,2,6,5,2,27,7.4,25,32,6,26,13,26,28,0,"FW,MF",25-29,Forward,Italy,Europe
2025,João Pedro,ITA,Cagliari,Serie A,2020,28.0,1992.0,36.1,13,6,2,6,5,2,27,7.4,25,32,6,26,13,26,28,0,"FW,MF",25-29,Forward,Italy,Europe
2025,João Pedro,ITA,Cagliari,Serie A,2020,28.0,1992.0,36.1,13,6,2,6,5,2,27,7.4,25,32,6,26,13,26,28,0,"FW,MF",25-29,Forward,Italy,Europe
2025,João Pedro,ITA,Cagliari,Serie A,2020,28.0,1992.0,36.1,13,6,2,6,5,2,27,7.4,25,32,6,26,13,26,28,0,"FW,MF",25-29,Forward,Italy,Europe
2025,João Pedro,ITA,Cagliari,Serie A,2020,28.0,1992.0,36.1,13,6,2,6,5,2,27,7.4,25,32,6,26,13,26,28,0,"FW,MF",25-29,Forward,Italy,Europe
2025,João Pedro,ITA,Cagliari,Serie A,2020,28.0,1992.0,36.1,13,6,2,6,5,2,27,7.4,25,32,6,26,13,26,28,0,"FW,MF",25-29,Forward,Italy,Europe
2025,João Pedro,ITA,Cagliari,Serie A,2020,28.0,1992.0,36.1,13,6,2,6,5,2,27,7.4,25,32,6,26,13,26,28,0,"FW,MF",25-29,Forward,Italy,Europe
2025,João Pedro,ITA,Cagliari,Serie A,2020,28.0,1992.0,36.1,13,6,2,6,5,2,27,7.4,25,32,6,26,13,26,28,0,"FW,MF",25-29,Forward,Italy,Europe
2025,João Pedro,ITA,Cagliari,Serie A,2020,28.0,1992.0,36.1,13,6,2,6,5,2,27,7.4,25,32,6,26,13,26,28,0,"FW,MF",25-29,Forward,Italy,Europe
2025,João Pedro,ITA,Cagliari,Serie A,2020,28.0,1992.0,36.1,13,6,2,6,5,2,27,7.4,25,32,6,26,13,26,28,0,"FW,MF",25-29,Forward,Italy,Europe
2025,João Pedro,ITA,Cagliari,Serie A,2020,28.0,1992.0,36.1,13,6,2,6,5,2,27,7.4,25,32,6,26,13,26,28,0,"FW,MF",25-29,Forward,Italy,Europe
2025,João Pedro,ITA,Cagliari,Serie A,2020,28.0,1992.0,36.1,13,6,2,6,5,2,27,7.4,25,32,6,26,13,26,28,0,"FW,MF",25-29,Forward,Italy,Europe
2025,João Pedro,ITA,Cagliari,Serie A,2020,28.0,1992.0,36.1,13,6,2,6,5,2,27,7.4,25,32,6,26,13,26,28,0,"FW,MF",25-29,Forward,Italy,Europe
2026,Gianluca Pegolo,ITA,Sassuolo,Serie A,2020,39.0,1981.0,1.0,0,0,0,0,0,0,0,,0,0,0,0,0,0,1,0,GK,35-39,Goalkeeper,Italy,Europe
2027,Peter Pekarík,SVK,Hertha BSC,Bundesliga,2020,33.0,1986.0,18.8,24,18,17,7,0,17,31,54.8,14,19,8,11,27,51,41,0,DF,30-34,Defender,Slovakia,Europe
2028,Yohann Pelé,FRA,Marseille,Ligue 1,2020,37.0,1982.0,1.0,0,0,0,0,0,0,0,,0,0,0,0,0,0,0,0,GK,35-39,Goalkeeper,France,Europe
2029,Graziano Pellè,ITA,Parma,Serie A,2020,35.0,1985.0,6.8,2,2,0,1,1,1,8,12.5,7,3,0,3,2,4,8,0,FW,35-39,Forward,Italy,Europe
2030,Pietro Pellegri,ITA,Monaco,Ligue 1,2020,19.0,2001.0,2.6,2,1,0,2,0,0,0,,0,1,0,1,0,2,0,0,"FW,MF",Under 20,Forward,Italy,Europe
2031,Lorenzo Pellegrini,ITA,Roma,Serie A,2020,24.0,1996.0,28.9,40,24,13,20,7,21,60,35.0,39,37,2,35,42,82,23,1,MF,20-24,Midfielder,Italy,Europe
2032,Luca Pellegrini,ITA,Genoa,Serie A,2020,21.0,1999.0,7.1,9,6,6,2,1,4,10,40.0,6,11,2,9,8,17,13,1,"DF,MF",20-24,Defender,Italy,Europe
2033,Facundo Pellistri,URU,Alavés,La Liga,2020,18.0,2001.0,6.0,8,5,2,4,2,3,13,23.1,10,0,0,0,4,12,3,0,"MF,FW",Under 20,Midfielder,Uruguay,South America
2034,Andy Pelmard,FRA,Nice,Ligue 1,2020,20.0,2000.0,13.4,18,12,12,5,1,9,12,75.0,3,11,3,8,20,38,35,0,DF,20-24,Defender,France,Europe
2035,Lee Peltier,ENG,West Brom,Premier League,2020,33.0,1986.0,2.5,9,4,8,1,0,4,4,100.0,0,1,1,0,1,10,11,0,DF,30-34,Defender,England,Europe
2036,Federico Peluso,ITA,Sassuolo,Serie A,2020,36.0,1984.0,2.3,1,1,1,0,0,1,2,50.0,1,2,2,0,3,4,12,0,DF,35-39,Defender,Italy,Europe
2037,Timothee Pembele,FRA,Paris S-G,Ligue 1,2020,17.0,2002.0,4.3,8,7,4,4,0,5,14,35.7,9,4,0,4,5,13,8,1,DF,Under 20,Defender,France,Europe
2039,Philipp Pentke,GER,Hoffenheim,Bundesliga,2020,35.0,1985.0,3.0,0,0,0,0,0,0,0,,0,0,0,0,0,0,0,0,GK,35-39,Goalkeeper,Germany,Europe
2040,Nicolas Pépé,CIV,Arsenal,Premier League,2020,25.0,1995.0,18.0,20,15,8,6,6,8,23,34.8,15,16,1,15,12,32,19,0,FW,25-29,Forward,Ivory Coast,Africa
2042,Andreas Pereira,BRA,Lazio,Serie A,2020,24.0,1996.0,6.0,5,0,1,3,1,2,12,16.7,10,6,0,6,1,6,4,0,"FW,MF",20-24,Forward,Brazil,South America
2043,Danilo Pereira,POR,Paris S-G,Ligue 1,2020,28.0,1991.0,15.9,21,11,6,11,4,6,14,42.9,8,14,6,8,29,50,33,4,"MF,DF",25-29,Midfielder,Portugal,Europe
2044,Mathias Pereira Lage,POR,Angers,Ligue 1,2020,23.0,1996.0,16.3,29,17,12,15,2,10,40,25.0,30,21,4,17,15,44,16,0,"FW,MF",20-24,Forward,Portugal,Europe
2045,Matheus Pereira,BRA,West Brom,Premier League,2020,24.0,1996.0,28.6,26,15,14,10,2,12,54,22.2,42,18,0,18,29,55,16,0,"MF,FW",20-24,Midfielder,Brazil,South America
2045,Matheus Pereira,BRA,West Brom,Premier League,2020,24.0,1996.0,28.6,26,15,14,10,2,12,54,22.2,42,18,0,18,29,55,16,0,"MF,FW",20-24,Midfielder,Brazil,South America
2045,Matheus Pereira,BRA,West Brom,Premier League,2020,24.0,1996.0,28.6,26,15,14,10,2,12,54,22.2,42,18,0,18,29,55,16,0,"MF,FW",20-24,Midfielder,Brazil,South America
2045,Matheus Pereira,BRA,West Brom,Premier League,2020,24.0,1996.0,28.6,26,15,14,10,2,12,54,22.2,42,18,0,18,29,55,16,0,"MF,FW",20-24,Midfielder,Brazil,South America
2045,Matheus Pereira,BRA,West Brom,Premier League,2020,24.0,1996.0,28.6,26,15,14,10,2,12,54,22.2,42,18,0,18,29,55,16,0,"MF,FW",20-24,Midfielder,Brazil,South America
2045,Matheus Pereira,BRA,West Brom,Premier League,2020,24.0,1996.0,28.6,26,15,14,10,2,12,54,22.2,42,18,0,18,29,55,16,0,"MF,FW",20-24,Midfielder,Brazil,South America
2045,Matheus Pereira,BRA,West Brom,Premier League,2020,24.0,1996.0,28.6,26,15,14,10,2,12,54,22.2,42,18,0,18,29,55,16,0,"MF,FW",20-24,Midfielder,Brazil,South America
2045,Matheus Pereira,BRA,West Brom,Premier League,2020,24.0,1996.0,28.6,26,15,14,10,2,12,54,22.2,42,18,0,18,29,55,16,0,"MF,FW",20-24,Midfielder,Brazil,South America
2045,Matheus Pereira,BRA,West Brom,Premier League,2020,24.0,1996.0,28.6,26,15,14,10,2,12,54,22.2,42,18,0,18,29,55,16,0,"MF,FW",20-24,Midfielder,Brazil,South America
2046,Pedro Pereira,POR,Crotone,Serie A,2020,22.0,1998.0,28.3,50,32,29,17,4,21,40,52.5,19,33,11,22,19,69,61,0,DF,20-24,Defender,Portugal,Europe
2046,Pedro Pereira,POR,Crotone,Serie A,2020,22.0,1998.0,28.3,50,32,29,17,4,21,40,52.5,19,33,11,22,19,69,61,0,DF,20-24,Defender,Portugal,Europe
2046,Pedro Pereira,POR,Crotone,Serie A,2020,22.0,1998.0,28.3,50,32,29,17,4,21,40,52.5,19,33,11,22,19,69,61,0,DF,20-24,Defender,Portugal,Europe
2046,Pedro Pereira,POR,Crotone,Serie A,2020,22.0,1998.0,28.3,50,32,29,17,4,21,40,52.5,19,33,11,22,19,69,61,0,DF,20-24,Defender,Portugal,Europe
2047,Ricardo Pereira,POR,Leicester City,Premier League,2020,26.0,1993.0,10.7,31,22,16,8,7,14,35,40.0,21,24,1,23,15,46,23,0,"DF,FW",25-29,Defender,Portugal,Europe
2048,Gastón Pereiro,URU,Cagliari,Serie A,2020,25.0,1995.0,3.0,3,1,2,1,0,1,2,50.0,1,2,0,2,1,4,2,1,"MF,DF",25-29,Midfielder,Uruguay,South America
24,Adrián,ESP,Liverpool,Premier League,2020,33.0,1987.0,3.0,0,0,0,0,0,0,0,,0,0,0,0,0,0,3,1,GK,30-34,Goalkeeper,Spain,Europe
25,Martin Agirregabiria,ESP,Alavés,La Liga,2020,24.0,1996.0,17.3,32,18,17,12,3,17,33,51.5,16,9,3,6,27,59,36,0,"DF,MF",20-24,Defender,Spain,Europe
51,Jony Álamo,ESP,Elche,La Liga,2020,18.0,2001.0,0.8,2,1,1,0,1,0,1,0.0,1,0,0,0,1,3,0,0,MF,Under 20,Midfielder,Spain,Europe
53,Jordi Alba,ESP,Barcelona,La Liga,2020,31.0,1989.0,33.6,45,30,22,16,7,24,52,46.2,28,21,2,19,49,94,48,0,"DF,FW",30-34,Defender,Spain,Europe
54,Luis Alberto,ESP,Lazio,Serie A,2020,27.0,1992.0,29.1,43,24,15,19,9,15,73,20.5,58,41,2,39,13,56,11,1,MF,25-29,Midfielder,Spain,Europe
55,Raúl Albiol,ESP,Villarreal,La Liga,2020,34.0,1985.0,34.6,22,15,19,3,0,13,18,72.2,5,32,22,10,22,44,146,2,DF,30-34,Defender,Spain,Europe
57,Paco Alcácer,ESP,Villarreal,La Liga,2020,26.0,1993.0,17.2,6,3,1,2,3,3,7,42.9,4,8,0,8,9,15,6,0,FW,25-29,Forward,Spain,Europe
58,Pedro Alcalá,ESP,Cádiz,La Liga,2020,31.0,1989.0,10.1,8,4,6,2,0,3,5,60.0,2,19,13,6,16,24,50,0,DF,30-34,Defender,Spain,Europe
59,Thiago Alcántara,ESP,Liverpool,Premier League,2020,29.0,1991.0,20.6,61,36,20,30,11,17,49,34.7,32,26,0,26,30,91,14,0,MF,25-29,Midfielder,Spain,Europe
60,Rubén Alcaraz,ESP,Valladolid,La Liga,2020,29.0,1991.0,24.1,54,29,32,21,1,30,80,37.5,50,35,8,27,31,85,28,0,MF,25-29,Midfielder,Spain,Europe
63,Iván Alejo,ESP,Cádiz,La Liga,2020,25.0,1995.0,9.2,14,10,8,4,2,4,23,17.4,19,14,1,13,3,17,10,0,"MF,FW",25-29,Midfielder,Spain,Europe
64,Carles Aleñá,ESP,Barcelona,La Liga,2020,22.0,1998.0,0.5,1,0,1,0,0,0,0,,0,0,0,0,0,1,0,0,MF,20-24,Midfielder,Spain,Europe
65,Carles Aleñá,ESP,Getafe,La Liga,2020,22.0,1998.0,15.2,15,10,3,9,3,7,25,28.0,18,14,1,13,2,17,2,0,"MF,FW",20-24,Midfielder,Spain,Europe
68,Alfon,ESP,Celta Vigo,La Liga,2020,21.0,1999.0,0.4,0,0,0,0,0,0,0,,0,0,0,0,0,0,0,0,MF,20-24,Midfielder,Spain,Europe
77,Marcos Alonso,ESP,Chelsea,Premier League,2020,29.0,1990.0,10.7,13,3,6,4,3,7,14,50.0,7,12,1,11,12,25,30,0,DF,25-29,Defender,Spain,Europe
78,Sergio Álvarez,ESP,Eibar,La Liga,2020,28.0,1992.0,17.4,42,25,13,26,3,8,22,36.4,14,22,5,17,22,64,24,2,"MF,DF",25-29,Midfielder,Spain,Europe
78,Sergio Álvarez,ESP,Eibar,La Liga,2020,28.0,1992.0,17.4,42,25,13,26,3,8,22,36.4,14,22,5,17,22,64,24,2,"MF,DF",25-29,Midfielder,Spain,Europe
78,Sergio Álvarez,ESP,Eibar,La Liga,2020,28.0,1992.0,17.4,42,25,13,26,3,8,22,36.4,14,22,5,17,22,64,24,2,"MF,DF",25-29,Midfielder,Spain,Europe
78,Sergio Álvarez,ESP,Eibar,La Liga,2020,28.0,1992.0,17.4,42,25,13,26,3,8,22,36.4,14,22,5,17,22,64,24,2,"MF,DF",25-29,Midfielder,Spain,Europe
79,Yeray Álvarez,ESP,Athletic Club,La Liga,2020,25.0,1995.0,21.6,19,12,11,8,0,9,21,42.9,12,12,5,7,53,72,73,0,DF,25-29,Defender,Spain,Europe
92,Jon Ander Garrido,ESP,Cádiz,La Liga,2020,30.0,1989.0,8.9,18,10,8,7,3,10,26,38.5,16,12,4,8,14,32,13,0,MF,30-34,Midfielder,Spain,Europe
104,Ángel,ESP,Granada,La Liga,2020,18.0,2002.0,1.0,0,0,0,0,0,0,0,,0,0,0,0,0,0,1,0,GK,Under 20,Goalkeeper,Spain,Europe
105,José Ángel,ESP,Eibar,La Liga,2020,30.0,1989.0,10.0,15,8,9,4,2,8,12,66.7,4,7,0,7,13,28,17,1,DF,30-34,Defender,Spain,Europe
106,Miguel Ángel Rubio,ESP,Valladolid,La Liga,2020,22.0,1998.0,1.5,0,0,0,0,0,0,0,,0,2,2,0,3,3,11,0,DF,20-24,Defender,Spain,Europe
107,Angeliño,ESP,RB Leipzig,Bundesliga,2020,23.0,1997.0,24.0,31,19,10,18,3,13,24,54.2,11,22,1,21,30,61,40,0,"DF,FW",20-24,Defender,Spain,Europe
118,Aritz Arambarri,ESP,Real Sociedad,La Liga,2020,22.0,1998.0,0.3,1,1,0,1,0,1,2,50.0,1,0,0,0,0,1,0,0,DF,20-24,Defender,Spain,Europe
124,Anaitz Arbilla,ESP,Eibar,La Liga,2020,33.0,1987.0,31.2,45,26,31,11,3,27,54,50.0,27,36,11,25,69,114,73,1,DF,30-34,Defender,Spain,Europe
128,Unai Arietaleanizbeaskoa,ESP,Eibar,La Liga,2020,21.0,1999.0,0.5,1,0,0,0,1,0,0,,0,0,0,0,0,1,0,0,"FW,MF",20-24,Forward,Spain,Europe
133,Sergio Arribas,ESP,Real Madrid,La Liga,2020,18.0,2001.0,1.5,3,1,2,1,0,1,3,33.3,2,2,0,2,4,7,2,0,"MF,FW",Under 20,Midfielder,Spain,Europe
133,Sergio Arribas,ESP,Real Madrid,La Liga,2020,18.0,2001.0,1.5,3,1,2,1,0,1,3,33.3,2,2,0,2,4,7,2,0,"MF,FW",Under 20,Midfielder,Spain,Europe
133,Sergio Arribas,ESP,Real Madrid,La Liga,2020,18.0,2001.0,1.5,3,1,2,1,0,1,3,33.3,2,2,0,2,4,7,2,0,"MF,FW",Under 20,Midfielder,Spain,Europe
133,Sergio Arribas,ESP,Real Madrid,La Liga,2020,18.0,2001.0,1.5,3,1,2,1,0,1,3,33.3,2,2,0,2,4,7,2,0,"MF,FW",Under 20,Midfielder,Spain,Europe
134,Kepa Arrizabalaga,ESP,Chelsea,Premier League,2020,25.0,1994.0,6.5,0,0,0,0,0,0,1,0.0,1,0,0,0,0,0,0,3,GK,25-29,Goalkeeper,Spain,Europe
138,Sergio Asenjo,ESP,Villarreal,La Liga,2020,31.0,1989.0,36.0,0,0,0,0,0,0,1,0.0,1,0,0,0,0,0,13,2,GK,30-34,Goalkeeper,Spain,Europe
139,Marco Asensio,ESP,Real Madrid,La Liga,2020,24.0,1996.0,20.8,12,6,7,4,1,3,24,12.5,21,15,0,15,11,23,10,0,"FW,MF",20-24,Forward,Spain,Europe
140,Kristoffer Askildsen,NOR,Sampdoria,Serie A,2020,19.0,2001.0,1.1,0,0,0,0,0,0,0,,0,2,0,2,3,3,3,0,MF,Under 20,Midfielder,Norway,Europe
141,Iago Aspas,ESP,Celta Vigo,La Liga,2020,32.0,1987.0,31.8,11,3,2,7,2,2,23,8.7,21,25,2,23,16,27,21,0,FW,30-34,Forward,Spain,Europe
144,Miguel Atienza,ESP,Eibar,La Liga,2020,21.0,1999.0,9.3,20,9,5,15,0,8,23,34.8,15,14,1,13,9,29,12,0,MF,20-24,Midfielder,Spain,Europe
159,César Azpilicueta,ESP,Chelsea,Premier League,2020,30.0,1989.0,24.3,53,28,22,24,7,19,37,51.4,18,30,5,25,28,81,62,2,DF,30-34,Defender,Spain,Europe
164,Édgar Badía,ESP,Elche,La Liga,2020,28.0,1992.0,30.0,1,0,1,0,0,1,3,33.3,2,0,0,0,0,1,17,3,GK,25-29,Goalkeeper,Spain,Europe
166,Alex Baena,ESP,Villarreal,La Liga,2020,19.0,2001.0,1.5,4,3,1,2,1,1,3,33.3,2,1,1,0,1,5,1,0,MF,Under 20,Midfielder,Spain,Europe
167,Miguel Baeza,ESP,Celta Vigo,La Liga,2020,20.0,2000.0,6.0,7,6,5,2,0,5,13,38.5,8,3,0,3,3,10,2,0,"MF,FW",20-24,Midfielder,Spain,Europe
181,Mikel Balenziaga,ESP,Athletic Club,La Liga,2020,32.0,1988.0,18.8,26,15,11,12,3,9,18,50.0,9,22,7,15,7,33,46,0,DF,30-34,Defender,Spain,Europe
192,Antonín Barák,CZE,Hellas Verona,Serie A,2020,25.0,1994.0,30.7,30,19,8,16,6,14,47,29.8,33,26,7,19,12,42,38,1,MF,25-29,Midfielder,Czech Republic,Europe
195,Barcia,ESP,Granada,La Liga,2020,19.0,2000.0,1.0,1,1,1,0,0,0,0,,0,1,1,0,3,4,9,0,DF,Under 20,Defender,Spain,Europe
201,Kike Barja,ESP,Osasuna,La Liga,2020,23.0,1997.0,15.9,10,5,6,1,3,5,24,20.8,19,10,1,9,16,26,8,0,"MF,FW",20-24,Midfielder,Spain,Europe
207,Marc Baró,ESP,Cádiz,La Liga,2020,20.0,1999.0,1.0,2,1,2,0,0,0,2,0.0,2,1,0,1,2,4,2,1,DF,20-24,Defender,Spain,Europe
208,Antonio Barragán,ESP,Elche,La Liga,2020,33.0,1987.0,24.8,28,14,21,5,2,12,21,57.1,9,22,8,14,33,61,67,1,DF,30-34,Defender,Spain,Europe
211,Ander Barrenetxea,ESP,Real Sociedad,La Liga,2020,18.0,2001.0,14.5,29,19,5,18,6,9,24,37.5,15,20,0,20,6,35,8,0,"MF,FW",Under 20,Midfielder,Spain,Europe
216,Marc Bartra,ESP,Betis,La Liga,2020,29.0,1991.0,18.8,27,16,18,8,1,12,22,54.5,10,19,5,14,40,67,74,3,DF,25-29,Defender,Spain,Europe
220,Álvaro Bastida,ESP,Cádiz,La Liga,2020,16.0,2004.0,0.4,0,0,0,0,0,0,0,,0,0,0,0,0,0,0,0,MF,Under 20,Midfielder,Spain,Europe
230,Jon Bautista,ESP,Real Sociedad,La Liga,2020,25.0,1995.0,4.1,5,3,0,2,3,0,3,0.0,3,3,1,2,2,7,4,0,FW,25-29,Forward,Spain,Europe
233,Ihlas Bebou,TOG,Hoffenheim,Bundesliga,2020,26.0,1994.0,24.4,24,9,5,10,9,8,14,57.1,6,18,4,14,17,41,16,0,"FW,MF",25-29,Forward,Togo,Africa
237,Jan Bednarek,POL,Southampton,Premier League,2020,24.0,1996.0,34.4,37,19,25,11,1,25,49,51.0,24,44,27,17,84,121,132,0,DF,20-24,Defender,Poland,Europe
248,Héctor Bellerín,ESP,Arsenal,Premier League,2020,25.0,1995.0,23.2,29,19,14,12,3,12,41,29.3,29,26,8,18,33,62,33,0,"DF,MF",25-29,Defender,Spain,Europe
251,Fran Beltrán,ESP,Celta Vigo,La Liga,2020,21.0,1999.0,15.5,30,22,15,12,3,8,24,33.3,16,14,1,13,16,46,24,0,"MF,FW",20-24,Midfielder,Spain,Europe
265,Sergio Benito,ESP,Valladolid,La Liga,2020,21.0,1999.0,0.0,0,0,0,0,0,0,0,,0,0,0,0,0,0,0,0,FW,20-24,Forward,Spain,Europe
281,Yuri Berchiche,ESP,Athletic Club,La Liga,2020,30.0,1990.0,18.7,24,19,14,5,5,10,24,41.7,14,14,0,14,11,35,29,0,DF,30-34,Defender,Spain,Europe
282,Álex Berenguer,ESP,Torino,Serie A,2020,25.0,1995.0,1.5,2,0,0,0,2,2,5,40.0,3,2,0,2,0,2,1,0,MF,25-29,Midfielder,Spain,Europe
283,Álex Berenguer,ESP,Athletic Club,La Liga,2020,25.0,1995.0,25.3,47,31,21,20,6,9,51,17.6,42,48,3,45,18,65,27,0,"MF,FW",25-29,Midfielder,Spain,Europe
284,Bartosz Bereszyński,POL,Sampdoria,Serie A,2020,28.0,1992.0,29.0,66,44,37,22,7,41,73,56.2,32,40,20,20,42,108,88,0,DF,25-29,Defender,Poland,Europe
286,Sander Berge,NOR,Sheffield Utd,Premier League,2020,22.0,1998.0,12.4,16,7,8,5,3,7,15,46.7,8,11,2,9,4,20,18,0,MF,20-24,Midfielder,Norway,Europe
293,Juan Bernat,ESP,Paris S-G,Ligue 1,2020,27.0,1993.0,2.2,5,3,0,4,1,3,5,60.0,2,4,0,4,1,6,6,0,DF,25-29,Defender,Spain,Europe
298,Loïc Bessile,TOG,Bordeaux,Ligue 1,2020,21.0,1999.0,1.0,0,0,0,0,0,0,0,,0,2,1,1,1,1,3,0,DF,20-24,Defender,Togo,Africa
301,Bartosz Białek,POL,Wolfsburg,Bundesliga,2020,18.0,2001.0,3.0,6,5,1,4,1,4,4,100.0,0,5,1,4,3,9,4,0,"FW,MF",Under 20,Forward,Poland,Europe
303,Pedro Bigas,ESP,Eibar,La Liga,2020,29.0,1990.0,17.0,11,9,7,4,0,7,14,50.0,7,12,6,6,23,34,54,0,DF,25-29,Defender,Spain,Europe
309,Alejandro Blanco,ESP,Valencia,La Liga,2020,21.0,1998.0,6.4,8,4,4,4,0,3,18,16.7,15,5,0,5,8,16,9,0,MF,20-24,Midfielder,Spain,Europe
310,Antonio Blanco,ESP,Real Madrid,La Liga,2020,20.0,2000.0,2.4,7,2,4,2,1,3,7,42.9,4,6,2,4,3,10,5,0,"MF,FW",20-24,Midfielder,Spain,Europe
311,Rubén Blanco,ESP,Celta Vigo,La Liga,2020,25.0,1995.0,18.2,0,0,0,0,0,0,0,,0,0,0,0,0,0,7,3,GK,25-29,Goalkeeper,Spain,Europe
313,Alejandro Blesa,ESP,Levante,La Liga,2020,18.0,2002.0,0.1,0,0,0,0,0,0,0,,0,0,0,0,0,0,0,0,MF,Under 20,Midfielder,Spain,Europe
341,Ismaël Boura,COM,Lens,Ligue 1,2020,19.0,2000.0,9.2,11,7,8,2,1,3,9,33.3,6,7,2,5,21,32,12,0,DF,Under 20,Defender,Comoros,Africa
356,Darko Brašanac,SRB,Osasuna,La Liga,2020,28.0,1992.0,10.1,10,6,6,4,0,5,16,31.3,11,8,1,7,7,17,10,0,MF,25-29,Midfielder,Serbia,Europe
358,Álvaro Bravo,ESP,Granada,La Liga,2020,22.0,1998.0,0.2,1,1,1,0,0,1,2,50.0,1,0,0,0,1,2,0,0,MF,20-24,Midfielder,Spain,Europe
387,Burgui,ESP,Alavés,La Liga,2020,26.0,1993.0,0.2,3,1,2,1,0,1,1,100.0,0,0,0,0,0,3,0,0,MF,25-29,Midfielder,Spain,Europe
396,Sergio Busquets,ESP,Barcelona,La Liga,2020,32.0,1988.0,28.0,63,35,21,29,13,27,76,35.5,49,27,4,23,53,116,18,2,MF,30-34,Midfielder,Spain,Europe
400,Marcin Bułka,POL,Paris S-G,Ligue 1,2020,20.0,1999.0,1.0,0,0,0,0,0,0,0,,0,0,0,0,0,0,0,1,GK,20-24,Goalkeeper,Poland,Europe
412,Cala,ESP,Cádiz,La Liga,2020,30.0,1989.0,25.2,21,12,15,6,0,11,21,52.4,10,18,8,10,35,56,91,0,DF,30-34,Defender,Spain,Europe
424,José Callejón,ESP,Fiorentina,Serie A,2020,33.0,1987.0,7.4,10,7,0,6,4,5,9,55.6,4,4,1,3,4,14,5,0,"FW,MF",30-34,Forward,Spain,Europe
427,Dani Calvo,ESP,Elche,La Liga,2020,26.0,1994.0,19.8,20,13,13,7,0,7,10,70.0,3,18,12,6,11,31,71,0,DF,25-29,Defender,Spain,Europe
431,José Campaña,ESP,Levante,La Liga,2020,27.0,1993.0,8.3,14,6,3,6,5,5,14,35.7,9,2,0,2,13,27,4,0,MF,25-29,Midfielder,Spain,Europe
433,Sergio Canales,ESP,Betis,La Liga,2020,29.0,1991.0,27.8,16,9,9,6,1,3,21,14.3,18,18,0,18,13,29,5,0,"MF,FW",25-29,Midfielder,Spain,Europe
436,Álex Cantero,ESP,Levante,La Liga,2020,20.0,2000.0,2.6,2,1,0,2,0,1,2,50.0,1,1,0,1,0,2,3,0,FW,20-24,Forward,Spain,Europe
437,Ander Capa,ESP,Athletic Club,La Liga,2020,28.0,1992.0,23.7,37,18,22,13,2,18,37,48.6,19,21,8,13,25,62,57,0,DF,25-29,Defender,Spain,Europe
445,Isaac Carcelen,ESP,Cádiz,La Liga,2020,27.0,1993.0,28.7,68,43,36,25,7,33,60,55.0,27,37,12,25,49,117,89,0,DF,25-29,Defender,Spain,Europe
446,Cárdenas,ESP,Levante,La Liga,2020,23.0,1997.0,8.0,0,0,0,0,0,0,1,0.0,1,0,0,0,3,3,5,1,GK,20-24,Goalkeeper,Spain,Europe
448,Marc Cardona,ESP,Osasuna,La Liga,2020,25.0,1995.0,0.6,1,0,1,0,0,1,1,100.0,0,0,0,0,0,1,0,0,"FW,DF",25-29,Forward,Spain,Europe
450,Juan Carlos,ESP,Huesca,La Liga,2020,29.0,1991.0,3.2,5,3,4,1,0,2,15,13.3,13,7,0,7,1,6,1,0,"MF,FW",25-29,Midfielder,Spain,Europe
450,Juan Carlos,ESP,Huesca,La Liga,2020,29.0,1991.0,3.2,5,3,4,1,0,2,15,13.3,13,7,0,7,1,6,1,0,"MF,FW",25-29,Midfielder,Spain,Europe
450,Juan Carlos,ESP,Huesca,La Liga,2020,29.0,1991.0,3.2,5,3,4,1,0,2,15,13.3,13,7,0,7,1,6,1,0,"MF,FW",25-29,Midfielder,Spain,Europe
450,Juan Carlos,ESP,Huesca,La Liga,2020,29.0,1991.0,3.2,5,3,4,1,0,2,15,13.3,13,7,0,7,1,6,1,0,"MF,FW",25-29,Midfielder,Spain,Europe
453,Sergio Carreira,ESP,Celta Vigo,La Liga,2020,19.0,2000.0,2.9,3,0,2,1,0,1,1,100.0,0,2,0,2,1,4,7,0,DF,Under 20,Defender,Spain,Europe
457,Dani Carvajal,ESP,Real Madrid,La Liga,2020,28.0,1992.0,10.6,27,20,12,10,5,11,20,55.0,9,19,1,18,13,40,27,0,DF,25-29,Defender,Spain,Europe
461,Matty Cash,POL,Aston Villa,Premier League,2020,22.0,1997.0,26.4,71,40,43,22,6,41,74,55.4,33,50,11,39,60,131,95,0,DF,20-24,Defender,Poland,Europe
462,Kiko Casilla,ESP,Leeds United,Premier League,2020,33.0,1986.0,3.0,0,0,0,0,0,0,0,,0,0,0,0,0,0,0,0,GK,30-34,Goalkeeper,Spain,Europe
469,Samu Castillejo,ESP,Milan,Serie A,2020,25.0,1995.0,13.1,24,12,9,14,1,14,40,35.0,26,21,0,21,6,30,9,0,FW,25-29,Forward,Spain,Europe
471,Jonny Castro,ESP,Wolves,Premier League,2020,26.0,1994.0,5.5,11,5,6,4,1,6,13,46.2,7,9,3,6,9,20,7,0,"MF,DF",25-29,Midfielder,Spain,Europe
476,Dani Ceballos,ESP,Arsenal,Premier League,2020,23.0,1996.0,17.9,37,22,20,11,6,21,51,41.2,30,23,6,17,35,72,14,1,MF,20-24,Midfielder,Spain,Europe
484,Sava Cestic,SRB,Köln,Bundesliga,2020,19.0,2001.0,10.0,20,9,12,6,2,8,17,47.1,9,13,4,9,18,38,40,0,DF,Under 20,Defender,Serbia,Europe
500,Chema,ESP,Getafe,La Liga,2020,28.0,1992.0,6.2,11,5,6,5,0,5,7,71.4,2,1,0,1,10,21,23,0,"DF,MF",25-29,Defender,Spain,Europe
508,Pedro Chirivella,ESP,Nantes,Ligue 1,2020,23.0,1997.0,25.3,26,8,7,13,6,14,49,28.6,35,23,4,19,41,67,19,0,MF,20-24,Midfielder,Spain,Europe
517,Víctor Chust,ESP,Real Madrid,La Liga,2020,20.0,2000.0,1.1,1,1,0,1,0,0,2,0.0,2,2,2,0,1,2,5,0,DF,20-24,Defender,Spain,Europe
519,Cifu,ESP,Elche,La Liga,2020,29.0,1990.0,5.0,10,7,7,3,0,7,13,53.8,6,5,1,4,8,18,10,0,DF,25-29,Defender,Spain,Europe
520,Alberto Cifuentes,ESP,Cádiz,La Liga,2020,41.0,1979.0,2.0,0,0,0,0,0,0,0,,0,0,0,0,0,0,0,0,GK,Over 40,Goalkeeper,Spain,Europe
528,Carlos Clerc,ESP,Levante,La Liga,2020,28.0,1992.0,30.9,56,29,33,16,7,22,39,56.4,17,26,4,22,37,93,55,1,DF,25-29,Defender,Spain,Europe
532,Coke,ESP,Levante,La Liga,2020,33.0,1987.0,9.3,24,10,14,7,3,14,27,51.9,13,13,1,12,14,38,27,0,DF,30-34,Defender,Spain,Europe
550,Iñigo Córdoba,ESP,Athletic Club,La Liga,2020,23.0,1997.0,1.1,0,0,0,0,0,0,3,0.0,3,4,0,4,2,2,1,0,"FW,MF",20-24,Forward,Spain,Europe
551,Iñigo Córdoba,ESP,Alavés,La Liga,2020,23.0,1997.0,2.4,6,4,1,3,2,2,10,20.0,8,7,0,7,3,9,2,0,MF,20-24,Midfielder,Spain,Europe
559,Rober Correa,ESP,Eibar,La Liga,2020,27.0,1992.0,12.6,16,9,8,6,2,8,12,66.7,4,9,1,8,20,36,31,0,DF,25-29,Defender,Spain,Europe
565,Diego Costa,ESP,Atlético Madrid,La Liga,2020,31.0,1988.0,2.3,1,0,1,0,0,1,3,33.3,2,0,0,0,0,1,2,0,FW,30-34,Forward,Spain,Europe
565,Diego Costa,ESP,Atlético Madrid,La Liga,2020,31.0,1988.0,2.3,1,0,1,0,0,1,3,33.3,2,0,0,0,0,1,2,0,FW,30-34,Forward,Spain,Europe
565,Diego Costa,ESP,Atlético Madrid,La Liga,2020,31.0,1988.0,2.3,1,0,1,0,0,1,3,33.3,2,0,0,0,0,1,2,0,FW,30-34,Forward,Spain,Europe
565,Diego Costa,ESP,Atlético Madrid,La Liga,2020,31.0,1988.0,2.3,1,0,1,0,0,1,3,33.3,2,0,0,0,0,1,2,0,FW,30-34,Forward,Spain,Europe
569,Jaume Costa,ESP,Villarreal,La Liga,2020,32.0,1988.0,3.9,10,6,4,6,0,7,9,77.8,2,7,1,6,6,16,8,0,"DF,MF",30-34,Defender,Spain,Europe
573,Vladimír Coufal,CZE,West Ham,Premier League,2020,27.0,1992.0,33.9,73,36,50,15,8,52,89,58.4,37,41,7,34,41,114,102,1,DF,25-29,Defender,Czech Republic,Europe
588,Juan Cruz Armada,ESP,Osasuna,La Liga,2020,28.0,1992.0,21.8,36,22,17,16,3,19,35,54.3,16,19,5,14,15,51,50,0,DF,25-29,Defender,Spain,Europe
591,Sergio Cubero Ezcurra,ESP,Eibar,La Liga,2020,20.0,1999.0,0.0,0,0,0,0,0,0,0,,0,0,0,0,0,0,0,0,MF,20-24,Midfielder,Spain,Europe
593,Marc Cucurella,ESP,Getafe,La Liga,2020,22.0,1998.0,36.0,64,51,19,40,5,25,66,37.9,41,45,4,41,40,104,27,0,MF,20-24,Midfielder,Spain,Europe
612,Stuart Dallas,NIR,Leeds United,Premier League,2020,29.0,1991.0,37.9,74,45,46,22,6,30,88,34.1,58,41,3,38,44,118,52,1,"MF,DF",25-29,Midfielder,Northern Ireland,Europe
623,Vladimír Darida,CZE,Hertha BSC,Bundesliga,2020,29.0,1990.0,21.1,34,19,11,19,4,9,31,29.0,22,34,2,32,27,61,18,0,MF,25-29,Midfielder,Czech Republic,Europe
633,Paweł Dawidowicz,POL,Hellas Verona,Serie A,2020,25.0,1995.0,20.7,42,28,30,10,2,14,24,58.3,10,28,19,9,27,69,62,1,DF,25-29,Defender,Poland,Europe
666,Kévin Denkey,TOG,Nîmes,Ligue 1,2020,19.0,2000.0,5.8,4,2,0,3,1,0,3,0.0,3,2,0,2,1,5,2,0,FW,Under 20,Forward,Togo,Africa
678,Gerard Deulofeu,ESP,Udinese,Serie A,2020,26.0,1994.0,6.6,2,2,1,1,0,2,12,16.7,10,2,0,2,3,5,0,0,"FW,MF",25-29,Forward,Spain,Europe
706,Víctor Díaz,ESP,Granada,La Liga,2020,32.0,1988.0,9.2,21,10,13,6,2,10,19,52.6,9,14,8,6,16,37,39,0,DF,30-34,Defender,Spain,Europe
729,Djené,TOG,Getafe,La Liga,2020,28.0,1991.0,32.7,61,39,31,26,4,26,34,76.5,8,24,11,13,42,103,96,0,DF,25-29,Defender,Togo,Africa
734,Marko Dmitrović,SRB,Eibar,La Liga,2020,28.0,1992.0,34.7,4,3,4,0,0,2,4,50.0,2,0,0,0,0,4,16,2,GK,25-29,Goalkeeper,Serbia,Europe
741,Jaume Doménech,ESP,Valencia,La Liga,2020,29.0,1990.0,28.0,1,1,1,0,0,1,2,50.0,1,1,0,1,0,1,16,2,GK,25-29,Goalkeeper,Spain,Europe
742,Carlos Dominguez,ESP,Celta Vigo,La Liga,2020,19.0,2001.0,4.0,5,4,4,1,0,3,6,50.0,3,5,3,2,6,11,24,0,DF,Under 20,Defender,Spain,Europe
744,John Donald,ESP,Elche,La Liga,2020,19.0,2000.0,0.6,0,0,0,0,0,0,0,,0,0,0,0,0,0,1,0,"DF,MF",Under 20,Defender,Spain,Europe
758,Bartłomiej Drągowski,POL,Fiorentina,Serie A,2020,22.0,1997.0,35.0,1,0,1,0,0,1,1,100.0,0,0,0,0,1,2,13,1,GK,20-24,Goalkeeper,Poland,Europe
768,Rubén Duarte,ESP,Alavés,La Liga,2020,24.0,1995.0,28.3,55,30,28,21,6,23,52,44.2,29,44,6,38,66,121,72,0,DF,20-24,Defender,Spain,Europe
772,Unai Dufur,ESP,Eibar,La Liga,2020,21.0,1999.0,0.7,2,2,2,0,0,2,4,50.0,2,0,0,0,1,3,0,0,DF,20-24,Defender,Spain,Europe
780,Hugo Duro,ESP,Real Madrid,La Liga,2020,20.0,1999.0,0.6,0,0,0,0,0,0,0,,0,1,0,1,0,0,0,0,FW,20-24,Forward,Spain,Europe
802,Aritz Elustondo,ESP,Real Sociedad,La Liga,2020,26.0,1994.0,20.9,30,16,21,7,2,18,22,81.8,4,12,5,7,15,45,63,0,DF,25-29,Defender,Spain,Europe
812,Sergi Enrich,ESP,Eibar,La Liga,2020,30.0,1990.0,15.6,21,15,6,7,8,9,22,40.9,13,11,0,11,6,27,5,0,FW,30-34,Forward,Spain,Europe
817,Aarón Escandell,ESP,Granada,La Liga,2020,24.0,1995.0,5.0,1,1,1,0,0,1,1,100.0,0,0,0,0,0,1,6,0,GK,20-24,Goalkeeper,Spain,Europe
818,Dani Escriche,ESP,Huesca,La Liga,2020,22.0,1998.0,9.5,9,7,5,2,2,3,10,30.0,7,11,0,11,8,17,5,0,"FW,MF",20-24,Forward,Spain,Europe
819,Sergio Escudero,ESP,Sevilla,La Liga,2020,30.0,1989.0,6.3,12,8,6,5,1,6,12,50.0,6,5,2,3,9,21,7,0,DF,30-34,Defender,Spain,Europe
821,Vicente Esquerdo,ESP,Valencia,La Liga,2020,21.0,1999.0,2.6,7,4,5,2,0,4,6,66.7,2,4,2,2,8,15,1,0,MF,20-24,Midfielder,Spain,Europe
825,Xabier Etxeita,ESP,Getafe,La Liga,2020,32.0,1987.0,9.8,8,4,5,3,0,7,14,50.0,7,6,3,3,13,21,38,0,DF,30-34,Defender,Spain,Europe
826,Jonny Evans,NIR,Leicester City,Premier League,2020,32.0,1988.0,27.5,25,12,22,2,1,14,20,70.0,6,8,3,5,46,71,98,1,DF,30-34,Defender,Northern Ireland,Europe
827,Edu Expósito,ESP,Eibar,La Liga,2020,23.0,1996.0,27.3,51,30,16,31,4,20,66,30.3,46,25,4,21,22,73,17,0,MF,20-24,Midfielder,Spain,Europe
830,Jokin Ezkieta,ESP,Athletic Club,La Liga,2020,23.0,1996.0,1.0,0,0,0,0,0,0,0,,0,0,0,0,0,0,0,0,GK,20-24,Goalkeeper,Spain,Europe
831,Łukasz Fabiański,POL,West Ham,Premier League,2020,35.0,1985.0,35.0,1,0,1,0,0,1,1,100.0,0,1,0,1,1,2,12,3,GK,35-39,Goalkeeper,Poland,Europe
834,Cesc Fàbregas,ESP,Monaco,Ligue 1,2020,33.0,1987.0,9.7,20,12,6,9,5,9,22,40.9,13,11,1,10,13,33,3,0,"MF,FW",30-34,Midfielder,Spain,Europe
841,Fali,ESP,Cádiz,La Liga,2020,26.0,1993.0,29.3,42,25,24,15,3,16,37,43.2,21,28,15,13,32,74,119,0,"DF,MF",25-29,Defender,Spain,Europe
842,Iago Falque,ESP,Benevento,Serie A,2020,30.0,1990.0,4.0,4,2,2,2,0,1,6,16.7,5,4,1,3,0,4,1,0,"MF,FW",30-34,Midfielder,Spain,Europe
851,Ansu Fati,ESP,Barcelona,La Liga,2020,17.0,2002.0,4.8,9,4,2,4,3,2,10,20.0,8,4,0,4,3,12,1,0,FW,Under 20,Forward,Spain,Europe
863,Aitor Fernández,ESP,Levante,La Liga,2020,29.0,1991.0,29.0,0,0,0,0,0,0,0,,0,0,0,0,2,2,17,1,GK,25-29,Goalkeeper,Spain,Europe
863,Aitor Fernández,ESP,Levante,La Liga,2020,29.0,1991.0,29.0,0,0,0,0,0,0,0,,0,0,0,0,2,2,17,1,GK,25-29,Goalkeeper,Spain,Europe
863,Aitor Fernández,ESP,Levante,La Liga,2020,29.0,1991.0,29.0,0,0,0,0,0,0,0,,0,0,0,0,2,2,17,1,GK,25-29,Goalkeeper,Spain,Europe
863,Aitor Fernández,ESP,Levante,La Liga,2020,29.0,1991.0,29.0,0,0,0,0,0,0,0,,0,0,0,0,2,2,17,1,GK,25-29,Goalkeeper,Spain,Europe
864,Álex Fernández,ESP,Cádiz,La Liga,2020,27.0,1992.0,21.6,19,9,8,8,3,8,30,26.7,22,14,1,13,22,41,15,0,MF,25-29,Midfielder,Spain,Europe
865,Álvaro Fernández,ESP,Huesca,La Liga,2020,22.0,1998.0,22.0,1,1,0,1,0,1,3,33.3,2,0,0,0,2,3,7,0,GK,20-24,Goalkeeper,Spain,Europe
865,Álvaro Fernández,ESP,Huesca,La Liga,2020,22.0,1998.0,22.0,1,1,0,1,0,1,3,33.3,2,0,0,0,2,3,7,0,GK,20-24,Goalkeeper,Spain,Europe
865,Álvaro Fernández,ESP,Huesca,La Liga,2020,22.0,1998.0,22.0,1,1,0,1,0,1,3,33.3,2,0,0,0,2,3,7,0,GK,20-24,Goalkeeper,Spain,Europe
865,Álvaro Fernández,ESP,Huesca,La Liga,2020,22.0,1998.0,22.0,1,1,0,1,0,1,3,33.3,2,0,0,0,2,3,7,0,GK,20-24,Goalkeeper,Spain,Europe
866,Andrés Fernández,ESP,Huesca,La Liga,2020,33.0,1986.0,16.0,0,0,0,0,0,0,0,,0,0,0,0,0,0,3,2,GK,30-34,Goalkeeper,Spain,Europe
868,Carlos Fernández,ESP,Sevilla,La Liga,2020,24.0,1996.0,1.6,1,0,1,0,0,0,2,0.0,2,3,1,2,1,2,0,0,FW,20-24,Forward,Spain,Europe
869,Carlos Fernández,ESP,Real Sociedad,La Liga,2020,24.0,1996.0,4.3,3,2,0,2,1,1,8,12.5,7,6,1,5,0,3,6,0,"FW,MF",20-24,Forward,Spain,Europe
871,Joaquín Fernández,ESP,Valladolid,La Liga,2020,24.0,1996.0,23.0,30,16,21,8,1,12,21,57.1,9,24,15,9,43,73,113,0,DF,20-24,Defender,Spain,Europe
871,Joaquín Fernández,ESP,Valladolid,La Liga,2020,24.0,1996.0,23.0,30,16,21,8,1,12,21,57.1,9,24,15,9,43,73,113,0,DF,20-24,Defender,Spain,Europe
871,Joaquín Fernández,ESP,Valladolid,La Liga,2020,24.0,1996.0,23.0,30,16,21,8,1,12,21,57.1,9,24,15,9,43,73,113,0,DF,20-24,Defender,Spain,Europe
871,Joaquín Fernández,ESP,Valladolid,La Liga,2020,24.0,1996.0,23.0,30,16,21,8,1,12,21,57.1,9,24,15,9,43,73,113,0,DF,20-24,Defender,Spain,Europe
875,David Ferreiro,ESP,Huesca,La Liga,2020,32.0,1988.0,28.1,25,12,12,8,5,8,49,16.3,41,21,1,20,25,50,15,0,"MF,FW",30-34,Midfielder,Spain,Europe
876,Salvador Ferrer,ESP,Spezia,Serie A,2020,22.0,1998.0,13.2,20,10,10,8,2,8,22,36.4,14,13,4,9,24,44,37,1,DF,20-24,Defender,Spain,Europe
880,Fidel,ESP,Elche,La Liga,2020,30.0,1989.0,26.6,46,30,28,15,3,25,64,39.1,39,22,2,20,16,62,14,0,"MF,DF",30-34,Midfielder,Spain,Europe
899,Ramón Folch,ESP,Elche,La Liga,2020,30.0,1989.0,0.0,0,0,0,0,0,0,0,,0,0,0,0,0,0,0,0,MF,30-34,Midfielder,Spain,Europe
902,José Fontán,ESP,Celta Vigo,La Liga,2020,20.0,2000.0,7.2,12,9,8,4,0,5,11,45.5,6,4,3,1,13,25,27,0,DF,20-24,Defender,Spain,Europe
905,Pablo Fornals,ESP,West Ham,Premier League,2020,24.0,1996.0,28.6,44,26,14,24,6,11,73,15.1,62,43,1,42,36,80,9,0,"FW,MF",20-24,Forward,Spain,Europe
926,Jorge de Frutos,ESP,Levante,La Liga,2020,23.0,1997.0,24.3,48,24,21,21,6,11,41,26.8,30,25,2,23,16,64,18,0,MF,20-24,Midfielder,Spain,Europe
936,Mijat Gaćinović,SRB,Hoffenheim,Bundesliga,2020,25.0,1995.0,9.1,18,10,6,11,1,9,24,37.5,15,13,0,13,18,36,15,0,"DF,MF",25-29,Defender,Serbia,Europe
941,Javi Galán,ESP,Huesca,La Liga,2020,25.0,1994.0,34.1,88,54,47,35,6,46,72,63.9,26,30,4,26,39,127,61,0,DF,25-29,Defender,Spain,Europe
943,Enric Gallego,ESP,Osasuna,La Liga,2020,33.0,1986.0,9.0,6,3,2,2,2,2,14,14.3,12,5,1,4,1,7,9,0,FW,30-34,Forward,Spain,Europe
947,Aleix García,ESP,Eibar,La Liga,2020,23.0,1997.0,4.9,5,4,2,2,1,1,10,10.0,9,5,0,5,8,13,2,0,MF,20-24,Midfielder,Spain,Europe
948,Borja García,ESP,Huesca,La Liga,2020,29.0,1990.0,12.4,13,7,4,6,3,6,12,50.0,6,12,0,12,10,23,4,1,"MF,FW",25-29,Midfielder,Spain,Europe
949,Dani García,ESP,Athletic Club,La Liga,2020,30.0,1990.0,21.3,39,19,10,23,6,15,46,32.6,31,20,7,13,33,72,34,0,MF,30-34,Midfielder,Spain,Europe
950,David García,ESP,Osasuna,La Liga,2020,26.0,1994.0,35.0,26,17,13,13,0,13,24,54.2,11,36,19,17,59,85,171,0,DF,25-29,Defender,Spain,Europe
950,David García,ESP,Osasuna,La Liga,2020,26.0,1994.0,35.0,26,17,13,13,0,13,24,54.2,11,36,19,17,59,85,171,0,DF,25-29,Defender,Spain,Europe
950,David García,ESP,Osasuna,La Liga,2020,26.0,1994.0,35.0,26,17,13,13,0,13,24,54.2,11,36,19,17,59,85,171,0,DF,25-29,Defender,Spain,Europe
950,David García,ESP,Osasuna,La Liga,2020,26.0,1994.0,35.0,26,17,13,13,0,13,24,54.2,11,36,19,17,59,85,171,0,DF,25-29,Defender,Spain,Europe
951,Eric García,ESP,Manchester City,Premier League,2020,19.0,2001.0,4.3,8,7,5,3,0,5,7,71.4,2,4,1,3,4,12,10,0,DF,Under 20,Defender,Spain,Europe
952,Manu García,ESP,Alavés,La Liga,2020,34.0,1986.0,12.5,24,13,10,13,1,8,35,22.9,27,16,1,15,12,36,21,0,MF,30-34,Midfielder,Spain,Europe
952,Manu García,ESP,Alavés,La Liga,2020,34.0,1986.0,12.5,24,13,10,13,1,8,35,22.9,27,16,1,15,12,36,21,0,MF,30-34,Midfielder,Spain,Europe
952,Manu García,ESP,Alavés,La Liga,2020,34.0,1986.0,12.5,24,13,10,13,1,8,35,22.9,27,16,1,15,12,36,21,0,MF,30-34,Midfielder,Spain,Europe
952,Manu García,ESP,Alavés,La Liga,2020,34.0,1986.0,12.5,24,13,10,13,1,8,35,22.9,27,16,1,15,12,36,21,0,MF,30-34,Midfielder,Spain,Europe
953,Raúl García,ESP,Valladolid,La Liga,2020,31.0,1989.0,5.6,10,8,5,5,0,6,20,30.0,14,5,1,4,9,19,10,0,"DF,MF",30-34,Defender,Spain,Europe
953,Raúl García,ESP,Valladolid,La Liga,2020,31.0,1989.0,5.6,10,8,5,5,0,6,20,30.0,14,5,1,4,9,19,10,0,"DF,MF",30-34,Defender,Spain,Europe
953,Raúl García,ESP,Valladolid,La Liga,2020,31.0,1989.0,5.6,10,8,5,5,0,6,20,30.0,14,5,1,4,9,19,10,0,"DF,MF",30-34,Defender,Spain,Europe
953,Raúl García,ESP,Valladolid,La Liga,2020,31.0,1989.0,5.6,10,8,5,5,0,6,20,30.0,14,5,1,4,9,19,10,0,"DF,MF",30-34,Defender,Spain,Europe
954,Raúl García,ESP,Athletic Club,La Liga,2020,34.0,1986.0,19.4,34,19,9,19,6,7,22,31.8,15,30,1,29,15,49,20,0,"FW,MF",30-34,Forward,Spain,Europe
954,Raúl García,ESP,Athletic Club,La Liga,2020,34.0,1986.0,19.4,34,19,9,19,6,7,22,31.8,15,30,1,29,15,49,20,0,"FW,MF",30-34,Forward,Spain,Europe
954,Raúl García,ESP,Athletic Club,La Liga,2020,34.0,1986.0,19.4,34,19,9,19,6,7,22,31.8,15,30,1,29,15,49,20,0,"FW,MF",30-34,Forward,Spain,Europe
954,Raúl García,ESP,Athletic Club,La Liga,2020,34.0,1986.0,19.4,34,19,9,19,6,7,22,31.8,15,30,1,29,15,49,20,0,"FW,MF",30-34,Forward,Spain,Europe
955,Rubén García,ESP,Osasuna,La Liga,2020,27.0,1993.0,30.2,50,29,21,22,7,14,45,31.1,31,28,2,26,29,79,20,0,"MF,FW",25-29,Midfielder,Spain,Europe
955,Rubén García,ESP,Osasuna,La Liga,2020,27.0,1993.0,30.2,50,29,21,22,7,14,45,31.1,31,28,2,26,29,79,20,0,"MF,FW",25-29,Midfielder,Spain,Europe
955,Rubén García,ESP,Osasuna,La Liga,2020,27.0,1993.0,30.2,50,29,21,22,7,14,45,31.1,31,28,2,26,29,79,20,0,"MF,FW",25-29,Midfielder,Spain,Europe
955,Rubén García,ESP,Osasuna,La Liga,2020,27.0,1993.0,30.2,50,29,21,22,7,14,45,31.1,31,28,2,26,29,79,20,0,"MF,FW",25-29,Midfielder,Spain,Europe
956,Sergi García,ESP,Alavés,La Liga,2020,21.0,1999.0,0.2,1,1,0,1,0,0,1,0.0,1,0,0,0,0,1,0,0,MF,20-24,Midfielder,Spain,Europe
957,Unai García,ESP,Osasuna,La Liga,2020,28.0,1992.0,13.8,19,9,14,4,1,9,15,60.0,6,16,8,8,14,33,40,0,DF,25-29,Defender,Spain,Europe
958,Mario Gaspar,ESP,Villarreal,La Liga,2020,29.0,1990.0,20.6,55,34,22,24,9,21,40,52.5,19,26,4,22,30,85,47,1,DF,25-29,Defender,Spain,Europe
964,David de Gea,ESP,Manchester Utd,Premier League,2020,29.0,1990.0,25.5,0,0,0,0,0,0,0,,0,0,0,0,0,0,8,3,GK,25-29,Goalkeeper,Spain,Europe
966,Theodor Gebre Selassie,CZE,Werder Bremen,Bundesliga,2020,33.0,1986.0,33.7,61,35,39,17,5,28,64,43.8,36,33,11,22,58,119,98,1,DF,30-34,Defender,Czech Republic,Europe
981,Rafał Gikiewicz,POL,Augsburg,Bundesliga,2020,32.0,1987.0,34.0,0,0,0,0,0,0,3,0.0,3,0,0,0,3,3,9,1,GK,30-34,Goalkeeper,Poland,Europe
982,Bryan Gil,ESP,Sevilla,La Liga,2020,19.0,2001.0,0.1,1,1,0,1,0,0,0,,0,0,0,0,0,1,0,0,FW,Under 20,Forward,Spain,Europe
983,Bryan Gil,ESP,Eibar,La Liga,2020,19.0,2001.0,25.2,28,18,12,11,5,6,23,26.1,17,20,0,20,17,45,6,0,"MF,FW",Under 20,Midfielder,Spain,Europe
984,David Gil,ESP,Cádiz,La Liga,2020,26.0,1994.0,4.0,0,0,0,0,0,0,1,0.0,1,0,0,0,0,0,2,0,GK,25-29,Goalkeeper,Spain,Europe
986,Álvaro Giménez,ESP,Cádiz,La Liga,2020,29.0,1991.0,4.5,4,2,2,2,0,0,3,0.0,3,2,0,2,2,6,3,0,FW,25-29,Forward,Spain,Europe
992,Kamil Glik,POL,Benevento,Serie A,2020,32.0,1988.0,35.6,44,24,33,10,1,25,53,47.2,28,37,31,6,62,106,153,0,DF,30-34,Defender,Poland,Europe
999,Vladimir Golemić,SVN,Crotone,Serie A,2020,29.0,1991.0,26.0,33,16,17,13,3,14,19,73.7,5,38,26,12,40,73,97,2,DF,25-29,Defender,Slovenia,Europe
1004,Dani Gómez,ESP,Levante,La Liga,2020,22.0,1998.0,18.5,4,3,2,1,1,0,11,0.0,11,3,0,3,2,6,4,0,FW,20-24,Forward,Spain,Europe
1005,Ibai Gómez,ESP,Athletic Club,La Liga,2020,30.0,1989.0,4.7,6,4,2,3,1,4,7,57.1,3,3,0,3,2,8,4,0,MF,30-34,Midfielder,Spain,Europe
1008,Moi Gómez,ESP,Villarreal,La Liga,2020,26.0,1994.0,28.5,21,12,6,8,7,14,35,40.0,21,20,3,17,11,32,16,0,"MF,FW",25-29,Midfielder,Spain,Europe
1011,Sergi Gómez,ESP,Sevilla,La Liga,2020,28.0,1992.0,8.0,4,3,2,2,0,1,1,100.0,0,5,4,1,6,10,34,0,DF,25-29,Defender,Spain,Europe
1012,Sergio Gómez,ESP,Huesca,La Liga,2020,19.0,2000.0,8.8,29,10,17,9,3,11,22,50.0,11,15,0,15,14,43,9,0,"MF,FW",Under 20,Midfielder,Spain,Europe
1017,Álvaro González,ESP,Marseille,Ligue 1,2020,30.0,1990.0,31.5,26,17,20,6,0,19,31,61.3,12,30,18,12,33,59,119,1,DF,30-34,Defender,Spain,Europe
1017,Álvaro González,ESP,Marseille,Ligue 1,2020,30.0,1990.0,31.5,26,17,20,6,0,19,31,61.3,12,30,18,12,33,59,119,1,DF,30-34,Defender,Spain,Europe
1017,Álvaro González,ESP,Marseille,Ligue 1,2020,30.0,1990.0,31.5,26,17,20,6,0,19,31,61.3,12,30,18,12,33,59,119,1,DF,30-34,Defender,Spain,Europe
1017,Álvaro González,ESP,Marseille,Ligue 1,2020,30.0,1990.0,31.5,26,17,20,6,0,19,31,61.3,12,30,18,12,33,59,119,1,DF,30-34,Defender,Spain,Europe
1018,Bruno González,ESP,Valladolid,La Liga,2020,30.0,1990.0,25.1,26,17,18,8,0,17,31,54.8,14,22,14,8,37,63,112,1,DF,30-34,Defender,Spain,Europe
1019,Diego González,ESP,Elche,La Liga,2020,25.0,1995.0,14.2,11,7,7,3,1,5,11,45.5,6,16,9,7,20,31,49,1,DF,25-29,Defender,Spain,Europe
1019,Diego González,ESP,Elche,La Liga,2020,25.0,1995.0,14.2,11,7,7,3,1,5,11,45.5,6,16,9,7,20,31,49,1,DF,25-29,Defender,Spain,Europe
1019,Diego González,ESP,Elche,La Liga,2020,25.0,1995.0,14.2,11,7,7,3,1,5,11,45.5,6,16,9,7,20,31,49,1,DF,25-29,Defender,Spain,Europe
1019,Diego González,ESP,Elche,La Liga,2020,25.0,1995.0,14.2,11,7,7,3,1,5,11,45.5,6,16,9,7,20,31,49,1,DF,25-29,Defender,Spain,Europe
1021,Sergio González,ESP,Cádiz,La Liga,2020,23.0,1997.0,1.0,1,0,0,1,0,1,2,50.0,1,0,0,0,2,3,0,0,"MF,DF",20-24,Midfielder,Spain,Europe
1021,Sergio González,ESP,Cádiz,La Liga,2020,23.0,1997.0,1.0,1,0,0,1,0,1,2,50.0,1,0,0,0,2,3,0,0,"MF,DF",20-24,Midfielder,Spain,Europe
1021,Sergio González,ESP,Cádiz,La Liga,2020,23.0,1997.0,1.0,1,0,0,1,0,1,2,50.0,1,0,0,0,2,3,0,0,"MF,DF",20-24,Midfielder,Spain,Europe
1021,Sergio González,ESP,Cádiz,La Liga,2020,23.0,1997.0,1.0,1,0,0,1,0,1,2,50.0,1,0,0,0,2,3,0,0,"MF,DF",20-24,Midfielder,Spain,Europe
1022,Urko González,ESP,Real Sociedad,La Liga,2020,19.0,2001.0,0.5,0,0,0,0,0,0,1,0.0,1,1,1,0,0,0,1,0,MF,Under 20,Midfielder,Spain,Europe
1025,Andoni Gorosabel,ESP,Real Sociedad,La Liga,2020,23.0,1996.0,26.5,76,43,45,20,11,27,64,42.2,37,25,4,21,23,99,42,0,DF,20-24,Defender,Spain,Europe
1049,Kamil Grosicki,POL,West Brom,Premier League,2020,32.0,1988.0,1.6,2,1,2,0,0,2,8,25.0,6,1,0,1,2,4,1,0,"MF,FW",30-34,Midfielder,Poland,Europe
1052,Vicente Guaita,ESP,Crystal Palace,Premier League,2020,33.0,1987.0,37.0,1,1,1,0,0,1,1,100.0,0,0,0,0,1,2,11,1,GK,30-34,Goalkeeper,Spain,Europe
1054,Sergi Guardiola,ESP,Valladolid,La Liga,2020,29.0,1991.0,19.9,11,5,1,5,5,2,27,7.4,25,12,1,11,7,18,16,3,FW,25-29,Forward,Spain,Europe
1055,Nemanja Gudelj,SRB,Sevilla,La Liga,2020,28.0,1991.0,11.6,23,12,16,5,2,4,10,40.0,6,10,6,4,24,47,24,2,"MF,DF",25-29,Midfielder,Serbia,Europe
1061,Ander Guevara,ESP,Real Sociedad,La Liga,2020,23.0,1997.0,23.1,35,23,15,16,4,15,30,50.0,15,19,5,14,25,60,35,1,MF,20-24,Midfielder,Spain,Europe
1067,Hugo Guillamón,ESP,Valencia,La Liga,2020,20.0,2000.0,22.1,23,13,17,6,0,8,20,40.0,12,19,14,5,27,50,102,3,DF,20-24,Defender,Spain,Europe
1072,Robert Gumny,POL,Augsburg,Bundesliga,2020,22.0,1998.0,15.3,24,15,12,9,3,15,23,65.2,8,12,2,10,18,42,31,0,DF,20-24,Defender,Poland,Europe
1076,Jon Guridi,ESP,Real Sociedad,La Liga,2020,25.0,1995.0,9.2,19,9,10,6,3,8,22,36.4,14,8,1,7,10,29,9,0,MF,25-29,Midfielder,Spain,Europe
1078,Raúl Guti,ESP,Elche,La Liga,2020,23.0,1996.0,31.8,48,28,21,22,5,16,52,30.8,36,25,3,22,49,97,25,0,MF,20-24,Midfielder,Spain,Europe
1080,Miguel Gutiérrez,ESP,Real Madrid,La Liga,2020,19.0,2001.0,3.5,4,0,0,3,1,1,7,14.3,6,3,0,3,5,9,5,0,DF,Under 20,Defender,Spain,Europe
1083,Erling Haaland,NOR,Dortmund,Bundesliga,2020,20.0,2000.0,26.7,7,2,1,3,3,1,4,25.0,3,19,4,15,4,11,16,0,FW,20-24,Forward,Norway,Europe
1096,Samir Handanović,SVN,Inter,Serie A,2020,36.0,1984.0,36.0,1,0,1,0,0,1,1,100.0,0,0,0,0,0,1,6,3,GK,35-39,Goalkeeper,Slovenia,Europe
1123,Mario Hermoso,ESP,Atlético Madrid,La Liga,2020,25.0,1995.0,28.6,55,31,40,11,4,37,61,60.7,24,23,10,13,36,91,73,0,DF,25-29,Defender,Spain,Europe
1124,Aridane Hernández,ESP,Osasuna,La Liga,2020,31.0,1989.0,22.5,20,11,13,6,1,7,12,58.3,5,22,19,3,34,54,127,1,DF,30-34,Defender,Spain,Europe
1126,Pablo Hernández,ESP,Leeds United,Premier League,2020,35.0,1985.0,4.7,5,3,2,1,2,5,16,31.3,11,2,0,2,0,5,0,1,MF,35-39,Midfielder,Spain,Europe
1126,Pablo Hernández,ESP,Leeds United,Premier League,2020,35.0,1985.0,4.7,5,3,2,1,2,5,16,31.3,11,2,0,2,0,5,0,1,MF,35-39,Midfielder,Spain,Europe
1126,Pablo Hernández,ESP,Leeds United,Premier League,2020,35.0,1985.0,4.7,5,3,2,1,2,5,16,31.3,11,2,0,2,0,5,0,1,MF,35-39,Midfielder,Spain,Europe
1126,Pablo Hernández,ESP,Leeds United,Premier League,2020,35.0,1985.0,4.7,5,3,2,1,2,5,16,31.3,11,2,0,2,0,5,0,1,MF,35-39,Midfielder,Spain,Europe
1129,Ander Herrera,ESP,Paris S-G,Ligue 1,2020,30.0,1989.0,20.6,53,35,17,26,10,30,77,39.0,47,31,5,26,31,84,22,1,MF,30-34,Midfielder,Spain,Europe
1131,Sergio Herrera,ESP,Osasuna,La Liga,2020,27.0,1993.0,32.9,0,0,0,0,0,0,2,0.0,2,0,0,0,3,3,29,3,GK,25-29,Goalkeeper,Spain,Europe
1134,Pablo Hervías,ESP,Valladolid,La Liga,2020,27.0,1993.0,13.4,19,12,7,9,3,9,26,34.6,17,6,0,6,11,30,8,0,"DF,MF",25-29,Defender,Spain,Europe
1170,Vicente Iborra,ESP,Villarreal,La Liga,2020,32.0,1988.0,10.3,18,8,8,7,3,8,24,33.3,16,14,7,7,14,32,25,1,MF,30-34,Midfielder,Spain,Europe
1177,Iglesias,ESP,Getafe,La Liga,2020,22.0,1998.0,6.7,27,15,14,10,3,11,19,57.9,8,11,1,10,17,44,19,0,"DF,MF",20-24,Defender,Spain,Europe
1178,Borja Iglesias,ESP,Betis,La Liga,2020,27.0,1993.0,15.7,1,1,0,0,1,1,8,12.5,7,7,2,5,3,4,9,0,FW,25-29,Forward,Spain,Europe
1183,Ivan Ilić,SRB,Hellas Verona,Serie A,2020,19.0,2001.0,20.4,26,14,11,11,4,7,21,33.3,14,17,5,12,27,53,26,0,MF,Under 20,Midfielder,Serbia,Europe
1184,Josip Iličić,SVN,Atalanta,Serie A,2020,32.0,1988.0,17.0,9,4,1,5,3,5,21,23.8,16,12,0,12,2,11,0,1,"MF,FW",30-34,Midfielder,Slovenia,Europe
1185,Asier Illarramendi,ESP,Real Sociedad,La Liga,2020,30.0,1990.0,3.7,5,2,1,4,0,1,5,20.0,4,2,0,2,5,10,7,0,MF,30-34,Midfielder,Spain,Europe
1194,Pablo Insua,ESP,Huesca,La Liga,2020,26.0,1993.0,17.6,37,18,26,9,2,14,31,45.2,17,14,8,6,24,61,68,0,DF,25-29,Defender,Spain,Europe
1198,Isco,ESP,Real Madrid,La Liga,2020,28.0,1992.0,10.1,13,9,5,5,3,2,14,14.3,12,7,1,6,2,15,2,0,MF,25-29,Midfielder,Spain,Europe
1201,Branislav Ivanović,SRB,West Brom,Premier League,2020,36.0,1984.0,8.5,14,5,11,3,0,7,13,53.8,6,11,5,6,8,22,25,0,DF,35-39,Defender,Serbia,Europe
1203,Jairo Izquierdo,ESP,Cádiz,La Liga,2020,26.0,1993.0,14.2,21,13,13,8,0,12,31,38.7,19,7,1,6,14,35,12,0,"MF,DF",25-29,Midfielder,Spain,Europe
1214,Jakub Jankto,CZE,Sampdoria,Serie A,2020,24.0,1996.0,26.8,28,17,14,7,7,11,35,31.4,24,16,1,15,24,52,34,0,MF,20-24,Midfielder,Czech Republic,Europe
1217,Rune Jarstein,NOR,Hertha BSC,Bundesliga,2020,35.0,1984.0,8.0,0,0,0,0,0,0,0,,0,0,0,0,0,0,7,1,GK,35-39,Goalkeeper,Norway,Europe
1218,Jason,ESP,Valencia,La Liga,2020,26.0,1994.0,4.9,9,3,5,2,2,4,16,25.0,12,6,1,5,10,19,4,0,"MF,DF",25-29,Midfielder,Spain,Europe
1224,Jesé,ESP,Paris S-G,Ligue 1,2020,27.0,1993.0,0.3,0,0,0,0,0,0,1,0.0,1,0,0,0,0,0,0,0,FW,25-29,Forward,Spain,Europe
1228,Joaquín,ESP,Betis,La Liga,2020,39.0,1981.0,14.3,9,3,1,5,3,4,12,33.3,8,8,0,8,17,26,11,0,"FW,MF",35-39,Forward,Spain,Europe
1237,Jony,ESP,Osasuna,La Liga,2020,29.0,1991.0,9.7,7,3,1,2,4,5,20,25.0,15,5,0,5,14,21,3,0,"MF,FW",25-29,Midfielder,Spain,Europe
1238,Joan Jordán,ESP,Sevilla,La Liga,2020,26.0,1994.0,26.7,52,28,17,29,6,17,76,22.4,59,22,3,19,27,79,25,0,MF,25-29,Midfielder,Spain,Europe
1240,Josan,ESP,Elche,La Liga,2020,30.0,1989.0,21.4,34,18,23,11,0,13,39,33.3,26,24,1,23,21,55,26,1,"MF,DF",30-34,Midfielder,Spain,Europe
1243,Joselu,ESP,Alavés,La Liga,2020,30.0,1990.0,33.6,27,14,6,15,6,8,28,28.6,20,26,3,23,15,42,58,1,FW,30-34,Forward,Spain,Europe
1244,Josema,ESP,Elche,La Liga,2020,24.0,1996.0,21.8,43,28,33,10,0,10,18,55.6,8,17,7,10,37,80,92,0,DF,20-24,Defender,Spain,Europe
1246,Jota,ESP,Alavés,La Liga,2020,29.0,1991.0,15.5,19,14,6,7,6,3,29,10.3,26,12,0,12,9,28,9,0,MF,25-29,Midfielder,Spain,Europe
1246,Jota,ESP,Alavés,La Liga,2020,29.0,1991.0,15.5,19,14,6,7,6,3,29,10.3,26,12,0,12,9,28,9,0,MF,25-29,Midfielder,Spain,Europe
1246,Jota,ESP,Alavés,La Liga,2020,29.0,1991.0,15.5,19,14,6,7,6,3,29,10.3,26,12,0,12,9,28,9,0,MF,25-29,Midfielder,Spain,Europe
1246,Jota,ESP,Alavés,La Liga,2020,29.0,1991.0,15.5,19,14,6,7,6,3,29,10.3,26,12,0,12,9,28,9,0,MF,25-29,Midfielder,Spain,Europe
1246,Jota,ESP,Alavés,La Liga,2020,29.0,1991.0,15.5,19,14,6,7,6,3,29,10.3,26,12,0,12,9,28,9,0,MF,25-29,Midfielder,Spain,Europe
1246,Jota,ESP,Alavés,La Liga,2020,29.0,1991.0,15.5,19,14,6,7,6,3,29,10.3,26,12,0,12,9,28,9,0,MF,25-29,Midfielder,Spain,Europe
1246,Jota,ESP,Alavés,La Liga,2020,29.0,1991.0,15.5,19,14,6,7,6,3,29,10.3,26,12,0,12,9,28,9,0,MF,25-29,Midfielder,Spain,Europe
1246,Jota,ESP,Alavés,La Liga,2020,29.0,1991.0,15.5,19,14,6,7,6,3,29,10.3,26,12,0,12,9,28,9,0,MF,25-29,Midfielder,Spain,Europe
1246,Jota,ESP,Alavés,La Liga,2020,29.0,1991.0,15.5,19,14,6,7,6,3,29,10.3,26,12,0,12,9,28,9,0,MF,25-29,Midfielder,Spain,Europe
1249,Luka Jović,SRB,Real Madrid,La Liga,2020,22.0,1997.0,1.7,0,0,0,0,0,0,0,,0,0,0,0,0,0,0,0,FW,20-24,Forward,Serbia,Europe
1250,Luka Jović,SRB,Eint Frankfurt,Bundesliga,2020,22.0,1997.0,9.9,2,0,0,2,0,0,4,0.0,4,3,0,3,1,3,7,0,FW,20-24,Forward,Serbia,Europe
1251,Juanmi,ESP,Betis,La Liga,2020,27.0,1993.0,6.7,13,9,3,5,5,4,18,22.2,14,4,0,4,2,15,4,0,"FW,MF",25-29,Forward,Spain,Europe
1260,Pavel Kadeřábek,CZE,Hoffenheim,Bundesliga,2020,28.0,1992.0,17.6,15,12,7,6,2,6,15,40.0,9,12,3,9,18,33,31,0,"DF,FW",25-29,Defender,Czech Republic,Europe
1262,Damian Kądzior,POL,Eibar,La Liga,2020,28.0,1992.0,2.2,1,0,0,1,0,1,5,20.0,4,1,0,1,0,1,0,0,"FW,MF",25-29,Forward,Poland,Europe
1278,Marcin Kamiński,POL,Stuttgart,Bundesliga,2020,28.0,1992.0,2.4,1,1,0,0,1,0,0,,0,2,1,1,1,2,10,0,DF,25-29,Defender,Poland,Europe
1279,Kevin Kampl,SVN,RB Leipzig,Bundesliga,2020,29.0,1990.0,21.5,38,26,9,24,5,18,35,51.4,17,20,2,18,29,67,14,0,MF,25-29,Midfielder,Slovenia,Europe
1315,Kiké,ESP,Eibar,La Liga,2020,30.0,1989.0,34.3,24,18,5,7,12,6,22,27.3,16,24,1,23,7,31,29,0,FW,30-34,Forward,Spain,Europe
1320,Joshua King,NOR,Everton,Premier League,2020,28.0,1992.0,1.6,4,1,2,1,1,0,0,,0,3,0,3,1,5,1,0,"MF,FW",25-29,Midfielder,Norway,Europe
1327,Mateusz Klich,POL,Leeds United,Premier League,2020,30.0,1990.0,26.6,38,20,14,20,4,14,61,23.0,47,13,4,9,11,49,16,0,MF,30-34,Midfielder,Poland,Europe
1344,Koke,ESP,Atlético Madrid,La Liga,2020,28.0,1992.0,33.6,64,42,22,31,11,28,98,28.6,70,35,6,29,36,100,40,0,MF,25-29,Midfielder,Spain,Europe
1346,Aleksandar Kolarov,SRB,Inter,Serie A,2020,34.0,1985.0,4.3,4,4,0,4,0,1,2,50.0,1,2,0,2,7,11,8,0,DF,30-34,Defender,Serbia,Europe
1362,Filip Kostić,SRB,Eint Frankfurt,Bundesliga,2020,27.0,1992.0,28.2,54,31,22,23,9,22,54,40.7,32,43,6,37,26,80,28,2,DF,25-29,Defender,Serbia,Europe
1383,Kuki,ESP,Valladolid,La Liga,2020,22.0,1998.0,0.3,1,1,0,0,1,0,1,0.0,1,0,0,0,0,1,0,0,MF,20-24,Midfielder,Spain,Europe
1388,Jasmin Kurtić,SVN,Parma,Serie A,2020,31.0,1989.0,30.4,46,28,22,21,3,21,70,30.0,49,22,2,20,33,79,57,1,MF,30-34,Midfielder,Slovenia,Europe
1400,Víctor Laguardia,ESP,Alavés,La Liga,2020,30.0,1989.0,29.2,20,12,13,6,1,14,31,45.2,17,25,13,12,37,57,104,0,DF,30-34,Defender,Spain,Europe
1413,Aymeric Laporte,ESP,Manchester City,Premier League,2020,26.0,1994.0,14.9,13,6,10,3,0,7,11,63.6,4,12,7,5,11,24,28,0,DF,25-29,Defender,Spain,Europe
1421,Toni Lato,ESP,Valencia,La Liga,2020,22.0,1997.0,8.1,13,6,7,3,3,6,13,46.2,7,12,1,11,10,23,21,0,DF,20-24,Defender,Spain,Europe
1428,Darko Lazović,SRB,Hellas Verona,Serie A,2020,29.0,1990.0,27.8,29,17,8,17,4,20,42,47.6,22,17,7,10,20,49,29,0,"DF,MF",25-29,Defender,Serbia,Europe
1434,Robin Le Normand,ESP,Real Sociedad,La Liga,2020,23.0,1996.0,30.5,34,20,25,8,1,9,19,47.4,10,35,24,11,36,70,87,1,DF,20-24,Defender,Spain,Europe
1445,Iñigo Lekue,ESP,Athletic Club,La Liga,2020,27.0,1993.0,7.2,9,7,6,3,0,3,8,37.5,5,8,1,7,4,13,24,0,DF,25-29,Defender,Spain,Europe
1452,Pedro León,ESP,Eibar,La Liga,2020,33.0,1986.0,10.4,9,8,3,3,3,3,17,17.6,14,11,0,11,7,16,2,0,"MF,FW",30-34,Midfielder,Spain,Europe
1453,Sergio León,ESP,Levante,La Liga,2020,31.0,1989.0,8.3,6,2,0,4,2,2,8,25.0,6,4,0,4,3,9,2,0,FW,30-34,Forward,Spain,Europe
1459,Robert Lewandowski,POL,Bayern Munich,Bundesliga,2020,31.0,1988.0,27.3,15,9,0,7,8,2,13,15.4,11,9,1,8,3,18,11,0,FW,30-34,Forward,Poland,Europe
1460,Jamal Lewis,NIR,Newcastle Utd,Premier League,2020,22.0,1998.0,20.4,37,20,23,13,1,16,38,42.1,22,21,7,14,11,48,44,1,DF,20-24,Defender,Northern Ireland,Europe
1469,Karol Linetty,POL,Torino,Serie A,2020,25.0,1995.0,20.4,38,28,13,19,6,16,45,35.6,29,19,5,14,15,53,7,0,MF,25-29,Midfielder,Poland,Europe
1471,Pol Lirola,ESP,Fiorentina,Serie A,2020,22.0,1997.0,5.5,13,8,8,2,3,6,12,50.0,6,6,3,3,6,19,9,0,"DF,FW",20-24,Defender,Spain,Europe
1472,Pol Lirola,ESP,Marseille,Ligue 1,2020,22.0,1997.0,17.3,28,16,11,15,2,16,28,57.1,12,18,5,13,25,53,26,0,"DF,FW",20-24,Defender,Spain,Europe
1474,Diego Llorente,ESP,Leeds United,Premier League,2020,26.0,1993.0,13.4,34,21,21,13,0,19,32,59.4,13,18,13,5,20,54,40,2,DF,25-29,Defender,Spain,Europe
1474,Diego Llorente,ESP,Leeds United,Premier League,2020,26.0,1993.0,13.4,34,21,21,13,0,19,32,59.4,13,18,13,5,20,54,40,2,DF,25-29,Defender,Spain,Europe
1474,Diego Llorente,ESP,Leeds United,Premier League,2020,26.0,1993.0,13.4,34,21,21,13,0,19,32,59.4,13,18,13,5,20,54,40,2,DF,25-29,Defender,Spain,Europe
1474,Diego Llorente,ESP,Leeds United,Premier League,2020,26.0,1993.0,13.4,34,21,21,13,0,19,32,59.4,13,18,13,5,20,54,40,2,DF,25-29,Defender,Spain,Europe
1475,Diego Llorente,ESP,Real Sociedad,La Liga,2020,26.0,1993.0,1.0,1,0,1,0,0,1,2,50.0,1,1,1,0,2,3,5,0,DF,25-29,Defender,Spain,Europe
1475,Diego Llorente,ESP,Real Sociedad,La Liga,2020,26.0,1993.0,1.0,1,0,1,0,0,1,2,50.0,1,1,1,0,2,3,5,0,DF,25-29,Defender,Spain,Europe
1475,Diego Llorente,ESP,Real Sociedad,La Liga,2020,26.0,1993.0,1.0,1,0,1,0,0,1,2,50.0,1,1,1,0,2,3,5,0,DF,25-29,Defender,Spain,Europe
1475,Diego Llorente,ESP,Real Sociedad,La Liga,2020,26.0,1993.0,1.0,1,0,1,0,0,1,2,50.0,1,1,1,0,2,3,5,0,DF,25-29,Defender,Spain,Europe
1476,Fernando Llorente,ESP,Udinese,Serie A,2020,35.0,1985.0,7.9,4,1,2,2,0,2,5,40.0,3,3,0,3,2,6,17,0,FW,35-39,Forward,Spain,Europe
1477,Fernando Llorente,ESP,Napoli,Serie A,2020,35.0,1985.0,0.6,0,0,0,0,0,0,0,,0,0,0,0,0,0,0,0,"FW,MF",35-39,Forward,Spain,Europe
1478,Marcos Llorente,ESP,Atlético Madrid,La Liga,2020,25.0,1995.0,32.8,71,42,21,40,10,26,62,41.9,36,40,3,37,29,100,28,0,"MF,FW",25-29,Midfielder,Spain,Europe
1494,Adrián López,ESP,Osasuna,La Liga,2020,32.0,1988.0,5.3,3,3,0,1,2,1,5,20.0,4,3,0,3,0,3,3,0,"FW,MF",30-34,Forward,Spain,Europe
1494,Adrián López,ESP,Osasuna,La Liga,2020,32.0,1988.0,5.3,3,3,0,1,2,1,5,20.0,4,3,0,3,0,3,3,0,"FW,MF",30-34,Forward,Spain,Europe
1494,Adrián López,ESP,Osasuna,La Liga,2020,32.0,1988.0,5.3,3,3,0,1,2,1,5,20.0,4,3,0,3,0,3,3,0,"FW,MF",30-34,Forward,Spain,Europe
1494,Adrián López,ESP,Osasuna,La Liga,2020,32.0,1988.0,5.3,3,3,0,1,2,1,5,20.0,4,3,0,3,0,3,3,0,"FW,MF",30-34,Forward,Spain,Europe
1495,Javi López,ESP,Alavés,La Liga,2020,18.0,2002.0,2.8,5,5,3,2,0,2,3,66.7,1,2,0,2,3,8,3,1,"DF,MF",Under 20,Defender,Spain,Europe
1495,Javi López,ESP,Alavés,La Liga,2020,18.0,2002.0,2.8,5,5,3,2,0,2,3,66.7,1,2,0,2,3,8,3,1,"DF,MF",Under 20,Defender,Spain,Europe
1495,Javi López,ESP,Alavés,La Liga,2020,18.0,2002.0,2.8,5,5,3,2,0,2,3,66.7,1,2,0,2,3,8,3,1,"DF,MF",Under 20,Defender,Spain,Europe
1495,Javi López,ESP,Alavés,La Liga,2020,18.0,2002.0,2.8,5,5,3,2,0,2,3,66.7,1,2,0,2,3,8,3,1,"DF,MF",Under 20,Defender,Spain,Europe
1498,Pedro López Muñoz,ESP,Huesca,La Liga,2020,36.0,1983.0,11.9,23,15,10,8,5,15,22,68.2,7,10,4,6,16,39,23,1,DF,35-39,Defender,Spain,Europe
1499,Pau López,ESP,Roma,Serie A,2020,25.0,1994.0,20.2,2,0,2,0,0,2,2,100.0,0,1,0,1,0,2,7,4,GK,25-29,Goalkeeper,Spain,Europe
1500,Roberto López,ESP,Real Sociedad,La Liga,2020,20.0,2000.0,5.6,5,1,1,2,2,2,5,40.0,3,2,0,2,4,9,6,0,"MF,FW",20-24,Midfielder,Spain,Europe
1501,Unai López,ESP,Athletic Club,La Liga,2020,24.0,1995.0,15.8,27,17,13,13,1,10,29,34.5,19,20,5,15,18,45,9,1,MF,20-24,Midfielder,Spain,Europe
1510,Anthony Lozano,HON,Cádiz,La Liga,2020,27.0,1993.0,16.9,12,4,1,5,6,2,13,15.4,11,3,1,2,3,15,8,0,FW,25-29,Forward,Honduras,North America
1519,José Luis Gayà,ESP,Valencia,La Liga,2020,25.0,1995.0,31.6,59,33,40,13,6,33,68,48.5,35,22,3,19,38,97,62,1,DF,25-29,Defender,Spain,Europe
1520,José Luis Morales,ESP,Levante,La Liga,2020,33.0,1987.0,27.1,18,10,7,9,2,8,36,22.2,28,17,0,17,11,29,11,0,"MF,FW",30-34,Midfielder,Spain,Europe
1523,Luismi,ESP,Elche,La Liga,2020,28.0,1992.0,1.9,4,2,1,3,0,1,2,50.0,1,2,0,2,4,8,0,0,"MF,DF",25-29,Midfielder,Spain,Europe
1528,Saša Lukić,SRB,Torino,Serie A,2020,23.0,1996.0,23.4,32,13,11,18,3,15,50,30.0,35,23,5,18,17,49,17,0,MF,20-24,Midfielder,Serbia,Europe
1542,Mikail Maden,NOR,Schalke 04,Bundesliga,2020,18.0,2002.0,0.1,0,0,0,0,0,0,0,,0,0,0,0,0,0,0,0,FW,Under 20,Forward,Norway,Europe
1543,Pablo Maffeo,ESP,Huesca,La Liga,2020,23.0,1997.0,21.8,26,17,21,4,1,12,26,46.2,14,18,6,12,35,61,27,0,DF,20-24,Defender,Spain,Europe
1563,Radosław Majecki,POL,Monaco,Ligue 1,2020,20.0,1999.0,1.0,0,0,0,0,0,0,0,,0,0,0,0,0,0,1,0,GK,20-24,Goalkeeper,Poland,Europe
1567,Nemanja Maksimović,SRB,Getafe,La Liga,2020,25.0,1995.0,30.3,50,28,22,24,4,19,46,41.3,27,40,9,31,57,107,46,1,MF,25-29,Midfielder,Serbia,Europe
1568,Nikola Maksimović,SRB,Napoli,Serie A,2020,28.0,1991.0,13.4,18,9,11,6,1,9,18,50.0,9,15,6,9,21,39,49,3,DF,25-29,Defender,Serbia,Europe
1569,Filip Malbašić,SRB,Cádiz,La Liga,2020,27.0,1992.0,9.6,12,7,4,5,3,6,18,33.3,12,10,0,10,4,16,2,0,"FW,MF",25-29,Forward,Serbia,Europe
1575,Hugo Mallo,ESP,Celta Vigo,La Liga,2020,29.0,1991.0,28.9,58,40,34,23,1,24,52,46.2,28,42,11,31,37,95,77,0,DF,25-29,Defender,Spain,Europe
1594,Javier Manquillo,ESP,Newcastle Utd,Premier League,2020,26.0,1994.0,9.2,24,14,8,14,2,11,17,64.7,6,8,1,7,9,33,15,1,DF,25-29,Defender,Spain,Europe
1596,Myziane Maolida,COM,Nice,Ligue 1,2020,21.0,1999.0,12.0,13,8,4,4,5,4,11,36.4,7,6,1,5,6,19,4,0,"FW,MF",20-24,Forward,Comoros,Africa
1608,Óscar de Marcos,ESP,Athletic Club,La Liga,2020,31.0,1989.0,16.9,28,17,12,10,6,10,25,40.0,15,12,1,11,12,40,38,0,"DF,MF",30-34,Defender,Spain,Europe
1610,José Mari,ESP,Cádiz,La Liga,2020,32.0,1987.0,16.1,32,17,13,18,1,14,31,45.2,17,16,7,9,27,59,33,1,MF,30-34,Midfielder,Spain,Europe
1611,Pablo Marí,ESP,Arsenal,Premier League,2020,26.0,1993.0,10.0,15,9,12,3,0,5,10,50.0,5,8,7,1,9,24,30,2,DF,25-29,Defender,Spain,Europe
1615,Adrián Marín,ESP,Alavés,La Liga,2020,23.0,1997.0,1.0,1,1,0,1,0,0,2,0.0,2,1,0,1,2,3,2,0,"DF,MF",20-24,Defender,Spain,Europe
1616,Adrián Marín,ESP,Granada,La Liga,2020,23.0,1997.0,3.0,5,2,1,3,1,2,3,66.7,1,5,2,3,4,9,9,0,"DF,MF",20-24,Defender,Spain,Europe
1623,Roger Martí,ESP,Levante,La Liga,2020,29.0,1991.0,24.4,11,7,5,4,2,6,23,26.1,17,10,3,7,4,15,6,0,FW,25-29,Forward,Spain,Europe
1625,Aarón Martín,ESP,Celta Vigo,La Liga,2020,23.0,1997.0,17.1,34,20,15,16,3,10,33,30.3,23,15,4,11,13,47,37,0,DF,20-24,Defender,Spain,Europe
1626,Aarón Martín,ESP,Mainz 05,Bundesliga,2020,23.0,1997.0,2.9,3,2,2,1,0,2,4,50.0,2,1,0,1,2,5,2,0,"DF,FW",20-24,Defender,Spain,Europe
1627,Álex Martín,ESP,Cádiz,La Liga,2020,22.0,1998.0,1.1,2,0,1,1,0,2,4,50.0,2,1,1,0,0,2,6,0,DF,20-24,Defender,Spain,Europe
1631,Iñigo Martínez,ESP,Athletic Club,La Liga,2020,29.0,1991.0,28.0,22,15,16,6,0,9,27,33.3,18,17,7,10,28,50,96,0,DF,25-29,Defender,Spain,Europe
1632,Javi Martínez,ESP,Osasuna,La Liga,2020,20.0,1999.0,5.1,9,4,1,6,2,5,12,41.7,7,9,0,9,5,14,4,0,"MF,FW",20-24,Midfielder,Spain,Europe
1632,Javi Martínez,ESP,Osasuna,La Liga,2020,20.0,1999.0,5.1,9,4,1,6,2,5,12,41.7,7,9,0,9,5,14,4,0,"MF,FW",20-24,Midfielder,Spain,Europe
1632,Javi Martínez,ESP,Osasuna,La Liga,2020,20.0,1999.0,5.1,9,4,1,6,2,5,12,41.7,7,9,0,9,5,14,4,0,"MF,FW",20-24,Midfielder,Spain,Europe
1632,Javi Martínez,ESP,Osasuna,La Liga,2020,20.0,1999.0,5.1,9,4,1,6,2,5,12,41.7,7,9,0,9,5,14,4,0,"MF,FW",20-24,Midfielder,Spain,Europe
1633,Javi Martínez,ESP,Bayern Munich,Bundesliga,2020,31.0,1988.0,5.2,10,5,4,4,2,7,9,77.8,2,8,4,4,13,23,19,0,"DF,MF",30-34,Defender,Spain,Europe
1633,Javi Martínez,ESP,Bayern Munich,Bundesliga,2020,31.0,1988.0,5.2,10,5,4,4,2,7,9,77.8,2,8,4,4,13,23,19,0,"DF,MF",30-34,Defender,Spain,Europe
1633,Javi Martínez,ESP,Bayern Munich,Bundesliga,2020,31.0,1988.0,5.2,10,5,4,4,2,7,9,77.8,2,8,4,4,13,23,19,0,"DF,MF",30-34,Defender,Spain,Europe
1633,Javi Martínez,ESP,Bayern Munich,Bundesliga,2020,31.0,1988.0,5.2,10,5,4,4,2,7,9,77.8,2,8,4,4,13,23,19,0,"DF,MF",30-34,Defender,Spain,Europe
1634,Josep Martinez,ESP,RB Leipzig,Bundesliga,2020,22.0,1998.0,1.0,0,0,0,0,0,0,0,,0,0,0,0,0,0,0,0,GK,20-24,Goalkeeper,Spain,Europe
1641,Marvin,ESP,Real Madrid,La Liga,2020,20.0,2000.0,1.5,3,2,0,3,0,1,2,50.0,1,1,0,1,2,5,3,0,"DF,MF",20-24,Defender,Spain,Europe
1644,Jordi Masip,ESP,Valladolid,La Liga,2020,31.0,1989.0,25.0,0,0,0,0,0,0,2,0.0,2,2,0,2,2,2,8,1,GK,30-34,Goalkeeper,Spain,Europe
1648,Jaime Mata,ESP,Getafe,La Liga,2020,31.0,1988.0,22.6,12,7,1,3,8,3,18,16.7,15,13,2,11,6,18,16,0,FW,30-34,Forward,Spain,Europe
1649,Juan Mata,ESP,Manchester Utd,Premier League,2020,32.0,1988.0,5.7,1,0,1,0,0,0,7,0.0,7,3,0,3,3,4,3,0,"FW,MF",30-34,Forward,Spain,Europe
1654,Nemanja Matić,SRB,Manchester Utd,Premier League,2020,31.0,1988.0,12.3,25,11,13,12,0,13,31,41.9,18,19,5,14,22,47,10,3,MF,30-34,Midfielder,Serbia,Europe
1666,Borja Mayoral,ESP,Roma,Serie A,2020,23.0,1997.0,17.2,3,2,0,0,3,1,10,10.0,9,5,0,5,0,3,5,2,FW,20-24,Forward,Spain,Europe
1667,Borja Mayoral,ESP,Real Madrid,La Liga,2020,23.0,1997.0,0.3,0,0,0,0,0,0,1,0.0,1,0,0,0,0,0,0,0,FW,20-24,Forward,Spain,Europe
1695,Gonzalo Melero,ESP,Levante,La Liga,2020,26.0,1994.0,20.6,24,15,11,6,7,10,39,25.6,29,14,5,9,18,42,22,1,"MF,FW",25-29,Midfielder,Spain,Europe
1696,Birger Meling,NOR,Nîmes,Ligue 1,2020,25.0,1994.0,25.9,49,31,27,15,7,33,50,66.0,17,43,9,34,36,85,70,0,DF,25-29,Defender,Norway,Europe
1702,Brais Méndez,ESP,Celta Vigo,La Liga,2020,23.0,1997.0,29.7,59,31,23,27,9,16,65,24.6,49,27,2,25,32,91,34,0,"MF,FW",20-24,Midfielder,Spain,Europe
1703,Édgar Méndez,ESP,Alavés,La Liga,2020,30.0,1990.0,23.2,39,29,18,13,8,15,48,31.3,33,20,3,17,19,58,14,0,"MF,FW",30-34,Midfielder,Spain,Europe
1704,Eñaut Mendía,ESP,Eibar,La Liga,2020,21.0,1999.0,0.7,2,1,2,0,0,1,2,50.0,1,1,1,0,0,2,0,0,FW,20-24,Forward,Spain,Europe
1713,Jorge Meré,ESP,Köln,Bundesliga,2020,23.0,1997.0,14.4,13,6,9,3,1,6,13,46.2,7,14,11,3,15,28,63,0,DF,20-24,Defender,Spain,Europe
1715,Mikel Merino,ESP,Real Sociedad,La Liga,2020,24.0,1996.0,23.9,61,36,14,36,11,18,45,40.0,27,36,8,28,32,93,26,0,MF,20-24,Midfielder,Spain,Europe
1716,Martín Merquelanz,ESP,Real Sociedad,La Liga,2020,25.0,1995.0,6.1,9,3,3,2,4,2,7,28.6,5,7,1,6,3,12,4,0,"MF,FW",25-29,Midfielder,Spain,Europe
1719,Roque Mesa,ESP,Valladolid,La Liga,2020,31.0,1989.0,19.6,46,29,18,24,4,20,47,42.6,27,11,2,9,14,60,23,1,MF,30-34,Midfielder,Spain,Europe
1727,Míchel,ESP,Valladolid,La Liga,2020,32.0,1988.0,10.5,18,11,10,3,5,5,22,22.7,17,10,1,9,9,27,12,1,MF,30-34,Midfielder,Spain,Europe
1731,Petar Mićin,SRB,Udinese,Serie A,2020,21.0,1998.0,0.2,0,0,0,0,0,0,0,,0,0,0,0,0,0,0,0,MF,20-24,Midfielder,Serbia,Europe
1734,Nikola Milenković,SRB,Fiorentina,Serie A,2020,22.0,1997.0,33.7,49,29,33,14,2,21,33,63.6,12,42,33,9,44,93,122,1,DF,20-24,Defender,Serbia,Europe
1735,Arkadiusz Milik,POL,Marseille,Ligue 1,2020,26.0,1994.0,13.6,14,9,0,7,7,2,12,16.7,10,5,1,4,2,16,9,0,FW,25-29,Forward,Poland,Europe
1736,Sergej Milinković-Savić,SRB,Lazio,Serie A,2020,25.0,1995.0,30.5,59,40,20,30,9,27,84,32.1,57,52,12,40,33,92,47,0,MF,25-29,Midfielder,Serbia,Europe
1737,Vanja Milinković-Savić,SRB,Torino,Serie A,2020,23.0,1997.0,5.0,1,1,1,0,0,1,1,100.0,0,0,0,0,0,1,1,3,GK,20-24,Goalkeeper,Serbia,Europe
1739,Luka Milivojević,SRB,Crystal Palace,Premier League,2020,29.0,1991.0,26.2,65,34,25,31,9,42,77,54.5,35,29,6,23,35,100,47,2,MF,25-29,Midfielder,Serbia,Europe
1740,Luis Milla,ESP,Granada,La Liga,2020,25.0,1994.0,13.9,22,11,11,10,1,6,28,21.4,22,10,0,10,24,46,16,1,MF,25-29,Midfielder,Spain,Europe
1741,Pere Milla,ESP,Elche,La Liga,2020,27.0,1992.0,22.0,24,17,12,10,2,8,37,21.6,29,17,5,12,13,37,17,1,"FW,MF",25-29,Forward,Spain,Europe
1742,Álex Millán,ESP,Villarreal,La Liga,2020,20.0,1999.0,0.0,0,0,0,0,0,0,0,,0,0,0,0,0,0,0,0,FW,20-24,Forward,Spain,Europe
1746,Santi Mina,ESP,Celta Vigo,La Liga,2020,24.0,1995.0,26.8,31,13,9,12,10,6,37,16.2,31,15,3,12,6,37,17,0,FW,20-24,Forward,Spain,Europe
1751,Óscar Mingueza,ESP,Barcelona,La Liga,2020,21.0,1999.0,21.1,52,33,28,17,7,30,53,56.6,23,19,6,13,20,72,48,2,DF,20-24,Defender,Spain,Europe
1752,Rafa Mir,ESP,Huesca,La Liga,2020,23.0,1997.0,32.0,15,9,4,4,7,7,22,31.8,15,14,2,12,15,30,25,0,FW,20-24,Forward,Spain,Europe
1753,Jorge Miramón,ESP,Levante,La Liga,2020,31.0,1989.0,19.2,32,22,26,6,0,21,35,60.0,14,22,2,20,27,59,54,0,DF,30-34,Defender,Spain,Europe
1755,Juan Miranda,ESP,Betis,La Liga,2020,20.0,2000.0,18.4,27,11,16,9,2,16,32,50.0,16,18,2,16,29,56,58,1,DF,20-24,Defender,Spain,Europe
1758,Aleksandar Mitrović,SRB,Fulham,Premier League,2020,25.0,1994.0,15.6,7,4,0,3,4,2,8,25.0,6,12,3,9,3,10,8,0,FW,25-29,Forward,Serbia,Europe
1759,Stefan Mitrović,SRB,Strasbourg,Ligue 1,2020,30.0,1990.0,30.9,36,27,29,7,0,24,37,64.9,13,23,13,10,31,67,108,5,DF,30-34,Defender,Serbia,Europe
1762,Jakub Moder,POL,Brighton,Premier League,2020,21.0,1999.0,7.2,15,7,5,7,3,7,20,35.0,13,12,1,11,3,18,9,0,"DF,MF",20-24,Defender,Poland,Europe
1772,Guillem Molina,ESP,Valencia,La Liga,2020,20.0,2000.0,1.7,1,0,1,0,0,0,5,0.0,5,1,1,0,4,5,5,0,DF,20-24,Defender,Spain,Europe
1773,Jorge Molina,ESP,Granada,La Liga,2020,38.0,1982.0,17.9,11,4,3,5,3,8,22,36.4,14,5,1,4,3,14,19,0,FW,35-39,Forward,Spain,Europe
1776,Victor Mollejo,ESP,Getafe,La Liga,2020,19.0,2001.0,0.8,2,1,1,0,1,0,1,0.0,1,0,0,0,0,2,0,0,"MF,DF",Under 20,Midfielder,Spain,Europe
1780,Jon Moncayola,ESP,Osasuna,La Liga,2020,22.0,1998.0,29.6,61,36,27,23,11,24,67,35.8,43,27,9,18,23,84,38,0,MF,20-24,Midfielder,Spain,Europe
1784,Nacho Monreal,ESP,Real Sociedad,La Liga,2020,34.0,1986.0,23.1,31,19,17,11,3,7,20,35.0,13,14,3,11,31,62,43,0,DF,30-34,Defender,Spain,Europe
1785,Cristóbal Montiel,ESP,Fiorentina,Serie A,2020,20.0,2000.0,0.0,0,0,0,0,0,0,1,0.0,1,0,0,0,0,0,0,0,"MF,FW",20-24,Midfielder,Spain,Europe
1787,Ángel Montoro,ESP,Granada,La Liga,2020,32.0,1988.0,15.1,15,9,7,7,1,4,16,25.0,12,13,3,10,22,37,21,0,MF,30-34,Midfielder,Spain,Europe
1788,Martín Montoya,ESP,Betis,La Liga,2020,29.0,1991.0,2.7,6,3,2,2,2,1,3,33.3,2,1,1,0,2,8,6,0,DF,25-29,Defender,Spain,Europe
1792,Álvaro Morata,ESP,Juventus,Serie A,2020,27.0,1992.0,22.4,17,12,2,10,5,4,28,14.3,24,22,2,20,5,22,21,0,FW,25-29,Forward,Spain,Europe
1793,Jan Morávek,CZE,Augsburg,Bundesliga,2020,30.0,1989.0,3.0,5,3,4,1,0,1,8,12.5,7,3,0,3,7,12,2,0,MF,30-34,Midfielder,Czech Republic,Europe
1794,Jon Morcillo,ESP,Athletic Club,La Liga,2020,21.0,1998.0,15.1,16,9,3,6,7,7,30,23.3,23,9,0,9,15,31,11,0,"MF,FW",20-24,Midfielder,Spain,Europe
1796,Alberto Moreno,ESP,Villarreal,La Liga,2020,28.0,1992.0,2.1,7,4,7,0,0,2,5,40.0,3,2,1,1,3,10,2,0,DF,25-29,Defender,Spain,Europe
1796,Alberto Moreno,ESP,Villarreal,La Liga,2020,28.0,1992.0,2.1,7,4,7,0,0,2,5,40.0,3,2,1,1,3,10,2,0,DF,25-29,Defender,Spain,Europe
1796,Alberto Moreno,ESP,Villarreal,La Liga,2020,28.0,1992.0,2.1,7,4,7,0,0,2,5,40.0,3,2,1,1,3,10,2,0,DF,25-29,Defender,Spain,Europe
1796,Alberto Moreno,ESP,Villarreal,La Liga,2020,28.0,1992.0,2.1,7,4,7,0,0,2,5,40.0,3,2,1,1,3,10,2,0,DF,25-29,Defender,Spain,Europe
1797,Álex Moreno,ESP,Betis,La Liga,2020,27.0,1993.0,19.8,42,26,25,12,5,20,43,46.5,23,18,4,14,35,77,48,0,DF,25-29,Defender,Spain,Europe
1798,Gerard Moreno,ESP,Villarreal,La Liga,2020,28.0,1992.0,29.7,24,15,8,10,6,7,34,20.6,27,17,4,13,15,39,26,0,FW,25-29,Forward,Spain,Europe
1799,Tete Morente,ESP,Elche,La Liga,2020,23.0,1996.0,22.4,31,17,17,9,5,9,39,23.1,30,20,0,20,13,44,28,0,"MF,FW",20-24,Midfielder,Spain,Europe
1800,Mateu Morey,ESP,Dortmund,Bundesliga,2020,20.0,2000.0,9.2,13,7,4,7,2,9,12,75.0,3,6,1,5,18,31,7,1,DF,20-24,Defender,Spain,Europe
1803,Raúl Moro,ESP,Lazio,Serie A,2020,17.0,2002.0,0.1,0,0,0,0,0,0,1,0.0,1,0,0,0,0,0,0,0,FW,Under 20,Forward,Spain,Europe
1804,Loren Morón,ESP,Betis,La Liga,2020,26.0,1993.0,11.0,11,7,2,6,3,1,16,6.3,15,11,0,11,3,14,14,0,FW,25-29,Forward,Spain,Europe
1805,Pedro Mosquera,ESP,Huesca,La Liga,2020,32.0,1988.0,22.8,38,18,19,18,1,13,53,24.5,40,23,6,17,31,69,38,1,MF,30-34,Midfielder,Spain,Europe
1817,Javi Moyano,ESP,Valladolid,La Liga,2020,34.0,1986.0,1.1,0,0,0,0,0,0,0,,0,2,0,2,0,0,2,0,DF,30-34,Defender,Spain,Europe
1825,Iker Muniain,ESP,Athletic Club,La Liga,2020,27.0,1992.0,21.6,20,7,4,10,6,6,24,25.0,18,15,0,15,11,31,4,0,"MF,FW",25-29,Midfielder,Spain,Europe
1826,Aihen Muñoz,ESP,Real Sociedad,La Liga,2020,22.0,1997.0,13.4,23,16,15,5,3,11,19,57.9,8,12,2,10,10,33,31,0,DF,20-24,Defender,Spain,Europe
1827,Joaquín Muñoz,ESP,Huesca,La Liga,2020,21.0,1999.0,0.5,0,0,0,0,0,0,2,0.0,2,0,0,0,1,1,0,0,FW,20-24,Forward,Spain,Europe
1847,Nacho,ESP,Valladolid,La Liga,2020,31.0,1989.0,20.1,43,21,29,10,4,24,52,46.2,28,21,1,20,29,72,47,0,DF,30-34,Defender,Spain,Europe
1848,Nacho,ESP,Real Madrid,La Liga,2020,30.0,1990.0,22.2,27,14,13,11,3,12,35,34.3,23,19,9,10,40,67,58,0,DF,30-34,Defender,Spain,Europe
1855,Nano,ESP,Cádiz,La Liga,2020,25.0,1995.0,0.1,0,0,0,0,0,0,0,,0,0,0,0,0,0,0,0,FW,25-29,Forward,Spain,Europe
1855,Nano,ESP,Cádiz,La Liga,2020,25.0,1995.0,0.1,0,0,0,0,0,0,0,,0,0,0,0,0,0,0,0,FW,25-29,Forward,Spain,Europe
1855,Nano,ESP,Cádiz,La Liga,2020,25.0,1995.0,0.1,0,0,0,0,0,0,0,,0,0,0,0,0,0,0,0,FW,25-29,Forward,Spain,Europe
1855,Nano,ESP,Cádiz,La Liga,2020,25.0,1995.0,0.1,0,0,0,0,0,0,0,,0,0,0,0,0,0,0,0,FW,25-29,Forward,Spain,Europe
1857,Matija Nastasić,SRB,Schalke 04,Bundesliga,2020,27.0,1993.0,13.6,11,7,9,2,0,9,16,56.3,7,22,18,4,26,37,51,1,DF,25-29,Defender,Serbia,Europe
1858,Roberto Navarro,ESP,Real Sociedad,La Liga,2020,18.0,2002.0,0.4,1,1,1,0,0,0,2,0.0,2,0,0,0,1,2,0,0,MF,Under 20,Midfielder,Spain,Europe
1859,Ximo Navarro,ESP,Alavés,La Liga,2020,30.0,1990.0,26.4,54,30,36,17,1,14,30,46.7,16,14,4,10,47,101,75,3,DF,30-34,Defender,Spain,Europe
1859,Ximo Navarro,ESP,Alavés,La Liga,2020,30.0,1990.0,26.4,54,30,36,17,1,14,30,46.7,16,14,4,10,47,101,75,3,DF,30-34,Defender,Spain,Europe
1859,Ximo Navarro,ESP,Alavés,La Liga,2020,30.0,1990.0,26.4,54,30,36,17,1,14,30,46.7,16,14,4,10,47,101,75,3,DF,30-34,Defender,Spain,Europe
1859,Ximo Navarro,ESP,Alavés,La Liga,2020,30.0,1990.0,26.4,54,30,36,17,1,14,30,46.7,16,14,4,10,47,101,75,3,DF,30-34,Defender,Spain,Europe
1860,Jesús Navas,ESP,Sevilla,La Liga,2020,34.0,1985.0,31.4,27,21,15,11,1,15,22,68.2,7,10,3,7,37,64,62,1,DF,30-34,Defender,Spain,Europe
1862,Raúl Navas,ESP,Osasuna,La Liga,2020,32.0,1988.0,1.9,6,3,5,1,0,4,6,66.7,2,0,0,0,3,9,13,0,DF,30-34,Defender,Spain,Europe
1870,Álvaro Negredo,ESP,Cádiz,La Liga,2020,34.0,1985.0,24.4,11,5,3,4,4,5,11,45.5,6,7,2,5,3,14,19,0,FW,30-34,Forward,Spain,Europe
1878,Carlos Neva,ESP,Granada,La Liga,2020,24.0,1996.0,20.0,12,6,6,6,0,6,11,54.5,5,16,4,12,27,39,58,0,DF,20-24,Defender,Spain,Europe
1892,Nieto,ESP,Cádiz,La Liga,2020,22.0,1998.0,0.2,1,1,0,1,0,0,0,,0,0,0,0,0,1,1,0,"FW,DF",20-24,Forward,Spain,Europe
1893,Saúl Ñíguez,ESP,Atlético Madrid,La Liga,2020,25.0,1994.0,22.6,57,34,27,23,7,30,59,50.8,29,35,2,33,19,76,43,0,"MF,DF",25-29,Midfielder,Spain,Europe
1896,Nino,ESP,Elche,La Liga,2020,40.0,1980.0,3.2,0,0,0,0,0,0,1,0.0,1,1,0,1,0,0,0,0,"FW,MF",Over 40,Forward,Spain,Europe
1896,Nino,ESP,Elche,La Liga,2020,40.0,1980.0,3.2,0,0,0,0,0,0,1,0.0,1,1,0,1,0,0,0,0,"FW,MF",Over 40,Forward,Spain,Europe
1896,Nino,ESP,Elche,La Liga,2020,40.0,1980.0,3.2,0,0,0,0,0,0,1,0.0,1,1,0,1,0,0,0,0,"FW,MF",Over 40,Forward,Spain,Europe
1896,Nino,ESP,Elche,La Liga,2020,40.0,1980.0,3.2,0,0,0,0,0,0,1,0.0,1,1,0,1,0,0,0,0,"FW,MF",Over 40,Forward,Spain,Europe
1897,Fernando Niño,ESP,Villarreal,La Liga,2020,19.0,2000.0,6.6,8,3,0,4,4,2,9,22.2,7,1,0,1,2,10,2,0,FW,Under 20,Forward,Spain,Europe
1904,Nolito,ESP,Celta Vigo,La Liga,2020,33.0,1986.0,28.9,70,36,30,30,10,32,92,34.8,60,46,2,44,22,92,19,0,"MF,FW",30-34,Midfielder,Spain,Europe
1906,Håvard Nordtveit,NOR,Hoffenheim,Bundesliga,2020,30.0,1990.0,7.8,6,2,5,1,0,6,8,75.0,2,4,2,2,13,19,42,0,DF,30-34,Defender,Norway,Europe
1908,Oliver Norwood,NIR,Sheffield Utd,Premier League,2020,29.0,1991.0,24.7,49,22,16,28,5,21,72,29.2,51,29,12,17,36,85,51,1,MF,25-29,Midfielder,Northern Ireland,Europe
1912,Unai Núñez,ESP,Athletic Club,La Liga,2020,23.0,1997.0,23.4,23,12,16,7,0,10,15,66.7,5,19,14,5,32,55,110,0,DF,20-24,Defender,Spain,Europe
1924,Jan Oblak,SVN,Atlético Madrid,La Liga,2020,27.0,1993.0,38.0,0,0,0,0,0,0,0,,0,0,0,0,0,0,6,2,GK,25-29,Goalkeeper,Slovenia,Europe
1929,Álvaro Odriozola,ESP,Real Madrid,La Liga,2020,24.0,1995.0,9.2,14,7,5,8,1,3,5,60.0,2,6,3,3,6,20,12,1,DF,20-24,Defender,Spain,Europe
1938,Kiko Olivas,ESP,Valladolid,La Liga,2020,31.0,1988.0,2.0,3,2,2,1,0,3,5,60.0,2,2,2,0,7,10,3,0,DF,30-34,Defender,Spain,Europe
1942,Dani Olmo,ESP,RB Leipzig,Bundesliga,2020,22.0,1998.0,24.4,23,14,6,13,4,4,23,17.4,19,15,0,15,13,36,21,0,MF,20-24,Midfielder,Spain,Europe
1948,Javier Ontiveros,ESP,Huesca,La Liga,2020,22.0,1997.0,10.2,21,14,10,10,1,9,26,34.6,17,12,0,12,9,30,6,0,"FW,MF",20-24,Forward,Spain,Europe
1971,Mikel Oyarzabal,ESP,Real Sociedad,La Liga,2020,23.0,1997.0,26.8,30,17,14,12,4,10,31,32.3,21,30,5,25,15,45,17,0,"FW,MF",20-24,Forward,Spain,Europe
1976,Fernando Pacheco,ESP,Alavés,La Liga,2020,28.0,1992.0,37.2,2,0,2,0,0,2,4,50.0,2,0,0,0,2,4,19,0,GK,25-29,Goalkeeper,Spain,Europe
1976,Fernando Pacheco,ESP,Alavés,La Liga,2020,28.0,1992.0,37.2,2,0,2,0,0,2,4,50.0,2,0,0,0,2,4,19,0,GK,25-29,Goalkeeper,Spain,Europe
1976,Fernando Pacheco,ESP,Alavés,La Liga,2020,28.0,1992.0,37.2,2,0,2,0,0,2,4,50.0,2,0,0,0,2,4,19,0,GK,25-29,Goalkeeper,Spain,Europe
1976,Fernando Pacheco,ESP,Alavés,La Liga,2020,28.0,1992.0,37.2,2,0,2,0,0,2,4,50.0,2,0,0,0,2,4,19,0,GK,25-29,Goalkeeper,Spain,Europe
1977,Jon Pacheco,ESP,Real Sociedad,La Liga,2020,19.0,2001.0,0.4,0,0,0,0,0,0,0,,0,0,0,0,1,1,0,0,DF,Under 20,Defender,Spain,Europe
1990,Martin Palumbo,NOR,Udinese,Serie A,2020,18.0,2002.0,0.7,0,0,0,0,0,0,0,,0,5,0,5,1,1,0,0,MF,Under 20,Midfielder,Norway,Europe
1997,Rubén Pardo,ESP,Bordeaux,Ligue 1,2020,27.0,1992.0,0.3,0,0,0,0,0,0,0,,0,0,0,0,1,1,0,0,MF,25-29,Midfielder,Spain,Europe
1999,Daniel Parejo,ESP,Villarreal,La Liga,2020,31.0,1989.0,34.6,65,40,32,23,10,33,81,40.7,48,35,8,27,45,110,21,3,MF,30-34,Midfielder,Spain,Europe
2008,Patric,ESP,Lazio,Serie A,2020,27.0,1993.0,17.7,30,16,15,11,4,13,24,54.2,11,13,3,10,18,48,51,1,DF,25-29,Defender,Spain,Europe
2013,Jiří Pavlenka,CZE,Werder Bremen,Bundesliga,2020,28.0,1992.0,34.0,2,0,2,0,0,2,2,100.0,0,0,0,0,1,3,17,4,GK,25-29,Goalkeeper,Czech Republic,Europe
2016,Strahinja Pavlović,SRB,Monaco,Ligue 1,2020,19.0,2001.0,0.0,0,0,0,0,0,0,0,,0,0,0,0,0,0,0,0,DF,Under 20,Defender,Serbia,Europe
2020,Bailey Peacock-Farrell,NIR,Burnley,Premier League,2020,23.0,1996.0,4.0,0,0,0,0,0,0,0,,0,0,0,0,0,0,0,0,GK,20-24,Goalkeeper,Northern Ireland,Europe
2022,Alfonso Pedraza,ESP,Villarreal,La Liga,2020,24.0,1996.0,23.3,35,19,16,11,8,11,31,35.5,20,21,5,16,34,69,47,1,DF,20-24,Defender,Spain,Europe
2023,Pedri,ESP,Barcelona,La Liga,2020,17.0,2002.0,26.8,44,27,16,16,12,17,71,23.9,54,46,1,45,33,77,7,0,MF,Under 20,Midfielder,Spain,Europe
2024,Pedro,ESP,Roma,Serie A,2020,33.0,1987.0,17.7,22,14,6,11,5,7,35,20.0,28,10,0,10,9,31,2,1,"MF,FW",30-34,Midfielder,Spain,Europe
2024,Pedro,ESP,Roma,Serie A,2020,33.0,1987.0,17.7,22,14,6,11,5,7,35,20.0,28,10,0,10,9,31,2,1,"MF,FW",30-34,Midfielder,Spain,Europe
2024,Pedro,ESP,Roma,Serie A,2020,33.0,1987.0,17.7,22,14,6,11,5,7,35,20.0,28,10,0,10,9,31,2,1,"MF,FW",30-34,Midfielder,Spain,Europe
2024,Pedro,ESP,Roma,Serie A,2020,33.0,1987.0,17.7,22,14,6,11,5,7,35,20.0,28,10,0,10,9,31,2,1,"MF,FW",30-34,Midfielder,Spain,Europe
2024,Pedro,ESP,Roma,Serie A,2020,33.0,1987.0,17.7,22,14,6,11,5,7,35,20.0,28,10,0,10,9,31,2,1,"MF,FW",30-34,Midfielder,Spain,Europe
2024,Pedro,ESP,Roma,Serie A,2020,33.0,1987.0,17.7,22,14,6,11,5,7,35,20.0,28,10,0,10,9,31,2,1,"MF,FW",30-34,Midfielder,Spain,Europe
2024,Pedro,ESP,Roma,Serie A,2020,33.0,1987.0,17.7,22,14,6,11,5,7,35,20.0,28,10,0,10,9,31,2,1,"MF,FW",30-34,Midfielder,Spain,Europe
2024,Pedro,ESP,Roma,Serie A,2020,33.0,1987.0,17.7,22,14,6,11,5,7,35,20.0,28,10,0,10,9,31,2,1,"MF,FW",30-34,Midfielder,Spain,Europe
2024,Pedro,ESP,Roma,Serie A,2020,33.0,1987.0,17.7,22,14,6,11,5,7,35,20.0,28,10,0,10,9,31,2,1,"MF,FW",30-34,Midfielder,Spain,Europe
2024,Pedro,ESP,Roma,Serie A,2020,33.0,1987.0,17.7,22,14,6,11,5,7,35,20.0,28,10,0,10,9,31,2,1,"MF,FW",30-34,Midfielder,Spain,Europe
2024,Pedro,ESP,Roma,Serie A,2020,33.0,1987.0,17.7,22,14,6,11,5,7,35,20.0,28,10,0,10,9,31,2,1,"MF,FW",30-34,Midfielder,Spain,Europe
2024,Pedro,ESP,Roma,Serie A,2020,33.0,1987.0,17.7,22,14,6,11,5,7,35,20.0,28,10,0,10,9,31,2,1,"MF,FW",30-34,Midfielder,Spain,Europe
2024,Pedro,ESP,Roma,Serie A,2020,33.0,1987.0,17.7,22,14,6,11,5,7,35,20.0,28,10,0,10,9,31,2,1,"MF,FW",30-34,Midfielder,Spain,Europe
2024,Pedro,ESP,Roma,Serie A,2020,33.0,1987.0,17.7,22,14,6,11,5,7,35,20.0,28,10,0,10,9,31,2,1,"MF,FW",30-34,Midfielder,Spain,Europe
2024,Pedro,ESP,Roma,Serie A,2020,33.0,1987.0,17.7,22,14,6,11,5,7,35,20.0,28,10,0,10,9,31,2,1,"MF,FW",30-34,Midfielder,Spain,Europe
2024,Pedro,ESP,Roma,Serie A,2020,33.0,1987.0,17.7,22,14,6,11,5,7,35,20.0,28,10,0,10,9,31,2,1,"MF,FW",30-34,Midfielder,Spain,Europe
2038,Rubén Peña,ESP,Villarreal,La Liga,2020,29.0,1991.0,12.4,25,14,8,15,2,19,33,57.6,14,20,1,19,13,38,19,0,DF,25-29,Defender,Spain,Europe
2041,Alberto Perea,ESP,Cádiz,La Liga,2020,29.0,1990.0,17.2,28,17,12,10,6,9,35,25.7,26,26,1,25,21,49,9,0,MF,25-29,Midfielder,Spain,Europe
2049,Bruno Peres,BRA,Roma,Serie A,2020,30.0,1990.0,15.9,21,11,11,7,3,13,24,54.2,11,18,4,14,27,48,11,0,DF,30-34,Defender,Brazil,South America
2050,Roberto Pereyra,ARG,Udinese,Serie A,2020,29.0,1991.0,32.5,18,11,7,8,3,7,23,30.4,16,24,5,19,27,45,24,0,"MF,FW",25-29,Midfielder,Argentina,South America
2058,Manuel Perez,FRA,Lens,Ligue 1,2020,29.0,1991.0,1.4,1,0,1,0,0,0,8,0.0,8,2,0,2,2,3,2,0,"MF,FW",25-29,Midfielder,France,Europe
2059,Nehuén Pérez,ARG,Granada,La Liga,2020,20.0,2000.0,8.2,6,3,6,0,0,4,6,66.7,2,5,4,1,12,18,33,0,DF,20-24,Defender,Argentina,South America
2060,Mattia Perin,ITA,Genoa,Serie A,2020,27.0,1992.0,32.0,0,0,0,0,0,0,0,,0,0,0,0,1,1,6,0,GK,25-29,Goalkeeper,Italy,Europe
2061,Ivan Perišić,CRO,Inter,Serie A,2020,31.0,1989.0,19.9,22,13,11,6,5,12,33,36.4,21,33,4,29,19,41,36,1,"DF,FW",30-34,Defender,Croatia,Europe
2062,Romain Perraud,FRA,Brest,Ligue 1,2020,22.0,1997.0,34.9,60,34,42,16,2,24,45,53.3,21,36,3,33,45,105,76,0,DF,20-24,Defender,France,Europe
2063,Lucas Perrin,FRA,Marseille,Ligue 1,2020,21.0,1998.0,3.4,7,4,4,3,0,5,12,41.7,7,5,4,1,8,15,16,0,DF,20-24,Defender,France,Europe
2064,Pavao Pervan,AUT,Wolfsburg,Bundesliga,2020,32.0,1987.0,2.0,0,0,0,0,0,0,0,,0,0,0,0,0,0,1,0,GK,30-34,Goalkeeper,Austria,Europe
2065,Matteo Pessina,ITA,Atalanta,Serie A,2020,23.0,1997.0,18.3,14,7,4,6,4,7,24,29.2,17,17,2,15,17,31,7,1,MF,20-24,Midfielder,Italy,Europe
2066,Andrea Petagna,ITA,Napoli,Serie A,2020,25.0,1995.0,10.7,2,0,0,2,0,2,7,28.6,5,4,0,4,1,3,7,0,FW,25-29,Forward,Italy,Europe
2067,Nils Petersen,GER,Freiburg,Bundesliga,2020,31.0,1988.0,14.5,11,7,2,6,3,3,21,14.3,18,25,1,24,9,20,28,0,FW,30-34,Forward,Germany,Europe
2068,Lukas Petkov,BUL,Augsburg,Bundesliga,2020,19.0,2000.0,0.0,0,0,0,0,0,0,0,,0,0,0,0,0,0,0,0,MF,Under 20,Midfielder,Bulgaria,Europe
2069,Jacopo Petriccione,ITA,Crotone,Serie A,2020,25.0,1995.0,10.6,14,8,6,7,1,9,24,37.5,15,11,2,9,8,22,11,0,MF,25-29,Midfielder,Italy,Europe
2071,Germán Pezzella,ARG,Fiorentina,Serie A,2020,29.0,1991.0,30.5,34,20,22,12,0,18,32,56.3,14,26,14,12,36,70,109,1,DF,25-29,Defender,Argentina,South America
2072,Giuseppe Pezzella,ITA,Parma,Serie A,2020,22.0,1997.0,20.3,34,19,23,9,2,22,41,53.7,19,22,9,13,12,46,52,3,DF,20-24,Defender,Italy,Europe
2073,Maximilian Philipp,GER,Wolfsburg,Bundesliga,2020,26.0,1994.0,12.3,15,6,3,6,6,5,21,23.8,16,17,0,17,6,21,3,0,MF,25-29,Midfielder,Germany,Europe
2074,Rayan Philippe,FRA,Dijon,Ligue 1,2020,19.0,2000.0,1.0,3,1,1,1,1,2,2,100.0,0,0,0,0,0,3,0,0,FW,Under 20,Forward,France,Europe
2075,Romain Philippoteaux,FRA,Nîmes,Ligue 1,2020,32.0,1988.0,2.4,1,1,1,0,0,1,5,20.0,4,2,0,2,2,3,1,0,"FW,MF",30-34,Forward,France,Europe
2076,Romain Philippoteaux,FRA,Brest,Ligue 1,2020,32.0,1988.0,6.5,11,6,6,3,2,6,9,66.7,3,4,0,4,10,21,2,0,"MF,FW",30-34,Midfielder,France,Europe
2077,Kalvin Phillips,ENG,Leeds United,Premier League,2020,24.0,1995.0,27.0,74,38,38,29,7,26,62,41.9,36,49,14,35,45,119,53,3,MF,20-24,Midfielder,England,Europe
2078,Matt Phillips,SCO,West Brom,Premier League,2020,29.0,1991.0,20.3,15,8,4,11,0,7,23,30.4,16,32,4,28,10,25,32,1,MF,25-29,Midfielder,Scotland,Europe
2079,Nathaniel Phillips,ENG,Liverpool,Premier League,2020,23.0,1997.0,16.2,22,14,15,7,0,11,24,45.8,13,17,14,3,20,42,81,0,DF,20-24,Defender,England,Europe
2080,Jaden Philogene Bidace,ENG,Aston Villa,Premier League,2020,18.0,2002.0,0.0,0,0,0,0,0,0,0,,0,0,0,0,0,0,0,0,FW,Under 20,Forward,England,Europe
2082,Pablo Piatti,ARG,Elche,La Liga,2020,31.0,1989.0,4.0,8,6,3,3,2,3,12,25.0,9,5,0,5,2,10,1,0,"MF,FW",30-34,Midfielder,Argentina,South America
2083,Cristiano Piccini,ITA,Atalanta,Serie A,2020,27.0,1992.0,0.7,1,1,1,0,0,0,1,0.0,1,1,0,1,0,1,0,0,DF,25-29,Defender,Italy,Europe
2084,Cristiano Piccini,ITA,Valencia,La Liga,2020,27.0,1992.0,0.7,1,1,1,0,0,1,2,50.0,1,0,0,0,0,1,3,0,DF,25-29,Defender,Italy,Europe
2085,Roberto Piccoli,ITA,Spezia,Serie A,2020,19.0,2001.0,7.8,7,3,0,4,3,2,4,50.0,2,4,0,4,2,9,5,0,FW,Under 20,Forward,Italy,Europe
2086,Jordan Pickford,ENG,Everton,Premier League,2020,26.0,1994.0,30.5,0,0,0,0,0,0,2,0.0,2,2,0,2,3,3,16,4,GK,25-29,Goalkeeper,England,Europe
2087,Jérémy Pied,FRA,Lille,Ligue 1,2020,31.0,1989.0,3.5,7,0,3,3,1,4,9,44.4,5,3,1,2,6,13,8,0,DF,30-34,Defender,France,Europe
2088,Amos Pieper,GER,Arminia,Bundesliga,2020,22.0,1998.0,29.8,58,32,39,17,2,20,33,60.6,13,48,35,13,66,124,160,3,DF,20-24,Defender,Germany,Europe
2089,Ronaël Pierre-Gabriel,FRA,Brest,Ligue 1,2020,22.0,1998.0,25.6,60,40,42,16,2,35,52,67.3,17,17,7,10,30,90,57,0,DF,20-24,Defender,France,Europe
2090,Erik Pieters,NED,Burnley,Premier League,2020,31.0,1988.0,14.1,30,21,18,9,3,19,39,48.7,20,30,9,21,12,42,34,0,"DF,MF",30-34,Defender,Netherlands,Europe
2092,Andrea Pinamonti,ITA,Inter,Serie A,2020,21.0,1999.0,1.9,0,0,0,0,0,0,0,,0,1,0,1,1,1,2,0,FW,20-24,Forward,Italy,Europe
2094,Carlo Pinsoglio,ITA,Juventus,Serie A,2020,30.0,1990.0,0.3,0,0,0,0,0,0,0,,0,0,0,0,0,0,0,0,GK,30-34,Goalkeeper,Italy,Europe
2096,Fabio Pisacane,ITA,Cagliari,Serie A,2020,34.0,1986.0,2.5,3,2,2,1,0,3,7,42.9,4,8,5,3,1,4,9,1,DF,30-34,Defender,Italy,Europe
2098,Marko Pjaca,CRO,Genoa,Serie A,2020,25.0,1995.0,15.8,13,6,6,3,4,4,16,25.0,12,7,2,5,7,20,12,0,"FW,MF",25-29,Forward,Croatia,Europe
2099,Miralem Pjanić,BIH,Barcelona,La Liga,2020,30.0,1990.0,7.0,13,8,7,4,2,7,13,53.8,6,5,1,4,11,24,5,0,MF,30-34,Midfielder,Bosnia and Herzegovina,Europe
2101,Marvin Plattenhardt,GER,Hertha BSC,Bundesliga,2020,28.0,1992.0,11.9,15,10,6,7,2,5,9,55.6,4,9,1,8,1,16,19,1,DF,25-29,Defender,Germany,Europe
2102,Alassane Pléa,FRA,Gladbach,Bundesliga,2020,27.0,1993.0,20.0,19,9,4,10,5,5,20,25.0,15,1,0,1,5,24,7,0,FW,25-29,Forward,France,Europe
2104,Tommaso Pobega,ITA,Spezia,Serie A,2020,21.0,1999.0,13.7,24,13,7,13,4,11,31,35.5,20,10,2,8,9,33,22,0,MF,20-24,Midfielder,Italy,Europe
2105,Daniel Podence,POR,Wolves,Premier League,2020,24.0,1995.0,18.5,12,6,5,5,2,2,19,10.5,17,5,1,4,13,25,2,0,"MF,FW",20-24,Midfielder,Portugal,Europe
2106,Paul Pogba,FRA,Manchester Utd,Premier League,2020,27.0,1993.0,21.1,36,26,15,16,5,11,33,33.3,22,24,2,22,26,62,37,0,"MF,FW",25-29,Midfielder,France,Europe
2107,Joel Pohjanpalo,FIN,Union Berlin,Bundesliga,2020,25.0,1994.0,9.5,5,1,0,3,2,1,6,16.7,5,1,0,1,1,6,12,0,FW,25-29,Forward,Finland,Europe
2108,Joel Pohjanpalo,FIN,Leverkusen,Bundesliga,2020,25.0,1994.0,0.1,0,0,0,0,0,0,0,,0,0,0,0,0,0,0,0,MF,25-29,Midfielder,Finland,Europe
2109,Andrea Poli,ITA,Bologna,Serie A,2020,30.0,1989.0,4.3,9,7,4,2,3,6,12,50.0,6,7,1,6,7,16,7,0,MF,30-34,Midfielder,Italy,Europe
2110,Matteo Politano,ITA,Napoli,Serie A,2020,26.0,1993.0,21.2,24,16,13,9,2,11,47,23.4,36,14,1,13,14,38,18,0,"FW,MF",25-29,Forward,Italy,Europe
2112,Marin Pongračić,CRO,Wolfsburg,Bundesliga,2020,22.0,1997.0,6.4,13,9,9,3,1,6,8,75.0,2,12,5,7,11,24,27,0,DF,20-24,Defender,Croatia,Europe
2114,Nick Pope,ENG,Burnley,Premier League,2020,28.0,1992.0,32.0,1,1,1,0,0,0,1,0.0,1,0,0,0,2,3,29,2,GK,25-29,Goalkeeper,England,Europe
2115,Manolo Portanova,ITA,Genoa,Serie A,2020,20.0,2000.0,0.7,3,3,1,1,1,0,2,0.0,2,3,1,2,1,4,2,0,"MF,FW",20-24,Midfielder,Italy,Europe
2116,Manolo Portanova,ITA,Juventus,Serie A,2020,20.0,2000.0,0.8,2,0,2,0,0,0,2,0.0,2,4,1,3,0,2,1,0,MF,20-24,Midfielder,Italy,Europe
2119,Stefan Posch,AUT,Hoffenheim,Bundesliga,2020,23.0,1997.0,23.5,52,24,29,17,6,27,47,57.4,20,27,8,19,37,89,73,1,DF,20-24,Defender,Austria,Europe
2121,Yussuf Poulsen,DEN,RB Leipzig,Bundesliga,2020,26.0,1994.0,15.0,10,6,1,6,3,1,17,5.9,16,16,0,16,6,16,13,0,FW,25-29,Forward,Denmark,Europe
2122,Maxime Poundjé,FRA,Bordeaux,Ligue 1,2020,27.0,1992.0,5.5,10,7,9,1,0,2,6,33.3,4,7,3,4,11,21,5,0,DF,25-29,Defender,France,Europe
2124,Ian Poveda,ENG,Leeds United,Premier League,2020,20.0,2000.0,3.9,5,4,3,0,2,1,7,14.3,6,5,1,4,1,6,2,0,MF,20-24,Midfielder,England,Europe
2126,Dennis Praet,BEL,Leicester City,Premier League,2020,26.0,1994.0,8.0,14,7,4,7,3,6,15,40.0,9,12,2,10,7,21,3,0,MF,25-29,Midfielder,Belgium,Europe
2127,Sanjin Prcić,BIH,Strasbourg,Ligue 1,2020,26.0,1993.0,3.9,3,2,0,3,0,2,5,40.0,3,4,3,1,4,7,2,1,MF,25-29,Midfielder,Bosnia and Herzegovina,Europe
2128,Nicolas de Préville,FRA,Bordeaux,Ligue 1,2020,29.0,1991.0,17.9,19,14,7,6,6,9,42,21.4,33,15,0,15,13,32,7,0,"FW,MF",25-29,Forward,France,Europe
2129,Manuel Prietl,AUT,Arminia,Bundesliga,2020,28.0,1991.0,28.0,65,44,33,28,4,12,73,16.4,61,34,7,27,45,110,24,0,MF,25-29,Midfielder,Austria,Europe
2130,Grischa Prömel,GER,Union Berlin,Bundesliga,2020,25.0,1995.0,20.2,39,23,14,23,2,18,34,52.9,16,20,2,18,24,63,22,0,MF,25-29,Midfielder,Germany,Europe
2131,Davy Pröpper,NED,Brighton,Premier League,2020,28.0,1991.0,2.4,6,5,0,6,0,2,5,40.0,3,3,0,3,1,7,0,0,MF,25-29,Midfielder,Netherlands,Europe
2132,Ivan Provedel,ITA,Spezia,Serie A,2020,26.0,1994.0,29.0,2,0,2,0,0,2,6,33.3,4,0,0,0,2,4,20,1,GK,25-29,Goalkeeper,Italy,Europe
2135,Erick Pulgar,CHI,Fiorentina,Serie A,2020,26.0,1994.0,22.2,41,18,17,23,1,22,49,44.9,27,24,10,14,41,82,45,1,MF,25-29,Midfielder,Chile,South America
2137,Christian Pulisic,USA,Chelsea,Premier League,2020,21.0,1998.0,19.3,19,11,8,10,1,8,21,38.1,13,25,2,23,12,31,9,0,"FW,MF",20-24,Forward,United States,North America
2138,Ignacio Pussetto,ARG,Udinese,Serie A,2020,24.0,1995.0,8.4,16,8,5,6,5,6,17,35.3,11,14,0,14,13,29,6,0,FW,20-24,Forward,Argentina,South America
2139,Fabio Quagliarella,ITA,Sampdoria,Serie A,2020,37.0,1983.0,24.5,12,8,4,4,4,2,19,10.5,17,14,1,13,7,19,10,0,FW,35-39,Forward,Italy,Europe
2140,Robin Quaison,SWE,Mainz 05,Bundesliga,2020,26.0,1993.0,16.4,14,6,3,6,5,7,14,50.0,7,10,0,10,13,27,10,0,"FW,MF",25-29,Forward,Sweden,Europe
2141,Domingos Quina,POR,Granada,La Liga,2020,20.0,1999.0,3.8,5,5,1,3,1,3,6,50.0,3,8,0,8,2,7,0,0,MF,20-24,Midfielder,Portugal,Europe
2145,Simone Rabbi,ITA,Bologna,Serie A,2020,18.0,2001.0,0.4,0,0,0,0,0,0,1,0.0,1,0,0,0,0,0,0,0,"FW,DF",Under 20,Forward,Italy,Europe
2146,Adrien Rabiot,FRA,Juventus,Serie A,2020,25.0,1995.0,25.7,72,42,24,41,7,28,60,46.7,32,32,11,21,43,115,29,1,MF,25-29,Midfielder,France,Europe
2148,Anthony Racioppi,SUI,Dijon,Ligue 1,2020,21.0,1998.0,21.0,0,0,0,0,0,0,2,0.0,2,0,0,0,2,2,12,4,GK,20-24,Goalkeeper,Switzerland,Europe
2154,Ionuț Radu,ROU,Inter,Serie A,2020,23.0,1997.0,1.5,0,0,0,0,0,0,0,,0,0,0,0,0,0,1,0,GK,20-24,Goalkeeper,Romania,Europe
2155,Ștefan Radu,ROU,Lazio,Serie A,2020,33.0,1986.0,27.3,43,24,20,19,4,25,40,62.5,15,27,14,13,45,88,73,1,DF,30-34,Defender,Romania,Europe
2156,Rafael,BRA,Spezia,Serie A,2020,38.0,1982.0,2.3,0,0,0,0,0,0,0,,0,0,0,0,0,0,0,0,GK,35-39,Goalkeeper,Brazil,South America
2156,Rafael,BRA,Spezia,Serie A,2020,38.0,1982.0,2.3,0,0,0,0,0,0,0,,0,0,0,0,0,0,0,0,GK,35-39,Goalkeeper,Brazil,South America
2156,Rafael,BRA,Spezia,Serie A,2020,38.0,1982.0,2.3,0,0,0,0,0,0,0,,0,0,0,0,0,0,0,0,GK,35-39,Goalkeeper,Brazil,South America
2156,Rafael,BRA,Spezia,Serie A,2020,38.0,1982.0,2.3,0,0,0,0,0,0,0,,0,0,0,0,0,0,0,0,GK,35-39,Goalkeeper,Brazil,South America
2157,Rafinha,BRA,Paris S-G,Ligue 1,2020,27.0,1993.0,15.1,54,26,18,28,8,28,49,57.1,21,18,3,15,13,67,6,0,"MF,FW",25-29,Midfielder,Brazil,South America
2157,Rafinha,BRA,Paris S-G,Ligue 1,2020,27.0,1993.0,15.1,54,26,18,28,8,28,49,57.1,21,18,3,15,13,67,6,0,"MF,FW",25-29,Midfielder,Brazil,South America
2157,Rafinha,BRA,Paris S-G,Ligue 1,2020,27.0,1993.0,15.1,54,26,18,28,8,28,49,57.1,21,18,3,15,13,67,6,0,"MF,FW",25-29,Midfielder,Brazil,South America
2157,Rafinha,BRA,Paris S-G,Ligue 1,2020,27.0,1993.0,15.1,54,26,18,28,8,28,49,57.1,21,18,3,15,13,67,6,0,"MF,FW",25-29,Midfielder,Brazil,South America
2157,Rafinha,BRA,Paris S-G,Ligue 1,2020,27.0,1993.0,15.1,54,26,18,28,8,28,49,57.1,21,18,3,15,13,67,6,0,"MF,FW",25-29,Midfielder,Brazil,South America
2157,Rafinha,BRA,Paris S-G,Ligue 1,2020,27.0,1993.0,15.1,54,26,18,28,8,28,49,57.1,21,18,3,15,13,67,6,0,"MF,FW",25-29,Midfielder,Brazil,South America
2157,Rafinha,BRA,Paris S-G,Ligue 1,2020,27.0,1993.0,15.1,54,26,18,28,8,28,49,57.1,21,18,3,15,13,67,6,0,"MF,FW",25-29,Midfielder,Brazil,South America
2157,Rafinha,BRA,Paris S-G,Ligue 1,2020,27.0,1993.0,15.1,54,26,18,28,8,28,49,57.1,21,18,3,15,13,67,6,0,"MF,FW",25-29,Midfielder,Brazil,South America
2157,Rafinha,BRA,Paris S-G,Ligue 1,2020,27.0,1993.0,15.1,54,26,18,28,8,28,49,57.1,21,18,3,15,13,67,6,0,"MF,FW",25-29,Midfielder,Brazil,South America
2157,Rafinha,BRA,Paris S-G,Ligue 1,2020,27.0,1993.0,15.1,54,26,18,28,8,28,49,57.1,21,18,3,15,13,67,6,0,"MF,FW",25-29,Midfielder,Brazil,South America
2157,Rafinha,BRA,Paris S-G,Ligue 1,2020,27.0,1993.0,15.1,54,26,18,28,8,28,49,57.1,21,18,3,15,13,67,6,0,"MF,FW",25-29,Midfielder,Brazil,South America
2157,Rafinha,BRA,Paris S-G,Ligue 1,2020,27.0,1993.0,15.1,54,26,18,28,8,28,49,57.1,21,18,3,15,13,67,6,0,"MF,FW",25-29,Midfielder,Brazil,South America
2157,Rafinha,BRA,Paris S-G,Ligue 1,2020,27.0,1993.0,15.1,54,26,18,28,8,28,49,57.1,21,18,3,15,13,67,6,0,"MF,FW",25-29,Midfielder,Brazil,South America
2157,Rafinha,BRA,Paris S-G,Ligue 1,2020,27.0,1993.0,15.1,54,26,18,28,8,28,49,57.1,21,18,3,15,13,67,6,0,"MF,FW",25-29,Midfielder,Brazil,South America
2157,Rafinha,BRA,Paris S-G,Ligue 1,2020,27.0,1993.0,15.1,54,26,18,28,8,28,49,57.1,21,18,3,15,13,67,6,0,"MF,FW",25-29,Midfielder,Brazil,South America
2157,Rafinha,BRA,Paris S-G,Ligue 1,2020,27.0,1993.0,15.1,54,26,18,28,8,28,49,57.1,21,18,3,15,13,67,6,0,"MF,FW",25-29,Midfielder,Brazil,South America
2158,Antonio Raimondo,ITA,Bologna,Serie A,2020,16.0,2004.0,0.0,0,0,0,0,0,0,0,,0,0,0,0,0,0,0,0,FW,Under 20,Forward,Italy,Europe
2160,Ivan Rakitić,CRO,Sevilla,La Liga,2020,32.0,1988.0,24.8,32,18,18,10,4,12,41,29.3,29,19,4,15,26,58,29,1,MF,30-34,Midfielder,Croatia,Europe
2162,Benito Raman,BEL,Schalke 04,Bundesliga,2020,25.0,1994.0,13.8,19,13,11,6,2,6,29,20.7,23,11,0,11,5,24,5,0,"FW,MF",25-29,Forward,Belgium,Europe
2163,Gastón Ramírez,URU,Sampdoria,Serie A,2020,29.0,1990.0,10.8,31,15,10,17,4,8,27,29.6,19,19,3,16,4,35,13,0,"FW,MF",25-29,Forward,Uruguay,South America
2166,Aaron Ramsdale,ENG,Sheffield Utd,Premier League,2020,22.0,1998.0,38.0,1,1,1,0,0,1,1,100.0,0,0,0,0,2,3,22,6,GK,20-24,Goalkeeper,England,Europe
2167,Aaron Ramsey,WAL,Juventus,Serie A,2020,29.0,1990.0,12.1,22,14,8,13,1,8,25,32.0,17,13,2,11,7,29,8,2,MF,25-29,Midfielder,Wales,Europe
2167,Aaron Ramsey,WAL,Juventus,Serie A,2020,29.0,1990.0,12.1,22,14,8,13,1,8,25,32.0,17,13,2,11,7,29,8,2,MF,25-29,Midfielder,Wales,Europe
2167,Aaron Ramsey,WAL,Juventus,Serie A,2020,29.0,1990.0,12.1,22,14,8,13,1,8,25,32.0,17,13,2,11,7,29,8,2,MF,25-29,Midfielder,Wales,Europe
2167,Aaron Ramsey,WAL,Juventus,Serie A,2020,29.0,1990.0,12.1,22,14,8,13,1,8,25,32.0,17,13,2,11,7,29,8,2,MF,25-29,Midfielder,Wales,Europe
2168,Jacob Ramsey,ENG,Aston Villa,Premier League,2020,19.0,2001.0,7.0,10,5,3,4,3,2,12,16.7,10,13,6,7,4,14,5,0,MF,Under 20,Midfielder,England,Europe
2169,Kayne Ramsey,ENG,Southampton,Premier League,2020,19.0,2000.0,1.0,5,2,4,1,0,3,3,100.0,0,0,0,0,0,5,3,0,DF,Under 20,Defender,England,Europe
2170,Darren Randolph,IRL,West Ham,Premier League,2020,33.0,1987.0,3.0,0,0,0,0,0,0,0,,0,0,0,0,0,0,1,0,GK,30-34,Goalkeeper,Republic of Ireland,Europe
2171,Andrea Ranocchia,ITA,Inter,Serie A,2020,32.0,1988.0,7.8,13,10,6,6,1,7,8,87.5,1,5,3,2,12,25,19,0,DF,30-34,Defender,Italy,Europe
2172,Raphinha,BRA,Leeds United,Premier League,2020,23.0,1996.0,26.2,34,17,13,16,5,12,58,20.7,46,31,1,30,29,63,27,0,"MF,FW",20-24,Midfielder,Brazil,South America
2173,Raphinha,BRA,Rennes,Ligue 1,2020,23.0,1996.0,4.5,5,2,1,3,1,1,4,25.0,3,5,0,5,3,8,4,0,"FW,MF",20-24,Forward,Brazil,South America
2174,Marcus Rashford,ENG,Manchester Utd,Premier League,2020,22.0,1997.0,32.4,18,9,2,8,8,7,27,25.9,20,22,2,20,8,26,10,0,FW,20-24,Forward,England,Europe
2176,Giacomo Raspadori,ITA,Sassuolo,Serie A,2020,20.0,2000.0,13.7,5,3,1,1,3,0,4,0.0,4,13,5,8,2,7,9,0,"FW,MF",20-24,Forward,Italy,Europe
2177,Federico Ravaglia,ITA,Bologna,Serie A,2020,20.0,1999.0,4.0,0,0,0,0,0,0,1,0.0,1,0,0,0,0,0,2,0,GK,20-24,Goalkeeper,Italy,Europe
2178,Tim Ream,USA,Fulham,Premier League,2020,32.0,1987.0,7.0,12,5,9,3,0,8,11,72.7,3,8,5,3,6,18,26,1,DF,30-34,Defender,United States,North America
2179,Ante Rebić,CRO,Milan,Serie A,2020,26.0,1993.0,19.7,26,9,4,8,14,8,37,21.6,29,21,1,20,7,33,17,0,FW,25-29,Forward,Croatia,Europe
2182,Daishawn Redan,NED,Hertha BSC,Bundesliga,2020,19.0,2001.0,1.1,0,0,0,0,0,0,0,,0,1,0,1,0,0,0,0,"FW,MF",Under 20,Forward,Netherlands,Europe
2183,Nathan Redmond,ENG,Southampton,Premier League,2020,26.0,1994.0,19.3,30,17,14,12,4,8,24,33.3,16,24,2,22,11,41,9,0,"MF,FW",25-29,Midfielder,England,Europe
2184,Harrison Reed,ENG,Fulham,Premier League,2020,25.0,1995.0,25.0,63,38,28,28,7,29,73,39.7,44,34,11,23,50,113,31,1,MF,25-29,Midfielder,England,Europe
2185,Vasco Regini,ITA,Sampdoria,Serie A,2020,29.0,1990.0,1.0,2,2,2,0,0,2,2,100.0,0,1,1,0,1,3,5,0,DF,25-29,Defender,Italy,Europe
2187,Bobby Reid,JAM,Fulham,Premier League,2020,27.0,1993.0,26.4,31,15,17,10,4,18,39,46.2,21,19,5,14,21,52,39,0,"MF,FW",25-29,Midfielder,Jamaica,North America
2189,Jeff Reine-Adélaïde,FRA,Nice,Ligue 1,2020,22.0,1998.0,11.8,7,4,1,4,2,2,9,22.2,7,10,1,9,4,11,6,0,"MF,FW",20-24,Midfielder,France,Europe
2190,Jeff Reine-Adélaïde,FRA,Lyon,Ligue 1,2020,22.0,1998.0,0.3,0,0,0,0,0,0,0,,0,0,0,0,0,0,0,0,FW,20-24,Forward,France,Europe
2191,Reinier,BRA,Dortmund,Bundesliga,2020,18.0,2002.0,2.9,9,4,6,1,2,2,4,50.0,2,4,1,3,2,11,0,0,"MF,FW",Under 20,Midfielder,Brazil,South America
2192,Francisco Reis Ferreira,POR,Valencia,La Liga,2020,23.0,1997.0,2.0,1,1,1,0,0,0,3,0.0,3,0,0,0,0,1,6,0,DF,20-24,Defender,Portugal,Europe
2193,Rocco Reitz,GER,Gladbach,Bundesliga,2020,18.0,2002.0,0.7,3,2,0,3,0,2,2,100.0,0,3,1,2,1,4,1,0,MF,Under 20,Midfielder,Germany,Europe
2194,Karim Rekik,NED,Sevilla,La Liga,2020,25.0,1994.0,7.3,7,5,2,5,0,1,4,25.0,3,8,3,5,6,13,17,0,DF,25-29,Defender,Netherlands,Europe
2196,Panagiotis Retsos,GRE,Saint-Étienne,Ligue 1,2020,21.0,1998.0,3.0,5,3,5,0,0,3,7,42.9,4,1,1,0,3,8,12,0,DF,20-24,Defender,Greece,Europe
2197,Marco Reus,GER,Dortmund,Bundesliga,2020,31.0,1989.0,25.3,33,16,9,16,8,9,33,27.3,24,22,2,20,14,47,13,0,"MF,FW",30-34,Midfielder,Germany,Europe
2200,Gio Reyna,USA,Dortmund,Bundesliga,2020,17.0,2002.0,22.0,24,13,9,8,7,9,25,36.0,16,14,1,13,10,34,11,0,"MF,FW",Under 20,Midfielder,United States,North America
2201,Baptiste Reynet,FRA,Nîmes,Ligue 1,2020,29.0,1990.0,38.0,2,1,2,0,0,2,4,50.0,2,1,0,1,1,3,9,2,GK,25-29,Goalkeeper,France,Europe
2202,Bryan Reynolds,USA,Roma,Serie A,2020,19.0,2001.0,3.1,4,2,1,1,2,1,5,20.0,4,4,0,4,6,10,4,0,DF,Under 20,Defender,United States,North America
2203,Franck Ribéry,FRA,Fiorentina,Serie A,2020,37.0,1983.0,23.9,24,11,4,9,11,5,29,17.2,24,11,2,9,3,27,1,0,FW,35-39,Forward,France,Europe
2204,Federico Ricci,ITA,Sassuolo,Serie A,2020,26.0,1994.0,0.0,0,0,0,0,0,0,0,,0,0,0,0,0,0,0,0,FW,25-29,Forward,Italy,Europe
2205,Giacomo Ricci,ITA,Parma,Serie A,2020,23.0,1996.0,0.7,3,1,1,2,0,0,0,,0,2,2,0,1,4,4,0,DF,20-24,Defender,Italy,Europe
2206,Matteo Ricci,ITA,Spezia,Serie A,2020,26.0,1994.0,24.8,40,23,14,24,2,27,52,51.9,25,24,4,20,34,74,13,0,MF,25-29,Midfielder,Italy,Europe
2207,Declan Rice,ENG,West Ham,Premier League,2020,21.0,1999.0,32.0,59,35,33,25,1,21,51,41.2,30,39,11,28,59,118,41,0,MF,20-24,Midfielder,England,Europe
2208,Chris Richards,USA,Hoffenheim,Bundesliga,2020,20.0,2000.0,10.5,19,8,12,6,1,10,16,62.5,6,13,4,9,21,40,40,1,DF,20-24,Defender,United States,North America
2209,Chris Richards,USA,Bayern Munich,Bundesliga,2020,20.0,2000.0,1.0,0,0,0,0,0,0,0,,0,0,0,0,1,1,1,0,DF,20-24,Defender,United States,North America
2210,Lewis Richardson,ENG,Burnley,Premier League,2020,17.0,2003.0,0.0,0,0,0,0,0,0,0,,0,0,0,0,0,0,0,0,"FW,MF",Under 20,Forward,England,Europe
2211,Richarlison,BRA,Everton,Premier League,2020,23.0,1997.0,31.8,50,32,21,22,7,16,51,31.4,35,28,3,25,14,64,36,1,FW,20-24,Forward,Brazil,South America
2212,Marco Richter,GER,Augsburg,Bundesliga,2020,22.0,1997.0,15.7,17,9,3,12,2,7,23,30.4,16,10,0,10,6,23,9,0,"FW,MF",20-24,Forward,Germany,Europe
2215,Jaïro Riedewald,NED,Crystal Palace,Premier League,2020,23.0,1996.0,20.2,34,15,13,17,4,16,36,44.4,20,39,7,32,29,63,25,0,MF,20-24,Midfielder,Netherlands,Europe
2216,Emiliano Rigoni,ARG,Elche,La Liga,2020,27.0,1993.0,12.7,12,7,3,8,1,3,15,20.0,12,16,1,15,6,18,9,0,MF,25-29,Midfielder,Argentina,South America
2217,Tomás Rincón,VEN,Torino,Serie A,2020,32.0,1988.0,31.6,68,38,27,33,8,36,71,50.7,35,32,7,25,31,99,44,0,MF,30-34,Midfielder,Venezuela,South America
2219,Renaud Ripart,FRA,Nîmes,Ligue 1,2020,27.0,1993.0,33.9,52,30,25,19,8,26,84,31.0,58,58,12,46,36,88,53,0,"MF,FW",25-29,Midfielder,France,Europe
2220,Andrea Rispoli,ITA,Crotone,Serie A,2020,31.0,1988.0,7.2,6,3,2,3,1,2,7,28.6,5,12,3,9,5,11,15,1,DF,30-34,Defender,Italy,Europe
2222,Matt Ritchie,SCO,Newcastle Utd,Premier League,2020,30.0,1989.0,15.0,10,3,5,3,2,3,17,17.6,14,17,2,15,12,22,47,0,"DF,MF",30-34,Defender,Scotland,Europe
2223,Maxence Rivera,FRA,Saint-Étienne,Ligue 1,2020,18.0,2002.0,2.7,12,10,6,4,2,4,10,40.0,6,5,0,5,1,13,0,0,"MF,FW",Under 20,Midfielder,France,Europe
2224,Emmanuel Rivière,FRA,Crotone,Serie A,2020,30.0,1990.0,7.1,2,1,2,0,0,0,3,0.0,3,5,1,4,1,3,0,0,FW,30-34,Forward,France,Europe
2228,Tyler Roberts,WAL,Leeds United,Premier League,2020,21.0,1999.0,14.9,15,13,1,11,3,5,22,22.7,17,17,2,15,9,24,12,0,"MF,FW",20-24,Midfielder,Wales,Europe
2229,Andrew Robertson,SCO,Liverpool,Premier League,2020,26.0,1994.0,37.6,46,34,23,18,5,28,57,49.1,29,39,9,30,21,67,79,1,DF,25-29,Defender,Scotland,Europe
2230,Antonee Robinson,USA,Fulham,Premier League,2020,22.0,1997.0,24.0,45,28,24,16,5,27,44,61.4,17,21,4,17,37,82,68,0,DF,20-24,Defender,United States,North America
2231,Callum Robinson,IRL,West Brom,Premier League,2020,25.0,1995.0,17.3,7,5,5,1,1,3,19,15.8,16,9,0,9,7,14,8,0,"FW,MF",25-29,Forward,Republic of Ireland,Europe
2232,Jack Robinson,ENG,Sheffield Utd,Premier League,2020,26.0,1993.0,9.7,14,6,8,5,1,6,11,54.5,5,10,4,6,9,23,42,0,DF,25-29,Defender,England,Europe
2234,Hal Robson-Kanu,WAL,West Brom,Premier League,2020,31.0,1989.0,6.2,2,1,1,0,1,0,1,0.0,1,2,0,2,2,4,7,0,FW,30-34,Forward,Wales,Europe
2236,Christopher Rocchia,FRA,Marseille,Ligue 1,2020,22.0,1998.0,0.2,1,0,1,0,0,0,2,0.0,2,0,0,0,0,1,1,0,"DF,FW",20-24,Defender,France,Europe
2238,Marek Rodák,SVK,Fulham,Premier League,2020,23.0,1996.0,2.0,0,0,0,0,0,0,0,,0,0,0,0,0,0,0,0,GK,20-24,Goalkeeper,Slovakia,Europe
2239,Sebastian Rode,GER,Eint Frankfurt,Bundesliga,2020,29.0,1990.0,18.1,44,25,21,16,7,14,46,30.4,32,30,3,27,47,91,18,0,MF,25-29,Midfielder,Germany,Europe
2240,Joe Rodon,WAL,Tottenham,Premier League,2020,22.0,1997.0,8.1,14,9,11,2,1,3,4,75.0,1,10,8,2,21,35,36,2,DF,20-24,Defender,Wales,Europe
2244,Kévin Rodrigues,POR,Eibar,La Liga,2020,26.0,1994.0,12.2,16,8,8,5,3,7,23,30.4,16,10,1,9,20,36,15,1,"DF,MF",25-29,Defender,Portugal,Europe
2247,Guido Rodríguez,ARG,Betis,La Liga,2020,26.0,1994.0,31.8,98,56,52,40,6,40,85,47.1,45,52,14,38,68,166,58,2,MF,25-29,Midfielder,Argentina,South America
2248,James Rodríguez,COL,Everton,Premier League,2020,29.0,1991.0,19.6,28,17,8,15,5,11,46,23.9,35,17,0,17,15,43,3,0,"FW,MF",25-29,Forward,Colombia,South America
2249,Jay Rodriguez,ENG,Burnley,Premier League,2020,31.0,1989.0,14.1,25,16,5,15,5,13,28,46.4,15,25,4,21,2,27,7,0,FW,30-34,Forward,England,Europe
2251,Ricardo Rodríguez,SUI,Torino,Serie A,2020,27.0,1992.0,13.8,21,14,11,8,2,13,22,59.1,9,16,5,11,20,41,43,0,DF,25-29,Defender,Switzerland,Europe
2253,Rodrygo,BRA,Real Madrid,La Liga,2020,19.0,2001.0,10.9,15,6,10,4,1,2,17,11.8,15,15,0,15,7,22,4,0,FW,Under 20,Forward,Brazil,South America
2254,Marko Rog,CRO,Cagliari,Serie A,2020,25.0,1995.0,12.9,40,24,15,22,3,16,37,43.2,21,17,6,11,19,59,15,0,MF,25-29,Midfielder,Croatia,Europe
2255,Rogério,BRA,Sassuolo,Serie A,2020,22.0,1998.0,20.9,26,13,19,5,2,19,27,70.4,8,26,5,21,31,57,53,0,DF,20-24,Defender,Brazil,South America
2255,Rogério,BRA,Sassuolo,Serie A,2020,22.0,1998.0,20.9,26,13,19,5,2,19,27,70.4,8,26,5,21,31,57,53,0,DF,20-24,Defender,Brazil,South America
2255,Rogério,BRA,Sassuolo,Serie A,2020,22.0,1998.0,20.9,26,13,19,5,2,19,27,70.4,8,26,5,21,31,57,53,0,DF,20-24,Defender,Brazil,South America
2255,Rogério,BRA,Sassuolo,Serie A,2020,22.0,1998.0,20.9,26,13,19,5,2,19,27,70.4,8,26,5,21,31,57,53,0,DF,20-24,Defender,Brazil,South America
2256,Luis Rojas,CHI,Crotone,Serie A,2020,18.0,2002.0,1.2,1,0,0,1,0,1,2,50.0,1,2,0,2,1,2,0,0,"MF,FW",Under 20,Midfielder,Chile,South America
2257,Alessio Romagnoli,ITA,Milan,Serie A,2020,25.0,1995.0,21.2,17,7,8,7,2,8,19,42.1,11,29,22,7,24,41,80,0,DF,25-29,Defender,Italy,Europe
2258,Cristian Romero,ARG,Atalanta,Serie A,2020,22.0,1998.0,28.3,63,32,41,19,3,27,49,55.1,22,31,13,18,96,159,71,2,DF,20-24,Defender,Argentina,South America
2260,Cristiano Ronaldo,POR,Juventus,Serie A,2020,35.0,1985.0,31.1,6,3,1,3,2,3,15,20.0,12,11,3,8,5,11,15,1,FW,35-39,Forward,Portugal,Europe
2261,Facundo Roncaglia,ARG,Osasuna,La Liga,2020,33.0,1987.0,13.7,25,14,14,11,0,11,20,55.0,9,11,6,5,25,50,26,0,DF,30-34,Defender,Argentina,South America
2262,Valentin Rongier,FRA,Marseille,Ligue 1,2020,25.0,1994.0,21.0,93,59,31,55,7,43,85,50.6,42,32,2,30,28,121,21,1,MF,25-29,Midfielder,France,Europe
2263,Marten de Roon,NED,Atalanta,Serie A,2020,29.0,1991.0,33.6,80,48,30,36,14,36,84,42.9,48,44,9,35,69,149,40,0,MF,25-29,Midfielder,Netherlands,Europe
2264,Jérôme Roussillon,FRA,Wolfsburg,Bundesliga,2020,27.0,1993.0,13.7,24,12,14,8,2,11,20,55.0,9,10,1,9,19,43,28,0,DF,25-29,Defender,France,Europe
2265,Nolan Roux,FRA,Nîmes,Ligue 1,2020,32.0,1988.0,7.2,7,3,1,4,2,3,8,37.5,5,6,0,6,5,12,4,0,FW,30-34,Forward,France,Europe
2266,Nicolò Rovella,ITA,Genoa,Serie A,2020,18.0,2001.0,13.2,29,16,15,11,3,9,32,28.1,23,11,0,11,20,49,19,1,MF,Under 20,Midfielder,Italy,Europe
2270,John Ruddy,ENG,Wolves,Premier League,2020,33.0,1986.0,1.0,0,0,0,0,0,0,0,,0,0,0,0,0,0,0,0,GK,30-34,Goalkeeper,England,Europe
2271,Antonio Rüdiger,GER,Chelsea,Premier League,2020,27.0,1993.0,19.0,31,23,16,14,1,12,15,80.0,3,17,10,7,18,49,51,0,DF,25-29,Defender,Germany,Europe
2272,Sebastian Rudy,GER,Hoffenheim,Bundesliga,2020,30.0,1990.0,18.6,35,26,15,15,5,16,45,35.6,29,24,4,20,13,48,21,1,"MF,FW",30-34,Midfielder,Germany,Europe
2273,Sebastian Rudy,GER,Schalke 04,Bundesliga,2020,30.0,1990.0,2.0,4,2,2,0,2,4,7,57.1,3,6,4,2,1,5,4,0,DF,30-34,Defender,Germany,Europe
2274,Kevin Rüegg,SUI,Hellas Verona,Serie A,2020,21.0,1998.0,2.3,0,0,0,0,0,0,0,,0,3,0,3,2,2,3,0,"DF,MF",20-24,Defender,Switzerland,Europe
2275,Daniele Rugani,ITA,Cagliari,Serie A,2020,26.0,1994.0,11.1,24,11,10,12,2,10,20,50.0,10,15,10,5,15,39,46,0,DF,25-29,Defender,Italy,Europe
2276,Daniele Rugani,ITA,Rennes,Ligue 1,2020,26.0,1994.0,1.0,0,0,0,0,0,0,1,0.0,1,1,1,0,1,1,1,0,DF,25-29,Defender,Italy,Europe
2277,Matteo Ruggeri,ITA,Atalanta,Serie A,2020,18.0,2002.0,2.3,3,0,1,2,0,2,3,66.7,1,2,0,2,4,7,2,0,DF,Under 20,Defender,Italy,Europe
2278,Mário Rui,POR,Napoli,Serie A,2020,29.0,1991.0,18.5,24,13,17,6,1,17,33,51.5,16,17,4,13,28,52,29,1,DF,25-29,Defender,Portugal,Europe
2281,Kays Ruiz,FRA,Paris S-G,Ligue 1,2020,17.0,2002.0,2.1,1,1,0,1,0,0,4,0.0,4,1,0,1,3,4,2,0,"FW,MF",Under 20,Forward,France,Europe
2284,Gerónimo Rulli,ARG,Villarreal,La Liga,2020,28.0,1992.0,2.0,0,0,0,0,0,0,0,,0,0,0,0,0,0,0,1,GK,25-29,Goalkeeper,Argentina,South America
2285,Georginio Rutter,FRA,Rennes,Ligue 1,2020,18.0,2002.0,0.5,2,2,0,1,1,1,3,33.3,2,2,0,2,0,2,0,0,"FW,MF",Under 20,Forward,France,Europe
2286,Georginio Rutter,FRA,Hoffenheim,Bundesliga,2020,18.0,2002.0,2.7,4,4,2,2,0,1,2,50.0,1,2,0,2,0,4,2,0,FW,Under 20,Forward,France,Europe
2287,Mathew Ryan,AUS,Arsenal,Premier League,2020,28.0,1992.0,3.0,0,0,0,0,0,0,0,,0,0,0,0,0,0,1,0,GK,25-29,Goalkeeper,Australia,Oceania
2288,Mathew Ryan,AUS,Brighton,Premier League,2020,28.0,1992.0,11.0,1,0,1,0,0,0,0,,0,0,0,0,0,1,4,0,GK,25-29,Goalkeeper,Australia,Oceania
2290,Frederik Rønnow,DEN,Schalke 04,Bundesliga,2020,27.0,1992.0,10.5,0,0,0,0,0,0,0,,0,0,0,0,1,1,9,1,GK,25-29,Goalkeeper,Denmark,Europe
2291,Roli Pereira de Sa,FRA,Nantes,Ligue 1,2020,23.0,1996.0,0.6,4,3,1,3,0,3,4,75.0,1,2,0,2,0,4,0,0,"FW,MF",20-24,Forward,France,Europe
2292,Victor Sá,BRA,Wolfsburg,Bundesliga,2020,26.0,1994.0,5.2,9,6,2,6,1,6,11,54.5,5,11,0,11,8,17,2,0,FW,25-29,Forward,Brazil,South America
2293,Idriss Saadi,ALG,Strasbourg,Ligue 1,2020,28.0,1992.0,1.4,0,0,0,0,0,0,2,0.0,2,0,0,0,0,0,0,0,"MF,FW",25-29,Midfielder,Algeria,Africa
2294,Youssouf Sabaly,SEN,Bordeaux,Ligue 1,2020,27.0,1993.0,32.3,47,33,24,17,6,27,45,60.0,18,31,8,23,49,96,57,2,DF,25-29,Defender,Senegal,Africa
2295,Mathys Saban,FRA,Saint-Étienne,Ligue 1,2020,18.0,2002.0,0.1,0,0,0,0,0,0,0,,0,0,0,0,0,0,0,0,FW,Under 20,Forward,France,Europe
2296,Marcel Sabitzer,AUT,RB Leipzig,Bundesliga,2020,26.0,1994.0,22.5,29,21,12,16,1,12,37,32.4,25,7,2,5,35,64,27,0,MF,25-29,Midfielder,Austria,Europe
2297,Alexis Saelemaekers,BEL,Milan,Serie A,2020,21.0,1999.0,22.4,43,26,20,18,5,19,60,31.7,41,29,1,28,25,68,6,0,FW,20-24,Forward,Belgium,Europe
2298,Modibo Sagnan,MLI,Real Sociedad,La Liga,2020,21.0,1999.0,6.9,12,7,6,6,0,4,6,66.7,2,7,2,5,6,18,25,1,DF,20-24,Defender,Mali,Africa
2299,Allan Saint-Maximin,FRA,Newcastle Utd,Premier League,2020,23.0,1997.0,17.3,16,9,6,9,1,4,9,44.4,5,10,0,10,4,20,2,0,"FW,MF",20-24,Forward,France,Europe
2301,Romain Saïss,MAR,Wolves,Premier League,2020,30.0,1990.0,26.7,35,24,23,12,0,19,33,57.6,14,28,13,15,52,87,115,1,DF,30-34,Defender,Morocco,Africa
2302,Bukayo Saka,ENG,Arsenal,Premier League,2020,18.0,2001.0,28.4,25,16,10,13,2,11,40,27.5,29,21,2,19,25,50,24,0,"FW,MF",Under 20,Forward,England,Europe
2303,Hiroki Sakai,JPN,Marseille,Ligue 1,2020,30.0,1990.0,26.5,81,48,34,35,12,39,51,76.5,12,21,5,16,54,135,65,0,DF,30-34,Defender,Japan,Asia
2304,Moïse Sakava,CMR,Reims,Ligue 1,2020,19.0,2000.0,0.1,0,0,0,0,0,0,0,,0,0,0,0,0,0,0,0,MF,Under 20,Midfielder,Cameroon,Africa
2305,Mamadou Sakho,FRA,Crystal Palace,Premier League,2020,30.0,1990.0,3.1,3,2,1,2,0,3,3,100.0,0,3,2,1,3,6,11,0,DF,30-34,Defender,France,Europe
2306,Jacopo Sala,ITA,Spezia,Serie A,2020,28.0,1991.0,4.2,17,9,14,1,2,8,22,36.4,14,5,2,3,5,22,6,0,DF,25-29,Defender,Italy,Europe
2307,Mohamed Salah,EGY,Liverpool,Premier League,2020,28.0,1992.0,34.2,18,9,4,4,10,7,16,43.8,9,10,0,10,1,19,10,1,FW,25-29,Forward,Egypt,Africa
2308,Eddie Salcedo,ITA,Hellas Verona,Serie A,2020,18.0,2001.0,8.4,6,2,3,2,1,3,3,100.0,0,6,0,6,6,12,6,0,"MF,FW",Under 20,Midfielder,Italy,Europe
2309,William Saliba,FRA,Nice,Ligue 1,2020,19.0,2001.0,20.0,15,9,8,5,2,5,6,83.3,1,17,16,1,26,41,80,2,DF,Under 20,Defender,France,Europe
2310,Romain Salin,FRA,Rennes,Ligue 1,2020,36.0,1984.0,15.0,0,0,0,0,0,0,1,0.0,1,0,0,0,1,1,6,3,GK,35-39,Goalkeeper,France,Europe
2311,Mohammed Salisu,GHA,Southampton,Premier League,2020,21.0,1999.0,9.4,38,21,20,16,2,25,34,73.5,9,22,5,17,17,55,30,0,DF,20-24,Defender,Ghana,Africa
2312,Roland Sallai,HUN,Freiburg,Bundesliga,2020,23.0,1997.0,18.5,18,14,7,9,2,5,13,38.5,8,11,1,10,11,29,8,0,"MF,FW",20-24,Midfielder,Hungary,Europe
2315,Diadie Samassékou,MLI,Hoffenheim,Bundesliga,2020,24.0,1996.0,28.5,71,41,22,42,7,33,90,36.7,57,41,12,29,78,149,50,0,MF,20-24,Midfielder,Mali,Africa
2316,Mama Samba Baldé,GNB,Dijon,Ligue 1,2020,24.0,1995.0,24.0,23,9,4,13,6,9,22,40.9,13,16,1,15,4,27,26,0,FW,20-24,Forward,Guinea-Bissau,Africa
2317,Junior Sambia,FRA,Montpellier,Ligue 1,2020,23.0,1996.0,27.2,41,29,20,14,7,26,38,68.4,12,27,14,13,39,80,46,0,"DF,MF",20-24,Defender,France,Europe
2318,Frédéric Sammaritano,FRA,Dijon,Ligue 1,2020,34.0,1986.0,12.6,15,10,9,5,1,9,26,34.6,17,6,0,6,9,24,3,0,"FW,MF",30-34,Forward,France,Europe
2320,Antonio Sanabria,PAR,Torino,Serie A,2020,24.0,1996.0,10.9,8,3,0,4,4,2,9,22.2,7,5,0,5,5,13,8,0,FW,20-24,Forward,Paraguay,South America
2321,Antonio Sanabria,PAR,Betis,La Liga,2020,24.0,1996.0,10.4,5,5,0,4,1,0,2,0.0,2,8,1,7,3,8,9,0,FW,20-24,Forward,Paraguay,South America
2323,Renato Sanches,POR,Lille,Ligue 1,2020,22.0,1997.0,14.1,13,7,4,8,1,5,25,20.0,20,13,2,11,13,26,8,0,MF,20-24,Midfielder,Portugal,Europe
2325,Alexis Sánchez,CHI,Inter,Serie A,2020,31.0,1988.0,12.7,14,8,4,4,6,5,18,27.8,13,11,0,11,7,21,1,1,FW,30-34,Forward,Chile,South America
2326,Davinson Sánchez,COL,Tottenham,Premier League,2020,24.0,1996.0,16.5,40,20,31,9,0,21,32,65.6,11,18,13,5,14,54,85,2,DF,20-24,Defender,Colombia,South America
2331,Juan Sánchez Miño,ARG,Elche,La Liga,2020,30.0,1990.0,5.5,8,5,5,3,0,6,14,42.9,8,4,0,4,4,12,7,0,"DF,MF",30-34,Defender,Argentina,South America
2334,Jadon Sancho,ENG,Dortmund,Bundesliga,2020,20.0,2000.0,22.9,18,11,4,10,4,7,16,43.8,9,20,1,19,16,34,9,0,"FW,MF",20-24,Forward,England,Europe
2335,Alex Sandro,BRA,Juventus,Serie A,2020,29.0,1991.0,20.6,37,23,19,13,5,13,25,52.0,12,20,4,16,31,68,57,0,DF,25-29,Defender,Brazil,South America
2336,Leroy Sané,GER,Bayern Munich,Bundesliga,2020,24.0,1996.0,20.1,18,10,2,10,6,13,30,43.3,17,23,1,22,9,27,8,1,"FW,MF",20-24,Forward,Germany,Europe
2337,Salif Sané,SEN,Schalke 04,Bundesliga,2020,29.0,1990.0,11.9,17,9,9,7,1,13,23,56.5,10,25,13,12,25,42,66,0,DF,25-29,Defender,Senegal,Africa
2339,Mohamed Sankoh,NED,Stuttgart,Bundesliga,2020,16.0,2003.0,0.2,0,0,0,0,0,0,0,,0,1,0,1,0,0,0,0,MF,Under 20,Midfielder,Netherlands,Europe
2340,Siriki Sanogo,CIV,Benevento,Serie A,2020,18.0,2001.0,0.1,0,0,0,0,0,0,0,,0,0,0,0,0,0,0,0,MF,Under 20,Midfielder,Ivory Coast,Africa
2341,Morgan Sanson,FRA,Aston Villa,Premier League,2020,25.0,1994.0,3.3,7,4,4,2,1,1,4,25.0,3,5,0,5,4,11,1,0,MF,25-29,Midfielder,France,Europe
2342,Morgan Sanson,FRA,Marseille,Ligue 1,2020,25.0,1994.0,9.2,21,12,6,12,3,9,28,32.1,19,12,0,12,9,30,5,0,MF,25-29,Midfielder,France,Europe
2343,Nicola Sansone,ITA,Bologna,Serie A,2020,28.0,1991.0,13.0,22,11,7,12,3,10,31,32.3,21,15,0,15,9,31,7,0,"FW,MF",25-29,Forward,Italy,Europe
2344,Baptiste Santamaria,FRA,Angers,Ligue 1,2020,25.0,1995.0,3.0,9,6,3,5,1,2,7,28.6,5,4,0,4,7,16,8,0,MF,25-29,Midfielder,France,Europe
2345,Baptiste Santamaria,FRA,Freiburg,Bundesliga,2020,25.0,1995.0,24.5,51,38,19,24,8,20,54,37.0,34,36,7,29,52,103,34,1,MF,25-29,Midfielder,France,Europe
2346,Federico Santander,PAR,Bologna,Serie A,2020,29.0,1991.0,0.4,0,0,0,0,0,0,0,,0,0,0,0,0,0,0,0,FW,25-29,Forward,Paraguay,South America
2347,Davide Santon,ITA,Roma,Serie A,2020,29.0,1991.0,6.5,4,3,2,2,0,3,7,42.9,4,10,1,9,4,8,12,0,DF,25-29,Defender,Italy,Europe
2348,Samir Santos,BRA,Udinese,Serie A,2020,25.0,1994.0,24.6,40,23,26,12,2,13,29,44.8,16,33,17,16,58,98,60,1,DF,25-29,Defender,Brazil,South America
2349,Riccardo Saponara,ITA,Fiorentina,Serie A,2020,28.0,1991.0,0.6,2,1,0,2,0,1,3,33.3,2,0,0,0,1,3,0,0,MF,25-29,Midfielder,Italy,Europe
2350,Riccardo Saponara,ITA,Spezia,Serie A,2020,28.0,1991.0,4.3,4,1,1,0,3,1,3,33.3,2,1,0,1,1,5,4,0,"FW,MF",25-29,Forward,Italy,Europe
2353,Josh Sargent,USA,Werder Bremen,Bundesliga,2020,20.0,2000.0,27.8,32,19,13,13,6,13,27,48.1,14,39,4,35,17,49,36,0,"FW,MF",20-24,Forward,United States,North America
2354,Bouna Sarr,SEN,Marseille,Ligue 1,2020,28.0,1992.0,0.8,1,1,0,0,1,1,1,100.0,0,1,1,0,1,2,1,0,DF,25-29,Defender,Senegal,Africa
2355,Bouna Sarr,SEN,Bayern Munich,Bundesliga,2020,28.0,1992.0,5.0,9,8,4,3,2,3,6,50.0,3,7,0,7,10,19,7,1,DF,25-29,Defender,Senegal,Africa
2356,Sidy Sarr,SEN,Nîmes,Ligue 1,2020,24.0,1996.0,5.1,10,6,4,6,0,2,5,40.0,3,1,1,0,7,17,4,0,MF,20-24,Midfielder,Senegal,Africa
2357,Marco Sau,ITA,Benevento,Serie A,2020,32.0,1987.0,8.7,6,2,0,6,0,1,16,6.3,15,7,0,7,5,11,3,0,"MF,FW",30-34,Midfielder,Italy,Europe
2358,Téji Savanier,FRA,Montpellier,Ligue 1,2020,28.0,1991.0,24.1,49,33,16,25,8,22,73,30.1,51,28,6,22,38,87,15,0,MF,25-29,Midfielder,France,Europe
2359,Stefan Savić,MNE,Atlético Madrid,La Liga,2020,29.0,1991.0,32.8,40,25,32,7,1,21,34,61.8,13,33,19,14,42,82,110,0,DF,25-29,Defender,Montenegro,Europe
2360,Romaine Sawyers,SKN,West Brom,Premier League,2020,28.0,1991.0,16.5,30,18,16,12,2,14,43,32.6,29,20,4,16,18,48,12,3,MF,25-29,Midfielder,Saint Kitts and Nevis,North America
2361,Gianluca Scamacca,ITA,Genoa,Serie A,2020,21.0,1999.0,15.0,19,10,6,7,6,7,19,36.8,12,21,4,17,9,28,12,0,FW,20-24,Forward,Italy,Europe
2362,Dane Scarlett,ENG,Tottenham,Premier League,2020,16.0,2004.0,0.0,0,0,0,0,0,0,0,,0,0,0,0,0,0,0,0,FW,Under 20,Forward,England,Europe
2363,Fabian Schär,SUI,Newcastle Utd,Premier League,2020,28.0,1991.0,13.8,13,4,8,5,0,7,19,36.8,12,19,12,7,27,40,52,1,DF,25-29,Defender,Switzerland,Europe
2364,Aurélien Scheidler,FRA,Dijon,Ligue 1,2020,22.0,1998.0,3.8,2,0,0,2,0,0,2,0.0,2,0,0,0,1,3,5,0,FW,20-24,Forward,France,Europe
2365,Nicolás Schiappacasse,URU,Sassuolo,Serie A,2020,21.0,1999.0,0.2,0,0,0,0,0,0,0,,0,0,0,0,0,0,0,0,MF,20-24,Midfielder,Uruguay,South America
2366,Pasquale Schiattarella,ITA,Benevento,Serie A,2020,33.0,1987.0,25.0,37,22,25,12,0,19,47,40.4,28,19,5,14,32,69,29,2,MF,30-34,Midfielder,Italy,Europe
2368,Sven Schipplock,GER,Arminia,Bundesliga,2020,31.0,1988.0,8.3,15,8,7,6,2,6,27,22.2,21,13,2,11,6,21,8,0,"FW,MF",30-34,Forward,Germany,Europe
2369,Xaver Schlager,AUT,Wolfsburg,Bundesliga,2020,22.0,1997.0,29.2,66,40,20,38,8,22,68,32.4,46,50,6,44,54,120,38,0,MF,20-24,Midfielder,Austria,Europe
2370,Keven Schlotterbeck,GER,Freiburg,Bundesliga,2020,23.0,1997.0,18.4,31,10,16,15,0,10,23,43.5,13,26,18,8,36,67,89,2,DF,20-24,Defender,Germany,Europe
2371,Nico Schlotterbeck,GER,Union Berlin,Bundesliga,2020,20.0,1999.0,14.3,34,19,14,19,1,18,28,64.3,10,13,6,7,31,65,29,1,DF,20-24,Defender,Germany,Europe
2372,Jeffrey Schlupp,GHA,Crystal Palace,Premier League,2020,27.0,1992.0,15.9,29,16,14,12,3,6,23,26.1,17,24,8,16,22,51,16,0,MF,25-29,Midfielder,Ghana,Africa
2373,Kasper Schmeichel,DEN,Leicester City,Premier League,2020,33.0,1986.0,38.0,0,0,0,0,0,0,0,,0,0,0,0,0,0,10,0,GK,30-34,Goalkeeper,Denmark,Europe
2374,Jonathan Schmid,FRA,Freiburg,Bundesliga,2020,30.0,1990.0,26.6,37,19,17,13,7,16,30,53.3,14,26,10,16,28,65,38,0,"MF,DF",30-34,Midfielder,France,Europe
2375,Romano Schmid,AUT,Werder Bremen,Bundesliga,2020,20.0,2000.0,13.1,22,16,8,10,4,8,35,22.9,27,21,0,21,8,30,6,0,"MF,FW",20-24,Midfielder,Austria,Europe
2376,Benno Schmitz,GER,Köln,Bundesliga,2020,25.0,1994.0,4.6,14,7,6,7,1,7,13,53.8,6,8,2,6,6,20,7,0,DF,25-29,Defender,Germany,Europe
2377,Morgan Schneiderlin,FRA,Nice,Ligue 1,2020,30.0,1989.0,24.4,51,31,21,24,6,20,54,37.0,34,21,11,10,53,104,46,0,MF,30-34,Midfielder,France,Europe
2378,Alessandro Schöpf,AUT,Schalke 04,Bundesliga,2020,26.0,1994.0,10.5,11,9,3,7,1,1,6,16.7,5,15,1,14,6,17,6,0,"FW,MF",25-29,Forward,Austria,Europe
2379,Jerdy Schouten,NED,Bologna,Serie A,2020,23.0,1997.0,27.9,50,25,23,25,2,16,37,43.2,21,36,13,23,79,129,37,6,MF,20-24,Midfielder,Netherlands,Europe
2380,Nico Schulz,GER,Dortmund,Bundesliga,2020,27.0,1993.0,6.8,9,6,4,3,2,2,11,18.2,9,12,4,8,6,15,10,0,DF,25-29,Defender,Germany,Europe
2381,Alexander Schwolow,GER,Hertha BSC,Bundesliga,2020,28.0,1992.0,26.0,0,0,0,0,0,0,0,,0,1,0,1,0,0,6,0,GK,25-29,Goalkeeper,Germany,Europe
2382,Christopher Scott,GER,Bayern Munich,Bundesliga,2020,18.0,2002.0,0.4,2,1,0,1,1,2,2,100.0,0,0,0,0,0,2,1,0,"MF,FW",Under 20,Midfielder,Germany,Europe
2383,Matteo Scozzarella,ITA,Parma,Serie A,2020,32.0,1988.0,1.7,4,0,3,1,0,2,3,66.7,1,3,1,2,6,10,0,0,MF,30-34,Midfielder,Italy,Europe
2384,Simone Scuffet,ITA,Udinese,Serie A,2020,24.0,1996.0,1.0,0,0,0,0,0,0,0,,0,0,0,0,0,0,0,0,GK,20-24,Goalkeeper,Italy,Europe
2385,Jacopo Segre,ITA,Torino,Serie A,2020,23.0,1997.0,2.1,5,2,2,1,2,2,5,40.0,3,0,0,0,0,5,1,0,MF,20-24,Midfielder,Italy,Europe
2386,Davie Selke,GER,Werder Bremen,Bundesliga,2020,25.0,1995.0,9.0,3,2,1,1,1,0,6,0.0,6,3,2,1,1,4,7,0,FW,25-29,Forward,Germany,Europe
2387,Malik Sellouki,FRA,Nice,Ligue 1,2020,20.0,2000.0,0.7,0,0,0,0,0,0,1,0.0,1,2,0,2,2,2,0,0,"FW,MF",20-24,Forward,France,Europe
2388,Matz Sels,BEL,Strasbourg,Ligue 1,2020,28.0,1992.0,6.0,0,0,0,0,0,0,0,,0,0,0,0,0,0,4,0,GK,25-29,Goalkeeper,Belgium,Europe
2389,Nélson Semedo,POR,Wolves,Premier League,2020,26.0,1993.0,33.1,85,48,53,23,9,42,72,58.3,30,30,10,20,41,126,78,2,"DF,MF",25-29,Defender,Portugal,Europe
2390,Léo Sena,BRA,Spezia,Serie A,2020,24.0,1995.0,9.8,22,12,7,10,5,12,26,46.2,14,19,4,15,11,33,5,0,MF,20-24,Midfielder,Brazil,South America
2391,Stefano Sensi,ITA,Inter,Serie A,2020,24.0,1995.0,6.7,9,6,3,5,1,4,11,36.4,7,6,1,5,7,16,1,0,MF,20-24,Midfielder,Italy,Europe
2393,Luigi Sepe,ITA,Parma,Serie A,2020,29.0,1991.0,36.0,0,0,0,0,0,0,2,0.0,2,0,0,0,2,2,13,2,GK,25-29,Goalkeeper,Italy,Europe
2394,Suat Serdar,GER,Schalke 04,Bundesliga,2020,23.0,1997.0,21.7,55,35,18,33,4,17,52,32.7,35,29,4,25,23,78,21,0,MF,20-24,Midfielder,Germany,Europe
2395,Jean Seri,CIV,Bordeaux,Ligue 1,2020,29.0,1991.0,7.9,17,9,3,12,2,4,15,26.7,11,8,2,6,12,29,7,0,MF,25-29,Midfielder,Ivory Coast,Africa
2396,Femi Seriki,ENG,Sheffield Utd,Premier League,2020,18.0,2002.0,0.0,0,0,0,0,0,0,0,,0,0,0,0,0,0,0,0,MF,Under 20,Midfielder,England,Europe
2397,Ryan Sessegnon,ENG,Hoffenheim,Bundesliga,2020,20.0,2000.0,17.5,47,25,26,13,8,15,34,44.1,19,26,3,23,30,77,46,0,"DF,FW",20-24,Defender,England,Europe
2398,Nils Seufert,GER,Arminia,Bundesliga,2020,23.0,1997.0,3.8,12,9,2,5,5,2,8,25.0,6,3,1,2,5,17,6,0,"MF,FW",20-24,Midfielder,Germany,Europe
2399,Edgar Sevikyan,ARM,Levante,La Liga,2020,18.0,2001.0,0.1,0,0,0,0,0,0,0,,0,0,0,0,0,0,0,0,MF,Under 20,Midfielder,Armenia,Asia
2400,Stephan El Shaarawy,ITA,Roma,Serie A,2020,27.0,1992.0,6.4,4,3,0,3,1,2,9,22.2,7,3,1,2,3,7,2,0,"MF,FW",25-29,Midfielder,Italy,Europe
2401,Jamie Shackleton,ENG,Leeds United,Premier League,2020,20.0,1999.0,5.1,10,6,6,4,0,4,11,36.4,7,3,1,2,9,19,3,0,"MF,DF",20-24,Midfielder,England,Europe
2402,Xherdan Shaqiri,SUI,Liverpool,Premier League,2020,28.0,1991.0,6.2,7,4,3,1,3,2,7,28.6,5,4,0,4,2,9,0,0,"MF,FW",25-29,Midfielder,Switzerland,Europe
2403,Billy Sharp,ENG,Sheffield Utd,Premier League,2020,34.0,1986.0,8.2,5,1,0,3,2,2,9,22.2,7,2,0,2,0,5,2,0,FW,30-34,Forward,England,Europe
2404,Luke Shaw,ENG,Manchester Utd,Premier League,2020,25.0,1995.0,29.5,44,28,21,16,7,21,36,58.3,15,34,9,25,20,64,44,2,DF,25-29,Defender,England,Europe
2405,Jonjo Shelvey,ENG,Newcastle Utd,Premier League,2020,28.0,1992.0,29.1,39,14,18,19,2,10,37,27.0,27,26,14,12,36,75,42,0,MF,25-29,Midfielder,England,Europe
2406,Eldor Shomurodov,UZB,Genoa,Serie A,2020,25.0,1995.0,18.6,28,14,7,13,8,9,37,24.3,28,17,2,15,6,34,11,0,FW,25-29,Forward,Uzbekistan,Asia
2407,Shola Shoretire,ENG,Manchester Utd,Premier League,2020,16.0,2004.0,0.1,0,0,0,0,0,0,0,,0,0,0,0,0,0,0,0,FW,Under 20,Forward,England,Europe
2408,Mahame Siby,MLI,Strasbourg,Ligue 1,2020,24.0,1996.0,0.2,0,0,0,0,0,0,1,0.0,1,0,0,0,0,0,1,0,MF,20-24,Midfielder,Mali,Africa
2409,Abdoulaye Sidibé,FRA,Saint-Étienne,Ligue 1,2020,18.0,2002.0,0.1,1,1,1,0,0,1,2,50.0,1,0,0,0,0,1,0,0,MF,Under 20,Midfielder,France,Europe
2410,Djibril Sidibé,FRA,Monaco,Ligue 1,2020,28.0,1992.0,22.0,58,34,26,29,3,37,52,71.2,15,20,5,15,50,108,37,2,DF,25-29,Defender,France,Europe
2411,Sidnei,BRA,Betis,La Liga,2020,30.0,1989.0,7.7,9,3,6,3,0,4,9,44.4,5,6,4,2,16,25,28,0,DF,30-34,Defender,Brazil,South America
2412,Kaj Sierhuis,NED,Reims,Ligue 1,2020,22.0,1998.0,7.2,7,2,1,2,4,2,9,22.2,7,2,1,1,2,9,5,0,"FW,MF",20-24,Forward,Netherlands,Europe
2413,Tim Siersleben,GER,Wolfsburg,Bundesliga,2020,20.0,2000.0,0.4,2,2,2,0,0,1,1,100.0,0,1,0,1,0,2,0,0,DF,20-24,Defender,Germany,Europe
2414,Gylfi Sigurðsson,ISL,Everton,Premier League,2020,30.0,1989.0,25.0,30,20,9,14,7,13,44,29.5,31,31,2,29,34,64,21,1,"MF,FW",30-34,Midfielder,Iceland,Europe
2415,Luca Siligardi,ITA,Crotone,Serie A,2020,32.0,1988.0,0.5,4,2,0,3,1,1,5,20.0,4,0,0,0,0,4,0,0,"MF,FW",30-34,Midfielder,Italy,Europe
2416,Luca Siligardi,ITA,Parma,Serie A,2020,32.0,1988.0,0.4,0,0,0,0,0,0,2,0.0,2,0,0,0,0,0,0,0,"FW,MF",30-34,Forward,Italy,Europe
2417,Adrien Silva,POR,Sampdoria,Serie A,2020,31.0,1989.0,17.8,49,22,21,22,6,18,54,33.3,36,34,1,33,30,79,10,1,MF,30-34,Midfielder,Portugal,Europe
2418,André Silva,POR,Eint Frankfurt,Bundesliga,2020,24.0,1995.0,30.7,11,2,0,7,4,6,13,46.2,7,11,1,10,3,14,15,0,FW,20-24,Forward,Portugal,Europe
2418,André Silva,POR,Eint Frankfurt,Bundesliga,2020,24.0,1995.0,30.7,11,2,0,7,4,6,13,46.2,7,11,1,10,3,14,15,0,FW,20-24,Forward,Portugal,Europe
2418,André Silva,POR,Eint Frankfurt,Bundesliga,2020,24.0,1995.0,30.7,11,2,0,7,4,6,13,46.2,7,11,1,10,3,14,15,0,FW,20-24,Forward,Portugal,Europe
2418,André Silva,POR,Eint Frankfurt,Bundesliga,2020,24.0,1995.0,30.7,11,2,0,7,4,6,13,46.2,7,11,1,10,3,14,15,0,FW,20-24,Forward,Portugal,Europe
2418,André Silva,POR,Eint Frankfurt,Bundesliga,2020,24.0,1995.0,30.7,11,2,0,7,4,6,13,46.2,7,11,1,10,3,14,15,0,FW,20-24,Forward,Portugal,Europe
2418,André Silva,POR,Eint Frankfurt,Bundesliga,2020,24.0,1995.0,30.7,11,2,0,7,4,6,13,46.2,7,11,1,10,3,14,15,0,FW,20-24,Forward,Portugal,Europe
2418,André Silva,POR,Eint Frankfurt,Bundesliga,2020,24.0,1995.0,30.7,11,2,0,7,4,6,13,46.2,7,11,1,10,3,14,15,0,FW,20-24,Forward,Portugal,Europe
2418,André Silva,POR,Eint Frankfurt,Bundesliga,2020,24.0,1995.0,30.7,11,2,0,7,4,6,13,46.2,7,11,1,10,3,14,15,0,FW,20-24,Forward,Portugal,Europe
2418,André Silva,POR,Eint Frankfurt,Bundesliga,2020,24.0,1995.0,30.7,11,2,0,7,4,6,13,46.2,7,11,1,10,3,14,15,0,FW,20-24,Forward,Portugal,Europe
2419,Bernardo Silva,POR,Manchester City,Premier League,2020,25.0,1994.0,22.9,26,14,7,12,7,11,52,21.2,41,17,1,16,17,43,8,0,"MF,FW",25-29,Midfielder,Portugal,Europe
2420,Caio Henrique Oliveira Silva,BRA,Monaco,Ligue 1,2020,23.0,1997.0,26.3,50,34,25,20,5,31,51,60.8,20,20,3,17,16,66,37,0,DF,20-24,Defender,Brazil,South America
2422,Fábio Silva,POR,Wolves,Premier League,2020,18.0,2002.0,15.2,6,4,1,4,1,4,12,33.3,8,12,1,11,4,10,5,1,FW,Under 20,Forward,Portugal,Europe
2423,Florent da Silva,FRA,Lyon,Ligue 1,2020,17.0,2003.0,0.0,0,0,0,0,0,0,0,,0,0,0,0,0,0,0,0,FW,Under 20,Forward,France,Europe
2424,Gabriel Silva,BRA,Saint-Étienne,Ligue 1,2020,29.0,1991.0,3.9,7,6,7,0,0,1,2,50.0,1,4,1,3,6,13,8,0,DF,25-29,Defender,Brazil,South America
2424,Gabriel Silva,BRA,Saint-Étienne,Ligue 1,2020,29.0,1991.0,3.9,7,6,7,0,0,1,2,50.0,1,4,1,3,6,13,8,0,DF,25-29,Defender,Brazil,South America
2424,Gabriel Silva,BRA,Saint-Étienne,Ligue 1,2020,29.0,1991.0,3.9,7,6,7,0,0,1,2,50.0,1,4,1,3,6,13,8,0,DF,25-29,Defender,Brazil,South America
2424,Gabriel Silva,BRA,Saint-Étienne,Ligue 1,2020,29.0,1991.0,3.9,7,6,7,0,0,1,2,50.0,1,4,1,3,6,13,8,0,DF,25-29,Defender,Brazil,South America
2425,Gastón Silva,URU,Huesca,La Liga,2020,26.0,1994.0,6.7,16,12,11,5,0,8,14,57.1,6,10,4,6,11,27,16,0,DF,25-29,Defender,Uruguay,South America
2426,Rui Silva,POR,Granada,La Liga,2020,26.0,1994.0,32.0,1,0,1,0,0,1,3,33.3,2,0,0,0,2,3,14,0,GK,25-29,Goalkeeper,Portugal,Europe
2426,Rui Silva,POR,Granada,La Liga,2020,26.0,1994.0,32.0,1,0,1,0,0,1,3,33.3,2,0,0,0,2,3,14,0,GK,25-29,Goalkeeper,Portugal,Europe
2426,Rui Silva,POR,Granada,La Liga,2020,26.0,1994.0,32.0,1,0,1,0,0,1,3,33.3,2,0,0,0,2,3,14,0,GK,25-29,Goalkeeper,Portugal,Europe
2426,Rui Silva,POR,Granada,La Liga,2020,26.0,1994.0,32.0,1,0,1,0,0,1,3,33.3,2,0,0,0,2,3,14,0,GK,25-29,Goalkeeper,Portugal,Europe
2427,Thiago Silva,BRA,Chelsea,Premier League,2020,35.0,1984.0,21.5,20,12,11,8,1,14,21,66.7,7,21,13,8,33,53,86,1,DF,35-39,Defender,Brazil,South America
2427,Thiago Silva,BRA,Chelsea,Premier League,2020,35.0,1984.0,21.5,20,12,11,8,1,14,21,66.7,7,21,13,8,33,53,86,1,DF,35-39,Defender,Brazil,South America
2427,Thiago Silva,BRA,Chelsea,Premier League,2020,35.0,1984.0,21.5,20,12,11,8,1,14,21,66.7,7,21,13,8,33,53,86,1,DF,35-39,Defender,Brazil,South America
2427,Thiago Silva,BRA,Chelsea,Premier League,2020,35.0,1984.0,21.5,20,12,11,8,1,14,21,66.7,7,21,13,8,33,53,86,1,DF,35-39,Defender,Brazil,South America
2428,Marco Silvestri,ITA,Hellas Verona,Serie A,2020,29.0,1991.0,34.0,0,0,0,0,0,0,0,,0,0,0,0,0,0,14,1,GK,25-29,Goalkeeper,Italy,Europe
2429,Mohamed Simakan,FRA,Strasbourg,Ligue 1,2020,20.0,2000.0,17.9,32,22,21,6,5,9,18,50.0,9,17,11,6,31,63,41,0,DF,20-24,Defender,France,Europe
2430,Giovanni Simeone,ARG,Cagliari,Serie A,2020,25.0,1995.0,19.3,24,11,2,15,7,7,31,22.6,24,23,1,22,10,34,18,0,FW,25-29,Forward,Argentina,South America
2431,Moses Simon,NGA,Nantes,Ligue 1,2020,25.0,1995.0,25.8,27,14,11,9,7,17,36,47.2,19,24,1,23,15,42,15,1,"FW,MF",25-29,Forward,Nigeria,Africa
2433,Xavi Simons,NED,Paris S-G,Ligue 1,2020,17.0,2003.0,0.0,0,0,0,0,0,0,0,,0,0,0,0,0,0,0,0,MF,Under 20,Midfielder,Netherlands,Europe
2434,Jóan Símun Edmundsson,FRO,Arminia,Bundesliga,2020,29.0,1991.0,0.6,0,0,0,0,0,0,0,,0,1,0,1,1,1,0,0,"FW,MF",25-29,Forward,Faroe Islands,Europe
2435,Wilfried Singo,CIV,Torino,Serie A,2020,19.0,2000.0,20.6,29,14,16,6,7,17,33,51.5,16,13,3,10,29,58,40,0,DF,Under 20,Defender,Ivory Coast,Africa
2436,Daley Sinkgraven,NED,Leverkusen,Bundesliga,2020,25.0,1995.0,17.4,32,17,13,16,3,18,35,51.4,17,22,5,17,23,55,23,0,DF,25-29,Defender,Netherlands,Europe
2437,Dimitris Siovas,GRE,Huesca,La Liga,2020,31.0,1988.0,34.1,46,24,34,10,2,20,30,66.7,10,38,17,21,62,108,125,2,DF,30-34,Defender,Greece,Europe
2438,Tobias Sippel,GER,Gladbach,Bundesliga,2020,32.0,1988.0,3.8,0,0,0,0,0,0,0,,0,0,0,0,1,1,4,0,GK,30-34,Goalkeeper,Germany,Europe
2439,Salvatore Sirigu,ITA,Torino,Serie A,2020,33.0,1987.0,32.0,1,0,1,0,0,1,2,50.0,1,0,0,0,0,1,6,2,GK,30-34,Goalkeeper,Italy,Europe
2440,Issouf Sissokho,MLI,Bordeaux,Ligue 1,2020,18.0,2002.0,0.9,6,4,4,2,0,3,6,50.0,3,2,0,2,1,7,0,0,"MF,DF",Under 20,Midfielder,Mali,Africa
2441,Ibrahima Sissoko,MLI,Strasbourg,Ligue 1,2020,22.0,1997.0,28.7,68,48,25,35,8,28,68,41.2,40,22,5,17,48,116,44,0,MF,20-24,Midfielder,Mali,Africa
2442,Moussa Sissoko,FRA,Tottenham,Premier League,2020,30.0,1989.0,17.6,22,16,19,3,0,8,20,40.0,12,11,4,7,23,45,25,0,MF,30-34,Midfielder,France,Europe
2443,Nelson Sissoko,FRA,Saint-Étienne,Ligue 1,2020,23.0,1997.0,5.3,12,6,6,3,3,7,12,58.3,5,2,1,1,12,24,16,1,DF,20-24,Defender,France,Europe
2445,Jacques Siwe,FRA,Dijon,Ligue 1,2020,19.0,2001.0,1.9,4,1,1,1,2,0,1,0.0,1,1,0,1,1,5,1,0,FW,Under 20,Forward,France,Europe
2446,Ellyes Skhiri,TUN,Köln,Bundesliga,2020,25.0,1995.0,30.9,83,48,44,31,8,33,65,50.8,32,49,13,36,82,165,38,2,MF,25-29,Midfielder,Tunisia,Africa
2448,Andreas Skov Olsen,DEN,Bologna,Serie A,2020,20.0,1999.0,13.1,19,10,11,4,4,11,21,52.4,10,15,0,15,3,22,25,0,"FW,DF",20-24,Forward,Denmark,Europe
2449,Robert Skov,DEN,Hoffenheim,Bundesliga,2020,24.0,1996.0,12.9,19,10,9,7,3,7,16,43.8,9,9,2,7,15,34,10,1,"FW,MF",20-24,Forward,Denmark,Europe
2450,Milan Škriniar,SVK,Inter,Serie A,2020,25.0,1995.0,30.9,48,32,29,16,3,23,34,67.6,11,30,19,11,30,78,89,1,DF,25-29,Defender,Slovakia,Europe
2451,Steven Skrzybski,GER,Schalke 04,Bundesliga,2020,27.0,1992.0,4.7,5,4,0,5,0,1,7,14.3,6,13,1,12,5,10,1,1,"FW,DF",25-29,Forward,Germany,Europe
2453,Islam Slimani,ALG,Leicester City,Premier League,2020,32.0,1988.0,0.2,0,0,0,0,0,0,0,,0,0,0,0,0,0,0,0,FW,30-34,Forward,Algeria,Africa
2454,Islam Slimani,ALG,Lyon,Ligue 1,2020,32.0,1988.0,6.4,7,5,3,1,3,3,12,25.0,9,4,1,3,1,8,6,0,FW,30-34,Forward,Algeria,Africa
2455,William Smallbone,IRL,Southampton,Premier League,2020,20.0,2000.0,1.9,6,3,2,4,0,1,3,33.3,2,5,0,5,2,8,1,0,MF,20-24,Midfielder,Republic of Ireland,Europe
2456,Chris Smalling,ENG,Roma,Serie A,2020,30.0,1989.0,12.3,14,8,5,7,2,6,10,60.0,4,17,11,6,28,42,46,1,DF,30-34,Defender,England,Europe
2457,Emile Smith Rowe,ENG,Arsenal,Premier League,2020,20.0,2000.0,16.0,14,7,5,5,4,6,17,35.3,11,15,1,14,10,24,12,0,"MF,FW",20-24,Midfielder,England,Europe
2458,Robert Snodgrass,SCO,West Brom,Premier League,2020,32.0,1987.0,5.8,17,12,12,4,1,10,16,62.5,6,11,2,9,1,18,12,0,"MF,FW",30-34,Midfielder,Scotland,Europe
2459,Robert Snodgrass,SCO,West Ham,Premier League,2020,32.0,1987.0,0.1,0,0,0,0,0,0,0,,0,0,0,0,0,0,0,0,"FW,MF",30-34,Forward,Scotland,Europe
2460,Cédric Soares,POR,Arsenal,Premier League,2020,28.0,1991.0,8.3,12,8,6,4,2,6,21,28.6,15,6,1,5,8,20,16,1,DF,25-29,Defender,Portugal,Europe
2461,Rafa Soares,POR,Eibar,La Liga,2020,25.0,1995.0,12.6,28,17,16,8,4,15,21,71.4,6,14,4,10,20,48,32,0,DF,25-29,Defender,Portugal,Europe
2464,Simon Sohm,SUI,Parma,Serie A,2020,19.0,2001.0,10.0,18,12,11,6,1,11,26,42.3,15,8,0,8,5,23,7,0,MF,Under 20,Midfielder,Switzerland,Europe
2465,Augusto Solari,ARG,Celta Vigo,La Liga,2020,28.0,1992.0,5.4,18,13,9,8,1,6,26,23.1,20,13,1,12,6,24,5,0,MF,25-29,Midfielder,Argentina,South America
2468,Yann Sommer,SUI,Gladbach,Bundesliga,2020,31.0,1988.0,30.1,1,1,1,0,0,1,1,100.0,0,0,0,0,2,3,9,2,GK,30-34,Goalkeeper,Switzerland,Europe
2470,Brandon Soppy,FRA,Rennes,Ligue 1,2020,18.0,2002.0,6.2,21,15,16,5,0,10,16,62.5,6,3,0,3,6,27,12,0,DF,Under 20,Defender,France,Europe
2472,Roberto Soriano,ITA,Bologna,Serie A,2020,29.0,1991.0,36.1,48,26,15,20,13,15,64,23.4,49,31,8,23,18,66,43,0,MF,25-29,Midfielder,Italy,Europe
2474,Borna Sosa,CRO,Stuttgart,Bundesliga,2020,22.0,1998.0,22.7,14,10,6,6,2,8,25,32.0,17,23,4,19,31,45,74,0,"DF,FW",20-24,Defender,Croatia,Europe
2476,Florian Sotoca,FRA,Lens,Ligue 1,2020,29.0,1990.0,26.8,31,20,3,20,8,6,22,27.3,16,27,0,27,9,40,24,0,FW,25-29,Forward,France,Europe
2477,Riccardo Sottil,ITA,Cagliari,Serie A,2020,21.0,1999.0,13.2,7,3,2,3,2,0,7,0.0,7,4,0,4,5,12,3,0,"FW,MF",20-24,Forward,Italy,Europe
2478,Cheick Souaré,FRA,Marseille,Ligue 1,2020,17.0,2002.0,0.1,0,0,0,0,0,0,0,,0,1,1,0,1,1,0,0,MF,Under 20,Midfielder,France,Europe
2480,Rayan Souici,FRA,Saint-Étienne,Ligue 1,2020,22.0,1998.0,0.1,0,0,0,0,0,0,0,,0,0,0,0,0,0,0,0,DF,20-24,Defender,France,Europe
2481,Cebio Soukou,BEN,Arminia,Bundesliga,2020,27.0,1992.0,5.1,12,8,5,5,2,6,11,54.5,5,3,0,3,3,15,4,0,"FW,MF",25-29,Forward,Benin,Africa
2482,Adama Soumaoro,FRA,Bologna,Serie A,2020,28.0,1992.0,19.5,24,14,17,7,0,6,12,50.0,6,28,23,5,20,44,72,0,DF,25-29,Defender,France,Europe
2483,Adama Soumaoro,FRA,Lille,Ligue 1,2020,28.0,1992.0,1.6,1,0,0,0,1,0,0,,0,1,1,0,2,3,2,0,DF,25-29,Defender,France,Europe
2484,Boubakary Soumaré,FRA,Lille,Ligue 1,2020,21.0,1999.0,21.3,44,29,16,25,3,14,29,48.3,15,14,6,8,39,83,21,0,MF,20-24,Midfielder,France,Europe
2485,Yaya Soumaré,FRA,Lyon,Ligue 1,2020,20.0,2000.0,0.0,1,1,1,0,0,1,2,50.0,1,0,0,0,2,3,0,0,FW,20-24,Forward,France,Europe
2486,Arnaud Souquet,FRA,Montpellier,Ligue 1,2020,28.0,1992.0,13.6,50,33,35,13,2,27,48,56.3,21,15,6,9,17,67,34,0,DF,25-29,Defender,France,Europe
2487,Ansou Sow,SEN,Lens,Ligue 1,2020,20.0,2000.0,0.1,0,0,0,0,0,0,0,,0,1,0,1,0,0,0,0,MF,20-24,Midfielder,Senegal,Africa
2488,Djibril Sow,SUI,Eint Frankfurt,Bundesliga,2020,23.0,1997.0,24.2,58,33,19,32,7,18,41,43.9,23,31,8,23,51,109,17,0,MF,20-24,Midfielder,Switzerland,Europe
2489,Saidou Sow,GUI,Saint-Étienne,Ligue 1,2020,18.0,2002.0,11.1,23,12,17,6,0,13,19,68.4,6,12,8,4,14,37,39,1,DF,Under 20,Defender,Guinea,Africa
2490,Çağlar Söyüncü,TUR,Leicester City,Premier League,2020,24.0,1996.0,20.2,27,17,13,14,0,17,30,56.7,13,12,9,3,28,55,80,1,DF,20-24,Defender,Turkey,Asia
2491,Leonardo Spinazzola,ITA,Roma,Serie A,2020,27.0,1993.0,23.6,12,6,3,9,0,8,20,40.0,12,16,1,15,25,37,31,0,DF,25-29,Defender,Italy,Europe
2492,Marco Sportiello,ITA,Atalanta,Serie A,2020,28.0,1992.0,14.0,2,2,2,0,0,1,3,33.3,2,0,0,0,2,4,5,1,GK,25-29,Goalkeeper,Italy,Europe
2493,Mattia Sprocati,ITA,Parma,Serie A,2020,27.0,1993.0,0.2,1,0,0,1,0,1,1,100.0,0,0,0,0,1,2,0,0,"MF,FW",25-29,Midfielder,Italy,Europe
2494,Jerry St. Juste,NED,Mainz 05,Bundesliga,2020,23.0,1996.0,32.0,65,38,37,26,2,20,36,55.6,16,46,27,19,64,129,82,1,DF,20-24,Defender,Netherlands,Europe
2495,Benjamin Stambouli,FRA,Schalke 04,Bundesliga,2020,29.0,1990.0,21.7,45,29,24,18,3,15,37,40.5,22,42,14,28,49,94,45,1,"DF,MF",25-29,Defender,France,Europe
2496,Josip Stanišić,CRO,Bayern Munich,Bundesliga,2020,20.0,2000.0,1.0,2,2,1,1,0,1,1,100.0,0,3,0,3,2,4,2,0,DF,20-24,Defender,Croatia,Europe
2497,Niklas Stark,GER,Hertha BSC,Bundesliga,2020,25.0,1995.0,31.0,49,28,20,27,2,13,31,41.9,18,43,16,27,42,91,101,0,"DF,MF",25-29,Defender,Germany,Europe
2498,Renato Steffen,SUI,Wolfsburg,Bundesliga,2020,28.0,1991.0,17.4,24,15,6,12,6,13,24,54.2,11,21,2,19,22,46,15,0,"FW,MF",25-29,Forward,Switzerland,Europe
2499,Zack Steffen,USA,Manchester City,Premier League,2020,25.0,1995.0,1.0,0,0,0,0,0,0,0,,0,0,0,0,0,0,0,0,GK,25-29,Goalkeeper,United States,North America
2500,Pascal Stenzel,GER,Stuttgart,Bundesliga,2020,24.0,1996.0,14.2,33,14,15,17,1,22,50,44.0,28,19,4,15,26,59,39,1,DF,20-24,Defender,Germany,Europe
2501,Dale Stephens,ENG,Burnley,Premier League,2020,31.0,1989.0,2.9,11,6,2,7,2,3,6,50.0,3,3,0,3,8,19,2,0,MF,30-34,Midfielder,England,Europe
2502,Jack Stephens,ENG,Southampton,Premier League,2020,26.0,1994.0,17.1,34,19,19,15,0,17,38,44.7,21,25,14,11,28,62,64,2,DF,25-29,Defender,England,Europe
2503,Raheem Sterling,ENG,Manchester City,Premier League,2020,25.0,1994.0,28.2,21,10,5,12,4,5,12,41.7,7,15,0,15,15,36,4,0,FW,25-29,Forward,England,Europe
2504,Enda Stevens,IRL,Sheffield Utd,Premier League,2020,30.0,1990.0,30.0,59,26,32,19,8,33,58,56.9,25,41,12,29,22,81,81,1,DF,30-34,Defender,Republic of Ireland,Europe
2505,Lars Stindl,GER,Gladbach,Bundesliga,2020,31.0,1988.0,21.8,24,17,3,16,5,7,32,21.9,25,26,3,23,13,37,14,0,"MF,FW",30-34,Midfielder,Germany,Europe
2506,Kevin Stöger,AUT,Mainz 05,Bundesliga,2020,26.0,1993.0,6.0,12,6,2,9,1,5,16,31.3,11,5,0,5,6,18,4,0,"MF,FW",25-29,Midfielder,Austria,Europe
2507,John Stones,ENG,Manchester City,Premier League,2020,26.0,1994.0,21.5,21,10,13,5,3,9,14,64.3,5,23,15,8,18,39,56,1,DF,25-29,Defender,England,Europe
2508,Thomas Strakosha,ALB,Lazio,Serie A,2020,25.0,1995.0,9.0,1,1,1,0,0,0,0,,0,0,0,0,1,2,4,0,GK,25-29,Goalkeeper,Albania,Europe
2509,Tobias Strobl,GER,Augsburg,Bundesliga,2020,30.0,1990.0,20.5,21,10,12,9,0,10,30,33.3,20,21,8,13,28,49,27,0,MF,30-34,Midfielder,Germany,Europe
2510,Kevin Strootman,NED,Genoa,Serie A,2020,30.0,1990.0,14.6,30,18,13,15,2,14,32,43.8,18,35,3,32,25,55,18,0,MF,30-34,Midfielder,Netherlands,Europe
2511,Kevin Strootman,NED,Marseille,Ligue 1,2020,30.0,1990.0,2.6,9,6,5,4,0,4,8,50.0,4,5,2,3,5,14,7,0,"MF,FW",30-34,Midfielder,Netherlands,Europe
2512,Pascal Struijk,NED,Leeds United,Premier League,2020,20.0,1999.0,23.1,49,30,28,19,2,17,28,60.7,11,35,21,14,47,96,92,0,"DF,MF",20-24,Defender,Netherlands,Europe
2513,Jens Stryger Larsen,DEN,Udinese,Serie A,2020,29.0,1991.0,29.3,17,11,14,3,0,8,25,32.0,17,26,11,15,24,41,65,0,DF,25-29,Defender,Denmark,Europe
2514,Stefano Sturaro,ITA,Hellas Verona,Serie A,2020,27.0,1993.0,4.7,4,3,3,0,1,2,8,25.0,6,5,1,4,5,9,10,0,MF,25-29,Midfielder,Italy,Europe
2515,Stefano Sturaro,ITA,Genoa,Serie A,2020,27.0,1993.0,4.9,11,5,3,6,2,3,15,20.0,12,5,0,5,7,18,2,0,MF,25-29,Midfielder,Italy,Europe
2516,Damián Suárez,URU,Getafe,La Liga,2020,32.0,1988.0,27.0,59,39,29,23,7,30,81,37.0,51,43,2,41,31,90,42,0,DF,30-34,Defender,Uruguay,South America
2518,Luis Suárez,URU,Atlético Madrid,La Liga,2020,33.0,1987.0,27.9,11,7,0,4,7,3,12,25.0,9,7,0,7,5,16,13,0,FW,30-34,Forward,Uruguay,South America
2518,Luis Suárez,URU,Atlético Madrid,La Liga,2020,33.0,1987.0,27.9,11,7,0,4,7,3,12,25.0,9,7,0,7,5,16,13,0,FW,30-34,Forward,Uruguay,South America
2518,Luis Suárez,URU,Atlético Madrid,La Liga,2020,33.0,1987.0,27.9,11,7,0,4,7,3,12,25.0,9,7,0,7,5,16,13,0,FW,30-34,Forward,Uruguay,South America
2518,Luis Suárez,URU,Atlético Madrid,La Liga,2020,33.0,1987.0,27.9,11,7,0,4,7,3,12,25.0,9,7,0,7,5,16,13,0,FW,30-34,Forward,Uruguay,South America
2520,Niklas Süle,GER,Bayern Munich,Bundesliga,2020,24.0,1995.0,16.7,32,21,15,14,3,13,21,61.9,8,24,12,12,21,53,36,1,DF,20-24,Defender,Germany,Europe
2522,Bosko Sutalo,CRO,Atalanta,Serie A,2020,20.0,2000.0,2.6,5,5,0,3,2,4,5,80.0,1,2,1,1,2,7,7,1,DF,20-24,Defender,Croatia,Europe
2523,Mattias Svanberg,SWE,Bologna,Serie A,2020,21.0,1999.0,20.6,38,17,21,9,8,16,45,35.6,29,25,4,21,30,68,25,1,MF,20-24,Midfielder,Sweden,Europe
2524,Abdoulaye Sylla,GUI,Nantes,Ligue 1,2020,20.0,2000.0,0.1,2,1,2,0,0,1,1,100.0,0,1,0,1,0,2,1,0,DF,20-24,Defender,Guinea,Africa
2525,Issiaga Sylla,GUI,Lens,Ligue 1,2020,26.0,1994.0,12.4,28,20,11,17,0,11,21,52.4,10,13,3,10,16,44,21,0,"DF,MF",25-29,Defender,Guinea,Africa
2526,Eddy Sylvestre,FRA,Nice,Ligue 1,2020,20.0,1999.0,1.1,1,1,1,0,0,0,1,0.0,1,1,0,1,1,2,0,0,"FW,MF",20-24,Forward,France,Europe
2527,Ádám Szalai,HUN,Mainz 05,Bundesliga,2020,32.0,1987.0,8.1,7,6,3,2,2,2,8,25.0,6,4,1,3,2,9,4,0,FW,30-34,Forward,Hungary,Europe
2529,Frederik Sørensen,DEN,Köln,Bundesliga,2020,28.0,1992.0,1.1,2,1,0,2,0,1,1,100.0,0,2,0,2,0,2,0,0,DF,25-29,Defender,Denmark,Europe
2532,Jonathan Tah,GER,Leverkusen,Bundesliga,2020,24.0,1996.0,24.7,30,17,19,9,2,11,21,52.4,10,19,12,7,33,63,89,1,DF,20-24,Defender,Germany,Europe
2533,Waniss Taibi,FRA,Angers,Ligue 1,2020,18.0,2002.0,0.4,0,0,0,0,0,0,2,0.0,2,1,0,1,0,0,0,0,MF,Under 20,Midfielder,France,Europe
2534,Flavien Tait,FRA,Rennes,Ligue 1,2020,27.0,1993.0,15.2,26,11,11,12,3,10,32,31.3,22,17,3,14,13,39,2,0,"MF,FW",25-29,Midfielder,France,Europe
2535,Adrien Tameze,CMR,Hellas Verona,Serie A,2020,26.0,1994.0,25.6,39,25,23,15,1,11,27,40.7,16,31,8,23,32,71,46,2,MF,25-29,Midfielder,Cameroon,Africa
2536,Japhet Tanganga,ENG,Tottenham,Premier League,2020,21.0,1999.0,5.4,5,4,3,2,0,1,3,33.3,2,6,5,1,3,8,15,0,DF,20-24,Defender,England,Europe
2537,Renato Tapia,PER,Celta Vigo,La Liga,2020,25.0,1995.0,30.0,93,44,50,34,9,32,83,38.6,51,56,13,43,53,146,75,2,MF,25-29,Midfielder,Peru,South America
2538,Edmond Tapsoba,BFA,Leverkusen,Bundesliga,2020,21.0,1999.0,29.5,54,28,35,18,1,21,45,46.7,24,55,29,26,48,102,96,0,DF,20-24,Defender,Burkina Faso,Africa
2539,Matt Targett,ENG,Aston Villa,Premier League,2020,24.0,1995.0,37.8,83,39,52,20,11,56,88,63.6,32,40,14,26,55,138,102,1,DF,20-24,Defender,England,Europe
2540,James Tarkowski,ENG,Burnley,Premier League,2020,27.0,1992.0,36.0,66,39,52,11,3,25,49,51.0,24,54,42,12,44,110,163,1,DF,25-29,Defender,England,Europe
2541,Ciprian Tătărușanu,ROU,Milan,Serie A,2020,34.0,1986.0,1.0,0,0,0,0,0,0,0,,0,0,0,0,0,0,0,1,GK,30-34,Goalkeeper,Romania,Europe
2542,Percy Tau,RSA,Brighton,Premier League,2020,26.0,1994.0,1.1,1,1,1,0,0,0,2,0.0,2,1,0,1,0,1,1,0,FW,25-29,Forward,South Africa,Africa
2543,Niklas Tauer,GER,Mainz 05,Bundesliga,2020,19.0,2001.0,0.8,1,1,0,1,0,1,2,50.0,1,3,1,2,3,4,1,0,"MF,DF",Under 20,Midfielder,Germany,Europe
2544,Heriberto Tavares,POR,Brest,Ligue 1,2020,23.0,1997.0,0.5,2,0,0,0,2,1,3,33.3,2,0,0,0,1,3,1,0,"FW,MF",20-24,Forward,Portugal,Europe
2545,Sidnei Tavares,POR,Leicester City,Premier League,2020,18.0,2001.0,0.9,1,1,0,1,0,0,0,,0,1,1,0,0,1,0,0,MF,Under 20,Midfielder,Portugal,Europe
2546,Tomás Tavares,POR,Alavés,La Liga,2020,19.0,2001.0,0.7,2,1,2,0,0,2,2,100.0,0,1,0,1,0,2,1,0,"MF,DF",Under 20,Midfielder,Portugal,Europe
2547,Charlie Taylor,ENG,Burnley,Premier League,2020,26.0,1993.0,27.0,48,28,30,15,3,25,46,54.3,21,36,19,17,29,77,87,2,DF,25-29,Defender,England,Europe
2548,Neil Taylor,WAL,Aston Villa,Premier League,2020,31.0,1989.0,0.2,1,1,1,0,0,0,0,,0,1,0,1,0,1,0,0,DF,30-34,Defender,Wales,Europe
2549,Allan Tchaptchet,FRA,Southampton,Premier League,2020,18.0,2001.0,0.1,0,0,0,0,0,0,0,,0,0,0,0,0,0,0,0,DF,Under 20,Defender,France,Europe
2550,Warren Tchimbembé,CGO,Metz,Ligue 1,2020,22.0,1998.0,5.5,7,4,4,3,0,3,9,33.3,6,6,1,5,2,9,3,0,"MF,FW",20-24,Midfielder,Congo,Africa
2551,Aurélien Tchouaméni,FRA,Monaco,Ligue 1,2020,20.0,2000.0,34.0,127,68,47,62,18,48,92,52.2,44,39,11,28,60,187,47,0,MF,20-24,Midfielder,France,Europe
2553,Nathan Tella,NGA,Southampton,Premier League,2020,21.0,1999.0,8.3,8,5,1,4,3,6,15,40.0,9,13,0,13,3,11,2,0,"FW,MF",20-24,Forward,Nigeria,Africa
2554,Alex Telles,BRA,Manchester Utd,Premier League,2020,27.0,1992.0,7.7,14,7,10,3,1,8,17,47.1,9,7,2,5,16,30,20,0,DF,25-29,Defender,Brazil,South America
2555,Andrés Tello,COL,Benevento,Serie A,2020,23.0,1996.0,4.6,9,6,8,0,1,5,20,25.0,15,8,1,7,6,15,6,0,"DF,MF",20-24,Defender,Colombia,South America
2557,Lino Tempelmann,GER,Freiburg,Bundesliga,2020,21.0,1999.0,3.0,5,3,2,2,1,0,4,0.0,4,6,1,5,2,7,6,0,MF,20-24,Midfielder,Germany,Europe
2558,Hidde ter Avest,NED,Udinese,Serie A,2020,23.0,1997.0,3.9,5,2,3,2,0,2,5,40.0,3,3,1,2,2,7,5,0,DF,20-24,Defender,Netherlands,Europe
2559,Marc-André ter Stegen,GER,Barcelona,La Liga,2020,28.0,1992.0,31.0,0,0,0,0,0,0,2,0.0,2,0,0,0,0,0,12,2,GK,25-29,Goalkeeper,Germany,Europe
2560,Pietro Terracciano,ITA,Fiorentina,Serie A,2020,30.0,1990.0,3.0,0,0,0,0,0,0,0,,0,0,0,0,0,0,1,0,GK,30-34,Goalkeeper,Italy,Europe
2561,Martin Terrier,FRA,Rennes,Ligue 1,2020,23.0,1997.0,27.1,33,15,5,15,13,10,36,27.8,26,23,0,23,16,49,7,0,"FW,MF",20-24,Forward,France,Europe
2562,Claudio Terzi,ITA,Spezia,Serie A,2020,36.0,1984.0,20.8,34,21,19,14,1,19,28,67.9,9,23,12,11,35,69,55,1,DF,35-39,Defender,Italy,Europe
2563,Kenny Tete,NED,Fulham,Premier League,2020,24.0,1995.0,16.5,48,30,27,16,5,10,18,55.6,8,14,5,9,27,75,49,0,"DF,MF",20-24,Defender,Netherlands,Europe
2564,Kenny Tete,NED,Lyon,Ligue 1,2020,24.0,1995.0,0.2,2,0,1,1,0,0,0,,0,0,0,0,2,4,0,0,DF,20-24,Defender,Netherlands,Europe
2565,Cedric Teuchert,GER,Union Berlin,Bundesliga,2020,23.0,1997.0,8.4,7,5,2,4,1,3,16,18.8,13,12,0,12,5,12,6,0,"FW,MF",20-24,Forward,Germany,Europe
2566,Florian Thauvin,FRA,Marseille,Ligue 1,2020,27.0,1993.0,30.4,40,22,14,21,5,20,54,37.0,34,26,2,24,14,54,11,0,"FW,MF",25-29,Forward,France,Europe
2567,Malick Thiaw,GER,Schalke 04,Bundesliga,2020,18.0,2001.0,16.1,42,27,24,17,1,15,26,57.7,11,17,12,5,33,75,70,0,DF,Under 20,Defender,Germany,Europe
2568,Jan Thielmann,GER,Köln,Bundesliga,2020,18.0,2002.0,11.4,11,6,1,8,2,5,9,55.6,4,10,1,9,9,20,2,0,"FW,MF",Under 20,Forward,Germany,Europe
2569,Sada Thioub,SEN,Angers,Ligue 1,2020,25.0,1995.0,14.0,17,14,7,6,4,7,23,30.4,16,10,0,10,9,26,3,0,"FW,MF",25-29,Forward,Senegal,Africa
2570,Luke Thomas,ENG,Leicester City,Premier League,2020,19.0,2001.0,10.8,23,14,11,5,7,14,21,66.7,7,15,2,13,17,40,21,0,DF,Under 20,Defender,England,Europe
2571,Romain Thomas,FRA,Angers,Ligue 1,2020,32.0,1988.0,33.6,47,25,34,11,2,20,35,57.1,15,35,20,15,50,97,138,0,DF,30-34,Defender,France,Europe
2572,Adrien Thomasson,FRA,Strasbourg,Ligue 1,2020,26.0,1993.0,29.2,36,17,8,16,12,12,58,20.7,46,44,5,39,22,58,2,0,"MF,FW",25-29,Midfielder,France,Europe
2573,Erik Thommy,GER,Stuttgart,Bundesliga,2020,25.0,1994.0,3.5,3,1,0,3,0,0,3,0.0,3,3,0,3,3,6,4,0,"MF,DF",25-29,Midfielder,Germany,Europe
2575,Khéphren Thuram,FRA,Nice,Ligue 1,2020,19.0,2001.0,16.6,32,16,5,21,6,9,27,33.3,18,21,9,12,18,50,22,1,MF,Under 20,Midfielder,France,Europe
2576,Marcus Thuram,FRA,Gladbach,Bundesliga,2020,22.0,1997.0,19.2,24,14,9,10,5,10,23,43.5,13,27,4,23,15,39,13,1,"FW,MF",20-24,Forward,France,Europe
2577,Cheikh Tidiane Sabaly,SEN,Metz,Ligue 1,2020,21.0,1999.0,0.1,0,0,0,0,0,0,0,,0,0,0,0,0,0,0,0,FW,20-24,Forward,Senegal,Africa
2578,Youri Tielemans,BEL,Leicester City,Premier League,2020,23.0,1997.0,37.3,86,45,32,38,16,45,108,41.7,63,35,8,27,46,132,20,1,MF,20-24,Midfielder,Belgium,Europe
2579,Kieran Tierney,SCO,Arsenal,Premier League,2020,23.0,1997.0,25.5,27,15,5,14,8,11,31,35.5,20,31,10,21,16,43,63,0,DF,20-24,Defender,Scotland,Europe
2580,Steffen Tigges,GER,Dortmund,Bundesliga,2020,22.0,1998.0,0.6,4,4,0,1,3,2,3,66.7,1,1,0,1,0,4,1,0,"FW,DF",20-24,Forward,Germany,Europe
2581,Guus Til,NED,Freiburg,Bundesliga,2020,22.0,1997.0,1.4,4,3,2,1,1,2,3,66.7,1,2,0,2,2,6,2,0,FW,20-24,Forward,Netherlands,Europe
2583,Jean-Clair Todibo,FRA,Nice,Ligue 1,2020,20.0,1999.0,14.8,25,15,16,9,0,16,31,51.6,15,13,7,6,19,44,48,1,DF,20-24,Defender,France,Europe
2584,Karl Toko Ekambi,CMR,Lyon,Ligue 1,2020,27.0,1992.0,31.2,16,10,5,3,8,8,32,25.0,24,20,1,19,26,42,8,0,FW,25-29,Forward,Cameroon,Africa
2585,Corentin Tolisso,FRA,Bayern Munich,Bundesliga,2020,25.0,1994.0,8.7,19,19,4,11,4,9,29,31.0,20,15,2,13,6,25,8,0,MF,25-29,Midfielder,France,Europe
2586,Jeremy Toljan,GER,Sassuolo,Serie A,2020,25.0,1994.0,16.6,21,12,16,3,2,12,27,44.4,15,15,7,8,13,34,28,0,DF,25-29,Defender,Germany,Europe
2587,Rafael Tolói,ITA,Atalanta,Serie A,2020,29.0,1990.0,28.2,51,23,21,26,4,26,48,54.2,22,37,7,30,33,84,66,0,DF,25-29,Defender,Italy,Europe
2588,Takehiro Tomiyasu,JPN,Bologna,Serie A,2020,21.0,1998.0,30.2,47,31,27,14,6,21,34,61.8,13,37,19,18,54,101,106,0,DF,20-24,Defender,Japan,Asia
2589,James Tomkins,ENG,Crystal Palace,Premier League,2020,31.0,1989.0,6.1,4,2,4,0,0,3,4,75.0,1,4,3,1,4,8,45,0,DF,30-34,Defender,England,Europe
2590,Fikayo Tomori,ENG,Chelsea,Premier League,2020,22.0,1997.0,0.5,2,1,2,0,0,0,0,,0,1,1,0,2,4,8,0,DF,20-24,Defender,England,Europe
2591,Fikayo Tomori,ENG,Milan,Serie A,2020,22.0,1997.0,16.3,28,18,17,9,2,8,14,57.1,6,32,20,12,18,46,61,1,DF,20-24,Defender,England,Europe
2592,Sandro Tonali,ITA,Milan,Serie A,2020,20.0,2000.0,14.8,28,19,14,13,1,13,28,46.4,15,18,5,13,22,50,18,0,MF,20-24,Midfielder,Italy,Europe
2593,Lorenzo Tonelli,ITA,Sampdoria,Serie A,2020,30.0,1990.0,19.8,33,18,20,11,2,10,21,47.6,11,21,14,7,25,58,94,1,DF,30-34,Defender,Italy,Europe
2595,Ömer Toprak,TUR,Werder Bremen,Bundesliga,2020,31.0,1989.0,21.6,23,16,15,6,2,12,24,50.0,12,27,16,11,36,59,115,1,DF,30-34,Defender,Turkey,Asia
2596,Tyron Tormin,FRA,Saint-Étienne,Ligue 1,2020,19.0,2001.0,0.2,0,0,0,0,0,0,0,,0,0,0,0,0,0,0,0,"FW,MF",Under 20,Forward,France,Europe
2597,Ernesto Torregrossa,VEN,Sampdoria,Serie A,2020,28.0,1992.0,1.9,1,1,0,0,1,0,2,0.0,2,4,0,4,1,2,1,0,FW,25-29,Forward,Venezuela,South America
2598,Lucas Torreira,URU,Atlético Madrid,La Liga,2020,24.0,1996.0,5.8,8,4,2,3,3,0,3,0.0,3,5,3,2,12,20,8,0,MF,20-24,Midfielder,Uruguay,South America
2604,Jordan Torunarigha,GER,Hertha BSC,Bundesliga,2020,22.0,1997.0,10.8,7,4,7,0,0,5,8,62.5,3,8,2,6,15,22,54,1,DF,20-24,Defender,Germany,Europe
2605,Cenk Tosun,TUR,Everton,Premier League,2020,29.0,1991.0,0.5,0,0,0,0,0,0,1,0.0,1,0,0,0,0,0,0,0,FW,25-29,Forward,Turkey,Asia
2606,Abdoulaye Touré,GUI,Nantes,Ligue 1,2020,26.0,1994.0,18.7,28,12,10,16,2,14,31,45.2,17,17,2,15,22,50,19,0,MF,25-29,Midfielder,Guinea,Africa
2606,Abdoulaye Touré,GUI,Nantes,Ligue 1,2020,26.0,1994.0,18.7,28,12,10,16,2,14,31,45.2,17,17,2,15,22,50,19,0,MF,25-29,Midfielder,Guinea,Africa
2606,Abdoulaye Touré,GUI,Nantes,Ligue 1,2020,26.0,1994.0,18.7,28,12,10,16,2,14,31,45.2,17,17,2,15,22,50,19,0,MF,25-29,Midfielder,Guinea,Africa
2606,Abdoulaye Touré,GUI,Nantes,Ligue 1,2020,26.0,1994.0,18.7,28,12,10,16,2,14,31,45.2,17,17,2,15,22,50,19,0,MF,25-29,Midfielder,Guinea,Africa
2607,Almamy Touré,MLI,Eint Frankfurt,Bundesliga,2020,24.0,1996.0,7.8,18,12,8,7,3,10,14,71.4,4,5,1,4,8,26,22,0,DF,20-24,Defender,Mali,Africa
2608,Lucas Tousart,FRA,Hertha BSC,Bundesliga,2020,23.0,1997.0,23.2,33,18,16,15,2,13,27,48.1,14,33,6,27,40,73,52,0,MF,20-24,Midfielder,France,Europe
2609,Andros Townsend,ENG,Crystal Palace,Premier League,2020,29.0,1991.0,25.1,78,41,45,20,13,30,79,38.0,49,48,2,46,41,119,19,0,"MF,FW",25-29,Midfielder,England,Europe
2610,Conor Townsend,ENG,West Brom,Premier League,2020,27.0,1993.0,24.8,44,28,32,9,3,30,49,61.2,19,38,15,23,36,80,55,2,DF,25-29,Defender,England,Europe
2611,Mattéo Tramoni,FRA,Cagliari,Serie A,2020,20.0,2000.0,0.8,4,2,2,1,1,1,2,50.0,1,5,0,5,1,5,2,0,"MF,FW",20-24,Midfielder,France,Europe
2613,Amadou Traore,FRA,Bordeaux,Ligue 1,2020,18.0,2002.0,3.4,6,1,2,2,2,2,9,22.2,7,9,0,9,1,7,2,0,"FW,MF",Under 20,Forward,France,Europe
2614,Bertrand Traoré,BFA,Aston Villa,Premier League,2020,24.0,1995.0,25.7,26,10,8,10,8,10,34,29.4,24,23,1,22,15,41,14,1,FW,20-24,Forward,Burkina Faso,Africa
2615,Boubacar Traoré,MLI,Metz,Ligue 1,2020,18.0,2001.0,0.6,3,2,1,2,0,1,1,100.0,0,1,0,1,0,3,0,0,MF,Under 20,Midfielder,Mali,Africa
2616,Chaka Traorè,CIV,Parma,Serie A,2020,15.0,2004.0,0.2,0,0,0,0,0,0,0,,0,0,0,0,0,0,1,1,"FW,DF",Under 20,Forward,Ivory Coast,Africa
2617,Charles Traore,MLI,Nantes,Ligue 1,2020,28.0,1992.0,18.9,53,34,30,17,6,27,54,50.0,27,26,5,21,36,89,65,0,DF,25-29,Defender,Mali,Africa
2618,Cheick Traoré,MLI,Lens,Ligue 1,2020,25.0,1995.0,0.4,2,2,1,1,0,2,4,50.0,2,1,0,1,2,4,1,0,DF,25-29,Defender,Mali,Africa
2619,Hamari Traoré,MLI,Rennes,Ligue 1,2020,28.0,1992.0,33.3,56,38,23,27,6,22,59,37.3,37,31,5,26,76,132,50,0,DF,25-29,Defender,Mali,Africa
2620,Ibrahima Traoré,GUI,Gladbach,Bundesliga,2020,32.0,1988.0,1.1,4,1,1,2,1,0,0,,0,2,0,2,0,4,0,0,"FW,DF",30-34,Forward,Guinea,Africa
2621,Ismaël Traoré,CIV,Angers,Ligue 1,2020,33.0,1986.0,33.3,32,14,23,9,0,20,37,54.1,17,27,13,14,40,72,107,0,DF,30-34,Defender,Ivory Coast,Africa
2622,Kevin Trapp,GER,Eint Frankfurt,Bundesliga,2020,30.0,1990.0,33.0,0,0,0,0,0,0,1,0.0,1,1,0,1,3,3,11,3,GK,30-34,Goalkeeper,Germany,Europe
2623,Miguel Trauco,PER,Saint-Étienne,Ligue 1,2020,27.0,1992.0,22.6,47,29,25,14,8,23,43,53.5,20,19,4,15,30,77,34,1,DF,25-29,Defender,Peru,South America
2624,Trézéguet,EGY,Aston Villa,Premier League,2020,25.0,1994.0,13.0,33,18,14,15,4,13,45,28.9,32,13,1,12,19,52,17,0,FW,25-29,Forward,Egypt,Africa
2626,Christopher Trimmel,AUT,Union Berlin,Bundesliga,2020,33.0,1987.0,28.6,50,25,28,18,4,28,54,51.9,26,32,7,25,50,100,99,0,"DF,FW",30-34,Defender,Austria,Europe
2627,Francisco Trincão,POR,Barcelona,La Liga,2020,20.0,1999.0,7.8,4,2,0,3,1,2,5,40.0,3,4,0,4,1,5,2,0,"FW,MF",20-24,Forward,Portugal,Europe
2628,Alessandro Tripaldelli,ITA,Cagliari,Serie A,2020,21.0,1999.0,3.3,13,6,5,6,2,5,6,83.3,1,6,1,5,3,16,15,0,DF,20-24,Defender,Italy,Europe
2629,Kieran Trippier,ENG,Atlético Madrid,La Liga,2020,29.0,1990.0,27.5,61,39,30,25,6,26,52,50.0,26,22,4,18,40,101,58,1,DF,25-29,Defender,England,Europe
2630,Leandro Trossard,BEL,Brighton,Premier League,2020,25.0,1994.0,29.0,33,14,11,16,6,10,36,27.8,26,34,2,32,26,59,7,1,"MF,FW",25-29,Midfielder,Belgium,Europe
2631,Alexis Trouillet,FRA,Nice,Ligue 1,2020,19.0,2000.0,1.2,5,4,1,4,0,4,5,80.0,1,0,0,0,3,8,0,0,"MF,FW",Under 20,Midfielder,France,Europe
2632,Adrien Truffert,FRA,Rennes,Ligue 1,2020,18.0,2001.0,21.7,38,18,18,12,8,13,24,54.2,11,26,5,21,18,56,38,1,"DF,MF",Under 20,Defender,France,Europe
2633,Marvin Tshibuabua,FRA,Saint-Étienne,Ligue 1,2020,18.0,2002.0,0.5,1,0,1,0,0,0,0,,0,0,0,0,1,2,1,0,DF,Under 20,Defender,France,Europe
2634,Kostas Tsimikas,GRE,Liverpool,Premier League,2020,24.0,1996.0,0.1,0,0,0,0,0,0,0,,0,0,0,0,0,0,0,0,"DF,FW",20-24,Defender,Greece,Europe
2635,Axel Tuanzebe,COD,Manchester Utd,Premier League,2020,22.0,1997.0,4.5,13,7,5,7,1,8,9,88.9,1,7,5,2,3,16,18,0,DF,20-24,Defender,DR Congo,Africa
2636,Alessandro Tuia,ITA,Benevento,Serie A,2020,30.0,1990.0,19.6,39,17,34,4,1,15,25,60.0,10,22,10,12,36,75,91,1,DF,30-34,Defender,Italy,Europe
2637,Ľubomír Tupta,SVK,Hellas Verona,Serie A,2020,22.0,1998.0,0.6,0,0,0,0,0,0,0,,0,0,0,0,0,0,0,0,FW,20-24,Forward,Slovakia,Europe
2638,Tuta,BRA,Eint Frankfurt,Bundesliga,2020,21.0,1999.0,16.2,35,20,22,13,0,24,43,55.8,19,19,2,17,29,64,53,0,DF,20-24,Defender,Brazil,South America
2639,Destiny Udogie,ITA,Hellas Verona,Serie A,2020,17.0,2002.0,1.9,6,4,2,2,2,2,2,100.0,0,3,0,3,2,8,4,0,"DF,MF",Under 20,Defender,Italy,Europe
2640,Matthieu Udol,FRA,Metz,Ligue 1,2020,24.0,1996.0,19.2,34,21,18,12,4,17,39,43.6,22,25,5,20,39,73,30,0,DF,20-24,Defender,France,Europe
2641,Naomichi Ueda,JPN,Nîmes,Ligue 1,2020,25.0,1994.0,7.9,4,2,3,1,0,4,6,66.7,2,5,4,1,6,10,30,1,DF,25-29,Defender,Japan,Asia
2642,Lesley Ugochukwu,FRA,Rennes,Ligue 1,2020,16.0,2004.0,0.7,3,1,0,3,0,2,3,66.7,1,1,0,1,0,3,0,0,MF,Under 20,Midfielder,France,Europe
2643,Hwang Ui-jo,KOR,Bordeaux,Ligue 1,2020,27.0,1992.0,27.8,14,6,5,8,1,6,25,24.0,19,17,2,15,8,22,14,0,"FW,MF",25-29,Forward,South Korea,Asia
2645,Samuel Umtiti,FRA,Barcelona,La Liga,2020,26.0,1993.0,7.2,5,1,3,2,0,1,2,50.0,1,11,6,5,9,14,15,0,DF,25-29,Defender,France,Europe
2646,Enes Ünal,TUR,Getafe,La Liga,2020,23.0,1997.0,14.6,11,3,0,8,3,4,15,26.7,11,11,0,11,2,13,14,0,FW,20-24,Forward,Turkey,Asia
2647,Cengiz Ünder,TUR,Leicester City,Premier League,2020,23.0,1997.0,3.1,4,1,0,3,1,3,5,60.0,2,3,0,3,2,6,0,0,"FW,MF",20-24,Forward,Turkey,Asia
2648,Dayot Upamecano,FRA,RB Leipzig,Bundesliga,2020,21.0,1998.0,25.9,37,30,18,19,0,14,20,70.0,6,25,14,11,33,70,74,2,DF,20-24,Defender,France,Europe
2650,Mark Uth,GER,Schalke 04,Bundesliga,2020,28.0,1991.0,16.6,25,13,13,10,2,5,23,21.7,18,21,0,21,5,30,10,0,"FW,MF",25-29,Forward,Germany,Europe
2653,Lautaro Valenti,ARG,Parma,Serie A,2020,21.0,1999.0,5.5,10,4,7,2,1,6,15,40.0,9,11,3,8,11,21,30,0,DF,20-24,Defender,Argentina,South America
2654,Antoine Valerio,FRA,Nîmes,Ligue 1,2020,20.0,1999.0,0.8,0,0,0,0,0,0,1,0.0,1,1,0,1,2,2,0,0,MF,20-24,Midfielder,France,Europe
2656,Yan Valery,TUN,Southampton,Premier League,2020,21.0,1999.0,1.1,5,3,2,3,0,1,5,20.0,4,2,0,2,2,7,5,0,"DF,MF",20-24,Defender,Tunisia,Africa
2659,Federico Valverde,URU,Real Madrid,La Liga,2020,22.0,1998.0,14.8,25,16,9,8,8,10,26,38.5,16,16,2,14,22,47,4,0,MF,20-24,Midfielder,Uruguay,South America
2660,Virgil van Dijk,NED,Liverpool,Premier League,2020,29.0,1991.0,4.1,3,2,1,2,0,0,0,,0,1,1,0,5,8,8,1,DF,25-29,Defender,Netherlands,Europe
2661,Raphaël Varane,FRA,Real Madrid,La Liga,2020,27.0,1993.0,30.2,22,14,16,5,1,10,19,52.6,9,26,18,8,36,58,114,2,DF,25-29,Defender,France,Europe
2662,Jamie Vardy,ENG,Leicester City,Premier League,2020,33.0,1987.0,31.6,18,12,1,8,9,2,15,13.3,13,14,5,9,4,22,32,0,FW,30-34,Forward,England,Europe
2663,Ruben Vargas,SUI,Augsburg,Bundesliga,2020,21.0,1998.0,17.9,18,12,6,9,3,1,16,6.3,15,26,2,24,18,36,27,0,"MF,FW",20-24,Midfielder,Switzerland,Europe
2664,Denis Vavro,SVK,Lazio,Serie A,2020,24.0,1996.0,0.4,0,0,0,0,0,0,1,0.0,1,0,0,0,1,1,3,0,DF,20-24,Defender,Slovakia,Europe
2665,Denis Vavro,SVK,Huesca,La Liga,2020,24.0,1996.0,6.8,7,4,2,4,1,2,5,40.0,3,2,0,2,11,18,21,0,DF,20-24,Defender,Slovakia,Europe
2666,Franco Vázquez,ARG,Sevilla,La Liga,2020,31.0,1989.0,1.8,5,1,0,3,2,1,5,20.0,4,2,1,1,1,6,1,0,"FW,MF",30-34,Forward,Argentina,South America
2669,Matías Vecino,URU,Inter,Serie A,2020,28.0,1991.0,3.1,1,1,0,0,1,0,5,0.0,5,7,1,6,4,5,3,0,MF,25-29,Midfielder,Uruguay,South America
2673,Miguel Veloso,POR,Hellas Verona,Serie A,2020,34.0,1986.0,14.6,24,17,10,10,4,12,34,35.3,22,12,1,11,12,36,25,0,MF,30-34,Midfielder,Portugal,Europe
2674,Joël Veltman,NED,Brighton,Premier League,2020,28.0,1992.0,25.3,67,33,34,25,8,29,57,50.9,28,24,5,19,33,100,64,0,DF,25-29,Defender,Netherlands,Europe
2676,Lorenzo Venuti,ITA,Fiorentina,Serie A,2020,25.0,1995.0,19.5,24,11,14,7,3,14,28,50.0,14,18,3,15,17,41,24,0,DF,25-29,Defender,Italy,Europe
2677,Daniele Verde,ITA,Spezia,Serie A,2020,24.0,1996.0,10.9,5,4,2,2,1,4,10,40.0,6,5,0,5,9,14,7,0,FW,20-24,Forward,Italy,Europe
2678,Simone Verdi,ITA,Torino,Serie A,2020,28.0,1992.0,18.0,19,12,10,6,3,6,19,31.6,13,8,0,8,8,27,2,2,"MF,FW",25-29,Midfielder,Italy,Europe
2680,Jordan Veretout,FRA,Roma,Serie A,2020,27.0,1993.0,22.8,20,12,8,12,0,9,33,27.3,24,14,3,11,14,34,21,3,MF,25-29,Midfielder,France,Europe
2681,Edoardo Vergani,ITA,Bologna,Serie A,2020,19.0,2001.0,0.1,0,0,0,0,0,0,0,,0,0,0,0,0,0,0,0,FW,Under 20,Forward,Italy,Europe
2682,Marco Verratti,ITA,Paris S-G,Ligue 1,2020,27.0,1992.0,16.6,53,30,17,25,11,24,72,33.3,48,22,5,17,26,79,4,1,MF,25-29,Midfielder,Italy,Europe
2683,Valerio Verre,ITA,Sampdoria,Serie A,2020,26.0,1994.0,11.1,11,7,2,7,2,4,19,21.1,15,14,2,12,9,20,3,0,"FW,MF",25-29,Forward,Italy,Europe
2685,Jannik Vestergaard,DEN,Southampton,Premier League,2020,27.0,1992.0,28.6,50,31,31,15,4,35,52,67.3,17,29,16,13,42,92,122,0,DF,25-29,Defender,Denmark,Europe
2686,Rúben Vezo,POR,Levante,La Liga,2020,26.0,1994.0,25.7,34,19,26,7,1,12,29,41.4,17,22,11,11,46,80,106,3,DF,25-29,Defender,Portugal,Europe
2687,Guglielmo Vicario,ITA,Cagliari,Serie A,2020,23.0,1996.0,4.0,0,0,0,0,0,0,0,,0,0,0,0,0,0,1,0,GK,20-24,Goalkeeper,Italy,Europe
2691,Arturo Vidal,CHI,Inter,Serie A,2020,33.0,1987.0,12.6,27,14,8,13,6,12,41,29.3,29,23,3,20,29,56,11,0,MF,30-34,Midfielder,Chile,South America
2692,Clément Vidal,FRA,Montpellier,Ligue 1,2020,20.0,2000.0,1.0,2,1,1,1,0,2,4,50.0,2,4,4,0,1,3,6,1,DF,20-24,Defender,France,Europe
2694,Ronaldo Vieira,ENG,Hellas Verona,Serie A,2020,22.0,1998.0,2.5,5,3,1,3,1,0,2,0.0,2,4,3,1,0,5,2,0,"MF,DF",20-24,Midfielder,England,Europe
2695,Luca Vignali,ITA,Spezia,Serie A,2020,24.0,1996.0,17.7,19,9,10,6,3,7,25,28.0,18,13,5,8,22,41,25,0,DF,20-24,Defender,Italy,Europe
2696,Emanuel Vignato,ITA,Bologna,Serie A,2020,19.0,2000.0,13.4,18,9,9,6,3,3,15,20.0,12,6,1,5,10,28,7,0,"FW,MF",Under 20,Forward,Italy,Europe
2701,Rúben Vinagre,POR,Wolves,Premier League,2020,21.0,1999.0,1.9,7,5,5,2,0,3,4,75.0,1,3,0,3,2,9,4,0,"MF,DF",20-24,Midfielder,Portugal,Europe
2702,Carlos Vinícius,BRA,Tottenham,Premier League,2020,25.0,1995.0,3.4,3,1,2,1,0,1,1,100.0,0,0,0,0,2,5,5,0,FW,25-29,Forward,Brazil,South America
2703,Nicolas Viola,ITA,Benevento,Serie A,2020,30.0,1989.0,11.5,16,9,2,11,3,6,28,21.4,22,10,3,7,9,25,7,0,MF,30-34,Midfielder,Italy,Europe
2704,João Virgínia,POR,Everton,Premier League,2020,20.0,1999.0,0.5,0,0,0,0,0,0,0,,0,0,0,0,0,0,0,0,GK,20-24,Goalkeeper,Portugal,Europe
2705,Vitinha,POR,Wolves,Premier League,2020,20.0,2000.0,5.8,7,3,2,5,0,3,8,37.5,5,3,0,3,3,10,1,0,MF,20-24,Midfielder,Portugal,Europe
2705,Vitinha,POR,Wolves,Premier League,2020,20.0,2000.0,5.8,7,3,2,5,0,3,8,37.5,5,3,0,3,3,10,1,0,MF,20-24,Midfielder,Portugal,Europe
2705,Vitinha,POR,Wolves,Premier League,2020,20.0,2000.0,5.8,7,3,2,5,0,3,8,37.5,5,3,0,3,3,10,1,0,MF,20-24,Midfielder,Portugal,Europe
2705,Vitinha,POR,Wolves,Premier League,2020,20.0,2000.0,5.8,7,3,2,5,0,3,8,37.5,5,3,0,3,3,10,1,0,MF,20-24,Midfielder,Portugal,Europe
2708,Michel Vlap,NED,Arminia,Bundesliga,2020,23.0,1997.0,4.1,1,1,0,1,0,0,8,0.0,8,4,0,4,5,6,3,0,"MF,FW",20-24,Midfielder,Netherlands,Europe
2709,Andreas Voglsammer,GER,Arminia,Bundesliga,2020,28.0,1992.0,11.1,12,8,6,6,0,8,17,47.1,9,11,0,11,3,15,11,0,"FW,MF",25-29,Forward,Germany,Europe
2710,Kevin Vogt,GER,Hoffenheim,Bundesliga,2020,28.0,1991.0,20.5,18,12,11,6,1,12,21,57.1,9,21,12,9,16,34,71,0,DF,25-29,Defender,Germany,Europe
2712,Jake Vokins,ENG,Southampton,Premier League,2020,20.0,2000.0,0.7,0,0,0,0,0,0,1,0.0,1,0,0,0,0,0,0,0,DF,20-24,Defender,England,Europe
2713,Kevin Volland,GER,Monaco,Ligue 1,2020,28.0,1992.0,30.8,33,16,11,19,3,8,34,23.5,26,23,0,23,4,37,4,0,"FW,MF",25-29,Forward,Germany,Europe
2714,Stefan de Vrij,NED,Inter,Serie A,2020,28.0,1992.0,30.4,28,16,15,12,1,15,24,62.5,9,24,18,6,41,69,95,0,DF,25-29,Defender,Netherlands,Europe
2715,Giacomo Vrioni,ALB,Juventus,Serie A,2020,21.0,1998.0,0.0,0,0,0,0,0,0,0,,0,0,0,0,0,0,0,0,FW,20-24,Forward,Albania,Europe
2716,Šime Vrsaljko,CRO,Atlético Madrid,La Liga,2020,28.0,1992.0,5.8,18,12,13,5,0,8,12,66.7,4,5,0,5,8,26,14,0,"FW,DF",25-29,Forward,Croatia,Europe
2717,Nikola Vukčević,MNE,Levante,La Liga,2020,28.0,1991.0,9.0,14,7,5,8,1,9,18,50.0,9,8,5,3,8,22,12,1,MF,25-29,Midfielder,Montenegro,Europe
2720,Franklin Wadja,CMR,Lorient,Ligue 1,2020,25.0,1995.0,0.4,4,2,0,2,2,2,2,100.0,0,0,0,0,2,6,1,0,"MF,FW",25-29,Midfielder,Cameroon,Africa
2721,Elye Wahi,FRA,Montpellier,Ligue 1,2020,17.0,2003.0,6.2,4,3,2,1,1,1,6,16.7,5,4,0,4,2,6,5,0,FW,Under 20,Forward,France,Europe
2722,Walace,BRA,Udinese,Serie A,2020,25.0,1995.0,22.8,50,23,28,19,3,21,60,35.0,39,36,3,33,34,84,23,0,MF,25-29,Midfielder,Brazil,South America
2723,Theo Walcott,ENG,Southampton,Premier League,2020,31.0,1989.0,18.0,23,11,8,9,6,11,32,34.4,21,16,0,16,14,37,5,0,"MF,FW",30-34,Midfielder,England,Europe
2724,Theo Walcott,ENG,Everton,Premier League,2020,31.0,1989.0,0.1,0,0,0,0,0,0,0,,0,0,0,0,0,0,0,0,FW,30-34,Forward,England,Europe
2725,Kyle Walker,ENG,Manchester City,Premier League,2020,30.0,1990.0,21.6,29,19,15,12,2,16,24,66.7,8,19,7,12,14,43,28,0,DF,30-34,Defender,England,Europe
2726,Kyle Walker-Peters,ENG,Southampton,Premier League,2020,23.0,1997.0,29.4,83,53,56,25,2,34,57,59.6,23,41,10,31,38,121,66,2,DF,20-24,Defender,England,Europe
2728,Aaron Wan-Bissaka,ENG,Manchester Utd,Premier League,2020,22.0,1997.0,34.0,88,54,53,29,6,32,45,71.1,13,65,17,48,62,150,84,2,DF,20-24,Defender,England,Europe
2729,Joel Ward,ENG,Crystal Palace,Premier League,2020,30.0,1989.0,25.1,43,25,29,14,0,24,42,57.1,18,27,8,19,41,84,87,2,DF,30-34,Defender,England,Europe
2730,James Ward-Prowse,ENG,Southampton,Premier League,2020,25.0,1994.0,38.0,75,49,30,41,4,29,70,41.4,41,36,4,32,42,117,60,0,MF,25-29,Midfielder,England,Europe
2731,Daniel Wass,DEN,Valencia,La Liga,2020,31.0,1989.0,33.1,52,31,21,29,2,22,55,40.0,33,33,13,20,47,99,69,0,"MF,DF",30-34,Midfielder,Denmark,Europe
2732,Ollie Watkins,ENG,Aston Villa,Premier League,2020,24.0,1995.0,37.0,29,17,5,16,8,10,33,30.3,23,21,2,19,7,36,24,0,FW,20-24,Forward,England,Europe
2733,Caleb Watts,AUS,Southampton,Premier League,2020,18.0,2002.0,0.4,2,1,2,0,0,1,2,50.0,1,0,0,0,0,2,0,0,MF,Under 20,Midfielder,Australia,Oceania
2734,Timothy Weah,USA,Lille,Ligue 1,2020,20.0,2000.0,9.8,15,7,3,9,3,7,14,50.0,7,7,0,7,4,19,5,0,"FW,MF",20-24,Forward,United States,North America
2735,Adam Webster,ENG,Brighton,Premier League,2020,25.0,1995.0,28.8,29,16,15,10,4,12,25,48.0,13,29,16,13,47,76,92,3,DF,25-29,Defender,England,Europe
2736,Wout Weghorst,NED,Wolfsburg,Bundesliga,2020,27.0,1992.0,32.7,13,8,2,8,3,4,20,20.0,16,17,3,14,4,17,26,0,FW,25-29,Forward,Netherlands,Europe
2737,Mitchell Weiser,GER,Leverkusen,Bundesliga,2020,26.0,1994.0,2.5,4,1,1,2,1,2,4,50.0,2,1,0,1,3,7,4,0,DF,25-29,Defender,Germany,Europe
2738,Shon Weissman,ISR,Valladolid,La Liga,2020,24.0,1996.0,23.7,12,9,4,5,3,2,23,8.7,21,17,3,14,8,20,7,0,FW,20-24,Forward,Israel,Asia
2739,Danny Welbeck,ENG,Brighton,Premier League,2020,29.0,1990.0,17.2,12,6,2,6,4,7,19,36.8,12,17,0,17,7,19,13,0,FW,25-29,Forward,England,Europe
2740,Wendell,BRA,Leverkusen,Bundesliga,2020,27.0,1993.0,16.2,53,35,27,18,8,23,49,46.9,26,26,3,23,25,78,39,1,DF,25-29,Defender,Brazil,South America
2740,Wendell,BRA,Leverkusen,Bundesliga,2020,27.0,1993.0,16.2,53,35,27,18,8,23,49,46.9,26,26,3,23,25,78,39,1,DF,25-29,Defender,Brazil,South America
2740,Wendell,BRA,Leverkusen,Bundesliga,2020,27.0,1993.0,16.2,53,35,27,18,8,23,49,46.9,26,26,3,23,25,78,39,1,DF,25-29,Defender,Brazil,South America
2740,Wendell,BRA,Leverkusen,Bundesliga,2020,27.0,1993.0,16.2,53,35,27,18,8,23,49,46.9,26,26,3,23,25,78,39,1,DF,25-29,Defender,Brazil,South America
2740,Wendell,BRA,Leverkusen,Bundesliga,2020,27.0,1993.0,16.2,53,35,27,18,8,23,49,46.9,26,26,3,23,25,78,39,1,DF,25-29,Defender,Brazil,South America
2740,Wendell,BRA,Leverkusen,Bundesliga,2020,27.0,1993.0,16.2,53,35,27,18,8,23,49,46.9,26,26,3,23,25,78,39,1,DF,25-29,Defender,Brazil,South America
2740,Wendell,BRA,Leverkusen,Bundesliga,2020,27.0,1993.0,16.2,53,35,27,18,8,23,49,46.9,26,26,3,23,25,78,39,1,DF,25-29,Defender,Brazil,South America
2740,Wendell,BRA,Leverkusen,Bundesliga,2020,27.0,1993.0,16.2,53,35,27,18,8,23,49,46.9,26,26,3,23,25,78,39,1,DF,25-29,Defender,Brazil,South America
2740,Wendell,BRA,Leverkusen,Bundesliga,2020,27.0,1993.0,16.2,53,35,27,18,8,23,49,46.9,26,26,3,23,25,78,39,1,DF,25-29,Defender,Brazil,South America
2741,Oscar Wendt,SWE,Gladbach,Bundesliga,2020,34.0,1985.0,13.9,12,6,2,9,1,4,12,33.3,8,18,4,14,14,26,23,0,DF,30-34,Defender,Sweden,Europe
2742,Timo Werner,GER,Chelsea,Premier League,2020,24.0,1996.0,28.9,20,9,6,11,3,7,43,16.3,36,23,1,22,8,28,8,0,"FW,MF",20-24,Forward,Germany,Europe
2743,Ashley Westwood,ENG,Burnley,Premier League,2020,30.0,1990.0,37.9,23,15,6,12,5,10,42,23.8,32,26,9,17,44,67,33,0,MF,30-34,Midfielder,England,Europe
2744,Ben White,ENG,Brighton,Premier League,2020,22.0,1997.0,35.5,49,26,21,24,4,24,57,42.1,33,46,22,24,62,111,56,0,"DF,MF",20-24,Defender,England,Europe
2745,Georginio Wijnaldum,NED,Liverpool,Premier League,2020,29.0,1990.0,32.7,23,7,6,14,3,7,31,22.6,24,18,3,15,26,49,18,1,MF,25-29,Midfielder,Netherlands,Europe
2746,William,BRA,Wolfsburg,Bundesliga,2020,25.0,1995.0,0.0,0,0,0,0,0,0,0,,0,0,0,0,0,0,0,0,"MF,FW",25-29,Midfielder,Brazil,South America
2746,William,BRA,Wolfsburg,Bundesliga,2020,25.0,1995.0,0.0,0,0,0,0,0,0,0,,0,0,0,0,0,0,0,0,"MF,FW",25-29,Midfielder,Brazil,South America
2746,William,BRA,Wolfsburg,Bundesliga,2020,25.0,1995.0,0.0,0,0,0,0,0,0,0,,0,0,0,0,0,0,0,0,"MF,FW",25-29,Midfielder,Brazil,South America
2746,William,BRA,Wolfsburg,Bundesliga,2020,25.0,1995.0,0.0,0,0,0,0,0,0,0,,0,0,0,0,0,0,0,0,"MF,FW",25-29,Midfielder,Brazil,South America
2746,William,BRA,Wolfsburg,Bundesliga,2020,25.0,1995.0,0.0,0,0,0,0,0,0,0,,0,0,0,0,0,0,0,0,"MF,FW",25-29,Midfielder,Brazil,South America
2746,William,BRA,Wolfsburg,Bundesliga,2020,25.0,1995.0,0.0,0,0,0,0,0,0,0,,0,0,0,0,0,0,0,0,"MF,FW",25-29,Midfielder,Brazil,South America
2746,William,BRA,Wolfsburg,Bundesliga,2020,25.0,1995.0,0.0,0,0,0,0,0,0,0,,0,0,0,0,0,0,0,0,"MF,FW",25-29,Midfielder,Brazil,South America
2746,William,BRA,Wolfsburg,Bundesliga,2020,25.0,1995.0,0.0,0,0,0,0,0,0,0,,0,0,0,0,0,0,0,0,"MF,FW",25-29,Midfielder,Brazil,South America
2746,William,BRA,Wolfsburg,Bundesliga,2020,25.0,1995.0,0.0,0,0,0,0,0,0,0,,0,0,0,0,0,0,0,0,"MF,FW",25-29,Midfielder,Brazil,South America
2746,William,BRA,Wolfsburg,Bundesliga,2020,25.0,1995.0,0.0,0,0,0,0,0,0,0,,0,0,0,0,0,0,0,0,"MF,FW",25-29,Midfielder,Brazil,South America
2746,William,BRA,Wolfsburg,Bundesliga,2020,25.0,1995.0,0.0,0,0,0,0,0,0,0,,0,0,0,0,0,0,0,0,"MF,FW",25-29,Midfielder,Brazil,South America
2746,William,BRA,Wolfsburg,Bundesliga,2020,25.0,1995.0,0.0,0,0,0,0,0,0,0,,0,0,0,0,0,0,0,0,"MF,FW",25-29,Midfielder,Brazil,South America
2746,William,BRA,Wolfsburg,Bundesliga,2020,25.0,1995.0,0.0,0,0,0,0,0,0,0,,0,0,0,0,0,0,0,0,"MF,FW",25-29,Midfielder,Brazil,South America
2746,William,BRA,Wolfsburg,Bundesliga,2020,25.0,1995.0,0.0,0,0,0,0,0,0,0,,0,0,0,0,0,0,0,0,"MF,FW",25-29,Midfielder,Brazil,South America
2746,William,BRA,Wolfsburg,Bundesliga,2020,25.0,1995.0,0.0,0,0,0,0,0,0,0,,0,0,0,0,0,0,0,0,"MF,FW",25-29,Midfielder,Brazil,South America
2746,William,BRA,Wolfsburg,Bundesliga,2020,25.0,1995.0,0.0,0,0,0,0,0,0,0,,0,0,0,0,0,0,0,0,"MF,FW",25-29,Midfielder,Brazil,South America
2747,William,BRA,Schalke 04,Bundesliga,2020,25.0,1995.0,5.3,14,10,10,4,0,5,15,33.3,10,16,5,11,11,25,15,1,"DF,FW",25-29,Defender,Brazil,South America
2747,William,BRA,Schalke 04,Bundesliga,2020,25.0,1995.0,5.3,14,10,10,4,0,5,15,33.3,10,16,5,11,11,25,15,1,"DF,FW",25-29,Defender,Brazil,South America
2747,William,BRA,Schalke 04,Bundesliga,2020,25.0,1995.0,5.3,14,10,10,4,0,5,15,33.3,10,16,5,11,11,25,15,1,"DF,FW",25-29,Defender,Brazil,South America
2747,William,BRA,Schalke 04,Bundesliga,2020,25.0,1995.0,5.3,14,10,10,4,0,5,15,33.3,10,16,5,11,11,25,15,1,"DF,FW",25-29,Defender,Brazil,South America
2747,William,BRA,Schalke 04,Bundesliga,2020,25.0,1995.0,5.3,14,10,10,4,0,5,15,33.3,10,16,5,11,11,25,15,1,"DF,FW",25-29,Defender,Brazil,South America
2747,William,BRA,Schalke 04,Bundesliga,2020,25.0,1995.0,5.3,14,10,10,4,0,5,15,33.3,10,16,5,11,11,25,15,1,"DF,FW",25-29,Defender,Brazil,South America
2747,William,BRA,Schalke 04,Bundesliga,2020,25.0,1995.0,5.3,14,10,10,4,0,5,15,33.3,10,16,5,11,11,25,15,1,"DF,FW",25-29,Defender,Brazil,South America
2747,William,BRA,Schalke 04,Bundesliga,2020,25.0,1995.0,5.3,14,10,10,4,0,5,15,33.3,10,16,5,11,11,25,15,1,"DF,FW",25-29,Defender,Brazil,South America
2747,William,BRA,Schalke 04,Bundesliga,2020,25.0,1995.0,5.3,14,10,10,4,0,5,15,33.3,10,16,5,11,11,25,15,1,"DF,FW",25-29,Defender,Brazil,South America
2747,William,BRA,Schalke 04,Bundesliga,2020,25.0,1995.0,5.3,14,10,10,4,0,5,15,33.3,10,16,5,11,11,25,15,1,"DF,FW",25-29,Defender,Brazil,South America
2747,William,BRA,Schalke 04,Bundesliga,2020,25.0,1995.0,5.3,14,10,10,4,0,5,15,33.3,10,16,5,11,11,25,15,1,"DF,FW",25-29,Defender,Brazil,South America
2747,William,BRA,Schalke 04,Bundesliga,2020,25.0,1995.0,5.3,14,10,10,4,0,5,15,33.3,10,16,5,11,11,25,15,1,"DF,FW",25-29,Defender,Brazil,South America
2747,William,BRA,Schalke 04,Bundesliga,2020,25.0,1995.0,5.3,14,10,10,4,0,5,15,33.3,10,16,5,11,11,25,15,1,"DF,FW",25-29,Defender,Brazil,South America
2747,William,BRA,Schalke 04,Bundesliga,2020,25.0,1995.0,5.3,14,10,10,4,0,5,15,33.3,10,16,5,11,11,25,15,1,"DF,FW",25-29,Defender,Brazil,South America
2747,William,BRA,Schalke 04,Bundesliga,2020,25.0,1995.0,5.3,14,10,10,4,0,5,15,33.3,10,16,5,11,11,25,15,1,"DF,FW",25-29,Defender,Brazil,South America
2747,William,BRA,Schalke 04,Bundesliga,2020,25.0,1995.0,5.3,14,10,10,4,0,5,15,33.3,10,16,5,11,11,25,15,1,"DF,FW",25-29,Defender,Brazil,South America
2748,Brandon Williams,ENG,Manchester Utd,Premier League,2020,19.0,2000.0,2.1,0,0,0,0,0,0,1,0.0,1,1,0,1,1,1,7,0,DF,Under 20,Defender,England,Europe
2749,Iñaki Williams,GHA,Athletic Club,La Liga,2020,26.0,1994.0,26.5,11,7,0,4,7,2,14,14.3,12,13,1,12,5,16,22,0,FW,25-29,Forward,Ghana,Africa
2750,Neco Williams,WAL,Liverpool,Premier League,2020,19.0,2001.0,2.8,6,5,4,2,0,5,9,55.6,4,3,1,2,6,12,6,0,DF,Under 20,Defender,Wales,Europe
2752,Rhys Williams,ENG,Liverpool,Premier League,2020,19.0,2001.0,7.3,6,4,3,3,0,3,3,100.0,0,4,3,1,6,12,27,1,DF,Under 20,Defender,England,Europe
2753,Willian,BRA,Arsenal,Premier League,2020,31.0,1988.0,15.6,13,7,6,6,1,6,16,37.5,10,13,0,13,8,21,8,0,FW,30-34,Forward,Brazil,South America
2753,Willian,BRA,Arsenal,Premier League,2020,31.0,1988.0,15.6,13,7,6,6,1,6,16,37.5,10,13,0,13,8,21,8,0,FW,30-34,Forward,Brazil,South America
2753,Willian,BRA,Arsenal,Premier League,2020,31.0,1988.0,15.6,13,7,6,6,1,6,16,37.5,10,13,0,13,8,21,8,0,FW,30-34,Forward,Brazil,South America
2753,Willian,BRA,Arsenal,Premier League,2020,31.0,1988.0,15.6,13,7,6,6,1,6,16,37.5,10,13,0,13,8,21,8,0,FW,30-34,Forward,Brazil,South America
2754,Joe Willock,ENG,Arsenal,Premier League,2020,20.0,1999.0,2.6,6,3,1,4,1,3,7,42.9,4,6,1,5,3,9,0,0,MF,20-24,Midfielder,England,Europe
2755,Joe Willock,ENG,Newcastle Utd,Premier League,2020,20.0,1999.0,10.9,26,13,16,7,3,9,42,21.4,33,21,3,18,17,43,15,1,MF,20-24,Midfielder,England,Europe
2756,Callum Wilson,ENG,Newcastle Utd,Premier League,2020,28.0,1992.0,23.2,12,5,1,6,5,2,12,16.7,10,10,3,7,7,19,14,0,FW,25-29,Forward,England,Europe
2756,Callum Wilson,ENG,Newcastle Utd,Premier League,2020,28.0,1992.0,23.2,12,5,1,6,5,2,12,16.7,10,10,3,7,7,19,14,0,FW,25-29,Forward,England,Europe
2756,Callum Wilson,ENG,Newcastle Utd,Premier League,2020,28.0,1992.0,23.2,12,5,1,6,5,2,12,16.7,10,10,3,7,7,19,14,0,FW,25-29,Forward,England,Europe
2756,Callum Wilson,ENG,Newcastle Utd,Premier League,2020,28.0,1992.0,23.2,12,5,1,6,5,2,12,16.7,10,10,3,7,7,19,14,0,FW,25-29,Forward,England,Europe
2757,Marten Winkler,GER,Hertha BSC,Bundesliga,2020,17.0,2002.0,0.0,0,0,0,0,0,0,0,,0,0,0,0,0,0,0,0,FW,Under 20,Forward,Germany,Europe
2758,Harry Winks,ENG,Tottenham,Premier League,2020,24.0,1996.0,9.6,16,9,11,5,0,5,20,25.0,15,16,4,12,11,27,12,1,MF,20-24,Midfielder,England,Europe
2759,Florian Wirtz,GER,Leverkusen,Bundesliga,2020,17.0,2003.0,24.7,35,18,8,22,5,11,37,29.7,26,27,1,26,9,44,8,0,MF,Under 20,Midfielder,Germany,Europe
2760,Yoane Wissa,COD,Lorient,Ligue 1,2020,23.0,1996.0,29.7,35,20,12,14,9,11,34,32.4,23,25,3,22,20,55,14,0,"MF,FW",20-24,Midfielder,DR Congo,Africa
2761,Axel Witsel,BEL,Dortmund,Bundesliga,2020,31.0,1989.0,12.6,18,12,6,11,1,8,16,50.0,8,13,3,10,22,40,13,0,MF,30-34,Midfielder,Belgium,Europe
2762,Hannes Wolf,AUT,Gladbach,Bundesliga,2020,21.0,1999.0,15.3,26,13,8,10,8,8,36,22.2,28,18,1,17,9,35,4,0,"MF,FW",20-24,Midfielder,Austria,Europe
2763,Marius Wolf,GER,Köln,Bundesliga,2020,25.0,1995.0,28.3,35,19,19,13,3,13,38,34.2,25,29,3,26,28,63,47,1,"MF,DF",25-29,Midfielder,Germany,Europe
2764,Nick Woltemade,GER,Werder Bremen,Bundesliga,2020,18.0,2002.0,1.6,3,2,1,1,1,2,4,50.0,2,1,0,1,0,3,0,0,"MF,FW",Under 20,Midfielder,Germany,Europe
2765,Jeong Woo-yeong,KOR,Freiburg,Bundesliga,2020,20.0,1999.0,9.1,9,5,1,6,2,2,11,18.2,9,8,1,7,11,20,11,0,"FW,MF",20-24,Forward,South Korea,Asia
2766,Chris Wood,NZL,Burnley,Premier League,2020,28.0,1991.0,30.5,12,7,2,4,6,5,18,27.8,13,14,3,11,1,13,21,0,FW,25-29,Forward,New Zealand,Oceania
2767,Joscha Wosz,GER,RB Leipzig,Bundesliga,2020,18.0,2002.0,0.4,1,1,1,0,0,0,0,,0,1,0,1,1,2,0,0,DF,Under 20,Defender,Germany,Europe
2768,Xeka,POR,Lille,Ligue 1,2020,25.0,1994.0,13.3,33,17,14,15,4,16,43,37.2,27,14,2,12,20,53,18,0,MF,25-29,Midfielder,Portugal,Europe
2769,Granit Xhaka,SUI,Arsenal,Premier League,2020,27.0,1992.0,28.0,50,26,18,17,15,30,58,51.7,28,23,7,16,24,74,38,3,"MF,DF",25-29,Midfielder,Switzerland,Europe
2770,Reinhold Yabo,GER,Arminia,Bundesliga,2020,28.0,1992.0,7.2,5,2,2,2,1,2,9,22.2,7,6,1,5,4,9,1,0,"MF,FW",25-29,Midfielder,Germany,Europe
2771,Jawad El Yamiq,MAR,Valladolid,La Liga,2020,28.0,1992.0,15.3,21,14,14,7,0,8,11,72.7,3,15,10,5,46,67,100,0,DF,25-29,Defender,Morocco,Africa
2773,Andriy Yarmolenko,UKR,West Ham,Premier League,2020,30.0,1989.0,4.2,5,4,2,2,1,2,8,25.0,6,1,0,1,1,6,2,0,"FW,MF",30-34,Forward,Ukraine,Europe
2774,Yusuf Yazıcı,TUR,Lille,Ligue 1,2020,23.0,1997.0,12.1,12,5,6,2,4,1,24,4.2,23,5,1,4,2,14,2,0,"FW,MF",20-24,Forward,Turkey,Asia
2775,DeAndre Yedlin,USA,Newcastle Utd,Premier League,2020,27.0,1993.0,4.8,9,4,8,1,0,4,10,40.0,6,5,1,4,7,16,17,0,DF,25-29,Defender,United States,North America
2776,Burak Yılmaz,TUR,Lille,Ligue 1,2020,35.0,1985.0,22.8,13,6,3,7,3,4,30,13.3,26,7,0,7,5,18,22,0,FW,35-39,Forward,Turkey,Asia
2778,Okay Yokuşlu,TUR,West Brom,Premier League,2020,26.0,1994.0,14.6,38,25,21,13,4,17,35,48.6,18,15,3,12,35,73,33,1,MF,25-29,Midfielder,Turkey,Asia
2779,Okay Yokuşlu,TUR,Celta Vigo,La Liga,2020,26.0,1994.0,5.1,14,8,8,4,2,5,9,55.6,4,5,2,3,10,24,9,0,MF,25-29,Midfielder,Turkey,Asia
2780,Maya Yoshida,JPN,Sampdoria,Serie A,2020,31.0,1988.0,25.3,17,4,10,7,0,7,13,53.8,6,45,34,11,57,74,93,1,DF,30-34,Defender,Japan,Asia
2781,Amin Younes,GER,Eint Frankfurt,Bundesliga,2020,26.0,1993.0,15.5,25,14,8,10,7,6,32,18.8,26,19,1,18,13,38,4,0,MF,25-29,Midfielder,Germany,Europe
2782,Ashley Young,ENG,Inter,Serie A,2020,35.0,1985.0,15.8,15,7,8,4,3,3,13,23.1,10,13,0,13,6,21,31,0,DF,35-39,Defender,England,Europe
2783,Wilitty Younoussa,CMR,Dijon,Ligue 1,2020,18.0,2001.0,0.9,6,3,3,3,0,3,7,42.9,4,3,0,3,2,8,0,0,MF,Under 20,Midfielder,Cameroon,Africa
2785,Mattia Zaccagni,ITA,Hellas Verona,Serie A,2020,25.0,1995.0,29.0,27,13,8,11,8,8,25,32.0,17,28,4,24,27,54,13,1,MF,25-29,Midfielder,Italy,Europe
2786,Dan-Axel Zagadou,FRA,Dortmund,Bundesliga,2020,21.0,1999.0,3.1,2,2,2,0,0,0,0,,0,3,2,1,6,8,13,0,DF,20-24,Defender,France,Europe
2787,Vasilios Zagaritis,GRE,Parma,Serie A,2020,19.0,2001.0,0.7,0,0,0,0,0,0,0,,0,1,0,1,0,0,0,0,DF,Under 20,Defender,Greece,Europe
2788,Arthur Zagre,FRA,Dijon,Ligue 1,2020,18.0,2001.0,1.4,3,1,2,1,0,2,2,100.0,0,1,1,0,3,6,1,0,"DF,MF",Under 20,Defender,France,Europe
2789,Wilfried Zaha,CIV,Crystal Palace,Premier League,2020,27.0,1992.0,29.0,26,18,8,15,3,11,30,36.7,19,21,0,21,9,35,4,0,FW,25-29,Forward,Ivory Coast,Africa
2791,Denis Zakaria,SUI,Gladbach,Bundesliga,2020,23.0,1996.0,15.8,30,15,12,15,3,11,20,55.0,9,20,7,13,23,53,29,1,"MF,DF",20-24,Midfielder,Switzerland,Europe
2794,Andre-Frank Zambo Anguissa,CMR,Fulham,Premier League,2020,24.0,1995.0,28.7,78,37,27,38,13,27,68,39.7,41,35,6,29,56,134,17,2,MF,20-24,Midfielder,Cameroon,Africa
2795,Niccolò Zanellato,ITA,Crotone,Serie A,2020,22.0,1998.0,18.2,24,14,16,6,2,13,36,36.1,23,19,5,14,16,40,12,2,MF,20-24,Midfielder,Italy,Europe
2796,Cristián Zapata,COL,Genoa,Serie A,2020,33.0,1986.0,10.8,18,12,11,7,0,10,14,71.4,4,15,11,4,15,33,56,0,DF,30-34,Defender,Colombia,South America
2797,Duván Zapata,COL,Atalanta,Serie A,2020,29.0,1991.0,26.4,12,5,2,3,7,4,13,30.8,9,19,5,14,6,18,19,0,FW,25-29,Forward,Colombia,South America
2798,Gabriele Zappa,ITA,Cagliari,Serie A,2020,20.0,1999.0,26.6,34,17,16,15,3,22,49,44.9,27,36,4,32,24,58,50,0,DF,20-24,Defender,Italy,Europe
2799,Davide Zappacosta,ITA,Genoa,Serie A,2020,28.0,1992.0,22.7,33,16,15,13,5,15,30,50.0,15,17,1,16,18,51,41,0,DF,25-29,Defender,Italy,Europe
2801,Simone Zaza,ITA,Torino,Serie A,2020,29.0,1991.0,16.6,15,9,4,6,5,6,20,30.0,14,14,0,14,3,18,5,1,FW,25-29,Forward,Italy,Europe
2802,Deyovaisio Zeefuik,NED,Hertha BSC,Bundesliga,2020,22.0,1998.0,10.1,13,9,8,3,2,8,19,42.1,11,15,3,12,12,25,36,0,"DF,FW",20-24,Defender,Netherlands,Europe
2803,Marvin Zeegelaar,NED,Udinese,Serie A,2020,29.0,1990.0,19.3,40,18,23,16,1,20,39,51.3,19,21,9,12,24,64,43,0,DF,25-29,Defender,Netherlands,Europe
2805,Robin Zentner,GER,Mainz 05,Bundesliga,2020,25.0,1994.0,31.0,1,1,1,0,0,1,3,33.3,2,0,0,0,3,4,9,2,GK,25-29,Goalkeeper,Germany,Europe
2806,Andi Zeqiri,SUI,Brighton,Premier League,2020,21.0,1999.0,1.9,3,2,0,2,1,1,2,50.0,1,1,0,1,0,3,2,0,"FW,DF",20-24,Forward,Switzerland,Europe
2807,Mehdi Zerkane,ALG,Bordeaux,Ligue 1,2020,21.0,1999.0,13.2,23,15,7,10,6,5,18,27.8,13,15,2,13,9,32,5,0,"MF,FW",20-24,Midfielder,Algeria,Africa
2808,Ron-Robert Zieler,GER,Köln,Bundesliga,2020,31.0,1989.0,0.6,0,0,0,0,0,0,0,,0,0,0,0,0,0,0,0,GK,30-34,Goalkeeper,Germany,Europe
2810,Oleksandr Zinchenko,UKR,Manchester City,Premier League,2020,23.0,1996.0,16.4,25,15,12,9,4,14,24,58.3,10,17,4,13,23,48,28,0,DF,20-24,Defender,Ukraine,Europe
2811,Joshua Zirkzee,NED,Parma,Serie A,2020,19.0,2001.0,1.3,2,2,1,1,0,1,3,33.3,2,1,1,0,0,2,1,0,"FW,MF",Under 20,Forward,Netherlands,Europe
2812,Joshua Zirkzee,NED,Bayern Munich,Bundesliga,2020,19.0,2001.0,1.0,1,0,0,1,0,1,2,50.0,1,0,0,0,0,1,0,0,FW,Under 20,Forward,Netherlands,Europe
2813,Hakim Ziyech,MAR,Chelsea,Premier League,2020,27.0,1993.0,13.0,14,10,5,7,2,5,19,26.3,14,9,1,8,10,24,2,0,"MF,FW",25-29,Midfielder,Morocco,Africa
2814,Jeroen Zoet,NED,Spezia,Serie A,2020,29.0,1991.0,6.7,0,0,0,0,0,0,1,0.0,1,0,0,0,0,0,4,2,GK,25-29,Goalkeeper,Netherlands,Europe
2815,Kévin Zohi,MLI,Strasbourg,Ligue 1,2020,23.0,1996.0,4.8,9,5,3,4,2,2,6,33.3,4,6,0,6,6,15,3,0,"FW,MF",20-24,Forward,Mali,Africa
2816,Kurt Zouma,FRA,Chelsea,Premier League,2020,25.0,1994.0,22.5,16,10,8,6,2,4,8,50.0,4,13,9,4,28,44,93,0,DF,25-29,Defender,France,Europe
2818,Steven Zuber,SUI,Eint Frankfurt,Bundesliga,2020,28.0,1991.0,6.5,24,12,8,13,3,8,16,50.0,8,4,1,3,4,28,1,0,"DF,MF",25-29,Defender,Switzerland,Europe
2051,Ayoze Pérez,ESP,Leicester City,Premier League,2020,27.0,1993.0,14.8,32,15,6,20,6,13,48,27.1,35,28,0,28,10,42,7,0,"MF,FW",25-29,Midfielder,Spain,Europe
2052,Carles Pérez,ESP,Roma,Serie A,2020,22.0,1998.0,8.6,9,4,3,6,0,6,31,19.4,25,9,0,9,6,15,1,0,"MF,FW",20-24,Midfielder,Spain,Europe
2053,Iñigo Pérez,ESP,Osasuna,La Liga,2020,32.0,1988.0,15.0,20,10,9,6,5,10,16,62.5,6,12,0,12,15,35,8,1,"MF,DF",30-34,Midfielder,Spain,Europe
2054,Juan Pérez,ESP,Osasuna,La Liga,2020,24.0,1996.0,3.0,0,0,0,0,0,0,0,,0,0,0,0,0,0,1,0,GK,20-24,Goalkeeper,Spain,Europe
2055,Kike Pérez,ESP,Valladolid,La Liga,2020,23.0,1997.0,12.9,26,19,8,14,4,7,33,21.2,26,10,1,9,17,43,18,0,MF,20-24,Midfielder,Spain,Europe
2056,Lucas Pérez,ESP,Alavés,La Liga,2020,31.0,1988.0,19.5,6,2,3,3,0,2,10,20.0,8,6,1,5,2,8,5,0,FW,30-34,Forward,Spain,Europe
2057,Luis Pérez,ESP,Valladolid,La Liga,2020,25.0,1995.0,14.4,33,17,16,17,0,18,30,60.0,12,26,8,18,14,47,54,1,DF,25-29,Defender,Spain,Europe
2070,Jens Petter Hauge,NOR,Milan,Serie A,2020,20.0,1999.0,5.9,7,4,3,3,1,6,10,60.0,4,4,0,4,1,8,3,0,FW,20-24,Forward,Norway,Europe
2081,Krzysztof Piątek,POL,Hertha BSC,Bundesliga,2020,25.0,1995.0,18.1,9,4,1,7,1,3,22,13.6,19,11,0,11,6,15,14,0,FW,25-29,Forward,Poland,Europe
2091,Tomás Pina Isla,ESP,Alavés,La Liga,2020,32.0,1987.0,28.6,39,18,18,16,5,16,42,38.1,26,28,8,20,37,76,42,0,MF,30-34,Midfielder,Spain,Europe
2093,Yeremi Pino,ESP,Villarreal,La Liga,2020,17.0,2002.0,8.9,19,11,10,7,2,8,28,28.6,20,20,1,19,9,28,8,0,"FW,MF",Under 20,Forward,Spain,Europe
2095,Gerard Piqué,ESP,Barcelona,La Liga,2020,33.0,1987.0,16.5,16,11,11,5,0,9,12,75.0,3,9,4,5,26,42,46,0,DF,30-34,Defender,Spain,Europe
2097,Łukasz Piszczek,POL,Dortmund,Bundesliga,2020,35.0,1985.0,5.1,10,7,6,4,0,5,12,41.7,7,5,1,4,5,15,12,0,DF,35-39,Defender,Poland,Europe
2100,Óscar Plano,ESP,Valladolid,La Liga,2020,29.0,1991.0,28.0,42,24,24,12,6,14,46,30.4,32,35,6,29,34,76,43,0,"MF,FW",25-29,Midfielder,Spain,Europe
2103,Dani Plomer,ESP,Granada,La Liga,2020,21.0,1998.0,0.5,0,0,0,0,0,0,1,0.0,1,0,0,0,0,0,1,0,FW,20-24,Forward,Spain,Europe
2111,Jorge Pombo,ESP,Cádiz,La Liga,2020,26.0,1994.0,5.8,7,3,3,2,2,1,8,12.5,7,2,0,2,2,9,3,0,"FW,MF",25-29,Forward,Spain,Europe
2113,Pere Pons,ESP,Alavés,La Liga,2020,27.0,1993.0,13.2,20,10,8,8,4,5,16,31.3,11,15,2,13,7,27,10,0,MF,25-29,Midfielder,Spain,Europe
2117,Francisco Portillo,ESP,Getafe,La Liga,2020,30.0,1990.0,4.6,5,3,1,4,0,2,14,14.3,12,3,0,3,5,10,1,0,"MF,FW",30-34,Midfielder,Spain,Europe
2118,Portu,ESP,Real Sociedad,La Liga,2020,28.0,1992.0,24.3,18,8,4,10,4,7,36,19.4,29,24,2,22,8,26,5,0,"FW,MF",25-29,Forward,Spain,Europe
2120,Sergio Postigo,ESP,Levante,La Liga,2020,31.0,1988.0,18.0,16,12,12,3,1,7,18,38.9,11,21,10,11,33,49,84,1,DF,30-34,Defender,Spain,Europe
2123,Darío Poveda,ESP,Getafe,La Liga,2020,23.0,1997.0,0.1,0,0,0,0,0,0,0,,0,1,0,1,0,0,0,0,FW,20-24,Forward,Spain,Europe
2125,Alejandro Pozo Pozo,ESP,Eibar,La Liga,2020,21.0,1999.0,24.3,38,22,17,15,6,17,38,44.7,21,35,2,33,27,65,40,1,"DF,MF",20-24,Defender,Spain,Europe
2133,Antonio Puertas,ESP,Granada,La Liga,2020,28.0,1992.0,24.1,27,13,9,12,6,10,32,31.3,22,24,5,19,12,39,25,0,"FW,MF",25-29,Forward,Spain,Europe
2134,Riqui Puig,ESP,Barcelona,La Liga,2020,20.0,1999.0,3.2,5,3,1,3,1,4,8,50.0,4,0,0,0,1,6,0,0,"MF,FW",20-24,Midfielder,Spain,Europe
2136,Jorge Pulido,ESP,Huesca,La Liga,2020,29.0,1991.0,32.1,39,24,31,8,0,17,29,58.6,12,32,18,14,52,91,98,0,DF,25-29,Defender,Spain,Europe
2142,Quini,ESP,Granada,La Liga,2020,30.0,1989.0,13.2,33,22,23,7,3,19,36,52.8,17,15,6,9,15,48,39,0,DF,30-34,Defender,Spain,Europe
2143,Quique,ESP,Eibar,La Liga,2020,30.0,1990.0,1.9,0,0,0,0,0,0,1,0.0,1,2,0,2,0,0,0,0,"FW,MF",30-34,Forward,Spain,Europe
2144,Dani Raba,ESP,Villarreal,La Liga,2020,24.0,1995.0,1.7,2,1,0,1,1,2,8,25.0,6,1,0,1,0,2,0,0,"MF,FW",20-24,Midfielder,Spain,Europe
2147,Uroš Račić,SRB,Valencia,La Liga,2020,22.0,1998.0,24.3,38,22,16,16,6,16,54,29.6,38,33,11,22,26,64,54,0,MF,20-24,Midfielder,Serbia,Europe
2149,Nemanja Radoja,SRB,Levante,La Liga,2020,27.0,1993.0,12.5,23,15,12,10,1,5,19,26.3,14,9,3,6,19,42,12,1,MF,25-29,Midfielder,Serbia,Europe
2150,Nemanja Radonjić,SRB,Marseille,Ligue 1,2020,24.0,1996.0,4.4,6,5,1,2,3,2,12,16.7,10,8,0,8,3,9,1,0,FW,20-24,Forward,Serbia,Europe
2151,Nemanja Radonjić,SRB,Hertha BSC,Bundesliga,2020,24.0,1996.0,6.8,5,3,2,2,1,1,5,20.0,4,1,0,1,2,7,1,0,"FW,MF",20-24,Forward,Serbia,Europe
2152,Aleksandar Radovanović,SRB,Lens,Ligue 1,2020,26.0,1993.0,1.0,1,1,0,1,0,0,0,,0,2,1,1,0,1,2,0,DF,25-29,Defender,Serbia,Europe
2153,Ivan Radovanović,SRB,Genoa,Serie A,2020,31.0,1988.0,24.8,18,15,13,5,0,12,31,38.7,19,39,21,18,37,55,114,2,"DF,MF",30-34,Defender,Serbia,Europe
2159,Predrag Rajković,SRB,Reims,Ligue 1,2020,24.0,1995.0,36.5,2,1,2,0,0,2,5,40.0,3,1,0,1,2,4,17,3,GK,20-24,Goalkeeper,Serbia,Europe
2161,Jonás Ramalho,ESP,Osasuna,La Liga,2020,27.0,1993.0,3.4,5,4,4,0,1,1,3,33.3,2,3,0,3,2,7,7,0,DF,25-29,Defender,Spain,Europe
2164,Sandro Ramírez,ESP,Huesca,La Liga,2020,25.0,1995.0,14.3,13,9,3,8,2,4,11,36.4,7,11,1,10,10,23,2,0,FW,25-29,Forward,Spain,Europe
2165,Sergio Ramos,ESP,Real Madrid,La Liga,2020,34.0,1986.0,14.2,15,12,8,6,1,6,10,60.0,4,9,5,4,19,34,39,1,DF,30-34,Defender,Spain,Europe
2180,Arkadiusz Reca,POL,Crotone,Serie A,2020,25.0,1995.0,25.7,34,16,15,11,8,10,45,22.2,35,30,3,27,50,84,64,0,DF,25-29,Defender,Poland,Europe
2181,Recio,ESP,Eibar,La Liga,2020,29.0,1991.0,8.2,17,5,4,8,5,8,18,44.4,10,6,0,6,4,21,1,0,MF,25-29,Midfielder,Spain,Europe
2186,Sergio Reguilón,ESP,Tottenham,Premier League,2020,23.0,1996.0,24.9,47,25,30,13,4,23,48,47.9,25,39,7,32,32,79,50,1,DF,20-24,Defender,Spain,Europe
2188,Pepe Reina,ESP,Lazio,Serie A,2020,37.0,1982.0,29.0,0,0,0,0,0,0,1,0.0,1,0,0,0,1,1,6,0,GK,35-39,Goalkeeper,Spain,Europe
2195,Álex Remiro,ESP,Real Sociedad,La Liga,2020,25.0,1995.0,38.0,0,0,0,0,0,0,1,0.0,1,0,0,0,3,3,14,0,GK,25-29,Goalkeeper,Spain,Europe
2199,Oriol Rey,ESP,Valladolid,La Liga,2020,22.0,1998.0,0.2,0,0,0,0,0,0,0,,0,0,0,0,1,1,0,0,MF,20-24,Midfielder,Spain,Europe
2213,Mikel Rico,ESP,Huesca,La Liga,2020,35.0,1984.0,24.3,24,12,14,8,2,11,34,32.4,23,20,3,17,23,47,22,0,MF,35-39,Midfielder,Spain,Europe
2214,Sergio Rico,ESP,Paris S-G,Ligue 1,2020,26.0,1993.0,9.0,0,0,0,0,0,0,0,,0,0,0,0,0,0,1,0,GK,25-29,Goalkeeper,Spain,Europe
2218,Luis Rioja,ESP,Alavés,La Liga,2020,26.0,1993.0,23.2,21,14,11,7,3,7,39,17.9,32,23,1,22,20,41,30,0,"MF,FW",25-29,Midfielder,Spain,Europe
2221,Mihailo Ristić,SRB,Montpellier,Ligue 1,2020,24.0,1995.0,24.8,45,22,25,13,7,28,44,63.6,16,30,9,21,26,71,57,0,DF,20-24,Defender,Serbia,Europe
2225,Rober,ESP,Levante,La Liga,2020,25.0,1995.0,15.8,14,7,8,3,3,8,18,44.4,10,24,16,8,35,49,52,1,"DF,MF",25-29,Defender,Spain,Europe
2226,Roberto,ESP,Valladolid,La Liga,2020,34.0,1986.0,13.0,0,0,0,0,0,0,1,0.0,1,0,0,0,0,0,7,0,GK,30-34,Goalkeeper,Spain,Europe
2226,Roberto,ESP,Valladolid,La Liga,2020,34.0,1986.0,13.0,0,0,0,0,0,0,1,0.0,1,0,0,0,0,0,7,0,GK,30-34,Goalkeeper,Spain,Europe
2226,Roberto,ESP,Valladolid,La Liga,2020,34.0,1986.0,13.0,0,0,0,0,0,0,1,0.0,1,0,0,0,0,0,7,0,GK,30-34,Goalkeeper,Spain,Europe
2226,Roberto,ESP,Valladolid,La Liga,2020,34.0,1986.0,13.0,0,0,0,0,0,0,1,0.0,1,0,0,0,0,0,7,0,GK,30-34,Goalkeeper,Spain,Europe
2227,Sergi Roberto,ESP,Barcelona,La Liga,2020,28.0,1992.0,10.5,9,6,5,2,2,7,13,53.8,6,12,6,6,10,19,20,0,"DF,FW",25-29,Defender,Spain,Europe
2233,Joel Robles,ESP,Betis,La Liga,2020,30.0,1990.0,18.0,0,0,0,0,0,0,1,0.0,1,1,0,1,0,0,11,2,GK,30-34,Goalkeeper,Spain,Europe
2235,Marc Roca,ESP,Bayern Munich,Bundesliga,2020,23.0,1996.0,2.0,2,2,0,0,2,0,4,0.0,4,4,1,3,2,4,1,0,MF,20-24,Midfielder,Spain,Europe
2237,Rubén Rochina,ESP,Levante,La Liga,2020,29.0,1991.0,15.6,38,28,12,23,3,12,35,34.3,23,22,2,20,22,60,7,0,MF,25-29,Midfielder,Spain,Europe
2241,Rodri,ESP,Manchester City,Premier League,2020,24.0,1996.0,30.5,72,40,24,40,8,33,66,50.0,33,23,9,14,36,108,54,3,MF,20-24,Midfielder,Spain,Europe
2241,Rodri,ESP,Manchester City,Premier League,2020,24.0,1996.0,30.5,72,40,24,40,8,33,66,50.0,33,23,9,14,36,108,54,3,MF,20-24,Midfielder,Spain,Europe
2241,Rodri,ESP,Manchester City,Premier League,2020,24.0,1996.0,30.5,72,40,24,40,8,33,66,50.0,33,23,9,14,36,108,54,3,MF,20-24,Midfielder,Spain,Europe
2241,Rodri,ESP,Manchester City,Premier League,2020,24.0,1996.0,30.5,72,40,24,40,8,33,66,50.0,33,23,9,14,36,108,54,3,MF,20-24,Midfielder,Spain,Europe
2242,Rodri,ESP,Betis,La Liga,2020,20.0,2000.0,6.0,3,3,1,2,0,1,6,16.7,5,7,0,7,2,5,0,0,"FW,MF",20-24,Forward,Spain,Europe
2242,Rodri,ESP,Betis,La Liga,2020,20.0,2000.0,6.0,3,3,1,2,0,1,6,16.7,5,7,0,7,2,5,0,0,"FW,MF",20-24,Forward,Spain,Europe
2242,Rodri,ESP,Betis,La Liga,2020,20.0,2000.0,6.0,3,3,1,2,0,1,6,16.7,5,7,0,7,2,5,0,0,"FW,MF",20-24,Forward,Spain,Europe
2242,Rodri,ESP,Betis,La Liga,2020,20.0,2000.0,6.0,3,3,1,2,0,1,6,16.7,5,7,0,7,2,5,0,0,"FW,MF",20-24,Forward,Spain,Europe
2243,Rodrigo,ESP,Leeds United,Premier League,2020,29.0,1991.0,14.3,14,7,8,3,3,4,22,18.2,18,7,0,7,5,19,16,0,"MF,FW",25-29,Midfielder,Spain,Europe
2245,Ángel Rodríguez,ESP,Getafe,La Liga,2020,33.0,1987.0,15.3,7,4,1,4,2,1,16,6.3,15,7,0,7,2,9,8,0,"FW,MF",30-34,Forward,Spain,Europe
2246,Óscar Rodríguez Arnaiz,ESP,Sevilla,La Liga,2020,22.0,1998.0,5.7,15,9,3,8,4,6,13,46.2,7,2,0,2,10,25,1,0,"MF,FW",20-24,Midfielder,Spain,Europe
2250,Miguel Rodríguez,ESP,Celta Vigo,La Liga,2020,17.0,2003.0,0.3,1,1,0,1,0,0,0,,0,0,0,0,0,1,0,0,"FW,DF",Under 20,Forward,Spain,Europe
2252,Víctor Rodríguez,ESP,Elche,La Liga,2020,31.0,1989.0,4.7,4,3,3,1,0,0,9,0.0,9,5,1,4,5,9,4,0,MF,30-34,Midfielder,Spain,Europe
2259,Oriol Romeu,ESP,Southampton,Premier League,2020,28.0,1991.0,19.6,69,35,25,39,5,26,68,38.2,42,28,7,21,30,99,18,0,MF,25-29,Midfielder,Spain,Europe
2268,Rubén,ESP,Osasuna,La Liga,2020,36.0,1984.0,2.1,0,0,0,0,0,0,0,,0,0,0,0,0,0,1,0,GK,35-39,Goalkeeper,Spain,Europe
2269,Waldo Rubio,ESP,Valladolid,La Liga,2020,24.0,1995.0,4.2,6,4,2,2,2,1,14,7.1,13,6,0,6,3,9,3,0,"FW,MF",20-24,Forward,Spain,Europe
2279,Aitor Ruibal,ESP,Betis,La Liga,2020,24.0,1996.0,17.7,32,18,14,14,4,10,35,28.6,25,26,0,26,11,43,8,0,"FW,MF",20-24,Forward,Spain,Europe
2280,Isma Ruiz,ESP,Granada,La Liga,2020,19.0,2001.0,0.7,1,0,0,1,0,0,1,0.0,1,0,0,0,0,1,3,0,MF,Under 20,Midfielder,Spain,Europe
2282,Fabián Ruiz Peña,ESP,Napoli,Serie A,2020,24.0,1996.0,28.5,58,31,26,21,11,25,70,35.7,45,33,3,30,36,94,32,1,MF,20-24,Midfielder,Spain,Europe
2283,Víctor Ruiz,ESP,Betis,La Liga,2020,31.0,1989.0,24.0,11,7,7,4,0,4,13,30.8,9,17,13,4,44,55,85,0,DF,30-34,Defender,Spain,Europe
2289,Julian Ryerson,NOR,Union Berlin,Bundesliga,2020,22.0,1997.0,11.9,22,15,4,14,4,12,15,80.0,3,13,0,13,11,33,17,0,"DF,MF",20-24,Defender,Norway,Europe
2300,Borja Sainz,ESP,Alavés,La Liga,2020,19.0,2001.0,5.0,7,3,3,2,2,4,16,25.0,12,4,0,4,6,13,1,0,"MF,FW",Under 20,Midfielder,Spain,Europe
2313,Salvi,ESP,Cádiz,La Liga,2020,29.0,1991.0,21.5,18,10,14,3,1,8,26,30.8,18,14,1,13,20,38,24,0,"MF,FW",25-29,Midfielder,Spain,Europe
2314,Lazar Samardzic,SRB,RB Leipzig,Bundesliga,2020,18.0,2002.0,2.2,10,7,4,6,0,5,13,38.5,8,6,0,6,2,12,1,0,MF,Under 20,Midfielder,Serbia,Europe
2319,Fede San Emeterio,ESP,Valladolid,La Liga,2020,23.0,1997.0,16.2,25,14,15,7,3,11,31,35.5,20,23,8,15,28,53,33,0,MF,20-24,Midfielder,Spain,Europe
2322,Oihan Sancet,ESP,Athletic Club,La Liga,2020,20.0,2000.0,11.5,8,2,3,4,1,2,7,28.6,5,4,0,4,5,13,7,0,"FW,MF",20-24,Forward,Spain,Europe
2324,Ricard Sánchez,ESP,Atlético Madrid,La Liga,2020,20.0,2000.0,0.3,1,1,0,0,1,0,0,,0,1,0,1,0,1,1,0,DF,20-24,Defender,Spain,Europe
2327,Germán Sánchez,ESP,Granada,La Liga,2020,33.0,1986.0,29.3,24,11,13,9,2,11,23,47.8,12,28,26,2,38,62,130,1,DF,30-34,Defender,Spain,Europe
2328,Javi Sánchez,ESP,Valladolid,La Liga,2020,23.0,1997.0,10.2,15,10,10,4,1,9,10,90.0,1,15,7,8,15,30,37,0,DF,20-24,Defender,Spain,Europe
2329,Manu Sánchez,ESP,Osasuna,La Liga,2020,19.0,2000.0,10.8,27,15,10,10,7,11,25,44.0,14,8,0,8,8,35,14,0,DF,Under 20,Defender,Spain,Europe
2330,Manu Sánchez,ESP,Atlético Madrid,La Liga,2020,19.0,2000.0,0.5,0,0,0,0,0,0,1,0.0,1,1,0,1,0,0,1,0,DF,Under 20,Defender,Spain,Europe
2332,Pepe Sánchez,ESP,Granada,La Liga,2020,20.0,2000.0,2.8,4,2,2,2,0,3,4,75.0,1,5,2,3,4,8,9,0,DF,20-24,Defender,Spain,Europe
2333,Robert Sánchez,ESP,Brighton,Premier League,2020,22.0,1997.0,27.0,1,0,1,0,0,1,1,100.0,0,1,0,1,1,2,11,2,GK,20-24,Goalkeeper,Spain,Europe
2338,Oier Sanjurjo,ESP,Osasuna,La Liga,2020,34.0,1986.0,23.2,39,16,8,27,4,17,60,28.3,43,24,6,18,29,68,41,0,MF,30-34,Midfielder,Spain,Europe
2351,Ivan Šaponjić,SRB,Cádiz,La Liga,2020,22.0,1997.0,4.3,1,0,0,1,0,0,2,0.0,2,2,0,2,1,2,4,0,FW,20-24,Forward,Serbia,Europe
2352,Pablo Sarabia,ESP,Paris S-G,Ligue 1,2020,28.0,1992.0,14.7,15,11,6,6,3,10,38,26.3,28,9,1,8,5,20,8,0,"FW,MF",25-29,Forward,Spain,Europe
2367,Patrik Schick,CZE,Leverkusen,Bundesliga,2020,24.0,1996.0,20.7,7,2,0,5,2,1,4,25.0,3,5,2,3,3,10,20,0,FW,20-24,Forward,Czech Republic,Europe
2392,Jaime Seoane,ESP,Huesca,La Liga,2020,23.0,1997.0,22.9,50,30,20,23,7,24,65,36.9,41,27,6,21,17,67,14,0,MF,20-24,Midfielder,Spain,Europe
2421,David Silva,ESP,Real Sociedad,La Liga,2020,34.0,1986.0,15.5,19,12,2,14,3,8,21,38.1,13,14,1,13,13,32,8,2,MF,30-34,Midfielder,Spain,Europe
2421,David Silva,ESP,Real Sociedad,La Liga,2020,34.0,1986.0,15.5,19,12,2,14,3,8,21,38.1,13,14,1,13,13,32,8,2,MF,30-34,Midfielder,Spain,Europe
2421,David Silva,ESP,Real Sociedad,La Liga,2020,34.0,1986.0,15.5,19,12,2,14,3,8,21,38.1,13,14,1,13,13,32,8,2,MF,30-34,Midfielder,Spain,Europe
2421,David Silva,ESP,Real Sociedad,La Liga,2020,34.0,1986.0,15.5,19,12,2,14,3,8,21,38.1,13,14,1,13,13,32,8,2,MF,30-34,Midfielder,Spain,Europe
2432,Unai Simón,ESP,Athletic Club,La Liga,2020,23.0,1997.0,37.0,1,0,1,0,0,1,2,50.0,1,0,0,0,0,1,7,7,GK,20-24,Goalkeeper,Spain,Europe
2444,Antonio Sivera,ESP,Alavés,La Liga,2020,23.0,1996.0,0.8,0,0,0,0,0,0,0,,0,0,0,0,0,0,0,0,GK,20-24,Goalkeeper,Spain,Europe
2447,Łukasz Skorupski,POL,Bologna,Serie A,2020,29.0,1991.0,28.0,1,1,1,0,0,1,4,25.0,3,0,0,0,0,1,23,5,GK,25-29,Goalkeeper,Poland,Europe
2452,Petar Škuletić,SRB,Montpellier,Ligue 1,2020,30.0,1990.0,2.6,3,2,1,2,0,0,5,0.0,5,4,2,2,0,3,4,0,"FW,MF",30-34,Forward,Serbia,Europe
2462,Rubén Sobrino,ESP,Valencia,La Liga,2020,28.0,1992.0,0.5,1,1,1,0,0,0,1,0.0,1,0,0,0,0,1,1,0,"MF,FW",25-29,Midfielder,Spain,Europe
2463,Rubén Sobrino,ESP,Cádiz,La Liga,2020,28.0,1992.0,12.4,29,13,8,16,5,8,18,44.4,10,19,0,19,15,44,11,0,"FW,MF",25-29,Forward,Spain,Europe
2466,Roberto Soldado,ESP,Granada,La Liga,2020,35.0,1985.0,16.0,7,4,1,4,2,2,11,18.2,9,8,0,8,4,11,13,1,FW,35-39,Forward,Spain,Europe
2467,Carlos Soler,ESP,Valencia,La Liga,2020,23.0,1997.0,30.4,41,24,14,24,3,19,52,36.5,33,35,11,24,23,64,41,0,MF,20-24,Midfielder,Spain,Europe
2469,Son,ESP,Levante,La Liga,2020,26.0,1994.0,12.3,18,10,11,6,1,9,19,47.4,10,11,2,9,12,30,20,0,"DF,MF",25-29,Defender,Spain,Europe
2471,David Soria,ESP,Getafe,La Liga,2020,27.0,1993.0,28.0,2,2,2,0,0,1,3,33.3,2,0,0,0,1,3,12,0,GK,25-29,Goalkeeper,Spain,Europe
2473,Alberto Soro,ESP,Granada,La Liga,2020,21.0,1999.0,4.4,7,2,2,4,1,4,10,40.0,6,7,0,7,1,8,2,0,"FW,MF",20-24,Forward,Spain,Europe
2475,Hugo Sotelo,ESP,Celta Vigo,La Liga,2020,16.0,2003.0,0.0,0,0,0,0,0,0,0,,0,0,0,0,0,0,0,0,MF,Under 20,Midfielder,Spain,Europe
2479,Tomáš Souček,CZE,West Ham,Premier League,2020,25.0,1995.0,38.0,78,41,37,36,5,28,77,36.4,49,43,18,25,62,140,107,0,MF,25-29,Midfielder,Czech Republic,Europe
2517,Denis Suárez,ESP,Celta Vigo,La Liga,2020,26.0,1994.0,31.7,64,32,22,30,12,21,94,22.3,73,30,2,28,22,86,15,2,MF,25-29,Midfielder,Spain,Europe
2519,Marek Suchý,CZE,Augsburg,Bundesliga,2020,32.0,1988.0,3.4,4,2,1,3,0,1,2,50.0,1,3,3,0,4,8,9,0,DF,30-34,Defender,Czech Republic,Europe
2521,Suso,ESP,Sevilla,La Liga,2020,26.0,1993.0,24.6,20,10,8,6,6,10,41,24.4,31,12,0,12,8,28,8,0,FW,25-29,Forward,Spain,Europe
2528,Wojciech Szczęsny,POL,Juventus,Serie A,2020,30.0,1990.0,29.7,0,0,0,0,0,0,0,,0,2,0,2,3,3,5,1,GK,30-34,Goalkeeper,Poland,Europe
2530,Alexander Sørloth,NOR,RB Leipzig,Bundesliga,2020,24.0,1995.0,16.0,7,5,0,5,2,2,14,14.3,12,13,2,11,3,10,13,0,FW,20-24,Forward,Norway,Europe
2531,Tachi,ESP,Alavés,La Liga,2020,22.0,1997.0,9.4,11,9,9,2,0,6,14,42.9,8,9,6,3,11,22,32,0,DF,20-24,Defender,Spain,Europe
2552,Álvaro Tejero,ESP,Eibar,La Liga,2020,24.0,1996.0,1.2,1,1,0,0,1,1,3,33.3,2,1,0,1,3,4,6,0,DF,20-24,Defender,Spain,Europe
2556,Cristian Tello,ESP,Betis,La Liga,2020,28.0,1991.0,14.3,16,10,5,9,2,4,22,18.2,18,14,0,14,11,27,8,0,"FW,MF",25-29,Forward,Spain,Europe
2574,Morten Thorsby,NOR,Sampdoria,Serie A,2020,24.0,1996.0,29.4,76,42,32,36,8,20,60,33.3,40,51,16,35,25,101,30,0,MF,20-24,Midfielder,Norway,Europe
2582,David Timor,ESP,Getafe,La Liga,2020,30.0,1989.0,15.5,13,9,5,6,2,9,21,42.9,12,5,1,4,19,32,32,1,"MF,DF",30-34,Midfielder,Spain,Europe
2594,Toño,ESP,Levante,La Liga,2020,30.0,1989.0,8.1,4,0,4,0,0,0,2,0.0,2,10,1,9,7,11,12,0,"DF,FW",30-34,Defender,Spain,Europe
2594,Toño,ESP,Levante,La Liga,2020,30.0,1989.0,8.1,4,0,4,0,0,0,2,0.0,2,10,1,9,7,11,12,0,"DF,FW",30-34,Defender,Spain,Europe
2594,Toño,ESP,Levante,La Liga,2020,30.0,1989.0,8.1,4,0,4,0,0,0,2,0.0,2,10,1,9,7,11,12,0,"DF,FW",30-34,Defender,Spain,Europe
2594,Toño,ESP,Levante,La Liga,2020,30.0,1989.0,8.1,4,0,4,0,0,0,2,0.0,2,10,1,9,7,11,12,0,"DF,FW",30-34,Defender,Spain,Europe
2599,Ferrán Torres,ESP,Manchester City,Premier League,2020,20.0,2000.0,14.5,12,5,4,6,2,5,16,31.3,11,16,0,16,3,15,8,0,"FW,MF",20-24,Forward,Spain,Europe
2600,Óliver Torres,ESP,Sevilla,La Liga,2020,25.0,1994.0,15.6,34,22,13,15,6,19,53,35.8,34,15,0,15,15,49,9,0,"MF,FW",25-29,Midfielder,Spain,Europe
2601,Pau Torres,ESP,Villarreal,La Liga,2020,23.0,1997.0,33.0,17,11,10,5,2,11,18,61.1,7,33,25,8,23,40,111,1,DF,20-24,Defender,Spain,Europe
2602,Roberto Torres,ESP,Osasuna,La Liga,2020,31.0,1989.0,21.0,15,8,6,5,4,8,29,27.6,21,12,0,12,16,31,13,0,"MF,FW",30-34,Midfielder,Spain,Europe
2603,Lucas Torró,ESP,Osasuna,La Liga,2020,26.0,1994.0,17.2,32,15,11,19,2,21,34,61.8,13,16,7,9,27,59,43,0,MF,25-29,Midfielder,Spain,Europe
2612,Adama Traoré,ESP,Wolves,Premier League,2020,24.0,1996.0,29.4,28,16,11,13,4,13,21,61.9,8,23,1,22,7,35,12,1,"FW,MF",20-24,Forward,Spain,Europe
2612,Adama Traoré,ESP,Wolves,Premier League,2020,24.0,1996.0,29.4,28,16,11,13,4,13,21,61.9,8,23,1,22,7,35,12,1,"FW,MF",20-24,Forward,Spain,Europe
2612,Adama Traoré,ESP,Wolves,Premier League,2020,24.0,1996.0,29.4,28,16,11,13,4,13,21,61.9,8,23,1,22,7,35,12,1,"FW,MF",20-24,Forward,Spain,Europe
2612,Adama Traoré,ESP,Wolves,Premier League,2020,24.0,1996.0,29.4,28,16,11,13,4,13,21,61.9,8,23,1,22,7,35,12,1,"FW,MF",20-24,Forward,Spain,Europe
2612,Adama Traoré,ESP,Wolves,Premier League,2020,24.0,1996.0,29.4,28,16,11,13,4,13,21,61.9,8,23,1,22,7,35,12,1,"FW,MF",20-24,Forward,Spain,Europe
2612,Adama Traoré,ESP,Wolves,Premier League,2020,24.0,1996.0,29.4,28,16,11,13,4,13,21,61.9,8,23,1,22,7,35,12,1,"FW,MF",20-24,Forward,Spain,Europe
2612,Adama Traoré,ESP,Wolves,Premier League,2020,24.0,1996.0,29.4,28,16,11,13,4,13,21,61.9,8,23,1,22,7,35,12,1,"FW,MF",20-24,Forward,Spain,Europe
2612,Adama Traoré,ESP,Wolves,Premier League,2020,24.0,1996.0,29.4,28,16,11,13,4,13,21,61.9,8,23,1,22,7,35,12,1,"FW,MF",20-24,Forward,Spain,Europe
2612,Adama Traoré,ESP,Wolves,Premier League,2020,24.0,1996.0,29.4,28,16,11,13,4,13,21,61.9,8,23,1,22,7,35,12,1,"FW,MF",20-24,Forward,Spain,Europe
2612,Adama Traoré,ESP,Wolves,Premier League,2020,24.0,1996.0,29.4,28,16,11,13,4,13,21,61.9,8,23,1,22,7,35,12,1,"FW,MF",20-24,Forward,Spain,Europe
2612,Adama Traoré,ESP,Wolves,Premier League,2020,24.0,1996.0,29.4,28,16,11,13,4,13,21,61.9,8,23,1,22,7,35,12,1,"FW,MF",20-24,Forward,Spain,Europe
2612,Adama Traoré,ESP,Wolves,Premier League,2020,24.0,1996.0,29.4,28,16,11,13,4,13,21,61.9,8,23,1,22,7,35,12,1,"FW,MF",20-24,Forward,Spain,Europe
2612,Adama Traoré,ESP,Wolves,Premier League,2020,24.0,1996.0,29.4,28,16,11,13,4,13,21,61.9,8,23,1,22,7,35,12,1,"FW,MF",20-24,Forward,Spain,Europe
2612,Adama Traoré,ESP,Wolves,Premier League,2020,24.0,1996.0,29.4,28,16,11,13,4,13,21,61.9,8,23,1,22,7,35,12,1,"FW,MF",20-24,Forward,Spain,Europe
2612,Adama Traoré,ESP,Wolves,Premier League,2020,24.0,1996.0,29.4,28,16,11,13,4,13,21,61.9,8,23,1,22,7,35,12,1,"FW,MF",20-24,Forward,Spain,Europe
2612,Adama Traoré,ESP,Wolves,Premier League,2020,24.0,1996.0,29.4,28,16,11,13,4,13,21,61.9,8,23,1,22,7,35,12,1,"FW,MF",20-24,Forward,Spain,Europe
2625,Manu Trigueros,ESP,Villarreal,La Liga,2020,28.0,1991.0,28.1,51,30,25,21,5,21,77,27.3,56,32,2,30,17,68,19,0,MF,25-29,Midfielder,Spain,Europe
2649,Kacper Urbanski,POL,Bologna,Serie A,2020,15.0,2004.0,0.0,0,0,0,0,0,0,0,,0,0,0,0,0,0,0,0,FW,Under 20,Forward,Poland,Europe
2651,Tomáš Vaclík,CZE,Sevilla,La Liga,2020,31.0,1989.0,5.0,0,0,0,0,0,0,1,0.0,1,0,0,0,0,0,0,1,GK,30-34,Goalkeeper,Czech Republic,Europe
2652,Eugeni Valderrama,ESP,Huesca,La Liga,2020,26.0,1994.0,1.3,2,2,1,0,1,0,1,0.0,1,0,0,0,5,7,3,0,"MF,FW",25-29,Midfielder,Spain,Europe
2655,Borja Valero,ESP,Fiorentina,Serie A,2020,35.0,1985.0,5.5,13,9,7,4,2,3,15,20.0,12,6,1,5,6,19,2,0,"MF,FW",35-39,Midfielder,Spain,Europe
2657,Jesús Vallejo,ESP,Granada,La Liga,2020,23.0,1997.0,15.0,11,6,7,3,1,7,18,38.9,11,21,11,10,13,24,55,0,DF,20-24,Defender,Spain,Europe
2658,Manu Vallejo,ESP,Valencia,La Liga,2020,23.0,1997.0,10.6,18,8,5,8,5,5,26,19.2,21,8,0,8,3,21,3,0,"FW,MF",20-24,Forward,Spain,Europe
2667,Kevin Vázquez,ESP,Celta Vigo,La Liga,2020,27.0,1993.0,6.2,11,5,9,2,0,3,9,33.3,6,8,0,8,9,20,18,0,DF,25-29,Defender,Spain,Europe
2668,Lucas Vázquez,ESP,Real Madrid,La Liga,2020,29.0,1991.0,20.5,61,37,30,22,9,22,52,42.3,30,14,1,13,19,80,31,1,"DF,FW",25-29,Defender,Spain,Europe
2670,Koke Vegas,ESP,Levante,La Liga,2020,24.0,1995.0,1.0,0,0,0,0,0,0,0,,0,0,0,0,0,0,1,1,GK,20-24,Goalkeeper,Spain,Europe
2671,Gabriel Veiga,ESP,Celta Vigo,La Liga,2020,18.0,2002.0,1.3,3,0,3,0,0,1,4,25.0,3,3,0,3,3,6,0,0,"MF,DF",Under 20,Midfielder,Spain,Europe
2672,Miloš Veljković,SRB,Werder Bremen,Bundesliga,2020,24.0,1995.0,19.1,24,14,17,6,1,15,31,48.4,16,22,9,13,29,53,94,1,DF,20-24,Defender,Serbia,Europe
2675,Unai Vencedor Paris,ESP,Athletic Club,La Liga,2020,19.0,2000.0,18.9,31,21,10,15,6,11,42,26.2,31,17,6,11,18,49,14,0,MF,Under 20,Midfielder,Spain,Europe
2679,Gonzalo Verdú,ESP,Elche,La Liga,2020,31.0,1988.0,32.7,34,19,26,8,0,16,28,57.1,12,40,30,10,52,86,113,0,DF,30-34,Defender,Spain,Europe
2684,Mikel Vesga,ESP,Athletic Club,La Liga,2020,27.0,1993.0,19.1,28,14,8,16,4,12,50,24.0,38,28,8,20,27,55,35,1,MF,25-29,Midfielder,Spain,Europe
2688,Iñigo Vicente,ESP,Athletic Club,La Liga,2020,22.0,1998.0,0.6,1,1,1,0,0,1,1,100.0,0,0,0,0,0,1,0,0,"FW,MF",20-24,Forward,Spain,Europe
2689,Fede Vico,ESP,Granada,La Liga,2020,26.0,1994.0,8.5,10,6,5,5,0,3,10,30.0,7,15,1,14,12,22,5,0,"MF,FW",25-29,Midfielder,Spain,Europe
2690,Aleix Vidal,ESP,Sevilla,La Liga,2020,30.0,1989.0,6.6,9,5,5,3,1,5,12,41.7,7,10,1,9,12,21,9,0,DF,30-34,Defender,Spain,Europe
2693,Nacho Vidal,ESP,Osasuna,La Liga,2020,25.0,1995.0,26.1,56,28,27,22,7,22,31,71.0,9,39,10,29,43,99,68,0,DF,25-29,Defender,Spain,Europe
2697,Toni Villa,ESP,Valladolid,La Liga,2020,25.0,1995.0,10.8,31,16,11,14,6,15,42,35.7,27,15,1,14,5,36,3,0,"MF,FW",25-29,Midfielder,Spain,Europe
2698,Asier Villalibre,ESP,Athletic Club,La Liga,2020,22.0,1997.0,17.7,3,2,0,2,1,2,8,25.0,6,4,0,4,2,5,16,0,FW,20-24,Forward,Spain,Europe
2699,Gonzalo Villar,ESP,Roma,Serie A,2020,22.0,1998.0,20.7,44,18,14,24,6,18,61,29.5,43,25,3,22,22,66,14,1,MF,20-24,Midfielder,Spain,Europe
2700,Iván Villar,ESP,Celta Vigo,La Liga,2020,23.0,1997.0,19.8,0,0,0,0,0,0,1,0.0,1,0,0,0,0,0,18,0,GK,20-24,Goalkeeper,Spain,Europe
2706,Vitolo,ESP,Atlético Madrid,La Liga,2020,30.0,1989.0,3.3,4,1,2,0,2,1,6,16.7,5,3,0,3,3,7,2,0,"MF,FW",30-34,Midfielder,Spain,Europe
2706,Vitolo,ESP,Atlético Madrid,La Liga,2020,30.0,1989.0,3.3,4,1,2,0,2,1,6,16.7,5,3,0,3,3,7,2,0,"MF,FW",30-34,Midfielder,Spain,Europe
2706,Vitolo,ESP,Atlético Madrid,La Liga,2020,30.0,1989.0,3.3,4,1,2,0,2,1,6,16.7,5,3,0,3,3,7,2,0,"MF,FW",30-34,Midfielder,Spain,Europe
2706,Vitolo,ESP,Atlético Madrid,La Liga,2020,30.0,1989.0,3.3,4,1,2,0,2,1,6,16.7,5,3,0,3,3,7,2,0,"MF,FW",30-34,Midfielder,Spain,Europe
2707,Dušan Vlahović,SRB,Fiorentina,Serie A,2020,20.0,2000.0,32.5,13,4,3,4,6,5,16,31.3,11,16,2,14,4,17,15,0,FW,20-24,Forward,Serbia,Europe
2718,Miloš Vulić,SRB,Crotone,Serie A,2020,23.0,1996.0,14.5,15,8,9,1,5,8,21,38.1,13,10,1,9,8,23,8,0,MF,20-24,Midfielder,Serbia,Europe
2719,Matěj Vydra,CZE,Burnley,Premier League,2020,28.0,1992.0,15.2,9,5,2,4,3,1,8,12.5,7,8,1,7,6,15,5,0,FW,25-29,Forward,Czech Republic,Europe
2727,Sebastian Walukiewicz,POL,Cagliari,Serie A,2020,20.0,2000.0,18.0,27,19,11,13,3,12,30,40.0,18,22,14,8,36,63,60,0,DF,20-24,Defender,Poland,Europe
2751,Nico Williams,ESP,Athletic Club,La Liga,2020,18.0,2002.0,0.6,1,0,1,0,0,0,2,0.0,2,0,0,0,1,2,0,0,MF,Under 20,Midfielder,Spain,Europe
2772,Rubén Yáñez,ESP,Getafe,La Liga,2020,26.0,1993.0,10.0,0,0,0,0,0,0,1,0.0,1,0,0,0,2,2,2,0,GK,25-29,Goalkeeper,Spain,Europe
2777,Yoel,ESP,Eibar,La Liga,2020,31.0,1988.0,3.3,0,0,0,0,0,0,0,,0,0,0,0,0,0,2,0,GK,30-34,Goalkeeper,Spain,Europe
2784,Zaydou Youssouf,COM,Saint-Étienne,Ligue 1,2020,21.0,1999.0,13.7,30,15,19,10,1,16,40,40.0,24,15,0,15,25,55,12,1,MF,20-24,Midfielder,Comoros,Africa
2790,Miha Zajc,SVN,Genoa,Serie A,2020,26.0,1994.0,20.7,22,14,9,10,3,13,39,33.3,26,30,4,26,27,49,19,0,MF,25-29,Midfielder,Slovenia,Europe
2792,Joseba Zaldúa,ESP,Real Sociedad,La Liga,2020,28.0,1992.0,7.1,15,12,7,5,3,6,18,33.3,12,6,2,4,6,21,13,0,DF,25-29,Defender,Spain,Europe
2793,Nicola Zalewski,POL,Roma,Serie A,2020,18.0,2002.0,0.1,1,1,0,1,0,1,1,100.0,0,0,0,0,0,1,0,0,MF,Under 20,Midfielder,Poland,Europe
2800,Oier Zarraga,ESP,Athletic Club,La Liga,2020,21.0,1999.0,1.1,1,1,0,1,0,1,2,50.0,1,1,0,1,0,1,0,0,MF,20-24,Midfielder,Spain,Europe
2809,Piotr Zieliński,POL,Napoli,Serie A,2020,26.0,1994.0,28.0,18,10,8,7,3,7,20,35.0,13,23,4,19,18,36,12,0,MF,25-29,Midfielder,Poland,Europe
2817,Igor Zubeldia,ESP,Real Sociedad,La Liga,2020,23.0,1997.0,21.8,23,16,15,8,0,8,14,57.1,6,20,13,7,12,35,46,0,DF,20-24,Defender,Spain,Europe
2819,Martín Zubimendi,ESP,Real Sociedad,La Liga,2020,21.0,1999.0,20.9,41,22,18,20,3,20,34,58.8,14,22,10,12,40,81,39,0,MF,20-24,Midfielder,Spain,Europe
2820,Martin Ødegaard,NOR,Arsenal,Premier League,2020,21.0,1998.0,9.6,9,3,2,6,1,4,14,28.6,10,2,0,2,2,11,5,0,MF,20-24,Midfielder,Norway,Europe
2821,Martin Ødegaard,NOR,Real Madrid,La Liga,2020,21.0,1998.0,2.6,1,0,0,1,0,1,2,50.0,1,1,0,1,1,2,0,0,MF,20-24,Midfielder,Norway,Europe
2822,Filip Đuričić,SRB,Sassuolo,Serie A,2020,28.0,1992.0,23.1,32,23,6,16,10,12,30,40.0,18,20,2,18,9,41,12,0,"MF,FW",25-29,Midfielder,Serbia,Europe
1,Max Aarons,ENG,Bournemouth,Premier League,2023,23.0,2000.0,13.7,29,19,20,7,2,20,34,58.8,14,9,5,4,8,37,27,0,DF,20-24,Defender,England,Europe
2,Brenden Aaronson,USA,Union Berlin,Bundesliga,2023,22.0,2000.0,14.1,32,18,13,13,6,16,32,50.0,16,26,1,25,2,34,4,0,"MF,FW",20-24,Midfielder,United States,North America
3,Paxten Aaronson,USA,Eint Frankfurt,Bundesliga,2023,19.0,2003.0,1.1,2,2,1,1,0,1,1,100.0,0,2,0,2,0,2,0,0,MF,Under 20,Midfielder,United States,North America
4,Keyliane Abdallah,FRA,Marseille,Ligue 1,2023,17.0,2006.0,0.0,0,0,0,0,0,0,0,,0,0,0,0,0,0,0,0,FW,Under 20,Forward,France,Europe
5,Yunis Abdelhamid,MAR,Reims,Ligue 1,2023,35.0,1987.0,30.9,64,35,36,23,5,26,45,57.8,19,51,32,19,39,103,109,2,DF,35-39,Defender,Morocco,Africa
6,Salis Abdul Samed,GHA,Lens,Ligue 1,2023,23.0,2000.0,16.9,21,14,8,10,3,8,18,44.4,10,12,1,11,12,33,18,0,MF,20-24,Midfielder,Ghana,Africa
7,Nabil Aberdin,FRA,Getafe,La Liga,2023,20.0,2002.0,2.0,0,0,0,0,0,0,1,0.0,1,0,0,0,0,0,4,0,DF,20-24,Defender,France,Europe
8,Laurent Abergel,FRA,Lorient,Ligue 1,2023,30.0,1993.0,31.8,85,52,43,34,8,38,96,39.6,58,29,6,23,61,146,61,3,MF,30-34,Midfielder,France,Europe
9,Matthis Abline,FRA,Nantes,Ligue 1,2023,20.0,2003.0,11.6,9,4,4,3,2,3,8,37.5,5,3,0,3,3,12,5,0,FW,20-24,Forward,France,Europe
10,Abner,BRA,Betis,La Liga,2023,23.0,2000.0,15.6,25,19,15,9,1,17,34,50.0,17,23,5,18,15,40,62,0,DF,20-24,Defender,Brazil,South America
11,Zakaria Aboukhlal,MAR,Toulouse,Ligue 1,2023,23.0,2000.0,8.4,9,8,1,5,3,3,12,25.0,9,9,1,8,1,10,2,0,"MF,FW",20-24,Midfielder,Morocco,Africa
12,Abdel Abqar,MAR,Alavés,La Liga,2023,24.0,1999.0,25.7,35,19,28,5,2,21,35,60.0,14,31,26,5,23,58,115,0,DF,20-24,Defender,Morocco,Africa
13,Tammy Abraham,ENG,Roma,Serie A,2023,25.0,1997.0,2.7,3,1,0,1,2,0,0,,0,1,0,1,0,3,4,0,FW,25-29,Forward,England,Europe
14,Francesco Acerbi,ITA,Inter,Serie A,2023,35.0,1988.0,26.5,22,13,16,6,0,11,14,78.6,3,20,13,7,32,54,77,1,DF,35-39,Defender,Italy,Europe
15,Joshua Acheampong,ENG,Chelsea,Premier League,2023,17.0,2006.0,0.1,0,0,0,0,0,0,0,,0,3,3,0,0,0,0,0,DF,Under 20,Defender,England,Europe
16,Marcos Acuña,ARG,Sevilla,La Liga,2023,31.0,1991.0,14.4,33,21,20,12,1,9,14,64.3,5,12,2,10,4,37,25,0,DF,30-34,Defender,Argentina,South America
17,Akor Adams,NGA,Montpellier,Ligue 1,2023,23.0,2000.0,25.0,12,4,3,4,5,3,7,42.9,4,9,2,7,5,17,11,0,FW,20-24,Forward,Nigeria,Africa
18,Tyler Adams,USA,Bournemouth,Premier League,2023,24.0,1999.0,1.3,4,3,1,3,0,2,3,66.7,1,2,0,2,4,8,2,0,MF,20-24,Midfielder,United States,North America
19,Junior Adamu,AUT,Freiburg,Bundesliga,2023,22.0,2001.0,1.2,5,1,1,2,2,1,2,50.0,1,1,0,1,0,5,2,0,"FW,MF",20-24,Forward,Austria,Europe
20,Sargis Adamyan,ARM,Köln,Bundesliga,2023,30.0,1993.0,8.9,14,9,2,9,3,6,11,54.5,5,16,1,15,5,19,7,0,"FW,MF",30-34,Forward,Armenia,Asia
21,Tosin Adarabioyo,ENG,Fulham,Premier League,2023,25.0,1997.0,18.0,21,11,16,5,0,12,21,57.1,9,16,11,5,25,46,80,0,DF,25-29,Defender,England,Europe
22,Elijah Adebayo,ENG,Luton Town,Premier League,2023,25.0,1998.0,15.8,4,1,1,0,3,1,12,8.3,11,13,2,11,6,10,25,0,FW,25-29,Forward,England,Europe
23,Karim Adeyemi,GER,Dortmund,Bundesliga,2023,21.0,2002.0,10.1,16,14,9,4,3,8,20,40.0,12,11,0,11,3,19,5,0,"FW,MF",20-24,Forward,Germany,Europe
24,Simon Adingra,CIV,Brighton,Premier League,2023,21.0,2002.0,24.7,45,20,23,11,11,19,42,45.2,23,31,1,30,19,64,22,0,FW,20-24,Forward,Ivory Coast,Africa
25,Nathaniel Adjei,GHA,Lorient,Ligue 1,2023,20.0,2002.0,13.8,13,9,8,3,2,6,7,85.7,1,15,8,7,18,31,64,1,DF,20-24,Defender,Ghana,Africa
26,Amine Adli,MAR,Leverkusen,Bundesliga,2023,23.0,2000.0,10.0,16,7,2,10,4,7,17,41.2,10,10,2,8,6,22,5,0,"MF,FW",20-24,Midfielder,Morocco,Africa
27,Yacine Adli,FRA,Milan,Serie A,2023,23.0,2000.0,15.6,34,17,17,13,4,13,35,37.1,22,22,8,14,20,54,15,1,MF,20-24,Midfielder,France,Europe
28,Adryelson,BRA,Lyon,Ligue 1,2023,25.0,1998.0,0.1,0,0,0,0,0,0,0,,0,0,0,0,1,1,3,0,"DF,FW",25-29,Defender,Brazil,South America
29,Adson,BRA,Nantes,Ligue 1,2023,22.0,2000.0,2.6,7,6,1,6,0,2,2,100.0,0,5,0,5,2,9,2,0,"MF,FW",20-24,Midfielder,Brazil,South America
30,Michel Aebischer,SUI,Bologna,Serie A,2023,26.0,1997.0,24.8,35,20,9,20,6,15,34,44.1,19,28,6,22,12,47,22,0,MF,25-29,Midfielder,Switzerland,Europe
31,Emmanuel Agbadou,CIV,Reims,Ligue 1,2023,26.0,1997.0,28.8,65,41,38,23,4,44,64,68.8,20,47,25,22,55,120,116,1,DF,25-29,Defender,Ivory Coast,Africa
33,Lucien Agoume,FRA,Inter,Serie A,2023,21.0,2002.0,0.1,0,0,0,0,0,0,0,,0,0,0,0,0,0,0,0,MF,20-24,Midfielder,France,Europe
34,Lucien Agoume,FRA,Sevilla,La Liga,2023,21.0,2002.0,8.6,23,18,7,14,2,9,12,75.0,3,6,1,5,7,30,8,0,MF,20-24,Midfielder,France,Europe
35,Felix Agu,GER,Werder Bremen,Bundesliga,2023,23.0,1999.0,17.9,45,29,28,13,4,29,41,70.7,12,27,7,20,13,58,41,0,"DF,MF",20-24,Defender,Germany,Europe
36,Nayef Aguerd,MAR,West Ham,Premier League,2023,27.0,1996.0,20.6,26,14,19,7,0,16,22,72.7,6,33,24,9,17,43,85,2,DF,25-29,Defender,Morocco,Africa
37,Ruben Aguilar,FRA,Lens,Ligue 1,2023,30.0,1993.0,21.4,53,31,27,23,3,27,45,60.0,18,35,5,30,26,79,46,0,DF,30-34,Defender,France,Europe
38,Brandon Aguilera,CRC,Nott'ham Forest,Premier League,2023,20.0,2003.0,0.1,0,0,0,0,0,0,0,,0,0,0,0,0,0,0,0,FW,20-24,Forward,Costa Rica,North America
39,Naouirou Ahamada,FRA,Crystal Palace,Premier League,2023,21.0,2002.0,3.9,13,9,5,6,2,8,17,47.1,9,3,0,3,2,15,4,0,"MF,FW",20-24,Midfielder,France,Europe
40,Anel Ahmedhodžić,BIH,Sheffield Utd,Premier League,2023,24.0,1999.0,29.4,64,36,48,14,2,30,49,61.2,19,43,26,17,35,99,137,2,DF,20-24,Defender,Bosnia and Herzegovina,Europe
41,Joseph Aidoo,GHA,Celta Vigo,La Liga,2023,27.0,1995.0,4.5,8,3,6,2,0,4,8,50.0,4,3,1,2,4,12,28,0,DF,25-29,Defender,Ghana,Africa
42,Ola Aina,NGA,Nott'ham Forest,Premier League,2023,26.0,1996.0,18.8,47,31,31,12,4,29,41,70.7,12,19,3,16,18,65,51,1,DF,25-29,Defender,Nigeria,Africa
43,Rayan Aït-Nouri,ALG,Wolves,Premier League,2023,22.0,2001.0,25.9,71,44,41,23,7,28,49,57.1,21,32,6,26,15,86,38,0,"DF,MF",20-24,Defender,Algeria,Africa
44,Tosin Aiyegun,BEN,Lorient,Ligue 1,2023,25.0,1998.0,10.0,6,4,2,3,1,3,9,33.3,6,4,1,3,2,8,8,0,"MF,FW",25-29,Midfielder,Benin,Africa
46,Ludovic Ajorque,FRA,Mainz 05,Bundesliga,2023,29.0,1994.0,15.1,3,2,1,2,0,2,11,18.2,9,6,2,4,4,7,11,0,FW,25-29,Forward,France,Europe
47,Manuel Akanji,SUI,Manchester City,Premier League,2023,28.0,1995.0,27.9,42,28,16,18,8,22,39,56.4,17,28,12,16,23,65,70,3,"DF,MF",25-29,Defender,Switzerland,Europe
48,Marley Aké,FRA,Udinese,Serie A,2023,22.0,2001.0,0.1,0,0,0,0,0,0,0,,0,0,0,0,0,0,0,0,FW,20-24,Forward,France,Europe
49,Nathan Aké,NED,Manchester City,Premier League,2023,28.0,1995.0,22.7,26,16,15,8,3,13,20,65.0,7,17,2,15,14,40,54,0,DF,25-29,Defender,Netherlands,Europe
50,Ilias Akhomach,MAR,Villarreal,La Liga,2023,19.0,2004.0,16.8,36,21,11,16,9,10,20,50.0,10,10,2,8,13,49,13,0,"MF,FW",Under 20,Midfielder,Morocco,Africa
53,Ebenezer Akinsanmiro,NGA,Inter,Serie A,2023,18.0,2004.0,0.2,0,0,0,0,0,0,1,0.0,1,0,0,0,0,0,0,0,MF,Under 20,Midfielder,Nigeria,Africa
54,Maghnes Akliouche,FRA,Monaco,Ligue 1,2023,21.0,2002.0,17.9,37,23,12,20,5,12,36,33.3,24,21,0,21,9,46,3,0,"MF,FW",20-24,Midfielder,France,Europe
55,Paul Akouokou,CIV,Betis,La Liga,2023,25.0,1997.0,0.3,5,3,0,2,3,3,3,100.0,0,3,1,2,1,6,1,0,MF,25-29,Midfielder,Ivory Coast,Africa
56,Paul Akouokou,CIV,Lyon,Ligue 1,2023,25.0,1997.0,3.4,14,9,2,10,2,6,7,85.7,1,5,1,4,6,20,11,0,MF,25-29,Midfielder,Ivory Coast,Africa
57,Jean-Daniel Akpa-Akpro,CIV,Monza,Serie A,2023,30.0,1992.0,7.8,20,11,14,4,2,3,9,33.3,6,10,4,6,12,32,15,1,MF,30-34,Midfielder,Ivory Coast,Africa
58,David Akpan Ankeye,NGA,Genoa,Serie A,2023,21.0,2002.0,0.6,1,0,0,1,0,0,1,0.0,1,1,0,1,0,1,0,0,FW,20-24,Forward,Nigeria,Africa
59,Kevin Akpoguma,NGA,Hoffenheim,Bundesliga,2023,28.0,1995.0,12.2,35,18,22,12,1,26,35,74.3,9,28,8,20,18,53,32,0,DF,25-29,Defender,Nigeria,Africa
60,David Alaba,AUT,Real Madrid,La Liga,2023,31.0,1992.0,12.8,13,9,7,5,1,4,8,50.0,4,10,7,3,15,28,34,0,DF,30-34,Defender,Austria,Europe
64,Carlos Alcaraz,ARG,Juventus,Serie A,2023,20.0,2002.0,4.2,6,6,0,6,0,5,10,50.0,5,5,2,3,5,11,4,0,MF,20-24,Midfielder,Argentina,South America
66,Omar Alderete,PAR,Getafe,La Liga,2023,26.0,1996.0,24.4,28,21,15,13,0,19,35,54.3,16,30,18,12,13,41,111,0,DF,25-29,Defender,Paraguay,South America
69,Trent Alexander-Arnold,ENG,Liverpool,Premier League,2023,24.0,1998.0,23.9,39,26,26,11,2,27,87,31.0,60,22,2,20,31,70,48,5,DF,20-24,Defender,England,Europe
70,Aboubacar Ali,FRA,Strasbourg,Ligue 1,2023,17.0,2006.0,1.4,2,0,0,2,0,0,0,,0,1,0,1,1,3,2,0,"MF,FW",Under 20,Midfielder,France,Europe
71,Mohamed Ali Cho,FRA,Real Sociedad,La Liga,2023,19.0,2004.0,2.8,4,3,3,1,0,2,7,28.6,5,6,0,6,1,5,1,0,"FW,MF",Under 20,Forward,France,Europe
72,Mohamed Ali Cho,FRA,Nice,Ligue 1,2023,19.0,2004.0,9.6,12,9,4,7,1,3,11,27.3,8,10,0,10,3,15,6,0,FW,Under 20,Forward,France,Europe
73,Faride Alidou,GER,Köln,Bundesliga,2023,22.0,2001.0,14.2,10,4,3,6,1,4,18,22.2,14,23,2,21,8,18,15,1,"FW,MF",20-24,Forward,Germany,Europe
74,Nabil Alioui,FRA,Le Havre,Ligue 1,2023,24.0,1999.0,11.2,3,2,2,1,0,2,4,50.0,2,6,1,5,3,6,4,0,"MF,FW",20-24,Midfielder,France,Europe
75,Alisson,BRA,Liverpool,Premier League,2023,30.0,1992.0,28.0,0,0,0,0,0,0,1,0.0,1,0,0,0,0,0,11,4,GK,30-34,Goalkeeper,Brazil,South America
75,Alisson,BRA,Liverpool,Premier League,2023,30.0,1992.0,28.0,0,0,0,0,0,0,1,0.0,1,0,0,0,0,0,11,4,GK,30-34,Goalkeeper,Brazil,South America
75,Alisson,BRA,Liverpool,Premier League,2023,30.0,1992.0,28.0,0,0,0,0,0,0,1,0.0,1,0,0,0,0,0,11,4,GK,30-34,Goalkeeper,Brazil,South America
75,Alisson,BRA,Liverpool,Premier League,2023,30.0,1992.0,28.0,0,0,0,0,0,0,1,0.0,1,0,0,0,0,0,11,4,GK,30-34,Goalkeeper,Brazil,South America
76,Tadeo Allende,ARG,Celta Vigo,La Liga,2023,24.0,1999.0,3.7,6,1,3,2,1,4,6,66.7,2,3,0,3,3,9,3,0,"MF,FW",20-24,Midfielder,Argentina,South America
77,Jim Allevinah,GAB,Clermont Foot,Ligue 1,2023,28.0,1995.0,20.7,30,18,11,14,5,14,35,40.0,21,20,3,17,13,43,30,0,"MF,DF",25-29,Midfielder,Gabon,Africa
78,Domingos André Ribeiro Almeida,POR,Valencia,La Liga,2023,23.0,2000.0,10.7,25,15,9,12,4,9,19,47.4,10,13,1,12,6,31,5,0,"FW,MF",20-24,Forward,Portugal,Europe
79,Miguel Almirón,PAR,Newcastle Utd,Premier League,2023,29.0,1994.0,21.5,36,24,13,15,8,11,29,37.9,18,29,2,27,10,46,13,0,FW,25-29,Forward,Paraguay,South America
80,Pontus Almqvist,SWE,Lecce,Serie A,2023,24.0,1999.0,23.4,45,29,16,22,7,23,51,45.1,28,21,2,19,14,59,10,0,"FW,MF",20-24,Forward,Sweden,Europe
84,Edson Álvarez,MEX,West Ham,Premier League,2023,25.0,1997.0,26.4,80,39,47,26,7,31,66,47.0,35,59,20,39,42,122,81,0,MF,25-29,Midfielder,Mexico,North America
85,Gastón Álvarez,URU,Getafe,La Liga,2023,23.0,2000.0,28.2,68,37,43,20,5,37,57,64.9,20,40,11,29,35,103,80,0,DF,20-24,Defender,Uruguay,South America
87,Julián Álvarez,ARG,Manchester City,Premier League,2023,23.0,2000.0,29.4,24,13,5,8,11,8,32,25.0,24,30,0,30,2,26,14,1,"MF,FW",20-24,Midfielder,Argentina,South America
89,Skelly Alvero,FRA,Lyon,Ligue 1,2023,21.0,2002.0,4.7,8,7,5,2,1,2,9,22.2,7,5,1,4,2,10,5,0,MF,20-24,Midfielder,France,Europe
90,Skelly Alvero,FRA,Werder Bremen,Bundesliga,2023,21.0,2002.0,1.4,6,4,1,5,0,3,3,100.0,0,3,1,2,1,7,1,0,MF,20-24,Midfielder,France,Europe
91,Papa Amadou Diallo,SEN,Metz,Ligue 1,2023,19.0,2004.0,9.9,18,8,10,7,1,7,21,33.3,14,11,1,10,11,29,16,0,FW,Under 20,Forward,Senegal,Africa
92,Selim Amallah,MAR,Valencia,La Liga,2023,26.0,1996.0,6.7,17,12,7,7,3,3,9,33.3,6,13,0,13,11,28,6,0,"FW,MF",25-29,Forward,Morocco,Africa
93,Amath,SEN,Mallorca,La Liga,2023,27.0,1996.0,4.4,9,6,7,2,0,2,10,20.0,8,2,0,2,3,12,6,0,"FW,MF",25-29,Forward,Senegal,Africa
94,Lorenzo Amatucci,ITA,Fiorentina,Serie A,2023,19.0,2004.0,0.2,0,0,0,0,0,0,0,,0,0,0,0,0,0,0,0,MF,Under 20,Midfielder,Italy,Europe
95,Jordan Amavi,FRA,Brest,Ligue 1,2023,29.0,1994.0,1.0,1,1,0,1,0,1,3,33.3,2,2,1,1,3,4,2,0,DF,25-29,Defender,France,Europe
96,Zeki Amdouni,SUI,Burnley,Premier League,2023,22.0,2000.0,21.7,27,18,1,15,11,7,25,28.0,18,23,10,13,9,36,10,0,FW,20-24,Forward,Switzerland,Europe
97,Kelvin Amian,FRA,Nantes,Ligue 1,2023,25.0,1998.0,8.9,16,7,12,4,0,11,15,73.3,4,6,0,6,7,23,28,0,DF,25-29,Defender,France,Europe
98,Bruno Amione,ARG,Hellas Verona,Serie A,2023,21.0,2002.0,6.4,11,3,9,2,0,4,5,80.0,1,4,2,2,9,20,19,2,DF,20-24,Defender,Argentina,South America
99,Michael Amir Murillo,PAN,Marseille,Ligue 1,2023,27.0,1996.0,11.1,23,11,13,6,4,15,23,65.2,8,9,2,7,11,34,34,2,DF,25-29,Defender,Panama,North America
100,Nadiem Amiri,GER,Mainz 05,Bundesliga,2023,26.0,1996.0,14.6,22,14,8,10,4,13,19,68.4,6,16,2,14,14,36,18,0,MF,25-29,Midfielder,Germany,Europe
101,Nadiem Amiri,GER,Leverkusen,Bundesliga,2023,26.0,1996.0,1.0,4,2,0,3,1,0,3,0.0,3,0,0,0,0,4,1,0,MF,25-29,Midfielder,Germany,Europe
102,Kofi Amoako,GER,Wolfsburg,Bundesliga,2023,18.0,2005.0,0.0,0,0,0,0,0,0,0,,0,0,0,0,0,0,0,0,MF,Under 20,Midfielder,Germany,Europe
103,Sofyan Amrabat,MAR,Manchester Utd,Premier League,2023,26.0,1996.0,10.4,27,16,17,8,2,17,31,54.8,14,20,7,13,8,35,19,2,"MF,DF",25-29,Midfielder,Morocco,Africa
104,Joachim Andersen,DEN,Crystal Palace,Premier League,2023,27.0,1996.0,37.9,56,35,33,21,2,29,39,74.4,10,33,18,15,41,97,207,1,DF,25-29,Defender,Denmark,Europe
105,Elliot Anderson,ENG,Newcastle Utd,Premier League,2023,20.0,2002.0,11.4,24,18,12,9,3,15,29,51.7,14,23,4,19,8,32,23,0,"MF,FW",20-24,Midfielder,England,Europe
106,Felipe Anderson,BRA,Lazio,Serie A,2023,30.0,1993.0,30.8,78,45,32,33,13,34,90,37.8,56,45,3,42,27,105,23,0,"FW,MF",30-34,Forward,Brazil,South America
107,Benjamin André,FRA,Lille,Ligue 1,2023,32.0,1990.0,28.6,89,49,39,45,5,43,81,53.1,38,34,5,29,35,124,60,0,MF,30-34,Midfielder,France,Europe
109,Robert Andrich,GER,Leverkusen,Bundesliga,2023,28.0,1994.0,18.8,30,18,8,14,8,13,24,54.2,11,15,4,11,20,50,17,0,"MF,DF",25-29,Midfielder,Germany,Europe
112,Ângelo,BRA,Strasbourg,Ligue 1,2023,18.0,2004.0,12.2,24,11,9,7,8,11,31,35.5,20,18,0,18,9,33,2,0,"FW,MF",Under 20,Forward,Brazil,South America
113,Fabrizio Angileri,ARG,Getafe,La Liga,2023,29.0,1994.0,1.8,1,1,1,0,0,1,3,33.3,2,0,0,0,4,5,8,0,"DF,MF",25-29,Defender,Argentina,South America
114,Jaidon Anthony,ENG,Bournemouth,Premier League,2023,23.0,1999.0,1.7,3,1,1,0,2,1,7,14.3,6,3,0,3,1,4,3,0,FW,20-24,Forward,England,Europe
115,Waldemar Anton,GER,Stuttgart,Bundesliga,2023,27.0,1996.0,32.1,39,25,21,16,2,23,42,54.8,19,33,20,13,40,79,150,1,DF,25-29,Defender,Germany,Europe
116,Michail Antonio,JAM,West Ham,Premier League,2023,33.0,1990.0,18.8,15,8,5,6,4,3,11,27.3,8,16,3,13,4,19,4,0,FW,30-34,Forward,Jamaica,North America
117,Antony,BRA,Manchester Utd,Premier League,2023,23.0,2000.0,14.7,40,21,15,19,6,20,40,50.0,20,29,1,28,12,52,9,0,FW,20-24,Forward,Brazil,South America
117,Antony,BRA,Manchester Utd,Premier League,2023,23.0,2000.0,14.7,40,21,15,19,6,20,40,50.0,20,29,1,28,12,52,9,0,FW,20-24,Forward,Brazil,South America
117,Antony,BRA,Manchester Utd,Premier League,2023,23.0,2000.0,14.7,40,21,15,19,6,20,40,50.0,20,29,1,28,12,52,9,0,FW,20-24,Forward,Brazil,South America
117,Antony,BRA,Manchester Utd,Premier League,2023,23.0,2000.0,14.7,40,21,15,19,6,20,40,50.0,20,29,1,28,12,52,9,0,FW,20-24,Forward,Brazil,South America
118,Christopher Antwi-Adjei,GHA,Bochum,Bundesliga,2023,29.0,1994.0,13.5,21,12,10,6,5,12,22,54.5,10,13,2,11,2,23,11,1,"FW,MF",25-29,Forward,Ghana,Africa
119,Houssem Aouar,ALG,Roma,Serie A,2023,25.0,1998.0,8.4,16,11,4,10,2,3,12,25.0,9,5,0,5,4,20,2,1,"MF,FW",25-29,Midfielder,Algeria,Africa
120,Stredair Appuah,FRA,Nantes,Ligue 1,2023,19.0,2004.0,0.9,0,0,0,0,0,0,3,0.0,3,0,0,0,1,1,1,0,"FW,MF",Under 20,Forward,France,Europe
121,Mauro Arambarri,URU,Getafe,La Liga,2023,27.0,1995.0,3.8,6,2,3,2,1,1,6,16.7,5,1,0,1,2,8,7,0,MF,25-29,Midfielder,Uruguay,South America
122,Jon Aramburu,VEN,Real Sociedad,La Liga,2023,21.0,2002.0,6.0,24,15,12,10,2,15,25,60.0,10,8,3,5,7,31,17,0,DF,20-24,Defender,Venezuela,South America
123,Asaf Arania,ISR,Darmstadt 98,Bundesliga,2023,17.0,2005.0,0.1,0,0,0,0,0,0,0,,0,0,0,0,0,0,0,0,MF,Under 20,Midfielder,Israel,Asia
124,Julian Araujo,MEX,Las Palmas,La Liga,2023,21.0,2001.0,16.2,41,22,29,7,5,23,33,69.7,10,23,16,7,10,51,52,1,DF,20-24,Defender,Mexico,North America
125,Ronald Araújo,URU,Barcelona,La Liga,2023,24.0,1999.0,22.2,27,22,11,15,1,12,17,70.6,5,20,11,9,12,39,66,2,DF,20-24,Defender,Uruguay,South America
126,Oliver Arblaster,ENG,Sheffield Utd,Premier League,2023,19.0,2004.0,10.5,23,14,11,8,4,7,15,46.7,8,17,7,10,15,38,9,0,MF,Under 20,Midfielder,England,Europe
127,Cameron Archer,ENG,Sheffield Utd,Premier League,2023,22.0,2001.0,20.4,18,13,6,6,6,8,18,44.4,10,22,3,19,1,19,11,0,"FW,MF",20-24,Forward,England,Europe
128,Cameron Archer,ENG,Aston Villa,Premier League,2023,22.0,2001.0,0.1,0,0,0,0,0,0,0,,0,0,0,0,0,0,0,0,MF,20-24,Midfielder,England,Europe
129,Alphonse Areola,FRA,West Ham,Premier League,2023,30.0,1993.0,30.0,1,1,1,0,0,1,3,33.3,2,0,0,0,1,2,16,0,GK,30-34,Goalkeeper,France,Europe
132,Simone Aresti,ITA,Cagliari,Serie A,2023,37.0,1986.0,0.0,0,0,0,0,0,0,0,,0,0,0,0,0,0,0,0,GK,35-39,Goalkeeper,Italy,Europe
133,Matias Arezo,URU,Granada,La Liga,2023,20.0,2002.0,4.1,7,3,2,5,0,1,5,20.0,4,4,1,3,1,8,4,0,FW,20-24,Forward,Uruguay,South America
135,Yoël Armougom,FRA,Clermont Foot,Ligue 1,2023,25.0,1998.0,2.6,3,3,2,0,1,2,3,66.7,1,1,0,1,1,4,3,0,"DF,MF",25-29,Defender,France,Europe
137,Hákon Arnar Haraldsson,ISL,Lille,Ligue 1,2023,20.0,2003.0,14.3,12,8,4,7,1,5,21,23.8,16,7,2,5,3,15,5,0,"FW,MF",20-24,Forward,Iceland,Europe
138,Marko Arnautović,AUT,Inter,Serie A,2023,34.0,1989.0,8.9,10,4,3,5,2,4,7,57.1,3,8,1,7,5,15,5,0,FW,30-34,Forward,Austria,Europe
139,Maximilian Arnold,GER,Wolfsburg,Bundesliga,2023,29.0,1994.0,27.8,51,31,15,27,9,28,57,49.1,29,23,4,19,24,75,60,0,MF,25-29,Midfielder,Germany,Europe
140,Mohamed El Arouch,FRA,Lyon,Ligue 1,2023,19.0,2004.0,0.0,0,0,0,0,0,0,0,,0,0,0,0,0,0,0,0,FW,Under 20,Forward,France,Europe
143,Arthur,BRA,Leverkusen,Bundesliga,2023,20.0,2003.0,2.0,4,3,2,0,2,2,2,100.0,0,1,1,0,0,4,7,0,DF,20-24,Defender,Brazil,South America
143,Arthur,BRA,Leverkusen,Bundesliga,2023,20.0,2003.0,2.0,4,3,2,0,2,2,2,100.0,0,1,1,0,0,4,7,0,DF,20-24,Defender,Brazil,South America
143,Arthur,BRA,Leverkusen,Bundesliga,2023,20.0,2003.0,2.0,4,3,2,0,2,2,2,100.0,0,1,1,0,0,4,7,0,DF,20-24,Defender,Brazil,South America
143,Arthur,BRA,Leverkusen,Bundesliga,2023,20.0,2003.0,2.0,4,3,2,0,2,2,2,100.0,0,1,1,0,0,4,7,0,DF,20-24,Defender,Brazil,South America
144,Takuma Asano,JPN,Bochum,Bundesliga,2023,28.0,1994.0,22.1,17,6,2,9,6,7,23,30.4,16,17,3,14,4,21,11,0,"FW,MF",25-29,Forward,Japan,Asia
146,Kristjan Asllani,ALB,Inter,Serie A,2023,21.0,2002.0,8.7,7,2,3,4,0,2,11,18.2,9,9,3,6,11,18,8,0,MF,20-24,Midfielder,Albania,Europe
147,Joel Asoro,SWE,Metz,Ligue 1,2023,24.0,1999.0,9.4,13,9,7,6,0,3,10,30.0,7,7,1,6,6,19,9,0,"FW,MF",20-24,Forward,Sweden,Europe
148,Jonathan Asp Jensen,DEN,Bayern Munich,Bundesliga,2023,17.0,2006.0,0.0,0,0,0,0,0,0,0,,0,0,0,0,0,0,1,0,FW,Under 20,Forward,Denmark,Europe
152,Youcef Atal,ALG,Nice,Ligue 1,2023,27.0,1996.0,4.0,9,3,6,2,1,6,8,75.0,2,7,1,6,4,13,1,0,DF,25-29,Defender,Algeria,Africa
153,Valentin Atangana Edoa,FRA,Reims,Ligue 1,2023,17.0,2005.0,6.2,19,13,6,9,4,5,13,38.5,8,5,1,4,6,25,9,0,MF,Under 20,Midfielder,France,Europe
154,Arthur Atta,FRA,Metz,Ligue 1,2023,20.0,2003.0,10.3,18,14,8,7,3,8,19,42.1,11,13,3,10,10,28,23,0,"MF,FW",20-24,Midfielder,France,Europe
155,Noah Atubolu,GER,Freiburg,Bundesliga,2023,21.0,2002.0,34.0,0,0,0,0,0,0,1,0.0,1,0,0,0,0,0,8,1,GK,20-24,Goalkeeper,Germany,Europe
156,Pierre-Emerick Aubameyang,GAB,Marseille,Ligue 1,2023,34.0,1989.0,29.1,22,14,4,11,7,7,26,26.9,19,30,5,25,9,31,26,0,FW,30-34,Forward,Gabon,Africa
157,Emil Audero,ITA,Inter,Serie A,2023,26.0,1997.0,3.7,0,0,0,0,0,0,0,,0,0,0,0,0,0,1,0,GK,25-29,Goalkeeper,Italy,Europe
158,Tommaso Augello,ITA,Cagliari,Serie A,2023,28.0,1994.0,26.9,26,19,18,6,2,16,25,64.0,9,21,10,11,17,43,89,0,DF,25-29,Defender,Italy,Europe
159,Carlos Augusto,BRA,Inter,Serie A,2023,24.0,1999.0,19.2,29,21,20,9,0,15,22,68.2,7,20,8,12,16,45,52,0,DF,20-24,Defender,Brazil,South America
160,Yann Aurel Bisseck,GER,Inter,Serie A,2023,22.0,2000.0,10.0,14,6,10,3,1,6,9,66.7,3,10,7,3,5,19,23,0,DF,20-24,Defender,Germany,Europe
161,Serge Aurier,CIV,Nott'ham Forest,Premier League,2023,30.0,1992.0,9.3,20,14,9,11,0,5,11,45.5,6,10,3,7,9,29,36,1,"DF,MF",30-34,Defender,Ivory Coast,Africa
162,Ezequiel Ávila,ARG,Osasuna,La Liga,2023,29.0,1994.0,9.6,3,2,1,1,1,3,11,27.3,8,14,0,14,4,7,8,0,"FW,MF",25-29,Forward,Argentina,South America
163,Ezequiel Ávila,ARG,Betis,La Liga,2023,29.0,1994.0,3.3,2,1,0,2,0,1,3,33.3,2,2,0,2,1,3,4,0,FW,25-29,Forward,Argentina,South America
164,Taiwo Awoniyi,NGA,Nott'ham Forest,Premier League,2023,25.0,1997.0,11.6,9,7,1,4,4,1,2,50.0,1,7,2,5,1,10,9,0,FW,25-29,Forward,Nigeria,Africa
165,André Ayew,GHA,Le Havre,Ligue 1,2023,33.0,1989.0,12.3,15,11,7,6,2,6,9,66.7,3,8,3,5,2,17,11,0,FW,30-34,Forward,Ghana,Africa
166,Jordan Ayew,GHA,Crystal Palace,Premier League,2023,31.0,1991.0,28.3,65,36,23,28,14,21,42,50.0,21,43,2,41,16,81,15,0,"FW,MF",30-34,Forward,Ghana,Africa
167,Neil El Aynaoui,FRA,Lens,Ligue 1,2023,22.0,2001.0,17.4,37,20,13,20,4,20,46,43.5,26,20,6,14,32,69,21,1,MF,20-24,Midfielder,France,Europe
168,Sardar Azmoun,IRN,Roma,Serie A,2023,28.0,1995.0,6.5,8,5,2,5,1,4,8,50.0,4,4,1,3,3,11,6,1,"FW,MF",25-29,Forward,Iran,Asia
170,Paulo Azzi,BRA,Cagliari,Serie A,2023,29.0,1994.0,10.6,19,11,10,6,3,9,18,50.0,9,11,2,9,16,35,23,0,"DF,MF",25-29,Defender,Brazil,South America
171,Oussama El Azzouzi,MAR,Bologna,Serie A,2023,22.0,2001.0,6.1,12,7,4,5,3,7,14,50.0,7,8,2,6,6,18,12,0,MF,20-24,Midfielder,Morocco,Africa
172,Abdellah Baallal,MAR,Clermont Foot,Ligue 1,2023,18.0,2004.0,0.0,0,0,0,0,0,0,0,,0,1,0,1,0,0,0,0,MF,Under 20,Midfielder,Morocco,Africa
173,Iddrisu Baba,GHA,Almería,La Liga,2023,27.0,1996.0,15.9,46,26,27,18,1,17,39,43.6,22,20,6,14,11,57,27,2,MF,25-29,Midfielder,Ghana,Africa
175,Shavy Babicka,GAB,Toulouse,Ligue 1,2023,23.0,2000.0,4.1,11,8,2,7,2,2,5,40.0,3,6,1,5,0,11,2,0,"FW,MF",20-24,Forward,Gabon,Africa
176,Aliou Badara Baldé,GUI,Nice,Ligue 1,2023,20.0,2002.0,0.8,4,1,0,3,1,1,1,100.0,0,2,1,1,3,7,0,0,"FW,DF",20-24,Forward,Guinea,Africa
177,Loïc Bade,FRA,Sevilla,La Liga,2023,23.0,2000.0,25.3,65,41,53,12,0,30,49,61.2,19,23,15,8,38,103,116,2,DF,20-24,Defender,France,Europe
178,Milan Badelj,CRO,Genoa,Serie A,2023,34.0,1989.0,28.2,51,27,23,24,4,24,61,39.3,37,45,13,32,50,101,54,1,MF,30-34,Midfielder,Croatia,Europe
179,Matthias Bader,GER,Darmstadt 98,Bundesliga,2023,26.0,1997.0,20.0,51,25,32,11,8,33,65,50.8,32,22,4,18,25,76,20,0,"DF,MF",25-29,Defender,Germany,Europe
180,Benoît Badiashile,FRA,Chelsea,Premier League,2023,22.0,2001.0,14.9,21,15,12,9,0,9,14,64.3,5,21,14,7,18,39,66,2,DF,20-24,Defender,France,Europe
182,Jaime Báez,URU,Frosinone,Serie A,2023,28.0,1995.0,5.6,4,1,0,2,2,0,7,0.0,7,5,0,5,4,8,1,0,"FW,MF",25-29,Forward,Uruguay,South America
183,Nicola Bagnolini,ITA,Bologna,Serie A,2023,19.0,2004.0,0.1,0,0,0,0,0,0,0,,0,0,0,0,0,0,0,0,GK,Under 20,Goalkeeper,Italy,Europe
184,Leon Bailey,JAM,Aston Villa,Premier League,2023,25.0,1997.0,23.0,13,7,7,4,2,5,20,25.0,15,18,1,17,9,22,6,0,"MF,FW",25-29,Midfielder,Jamaica,North America
185,Eric Bailly,CIV,Villarreal,La Liga,2023,29.0,1994.0,9.3,5,3,4,1,0,2,2,100.0,0,8,8,0,9,14,38,2,DF,25-29,Defender,Ivory Coast,Africa
187,Nedim Bajrami,ALB,Sassuolo,Serie A,2023,24.0,1999.0,14.6,13,6,6,3,4,5,13,38.5,8,5,1,4,6,19,8,0,"MF,FW",20-24,Midfielder,Albania,Europe
188,Cédric Bakambu,COD,Betis,La Liga,2023,32.0,1991.0,2.2,1,0,0,1,0,0,0,,0,2,0,2,0,1,0,0,FW,30-34,Forward,DR Congo,Africa
189,Tiemoué Bakayoko,FRA,Lorient,Ligue 1,2023,28.0,1994.0,14.6,34,17,14,17,3,15,28,53.6,13,10,4,6,26,60,15,1,MF,25-29,Midfielder,France,Europe
190,Mitchel Bakker,NED,Atalanta,Serie A,2023,23.0,2000.0,4.2,7,3,6,1,0,2,12,16.7,10,5,0,5,3,10,6,0,DF,20-24,Defender,Netherlands,Europe
191,Ridle Baku,GER,Wolfsburg,Bundesliga,2023,25.0,1998.0,22.4,37,20,24,7,6,21,46,45.7,25,27,1,26,21,58,45,1,"DF,MF",25-29,Defender,Germany,Europe
192,Dilane Bakwa,FRA,Strasbourg,Ligue 1,2023,20.0,2002.0,24.2,30,22,12,13,5,11,40,27.5,29,26,1,25,20,50,11,0,"FW,MF",20-24,Forward,France,Europe
193,Tommaso Baldanzi,ITA,Empoli,Serie A,2023,20.0,2003.0,8.3,4,2,1,1,2,3,10,30.0,7,7,0,7,2,6,0,0,"MF,FW",20-24,Midfielder,Italy,Europe
194,Tommaso Baldanzi,ITA,Roma,Serie A,2023,20.0,2003.0,5.8,9,5,3,4,2,1,1,100.0,0,2,0,2,0,9,4,0,"FW,MF",20-24,Forward,Italy,Europe
196,George Baldock,GRE,Sheffield Utd,Premier League,2023,30.0,1993.0,10.8,18,10,10,7,1,6,15,40.0,9,14,8,6,10,28,33,0,DF,30-34,Defender,Greece,Europe
197,Carlos Baleba,CMR,Brighton,Premier League,2023,19.0,2004.0,14.7,40,20,17,19,4,23,46,50.0,23,35,7,28,18,58,30,3,MF,Under 20,Midfielder,Cameroon,Africa
198,Carlos Baleba,CMR,Lille,Ligue 1,2023,19.0,2004.0,0.7,6,2,1,4,1,3,4,75.0,1,0,0,0,2,8,0,0,MF,Under 20,Midfielder,Cameroon,Africa
199,Leonardo Balerdi,ARG,Marseille,Ligue 1,2023,24.0,1999.0,25.2,79,50,55,23,1,49,67,73.1,18,38,15,23,51,130,91,0,DF,20-24,Defender,Argentina,South America
200,Iván Balliu,ALB,Rayo Vallecano,La Liga,2023,31.0,1992.0,31.9,44,31,20,24,0,22,39,56.4,17,27,11,16,29,73,66,1,DF,30-34,Defender,Albania,Europe
201,Fodé Ballo-Touré,SEN,Fulham,Premier League,2023,26.0,1997.0,0.8,4,2,1,3,0,1,2,50.0,1,1,0,1,3,7,2,0,"DF,MF",25-29,Defender,Senegal,Africa
202,Folarin Balogun,USA,Monaco,Ligue 1,2023,22.0,2001.0,18.8,12,4,3,8,1,5,13,38.5,8,10,0,10,3,15,4,0,FW,20-24,Forward,United States,North America
203,Jonathan Bamba,CIV,Celta Vigo,La Liga,2023,27.0,1996.0,22.0,14,9,4,8,2,2,17,11.8,15,20,0,20,18,32,12,0,"MF,FW",25-29,Midfielder,Ivory Coast,Africa
204,Mohamed Bamba,CIV,Lorient,Ligue 1,2023,21.0,2001.0,12.6,14,9,3,8,3,4,10,40.0,6,7,1,6,2,16,3,0,FW,20-24,Forward,Ivory Coast,Africa
204,Mohamed Bamba,CIV,Lorient,Ligue 1,2023,21.0,2001.0,12.6,14,9,3,8,3,4,10,40.0,6,7,1,6,2,16,3,0,FW,20-24,Forward,Ivory Coast,Africa
204,Mohamed Bamba,CIV,Lorient,Ligue 1,2023,21.0,2001.0,12.6,14,9,3,8,3,4,10,40.0,6,7,1,6,2,16,3,0,FW,20-24,Forward,Ivory Coast,Africa
204,Mohamed Bamba,CIV,Lorient,Ligue 1,2023,21.0,2001.0,12.6,14,9,3,8,3,4,10,40.0,6,7,1,6,2,16,3,0,FW,20-24,Forward,Ivory Coast,Africa
205,Samuel Bamba,GER,Dortmund,Bundesliga,2023,19.0,2004.0,0.5,1,1,1,0,0,1,2,50.0,1,0,0,0,0,1,1,0,FW,Under 20,Forward,Germany,Europe
206,Lameck Banda,ZAM,Lecce,Serie A,2023,22.0,2001.0,15.0,27,23,11,12,4,7,21,33.3,14,18,0,18,3,30,7,0,FW,20-24,Forward,Zambia,Africa
207,Daniel Bandeira,POR,Hellas Verona,Serie A,2023,23.0,2000.0,5.0,6,5,1,4,1,3,7,42.9,4,3,0,3,3,9,9,0,MF,20-24,Midfielder,Portugal,Europe
208,Mamady Bangré,BFA,Toulouse,Ligue 1,2023,22.0,2001.0,1.1,4,2,2,2,0,3,4,75.0,1,0,0,0,4,8,3,0,"FW,MF",20-24,Forward,Burkina Faso,Africa
209,Mattia Bani,ITA,Genoa,Serie A,2023,29.0,1993.0,25.6,26,10,18,7,1,11,22,50.0,11,51,31,20,22,48,116,1,DF,25-29,Defender,Italy,Europe
210,Léo Baptistão,BRA,Almería,La Liga,2023,30.0,1992.0,20.4,25,16,12,8,5,9,25,36.0,16,13,1,12,11,36,22,0,FW,30-34,Forward,Brazil,South America
211,Shandon Baptiste,GRN,Brentford,Premier League,2023,25.0,1998.0,2.5,4,4,2,2,0,1,5,20.0,4,5,1,4,3,7,6,0,MF,25-29,Midfielder,Grenada,North America
213,Valentín Barco,ARG,Brighton,Premier League,2023,19.0,2004.0,3.4,11,5,4,5,2,6,8,75.0,2,3,0,3,4,15,3,1,"DF,FW",Under 20,Defender,Argentina,South America
214,Bradley Barcola,FRA,Lyon,Ligue 1,2023,20.0,2002.0,3.0,5,2,0,2,3,1,7,14.3,6,4,0,4,2,7,0,0,FW,20-24,Forward,France,Europe
215,Bradley Barcola,FRA,Paris S-G,Ligue 1,2023,20.0,2002.0,15.2,34,16,12,13,9,7,25,28.0,18,27,2,25,10,44,13,1,"FW,MF",20-24,Forward,France,Europe
216,Melvin Bard,FRA,Nice,Ligue 1,2023,22.0,2000.0,29.5,69,38,28,30,11,37,63,58.7,26,46,12,34,42,111,46,0,DF,20-24,Defender,France,Europe
217,Nicolò Barella,ITA,Inter,Serie A,2023,26.0,1997.0,31.6,46,30,17,20,9,19,63,30.2,44,31,1,30,10,56,12,1,MF,25-29,Midfielder,Italy,Europe
219,Ross Barkley,ENG,Luton Town,Premier League,2023,29.0,1993.0,29.1,47,19,16,21,10,11,48,22.9,37,25,9,16,25,72,51,2,MF,25-29,Midfielder,England,Europe
220,Aymen Barkok,MAR,Mainz 05,Bundesliga,2023,25.0,1998.0,3.6,9,5,2,6,1,3,6,50.0,3,7,0,7,2,11,1,0,"MF,FW",25-29,Midfielder,Morocco,Africa
221,Harvey Barnes,ENG,Newcastle Utd,Premier League,2023,25.0,1997.0,8.9,6,1,3,2,1,1,2,50.0,1,1,0,1,5,11,3,0,"FW,MF",25-29,Forward,England,Europe
222,Leandro Barreiro Martins,LUX,Mainz 05,Bundesliga,2023,23.0,2000.0,29.0,65,40,19,37,9,30,50,60.0,20,45,16,29,36,101,53,0,MF,20-24,Midfielder,Luxembourg,Europe
223,Enzo Barrenechea,ARG,Frosinone,Serie A,2023,22.0,2001.0,31.2,65,42,28,29,8,28,70,40.0,42,47,12,35,27,92,61,2,MF,20-24,Midfielder,Argentina,South America
226,Davide Bartesaghi,ITA,Milan,Serie A,2023,17.0,2005.0,0.9,2,0,1,1,0,2,4,50.0,2,1,1,0,0,2,7,0,"DF,MF",Under 20,Defender,Italy,Europe
228,Federico Baschirotto,ITA,Lecce,Serie A,2023,26.0,1996.0,36.6,21,12,16,5,0,8,15,53.3,7,42,26,16,23,44,144,1,DF,25-29,Defender,Italy,Europe
229,Steven Baseya,FRA,Strasbourg,Ligue 1,2023,18.0,2005.0,0.1,2,1,1,1,0,1,1,100.0,0,0,0,0,0,2,1,0,DF,Under 20,Defender,France,Europe
230,Chris Basham,ENG,Sheffield Utd,Premier League,2023,35.0,1988.0,3.6,7,2,4,3,0,2,9,22.2,7,9,4,5,5,12,17,0,"DF,MF",35-39,Defender,England,Europe
231,Toma Bašić,CRO,Salernitana,Serie A,2023,26.0,1996.0,12.9,20,13,10,9,1,10,27,37.0,17,18,6,12,14,34,29,0,MF,25-29,Midfielder,Croatia,Europe
232,Calvin Bassey,NGA,Fulham,Premier League,2023,23.0,1999.0,25.6,49,29,33,15,1,21,29,72.4,8,32,11,21,28,77,84,4,DF,20-24,Defender,Nigeria,Africa
233,Alessandro Bastoni,ITA,Inter,Serie A,2023,24.0,1999.0,25.2,46,33,31,12,3,26,40,65.0,14,25,11,14,23,69,48,1,DF,20-24,Defender,Italy,Europe
234,Simone Bastoni,ITA,Empoli,Serie A,2023,26.0,1996.0,8.3,22,13,12,7,3,11,22,50.0,11,8,0,8,11,33,18,0,"MF,DF",25-29,Midfielder,Italy,Europe
235,Augusto Batalla,ARG,Granada,La Liga,2023,27.0,1996.0,17.0,0,0,0,0,0,0,1,0.0,1,0,0,0,0,0,10,2,GK,25-29,Goalkeeper,Argentina,South America
236,Daniel Batz,GER,Mainz 05,Bundesliga,2023,32.0,1991.0,4.0,0,0,0,0,0,0,0,,0,0,0,0,0,0,3,0,GK,30-34,Goalkeeper,Germany,Europe
237,Maximilian Bauer,GER,Augsburg,Bundesliga,2023,23.0,2000.0,9.0,19,12,13,4,2,9,17,52.9,8,14,8,6,11,30,30,1,DF,20-24,Defender,Germany,Europe
238,Elias Baum,GER,Eint Frankfurt,Bundesliga,2023,17.0,2005.0,0.3,1,0,0,0,1,0,0,,0,3,2,1,0,1,1,0,"DF,MF",Under 20,Defender,Germany,Europe
239,Oliver Baumann,GER,Hoffenheim,Bundesliga,2023,33.0,1990.0,34.0,1,1,1,0,0,1,2,50.0,1,0,0,0,0,1,19,2,GK,30-34,Goalkeeper,Germany,Europe
240,Christoph Baumgartner,AUT,RB Leipzig,Bundesliga,2023,23.0,1999.0,12.9,26,13,10,12,4,14,38,36.8,24,20,1,19,5,31,14,0,"MF,FW",20-24,Midfielder,Austria,Europe
241,Bebé,CPV,Rayo Vallecano,La Liga,2023,33.0,1990.0,2.4,2,2,1,1,0,1,5,20.0,4,1,0,1,0,2,0,0,"MF,FW",30-34,Midfielder,Cape Verde,Africa
243,Mohamed Bechikh,FRA,Strasbourg,Ligue 1,2023,18.0,2005.0,0.2,0,0,0,0,0,0,0,,0,0,0,0,0,0,0,0,"FW,MF",Under 20,Forward,France,Europe
244,Adrian Beck,GER,Heidenheim,Bundesliga,2023,26.0,1997.0,10.8,22,13,8,12,2,9,24,37.5,15,17,0,17,4,26,15,0,"MF,FW",25-29,Midfielder,Germany,Europe
245,Owen Beck,WAL,Liverpool,Premier League,2023,20.0,2002.0,0.1,2,1,1,1,0,0,0,,0,0,0,0,0,2,1,0,DF,20-24,Defender,Wales,Europe
246,Sheraldo Becker,SUR,Real Sociedad,La Liga,2023,28.0,1995.0,8.6,2,2,0,2,0,0,1,0.0,1,3,0,3,1,3,0,0,"FW,MF",25-29,Forward,Suriname,South America
247,Sheraldo Becker,SUR,Union Berlin,Bundesliga,2023,28.0,1995.0,7.2,3,3,0,2,1,0,2,0.0,2,2,0,2,0,3,2,0,"FW,MF",25-29,Forward,Suriname,South America
248,Chris Bedia,CIV,Union Berlin,Bundesliga,2023,27.0,1996.0,1.6,2,1,0,2,0,0,1,0.0,1,3,0,3,0,2,2,0,"FW,MF",25-29,Forward,Ivory Coast,Africa
249,Donny van de Beek,NED,Manchester Utd,Premier League,2023,26.0,1997.0,0.0,0,0,0,0,0,0,0,,0,1,0,1,0,0,0,0,DF,25-29,Defender,Netherlands,Europe
250,Donny van de Beek,NED,Eint Frankfurt,Bundesliga,2023,26.0,1997.0,4.0,8,3,3,3,2,3,7,42.9,4,5,1,4,3,11,1,0,"MF,FW",25-29,Midfielder,Netherlands,Europe
251,Yanis Begraoui,MAR,Toulouse,Ligue 1,2023,22.0,2001.0,3.3,5,3,1,3,1,3,9,33.3,6,4,0,4,5,10,5,0,"FW,MF",20-24,Forward,Morocco,Africa
252,Kevin Behrens,GER,Wolfsburg,Bundesliga,2023,32.0,1991.0,6.8,2,1,0,1,1,0,2,0.0,2,9,0,9,3,5,6,0,FW,30-34,Forward,Germany,Europe
253,Kevin Behrens,GER,Union Berlin,Bundesliga,2023,32.0,1991.0,14.0,13,10,3,7,3,1,4,25.0,3,7,2,5,6,19,19,0,FW,30-34,Forward,Germany,Europe
254,Maximilian Beier,GER,Hoffenheim,Bundesliga,2023,20.0,2002.0,26.9,20,12,5,11,4,4,19,21.1,15,21,1,20,9,29,12,0,"FW,MF",20-24,Forward,Germany,Europe
255,Jérémie Bela,ANG,Clermont Foot,Ligue 1,2023,30.0,1993.0,2.3,1,1,0,1,0,1,3,33.3,2,1,0,1,0,1,1,0,"MF,FW",30-34,Midfielder,Angola,Africa
256,Reda Belahyane,MAR,Hellas Verona,Serie A,2023,19.0,2004.0,1.0,1,1,0,1,0,1,1,100.0,0,0,0,0,1,2,0,0,MF,Under 20,Midfielder,Morocco,Africa
257,Reda Belahyane,MAR,Nice,Ligue 1,2023,19.0,2004.0,0.3,1,0,0,1,0,1,1,100.0,0,0,0,0,0,1,0,0,MF,Under 20,Midfielder,Morocco,Africa
258,Amari'i Bell,JAM,Luton Town,Premier League,2023,29.0,1994.0,19.1,50,33,30,19,1,22,35,62.9,13,33,15,18,25,75,60,1,DF,25-29,Defender,Jamaica,North America
259,Stefan Bell,GER,Mainz 05,Bundesliga,2023,31.0,1991.0,7.4,8,8,7,1,0,4,8,50.0,4,7,5,2,6,14,30,0,DF,30-34,Defender,Germany,Europe
260,Alaa Bellaarouch,MAR,Strasbourg,Ligue 1,2023,21.0,2002.0,15.0,0,0,0,0,0,0,0,,0,0,0,0,1,1,11,2,GK,20-24,Goalkeeper,Morocco,Africa
261,Raoul Bellanova,ITA,Torino,Serie A,2023,23.0,2000.0,33.8,36,26,15,17,4,18,31,58.1,13,21,4,17,15,51,36,3,DF,20-24,Defender,Italy,Europe
262,Jean-Ricner Bellegarde,FRA,Wolves,Premier League,2023,25.0,1998.0,10.6,17,10,9,6,2,7,15,46.7,8,18,2,16,8,25,14,0,"MF,FW",25-29,Midfielder,France,Europe
263,Jean-Ricner Bellegarde,FRA,Strasbourg,Ligue 1,2023,25.0,1998.0,3.0,5,3,3,2,0,3,6,50.0,3,4,0,4,4,9,0,0,"MF,FW",25-29,Midfielder,France,Europe
265,Jude Bellingham,ENG,Real Madrid,La Liga,2023,20.0,2003.0,25.7,42,34,14,18,10,12,36,33.3,24,55,5,50,21,63,17,0,MF,20-24,Midfielder,England,Europe
266,Jeanuël Belocian,FRA,Rennes,Ligue 1,2023,18.0,2005.0,16.1,32,22,23,8,1,22,28,78.6,6,18,10,8,13,45,49,0,DF,Under 20,Defender,France,Europe
267,Andrea Belotti,ITA,Fiorentina,Serie A,2023,29.0,1993.0,10.5,8,3,1,5,2,5,12,41.7,7,8,1,7,2,10,3,0,FW,25-29,Forward,Italy,Europe
268,Andrea Belotti,ITA,Roma,Serie A,2023,29.0,1993.0,7.5,8,4,2,3,3,3,6,50.0,3,7,0,7,2,10,3,0,FW,25-29,Forward,Italy,Europe
270,Lucas Beltrán,ARG,Fiorentina,Serie A,2023,22.0,2001.0,18.8,27,14,4,18,5,11,20,55.0,9,29,3,26,2,29,11,0,"FW,MF",20-24,Forward,Argentina,South America
271,Eliesse Ben Seghir,MAR,Monaco,Ligue 1,2023,18.0,2005.0,4.8,9,6,2,5,2,3,7,42.9,4,6,0,6,2,11,2,0,"MF,FW",Under 20,Midfielder,Morocco,Africa
272,Anis Ben Slimane,TUN,Sheffield Utd,Premier League,2023,22.0,2001.0,4.7,11,6,5,2,4,4,10,40.0,6,7,1,6,5,16,7,0,MF,20-24,Midfielder,Tunisia,Africa
273,Wissam Ben Yedder,FRA,Monaco,Ligue 1,2023,32.0,1990.0,25.7,4,3,1,2,1,1,11,9.1,10,18,0,18,8,12,1,0,FW,30-34,Forward,France,Europe
274,Carlos Benavídez,URU,Alavés,La Liga,2023,25.0,1998.0,12.6,56,35,19,26,11,19,34,55.9,15,13,5,8,19,75,31,0,MF,25-29,Midfielder,Uruguay,South America
275,Ismaël Bennacer,ALG,Milan,Serie A,2023,25.0,1997.0,12.8,29,19,11,16,2,11,22,50.0,11,12,4,8,12,41,9,2,MF,25-29,Midfielder,Algeria,Africa
276,Saïd Benrahma,ALG,West Ham,Premier League,2023,27.0,1995.0,6.9,8,4,5,3,0,4,15,26.7,11,8,0,8,5,13,7,0,"FW,MF",25-29,Forward,Algeria,Africa
277,Saïd Benrahma,ALG,Lyon,Ligue 1,2023,27.0,1995.0,8.6,9,7,1,6,2,5,7,71.4,2,7,0,7,1,10,3,0,"FW,MF",25-29,Forward,Algeria,Africa
278,Ramy Bensebaini,ALG,Dortmund,Bundesliga,2023,28.0,1995.0,11.5,34,21,21,11,2,24,34,70.6,10,22,7,15,16,50,37,0,DF,25-29,Defender,Algeria,Africa
279,Nabil Bentaleb,ALG,Lille,Ligue 1,2023,28.0,1994.0,21.9,49,32,29,18,2,22,43,51.2,21,33,12,21,37,86,33,0,MF,25-29,Midfielder,Algeria,Africa
280,Rodrigo Bentancur,URU,Tottenham,Premier League,2023,26.0,1997.0,11.2,23,15,10,11,2,10,24,41.7,14,15,4,11,17,40,16,1,MF,25-29,Midfielder,Uruguay,South America
281,Daniel Bentley,ENG,Wolves,Premier League,2023,30.0,1993.0,4.3,0,0,0,0,0,0,1,0.0,1,0,0,0,0,0,1,0,GK,30-34,Goalkeeper,England,Europe
282,Lucas Beraldo,BRA,Paris S-G,Ligue 1,2023,19.0,2003.0,11.2,22,14,14,8,0,10,25,40.0,15,15,6,9,20,42,25,0,DF,Under 20,Defender,Brazil,South America
283,Domenico Berardi,ITA,Sassuolo,Serie A,2023,28.0,1994.0,15.9,17,8,7,9,1,2,21,9.5,19,17,0,17,13,30,9,0,FW,25-29,Forward,Italy,Europe
287,Jóhann Berg Guðmundsson,ISL,Burnley,Premier League,2023,32.0,1990.0,13.2,13,4,6,5,2,7,16,43.8,9,14,0,14,16,29,16,0,"MF,FW",30-34,Midfielder,Iceland,Europe
289,Etrit Berisha,ALB,Empoli,Serie A,2023,34.0,1989.0,14.0,0,0,0,0,0,0,1,0.0,1,0,0,0,0,0,7,1,GK,30-34,Goalkeeper,Albania,Europe
290,Medon Berisha,ALB,Lecce,Serie A,2023,19.0,2003.0,2.3,3,1,3,0,0,0,2,0.0,2,2,2,0,1,4,0,0,"FW,MF",Under 20,Forward,Albania,Europe
291,Mergim Berisha,GER,Hoffenheim,Bundesliga,2023,25.0,1998.0,1.6,0,0,0,0,0,0,0,,0,2,1,1,0,0,0,0,FW,25-29,Forward,Germany,Europe
292,Mergim Berisha,GER,Augsburg,Bundesliga,2023,25.0,1998.0,1.4,0,0,0,0,0,0,0,,0,1,0,1,0,0,3,0,FW,25-29,Forward,Germany,Europe
293,Bernardo,BRA,Bochum,Bundesliga,2023,28.0,1995.0,32.5,99,58,56,35,8,45,69,65.2,24,66,30,36,55,154,120,1,DF,25-29,Defender,Brazil,South America
293,Bernardo,BRA,Bochum,Bundesliga,2023,28.0,1995.0,32.5,99,58,56,35,8,45,69,65.2,24,66,30,36,55,154,120,1,DF,25-29,Defender,Brazil,South America
293,Bernardo,BRA,Bochum,Bundesliga,2023,28.0,1995.0,32.5,99,58,56,35,8,45,69,65.2,24,66,30,36,55,154,120,1,DF,25-29,Defender,Brazil,South America
293,Bernardo,BRA,Bochum,Bundesliga,2023,28.0,1995.0,32.5,99,58,56,35,8,45,69,65.2,24,66,30,36,55,154,120,1,DF,25-29,Defender,Brazil,South America
294,Victor Bernth Kristiansen,DEN,Bologna,Serie A,2023,20.0,2002.0,25.6,52,34,23,22,7,20,35,57.1,15,35,8,27,12,64,45,1,DF,20-24,Defender,Denmark,Europe
295,Matúš Bero,SVK,Bochum,Bundesliga,2023,27.0,1995.0,18.5,32,22,13,12,7,13,32,40.6,19,24,3,21,12,44,26,0,"MF,FW",25-29,Midfielder,Slovakia,Europe
296,Luke Berry,ENG,Luton Town,Premier League,2023,31.0,1992.0,3.6,7,2,2,4,1,2,3,66.7,1,6,1,5,0,7,3,0,"MF,DF",30-34,Midfielder,England,Europe
297,Dimitry Bertaud,COD,Montpellier,Ligue 1,2023,25.0,1998.0,4.0,0,0,0,0,0,0,0,,0,0,0,0,0,0,0,0,GK,25-29,Goalkeeper,DR Congo,Africa
298,Jan-Niklas Beste,GER,Heidenheim,Bundesliga,2023,24.0,1999.0,28.9,77,49,35,24,18,28,55,50.9,27,48,1,47,18,95,31,0,"FW,MF",20-24,Forward,Germany,Europe
299,Beto,GNB,Everton,Premier League,2023,25.0,1998.0,10.6,14,6,1,6,7,4,12,33.3,8,11,0,11,1,15,14,0,FW,25-29,Forward,Guinea-Bissau,Africa
299,Beto,GNB,Everton,Premier League,2023,25.0,1998.0,10.6,14,6,1,6,7,4,12,33.3,8,11,0,11,1,15,14,0,FW,25-29,Forward,Guinea-Bissau,Africa
299,Beto,GNB,Everton,Premier League,2023,25.0,1998.0,10.6,14,6,1,6,7,4,12,33.3,8,11,0,11,1,15,14,0,FW,25-29,Forward,Guinea-Bissau,Africa
299,Beto,GNB,Everton,Premier League,2023,25.0,1998.0,10.6,14,6,1,6,7,4,12,33.3,8,11,0,11,1,15,14,0,FW,25-29,Forward,Guinea-Bissau,Africa
300,Beto,GNB,Udinese,Serie A,2023,25.0,1998.0,0.8,1,0,0,0,1,0,0,,0,0,0,0,0,1,0,0,FW,25-29,Forward,Guinea-Bissau,Africa
300,Beto,GNB,Udinese,Serie A,2023,25.0,1998.0,0.8,1,0,0,0,1,0,0,,0,0,0,0,0,1,0,0,FW,25-29,Forward,Guinea-Bissau,Africa
300,Beto,GNB,Udinese,Serie A,2023,25.0,1998.0,0.8,1,0,0,0,1,0,0,,0,0,0,0,0,1,0,0,FW,25-29,Forward,Guinea-Bissau,Africa
300,Beto,GNB,Udinese,Serie A,2023,25.0,1998.0,0.8,1,0,0,0,1,0,0,,0,0,0,0,0,1,0,0,FW,25-29,Forward,Guinea-Bissau,Africa
301,Davide Bettella,ITA,Monza,Serie A,2023,23.0,2000.0,0.0,0,0,0,0,0,0,0,,0,0,0,0,0,0,0,0,MF,20-24,Midfielder,Italy,Europe
302,Sam Beukema,NED,Bologna,Serie A,2023,24.0,1998.0,28.3,27,11,14,11,2,16,25,64.0,9,35,21,14,15,42,99,2,DF,20-24,Defender,Netherlands,Europe
303,Jordan Beyer,GER,Burnley,Premier League,2023,23.0,2000.0,13.7,35,20,22,12,1,14,24,58.3,10,22,15,7,16,51,68,1,DF,20-24,Defender,Germany,Europe
306,El Bilal Touré,MLI,Atalanta,Serie A,2023,21.0,2001.0,4.4,1,1,0,1,0,0,1,0.0,1,0,0,0,1,2,2,0,FW,20-24,Forward,Mali,Africa
307,Philip Billing,DEN,Bournemouth,Premier League,2023,27.0,1996.0,15.5,33,16,7,22,4,9,27,33.3,18,31,5,26,20,53,28,1,MF,25-29,Midfielder,Denmark,Europe
308,Cristiano Biraghi,ITA,Fiorentina,Serie A,2023,30.0,1992.0,26.2,47,28,20,24,3,28,52,53.8,24,30,5,25,14,61,43,0,DF,30-34,Defender,Italy,Europe
309,Davide Biraschi,ITA,Genoa,Serie A,2023,29.0,1994.0,1.0,3,3,1,2,0,1,3,33.3,2,0,0,0,2,5,5,0,DF,25-29,Defender,Italy,Europe
310,Samuele Birindelli,ITA,Monza,Serie A,2023,24.0,1999.0,22.4,28,19,16,7,5,14,25,56.0,11,30,11,19,18,46,48,0,DF,20-24,Defender,Italy,Europe
311,Tom Bischof,GER,Hoffenheim,Bundesliga,2023,18.0,2005.0,2.0,8,4,6,1,1,2,9,22.2,7,3,0,3,1,9,2,0,"MF,FW",Under 20,Midfielder,Germany,Europe
312,Yves Bissouma,MLI,Tottenham,Premier League,2023,26.0,1996.0,23.0,80,52,32,36,12,41,61,67.2,20,28,5,23,37,117,43,3,MF,25-29,Midfielder,Mali,Africa
313,Leonardo Bittencourt,GER,Werder Bremen,Bundesliga,2023,29.0,1993.0,17.5,42,18,20,17,5,15,39,38.5,24,18,1,17,13,55,6,0,MF,25-29,Midfielder,Germany,Europe
314,Marco Bizot,NED,Brest,Ligue 1,2023,32.0,1991.0,32.0,0,0,0,0,0,0,1,0.0,1,0,0,0,0,0,18,3,GK,30-34,Goalkeeper,Netherlands,Europe
317,Hendry Blank,GER,Dortmund,Bundesliga,2023,18.0,2004.0,0.5,1,0,1,0,0,1,1,100.0,0,1,0,1,0,1,4,0,DF,Under 20,Defender,Germany,Europe
318,Ludovic Blas,FRA,Rennes,Ligue 1,2023,25.0,1997.0,17.4,30,14,16,13,1,12,28,42.9,16,13,1,12,6,36,9,0,"FW,MF",25-29,Forward,France,Europe
319,Janis Blaswich,GER,RB Leipzig,Bundesliga,2023,32.0,1991.0,21.0,1,1,1,0,0,0,0,,0,0,0,0,0,1,7,3,GK,30-34,Goalkeeper,Germany,Europe
320,Alexis Blin,FRA,Lecce,Serie A,2023,26.0,1996.0,18.2,33,19,11,19,3,15,43,34.9,28,16,2,14,22,55,39,0,MF,25-29,Midfielder,France,Europe
321,Daley Blind,NED,Girona,La Liga,2023,33.0,1990.0,33.0,47,21,33,13,1,29,47,61.7,18,37,19,18,21,68,113,0,DF,30-34,Defender,Netherlands,Europe
322,Myron Boadu,NED,Monaco,Ligue 1,2023,22.0,2001.0,0.9,2,2,0,1,1,1,2,50.0,1,2,0,2,0,2,0,0,FW,20-24,Forward,Netherlands,Europe
323,Benicio Boaitey,ENG,Brighton,Premier League,2023,19.0,2004.0,0.4,0,0,0,0,0,0,1,0.0,1,1,0,1,0,0,2,0,"FW,DF",Under 20,Forward,England,Europe
324,Jérôme Boateng,GER,Salernitana,Serie A,2023,34.0,1988.0,2.6,0,0,0,0,0,0,0,,0,6,5,1,4,4,21,0,DF,30-34,Defender,Germany,Europe
326,Sacha Boey,FRA,Bayern Munich,Bundesliga,2023,22.0,2000.0,1.2,2,0,2,0,0,1,2,50.0,1,1,0,1,1,3,2,0,DF,20-24,Defender,France,Europe
327,Jeremie Boga,CIV,Nice,Ligue 1,2023,26.0,1997.0,22.2,18,7,6,10,2,10,20,50.0,10,26,2,24,8,26,4,0,FW,25-29,Forward,Ivory Coast,Africa
328,Jayden Bogle,ENG,Sheffield Utd,Premier League,2023,23.0,2000.0,31.0,66,36,43,21,2,35,70,50.0,35,42,11,31,32,98,97,0,DF,20-24,Defender,England,Europe
331,Adama Bojang,GAM,Reims,Ligue 1,2023,19.0,2004.0,0.9,2,1,1,0,1,0,0,,0,2,1,1,1,3,0,0,FW,Under 20,Forward,Gambia,Africa
332,Daniel Boloca,ROU,Sassuolo,Serie A,2023,24.0,1998.0,22.5,48,33,18,25,5,27,46,58.7,19,23,13,10,14,62,33,2,MF,20-24,Midfielder,Romania,Europe
333,Willy Boly,CIV,Nott'ham Forest,Premier League,2023,32.0,1991.0,16.0,46,29,36,9,1,22,40,55.0,18,32,21,11,25,71,90,0,DF,30-34,Defender,Ivory Coast,Africa
334,Giacomo Bonaventura,ITA,Fiorentina,Serie A,2023,33.0,1989.0,25.3,26,13,6,10,10,9,21,42.9,12,16,1,15,14,40,10,0,MF,30-34,Midfielder,Italy,Europe
335,Federico Bonazzoli,ITA,Hellas Verona,Serie A,2023,26.0,1997.0,11.3,4,1,1,3,0,1,8,12.5,7,9,1,8,3,7,3,0,"FW,MF",25-29,Forward,Italy,Europe
336,Warren Bondo,FRA,Monza,Serie A,2023,19.0,2003.0,16.4,29,22,16,10,3,13,17,76.5,4,13,3,10,6,35,13,0,MF,Under 20,Midfielder,France,Europe
337,Giovanni Bonfanti,ITA,Atalanta,Serie A,2023,20.0,2003.0,1.0,4,2,2,2,0,2,3,66.7,1,1,1,0,1,5,1,0,DF,20-24,Defender,Italy,Europe
338,Victor Boniface,NGA,Leverkusen,Bundesliga,2023,22.0,2000.0,17.2,6,4,0,1,5,1,4,25.0,3,6,1,5,0,6,13,0,FW,20-24,Forward,Nigeria,Africa
339,Kevin Bonifazi,ITA,Bologna,Serie A,2023,27.0,1996.0,1.0,4,0,0,4,0,1,2,50.0,1,0,0,0,0,4,7,1,DF,25-29,Defender,Italy,Europe
340,Kevin Bonifazi,ITA,Frosinone,Serie A,2023,27.0,1996.0,3.4,5,3,2,3,0,2,3,66.7,1,1,0,1,3,8,9,0,DF,25-29,Defender,Italy,Europe
341,Leonardo Bonucci,ITA,Union Berlin,Bundesliga,2023,36.0,1987.0,5.1,6,5,2,4,0,4,4,100.0,0,5,3,2,7,13,16,0,DF,35-39,Defender,Italy,Europe
342,Neto Borges,BRA,Clermont Foot,Ligue 1,2023,26.0,1996.0,28.0,48,24,25,18,5,28,63,44.4,35,28,6,22,57,105,84,0,DF,25-29,Defender,Brazil,South America
343,Yvandro Borges Sanches,LUX,Gladbach,Bundesliga,2023,19.0,2004.0,0.2,0,0,0,0,0,0,0,,0,0,0,0,0,0,0,0,"MF,FW",Under 20,Midfielder,Luxembourg,Europe
344,Sebastiaan Bornauw,BEL,Wolfsburg,Bundesliga,2023,24.0,1999.0,15.9,26,12,19,7,0,13,19,68.4,6,21,12,9,18,44,81,0,DF,20-24,Defender,Belgium,Europe
345,Rafael Borré,COL,Werder Bremen,Bundesliga,2023,27.0,1995.0,11.0,10,7,2,4,4,5,16,31.3,11,8,2,6,2,12,10,0,FW,25-29,Forward,Colombia,South America
346,Gennaro Borrelli,ITA,Frosinone,Serie A,2023,23.0,2000.0,0.3,0,0,0,0,0,0,0,,0,0,0,0,0,0,0,0,FW,20-24,Forward,Italy,Europe
349,Sven Botman,NED,Newcastle Utd,Premier League,2023,23.0,2000.0,15.3,20,13,14,6,0,8,13,61.5,5,20,16,4,9,29,61,3,DF,20-24,Defender,Netherlands,Europe
350,Saïmon Bouabré,FRA,Monaco,Ligue 1,2023,17.0,2006.0,0.5,2,2,0,2,0,1,2,50.0,1,1,0,1,0,2,0,0,MF,Under 20,Midfielder,France,Europe
351,Ayyoub Bouaddi,FRA,Lille,Ligue 1,2023,15.0,2007.0,1.5,6,2,6,0,0,2,5,40.0,3,2,0,2,1,7,3,0,MF,Under 20,Midfielder,France,Europe
352,Badredine Bouanani,ALG,Nice,Ligue 1,2023,18.0,2004.0,1.8,3,2,1,1,1,3,4,75.0,1,5,0,5,3,6,0,0,FW,Under 20,Forward,Algeria,Africa
353,Badredine Bouanani,ALG,Lorient,Ligue 1,2023,18.0,2004.0,4.9,4,2,1,1,2,2,4,50.0,2,3,0,3,2,6,3,0,MF,Under 20,Midfielder,Algeria,Africa
354,Mohamed Bouchenna,FRA,Clermont Foot,Ligue 1,2023,17.0,2006.0,0.3,1,0,1,0,0,0,0,,0,0,0,0,0,1,0,0,"MF,FW",Under 20,Midfielder,France,Europe
355,Hicham Boudaoui,ALG,Nice,Ligue 1,2023,23.0,1999.0,17.9,41,19,16,22,3,21,30,70.0,9,15,1,14,11,52,15,0,MF,20-24,Midfielder,Algeria,Africa
356,Yassine Bounou,MAR,Sevilla,La Liga,2023,32.0,1991.0,1.0,0,0,0,0,0,0,0,,0,0,0,0,0,0,0,0,GK,30-34,Goalkeeper,Morocco,Africa
357,Mehdi Bourabia,MAR,Frosinone,Serie A,2023,31.0,1991.0,2.2,5,4,1,4,0,2,4,50.0,2,3,0,3,0,5,4,0,MF,30-34,Midfielder,Morocco,Africa
358,Benjamin Bourigeaud,FRA,Rennes,Ligue 1,2023,29.0,1994.0,26.9,31,18,14,9,8,13,44,29.5,31,31,2,29,22,53,39,2,"MF,FW",25-29,Midfielder,France,Europe
359,Bilal Boutobba,FRA,Clermont Foot,Ligue 1,2023,24.0,1998.0,10.3,22,12,6,10,6,10,23,43.5,13,9,0,9,8,30,3,0,"FW,MF",20-24,Forward,France,Europe
360,Hugo Boutsingkham,FRA,Nantes,Ligue 1,2023,20.0,2003.0,0.1,0,0,0,0,0,0,0,,0,0,0,0,0,0,1,0,"MF,FW",20-24,Midfielder,France,Europe
361,Edoardo Bove,ITA,Roma,Serie A,2023,21.0,2002.0,19.8,60,31,16,31,13,27,46,58.7,19,21,1,20,11,71,11,1,MF,20-24,Midfielder,Italy,Europe
362,Jarrod Bowen,ENG,West Ham,Premier League,2023,26.0,1996.0,33.5,42,28,14,14,14,13,35,37.1,22,37,5,32,19,61,14,0,FW,25-29,Forward,England,Europe
363,Lucas Boyé,ARG,Granada,La Liga,2023,27.0,1996.0,28.2,50,25,14,25,11,14,34,41.2,20,35,5,30,10,60,46,0,FW,25-29,Forward,Argentina,South America
364,Domagoj Bradarić,CRO,Salernitana,Serie A,2023,23.0,1999.0,30.5,29,20,13,10,6,15,25,60.0,10,22,7,15,32,61,62,1,DF,20-24,Defender,Croatia,Europe
366,Bilal Brahimi,ALG,Nice,Ligue 1,2023,23.0,2000.0,0.1,0,0,0,0,0,0,1,0.0,1,0,0,0,0,0,0,0,FW,20-24,Forward,Algeria,Africa
367,Bilal Brahimi,ALG,Brest,Ligue 1,2023,23.0,2000.0,2.5,0,0,0,0,0,0,3,0.0,3,3,0,3,0,0,0,0,"FW,MF",20-24,Forward,Algeria,Africa
368,Julian Brandt,GER,Dortmund,Bundesliga,2023,27.0,1996.0,24.7,17,14,8,8,1,10,27,37.0,17,20,3,17,8,25,18,0,"MF,FW",25-29,Midfielder,Germany,Europe
369,Jarrad Branthwaite,ENG,Everton,Premier League,2023,21.0,2002.0,34.6,66,32,42,22,2,45,62,72.6,17,51,36,15,50,116,163,2,DF,20-24,Defender,England,Europe
371,Lilian Brassier,FRA,Brest,Ligue 1,2023,23.0,1999.0,29.7,31,18,18,13,0,12,24,50.0,12,28,21,7,41,72,93,0,DF,20-24,Defender,France,Europe
373,Claudio Bravo,CHI,Betis,La Liga,2023,40.0,1983.0,7.0,0,0,0,0,0,0,1,0.0,1,0,0,0,0,0,2,0,GK,Over 40,Goalkeeper,Chile,South America
374,Fabian Bredlow,GER,Stuttgart,Bundesliga,2023,28.0,1995.0,4.0,0,0,0,0,0,0,1,0.0,1,0,0,0,0,0,3,0,GK,25-29,Goalkeeper,Germany,Europe
375,Tim Breithaupt,GER,Augsburg,Bundesliga,2023,21.0,2002.0,7.0,20,11,11,9,0,13,21,61.9,8,15,3,12,8,28,10,0,MF,20-24,Midfielder,Germany,Europe
376,Josip Brekalo,CRO,Fiorentina,Serie A,2023,25.0,1998.0,7.2,8,6,6,2,0,2,11,18.2,9,7,0,7,1,9,0,0,FW,25-29,Forward,Croatia,Europe
377,Gleison Bremer,BRA,Juventus,Serie A,2023,26.0,1997.0,35.9,58,42,32,21,5,21,29,72.4,8,45,27,18,40,98,147,0,DF,25-29,Defender,Brazil,South America
378,Brenner,BRA,Udinese,Serie A,2023,23.0,2000.0,2.1,8,7,1,5,2,4,7,57.1,3,2,0,2,0,8,2,0,"MF,FW",20-24,Midfielder,Brazil,South America
378,Brenner,BRA,Udinese,Serie A,2023,23.0,2000.0,2.1,8,7,1,5,2,4,7,57.1,3,2,0,2,0,8,2,0,"MF,FW",20-24,Midfielder,Brazil,South America
378,Brenner,BRA,Udinese,Serie A,2023,23.0,2000.0,2.1,8,7,1,5,2,4,7,57.1,3,2,0,2,0,8,2,0,"MF,FW",20-24,Midfielder,Brazil,South America
378,Brenner,BRA,Udinese,Serie A,2023,23.0,2000.0,2.1,8,7,1,5,2,4,7,57.1,3,2,0,2,0,8,2,0,"MF,FW",20-24,Midfielder,Brazil,South America
379,Ben Brereton,CHI,Sheffield Utd,Premier League,2023,24.0,1999.0,12.3,9,4,4,4,1,4,10,40.0,6,9,3,6,3,12,12,0,"FW,MF",20-24,Forward,Chile,South America
380,Ben Brereton,CHI,Villarreal,La Liga,2023,24.0,1999.0,3.0,2,2,1,0,1,0,2,0.0,2,0,0,0,0,2,0,0,"FW,MF",20-24,Forward,Chile,South America
381,Marco Brescianini,ITA,Frosinone,Serie A,2023,23.0,2000.0,25.8,28,13,13,12,3,9,25,36.0,16,22,5,17,10,38,37,0,MF,20-24,Midfielder,Italy,Europe
382,Maximilian Breunig,GER,Freiburg,Bundesliga,2023,22.0,2000.0,0.1,0,0,0,0,0,0,0,,0,1,0,1,0,0,0,0,FW,20-24,Forward,Germany,Europe
383,Rhian Brewster,ENG,Sheffield Utd,Premier League,2023,23.0,2000.0,3.8,5,1,1,2,2,0,2,0.0,2,2,0,2,1,6,2,0,"FW,MF",20-24,Forward,England,Europe
384,Bennit Bröger,GER,Wolfsburg,Bundesliga,2023,17.0,2006.0,0.1,0,0,0,0,0,0,0,,0,0,0,0,0,0,0,0,FW,Under 20,Forward,Germany,Europe
385,Armando Broja,ALB,Chelsea,Premier League,2023,21.0,2001.0,5.0,3,0,0,1,2,1,2,50.0,1,5,1,4,0,3,3,0,FW,20-24,Forward,Albania,Europe
386,Armando Broja,ALB,Fulham,Premier League,2023,21.0,2001.0,1.0,0,0,0,0,0,0,0,,0,1,0,1,0,0,0,0,FW,20-24,Forward,Albania,Europe
387,Dylan Bronn,TUN,Salernitana,Serie A,2023,28.0,1995.0,0.6,0,0,0,0,0,0,1,0.0,1,2,0,2,0,0,4,0,"DF,MF",25-29,Defender,Tunisia,Africa
388,Andre Brooks,ENG,Sheffield Utd,Premier League,2023,19.0,2003.0,10.4,22,13,7,11,4,9,21,42.9,12,13,1,12,14,36,20,0,"MF,DF",Under 20,Midfielder,England,Europe
389,David Brooks,WAL,Bournemouth,Premier League,2023,26.0,1997.0,3.1,5,4,2,1,2,2,4,50.0,2,3,0,3,2,7,2,0,"FW,MF",25-29,Forward,Wales,Europe
390,John Brooks,USA,Hoffenheim,Bundesliga,2023,30.0,1993.0,17.1,28,15,17,10,1,15,30,50.0,15,29,17,12,27,55,109,1,DF,30-34,Defender,United States,North America
391,Moritz Broschinski,GER,Bochum,Bundesliga,2023,22.0,2000.0,13.9,11,7,2,5,4,2,8,25.0,6,11,2,9,0,11,6,0,FW,20-24,Forward,Germany,Europe
392,Jacob Brown,SCO,Luton Town,Premier League,2023,25.0,1998.0,11.3,19,12,7,7,5,7,18,38.9,11,20,1,19,8,27,22,0,"MF,FW",25-29,Midfielder,Scotland,Europe
393,Josh Brownhill,ENG,Burnley,Premier League,2023,27.0,1995.0,25.0,61,35,23,28,10,27,37,73.0,10,33,8,25,34,95,40,1,MF,25-29,Midfielder,England,Europe
394,Alexander Brunst,GER,Darmstadt 98,Bundesliga,2023,28.0,1995.0,3.0,0,0,0,0,0,0,2,0.0,2,0,0,0,0,0,2,1,GK,25-29,Goalkeeper,Germany,Europe
395,Jacob Bruun Larsen,DEN,Burnley,Premier League,2023,24.0,1998.0,13.9,9,4,4,3,2,7,21,33.3,14,16,2,14,7,16,23,0,"MF,FW",20-24,Midfielder,Denmark,Europe
396,Tajon Buchanan,CAN,Inter,Serie A,2023,24.0,1999.0,1.8,1,1,0,0,1,1,2,50.0,1,1,0,1,0,1,4,0,DF,20-24,Defender,Canada,North America
397,Ante Budimir,CRO,Osasuna,La Liga,2023,32.0,1991.0,27.1,21,15,2,11,8,5,14,35.7,9,19,5,14,5,26,18,0,FW,30-34,Forward,Croatia,Europe
400,Santiago Bueno,URU,Wolves,Premier League,2023,24.0,1998.0,9.1,13,7,5,7,1,5,11,45.5,6,22,12,10,6,19,33,0,DF,20-24,Defender,Uruguay,South America
401,Marius Bülter,GER,Hoffenheim,Bundesliga,2023,30.0,1993.0,15.0,18,11,9,5,4,12,23,52.2,11,17,3,14,10,28,20,0,"DF,FW",30-34,Defender,Germany,Europe
402,Facundo Buonanotte,ARG,Brighton,Premier League,2023,18.0,2004.0,15.2,42,22,13,22,7,14,44,31.8,30,22,3,19,8,50,5,0,"FW,MF",Under 20,Forward,Argentina,South America
403,Alessandro Buongiorno,ITA,Torino,Serie A,2023,24.0,1999.0,28.1,70,39,43,24,3,24,34,70.6,10,20,12,8,69,139,131,0,DF,20-24,Defender,Italy,Europe
404,Jonathan Burkardt,GER,Mainz 05,Bundesliga,2023,23.0,2000.0,17.1,12,8,2,6,4,4,11,36.4,7,16,3,13,3,15,2,0,"FW,MF",20-24,Forward,Germany,Europe
405,Oliver Burke,SCO,Werder Bremen,Bundesliga,2023,26.0,1997.0,0.4,0,0,0,0,0,0,2,0.0,2,0,0,0,0,0,0,0,FW,25-29,Forward,Scotland,Europe
406,Reece Burke,ENG,Luton Town,Premier League,2023,26.0,1996.0,18.4,37,23,17,14,6,12,26,46.2,14,25,18,7,18,55,78,1,DF,25-29,Defender,England,Europe
407,Dan Burn,ENG,Newcastle Utd,Premier League,2023,31.0,1992.0,30.3,61,33,37,20,4,26,61,42.6,35,55,25,30,37,98,124,1,DF,30-34,Defender,England,Europe
408,Rareș-Cătălin Burnete,ROU,Lecce,Serie A,2023,19.0,2004.0,0.1,0,0,0,0,0,0,0,,0,0,0,0,0,0,0,0,FW,Under 20,Forward,Romania,Europe
409,Mason Burstow,ENG,Chelsea,Premier League,2023,19.0,2003.0,0.1,0,0,0,0,0,0,0,,0,0,0,0,0,0,0,0,FW,Under 20,Forward,England,Europe
410,Marnon Busch,GER,Heidenheim,Bundesliga,2023,28.0,1994.0,6.6,11,9,6,3,2,7,12,58.3,5,9,2,7,10,21,12,0,DF,25-29,Defender,Germany,Europe
411,Maxime Busi,BEL,Reims,Ligue 1,2023,23.0,1999.0,1.8,2,0,0,1,1,0,2,0.0,2,6,1,5,4,6,5,0,"FW,DF",20-24,Forward,Belgium,Europe
413,Aurélio Buta,POR,Eint Frankfurt,Bundesliga,2023,26.0,1997.0,19.4,40,25,19,16,5,21,38,55.3,17,24,5,19,15,55,36,0,"DF,MF",25-29,Defender,Portugal,Europe
415,Rémy Cabella,FRA,Lille,Ligue 1,2023,33.0,1990.0,16.4,54,36,19,20,15,20,54,37.0,34,32,0,32,5,59,5,0,"FW,MF",30-34,Forward,France,Europe
416,Jovane Cabral,CPV,Salernitana,Serie A,2023,25.0,1998.0,7.5,13,9,4,7,2,3,9,33.3,6,3,0,3,1,14,4,0,"MF,FW",25-29,Midfielder,Cape Verde,Africa
417,Liberato Cacace,NZL,Empoli,Serie A,2023,22.0,2000.0,21.2,40,24,24,13,3,24,38,63.2,14,23,6,17,19,59,56,0,DF,20-24,Defender,New Zealand,Oceania
418,Anthony Caci,FRA,Mainz 05,Bundesliga,2023,26.0,1997.0,27.6,56,23,30,25,1,27,44,61.4,17,43,7,36,32,88,45,0,DF,25-29,Defender,France,Europe
419,Moisés Caicedo,ECU,Chelsea,Premier League,2023,21.0,2001.0,31.8,91,46,38,42,11,36,60,60.0,24,59,25,34,37,128,44,4,MF,20-24,Midfielder,Ecuador,South America
420,Tom Cairney,SCO,Fulham,Premier League,2023,32.0,1991.0,16.5,24,16,10,12,2,13,25,52.0,12,16,4,12,13,37,6,0,MF,30-34,Midfielder,Scotland,Europe
421,Jens Cajuste,SWE,Napoli,Serie A,2023,23.0,1999.0,11.3,36,24,13,17,6,20,37,54.1,17,20,3,17,4,40,15,0,MF,20-24,Midfielder,Sweden,Europe
422,Davide Calabria,ITA,Milan,Serie A,2023,26.0,1996.0,24.3,70,38,38,25,7,44,72,61.1,28,26,7,19,24,94,49,1,DF,25-29,Defender,Italy,Europe
423,Riccardo Calafiori,ITA,Bologna,Serie A,2023,21.0,2002.0,26.1,47,32,28,16,3,22,32,68.8,10,38,13,25,50,97,74,3,DF,20-24,Defender,Italy,Europe
424,Mattia Caldara,ITA,Milan,Serie A,2023,29.0,1994.0,0.4,1,1,1,0,0,1,1,100.0,0,1,1,0,1,2,1,0,DF,25-29,Defender,Italy,Europe
425,Luca Caldirola,ITA,Monza,Serie A,2023,32.0,1991.0,23.8,25,14,19,4,2,13,22,59.1,9,26,17,9,29,54,53,0,DF,30-34,Defender,Italy,Europe
426,Duje Ćaleta-Car,CRO,Lyon,Ligue 1,2023,26.0,1996.0,22.1,26,11,19,6,1,18,22,81.8,4,27,14,13,18,44,94,1,DF,25-29,Defender,Croatia,Europe
427,Hakan Çalhanoğlu,TUR,Inter,Serie A,2023,29.0,1994.0,28.4,66,33,29,29,8,32,49,65.3,17,29,13,16,24,90,22,0,MF,25-29,Midfielder,Turkey,Asia
429,Dominic Calvert-Lewin,ENG,Everton,Premier League,2023,26.0,1997.0,24.1,13,6,2,6,5,2,15,13.3,13,14,4,10,4,17,38,0,FW,25-29,Forward,England,Europe
430,Lamine Camara,SEN,Metz,Ligue 1,2023,19.0,2004.0,25.1,62,42,26,30,6,24,49,49.0,25,35,2,33,28,90,34,0,MF,Under 20,Midfielder,Senegal,Africa
431,Mahdi Camara,FRA,Brest,Ligue 1,2023,25.0,1998.0,22.4,55,39,8,40,7,20,49,40.8,29,24,1,23,27,82,19,0,MF,25-29,Midfielder,France,Europe
432,Mohamed Camara,MLI,Monaco,Ligue 1,2023,23.0,2000.0,11.5,35,21,10,20,5,15,29,51.7,14,8,2,6,11,46,7,0,MF,20-24,Midfielder,Mali,Africa
432,Mohamed Camara,MLI,Monaco,Ligue 1,2023,23.0,2000.0,11.5,35,21,10,20,5,15,29,51.7,14,8,2,6,11,46,7,0,MF,20-24,Midfielder,Mali,Africa
432,Mohamed Camara,MLI,Monaco,Ligue 1,2023,23.0,2000.0,11.5,35,21,10,20,5,15,29,51.7,14,8,2,6,11,46,7,0,MF,20-24,Midfielder,Mali,Africa
432,Mohamed Camara,MLI,Monaco,Ligue 1,2023,23.0,2000.0,11.5,35,21,10,20,5,15,29,51.7,14,8,2,6,11,46,7,0,MF,20-24,Midfielder,Mali,Africa
433,Francesco Camarda,ITA,Milan,Serie A,2023,15.0,2008.0,0.2,0,0,0,0,0,0,2,0.0,2,0,0,0,0,0,0,0,FW,Under 20,Forward,Italy,Europe
434,Eduardo Camavinga,FRA,Real Madrid,La Liga,2023,20.0,2002.0,20.2,76,47,39,29,8,23,39,59.0,16,36,8,28,29,105,29,1,"MF,DF",20-24,Midfielder,France,Europe
435,Nicolò Cambiaghi,ITA,Empoli,Serie A,2023,22.0,2000.0,28.4,51,39,15,20,16,16,35,45.7,19,26,1,25,14,65,8,0,"FW,MF",20-24,Forward,Italy,Europe
436,Andrea Cambiaso,ITA,Juventus,Serie A,2023,23.0,2000.0,26.4,47,30,23,15,9,25,43,58.1,18,28,3,25,11,58,26,1,"DF,FW",20-24,Defender,Italy,Europe
437,Axel Camblan,FRA,Brest,Ligue 1,2023,19.0,2003.0,1.0,3,1,0,2,1,2,4,50.0,2,2,0,2,0,3,0,0,FW,Under 20,Forward,France,Europe
440,Emre Can,GER,Dortmund,Bundesliga,2023,29.0,1994.0,21.7,63,45,37,23,3,28,48,58.3,20,30,7,23,22,85,41,2,"MF,DF",25-29,Midfielder,Germany,Europe
441,Matteo Cancellieri,ITA,Empoli,Serie A,2023,21.0,2002.0,19.9,35,22,12,16,7,13,36,36.1,23,19,0,19,6,41,18,0,"FW,MF",20-24,Forward,Italy,Europe
442,João Cancelo,POR,Barcelona,La Liga,2023,29.0,1994.0,27.8,64,44,35,21,8,38,58,65.5,20,35,6,29,29,93,59,1,DF,25-29,Defender,Portugal,Europe
443,Fali Candé,GNB,Metz,Ligue 1,2023,25.0,1998.0,20.5,40,19,31,9,0,20,35,57.1,15,41,28,13,20,60,107,1,DF,25-29,Defender,Guinea-Bissau,Africa
444,Antonio Candreva,ITA,Salernitana,Serie A,2023,36.0,1987.0,30.6,18,13,8,8,2,9,25,36.0,16,9,0,9,7,25,23,0,"MF,FW",35-39,Midfielder,Italy,Europe
445,Thomas Cannon,IRL,Everton,Premier League,2023,20.0,2002.0,0.0,0,0,0,0,0,0,0,,0,0,0,0,0,0,0,0,FW,20-24,Forward,Republic of Ireland,Europe
447,Luigi Canotto,ITA,Frosinone,Serie A,2023,29.0,1994.0,0.2,0,0,0,0,0,0,0,,0,0,0,0,0,0,0,0,FW,25-29,Forward,Italy,Europe
448,Gino Caoki,FRA,Lorient,Ligue 1,2023,19.0,2004.0,0.1,0,0,0,0,0,0,1,0.0,1,0,0,0,0,0,0,0,MF,Under 20,Midfielder,France,Europe
449,Étienne Capoue,FRA,Villarreal,La Liga,2023,35.0,1988.0,16.2,32,18,17,12,3,15,22,68.2,7,20,4,16,22,54,24,1,MF,35-39,Midfielder,France,Europe
450,Gianluca Caprari,ITA,Monza,Serie A,2023,30.0,1993.0,3.2,2,1,1,1,0,0,1,0.0,1,0,0,0,2,4,0,0,"MF,FW",30-34,Midfielder,Italy,Europe
451,Elia Caprile,ITA,Empoli,Serie A,2023,21.0,2001.0,23.0,1,0,1,0,0,1,1,100.0,0,0,0,0,0,1,16,2,GK,20-24,Goalkeeper,Italy,Europe
452,Francesco Caputo,ITA,Empoli,Serie A,2023,35.0,1987.0,14.1,2,0,0,0,2,0,1,0.0,1,4,0,4,1,3,3,0,FW,35-39,Forward,Italy,Europe
453,Maxence Caqueret,FRA,Lyon,Ligue 1,2023,23.0,2000.0,33.6,91,64,39,37,15,38,107,35.5,69,40,9,31,48,139,26,2,MF,20-24,Midfielder,France,Europe
454,Andrea Carboni,ITA,Monza,Serie A,2023,22.0,2001.0,16.5,38,22,24,12,2,20,31,64.5,11,23,13,10,17,55,56,1,DF,20-24,Defender,Italy,Europe
455,Valentin Carboni,ARG,Monza,Serie A,2023,18.0,2005.0,13.0,25,15,10,12,3,8,26,30.8,18,12,1,11,7,32,4,0,"MF,FW",Under 20,Midfielder,Argentina,South America
458,Irvin Cardona,FRA,Augsburg,Bundesliga,2023,25.0,1997.0,0.6,1,1,0,0,1,1,3,33.3,2,1,0,1,0,1,1,0,"MF,DF",25-29,Midfielder,France,Europe
461,Johnny Cardoso,USA,Betis,La Liga,2023,21.0,2001.0,14.8,48,29,19,24,5,22,33,66.7,11,20,5,15,32,80,31,0,MF,20-24,Midfielder,United States,North America
462,Igor Carioca,BRA,Lorient,Ligue 1,2023,26.0,1996.0,2.9,8,6,6,1,1,4,6,66.7,2,0,0,0,3,11,6,0,"DF,MF",25-29,Defender,Brazil,South America
463,Diego Carlos,BRA,Aston Villa,Premier League,2023,30.0,1993.0,20.2,27,16,22,4,1,13,21,61.9,8,24,19,5,13,40,78,3,DF,30-34,Defender,Brazil,South America
465,Marco Carnesecchi,ITA,Atalanta,Serie A,2023,23.0,2000.0,26.9,0,0,0,0,0,0,0,,0,0,0,0,0,0,22,3,GK,20-24,Goalkeeper,Italy,Europe
466,Yannick Carrasco,BEL,Atlético Madrid,La Liga,2023,29.0,1993.0,2.5,4,4,3,1,0,2,7,28.6,5,2,0,2,1,5,6,0,DF,25-29,Defender,Belgium,Europe
468,Rasmus Carstensen,DEN,Köln,Bundesliga,2023,22.0,2000.0,18.4,47,22,23,20,4,31,56,55.4,25,38,9,29,20,67,50,2,"DF,FW",20-24,Defender,Denmark,Europe
469,Antonin Cartillier,FRA,Monaco,Ligue 1,2023,19.0,2004.0,0.1,0,0,0,0,0,0,0,,0,1,0,1,0,0,0,0,DF,Under 20,Defender,France,Europe
471,Fabio Carvalho,POR,RB Leipzig,Bundesliga,2023,20.0,2002.0,1.8,3,1,0,2,1,1,3,33.3,2,8,0,8,0,3,1,0,MF,20-24,Midfielder,Portugal,Europe
472,William Carvalho,POR,Betis,La Liga,2023,31.0,1992.0,7.6,20,12,11,7,2,10,16,62.5,6,8,1,7,8,28,9,1,MF,30-34,Midfielder,Portugal,Europe
473,Cesare Casadei,ITA,Chelsea,Premier League,2023,20.0,2003.0,0.9,5,3,2,1,2,2,5,40.0,3,1,0,1,0,5,4,0,"FW,MF",20-24,Forward,Italy,Europe
475,Nicolò Casale,ITA,Lazio,Serie A,2023,25.0,1998.0,17.3,15,9,13,2,0,6,15,40.0,9,19,16,3,12,27,61,0,DF,25-29,Defender,Italy,Europe
476,Casemiro,BRA,Manchester Utd,Premier League,2023,31.0,1992.0,22.0,83,56,43,32,8,51,106,48.1,55,74,33,41,18,101,71,1,"MF,DF",30-34,Midfielder,Brazil,South America
477,Kaelan Casey,ENG,West Ham,Premier League,2023,18.0,2004.0,0.0,0,0,0,0,0,0,0,,0,0,0,0,0,0,1,0,DF,Under 20,Defender,England,Europe
479,Josué Casimir,FRA,Le Havre,Ligue 1,2023,21.0,2001.0,22.4,31,18,14,14,3,7,18,38.9,11,23,2,21,13,44,25,0,"FW,DF",20-24,Forward,France,Europe
480,Giuseppe Caso,ITA,Frosinone,Serie A,2023,24.0,1998.0,4.6,4,3,2,0,2,2,3,66.7,1,0,0,0,0,4,0,0,"FW,MF",20-24,Forward,Italy,Europe
481,Cristian Cásseres Jr.,VEN,Toulouse,Ligue 1,2023,23.0,2000.0,21.6,70,34,31,33,6,29,61,47.5,32,34,4,30,27,97,33,1,MF,20-24,Midfielder,Venezuela,South America
482,Timothy Castagne,BEL,Fulham,Premier League,2023,27.0,1995.0,29.3,49,24,23,16,10,26,44,59.1,18,38,10,28,38,87,69,1,DF,25-29,Defender,Belgium,Europe
483,Koen Casteels,BEL,Wolfsburg,Bundesliga,2023,31.0,1992.0,25.0,2,1,2,0,0,2,3,66.7,1,0,0,0,0,2,16,5,GK,30-34,Goalkeeper,Belgium,Europe
484,Valentín Castellanos,ARG,Lazio,Serie A,2023,24.0,1998.0,18.7,22,10,1,12,9,6,20,30.0,14,22,2,20,2,24,18,0,FW,20-24,Forward,Argentina,South America
485,Jean-Charles Castelletto,CMR,Nantes,Ligue 1,2023,28.0,1995.0,27.4,34,26,22,10,2,18,29,62.1,11,19,10,9,32,66,81,0,DF,25-29,Defender,Cameroon,Africa
488,Santiago Castro,ARG,Bologna,Serie A,2023,18.0,2004.0,2.7,2,1,0,1,1,1,3,33.3,2,1,0,1,1,3,1,0,FW,Under 20,Forward,Argentina,South America
489,Gaetano Castrovilli,ITA,Fiorentina,Serie A,2023,26.0,1997.0,4.1,3,2,1,2,0,1,8,12.5,7,4,0,4,2,5,3,0,"FW,MF",25-29,Forward,Italy,Europe
490,Danilo Cataldi,ITA,Lazio,Serie A,2023,28.0,1994.0,15.1,24,12,7,16,1,8,18,44.4,10,15,7,8,17,41,19,1,MF,25-29,Midfielder,Italy,Europe
492,Maximiliano Caufriez,BEL,Clermont Foot,Ligue 1,2023,26.0,1997.0,18.4,38,28,31,5,2,19,29,65.5,10,18,12,6,18,56,69,2,DF,25-29,Defender,Belgium,Europe
493,Ivan Cavaleiro,POR,Lille,Ligue 1,2023,29.0,1993.0,8.6,10,6,3,4,3,7,20,35.0,13,9,2,7,5,15,6,0,FW,25-29,Forward,Portugal,Europe
496,Zeki Çelik,TUR,Roma,Serie A,2023,26.0,1997.0,7.5,23,16,10,10,3,14,25,56.0,11,12,5,7,8,31,25,0,DF,25-29,Defender,Turkey,Asia
498,Fabien Centonze,FRA,Hellas Verona,Serie A,2023,27.0,1996.0,7.5,14,8,10,4,0,5,10,50.0,5,14,2,12,10,24,18,0,DF,25-29,Defender,France,Europe
499,Fabien Centonze,FRA,Nantes,Ligue 1,2023,27.0,1996.0,1.0,2,1,2,0,0,2,3,66.7,1,2,1,1,0,2,1,0,DF,25-29,Defender,France,Europe
501,Michele Cerofolini,ITA,Frosinone,Serie A,2023,24.0,1999.0,7.5,0,0,0,0,0,0,0,,0,0,0,0,0,0,5,1,GK,20-24,Goalkeeper,Italy,Europe
502,Alberto Cerri,ITA,Empoli,Serie A,2023,27.0,1996.0,6.1,3,3,1,1,1,2,5,40.0,3,3,1,2,3,6,7,0,FW,25-29,Forward,Italy,Europe
503,Leonardo Cerri,ITA,Juventus,Serie A,2023,20.0,2003.0,0.1,0,0,0,0,0,0,0,,0,0,0,0,0,0,0,0,DF,20-24,Defender,Italy,Europe
504,Franco Cervi,ARG,Celta Vigo,La Liga,2023,29.0,1994.0,6.1,24,18,13,9,2,13,24,54.2,11,16,0,16,9,33,4,0,"MF,DF",25-29,Midfielder,Argentina,South America
505,Julian Chabot,GER,Köln,Bundesliga,2023,25.0,1998.0,30.0,59,42,40,17,2,35,59,59.3,24,66,43,23,45,104,145,0,DF,25-29,Defender,Germany,Europe
506,El Chadaille Bitshiabu,FRA,RB Leipzig,Bundesliga,2023,18.0,2005.0,0.4,1,0,1,0,0,0,0,,0,0,0,0,1,2,4,0,"DF,MF",Under 20,Defender,France,Europe
507,Fares Chaïbi,ALG,Toulouse,Ligue 1,2023,20.0,2002.0,0.6,0,0,0,0,0,0,0,,0,0,0,0,0,0,2,0,"FW,MF",20-24,Forward,Algeria,Africa
508,Fares Chaïbi,ALG,Eint Frankfurt,Bundesliga,2023,20.0,2002.0,21.2,27,17,7,12,8,8,18,44.4,10,37,1,36,5,32,19,0,"MF,FW",20-24,Midfielder,Algeria,Africa
509,Trevoh Chalobah,ENG,Chelsea,Premier League,2023,24.0,1999.0,10.6,16,12,10,2,4,10,15,66.7,5,8,7,1,8,24,51,0,DF,20-24,Defender,England,Europe
510,Muhammed Cham,AUT,Clermont Foot,Ligue 1,2023,22.0,2000.0,28.4,25,14,10,13,2,11,27,40.7,16,20,2,18,8,33,5,1,"MF,FW",20-24,Midfielder,Austria,Europe
511,Calum Chambers,ENG,Aston Villa,Premier League,2023,28.0,1995.0,1.7,3,0,3,0,0,0,1,0.0,1,2,1,1,2,5,4,0,"MF,DF",25-29,Midfielder,England,Europe
512,Timothy Chandler,USA,Eint Frankfurt,Bundesliga,2023,33.0,1990.0,0.2,0,0,0,0,0,0,0,,0,0,0,0,0,0,0,0,"MF,DF",30-34,Midfielder,United States,North America
513,Brendan Chardonnet,FRA,Brest,Ligue 1,2023,28.0,1994.0,33.0,57,34,33,22,2,32,63,50.8,31,58,34,24,53,110,139,3,DF,25-29,Defender,France,Europe
514,Charlys,BRA,Hellas Verona,Serie A,2023,19.0,2004.0,0.3,0,0,0,0,0,0,0,,0,0,0,0,1,1,0,0,MF,Under 20,Midfielder,Brazil,South America
516,Jhoanner Chávez,ECU,Lens,Ligue 1,2023,21.0,2002.0,5.3,6,5,2,2,2,3,9,33.3,6,2,0,2,5,11,11,0,DF,20-24,Defender,Ecuador,South America
517,Walid Cheddira,MAR,Frosinone,Serie A,2023,25.0,1998.0,23.6,12,7,1,8,3,4,8,50.0,4,6,1,5,5,17,10,0,FW,25-29,Forward,Morocco,Africa
518,Rayan Cherki,FRA,Lyon,Ligue 1,2023,19.0,2003.0,19.1,28,15,4,16,8,17,46,37.0,29,13,3,10,7,35,1,0,"MF,FW",Under 20,Midfielder,France,Europe
519,Youssef Chermiti,POR,Everton,Premier League,2023,19.0,2004.0,2.3,3,2,2,1,0,1,5,20.0,4,4,1,3,1,4,2,0,FW,Under 20,Forward,Portugal,Europe
520,Lucas Chevalier,FRA,Lille,Ligue 1,2023,21.0,2001.0,33.0,3,0,3,0,0,3,4,75.0,1,1,0,1,0,3,11,2,GK,20-24,Goalkeeper,France,Europe
521,Fabio Chiarodia,ITA,Gladbach,Bundesliga,2023,18.0,2005.0,1.7,8,5,5,1,2,5,7,71.4,2,2,1,1,3,11,9,0,DF,Under 20,Defender,Italy,Europe
522,Federico Chiesa,ITA,Juventus,Serie A,2023,25.0,1997.0,24.4,20,10,7,6,7,3,13,23.1,10,17,1,16,6,26,4,0,FW,25-29,Forward,Italy,Europe
523,Ben Chilwell,ENG,Chelsea,Premier League,2023,26.0,1996.0,8.4,15,10,5,9,1,5,8,62.5,3,11,3,8,4,19,19,1,DF,25-29,Defender,England,Europe
524,Tawanda Chirewa,ZIM,Wolves,Premier League,2023,19.0,2003.0,1.6,7,3,3,3,1,2,3,66.7,1,0,0,0,1,8,0,0,"MF,FW",Under 20,Midfielder,Zimbabwe,Africa
526,Leon Chiwome,ENG,Wolves,Premier League,2023,17.0,2006.0,1.9,2,1,0,1,1,1,2,50.0,1,3,1,2,0,2,2,0,FW,Under 20,Forward,England,Europe
527,Tahith Chong,NED,Luton Town,Premier League,2023,23.0,1999.0,22.0,36,22,19,13,4,15,33,45.5,18,30,6,24,8,44,11,1,"MF,FW",20-24,Midfielder,Netherlands,Europe
528,Joris Chotard,FRA,Montpellier,Ligue 1,2023,21.0,2001.0,28.7,81,52,45,25,11,48,96,50.0,48,47,21,26,44,125,60,0,MF,20-24,Midfielder,France,Europe
529,Andreas Christensen,DEN,Barcelona,La Liga,2023,27.0,1996.0,22.0,23,14,7,14,2,16,28,57.1,12,23,10,13,21,44,41,0,"DF,MF",25-29,Defender,Denmark,Europe
530,Jacob Christensen,DEN,Köln,Bundesliga,2023,22.0,2001.0,2.4,10,6,7,3,0,4,7,57.1,3,8,2,6,4,14,4,0,MF,20-24,Midfielder,Denmark,Europe
531,Oliver Christensen,DEN,Fiorentina,Serie A,2023,24.0,1999.0,4.0,0,0,0,0,0,0,0,,0,0,0,0,0,0,1,0,GK,20-24,Goalkeeper,Denmark,Europe
532,Ryan Christie,SCO,Bournemouth,Premier League,2023,28.0,1995.0,32.3,86,44,34,35,17,39,92,42.4,53,52,11,41,52,138,53,1,MF,25-29,Midfielder,Scotland,Europe
533,Carney Chukwuemeka,ENG,Chelsea,Premier League,2023,19.0,2003.0,2.5,6,4,3,3,0,1,3,33.3,2,1,1,0,0,6,1,0,"MF,FW",Under 20,Midfielder,England,Europe
534,Samuel Chukwueze,NGA,Milan,Serie A,2023,24.0,1999.0,11.3,18,7,11,5,2,9,17,52.9,8,3,1,2,6,24,3,0,FW,20-24,Forward,Nigeria,Africa
537,Pathé Ciss,SEN,Rayo Vallecano,La Liga,2023,29.0,1994.0,18.5,44,24,16,26,2,16,29,55.2,13,27,10,17,30,74,54,0,MF,25-29,Midfielder,Senegal,Africa
538,Alphadjo Cissè,ITA,Hellas Verona,Serie A,2023,16.0,2006.0,0.1,0,0,0,0,0,0,0,,0,0,0,0,0,0,0,0,FW,Under 20,Forward,Italy,Europe
539,Djaoui Cissé,FRA,Rennes,Ligue 1,2023,19.0,2004.0,0.0,0,0,0,0,0,0,0,,0,0,0,0,0,0,0,0,MF,Under 20,Midfielder,France,Europe
540,Ibrahim Cissoko,NED,Toulouse,Ligue 1,2023,20.0,2003.0,2.7,4,3,3,1,0,1,3,33.3,2,3,0,3,1,5,0,0,"FW,MF",20-24,Forward,Netherlands,Europe
541,Giorgio Cittadini,ITA,Monza,Serie A,2023,21.0,2002.0,0.2,1,1,1,0,0,1,1,100.0,0,1,1,0,0,1,0,0,DF,20-24,Defender,Italy,Europe
542,Giorgio Cittadini,ITA,Genoa,Serie A,2023,21.0,2002.0,1.2,5,4,4,1,0,3,3,100.0,0,1,0,1,3,8,5,0,DF,20-24,Defender,Italy,Europe
543,Patrick Ciurria,ITA,Monza,Serie A,2023,28.0,1995.0,17.8,30,18,13,13,4,13,21,61.9,8,20,5,15,9,39,28,0,"DF,MF",25-29,Defender,Italy,Europe
544,Bobby Clark,ENG,Liverpool,Premier League,2023,18.0,2005.0,1.0,2,1,1,1,0,1,5,20.0,4,6,2,4,1,3,1,0,MF,Under 20,Midfielder,England,Europe
545,Jordan Clark,ENG,Luton Town,Premier League,2023,29.0,1993.0,14.5,30,17,14,11,5,11,39,28.2,28,24,3,21,11,41,15,1,MF,25-29,Midfielder,England,Europe
546,Alexis Claude-Maurice,FRA,Nice,Ligue 1,2023,25.0,1998.0,5.6,12,5,3,6,3,1,5,20.0,4,4,1,3,5,17,7,0,MF,25-29,Midfielder,France,Europe
547,Jonathan Clauss,FRA,Marseille,Ligue 1,2023,30.0,1992.0,23.0,47,20,22,19,6,26,49,53.1,23,17,3,14,36,83,46,0,DF,30-34,Defender,France,Europe
549,Nathaniel Clyne,ENG,Crystal Palace,Premier League,2023,32.0,1991.0,14.9,24,15,11,11,2,14,21,66.7,7,18,6,12,10,34,33,0,DF,30-34,Defender,England,Europe
550,Marcus Coco,FRA,Nantes,Ligue 1,2023,27.0,1996.0,16.5,43,26,29,10,4,28,60,46.7,32,19,1,18,21,64,38,0,"DF,FW",25-29,Defender,France,Europe
551,Saúl Coco,EQG,Las Palmas,La Liga,2023,24.0,1999.0,25.5,32,19,25,7,0,11,18,61.1,7,27,15,12,20,52,120,3,DF,20-24,Defender,Equatorial Guinea,Africa
552,Séamus Coleman,IRL,Everton,Premier League,2023,34.0,1988.0,7.4,17,14,10,3,4,11,16,68.8,5,12,4,8,7,24,26,1,DF,30-34,Defender,Republic of Ireland,Europe
553,Maxime Colin,FRA,Metz,Ligue 1,2023,31.0,1991.0,20.4,39,23,25,7,7,16,29,55.2,13,22,7,15,20,59,71,0,DF,30-34,Defender,France,Europe
554,Nathan Collins,IRL,Brentford,Premier League,2023,22.0,2001.0,29.5,38,20,24,12,2,19,29,65.5,10,46,30,16,44,82,141,4,DF,20-24,Defender,Republic of Ireland,Europe
555,Nnamdi Collins,GER,Eint Frankfurt,Bundesliga,2023,19.0,2004.0,1.0,0,0,0,0,0,0,0,,0,0,0,0,2,2,4,0,DF,Under 20,Defender,Germany,Europe
556,Lorenzo Colombo,ITA,Monza,Serie A,2023,21.0,2002.0,15.1,17,12,3,9,5,8,14,57.1,6,18,5,13,0,17,14,0,FW,20-24,Forward,Italy,Europe
557,Andrea Colpani,ITA,Monza,Serie A,2023,24.0,1999.0,29.5,25,15,6,13,6,11,20,55.0,9,11,4,7,14,39,14,0,"MF,FW",20-24,Midfielder,Italy,Europe
558,Levi Colwill,ENG,Chelsea,Premier League,2023,20.0,2003.0,20.0,48,30,26,17,5,26,34,76.5,8,28,10,18,26,74,66,0,DF,20-24,Defender,England,Europe
559,Kingsley Coman,FRA,Bayern Munich,Bundesliga,2023,27.0,1996.0,12.4,12,7,5,3,4,9,17,52.9,8,15,1,14,2,14,5,0,FW,25-29,Forward,France,Europe
560,Eray Cömert,SUI,Nantes,Ligue 1,2023,25.0,1998.0,22.2,42,28,28,13,1,28,38,73.7,10,35,18,17,36,78,77,1,DF,25-29,Defender,Switzerland,Europe
562,Pietro Comuzzo,ITA,Fiorentina,Serie A,2023,18.0,2005.0,0.5,1,1,1,0,0,1,1,100.0,0,1,0,1,1,2,2,0,"DF,FW",Under 20,Defender,Italy,Europe
563,Alois Confais,FRA,Le Havre,Ligue 1,2023,26.0,1996.0,0.1,2,2,1,1,0,1,1,100.0,0,0,0,0,0,2,0,0,"MF,FW",25-29,Midfielder,France,Europe
564,Andrea Consigli,ITA,Sassuolo,Serie A,2023,36.0,1987.0,35.0,0,0,0,0,0,0,0,,0,1,0,1,1,1,19,1,GK,35-39,Goalkeeper,Italy,Europe
565,Bambasé Conté,GER,Hoffenheim,Bundesliga,2023,20.0,2003.0,0.5,3,3,2,0,1,1,1,100.0,0,0,0,0,0,3,0,0,"MF,FW",20-24,Midfielder,Germany,Europe
566,Nikita Contini Baranovsky,ITA,Napoli,Serie A,2023,27.0,1996.0,0.2,0,0,0,0,0,0,0,,0,0,0,0,0,0,1,0,GK,25-29,Goalkeeper,Italy,Europe
567,Lewis Cook,ENG,Bournemouth,Premier League,2023,26.0,1997.0,31.0,61,41,24,30,7,34,63,54.0,29,32,11,21,65,126,46,1,MF,25-29,Midfielder,England,Europe
569,Diego Coppola,ITA,Hellas Verona,Serie A,2023,19.0,2003.0,18.2,36,22,25,9,2,20,33,60.6,13,26,9,17,27,63,89,1,DF,Under 20,Defender,Italy,Europe
570,Francis Coquelin,FRA,Villarreal,La Liga,2023,32.0,1991.0,10.1,20,12,8,10,2,5,13,38.5,8,14,4,10,16,36,15,0,MF,30-34,Midfielder,France,Europe
571,Tommaso Corazza,ITA,Bologna,Serie A,2023,19.0,2004.0,2.2,10,4,9,1,0,4,9,44.4,5,2,0,2,5,15,3,0,DF,Under 20,Defender,Italy,Europe
572,Theo Corbeanu,CAN,Granada,La Liga,2023,21.0,2002.0,2.0,5,2,2,3,0,1,3,33.3,2,3,0,3,3,8,2,0,"MF,FW",20-24,Midfielder,Canada,North America
573,Jeppe Corfitzen,DEN,Lecce,Serie A,2023,18.0,2004.0,0.1,1,0,0,1,0,1,1,100.0,0,0,0,0,0,1,0,0,FW,Under 20,Forward,Denmark,Europe
574,Jack Cork,ENG,Burnley,Premier League,2023,34.0,1989.0,0.3,2,0,0,2,0,1,3,33.3,2,0,0,0,1,3,1,0,MF,30-34,Midfielder,England,Europe
575,Maxwel Cornet,CIV,West Ham,Premier League,2023,26.0,1996.0,1.2,3,2,3,0,0,1,5,20.0,4,2,0,2,2,5,1,0,"MF,FW",25-29,Midfielder,Ivory Coast,Africa
576,Giacomo Corona,ITA,Empoli,Serie A,2023,19.0,2004.0,0.1,0,0,0,0,0,0,0,,0,0,0,0,0,0,0,0,FW,Under 20,Forward,Italy,Europe
577,Jesús Corona,MEX,Sevilla,La Liga,2023,30.0,1993.0,0.2,0,0,0,0,0,0,0,,0,0,0,0,1,1,0,0,"MF,DF",30-34,Midfielder,Mexico,North America
578,Ángel Correa,ARG,Atlético Madrid,La Liga,2023,28.0,1995.0,17.0,22,15,3,11,8,5,17,29.4,12,13,0,13,2,24,6,0,"FW,MF",25-29,Forward,Argentina,South America
579,Joaquín Correa,ARG,Marseille,Ligue 1,2023,28.0,1994.0,4.8,7,5,4,2,1,0,8,0.0,8,2,0,2,1,8,1,0,"FW,MF",25-29,Forward,Argentina,South America
580,Thierry Correia,POR,Valencia,La Liga,2023,24.0,1999.0,23.9,63,35,39,20,4,28,49,57.1,21,39,16,23,33,96,61,0,DF,20-24,Defender,Portugal,Europe
581,Oscar Cortés,COL,Lens,Ligue 1,2023,19.0,2003.0,0.5,0,0,0,0,0,0,0,,0,1,0,1,0,0,0,0,"FW,MF",Under 20,Forward,Colombia,South America
582,Danny da Costa,GER,Mainz 05,Bundesliga,2023,30.0,1993.0,9.2,18,9,9,7,2,9,19,47.4,10,17,4,13,16,34,24,0,DF,30-34,Defender,Germany,Europe
583,David Costa,POR,Lens,Ligue 1,2023,22.0,2001.0,16.6,18,10,5,12,1,10,23,43.5,13,21,4,17,16,34,8,1,MF,20-24,Midfielder,Portugal,Europe
585,João Costa,BRA,Roma,Serie A,2023,18.0,2005.0,0.2,0,0,0,0,0,0,0,,0,0,0,0,0,0,0,0,"MF,FW",Under 20,Midfielder,Brazil,South America
585,João Costa,BRA,Roma,Serie A,2023,18.0,2005.0,0.2,0,0,0,0,0,0,0,,0,0,0,0,0,0,0,0,"MF,FW",Under 20,Midfielder,Brazil,South America
585,João Costa,BRA,Roma,Serie A,2023,18.0,2005.0,0.2,0,0,0,0,0,0,0,,0,0,0,0,0,0,0,0,"MF,FW",Under 20,Midfielder,Brazil,South America
585,João Costa,BRA,Roma,Serie A,2023,18.0,2005.0,0.2,0,0,0,0,0,0,0,,0,0,0,0,0,0,0,0,"MF,FW",Under 20,Midfielder,Brazil,South America
585,João Costa,BRA,Roma,Serie A,2023,18.0,2005.0,0.2,0,0,0,0,0,0,0,,0,0,0,0,0,0,0,0,"MF,FW",Under 20,Midfielder,Brazil,South America
585,João Costa,BRA,Roma,Serie A,2023,18.0,2005.0,0.2,0,0,0,0,0,0,0,,0,0,0,0,0,0,0,0,"MF,FW",Under 20,Midfielder,Brazil,South America
585,João Costa,BRA,Roma,Serie A,2023,18.0,2005.0,0.2,0,0,0,0,0,0,0,,0,0,0,0,0,0,0,0,"MF,FW",Under 20,Midfielder,Brazil,South America
585,João Costa,BRA,Roma,Serie A,2023,18.0,2005.0,0.2,0,0,0,0,0,0,0,,0,0,0,0,0,0,0,0,"MF,FW",Under 20,Midfielder,Brazil,South America
585,João Costa,BRA,Roma,Serie A,2023,18.0,2005.0,0.2,0,0,0,0,0,0,0,,0,0,0,0,0,0,0,0,"MF,FW",Under 20,Midfielder,Brazil,South America
586,Logan Costa,CPV,Toulouse,Ligue 1,2023,22.0,2001.0,29.4,40,24,31,9,0,15,24,62.5,9,42,27,15,23,63,120,1,DF,20-24,Defender,Cape Verde,Africa
587,Samu Costa,POR,Mallorca,La Liga,2023,22.0,2000.0,25.6,91,50,40,46,5,46,93,49.5,47,28,14,14,39,130,59,3,MF,20-24,Midfielder,Portugal,Europe
588,Benoît Costil,FRA,Salernitana,Serie A,2023,36.0,1987.0,13.0,2,1,1,1,0,2,3,66.7,1,0,0,0,0,2,5,1,GK,35-39,Goalkeeper,France,Europe
589,Grégoire Coudert,FRA,Brest,Ligue 1,2023,24.0,1999.0,2.0,0,0,0,0,0,0,0,,0,0,0,0,0,0,0,0,GK,20-24,Goalkeeper,France,Europe
591,Lassana Coulibaly,MLI,Salernitana,Serie A,2023,27.0,1996.0,23.1,47,32,20,21,6,22,49,44.9,27,23,5,18,16,63,29,0,MF,25-29,Midfielder,Mali,Africa
592,Mamadou Coulibaly,SEN,Salernitana,Serie A,2023,24.0,1999.0,0.0,0,0,0,0,0,0,0,,0,0,0,0,0,0,0,0,DF,20-24,Defender,Senegal,Africa
592,Mamadou Coulibaly,SEN,Salernitana,Serie A,2023,24.0,1999.0,0.0,0,0,0,0,0,0,0,,0,0,0,0,0,0,0,0,DF,20-24,Defender,Senegal,Africa
592,Mamadou Coulibaly,SEN,Salernitana,Serie A,2023,24.0,1999.0,0.0,0,0,0,0,0,0,0,,0,0,0,0,0,0,0,0,DF,20-24,Defender,Senegal,Africa
592,Mamadou Coulibaly,SEN,Salernitana,Serie A,2023,24.0,1999.0,0.0,0,0,0,0,0,0,0,,0,0,0,0,0,0,0,0,DF,20-24,Defender,Senegal,Africa
593,Mamadou Coulibaly,FRA,Monaco,Ligue 1,2023,19.0,2004.0,1.3,7,4,2,3,2,3,8,37.5,5,4,0,4,0,7,0,0,MF,Under 20,Midfielder,France,Europe
593,Mamadou Coulibaly,FRA,Monaco,Ligue 1,2023,19.0,2004.0,1.3,7,4,2,3,2,3,8,37.5,5,4,0,4,0,7,0,0,MF,Under 20,Midfielder,France,Europe
593,Mamadou Coulibaly,FRA,Monaco,Ligue 1,2023,19.0,2004.0,1.3,7,4,2,3,2,3,8,37.5,5,4,0,4,0,7,0,0,MF,Under 20,Midfielder,France,Europe
593,Mamadou Coulibaly,FRA,Monaco,Ligue 1,2023,19.0,2004.0,1.3,7,4,2,3,2,3,8,37.5,5,4,0,4,0,7,0,0,MF,Under 20,Midfielder,France,Europe
594,Tanguy Coulibaly,FRA,Montpellier,Ligue 1,2023,22.0,2001.0,6.9,13,11,8,4,1,4,9,44.4,5,11,1,10,2,15,2,0,"FW,MF",20-24,Forward,France,Europe
595,Thibaut Courtois,BEL,Real Madrid,La Liga,2023,31.0,1992.0,3.7,1,0,1,0,0,0,0,,0,0,0,0,0,1,0,0,GK,30-34,Goalkeeper,Belgium,Europe
596,Philippe Coutinho,BRA,Aston Villa,Premier League,2023,31.0,1992.0,0.3,0,0,0,0,0,0,1,0.0,1,0,0,0,0,0,0,0,"MF,FW",30-34,Midfielder,Brazil,South America
597,Yan Couto,BRA,Girona,La Liga,2023,21.0,2002.0,24.9,45,34,25,14,6,20,40,50.0,20,14,2,12,10,55,31,1,"DF,FW",20-24,Defender,Brazil,South America
598,Nicolas Cozza,FRA,Nantes,Ligue 1,2023,24.0,1999.0,9.9,35,23,23,10,2,17,24,70.8,7,7,0,7,14,49,32,0,DF,20-24,Defender,France,Europe
599,Nicolas Cozza,FRA,Wolfsburg,Bundesliga,2023,24.0,1999.0,3.1,8,6,4,4,0,2,7,28.6,5,3,0,3,4,12,6,0,DF,20-24,Defender,France,Europe
600,Alessio Cragno,ITA,Sassuolo,Serie A,2023,29.0,1994.0,3.0,0,0,0,0,0,0,0,,0,0,0,0,0,0,3,1,GK,25-29,Goalkeeper,Italy,Europe
601,Crespo,POR,Rayo Vallecano,La Liga,2023,26.0,1996.0,5.9,16,9,8,6,2,9,17,52.9,8,15,6,9,10,26,7,0,MF,25-29,Midfielder,Portugal,Europe
602,Aaron Cresswell,ENG,West Ham,Premier League,2023,33.0,1989.0,4.8,3,2,1,1,1,2,3,66.7,1,5,3,2,3,6,7,0,"DF,FW",30-34,Defender,England,Europe
603,Bryan Cristante,ITA,Roma,Serie A,2023,28.0,1995.0,36.5,72,41,33,28,11,28,50,56.0,22,36,6,30,25,97,55,2,"MF,DF",25-29,Midfielder,Italy,Europe
606,Juan Cruz,ARG,Hellas Verona,Serie A,2023,24.0,1999.0,1.2,2,2,0,0,2,0,0,,0,1,0,1,1,3,0,0,"FW,MF",20-24,Forward,Argentina,South America
606,Juan Cruz,ARG,Hellas Verona,Serie A,2023,24.0,1999.0,1.2,2,2,0,0,2,0,0,,0,1,0,1,1,3,0,0,"FW,MF",20-24,Forward,Argentina,South America
606,Juan Cruz,ARG,Hellas Verona,Serie A,2023,24.0,1999.0,1.2,2,2,0,0,2,0,0,,0,1,0,1,1,3,0,0,"FW,MF",20-24,Forward,Argentina,South America
606,Juan Cruz,ARG,Hellas Verona,Serie A,2023,24.0,1999.0,1.2,2,2,0,0,2,0,0,,0,1,0,1,1,3,0,0,"FW,MF",20-24,Forward,Argentina,South America
608,Juan Cuadrado,COL,Inter,Serie A,2023,35.0,1988.0,3.0,4,3,2,2,0,3,5,60.0,2,6,1,5,1,5,2,0,DF,35-39,Defender,Colombia,South America
613,Josh Cullen,IRL,Burnley,Premier League,2023,27.0,1996.0,22.9,42,29,15,22,5,26,46,56.5,20,31,19,12,15,57,26,1,MF,25-29,Midfielder,Republic of Ireland,Europe
614,Matheus Cunha,BRA,Wolves,Premier League,2023,24.0,1999.0,27.1,30,16,8,17,5,13,35,37.1,22,28,7,21,13,43,21,1,"FW,MF",20-24,Forward,Brazil,South America
615,Marvin Cuni,ALB,Frosinone,Serie A,2023,22.0,2001.0,5.9,8,3,1,3,4,3,4,75.0,1,10,1,9,1,9,0,0,FW,20-24,Forward,Albania,Europe
617,Sam Curtis,IRL,Sheffield Utd,Premier League,2023,17.0,2005.0,0.3,1,0,1,0,0,1,2,50.0,1,2,0,2,0,1,0,0,DF,Under 20,Defender,Republic of Ireland,Europe
619,Danilo D'Ambrosio,ITA,Monza,Serie A,2023,34.0,1988.0,17.1,57,34,34,20,3,28,41,68.3,13,22,13,9,14,71,31,0,DF,30-34,Defender,Italy,Europe
621,Trévis Dago,CIV,Lille,Ligue 1,2023,18.0,2005.0,0.3,0,0,0,0,0,0,0,,0,0,0,0,1,1,0,0,"FW,MF",Under 20,Forward,Ivory Coast,Africa
622,Finn Dahmen,GER,Augsburg,Bundesliga,2023,25.0,1998.0,31.0,1,0,1,0,0,1,3,33.3,2,0,0,0,0,1,17,5,GK,25-29,Goalkeeper,Germany,Europe
623,Mahmoud Dahoud,GER,Brighton,Premier League,2023,27.0,1996.0,5.0,9,4,2,4,3,3,9,33.3,6,4,1,3,1,10,5,0,MF,25-29,Midfielder,Germany,Europe
624,Mahmoud Dahoud,GER,Stuttgart,Bundesliga,2023,27.0,1996.0,2.5,5,1,1,4,0,3,7,42.9,4,4,0,4,0,5,1,0,MF,25-29,Midfielder,Germany,Europe
625,Ameen Al-Dakhil,BEL,Burnley,Premier League,2023,21.0,2002.0,11.7,12,5,4,7,1,1,10,10.0,9,13,6,7,12,24,38,2,DF,20-24,Defender,Belgium,Europe
626,Thijs Dallinga,NED,Toulouse,Ligue 1,2023,22.0,2000.0,27.9,29,15,6,11,12,9,15,60.0,6,11,4,7,3,32,35,0,FW,20-24,Forward,Netherlands,Europe
627,Diogo Dalot,POR,Manchester Utd,Premier League,2023,24.0,1999.0,35.3,81,51,58,12,11,51,74,68.9,23,44,16,28,37,118,111,0,DF,20-24,Defender,Portugal,Europe
628,Mikkel Damsgaard,DEN,Brentford,Premier League,2023,23.0,2000.0,9.4,29,17,13,9,7,14,40,35.0,26,23,1,22,11,40,10,1,MF,20-24,Midfielder,Denmark,Europe
629,Flavius Daniliuc,AUT,Salernitana,Serie A,2023,22.0,2001.0,8.3,19,11,12,5,2,9,19,47.4,10,13,4,9,8,27,15,0,DF,20-24,Defender,Austria,Europe
630,Danilo,BRA,Nott'ham Forest,Premier League,2023,22.0,2001.0,19.9,36,18,22,12,2,21,46,45.7,25,33,8,25,35,71,42,0,MF,20-24,Midfielder,Brazil,South America
630,Danilo,BRA,Nott'ham Forest,Premier League,2023,22.0,2001.0,19.9,36,18,22,12,2,21,46,45.7,25,33,8,25,35,71,42,0,MF,20-24,Midfielder,Brazil,South America
630,Danilo,BRA,Nott'ham Forest,Premier League,2023,22.0,2001.0,19.9,36,18,22,12,2,21,46,45.7,25,33,8,25,35,71,42,0,MF,20-24,Midfielder,Brazil,South America
630,Danilo,BRA,Nott'ham Forest,Premier League,2023,22.0,2001.0,19.9,36,18,22,12,2,21,46,45.7,25,33,8,25,35,71,42,0,MF,20-24,Midfielder,Brazil,South America
630,Danilo,BRA,Nott'ham Forest,Premier League,2023,22.0,2001.0,19.9,36,18,22,12,2,21,46,45.7,25,33,8,25,35,71,42,0,MF,20-24,Midfielder,Brazil,South America
630,Danilo,BRA,Nott'ham Forest,Premier League,2023,22.0,2001.0,19.9,36,18,22,12,2,21,46,45.7,25,33,8,25,35,71,42,0,MF,20-24,Midfielder,Brazil,South America
630,Danilo,BRA,Nott'ham Forest,Premier League,2023,22.0,2001.0,19.9,36,18,22,12,2,21,46,45.7,25,33,8,25,35,71,42,0,MF,20-24,Midfielder,Brazil,South America
630,Danilo,BRA,Nott'ham Forest,Premier League,2023,22.0,2001.0,19.9,36,18,22,12,2,21,46,45.7,25,33,8,25,35,71,42,0,MF,20-24,Midfielder,Brazil,South America
630,Danilo,BRA,Nott'ham Forest,Premier League,2023,22.0,2001.0,19.9,36,18,22,12,2,21,46,45.7,25,33,8,25,35,71,42,0,MF,20-24,Midfielder,Brazil,South America
630,Danilo,BRA,Nott'ham Forest,Premier League,2023,22.0,2001.0,19.9,36,18,22,12,2,21,46,45.7,25,33,8,25,35,71,42,0,MF,20-24,Midfielder,Brazil,South America
630,Danilo,BRA,Nott'ham Forest,Premier League,2023,22.0,2001.0,19.9,36,18,22,12,2,21,46,45.7,25,33,8,25,35,71,42,0,MF,20-24,Midfielder,Brazil,South America
630,Danilo,BRA,Nott'ham Forest,Premier League,2023,22.0,2001.0,19.9,36,18,22,12,2,21,46,45.7,25,33,8,25,35,71,42,0,MF,20-24,Midfielder,Brazil,South America
630,Danilo,BRA,Nott'ham Forest,Premier League,2023,22.0,2001.0,19.9,36,18,22,12,2,21,46,45.7,25,33,8,25,35,71,42,0,MF,20-24,Midfielder,Brazil,South America
630,Danilo,BRA,Nott'ham Forest,Premier League,2023,22.0,2001.0,19.9,36,18,22,12,2,21,46,45.7,25,33,8,25,35,71,42,0,MF,20-24,Midfielder,Brazil,South America
630,Danilo,BRA,Nott'ham Forest,Premier League,2023,22.0,2001.0,19.9,36,18,22,12,2,21,46,45.7,25,33,8,25,35,71,42,0,MF,20-24,Midfielder,Brazil,South America
630,Danilo,BRA,Nott'ham Forest,Premier League,2023,22.0,2001.0,19.9,36,18,22,12,2,21,46,45.7,25,33,8,25,35,71,42,0,MF,20-24,Midfielder,Brazil,South America
630,Danilo,BRA,Nott'ham Forest,Premier League,2023,22.0,2001.0,19.9,36,18,22,12,2,21,46,45.7,25,33,8,25,35,71,42,0,MF,20-24,Midfielder,Brazil,South America
630,Danilo,BRA,Nott'ham Forest,Premier League,2023,22.0,2001.0,19.9,36,18,22,12,2,21,46,45.7,25,33,8,25,35,71,42,0,MF,20-24,Midfielder,Brazil,South America
630,Danilo,BRA,Nott'ham Forest,Premier League,2023,22.0,2001.0,19.9,36,18,22,12,2,21,46,45.7,25,33,8,25,35,71,42,0,MF,20-24,Midfielder,Brazil,South America
630,Danilo,BRA,Nott'ham Forest,Premier League,2023,22.0,2001.0,19.9,36,18,22,12,2,21,46,45.7,25,33,8,25,35,71,42,0,MF,20-24,Midfielder,Brazil,South America
630,Danilo,BRA,Nott'ham Forest,Premier League,2023,22.0,2001.0,19.9,36,18,22,12,2,21,46,45.7,25,33,8,25,35,71,42,0,MF,20-24,Midfielder,Brazil,South America
630,Danilo,BRA,Nott'ham Forest,Premier League,2023,22.0,2001.0,19.9,36,18,22,12,2,21,46,45.7,25,33,8,25,35,71,42,0,MF,20-24,Midfielder,Brazil,South America
630,Danilo,BRA,Nott'ham Forest,Premier League,2023,22.0,2001.0,19.9,36,18,22,12,2,21,46,45.7,25,33,8,25,35,71,42,0,MF,20-24,Midfielder,Brazil,South America
630,Danilo,BRA,Nott'ham Forest,Premier League,2023,22.0,2001.0,19.9,36,18,22,12,2,21,46,45.7,25,33,8,25,35,71,42,0,MF,20-24,Midfielder,Brazil,South America
630,Danilo,BRA,Nott'ham Forest,Premier League,2023,22.0,2001.0,19.9,36,18,22,12,2,21,46,45.7,25,33,8,25,35,71,42,0,MF,20-24,Midfielder,Brazil,South America
630,Danilo,BRA,Nott'ham Forest,Premier League,2023,22.0,2001.0,19.9,36,18,22,12,2,21,46,45.7,25,33,8,25,35,71,42,0,MF,20-24,Midfielder,Brazil,South America
630,Danilo,BRA,Nott'ham Forest,Premier League,2023,22.0,2001.0,19.9,36,18,22,12,2,21,46,45.7,25,33,8,25,35,71,42,0,MF,20-24,Midfielder,Brazil,South America
630,Danilo,BRA,Nott'ham Forest,Premier League,2023,22.0,2001.0,19.9,36,18,22,12,2,21,46,45.7,25,33,8,25,35,71,42,0,MF,20-24,Midfielder,Brazil,South America
630,Danilo,BRA,Nott'ham Forest,Premier League,2023,22.0,2001.0,19.9,36,18,22,12,2,21,46,45.7,25,33,8,25,35,71,42,0,MF,20-24,Midfielder,Brazil,South America
630,Danilo,BRA,Nott'ham Forest,Premier League,2023,22.0,2001.0,19.9,36,18,22,12,2,21,46,45.7,25,33,8,25,35,71,42,0,MF,20-24,Midfielder,Brazil,South America
630,Danilo,BRA,Nott'ham Forest,Premier League,2023,22.0,2001.0,19.9,36,18,22,12,2,21,46,45.7,25,33,8,25,35,71,42,0,MF,20-24,Midfielder,Brazil,South America
630,Danilo,BRA,Nott'ham Forest,Premier League,2023,22.0,2001.0,19.9,36,18,22,12,2,21,46,45.7,25,33,8,25,35,71,42,0,MF,20-24,Midfielder,Brazil,South America
630,Danilo,BRA,Nott'ham Forest,Premier League,2023,22.0,2001.0,19.9,36,18,22,12,2,21,46,45.7,25,33,8,25,35,71,42,0,MF,20-24,Midfielder,Brazil,South America
630,Danilo,BRA,Nott'ham Forest,Premier League,2023,22.0,2001.0,19.9,36,18,22,12,2,21,46,45.7,25,33,8,25,35,71,42,0,MF,20-24,Midfielder,Brazil,South America
630,Danilo,BRA,Nott'ham Forest,Premier League,2023,22.0,2001.0,19.9,36,18,22,12,2,21,46,45.7,25,33,8,25,35,71,42,0,MF,20-24,Midfielder,Brazil,South America
630,Danilo,BRA,Nott'ham Forest,Premier League,2023,22.0,2001.0,19.9,36,18,22,12,2,21,46,45.7,25,33,8,25,35,71,42,0,MF,20-24,Midfielder,Brazil,South America
630,Danilo,BRA,Nott'ham Forest,Premier League,2023,22.0,2001.0,19.9,36,18,22,12,2,21,46,45.7,25,33,8,25,35,71,42,0,MF,20-24,Midfielder,Brazil,South America
630,Danilo,BRA,Nott'ham Forest,Premier League,2023,22.0,2001.0,19.9,36,18,22,12,2,21,46,45.7,25,33,8,25,35,71,42,0,MF,20-24,Midfielder,Brazil,South America
630,Danilo,BRA,Nott'ham Forest,Premier League,2023,22.0,2001.0,19.9,36,18,22,12,2,21,46,45.7,25,33,8,25,35,71,42,0,MF,20-24,Midfielder,Brazil,South America
630,Danilo,BRA,Nott'ham Forest,Premier League,2023,22.0,2001.0,19.9,36,18,22,12,2,21,46,45.7,25,33,8,25,35,71,42,0,MF,20-24,Midfielder,Brazil,South America
630,Danilo,BRA,Nott'ham Forest,Premier League,2023,22.0,2001.0,19.9,36,18,22,12,2,21,46,45.7,25,33,8,25,35,71,42,0,MF,20-24,Midfielder,Brazil,South America
630,Danilo,BRA,Nott'ham Forest,Premier League,2023,22.0,2001.0,19.9,36,18,22,12,2,21,46,45.7,25,33,8,25,35,71,42,0,MF,20-24,Midfielder,Brazil,South America
630,Danilo,BRA,Nott'ham Forest,Premier League,2023,22.0,2001.0,19.9,36,18,22,12,2,21,46,45.7,25,33,8,25,35,71,42,0,MF,20-24,Midfielder,Brazil,South America
630,Danilo,BRA,Nott'ham Forest,Premier League,2023,22.0,2001.0,19.9,36,18,22,12,2,21,46,45.7,25,33,8,25,35,71,42,0,MF,20-24,Midfielder,Brazil,South America
630,Danilo,BRA,Nott'ham Forest,Premier League,2023,22.0,2001.0,19.9,36,18,22,12,2,21,46,45.7,25,33,8,25,35,71,42,0,MF,20-24,Midfielder,Brazil,South America
630,Danilo,BRA,Nott'ham Forest,Premier League,2023,22.0,2001.0,19.9,36,18,22,12,2,21,46,45.7,25,33,8,25,35,71,42,0,MF,20-24,Midfielder,Brazil,South America
630,Danilo,BRA,Nott'ham Forest,Premier League,2023,22.0,2001.0,19.9,36,18,22,12,2,21,46,45.7,25,33,8,25,35,71,42,0,MF,20-24,Midfielder,Brazil,South America
630,Danilo,BRA,Nott'ham Forest,Premier League,2023,22.0,2001.0,19.9,36,18,22,12,2,21,46,45.7,25,33,8,25,35,71,42,0,MF,20-24,Midfielder,Brazil,South America
630,Danilo,BRA,Nott'ham Forest,Premier League,2023,22.0,2001.0,19.9,36,18,22,12,2,21,46,45.7,25,33,8,25,35,71,42,0,MF,20-24,Midfielder,Brazil,South America
631,Danilo,BRA,Juventus,Serie A,2023,32.0,1991.0,27.2,60,36,38,18,4,32,48,66.7,16,34,15,19,37,97,94,0,DF,30-34,Defender,Brazil,South America
631,Danilo,BRA,Juventus,Serie A,2023,32.0,1991.0,27.2,60,36,38,18,4,32,48,66.7,16,34,15,19,37,97,94,0,DF,30-34,Defender,Brazil,South America
631,Danilo,BRA,Juventus,Serie A,2023,32.0,1991.0,27.2,60,36,38,18,4,32,48,66.7,16,34,15,19,37,97,94,0,DF,30-34,Defender,Brazil,South America
631,Danilo,BRA,Juventus,Serie A,2023,32.0,1991.0,27.2,60,36,38,18,4,32,48,66.7,16,34,15,19,37,97,94,0,DF,30-34,Defender,Brazil,South America
631,Danilo,BRA,Juventus,Serie A,2023,32.0,1991.0,27.2,60,36,38,18,4,32,48,66.7,16,34,15,19,37,97,94,0,DF,30-34,Defender,Brazil,South America
631,Danilo,BRA,Juventus,Serie A,2023,32.0,1991.0,27.2,60,36,38,18,4,32,48,66.7,16,34,15,19,37,97,94,0,DF,30-34,Defender,Brazil,South America
631,Danilo,BRA,Juventus,Serie A,2023,32.0,1991.0,27.2,60,36,38,18,4,32,48,66.7,16,34,15,19,37,97,94,0,DF,30-34,Defender,Brazil,South America
631,Danilo,BRA,Juventus,Serie A,2023,32.0,1991.0,27.2,60,36,38,18,4,32,48,66.7,16,34,15,19,37,97,94,0,DF,30-34,Defender,Brazil,South America
631,Danilo,BRA,Juventus,Serie A,2023,32.0,1991.0,27.2,60,36,38,18,4,32,48,66.7,16,34,15,19,37,97,94,0,DF,30-34,Defender,Brazil,South America
631,Danilo,BRA,Juventus,Serie A,2023,32.0,1991.0,27.2,60,36,38,18,4,32,48,66.7,16,34,15,19,37,97,94,0,DF,30-34,Defender,Brazil,South America
631,Danilo,BRA,Juventus,Serie A,2023,32.0,1991.0,27.2,60,36,38,18,4,32,48,66.7,16,34,15,19,37,97,94,0,DF,30-34,Defender,Brazil,South America
631,Danilo,BRA,Juventus,Serie A,2023,32.0,1991.0,27.2,60,36,38,18,4,32,48,66.7,16,34,15,19,37,97,94,0,DF,30-34,Defender,Brazil,South America
631,Danilo,BRA,Juventus,Serie A,2023,32.0,1991.0,27.2,60,36,38,18,4,32,48,66.7,16,34,15,19,37,97,94,0,DF,30-34,Defender,Brazil,South America
631,Danilo,BRA,Juventus,Serie A,2023,32.0,1991.0,27.2,60,36,38,18,4,32,48,66.7,16,34,15,19,37,97,94,0,DF,30-34,Defender,Brazil,South America
631,Danilo,BRA,Juventus,Serie A,2023,32.0,1991.0,27.2,60,36,38,18,4,32,48,66.7,16,34,15,19,37,97,94,0,DF,30-34,Defender,Brazil,South America
631,Danilo,BRA,Juventus,Serie A,2023,32.0,1991.0,27.2,60,36,38,18,4,32,48,66.7,16,34,15,19,37,97,94,0,DF,30-34,Defender,Brazil,South America
631,Danilo,BRA,Juventus,Serie A,2023,32.0,1991.0,27.2,60,36,38,18,4,32,48,66.7,16,34,15,19,37,97,94,0,DF,30-34,Defender,Brazil,South America
631,Danilo,BRA,Juventus,Serie A,2023,32.0,1991.0,27.2,60,36,38,18,4,32,48,66.7,16,34,15,19,37,97,94,0,DF,30-34,Defender,Brazil,South America
631,Danilo,BRA,Juventus,Serie A,2023,32.0,1991.0,27.2,60,36,38,18,4,32,48,66.7,16,34,15,19,37,97,94,0,DF,30-34,Defender,Brazil,South America
631,Danilo,BRA,Juventus,Serie A,2023,32.0,1991.0,27.2,60,36,38,18,4,32,48,66.7,16,34,15,19,37,97,94,0,DF,30-34,Defender,Brazil,South America
631,Danilo,BRA,Juventus,Serie A,2023,32.0,1991.0,27.2,60,36,38,18,4,32,48,66.7,16,34,15,19,37,97,94,0,DF,30-34,Defender,Brazil,South America
631,Danilo,BRA,Juventus,Serie A,2023,32.0,1991.0,27.2,60,36,38,18,4,32,48,66.7,16,34,15,19,37,97,94,0,DF,30-34,Defender,Brazil,South America
631,Danilo,BRA,Juventus,Serie A,2023,32.0,1991.0,27.2,60,36,38,18,4,32,48,66.7,16,34,15,19,37,97,94,0,DF,30-34,Defender,Brazil,South America
631,Danilo,BRA,Juventus,Serie A,2023,32.0,1991.0,27.2,60,36,38,18,4,32,48,66.7,16,34,15,19,37,97,94,0,DF,30-34,Defender,Brazil,South America
631,Danilo,BRA,Juventus,Serie A,2023,32.0,1991.0,27.2,60,36,38,18,4,32,48,66.7,16,34,15,19,37,97,94,0,DF,30-34,Defender,Brazil,South America
631,Danilo,BRA,Juventus,Serie A,2023,32.0,1991.0,27.2,60,36,38,18,4,32,48,66.7,16,34,15,19,37,97,94,0,DF,30-34,Defender,Brazil,South America
631,Danilo,BRA,Juventus,Serie A,2023,32.0,1991.0,27.2,60,36,38,18,4,32,48,66.7,16,34,15,19,37,97,94,0,DF,30-34,Defender,Brazil,South America
631,Danilo,BRA,Juventus,Serie A,2023,32.0,1991.0,27.2,60,36,38,18,4,32,48,66.7,16,34,15,19,37,97,94,0,DF,30-34,Defender,Brazil,South America
631,Danilo,BRA,Juventus,Serie A,2023,32.0,1991.0,27.2,60,36,38,18,4,32,48,66.7,16,34,15,19,37,97,94,0,DF,30-34,Defender,Brazil,South America
631,Danilo,BRA,Juventus,Serie A,2023,32.0,1991.0,27.2,60,36,38,18,4,32,48,66.7,16,34,15,19,37,97,94,0,DF,30-34,Defender,Brazil,South America
631,Danilo,BRA,Juventus,Serie A,2023,32.0,1991.0,27.2,60,36,38,18,4,32,48,66.7,16,34,15,19,37,97,94,0,DF,30-34,Defender,Brazil,South America
631,Danilo,BRA,Juventus,Serie A,2023,32.0,1991.0,27.2,60,36,38,18,4,32,48,66.7,16,34,15,19,37,97,94,0,DF,30-34,Defender,Brazil,South America
631,Danilo,BRA,Juventus,Serie A,2023,32.0,1991.0,27.2,60,36,38,18,4,32,48,66.7,16,34,15,19,37,97,94,0,DF,30-34,Defender,Brazil,South America
631,Danilo,BRA,Juventus,Serie A,2023,32.0,1991.0,27.2,60,36,38,18,4,32,48,66.7,16,34,15,19,37,97,94,0,DF,30-34,Defender,Brazil,South America
631,Danilo,BRA,Juventus,Serie A,2023,32.0,1991.0,27.2,60,36,38,18,4,32,48,66.7,16,34,15,19,37,97,94,0,DF,30-34,Defender,Brazil,South America
631,Danilo,BRA,Juventus,Serie A,2023,32.0,1991.0,27.2,60,36,38,18,4,32,48,66.7,16,34,15,19,37,97,94,0,DF,30-34,Defender,Brazil,South America
631,Danilo,BRA,Juventus,Serie A,2023,32.0,1991.0,27.2,60,36,38,18,4,32,48,66.7,16,34,15,19,37,97,94,0,DF,30-34,Defender,Brazil,South America
631,Danilo,BRA,Juventus,Serie A,2023,32.0,1991.0,27.2,60,36,38,18,4,32,48,66.7,16,34,15,19,37,97,94,0,DF,30-34,Defender,Brazil,South America
631,Danilo,BRA,Juventus,Serie A,2023,32.0,1991.0,27.2,60,36,38,18,4,32,48,66.7,16,34,15,19,37,97,94,0,DF,30-34,Defender,Brazil,South America
631,Danilo,BRA,Juventus,Serie A,2023,32.0,1991.0,27.2,60,36,38,18,4,32,48,66.7,16,34,15,19,37,97,94,0,DF,30-34,Defender,Brazil,South America
631,Danilo,BRA,Juventus,Serie A,2023,32.0,1991.0,27.2,60,36,38,18,4,32,48,66.7,16,34,15,19,37,97,94,0,DF,30-34,Defender,Brazil,South America
631,Danilo,BRA,Juventus,Serie A,2023,32.0,1991.0,27.2,60,36,38,18,4,32,48,66.7,16,34,15,19,37,97,94,0,DF,30-34,Defender,Brazil,South America
631,Danilo,BRA,Juventus,Serie A,2023,32.0,1991.0,27.2,60,36,38,18,4,32,48,66.7,16,34,15,19,37,97,94,0,DF,30-34,Defender,Brazil,South America
631,Danilo,BRA,Juventus,Serie A,2023,32.0,1991.0,27.2,60,36,38,18,4,32,48,66.7,16,34,15,19,37,97,94,0,DF,30-34,Defender,Brazil,South America
631,Danilo,BRA,Juventus,Serie A,2023,32.0,1991.0,27.2,60,36,38,18,4,32,48,66.7,16,34,15,19,37,97,94,0,DF,30-34,Defender,Brazil,South America
631,Danilo,BRA,Juventus,Serie A,2023,32.0,1991.0,27.2,60,36,38,18,4,32,48,66.7,16,34,15,19,37,97,94,0,DF,30-34,Defender,Brazil,South America
631,Danilo,BRA,Juventus,Serie A,2023,32.0,1991.0,27.2,60,36,38,18,4,32,48,66.7,16,34,15,19,37,97,94,0,DF,30-34,Defender,Brazil,South America
631,Danilo,BRA,Juventus,Serie A,2023,32.0,1991.0,27.2,60,36,38,18,4,32,48,66.7,16,34,15,19,37,97,94,0,DF,30-34,Defender,Brazil,South America
631,Danilo,BRA,Juventus,Serie A,2023,32.0,1991.0,27.2,60,36,38,18,4,32,48,66.7,16,34,15,19,37,97,94,0,DF,30-34,Defender,Brazil,South America
632,Arnaut Danjuma,NED,Everton,Premier League,2023,26.0,1997.0,6.6,6,4,2,3,1,1,4,25.0,3,4,0,4,3,9,0,0,"MF,FW",25-29,Midfielder,Netherlands,Europe
633,Jayden Danns,ENG,Liverpool,Premier League,2023,17.0,2006.0,0.1,0,0,0,0,0,0,0,,0,0,0,0,0,0,0,0,FW,Under 20,Forward,England,Europe
634,Kevin Danso,AUT,Lens,Ligue 1,2023,24.0,1998.0,29.5,24,14,12,11,1,15,30,50.0,15,43,30,13,23,47,115,1,DF,20-24,Defender,Austria,Europe
635,Dante,BRA,Nice,Ligue 1,2023,39.0,1983.0,31.6,62,30,44,16,2,38,52,73.1,14,43,22,21,37,99,77,2,DF,35-39,Defender,Brazil,South America
637,Mohammed Daramy,DEN,Reims,Ligue 1,2023,21.0,2002.0,18.3,10,9,4,4,2,6,16,37.5,10,5,1,4,4,14,4,0,"FW,MF",20-24,Forward,Denmark,Europe
639,Achraf Dari,MAR,Brest,Ligue 1,2023,24.0,1999.0,1.3,1,1,1,0,0,0,2,0.0,2,2,0,2,5,6,9,1,"DF,FW",20-24,Defender,Morocco,Africa
640,Matteo Darmian,ITA,Inter,Serie A,2023,33.0,1989.0,26.7,48,22,23,15,10,20,53,37.7,33,27,11,16,13,61,55,0,DF,30-34,Defender,Italy,Europe
641,Lukas Daschner,GER,Bochum,Bundesliga,2023,24.0,1998.0,6.0,9,4,2,3,4,4,9,44.4,5,7,0,7,2,11,2,0,"MF,FW",20-24,Midfielder,Germany,Europe
642,Josh Dasilva,ENG,Brentford,Premier League,2023,24.0,1998.0,0.3,2,1,0,1,1,0,0,,0,0,0,0,0,2,0,0,"DF,FW",20-24,Defender,England,Europe
643,David Datro Fofana,CIV,Burnley,Premier League,2023,20.0,2002.0,9.8,10,5,3,5,2,3,6,50.0,3,9,3,6,1,11,2,0,FW,20-24,Forward,Ivory Coast,Africa
644,David Datro Fofana,CIV,Union Berlin,Bundesliga,2023,20.0,2002.0,7.6,10,7,3,5,2,4,9,44.4,5,4,0,4,0,10,5,0,"FW,MF",20-24,Forward,Ivory Coast,Africa
645,Juan David Cabal,COL,Hellas Verona,Serie A,2023,22.0,2001.0,16.6,36,27,19,14,3,18,29,62.1,11,30,9,21,26,62,55,2,DF,20-24,Defender,Colombia,South America
646,Jonathan David,CAN,Lille,Ligue 1,2023,23.0,2000.0,29.2,26,15,6,13,7,8,26,30.8,18,16,0,16,9,35,4,0,FW,20-24,Forward,Canada,North America
647,Alphonso Davies,CAN,Bayern Munich,Bundesliga,2023,22.0,2000.0,22.9,47,24,29,13,5,30,53,56.6,23,30,4,26,26,73,49,1,DF,20-24,Defender,Canada,North America
648,Ben Davies,WAL,Tottenham,Premier League,2023,30.0,1993.0,12.1,24,17,13,8,3,16,21,76.2,5,17,15,2,10,34,35,0,DF,30-34,Defender,Wales,Europe
648,Ben Davies,WAL,Tottenham,Premier League,2023,30.0,1993.0,12.1,24,17,13,8,3,16,21,76.2,5,17,15,2,10,34,35,0,DF,30-34,Defender,Wales,Europe
648,Ben Davies,WAL,Tottenham,Premier League,2023,30.0,1993.0,12.1,24,17,13,8,3,16,21,76.2,5,17,15,2,10,34,35,0,DF,30-34,Defender,Wales,Europe
648,Ben Davies,WAL,Tottenham,Premier League,2023,30.0,1993.0,12.1,24,17,13,8,3,16,21,76.2,5,17,15,2,10,34,35,0,DF,30-34,Defender,Wales,Europe
649,Tom Davies,ENG,Sheffield Utd,Premier League,2023,25.0,1998.0,2.5,10,5,4,3,3,3,9,33.3,6,2,1,1,3,13,6,1,MF,25-29,Midfielder,England,Europe
649,Tom Davies,ENG,Sheffield Utd,Premier League,2023,25.0,1998.0,2.5,10,5,4,3,3,3,9,33.3,6,2,1,1,3,13,6,1,MF,25-29,Midfielder,England,Europe
649,Tom Davies,ENG,Sheffield Utd,Premier League,2023,25.0,1998.0,2.5,10,5,4,3,3,3,9,33.3,6,2,1,1,3,13,6,1,MF,25-29,Midfielder,England,Europe
649,Tom Davies,ENG,Sheffield Utd,Premier League,2023,25.0,1998.0,2.5,10,5,4,3,3,3,9,33.3,6,2,1,1,3,13,6,1,MF,25-29,Midfielder,England,Europe
650,Keinan Davis,ENG,Udinese,Serie A,2023,25.0,1998.0,2.1,0,0,0,0,0,0,0,,0,0,0,0,0,0,3,0,"FW,MF",25-29,Forward,England,Europe
652,Craig Dawson,ENG,Wolves,Premier League,2023,33.0,1990.0,24.5,30,20,23,6,1,22,34,64.7,12,51,39,12,16,46,120,1,DF,30-34,Defender,England,Europe
653,Kevin De Bruyne,BEL,Manchester City,Premier League,2023,32.0,1991.0,13.6,14,9,1,5,8,7,20,35.0,13,5,0,5,4,18,4,0,MF,30-34,Midfielder,Belgium,Europe
654,Charles De Ketelaere,BEL,Atalanta,Serie A,2023,22.0,2001.0,22.5,33,21,3,12,18,10,20,50.0,10,30,2,28,7,40,6,0,"FW,MF",20-24,Forward,Belgium,Europe
655,Rodrigo De Paul,ARG,Atlético Madrid,La Liga,2023,29.0,1994.0,23.1,31,21,11,14,6,15,38,39.5,23,28,1,27,11,42,15,2,MF,25-29,Midfielder,Argentina,South America
656,Mattia De Sciglio,ITA,Juventus,Serie A,2023,30.0,1992.0,0.5,0,0,0,0,0,0,0,,0,1,0,1,1,1,2,0,DF,30-34,Defender,Italy,Europe
657,Lorenzo De Silvestri,ITA,Bologna,Serie A,2023,35.0,1988.0,7.5,10,8,5,2,3,4,7,57.1,3,9,4,5,6,16,27,0,DF,35-39,Defender,Italy,Europe
658,Thibault De Smet,BEL,Reims,Ligue 1,2023,25.0,1998.0,20.3,56,35,36,16,4,33,59,55.9,26,25,5,20,21,77,51,1,DF,25-29,Defender,Belgium,Europe
659,Koni De Winter,BEL,Genoa,Serie A,2023,21.0,2002.0,26.4,44,25,26,13,5,21,31,67.7,10,30,10,20,21,65,78,0,DF,20-24,Defender,Belgium,Europe
661,Alessandro Deiola,ITA,Cagliari,Serie A,2023,27.0,1995.0,17.9,33,19,13,16,4,18,47,38.3,29,16,6,10,9,42,37,0,MF,25-29,Midfielder,Italy,Europe
662,Romain Del Castillo,FRA,Brest,Ligue 1,2023,27.0,1996.0,27.7,46,29,14,18,14,18,70,25.7,52,33,1,32,9,55,8,0,FW,25-29,Forward,France,Europe
663,Thomas Delaine,FRA,Strasbourg,Ligue 1,2023,31.0,1992.0,22.7,38,19,29,8,1,20,42,47.6,22,18,2,16,17,55,51,0,"DF,MF",30-34,Defender,France,Europe
664,Sacha Delaye,FRA,Montpellier,Ligue 1,2023,21.0,2002.0,1.4,7,2,2,2,3,1,6,16.7,5,2,0,2,0,7,1,0,"MF,FW",20-24,Midfielder,France,Europe
665,Hannes Delcroix,BEL,Burnley,Premier League,2023,24.0,1999.0,6.5,10,6,6,4,0,3,4,75.0,1,9,3,6,9,19,26,0,DF,20-24,Defender,Belgium,Europe
666,Alessandro Dellavalle,ITA,Torino,Serie A,2023,19.0,2004.0,0.2,0,0,0,0,0,0,0,,0,1,1,0,1,1,0,0,DF,Under 20,Defender,Italy,Europe
667,Olivier Deman,BEL,Werder Bremen,Bundesliga,2023,23.0,2000.0,15.2,28,15,21,4,3,18,38,47.4,20,24,8,16,14,42,49,1,DF,20-24,Defender,Belgium,Europe
668,Karamoko Dembélé,ENG,Brest,Ligue 1,2023,20.0,2003.0,0.2,0,0,0,0,0,0,0,,0,0,0,0,0,0,0,0,"MF,FW",20-24,Midfielder,England,Europe
669,Ousmane Dembélé,FRA,Paris S-G,Ligue 1,2023,26.0,1997.0,16.7,19,14,2,7,10,6,13,46.2,7,11,0,11,5,24,4,1,"MF,FW",25-29,Midfielder,France,Europe
670,Jessy Deminguet,FRA,Strasbourg,Ligue 1,2023,25.0,1998.0,7.7,14,9,6,8,0,6,18,33.3,12,8,0,8,9,23,5,1,"MF,FW",25-29,Midfielder,France,Europe
671,Ermedin Demirović,BIH,Augsburg,Bundesliga,2023,25.0,1998.0,31.9,24,14,5,16,3,12,40,30.0,28,28,2,26,11,35,26,0,"FW,MF",25-29,Forward,Bosnia and Herzegovina,Europe
672,Diego Demme,GER,Napoli,Serie A,2023,31.0,1991.0,0.8,1,1,0,1,0,0,1,0.0,1,0,0,0,0,1,0,0,MF,30-34,Midfielder,Germany,Europe
673,Sepp van den Berg,NED,Mainz 05,Bundesliga,2023,21.0,2001.0,31.5,38,23,20,15,3,15,26,57.7,11,66,36,30,43,81,159,2,DF,20-24,Defender,Netherlands,Europe
674,Leander Dendoncker,BEL,Aston Villa,Premier League,2023,28.0,1995.0,1.3,6,4,3,2,1,4,5,80.0,1,5,2,3,2,8,3,1,MF,25-29,Midfielder,Belgium,Europe
675,Leander Dendoncker,BEL,Napoli,Serie A,2023,28.0,1995.0,0.3,0,0,0,0,0,0,0,,0,1,1,0,0,0,0,0,MF,25-29,Midfielder,Belgium,Europe
676,Rémy Descamps,FRA,Nantes,Ligue 1,2023,27.0,1996.0,6.0,0,0,0,0,0,0,0,,0,0,0,0,0,0,7,0,GK,25-29,Goalkeeper,France,Europe
677,Mikkel Desler,DEN,Toulouse,Ligue 1,2023,28.0,1995.0,17.2,18,12,8,7,3,9,17,52.9,8,32,13,19,19,37,38,0,DF,25-29,Defender,Denmark,Europe
678,Arthur Desmas,FRA,Le Havre,Ligue 1,2023,29.0,1994.0,33.0,0,0,0,0,0,0,2,0.0,2,0,0,0,0,0,13,1,GK,25-29,Goalkeeper,France,Europe
679,Mattia Destro,ITA,Empoli,Serie A,2023,32.0,1991.0,4.1,2,1,0,2,0,1,1,100.0,0,4,0,4,2,4,3,0,"FW,MF",30-34,Forward,Italy,Europe
680,Samuele Di Benedetto,GER,Stuttgart,Bundesliga,2023,18.0,2005.0,0.1,0,0,0,0,0,0,0,,0,0,0,0,1,1,0,0,MF,Under 20,Midfielder,Germany,Europe
681,Federico Di Francesco,ITA,Lecce,Serie A,2023,29.0,1994.0,0.2,1,0,0,1,0,0,0,,0,0,0,0,0,1,0,0,"FW,MF",25-29,Forward,Italy,Europe
682,Raffaele Di Gennaro,ITA,Inter,Serie A,2023,29.0,1993.0,0.3,0,0,0,0,0,0,0,,0,0,0,0,0,0,0,0,GK,25-29,Goalkeeper,Italy,Europe
683,Michele Di Gregorio,ITA,Monza,Serie A,2023,26.0,1997.0,31.9,1,0,1,0,0,1,4,25.0,3,1,0,1,1,2,10,2,GK,25-29,Goalkeeper,Italy,Europe
684,Giovanni Di Lorenzo,ITA,Napoli,Serie A,2023,29.0,1993.0,35.9,58,36,26,26,6,32,68,47.1,36,43,16,27,24,82,45,0,DF,25-29,Defender,Italy,Europe
685,Alessandro Di Pardo,ITA,Cagliari,Serie A,2023,24.0,1999.0,4.0,4,1,3,0,1,0,3,0.0,3,9,2,7,5,9,7,0,"DF,MF",20-24,Defender,Italy,Europe
686,Boulaye Dia,SEN,Salernitana,Serie A,2023,26.0,1996.0,12.7,4,2,2,2,0,1,3,33.3,2,5,0,5,3,7,7,0,"FW,MF",25-29,Forward,Senegal,Africa
687,Moussa Diaby,FRA,Aston Villa,Premier League,2023,24.0,1999.0,24.2,12,5,5,4,3,4,22,18.2,18,8,1,7,9,21,6,0,"FW,MF",20-24,Forward,France,Europe
688,Lamine Diack,SEN,Nantes,Ligue 1,2023,22.0,2000.0,0.0,0,0,0,0,0,0,0,,0,0,0,0,0,0,0,0,MF,20-24,Midfielder,Senegal,Africa
689,Mouctar Diakhaby,GUI,Valencia,La Liga,2023,26.0,1996.0,11.9,18,11,9,9,0,11,13,84.6,2,17,7,10,11,29,62,0,"DF,MF",25-29,Defender,Guinea,Africa
690,Mamadou Diakhon,FRA,Reims,Ligue 1,2023,17.0,2005.0,2.3,5,3,2,1,2,3,9,33.3,6,1,0,1,1,6,1,0,"FW,MF",Under 20,Forward,France,Europe
691,Bafodé Diakité,FRA,Lille,Ligue 1,2023,22.0,2001.0,18.8,29,20,12,15,2,24,32,75.0,8,16,8,8,21,50,49,1,DF,20-24,Defender,France,Europe
692,Ibrahim Diakité,GUI,Reims,Ligue 1,2023,19.0,2003.0,1.2,1,0,0,1,0,0,1,0.0,1,3,0,3,2,3,5,0,DF,Under 20,Defender,Guinea,Africa
693,Moussa Diakité,MLI,Cádiz,La Liga,2023,19.0,2003.0,0.0,0,0,0,0,0,0,0,,0,0,0,0,0,0,0,0,MF,Under 20,Midfielder,Mali,Africa
694,Oumar Diakité,CIV,Reims,Ligue 1,2023,19.0,2003.0,17.6,25,12,10,9,6,7,21,33.3,14,13,0,13,7,32,7,0,FW,Under 20,Forward,Ivory Coast,Africa
695,Amad Diallo,CIV,Manchester Utd,Premier League,2023,21.0,2002.0,4.3,10,3,1,6,3,3,7,42.9,4,3,1,2,1,11,6,0,"FW,MF",20-24,Forward,Ivory Coast,Africa
696,Amadou Diallo,ENG,Newcastle Utd,Premier League,2023,20.0,2003.0,0.0,0,0,0,0,0,0,0,,0,0,0,0,0,0,0,0,MF,20-24,Midfielder,England,Europe
698,Habib Diarra,SEN,Strasbourg,Ligue 1,2023,19.0,2004.0,25.6,30,23,8,20,2,9,33,27.3,24,23,4,19,17,47,15,0,"MF,FW",Under 20,Midfielder,Senegal,Africa
699,Moussa Diarra,MLI,Toulouse,Ligue 1,2023,22.0,2000.0,15.5,32,12,16,15,1,13,27,48.1,14,30,14,16,20,52,43,0,DF,20-24,Defender,Mali,Africa
700,Rúben Dias,POR,Manchester City,Premier League,2023,26.0,1997.0,28.4,39,20,14,21,4,19,26,73.1,7,32,17,15,30,69,77,0,DF,25-29,Defender,Portugal,Europe
701,Krépin Diatta,SEN,Monaco,Ligue 1,2023,24.0,1999.0,13.4,37,20,17,16,4,27,49,55.1,22,17,2,15,16,53,22,0,"DF,FW",20-24,Defender,Senegal,Africa
702,Mory Diaw,SEN,Clermont Foot,Ligue 1,2023,30.0,1993.0,30.0,1,1,1,0,0,1,2,50.0,1,0,0,0,1,2,13,5,GK,30-34,Goalkeeper,Senegal,Africa
703,Mahamadou Diawara,FRA,Lyon,Ligue 1,2023,18.0,2005.0,4.0,9,6,4,5,0,3,11,27.3,8,4,1,3,4,13,4,0,MF,Under 20,Midfielder,France,Europe
704,Brahim Díaz,MAR,Real Madrid,La Liga,2023,23.0,1999.0,17.2,29,19,4,16,9,6,13,46.2,7,16,1,15,5,34,2,0,"FW,MF",20-24,Forward,Morocco,Africa
705,Luis Díaz,COL,Liverpool,Premier League,2023,26.0,1997.0,29.2,35,25,5,17,13,7,30,23.3,23,15,0,15,3,38,8,0,FW,25-29,Forward,Colombia,South America
707,Famara Diedhiou,SEN,Granada,La Liga,2023,30.0,1992.0,1.0,1,1,0,1,0,0,1,0.0,1,0,0,0,0,1,2,0,"FW,MF",30-34,Forward,Senegal,Africa
708,Justin Diehl,GER,Köln,Bundesliga,2023,18.0,2004.0,1.9,0,0,0,0,0,0,0,,0,1,1,0,0,0,0,1,"FW,MF",Under 20,Forward,Germany,Europe
709,Bamba Dieng,SEN,Lorient,Ligue 1,2023,23.0,2000.0,6.1,3,3,0,3,0,1,3,33.3,2,3,0,3,0,3,7,0,FW,20-24,Forward,Senegal,Africa
710,Eric Dier,ENG,Tottenham,Premier League,2023,29.0,1994.0,2.2,2,1,2,0,0,2,2,100.0,0,3,3,0,2,4,12,0,DF,25-29,Defender,England,Europe
711,Eric Dier,ENG,Bayern Munich,Bundesliga,2023,29.0,1994.0,13.0,11,8,5,5,1,5,6,83.3,1,20,12,8,10,21,48,1,DF,25-29,Defender,England,Europe
712,Guillaume Dietsch,FRA,Metz,Ligue 1,2023,22.0,2001.0,0.8,0,0,0,0,0,0,0,,0,0,0,0,0,0,0,0,GK,20-24,Goalkeeper,France,Europe
713,Florian Dietz,GER,Köln,Bundesliga,2023,24.0,1998.0,0.8,0,0,0,0,0,0,0,,0,1,0,1,0,0,0,0,"FW,MF",20-24,Forward,Germany,Europe
714,Lucas Digne,FRA,Aston Villa,Premier League,2023,30.0,1993.0,26.8,47,19,35,9,3,25,44,56.8,19,20,2,18,26,73,67,0,DF,30-34,Defender,France,Europe
715,Federico Dimarco,ITA,Inter,Serie A,2023,25.0,1997.0,23.1,42,25,19,14,9,17,35,48.6,18,18,3,15,9,51,34,1,DF,25-29,Defender,Italy,Europe
716,Stole Dimitrievski,MKD,Rayo Vallecano,La Liga,2023,29.0,1993.0,37.0,1,1,1,0,0,1,1,100.0,0,0,0,0,0,1,17,3,GK,25-29,Goalkeeper,North Macedonia,Europe
717,Junior Dina Ebimbe,FRA,Eint Frankfurt,Bundesliga,2023,22.0,2000.0,21.7,44,29,15,17,12,18,41,43.9,23,28,7,21,9,53,39,1,"MF,DF",20-24,Midfielder,France,Europe
718,Eren Dinkçi,GER,Heidenheim,Bundesliga,2023,21.0,2001.0,29.4,32,18,16,13,3,19,48,39.6,29,40,4,36,12,44,21,0,"FW,MF",20-24,Forward,Germany,Europe
719,Sinaly Diomande,CIV,Lyon,Ligue 1,2023,22.0,2001.0,9.9,10,4,5,3,2,9,16,56.3,7,12,9,3,15,25,26,1,DF,20-24,Defender,Ivory Coast,Africa
720,Edan Diop,FRA,Monaco,Ligue 1,2023,18.0,2004.0,1.8,10,8,6,3,1,7,9,77.8,2,3,0,3,1,11,5,0,"MF,DF",Under 20,Midfielder,France,Europe
721,Issa Diop,FRA,Fulham,Premier League,2023,26.0,1997.0,15.8,30,16,23,5,2,15,20,75.0,5,28,19,9,17,47,80,1,DF,25-29,Defender,France,Europe
722,Sofiane Diop,FRA,Nice,Ligue 1,2023,23.0,2000.0,5.5,8,6,3,4,1,4,10,40.0,6,4,0,4,3,11,3,0,FW,20-24,Forward,France,Europe
723,Andy Diouf,FRA,Lens,Ligue 1,2023,20.0,2003.0,14.6,28,19,12,11,5,14,22,63.6,8,13,3,10,3,31,5,1,MF,20-24,Midfielder,France,Europe
724,Yehvann Diouf,FRA,Reims,Ligue 1,2023,23.0,1999.0,34.0,0,0,0,0,0,0,1,0.0,1,0,0,0,1,1,19,3,GK,20-24,Goalkeeper,France,Europe
725,Axel Disasi,FRA,Chelsea,Premier League,2023,25.0,1998.0,28.7,33,19,20,10,3,23,30,76.7,7,26,19,7,18,51,102,2,DF,25-29,Defender,France,Europe
726,Tiago Djaló,POR,Juventus,Serie A,2023,23.0,2000.0,0.2,0,0,0,0,0,0,0,,0,1,0,1,0,0,1,0,DF,20-24,Defender,Portugal,Europe
727,Chaim El Djebali,TUN,Lyon,Ligue 1,2023,19.0,2004.0,0.1,0,0,0,0,0,0,0,,0,0,0,0,0,0,0,0,MF,Under 20,Midfielder,Tunisia,Africa
729,Koffi Djidji,CIV,Torino,Serie A,2023,30.0,1992.0,8.4,14,9,9,5,0,3,4,75.0,1,10,5,5,10,24,20,0,DF,30-34,Defender,Ivory Coast,Africa
730,Berat Djimsiti,ALB,Atalanta,Serie A,2023,30.0,1993.0,31.5,42,24,29,12,1,19,31,61.3,12,53,33,20,57,99,100,0,DF,30-34,Defender,Albania,Europe
732,Ben Doak,SCO,Liverpool,Premier League,2023,17.0,2005.0,0.2,0,0,0,0,0,0,0,,0,0,0,0,0,0,0,0,FW,Under 20,Forward,Scotland,Europe
733,Ritsu Doan,JPN,Freiburg,Bundesliga,2023,25.0,1998.0,25.0,50,27,21,19,10,21,36,58.3,15,30,3,27,9,59,29,0,"DF,MF",25-29,Defender,Japan,Asia
734,Lewis Dobbin,ENG,Everton,Premier League,2023,20.0,2003.0,2.6,9,7,3,5,1,5,9,55.6,4,5,1,4,1,10,0,0,MF,20-24,Midfielder,England,Europe
735,Dodô,BRA,Fiorentina,Serie A,2023,24.0,1998.0,5.8,5,3,1,4,0,2,5,40.0,3,2,0,2,5,10,11,0,DF,20-24,Defender,Brazil,South America
735,Dodô,BRA,Fiorentina,Serie A,2023,24.0,1998.0,5.8,5,3,1,4,0,2,5,40.0,3,2,0,2,5,10,11,0,DF,20-24,Defender,Brazil,South America
735,Dodô,BRA,Fiorentina,Serie A,2023,24.0,1998.0,5.8,5,3,1,4,0,2,5,40.0,3,2,0,2,5,10,11,0,DF,20-24,Defender,Brazil,South America
735,Dodô,BRA,Fiorentina,Serie A,2023,24.0,1998.0,5.8,5,3,1,4,0,2,5,40.0,3,2,0,2,5,10,11,0,DF,20-24,Defender,Brazil,South America
735,Dodô,BRA,Fiorentina,Serie A,2023,24.0,1998.0,5.8,5,3,1,4,0,2,5,40.0,3,2,0,2,5,10,11,0,DF,20-24,Defender,Brazil,South America
735,Dodô,BRA,Fiorentina,Serie A,2023,24.0,1998.0,5.8,5,3,1,4,0,2,5,40.0,3,2,0,2,5,10,11,0,DF,20-24,Defender,Brazil,South America
735,Dodô,BRA,Fiorentina,Serie A,2023,24.0,1998.0,5.8,5,3,1,4,0,2,5,40.0,3,2,0,2,5,10,11,0,DF,20-24,Defender,Brazil,South America
735,Dodô,BRA,Fiorentina,Serie A,2023,24.0,1998.0,5.8,5,3,1,4,0,2,5,40.0,3,2,0,2,5,10,11,0,DF,20-24,Defender,Brazil,South America
735,Dodô,BRA,Fiorentina,Serie A,2023,24.0,1998.0,5.8,5,3,1,4,0,2,5,40.0,3,2,0,2,5,10,11,0,DF,20-24,Defender,Brazil,South America
736,Danilho Doekhi,NED,Union Berlin,Bundesliga,2023,25.0,1998.0,24.0,34,23,18,16,0,15,21,71.4,6,46,25,21,38,72,111,1,DF,25-29,Defender,Netherlands,Europe
737,Matt Doherty,IRL,Wolves,Premier League,2023,31.0,1992.0,12.8,31,18,17,10,4,12,23,52.2,11,15,5,10,7,38,47,0,"DF,MF",30-34,Defender,Republic of Ireland,Europe
738,Josh Doig,SCO,Hellas Verona,Serie A,2023,21.0,2002.0,9.2,16,9,9,7,0,13,17,76.5,4,12,3,9,4,20,17,1,DF,20-24,Defender,Scotland,Europe
739,Josh Doig,SCO,Sassuolo,Serie A,2023,21.0,2002.0,14.9,25,17,16,9,0,15,27,55.6,12,31,10,21,16,41,38,0,DF,20-24,Defender,Scotland,Europe
740,Jeremy Doku,BEL,Manchester City,Premier League,2023,21.0,2002.0,17.7,39,22,13,12,14,9,20,45.0,11,14,0,14,9,48,5,0,"FW,MF",20-24,Forward,Belgium,Europe
741,Jeremy Doku,BEL,Rennes,Ligue 1,2023,21.0,2002.0,1.2,2,2,1,0,1,1,1,100.0,0,0,0,0,0,2,0,0,FW,20-24,Forward,Belgium,Europe
745,Nicolás Domínguez,ARG,Nott'ham Forest,Premier League,2023,25.0,1998.0,16.6,63,34,35,27,1,23,48,47.9,25,31,5,26,18,81,24,0,"MF,FW",25-29,Midfielder,Argentina,South America
746,Nicolás Domínguez,ARG,Bologna,Serie A,2023,25.0,1998.0,1.1,1,0,1,0,0,0,2,0.0,2,3,0,3,0,1,2,0,MF,25-29,Midfielder,Argentina,South America
747,Giulio Donati,ITA,Monza,Serie A,2023,33.0,1990.0,0.4,0,0,0,0,0,0,0,,0,0,0,0,0,0,1,1,DF,30-34,Defender,Italy,Europe
748,Jamie Donley,ENG,Tottenham,Premier League,2023,18.0,2005.0,0.0,0,0,0,0,0,0,0,,0,0,0,0,0,0,3,0,FW,Under 20,Forward,England,Europe
749,Gianluigi Donnarumma,ITA,Paris S-G,Ligue 1,2023,24.0,1999.0,24.1,0,0,0,0,0,0,0,,0,0,0,0,1,1,9,4,GK,20-24,Goalkeeper,Italy,Europe
750,Patrick Dorgu,DEN,Lecce,Serie A,2023,18.0,2004.0,17.4,43,22,22,17,4,22,34,64.7,12,16,5,11,9,52,45,2,"DF,MF",Under 20,Defender,Denmark,Europe
751,Niklas Dorsch,GER,Augsburg,Bundesliga,2023,25.0,1998.0,15.4,35,24,13,21,1,13,33,39.4,20,15,9,6,16,51,27,0,MF,25-29,Midfielder,Germany,Europe
752,Alberto Dossena,ITA,Cagliari,Serie A,2023,24.0,1998.0,33.1,55,35,43,12,0,32,48,66.7,16,50,27,23,45,100,172,2,DF,20-24,Defender,Italy,Europe
754,Abdoulaye Doucouré,MLI,Everton,Premier League,2023,30.0,1993.0,29.2,43,27,20,14,9,18,46,39.1,28,23,3,20,15,58,19,0,"FW,MF",30-34,Forward,Mali,Africa
755,Cheick Doucouré,MLI,Crystal Palace,Premier League,2023,23.0,2000.0,10.2,34,17,15,13,6,18,30,60.0,12,13,2,11,20,54,12,0,MF,20-24,Midfielder,Mali,Africa
756,Siriné Doucouré,MLI,Lorient,Ligue 1,2023,21.0,2002.0,4.7,8,6,0,4,4,3,3,100.0,0,4,0,4,1,9,6,0,FW,20-24,Forward,Mali,Africa
757,Désiré Doué,FRA,Rennes,Ligue 1,2023,18.0,2005.0,18.1,32,18,11,14,7,10,33,30.3,23,30,1,29,14,46,8,0,"MF,FW",Under 20,Midfielder,France,Europe
758,Guela Doué,CIV,Rennes,Ligue 1,2023,20.0,2002.0,13.7,28,21,14,12,2,22,32,68.8,10,12,1,11,15,43,65,1,DF,20-24,Defender,Ivory Coast,Africa
759,Alfie Doughty,ENG,Luton Town,Premier League,2023,23.0,1999.0,32.5,63,40,29,18,16,37,82,45.1,45,51,9,42,31,94,43,4,DF,20-24,Defender,England,Europe
760,Douglas,BRA,Nantes,Ligue 1,2023,26.0,1997.0,19.7,70,42,34,30,6,30,59,50.8,29,22,8,14,26,96,30,0,MF,25-29,Midfielder,Brazil,South America
760,Douglas,BRA,Nantes,Ligue 1,2023,26.0,1997.0,19.7,70,42,34,30,6,30,59,50.8,29,22,8,14,26,96,30,0,MF,25-29,Midfielder,Brazil,South America
760,Douglas,BRA,Nantes,Ligue 1,2023,26.0,1997.0,19.7,70,42,34,30,6,30,59,50.8,29,22,8,14,26,96,30,0,MF,25-29,Midfielder,Brazil,South America
760,Douglas,BRA,Nantes,Ligue 1,2023,26.0,1997.0,19.7,70,42,34,30,6,30,59,50.8,29,22,8,14,26,96,30,0,MF,25-29,Midfielder,Brazil,South America
760,Douglas,BRA,Nantes,Ligue 1,2023,26.0,1997.0,19.7,70,42,34,30,6,30,59,50.8,29,22,8,14,26,96,30,0,MF,25-29,Midfielder,Brazil,South America
760,Douglas,BRA,Nantes,Ligue 1,2023,26.0,1997.0,19.7,70,42,34,30,6,30,59,50.8,29,22,8,14,26,96,30,0,MF,25-29,Midfielder,Brazil,South America
760,Douglas,BRA,Nantes,Ligue 1,2023,26.0,1997.0,19.7,70,42,34,30,6,30,59,50.8,29,22,8,14,26,96,30,0,MF,25-29,Midfielder,Brazil,South America
760,Douglas,BRA,Nantes,Ligue 1,2023,26.0,1997.0,19.7,70,42,34,30,6,30,59,50.8,29,22,8,14,26,96,30,0,MF,25-29,Midfielder,Brazil,South America
760,Douglas,BRA,Nantes,Ligue 1,2023,26.0,1997.0,19.7,70,42,34,30,6,30,59,50.8,29,22,8,14,26,96,30,0,MF,25-29,Midfielder,Brazil,South America
760,Douglas,BRA,Nantes,Ligue 1,2023,26.0,1997.0,19.7,70,42,34,30,6,30,59,50.8,29,22,8,14,26,96,30,0,MF,25-29,Midfielder,Brazil,South America
760,Douglas,BRA,Nantes,Ligue 1,2023,26.0,1997.0,19.7,70,42,34,30,6,30,59,50.8,29,22,8,14,26,96,30,0,MF,25-29,Midfielder,Brazil,South America
760,Douglas,BRA,Nantes,Ligue 1,2023,26.0,1997.0,19.7,70,42,34,30,6,30,59,50.8,29,22,8,14,26,96,30,0,MF,25-29,Midfielder,Brazil,South America
760,Douglas,BRA,Nantes,Ligue 1,2023,26.0,1997.0,19.7,70,42,34,30,6,30,59,50.8,29,22,8,14,26,96,30,0,MF,25-29,Midfielder,Brazil,South America
760,Douglas,BRA,Nantes,Ligue 1,2023,26.0,1997.0,19.7,70,42,34,30,6,30,59,50.8,29,22,8,14,26,96,30,0,MF,25-29,Midfielder,Brazil,South America
760,Douglas,BRA,Nantes,Ligue 1,2023,26.0,1997.0,19.7,70,42,34,30,6,30,59,50.8,29,22,8,14,26,96,30,0,MF,25-29,Midfielder,Brazil,South America
760,Douglas,BRA,Nantes,Ligue 1,2023,26.0,1997.0,19.7,70,42,34,30,6,30,59,50.8,29,22,8,14,26,96,30,0,MF,25-29,Midfielder,Brazil,South America
760,Douglas,BRA,Nantes,Ligue 1,2023,26.0,1997.0,19.7,70,42,34,30,6,30,59,50.8,29,22,8,14,26,96,30,0,MF,25-29,Midfielder,Brazil,South America
760,Douglas,BRA,Nantes,Ligue 1,2023,26.0,1997.0,19.7,70,42,34,30,6,30,59,50.8,29,22,8,14,26,96,30,0,MF,25-29,Midfielder,Brazil,South America
760,Douglas,BRA,Nantes,Ligue 1,2023,26.0,1997.0,19.7,70,42,34,30,6,30,59,50.8,29,22,8,14,26,96,30,0,MF,25-29,Midfielder,Brazil,South America
760,Douglas,BRA,Nantes,Ligue 1,2023,26.0,1997.0,19.7,70,42,34,30,6,30,59,50.8,29,22,8,14,26,96,30,0,MF,25-29,Midfielder,Brazil,South America
760,Douglas,BRA,Nantes,Ligue 1,2023,26.0,1997.0,19.7,70,42,34,30,6,30,59,50.8,29,22,8,14,26,96,30,0,MF,25-29,Midfielder,Brazil,South America
760,Douglas,BRA,Nantes,Ligue 1,2023,26.0,1997.0,19.7,70,42,34,30,6,30,59,50.8,29,22,8,14,26,96,30,0,MF,25-29,Midfielder,Brazil,South America
760,Douglas,BRA,Nantes,Ligue 1,2023,26.0,1997.0,19.7,70,42,34,30,6,30,59,50.8,29,22,8,14,26,96,30,0,MF,25-29,Midfielder,Brazil,South America
760,Douglas,BRA,Nantes,Ligue 1,2023,26.0,1997.0,19.7,70,42,34,30,6,30,59,50.8,29,22,8,14,26,96,30,0,MF,25-29,Midfielder,Brazil,South America
760,Douglas,BRA,Nantes,Ligue 1,2023,26.0,1997.0,19.7,70,42,34,30,6,30,59,50.8,29,22,8,14,26,96,30,0,MF,25-29,Midfielder,Brazil,South America
761,Ismaël Doukouré,FRA,Strasbourg,Ligue 1,2023,20.0,2003.0,18.4,23,16,7,14,2,13,21,61.9,8,19,7,12,19,42,29,2,"MF,DF",20-24,Midfielder,France,Europe
762,Kamory Doumbia,MLI,Brest,Ligue 1,2023,20.0,2003.0,9.8,28,18,8,10,10,10,29,34.5,19,14,0,14,9,37,6,0,MF,20-24,Midfielder,Mali,Africa
763,Anastasios Douvikas,GRE,Celta Vigo,La Liga,2023,23.0,1999.0,10.1,15,7,2,6,7,3,8,37.5,5,6,3,3,2,17,9,0,FW,20-24,Forward,Greece,Europe
764,Artem Dovbyk,UKR,Girona,La Liga,2023,26.0,1997.0,28.7,4,3,2,1,1,0,2,0.0,2,8,1,7,0,4,17,0,FW,25-29,Forward,Ukraine,Europe
765,Nikola Dovedan,AUT,Heidenheim,Bundesliga,2023,29.0,1994.0,7.3,14,9,2,10,2,5,25,20.0,20,9,0,9,1,15,3,0,"MF,FW",25-29,Midfielder,Austria,Europe
766,Damion Downs,USA,Köln,Bundesliga,2023,19.0,2004.0,2.0,1,1,1,0,0,1,2,50.0,1,1,0,1,0,1,1,0,"FW,MF",Under 20,Forward,United States,North America
767,Tommy Doyle,ENG,Wolves,Premier League,2023,21.0,2001.0,13.6,26,13,11,10,5,14,23,60.9,9,22,9,13,12,38,18,0,MF,20-24,Midfielder,England,Europe
768,Radu Drăgușin,ROU,Tottenham,Premier League,2023,21.0,2002.0,4.8,5,3,5,0,0,3,3,100.0,0,5,4,1,8,13,19,0,DF,20-24,Defender,Romania,Europe
769,Radu Drăgușin,ROU,Genoa,Serie A,2023,21.0,2002.0,19.0,16,11,9,6,1,8,9,88.9,1,18,12,6,21,37,87,3,DF,20-24,Defender,Romania,Europe
770,Dion Drena Beljo,CRO,Augsburg,Bundesliga,2023,21.0,2002.0,6.5,0,0,0,0,0,0,2,0.0,2,8,1,7,1,1,4,0,"FW,MF",20-24,Forward,Croatia,Europe
771,Tim Drexler,GER,Hoffenheim,Bundesliga,2023,18.0,2005.0,6.4,16,9,12,4,0,8,17,47.1,9,12,8,4,8,24,14,0,DF,Under 20,Defender,Germany,Europe
772,Domingos Duarte,POR,Getafe,La Liga,2023,28.0,1995.0,10.1,7,4,6,0,1,5,7,71.4,2,7,5,2,8,15,27,0,DF,25-29,Defender,Portugal,Europe
774,Martin Dúbravka,SVK,Newcastle Utd,Premier League,2023,34.0,1989.0,22.1,0,0,0,0,0,0,4,0.0,4,0,0,0,0,0,8,1,GK,30-34,Goalkeeper,Slovakia,Europe
775,Marvin Ducksch,GER,Werder Bremen,Bundesliga,2023,29.0,1994.0,30.0,8,3,4,3,1,6,14,42.9,8,2,0,2,4,12,25,0,FW,25-29,Forward,Germany,Europe
776,Ondrej Duda,SVK,Hellas Verona,Serie A,2023,28.0,1994.0,27.3,59,39,17,35,7,31,52,59.6,21,29,12,17,26,85,21,0,MF,25-29,Midfielder,Slovakia,Europe
777,Denzel Dumfries,NED,Inter,Serie A,2023,27.0,1996.0,18.2,22,13,9,11,2,9,23,39.1,14,15,6,9,12,34,33,1,DF,25-29,Defender,Netherlands,Europe
778,Paul Dummett,WAL,Newcastle Utd,Premier League,2023,31.0,1991.0,0.2,1,0,1,0,0,1,1,100.0,0,0,0,0,0,1,1,0,DF,30-34,Defender,Wales,Europe
779,Alfred Duncan,GHA,Fiorentina,Serie A,2023,30.0,1993.0,21.0,35,22,13,15,7,15,35,42.9,20,27,5,22,11,46,13,0,MF,30-34,Midfielder,Ghana,Africa
780,Lewis Dunk,ENG,Brighton,Premier League,2023,31.0,1991.0,31.9,27,14,17,9,1,13,36,36.1,23,49,37,12,31,58,90,1,DF,30-34,Defender,England,Europe
781,Jhon Durán,COL,Aston Villa,Premier League,2023,19.0,2003.0,5.3,6,5,3,1,2,1,6,16.7,5,6,0,6,1,7,10,0,"FW,MF",Under 20,Forward,Colombia,South America
782,Julien Duranville,BEL,Dortmund,Bundesliga,2023,17.0,2006.0,0.1,1,0,0,1,0,1,1,100.0,0,0,0,0,0,1,0,0,"FW,MF",Under 20,Forward,Belgium,Europe
784,Jean-Kevin Duverne,HAI,Nantes,Ligue 1,2023,26.0,1997.0,15.0,37,19,16,17,4,18,44,40.9,26,17,5,12,18,55,34,0,DF,25-29,Defender,Haiti,North America
785,Paulo Dybala,ARG,Roma,Serie A,2023,29.0,1993.0,21.8,22,13,3,10,9,2,18,11.1,16,12,0,12,3,25,6,1,"FW,MF",25-29,Forward,Argentina,South America
787,George Earthy,ENG,West Ham,Premier League,2023,18.0,2004.0,0.4,0,0,0,0,0,0,1,0.0,1,0,0,0,1,1,0,0,FW,Under 20,Forward,England,Europe
788,Simon Ebonog,CMR,Le Havre,Ligue 1,2023,18.0,2004.0,0.2,1,1,0,1,0,1,1,100.0,0,1,1,0,0,1,1,0,MF,Under 20,Midfielder,Cameroon,Africa
789,Festy Ebosele,IRL,Udinese,Serie A,2023,20.0,2002.0,18.9,33,20,23,9,1,21,35,60.0,14,33,2,31,10,43,27,0,DF,20-24,Defender,Republic of Ireland,Europe
790,Enzo Ebosse,CMR,Udinese,Serie A,2023,24.0,1999.0,0.1,1,1,1,0,0,0,1,0.0,1,0,0,0,1,2,0,0,DF,20-24,Defender,Cameroon,Africa
791,Tyronne Ebuehi,NGA,Empoli,Serie A,2023,27.0,1995.0,12.2,14,9,9,5,0,7,11,63.6,4,9,4,5,6,20,27,1,DF,25-29,Defender,Nigeria,Africa
792,Ederson,BRA,Manchester City,Premier League,2023,29.0,1993.0,30.9,0,0,0,0,0,0,1,0.0,1,0,0,0,0,0,10,1,GK,25-29,Goalkeeper,Brazil,South America
792,Ederson,BRA,Manchester City,Premier League,2023,29.0,1993.0,30.9,0,0,0,0,0,0,1,0.0,1,0,0,0,0,0,10,1,GK,25-29,Goalkeeper,Brazil,South America
792,Ederson,BRA,Manchester City,Premier League,2023,29.0,1993.0,30.9,0,0,0,0,0,0,1,0.0,1,0,0,0,0,0,10,1,GK,25-29,Goalkeeper,Brazil,South America
792,Ederson,BRA,Manchester City,Premier League,2023,29.0,1993.0,30.9,0,0,0,0,0,0,1,0.0,1,0,0,0,0,0,10,1,GK,25-29,Goalkeeper,Brazil,South America
793,Éderson,BRA,Atalanta,Serie A,2023,24.0,1999.0,31.9,83,49,38,38,7,44,63,69.8,19,48,8,40,41,124,33,1,MF,20-24,Midfielder,Brazil,South America
794,Odsonne Édouard,FRA,Crystal Palace,Premier League,2023,25.0,1998.0,17.3,24,12,8,8,8,4,19,21.1,15,17,1,16,6,30,19,0,"FW,MF",25-29,Forward,France,Europe
795,John Egan,IRL,Sheffield Utd,Premier League,2023,30.0,1992.0,5.4,6,4,4,2,0,4,11,36.4,7,10,4,6,13,19,39,1,DF,30-34,Defender,Republic of Ireland,Europe
796,Maximilian Eggestein,GER,Freiburg,Bundesliga,2023,26.0,1996.0,32.4,49,24,25,19,5,15,36,41.7,21,53,19,34,28,77,40,1,MF,25-29,Midfielder,Germany,Europe
797,Lilian Egloff,GER,Stuttgart,Bundesliga,2023,20.0,2002.0,1.2,4,1,3,1,0,2,4,50.0,2,3,1,2,1,5,0,0,"MF,DF",20-24,Midfielder,Germany,Europe
798,Kingsley Ehizibue,NED,Udinese,Serie A,2023,28.0,1995.0,10.6,22,14,16,4,2,11,18,61.1,7,21,3,18,8,30,36,0,DF,25-29,Defender,Netherlands,Europe
799,Hjalmar Ekdal,SWE,Burnley,Premier League,2023,24.0,1998.0,4.9,4,2,2,2,0,2,4,50.0,2,10,5,5,6,10,21,0,DF,20-24,Defender,Sweden,Europe
800,Hugo Ekitike,FRA,Paris S-G,Ligue 1,2023,21.0,2002.0,0.1,0,0,0,0,0,0,0,,0,0,0,0,0,0,0,0,FW,20-24,Forward,France,Europe
801,Hugo Ekitike,FRA,Eint Frankfurt,Bundesliga,2023,21.0,2002.0,8.0,11,7,3,6,2,4,6,66.7,2,10,0,10,2,13,4,0,FW,20-24,Forward,France,Europe
802,Emmanuel Ekong,SWE,Empoli,Serie A,2023,21.0,2002.0,0.1,0,0,0,0,0,0,0,,0,0,0,0,0,0,0,0,FW,20-24,Forward,Sweden,Europe
803,Caleb Ekuban,GHA,Genoa,Serie A,2023,29.0,1994.0,12.6,8,4,2,4,2,5,9,55.6,4,11,3,8,1,9,7,0,FW,25-29,Forward,Ghana,Africa
804,Anthony Elanga,SWE,Nott'ham Forest,Premier League,2023,21.0,2002.0,27.0,33,19,20,6,7,17,36,47.2,19,22,2,20,8,41,20,1,"FW,MF",20-24,Forward,Sweden,Europe
805,Simon Elisor,FRA,Metz,Ligue 1,2023,24.0,1999.0,8.5,9,2,3,2,4,2,6,33.3,4,6,1,5,0,9,9,0,FW,20-24,Forward,France,Europe
806,Harvey Elliott,ENG,Liverpool,Premier League,2023,20.0,2003.0,15.0,27,17,8,14,5,10,31,32.3,21,27,0,27,6,33,7,0,"MF,FW",20-24,Midfielder,England,Europe
807,Elif Elmas,MKD,Napoli,Serie A,2023,23.0,1999.0,3.8,4,3,1,3,0,2,2,100.0,0,2,0,2,2,6,8,0,"FW,MF",20-24,Forward,North Macedonia,Europe
808,Elif Elmas,MKD,RB Leipzig,Bundesliga,2023,23.0,1999.0,3.0,8,6,1,6,1,6,8,75.0,2,5,0,5,1,9,2,0,"MF,FW",20-24,Midfielder,North Macedonia,Europe
809,Mohamed Elneny,EGY,Arsenal,Premier League,2023,31.0,1992.0,0.3,0,0,0,0,0,0,1,0.0,1,0,0,0,1,1,0,0,MF,30-34,Midfielder,Egypt,Africa
811,Nico Elvedi,SUI,Gladbach,Bundesliga,2023,26.0,1996.0,27.6,33,18,22,10,1,18,24,75.0,6,40,25,15,43,76,150,2,DF,25-29,Defender,Switzerland,Europe
813,Breel Embolo,SUI,Monaco,Ligue 1,2023,26.0,1997.0,2.0,3,3,0,2,1,1,4,25.0,3,1,0,1,1,4,2,0,FW,25-29,Forward,Switzerland,Europe
814,Emanuel Emegha,NED,Strasbourg,Ligue 1,2023,20.0,2003.0,23.1,8,5,2,4,2,4,9,44.4,5,13,3,10,2,10,25,0,FW,20-24,Forward,Netherlands,Europe
815,Emerson,BRA,Tottenham,Premier League,2023,24.0,1999.0,12.9,36,24,23,10,3,21,43,48.8,22,23,10,13,20,56,50,1,DF,20-24,Defender,Brazil,South America
816,Youssef En-Nesyri,MAR,Sevilla,La Liga,2023,26.0,1997.0,28.6,10,7,3,4,3,0,10,0.0,10,9,1,8,7,17,29,1,FW,25-29,Forward,Morocco,Africa
817,Julio Enciso,PAR,Brighton,Premier League,2023,19.0,2004.0,5.3,6,2,3,2,1,2,7,28.6,5,11,0,11,0,6,3,0,"MF,FW",Under 20,Midfielder,Paraguay,South America
818,Wataru Endo,JPN,Liverpool,Premier League,2023,30.0,1993.0,19.1,48,28,11,31,6,20,61,32.8,41,24,2,22,20,68,31,3,MF,30-34,Midfielder,Japan,Asia
819,Arne Engels,BEL,Augsburg,Bundesliga,2023,19.0,2003.0,15.6,33,18,15,14,4,12,29,41.4,17,23,1,22,15,48,21,0,"MF,DF",Under 20,Midfielder,Belgium,Europe
820,Christian Eriksen,DEN,Manchester Utd,Premier League,2023,31.0,1992.0,12.7,18,13,5,10,3,12,33,36.4,21,17,6,11,4,22,13,0,MF,30-34,Midfielder,Denmark,Europe
821,Martin Erlic,CRO,Sassuolo,Serie A,2023,25.0,1998.0,29.1,37,22,26,8,3,20,30,66.7,10,31,16,15,28,65,128,1,DF,25-29,Defender,Croatia,Europe
822,Gonzalo Escalante,ARG,Cádiz,La Liga,2023,30.0,1993.0,18.9,39,24,16,14,9,20,55,36.4,35,23,5,18,26,65,33,2,MF,30-34,Midfielder,Argentina,South America
824,Alfonso Espino,URU,Rayo Vallecano,La Liga,2023,31.0,1992.0,27.9,67,45,43,22,2,30,82,36.6,52,26,4,22,40,107,63,0,DF,30-34,Defender,Uruguay,South America
825,Bernardo Espinosa,COL,Girona,La Liga,2023,34.0,1989.0,0.0,1,1,1,0,0,1,1,100.0,0,0,0,0,0,1,2,0,DF,30-34,Defender,Colombia,South America
826,Maxime Estève,FRA,Burnley,Premier League,2023,21.0,2002.0,14.5,27,10,15,12,0,18,32,56.3,14,21,10,11,27,54,56,0,DF,20-24,Defender,France,Europe
827,Maxime Estève,FRA,Montpellier,Ligue 1,2023,21.0,2002.0,11.1,16,12,11,5,0,10,15,66.7,5,13,9,4,18,34,50,0,DF,20-24,Defender,France,Europe
828,Oscar Estupiñan,COL,Metz,Ligue 1,2023,26.0,1996.0,2.9,5,4,0,3,2,1,2,50.0,1,2,0,2,0,5,0,0,FW,25-29,Forward,Colombia,South America
829,Pervis Estupiñán,ECU,Brighton,Premier League,2023,25.0,1998.0,13.8,26,13,12,11,3,14,30,46.7,16,14,4,10,21,47,20,0,DF,25-29,Defender,Ecuador,South America
830,Karl Etta,CMR,Cádiz,La Liga,2023,19.0,2003.0,0.2,1,1,0,1,0,0,0,,0,0,0,0,0,1,0,0,FW,Under 20,Forward,Cameroon,Africa
832,Eberechi Eze,ENG,Crystal Palace,Premier League,2023,25.0,1998.0,22.8,35,17,4,18,13,15,31,48.4,16,27,2,25,11,46,6,0,"MF,FW",25-29,Midfielder,England,Europe
833,Abde Ezzalzouli,MAR,Barcelona,La Liga,2023,21.0,2001.0,0.8,1,1,0,0,1,0,1,0.0,1,1,0,1,0,1,0,0,"FW,MF",20-24,Forward,Morocco,Africa
834,Abde Ezzalzouli,MAR,Betis,La Liga,2023,21.0,2001.0,9.6,17,14,7,5,5,4,14,28.6,10,10,0,10,5,22,5,0,FW,20-24,Forward,Morocco,Africa
835,Giovanni Fabbian,ITA,Bologna,Serie A,2023,20.0,2003.0,11.7,17,10,9,7,1,7,12,58.3,5,5,2,3,7,24,11,0,"MF,FW",20-24,Midfielder,Italy,Europe
837,Nicolò Fagioli,ITA,Juventus,Serie A,2023,22.0,2001.0,4.9,5,3,1,3,1,3,7,42.9,4,3,0,3,4,9,1,0,MF,20-24,Midfielder,Italy,Europe
838,Romain Faivre,FRA,Bournemouth,Premier League,2023,25.0,1998.0,0.5,1,1,0,1,0,0,3,0.0,3,0,0,0,0,1,0,0,"MF,FW",25-29,Midfielder,France,Europe
839,Romain Faivre,FRA,Lorient,Ligue 1,2023,25.0,1998.0,16.1,13,6,5,4,4,6,15,40.0,9,6,1,5,7,20,3,1,"MF,FW",25-29,Midfielder,France,Europe
840,Ilhan Fakili,FRA,Clermont Foot,Ligue 1,2023,17.0,2006.0,1.0,0,0,0,0,0,0,1,0.0,1,1,0,1,1,1,0,0,"MF,FW",Under 20,Midfielder,France,Europe
841,Radamel Falcao,COL,Rayo Vallecano,La Liga,2023,37.0,1986.0,4.5,7,5,1,5,1,1,3,33.3,2,2,0,2,3,10,4,0,"FW,DF",35-39,Forward,Colombia,South America
842,Wladimiro Falcone,ITA,Lecce,Serie A,2023,28.0,1995.0,38.0,0,0,0,0,0,0,0,,0,1,0,1,1,1,21,2,GK,25-29,Goalkeeper,Italy,Europe
844,Davide Faraoni,ITA,Hellas Verona,Serie A,2023,31.0,1991.0,6.7,13,10,5,6,2,7,10,70.0,3,9,5,4,6,19,21,0,DF,30-34,Defender,Italy,Europe
845,Davide Faraoni,ITA,Fiorentina,Serie A,2023,31.0,1991.0,4.4,9,4,5,2,2,5,11,45.5,6,3,1,2,5,14,14,0,DF,30-34,Defender,Italy,Europe
848,Khalil Fayad,FRA,Montpellier,Ligue 1,2023,19.0,2004.0,11.4,28,15,17,7,4,9,22,40.9,13,15,3,12,14,42,6,0,"FW,MF",Under 20,Forward,France,Europe
849,Federico Fazio,ARG,Salernitana,Serie A,2023,36.0,1987.0,15.1,18,11,14,4,0,8,14,57.1,6,22,19,3,17,35,99,1,DF,35-39,Defender,Argentina,South America
850,Jacopo Fazzini,ITA,Empoli,Serie A,2023,20.0,2003.0,13.7,49,25,27,13,9,30,53,56.6,23,21,3,18,12,61,18,0,MF,20-24,Midfielder,Italy,Europe
851,Peter Federico,DOM,Valencia,La Liga,2023,21.0,2002.0,7.2,5,3,3,1,1,1,10,10.0,9,11,0,11,7,12,10,0,"MF,FW",20-24,Midfielder,Dominican Republic,North America
852,Nabil Fekir,FRA,Betis,La Liga,2023,30.0,1993.0,11.7,15,10,5,7,3,5,10,50.0,5,9,0,9,7,22,3,0,"MF,FW",30-34,Midfielder,France,Europe
853,Felipe,BRA,Nott'ham Forest,Premier League,2023,34.0,1989.0,4.2,12,9,9,3,0,9,12,75.0,3,4,1,3,4,16,12,0,DF,30-34,Defender,Brazil,South America
853,Felipe,BRA,Nott'ham Forest,Premier League,2023,34.0,1989.0,4.2,12,9,9,3,0,9,12,75.0,3,4,1,3,4,16,12,0,DF,30-34,Defender,Brazil,South America
853,Felipe,BRA,Nott'ham Forest,Premier League,2023,34.0,1989.0,4.2,12,9,9,3,0,9,12,75.0,3,4,1,3,4,16,12,0,DF,30-34,Defender,Brazil,South America
853,Felipe,BRA,Nott'ham Forest,Premier League,2023,34.0,1989.0,4.2,12,9,9,3,0,9,12,75.0,3,4,1,3,4,16,12,0,DF,30-34,Defender,Brazil,South America
854,Luiz Felipe,ITA,Betis,La Liga,2023,26.0,1997.0,4.0,7,3,5,2,0,4,5,80.0,1,10,4,6,4,11,16,0,DF,25-29,Defender,Italy,Europe
854,Luiz Felipe,ITA,Betis,La Liga,2023,26.0,1997.0,4.0,7,3,5,2,0,4,5,80.0,1,10,4,6,4,11,16,0,DF,25-29,Defender,Italy,Europe
854,Luiz Felipe,ITA,Betis,La Liga,2023,26.0,1997.0,4.0,7,3,5,2,0,4,5,80.0,1,10,4,6,4,11,16,0,DF,25-29,Defender,Italy,Europe
854,Luiz Felipe,ITA,Betis,La Liga,2023,26.0,1997.0,4.0,7,3,5,2,0,4,5,80.0,1,10,4,6,4,11,16,0,DF,25-29,Defender,Italy,Europe
855,João Félix,POR,Barcelona,La Liga,2023,23.0,1999.0,17.1,22,16,9,7,6,8,22,36.4,14,14,1,13,10,32,11,0,FW,20-24,Forward,Portugal,Europe
856,Ohis Felix Uduokhai,GER,Augsburg,Bundesliga,2023,25.0,1997.0,32.5,37,21,18,14,5,16,25,64.0,9,45,35,10,46,83,178,2,DF,25-29,Defender,Germany,Europe
858,Evan Ferguson,IRL,Brighton,Premier League,2023,18.0,2004.0,15.2,14,6,4,7,3,5,14,35.7,9,10,3,7,2,16,8,0,FW,Under 20,Forward,Republic of Ireland,Europe
859,Lewis Ferguson,SCO,Bologna,Serie A,2023,23.0,1999.0,30.1,37,21,16,17,4,16,37,43.2,21,25,8,17,17,54,27,1,MF,20-24,Midfielder,Scotland,Europe
860,Bruno Fernandes,POR,Manchester Utd,Premier League,2023,28.0,1994.0,34.6,68,38,27,25,16,30,88,34.1,58,49,6,43,27,95,50,2,"MF,FW",25-29,Midfielder,Portugal,Europe
861,Edimilson Fernandes,SUI,Mainz 05,Bundesliga,2023,27.0,1996.0,14.3,25,16,15,9,1,16,24,66.7,8,14,6,8,22,47,52,0,DF,25-29,Defender,Switzerland,Europe
865,Enzo Fernández,ARG,Chelsea,Premier League,2023,22.0,2001.0,24.5,50,22,22,18,10,27,65,41.5,38,36,13,23,17,67,28,0,MF,20-24,Midfielder,Argentina,South America
869,Fernando,BRA,Sevilla,La Liga,2023,36.0,1987.0,5.1,9,8,2,4,3,5,9,55.6,4,2,0,2,7,16,9,0,MF,35-39,Midfielder,Brazil,South America
869,Fernando,BRA,Sevilla,La Liga,2023,36.0,1987.0,5.1,9,8,2,4,3,5,9,55.6,4,2,0,2,7,16,9,0,MF,35-39,Midfielder,Brazil,South America
869,Fernando,BRA,Sevilla,La Liga,2023,36.0,1987.0,5.1,9,8,2,4,3,5,9,55.6,4,2,0,2,7,16,9,0,MF,35-39,Midfielder,Brazil,South America
869,Fernando,BRA,Sevilla,La Liga,2023,36.0,1987.0,5.1,9,8,2,4,3,5,9,55.6,4,2,0,2,7,16,9,0,MF,35-39,Midfielder,Brazil,South America
869,Fernando,BRA,Sevilla,La Liga,2023,36.0,1987.0,5.1,9,8,2,4,3,5,9,55.6,4,2,0,2,7,16,9,0,MF,35-39,Midfielder,Brazil,South America
869,Fernando,BRA,Sevilla,La Liga,2023,36.0,1987.0,5.1,9,8,2,4,3,5,9,55.6,4,2,0,2,7,16,9,0,MF,35-39,Midfielder,Brazil,South America
869,Fernando,BRA,Sevilla,La Liga,2023,36.0,1987.0,5.1,9,8,2,4,3,5,9,55.6,4,2,0,2,7,16,9,0,MF,35-39,Midfielder,Brazil,South America
869,Fernando,BRA,Sevilla,La Liga,2023,36.0,1987.0,5.1,9,8,2,4,3,5,9,55.6,4,2,0,2,7,16,9,0,MF,35-39,Midfielder,Brazil,South America
869,Fernando,BRA,Sevilla,La Liga,2023,36.0,1987.0,5.1,9,8,2,4,3,5,9,55.6,4,2,0,2,7,16,9,0,MF,35-39,Midfielder,Brazil,South America
869,Fernando,BRA,Sevilla,La Liga,2023,36.0,1987.0,5.1,9,8,2,4,3,5,9,55.6,4,2,0,2,7,16,9,0,MF,35-39,Midfielder,Brazil,South America
869,Fernando,BRA,Sevilla,La Liga,2023,36.0,1987.0,5.1,9,8,2,4,3,5,9,55.6,4,2,0,2,7,16,9,0,MF,35-39,Midfielder,Brazil,South America
869,Fernando,BRA,Sevilla,La Liga,2023,36.0,1987.0,5.1,9,8,2,4,3,5,9,55.6,4,2,0,2,7,16,9,0,MF,35-39,Midfielder,Brazil,South America
869,Fernando,BRA,Sevilla,La Liga,2023,36.0,1987.0,5.1,9,8,2,4,3,5,9,55.6,4,2,0,2,7,16,9,0,MF,35-39,Midfielder,Brazil,South America
869,Fernando,BRA,Sevilla,La Liga,2023,36.0,1987.0,5.1,9,8,2,4,3,5,9,55.6,4,2,0,2,7,16,9,0,MF,35-39,Midfielder,Brazil,South America
869,Fernando,BRA,Sevilla,La Liga,2023,36.0,1987.0,5.1,9,8,2,4,3,5,9,55.6,4,2,0,2,7,16,9,0,MF,35-39,Midfielder,Brazil,South America
869,Fernando,BRA,Sevilla,La Liga,2023,36.0,1987.0,5.1,9,8,2,4,3,5,9,55.6,4,2,0,2,7,16,9,0,MF,35-39,Midfielder,Brazil,South America
870,Ichem Ferrah,FRA,Lille,Ligue 1,2023,17.0,2005.0,0.0,0,0,0,0,0,0,0,,0,0,0,0,0,0,0,0,FW,Under 20,Forward,France,Europe
871,Andrea Ferraris,ITA,Monza,Serie A,2023,20.0,2003.0,0.1,1,1,1,0,0,0,0,,0,0,0,0,0,1,0,0,MF,20-24,Midfielder,Italy,Europe
872,André Ferreira,POR,Granada,La Liga,2023,27.0,1996.0,14.9,0,0,0,0,0,0,1,0.0,1,0,0,0,0,0,9,2,GK,25-29,Goalkeeper,Portugal,Europe
872,André Ferreira,POR,Granada,La Liga,2023,27.0,1996.0,14.9,0,0,0,0,0,0,1,0.0,1,0,0,0,0,0,9,2,GK,25-29,Goalkeeper,Portugal,Europe
872,André Ferreira,POR,Granada,La Liga,2023,27.0,1996.0,14.9,0,0,0,0,0,0,1,0.0,1,0,0,0,0,0,9,2,GK,25-29,Goalkeeper,Portugal,Europe
872,André Ferreira,POR,Granada,La Liga,2023,27.0,1996.0,14.9,0,0,0,0,0,0,1,0.0,1,0,0,0,0,0,9,2,GK,25-29,Goalkeeper,Portugal,Europe
872,André Ferreira,POR,Granada,La Liga,2023,27.0,1996.0,14.9,0,0,0,0,0,0,1,0.0,1,0,0,0,0,0,9,2,GK,25-29,Goalkeeper,Portugal,Europe
872,André Ferreira,POR,Granada,La Liga,2023,27.0,1996.0,14.9,0,0,0,0,0,0,1,0.0,1,0,0,0,0,0,9,2,GK,25-29,Goalkeeper,Portugal,Europe
872,André Ferreira,POR,Granada,La Liga,2023,27.0,1996.0,14.9,0,0,0,0,0,0,1,0.0,1,0,0,0,0,0,9,2,GK,25-29,Goalkeeper,Portugal,Europe
872,André Ferreira,POR,Granada,La Liga,2023,27.0,1996.0,14.9,0,0,0,0,0,0,1,0.0,1,0,0,0,0,0,9,2,GK,25-29,Goalkeeper,Portugal,Europe
872,André Ferreira,POR,Granada,La Liga,2023,27.0,1996.0,14.9,0,0,0,0,0,0,1,0.0,1,0,0,0,0,0,9,2,GK,25-29,Goalkeeper,Portugal,Europe
873,João Ferreira,POR,Udinese,Serie A,2023,22.0,2001.0,20.2,58,42,36,18,4,34,58,58.6,24,27,6,21,29,87,89,0,DF,20-24,Defender,Portugal,Europe
874,Jordan Ferri,FRA,Montpellier,Ligue 1,2023,31.0,1992.0,22.6,36,22,16,17,3,20,67,29.9,47,19,1,18,13,49,23,0,MF,30-34,Midfielder,France,Europe
876,Rachad Fettal,MAR,Almería,La Liga,2023,18.0,2005.0,0.2,1,1,1,0,0,0,0,,0,0,0,0,0,1,0,0,FW,Under 20,Forward,Morocco,Africa
877,Seydou Fini,ITA,Genoa,Serie A,2023,17.0,2006.0,0.4,0,0,0,0,0,0,0,,0,0,0,0,0,0,0,0,"DF,FW",Under 20,Defender,Italy,Europe
878,Max Finkgräfe,GER,Köln,Bundesliga,2023,19.0,2004.0,19.5,65,39,40,25,0,39,74,52.7,35,35,10,25,22,87,39,0,"DF,FW",Under 20,Defender,Germany,Europe
879,Vincenzo Fiorillo,ITA,Salernitana,Serie A,2023,33.0,1990.0,4.0,0,0,0,0,0,0,0,,0,0,0,0,0,0,0,1,GK,30-34,Goalkeeper,Italy,Europe
880,Kilian Fischer,GER,Wolfsburg,Bundesliga,2023,22.0,2000.0,3.2,8,6,4,3,1,2,5,40.0,3,8,1,7,1,9,12,0,"DF,MF",20-24,Defender,Germany,Europe
881,John Fleck,SCO,Sheffield Utd,Premier League,2023,31.0,1991.0,1.0,1,0,0,1,0,0,1,0.0,1,0,0,0,0,1,1,0,"MF,DF",30-34,Midfielder,Scotland,Europe
882,Mark Flekken,NED,Brentford,Premier League,2023,30.0,1993.0,36.5,1,1,1,0,0,1,5,20.0,4,1,0,1,0,1,17,1,GK,30-34,Goalkeeper,Netherlands,Europe
883,Alessandro Florenzi,ITA,Milan,Serie A,2023,32.0,1991.0,19.2,43,21,26,12,5,26,48,54.2,22,16,9,7,20,63,25,1,DF,30-34,Defender,Italy,Europe
884,Phil Foden,ENG,Manchester City,Premier League,2023,23.0,2000.0,31.7,31,20,11,10,10,13,31,41.9,18,30,0,30,13,44,18,1,"FW,MF",20-24,Forward,England,Europe
885,Wes Foderingham,ENG,Sheffield Utd,Premier League,2023,32.0,1991.0,29.4,5,3,5,0,0,5,6,83.3,1,0,0,0,0,5,18,6,GK,30-34,Goalkeeper,England,Europe
886,Malick Fofana,BEL,Lyon,Ligue 1,2023,18.0,2005.0,6.2,5,4,3,1,1,4,9,44.4,5,3,0,3,5,10,9,0,FW,Under 20,Forward,Belgium,Europe
887,Youssouf Fofana,FRA,Monaco,Ligue 1,2023,24.0,1999.0,30.0,61,39,19,36,6,30,66,45.5,36,35,7,28,37,98,31,1,MF,20-24,Midfielder,France,Europe
888,Jonas Föhrenbach,GER,Heidenheim,Bundesliga,2023,27.0,1996.0,31.0,44,24,24,14,6,19,36,52.8,17,34,19,15,31,75,70,0,DF,25-29,Defender,Germany,Europe
889,Thomas Foket,BEL,Reims,Ligue 1,2023,28.0,1994.0,20.4,32,17,21,8,3,20,45,44.4,25,34,12,22,25,57,36,0,DF,25-29,Defender,Belgium,Europe
890,Michael Folorunsho,ITA,Hellas Verona,Serie A,2023,25.0,1998.0,30.9,50,28,21,22,7,23,57,40.4,34,45,12,33,17,67,44,2,"MF,FW",25-29,Midfielder,Italy,Europe
891,Tiago Fonseca Morais,POR,Lille,Ligue 1,2023,19.0,2003.0,0.5,1,1,0,1,0,0,0,,0,0,0,0,1,2,0,0,FW,Under 20,Forward,Portugal,Europe
894,Emil Forsberg,SWE,RB Leipzig,Bundesliga,2023,31.0,1991.0,5.2,7,3,2,5,0,5,12,41.7,7,7,0,7,0,7,5,0,"MF,FW",30-34,Midfielder,Sweden,Europe
895,Omari Forson,ENG,Manchester Utd,Premier League,2023,19.0,2004.0,0.8,2,0,0,2,0,1,1,100.0,0,0,0,0,0,2,0,0,FW,Under 20,Forward,England,Europe
896,Philipp Förster,GER,Bochum,Bundesliga,2023,28.0,1995.0,4.3,9,5,3,4,2,2,6,33.3,4,3,0,3,7,16,3,0,"MF,FW",25-29,Midfielder,Germany,Europe
898,Lyle Foster,RSA,Burnley,Premier League,2023,22.0,2000.0,21.1,19,10,5,6,8,6,17,35.3,11,13,3,10,3,22,34,0,"FW,MF",20-24,Forward,South Africa,Africa
899,Dimitri Foulquier,FRA,Valencia,La Liga,2023,30.0,1993.0,20.5,39,22,22,13,4,18,26,69.2,8,10,1,9,16,55,49,1,"DF,MF",30-34,Defender,France,Europe
900,Juan Foyth,ARG,Villarreal,La Liga,2023,25.0,1998.0,11.8,26,15,18,8,0,12,27,44.4,15,17,4,13,12,38,44,0,DF,25-29,Defender,Argentina,South America
901,Matheus França,BRA,Crystal Palace,Premier League,2023,19.0,2004.0,2.6,3,3,2,1,0,1,7,14.3,6,4,0,4,1,4,1,0,"MF,FW",Under 20,Midfielder,Brazil,South America
902,Bartol Franjić,CRO,Darmstadt 98,Bundesliga,2023,23.0,2000.0,13.7,15,12,4,10,1,7,28,25.0,21,12,4,8,30,45,29,2,MF,20-24,Midfielder,Croatia,Europe
904,Nathan Fraser,IRL,Wolves,Premier League,2023,18.0,2005.0,2.1,5,2,2,1,2,1,3,33.3,2,2,1,1,1,6,2,0,FW,Under 20,Forward,Republic of Ireland,Europe
905,Davide Frattesi,ITA,Inter,Serie A,2023,23.0,1999.0,10.6,10,6,3,7,0,4,8,50.0,4,9,3,6,5,15,19,0,MF,20-24,Midfielder,Italy,Europe
906,Morten Frendrup,DEN,Genoa,Serie A,2023,22.0,2001.0,34.9,133,72,47,70,16,55,91,60.4,36,55,14,41,51,184,42,1,MF,20-24,Midfielder,Denmark,Europe
907,Remo Freuler,SUI,Bologna,Serie A,2023,31.0,1992.0,29.2,78,50,41,32,5,38,69,55.1,31,37,9,28,36,114,53,2,MF,30-34,Midfielder,Switzerland,Europe
908,Marco Friedl,AUT,Werder Bremen,Bundesliga,2023,25.0,1998.0,24.4,53,32,38,15,0,36,48,75.0,12,45,29,16,35,88,129,0,DF,25-29,Defender,Austria,Europe
909,Marvin Friedrich,GER,Gladbach,Bundesliga,2023,27.0,1995.0,17.4,23,15,16,6,1,12,20,60.0,8,28,20,8,17,40,87,0,DF,25-29,Defender,Germany,Europe
910,Jeremie Frimpong,NED,Leverkusen,Bundesliga,2023,22.0,2000.0,25.0,26,17,12,7,7,8,20,40.0,12,26,0,26,7,33,17,0,DF,20-24,Defender,Netherlands,Europe
912,Chris Führich,GER,Stuttgart,Bundesliga,2023,25.0,1998.0,28.5,30,19,6,14,10,16,37,43.2,21,31,0,31,7,37,7,0,"FW,MF",25-29,Forward,Germany,Europe
913,Shiō Fukuda,JPN,Gladbach,Bundesliga,2023,19.0,2004.0,0.4,2,0,1,1,0,1,2,50.0,1,0,0,0,1,3,0,0,"FW,MF",Under 20,Forward,Japan,Asia
914,Angelo Fulgini,FRA,Lens,Ligue 1,2023,26.0,1996.0,15.3,23,14,6,13,4,11,19,57.9,8,22,1,21,8,31,11,0,MF,25-29,Midfielder,France,Europe
915,Niclas Füllkrug,GER,Werder Bremen,Bundesliga,2023,30.0,1993.0,2.0,1,1,0,1,0,1,1,100.0,0,2,1,1,0,1,1,0,FW,30-34,Forward,Germany,Europe
916,Niclas Füllkrug,GER,Dortmund,Bundesliga,2023,30.0,1993.0,24.6,7,2,1,6,0,2,8,25.0,6,17,4,13,2,9,25,0,FW,30-34,Forward,Germany,Europe
917,Gerardo Fusco,ITA,Salernitana,Serie A,2023,18.0,2005.0,0.2,0,0,0,0,0,0,0,,0,0,0,0,0,0,0,0,FW,Under 20,Forward,Italy,Europe
918,Daniel Fuzato,BRA,Getafe,La Liga,2023,26.0,1997.0,0.1,0,0,0,0,0,0,0,,0,0,0,0,0,0,1,0,GK,25-29,Goalkeeper,Brazil,South America
919,Matteo Gabbia,ITA,Milan,Serie A,2023,23.0,1999.0,14.2,29,20,15,13,1,18,24,75.0,6,11,6,5,10,39,48,0,DF,20-24,Defender,Italy,Europe
920,Matteo Gabbia,ITA,Villarreal,La Liga,2023,23.0,1999.0,5.3,10,6,4,6,0,5,8,62.5,3,5,2,3,8,18,36,1,DF,20-24,Defender,Italy,Europe
921,Gianluca Gaetano,ITA,Cagliari,Serie A,2023,23.0,2000.0,8.3,7,4,0,4,3,2,7,28.6,5,4,0,4,3,10,4,0,"FW,MF",20-24,Forward,Italy,Europe
922,Gianluca Gaetano,ITA,Napoli,Serie A,2023,23.0,2000.0,1.8,4,1,0,4,0,2,4,50.0,2,5,2,3,1,5,4,0,MF,20-24,Midfielder,Italy,Europe
923,Roberto Gagliardini,ITA,Monza,Serie A,2023,29.0,1994.0,26.2,61,30,27,25,9,31,50,62.0,19,30,11,19,31,92,38,0,"MF,DF",25-29,Midfielder,Italy,Europe
924,Cody Gakpo,NED,Liverpool,Premier League,2023,24.0,1999.0,18.3,27,17,8,14,5,8,25,32.0,17,21,4,17,14,41,7,0,"FW,MF",20-24,Forward,Netherlands,Europe
928,Pablo Galdames Millán,CHI,Genoa,Serie A,2023,26.0,1996.0,0.1,0,0,0,0,0,0,0,,0,1,0,1,0,0,0,0,"MF,DF",25-29,Midfielder,Chile,South America
929,Conor Gallagher,ENG,Chelsea,Premier League,2023,23.0,2000.0,34.8,85,52,37,31,17,33,77,42.9,44,50,11,39,43,128,34,0,MF,20-24,Midfielder,England,Europe
930,Antonino Gallo,ITA,Lecce,Serie A,2023,23.0,2000.0,27.7,43,27,31,11,1,31,49,63.3,18,34,9,25,25,68,67,0,DF,20-24,Defender,Italy,Europe
931,Cristian Gamboa,CRC,Bochum,Bundesliga,2023,33.0,1989.0,13.2,24,18,12,11,1,14,33,42.4,19,20,7,13,15,39,34,1,DF,30-34,Defender,Costa Rica,North America
932,Kévin Gameiro,FRA,Strasbourg,Ligue 1,2023,36.0,1987.0,15.0,10,10,5,3,2,2,17,11.8,15,9,0,9,3,13,7,0,"FW,MF",35-39,Forward,France,Europe
933,Idrissa Gana Gueye,SEN,Everton,Premier League,2023,33.0,1989.0,20.9,73,44,32,27,14,29,46,63.0,17,24,7,17,28,101,16,0,MF,30-34,Midfielder,Senegal,Africa
934,Ignatius Ganago,CMR,Nantes,Ligue 1,2023,24.0,1999.0,2.0,0,0,0,0,0,0,1,0.0,1,1,0,1,1,1,1,0,"FW,MF",20-24,Forward,Cameroon,Africa
947,Ulisses Garcia,SUI,Marseille,Ligue 1,2023,27.0,1996.0,10.1,21,16,6,13,2,13,20,65.0,7,8,3,5,7,28,13,2,DF,25-29,Defender,Switzerland,Europe
949,Alejandro Garnacho,ARG,Manchester Utd,Premier League,2023,19.0,2004.0,28.5,22,15,7,6,9,12,45,26.7,33,26,2,24,18,40,18,0,FW,Under 20,Forward,Argentina,South America
950,James Garner,ENG,Everton,Premier League,2023,22.0,2001.0,33.4,83,44,32,38,13,35,82,42.7,47,45,14,31,45,128,47,1,MF,20-24,Midfielder,England,Europe
951,Luca Garritano,ITA,Frosinone,Serie A,2023,29.0,1994.0,5.4,10,5,7,2,1,5,15,33.3,10,13,0,13,4,14,8,1,"MF,DF",25-29,Midfielder,Italy,Europe
953,Johan Gastien,FRA,Clermont Foot,Ligue 1,2023,35.0,1988.0,25.1,43,22,18,21,4,23,81,28.4,58,31,9,22,36,79,24,4,MF,35-39,Midfielder,France,Europe
954,Federico Gatti,ITA,Juventus,Serie A,2023,25.0,1998.0,29.3,33,19,16,16,1,19,24,79.2,5,26,15,11,19,52,90,1,DF,25-29,Defender,Italy,Europe
955,Federico Gattoni,ARG,Sevilla,La Liga,2023,24.0,1999.0,0.1,1,0,1,0,0,1,1,100.0,0,0,0,0,0,1,1,0,"DF,FW",20-24,Defender,Argentina,South America
957,Paulo Gazzaniga,ARG,Girona,La Liga,2023,31.0,1992.0,38.0,2,2,2,0,0,2,4,50.0,2,0,0,0,0,2,12,1,GK,30-34,Goalkeeper,Argentina,South America
958,Yann Gboho,FRA,Toulouse,Ligue 1,2023,22.0,2001.0,13.3,14,4,6,6,2,8,23,34.8,15,21,1,20,4,18,2,0,"MF,FW",20-24,Midfielder,France,Europe
959,Dennis Geiger,GER,Hoffenheim,Bundesliga,2023,25.0,1998.0,0.7,1,0,1,0,0,0,0,,0,1,1,0,0,1,0,0,MF,25-29,Midfielder,Germany,Europe
961,Francesco Gelli,ITA,Frosinone,Serie A,2023,26.0,1996.0,17.3,19,13,8,4,7,10,24,41.7,14,19,3,16,11,30,27,1,"MF,DF",25-29,Midfielder,Italy,Europe
962,Luca Gemello,ITA,Torino,Serie A,2023,23.0,2000.0,2.0,0,0,0,0,0,0,1,0.0,1,0,0,0,0,0,1,1,GK,20-24,Goalkeeper,Italy,Europe
963,Valentin Gendrey,FRA,Lecce,Serie A,2023,23.0,2000.0,33.8,55,33,35,16,4,30,46,65.2,16,40,11,29,35,90,99,0,DF,20-24,Defender,France,Europe
964,Denis Genreau,AUS,Toulouse,Ligue 1,2023,24.0,1999.0,5.2,12,9,6,6,0,8,15,53.3,7,8,1,7,6,18,8,0,"MF,FW",20-24,Midfielder,Australia,Oceania
965,Yannick Gerhardt,GER,Wolfsburg,Bundesliga,2023,29.0,1994.0,18.1,31,20,16,12,3,9,32,28.1,23,15,2,13,7,38,35,0,"MF,DF",25-29,Midfielder,Germany,Europe
966,Anwar El Ghazi,NED,Mainz 05,Bundesliga,2023,28.0,1995.0,0.6,0,0,0,0,0,0,1,0.0,1,0,0,0,0,0,0,0,"MF,DF",25-29,Midfielder,Netherlands,Europe
967,Farés Ghedjemis,FRA,Frosinone,Serie A,2023,20.0,2002.0,2.0,2,0,1,0,1,0,2,0.0,2,2,0,2,1,3,2,0,"FW,MF",20-24,Forward,France,Europe
968,Saman Ghoddos,IRN,Brentford,Premier League,2023,29.0,1993.0,8.2,28,19,19,7,2,17,31,54.8,14,9,2,7,5,33,12,0,DF,25-29,Defender,Iran,Asia
969,Lautaro Gianetti,ARG,Udinese,Serie A,2023,29.0,1993.0,7.0,9,4,7,2,0,4,5,80.0,1,10,6,4,19,28,39,0,DF,25-29,Defender,Argentina,South America
970,Morgan Gibbs-White,ENG,Nott'ham Forest,Premier League,2023,23.0,2000.0,35.1,36,24,6,20,10,14,33,42.4,19,31,8,23,17,53,21,0,"MF,FW",20-24,Midfielder,England,Europe
971,Samuel Gigot,FRA,Marseille,Ligue 1,2023,29.0,1993.0,19.2,33,22,16,13,4,13,19,68.4,6,28,18,10,25,58,93,1,DF,25-29,Defender,France,Europe
975,Alfie Gilchrist,ENG,Chelsea,Premier League,2023,19.0,2003.0,2.3,4,0,4,0,0,2,5,40.0,3,6,3,3,3,7,11,0,DF,Under 20,Defender,England,Europe
976,Billy Gilmour,SCO,Brighton,Premier League,2023,22.0,2001.0,23.6,26,16,14,10,2,11,35,31.4,24,23,9,14,11,37,14,1,MF,20-24,Midfielder,Scotland,Europe
977,Benedikt Gimber,GER,Heidenheim,Bundesliga,2023,26.0,1997.0,22.5,40,24,25,14,1,19,35,54.3,16,27,17,10,16,56,101,1,DF,25-29,Defender,Germany,Europe
978,Gvidas Gineitis,LTU,Torino,Serie A,2023,19.0,2004.0,6.0,11,7,3,8,0,4,7,57.1,3,10,4,6,4,15,9,1,MF,Under 20,Midfielder,Lithuania,Europe
979,Matthias Ginter,GER,Freiburg,Bundesliga,2023,29.0,1994.0,21.3,29,15,19,9,1,16,29,55.2,13,40,26,14,16,45,93,0,DF,25-29,Defender,Germany,Europe
980,Olivier Giroud,FRA,Milan,Serie A,2023,36.0,1986.0,26.3,17,11,6,6,5,2,14,14.3,12,14,3,11,6,23,22,0,FW,35-39,Forward,France,Europe
981,Jamie Gittens,ENG,Dortmund,Bundesliga,2023,18.0,2004.0,11.8,14,7,6,7,1,2,17,11.8,15,11,2,9,4,18,7,0,"FW,MF",Under 20,Forward,England,Europe
982,Klaus Gjasula,ALB,Darmstadt 98,Bundesliga,2023,33.0,1989.0,15.1,44,22,18,25,1,17,30,56.7,13,26,14,12,19,63,42,2,"DF,MF",30-34,Defender,Albania,Europe
983,Serge Gnabry,GER,Bayern Munich,Bundesliga,2023,28.0,1995.0,4.8,8,5,0,5,3,2,13,15.4,11,5,0,5,3,11,2,0,"FW,MF",25-29,Forward,Germany,Europe
984,Ben Godfrey,ENG,Everton,Premier League,2023,25.0,1998.0,12.4,30,20,17,8,5,15,28,53.6,13,14,8,6,16,46,57,0,DF,25-29,Defender,England,Europe
985,Edoardo Goldaniga,ITA,Cagliari,Serie A,2023,29.0,1993.0,11.2,12,7,9,3,0,4,10,40.0,6,11,7,4,15,27,37,1,DF,25-29,Defender,Italy,Europe
986,Pierluigi Gollini,ITA,Napoli,Serie A,2023,28.0,1995.0,7.0,1,1,1,0,0,1,1,100.0,0,0,0,0,1,2,2,0,GK,25-29,Goalkeeper,Italy,Europe
987,Aleksandr Golovin,RUS,Monaco,Ligue 1,2023,27.0,1996.0,23.9,42,30,14,22,6,15,42,35.7,27,37,3,34,21,63,14,0,"MF,FW",25-29,Midfielder,Russia,Europe
988,André Gomes,POR,Everton,Premier League,2023,30.0,1993.0,5.6,7,4,2,3,2,3,13,23.1,10,10,1,9,3,10,4,1,"MF,FW",30-34,Midfielder,Portugal,Europe
988,André Gomes,POR,Everton,Premier League,2023,30.0,1993.0,5.6,7,4,2,3,2,3,13,23.1,10,10,1,9,3,10,4,1,"MF,FW",30-34,Midfielder,Portugal,Europe
988,André Gomes,POR,Everton,Premier League,2023,30.0,1993.0,5.6,7,4,2,3,2,3,13,23.1,10,10,1,9,3,10,4,1,"MF,FW",30-34,Midfielder,Portugal,Europe
988,André Gomes,POR,Everton,Premier League,2023,30.0,1993.0,5.6,7,4,2,3,2,3,13,23.1,10,10,1,9,3,10,4,1,"MF,FW",30-34,Midfielder,Portugal,Europe
989,Angel Gomes,ENG,Lille,Ligue 1,2023,22.0,2000.0,28.6,26,13,4,15,7,14,32,43.8,18,23,6,17,18,44,28,1,MF,20-24,Midfielder,England,Europe
990,João Gomes,BRA,Wolves,Premier League,2023,22.0,2001.0,29.4,128,74,67,49,12,44,99,44.4,55,51,8,43,18,146,29,2,MF,20-24,Midfielder,Brazil,South America
990,João Gomes,BRA,Wolves,Premier League,2023,22.0,2001.0,29.4,128,74,67,49,12,44,99,44.4,55,51,8,43,18,146,29,2,MF,20-24,Midfielder,Brazil,South America
990,João Gomes,BRA,Wolves,Premier League,2023,22.0,2001.0,29.4,128,74,67,49,12,44,99,44.4,55,51,8,43,18,146,29,2,MF,20-24,Midfielder,Brazil,South America
990,João Gomes,BRA,Wolves,Premier League,2023,22.0,2001.0,29.4,128,74,67,49,12,44,99,44.4,55,51,8,43,18,146,29,2,MF,20-24,Midfielder,Brazil,South America
991,Toti Gomes,POR,Wolves,Premier League,2023,24.0,1999.0,30.8,44,25,32,8,4,24,37,64.9,13,40,19,21,26,70,93,2,DF,20-24,Defender,Portugal,Europe
992,Joe Gomez,ENG,Liverpool,Premier League,2023,26.0,1997.0,19.8,47,31,24,16,7,30,63,47.6,33,26,4,22,19,66,50,2,DF,25-29,Defender,England,Europe
993,Maxi Gómez,URU,Cádiz,La Liga,2023,26.0,1996.0,12.9,6,4,2,3,1,3,5,60.0,2,8,3,5,3,9,3,0,FW,25-29,Forward,Uruguay,South America
995,Papu Gómez,ARG,Monza,Serie A,2023,35.0,1988.0,0.5,0,0,0,0,0,0,2,0.0,2,0,0,0,1,1,0,0,"MF,FW",35-39,Midfielder,Argentina,South America
998,Iron Gomis,FRA,Salernitana,Serie A,2023,23.0,1999.0,1.5,4,1,2,2,0,0,1,0.0,1,2,0,2,2,6,2,0,MF,20-24,Midfielder,France,Europe
999,Maxime Gonalons,FRA,Clermont Foot,Ligue 1,2023,34.0,1989.0,14.4,47,33,14,27,6,25,57,43.9,32,18,3,15,20,67,11,0,MF,30-34,Midfielder,France,Europe
1001,Enso Gonzalez,PAR,Wolves,Premier League,2023,18.0,2005.0,0.0,0,0,0,0,0,0,1,0.0,1,0,0,0,0,0,0,0,"MF,DF",Under 20,Midfielder,Paraguay,South America
1003,Giovanni González,URU,Mallorca,La Liga,2023,28.0,1994.0,27.4,73,45,37,32,4,40,81,49.4,41,24,3,21,31,104,60,2,DF,25-29,Defender,Uruguay,South America
1007,Nicolás González,ARG,Fiorentina,Serie A,2023,25.0,1998.0,21.3,28,18,15,8,5,8,28,28.6,20,26,1,25,12,40,9,0,FW,25-29,Forward,Argentina,South America
1009,Anthony Gordon,ENG,Newcastle Utd,Premier League,2023,22.0,2001.0,32.1,55,34,16,28,11,22,64,34.4,42,27,0,27,7,62,7,0,FW,20-24,Forward,England,Europe
1010,Kaide Gordon,ENG,Liverpool,Premier League,2023,18.0,2004.0,0.0,0,0,0,0,0,0,0,,0,0,0,0,0,0,0,0,FW,Under 20,Forward,England,Europe
1011,Daniel Gore,ENG,Manchester Utd,Premier League,2023,18.0,2004.0,0.0,1,1,0,1,0,1,1,100.0,0,0,0,0,1,2,0,0,MF,Under 20,Midfielder,England,Europe
1012,Leon Goretzka,GER,Bayern Munich,Bundesliga,2023,28.0,1995.0,24.9,41,23,18,14,9,24,54,44.4,30,44,8,36,31,72,42,1,MF,25-29,Midfielder,Germany,Europe
1013,Mathieu Gorgelin,FRA,Le Havre,Ligue 1,2023,32.0,1990.0,1.0,0,0,0,0,0,0,0,,0,0,0,0,0,0,0,0,GK,30-34,Goalkeeper,France,Europe
1015,Robin Gosens,GER,Union Berlin,Bundesliga,2023,29.0,1994.0,25.4,63,44,25,31,7,30,44,68.2,14,52,9,43,36,99,75,0,"DF,MF",25-29,Defender,Germany,Europe
1016,Mario Götze,GER,Eint Frankfurt,Bundesliga,2023,31.0,1992.0,23.0,51,34,18,25,8,28,62,45.2,34,19,3,16,14,65,10,0,MF,30-34,Midfielder,Germany,Europe
1017,Amine Gouiri,ALG,Rennes,Ligue 1,2023,23.0,2000.0,23.0,20,10,4,11,5,8,19,42.1,11,18,1,17,14,34,12,0,"FW,MF",20-24,Forward,Algeria,Africa
1018,Jeffrey Gouweleeuw,NED,Augsburg,Bundesliga,2023,32.0,1991.0,28.8,35,23,13,17,5,16,25,64.0,9,44,24,20,35,70,108,0,DF,30-34,Defender,Netherlands,Europe
1020,Jonathan Gradit,FRA,Lens,Ligue 1,2023,30.0,1992.0,23.5,32,20,15,14,3,19,35,54.3,16,30,17,13,37,69,61,0,DF,30-34,Defender,France,Europe
1021,Jens Grahl,GER,Eint Frankfurt,Bundesliga,2023,34.0,1988.0,2.0,0,0,0,0,0,0,0,,0,0,0,0,0,0,3,0,GK,30-34,Goalkeeper,Germany,Europe
1022,Samuel Grandsir,FRA,Le Havre,Ligue 1,2023,26.0,1996.0,6.7,16,12,5,9,2,8,18,44.4,10,4,0,4,3,19,3,1,"MF,FW",25-29,Midfielder,France,Europe
1023,Alberto Grassi,ITA,Empoli,Serie A,2023,28.0,1995.0,20.1,30,18,13,13,4,10,26,38.5,16,26,11,15,41,71,37,0,MF,25-29,Midfielder,Italy,Europe
1024,Ryan Gravenberch,NED,Liverpool,Premier League,2023,21.0,2002.0,12.5,26,12,5,13,8,12,29,41.4,17,20,2,18,14,40,11,0,MF,20-24,Midfielder,Netherlands,Europe
1025,Ryan Gravenberch,NED,Bayern Munich,Bundesliga,2023,21.0,2002.0,0.1,0,0,0,0,0,0,0,,0,0,0,0,0,0,0,0,FW,20-24,Forward,Netherlands,Europe
1026,Adrian Grbić,AUT,Lorient,Ligue 1,2023,26.0,1996.0,0.3,0,0,0,0,0,0,0,,0,0,0,0,0,0,0,0,FW,25-29,Forward,Austria,Europe
1027,Ivo Grbić,CRO,Sheffield Utd,Premier League,2023,27.0,1996.0,8.6,0,0,0,0,0,0,1,0.0,1,1,0,1,0,0,9,1,GK,25-29,Goalkeeper,Croatia,Europe
1028,Jack Grealish,ENG,Manchester City,Premier League,2023,27.0,1995.0,11.2,13,8,6,7,0,6,12,50.0,6,13,2,11,6,19,5,0,"FW,MF",25-29,Forward,England,Europe
1029,Mason Greenwood,ENG,Getafe,La Liga,2023,21.0,2001.0,29.6,11,6,3,5,3,4,21,19.0,17,9,0,9,4,15,4,0,"MF,FW",20-24,Midfielder,England,Europe
1030,Michael Gregoritsch,AUT,Freiburg,Bundesliga,2023,29.0,1994.0,18.7,16,12,8,5,3,2,14,14.3,12,17,4,13,9,25,27,0,FW,25-29,Forward,Austria,Europe
1031,Dominik Greif,SVK,Mallorca,La Liga,2023,26.0,1997.0,1.0,0,0,0,0,0,0,0,,0,0,0,0,0,0,0,0,GK,25-29,Goalkeeper,Slovakia,Europe
1032,Antoine Griezmann,FRA,Atlético Madrid,La Liga,2023,32.0,1991.0,29.4,33,19,14,14,5,15,41,36.6,26,34,3,31,10,43,23,1,"FW,MF",30-34,Forward,France,Europe
1033,Vincenzo Grifo,ITA,Freiburg,Bundesliga,2023,30.0,1993.0,25.8,31,20,14,11,6,14,31,45.2,17,22,1,21,15,46,20,0,"MF,FW",30-34,Midfielder,Italy,Europe
1034,Florian Grillitsch,AUT,Hoffenheim,Bundesliga,2023,27.0,1995.0,25.5,54,28,31,19,4,22,54,40.7,32,41,20,21,52,106,90,2,"DF,MF",25-29,Defender,Austria,Europe
1036,Christian Groß,GER,Werder Bremen,Bundesliga,2023,34.0,1989.0,8.9,21,16,11,9,1,11,25,44.0,14,17,6,11,13,34,28,1,"DF,MF",30-34,Defender,Germany,Europe
1037,Pascal Groß,GER,Brighton,Premier League,2023,32.0,1991.0,34.6,70,46,33,21,16,31,72,43.1,41,41,8,33,22,92,32,3,"MF,DF",30-34,Midfielder,Germany,Europe
1038,Brajan Gruda,GER,Mainz 05,Bundesliga,2023,19.0,2004.0,18.2,22,14,5,11,6,14,24,58.3,10,15,0,15,5,27,4,0,"MF,FW",Under 20,Midfielder,Germany,Europe
1039,Ilia Gruev,BUL,Werder Bremen,Bundesliga,2023,23.0,2000.0,0.0,0,0,0,0,0,0,0,,0,0,0,0,0,0,0,0,MF,20-24,Midfielder,Bulgaria,Europe
1041,Andrés Guardado,MEX,Betis,La Liga,2023,36.0,1986.0,5.0,17,12,5,9,3,7,14,50.0,7,4,2,2,6,23,5,0,MF,35-39,Midfielder,Mexico,North America
1044,Gabriel Gudmundsson,SWE,Lille,Ligue 1,2023,24.0,1999.0,14.1,22,16,7,13,2,12,20,60.0,8,14,3,11,15,37,25,0,"DF,FW",20-24,Defender,Sweden,Europe
1045,Gonçalo Guedes,POR,Villarreal,La Liga,2023,26.0,1996.0,10.6,6,4,1,2,3,2,7,28.6,5,8,0,8,2,8,3,0,"FW,MF",25-29,Forward,Portugal,Europe
1046,Axel Gueguin,FRA,Montpellier,Ligue 1,2023,18.0,2005.0,1.5,9,5,6,2,1,2,6,33.3,4,2,0,2,2,11,6,0,"DF,FW",Under 20,Defender,France,Europe
1047,Marc Guéhi,ENG,Crystal Palace,Premier League,2023,23.0,2000.0,22.5,28,19,21,7,0,14,24,58.3,10,22,17,5,18,46,89,1,DF,20-24,Defender,England,Europe
1048,Mattéo Guendouzi,FRA,Lazio,Serie A,2023,24.0,1999.0,26.3,34,15,11,18,5,21,49,42.9,28,24,6,18,21,55,24,1,MF,20-24,Midfielder,France,Europe
1049,Mattéo Guendouzi,FRA,Marseille,Ligue 1,2023,24.0,1999.0,0.2,0,0,0,0,0,0,0,,0,1,1,0,0,0,0,0,MF,20-24,Midfielder,France,Europe
1051,Raphaël Guerreiro,POR,Bayern Munich,Bundesliga,2023,29.0,1993.0,13.2,19,16,6,9,4,9,15,60.0,6,7,1,6,15,34,5,1,"DF,MF",25-29,Defender,Portugal,Europe
1052,Axel Guessand,FRA,Udinese,Serie A,2023,18.0,2004.0,0.5,1,1,0,1,0,1,1,100.0,0,1,0,1,0,1,0,0,DF,Under 20,Defender,France,Europe
1053,Evann Guessand,CIV,Nice,Ligue 1,2023,22.0,2001.0,17.3,16,7,2,7,7,6,7,85.7,1,12,1,11,12,28,7,0,FW,20-24,Forward,Ivory Coast,Africa
1055,Pape Gueye,SEN,Marseille,Ligue 1,2023,24.0,1999.0,8.5,33,21,11,19,3,13,19,68.4,6,17,3,14,13,46,12,0,"MF,DF",20-24,Midfielder,Senegal,Africa
1056,Josuha Guilavogui,FRA,Mainz 05,Bundesliga,2023,32.0,1990.0,4.5,15,10,10,5,0,6,7,85.7,1,13,7,6,13,28,21,0,DF,30-34,Defender,France,Europe
1057,Morgan Guilavogui,GUI,Lens,Ligue 1,2023,25.0,1998.0,6.3,21,10,4,12,5,5,11,45.5,6,11,2,9,4,25,7,0,"FW,MF",25-29,Forward,Guinea,Africa
1058,Frederic Guilbert,FRA,Strasbourg,Ligue 1,2023,28.0,1994.0,27.7,87,50,49,30,8,47,72,65.3,25,39,10,29,71,158,99,1,"DF,MF",25-29,Defender,France,Europe
1060,Bruno Guimarães,BRA,Newcastle Utd,Premier League,2023,25.0,1997.0,36.3,88,53,45,32,11,40,77,51.9,37,52,14,38,35,123,20,0,MF,25-29,Midfielder,Brazil,South America
1061,Serhou Guirassy,GUI,Stuttgart,Bundesliga,2023,27.0,1996.0,24.5,6,3,1,4,1,2,5,40.0,3,8,1,7,6,12,29,0,FW,25-29,Forward,Guinea,Africa
1063,Péter Gulácsi,HUN,RB Leipzig,Bundesliga,2023,33.0,1990.0,13.0,0,0,0,0,0,0,0,,0,0,0,0,0,0,8,1,GK,30-34,Goalkeeper,Hungary,Europe
1064,Manuel Gulde,GER,Freiburg,Bundesliga,2023,32.0,1991.0,22.7,37,23,23,13,1,17,23,73.9,6,24,14,10,25,62,82,0,DF,30-34,Defender,Germany,Europe
1065,Arda Güler,TUR,Real Madrid,La Liga,2023,18.0,2005.0,4.2,6,4,1,3,2,5,8,62.5,3,0,0,0,2,8,5,0,"FW,MF",Under 20,Forward,Turkey,Asia
1068,İlkay Gündoğan,GER,Barcelona,La Liga,2023,32.0,1990.0,33.3,32,22,14,16,2,12,39,30.8,27,19,4,15,21,53,18,1,MF,30-34,Midfielder,Germany,Europe
1069,Christian Günter,GER,Freiburg,Bundesliga,2023,30.0,1993.0,11.8,20,12,9,11,0,7,18,38.9,11,9,3,6,2,22,16,0,DF,30-34,Defender,Germany,Europe
1072,Malo Gusto,FRA,Chelsea,Premier League,2023,20.0,2003.0,19.5,55,27,34,15,6,35,52,67.3,17,28,4,24,17,72,43,1,DF,20-24,Defender,France,Europe
1074,Albert Guðmundsson,ISL,Genoa,Serie A,2023,26.0,1997.0,33.5,23,10,8,10,5,12,44,27.3,32,15,2,13,11,34,13,0,"FW,MF",25-29,Forward,Iceland,Europe
1075,Joško Gvardiol,CRO,Manchester City,Premier League,2023,21.0,2002.0,25.9,55,33,21,24,10,21,38,55.3,17,36,12,24,27,82,37,3,DF,20-24,Defender,Croatia,Europe
1076,Emmanuel Gyasi,GHA,Empoli,Serie A,2023,29.0,1994.0,20.9,34,17,18,13,3,15,32,46.9,17,30,12,18,5,39,27,1,"DF,FW",25-29,Defender,Ghana,Africa
1077,Norbert Gyömbér,SVK,Salernitana,Serie A,2023,31.0,1992.0,19.6,36,18,30,6,0,20,26,76.9,6,33,23,10,23,59,77,2,DF,30-34,Defender,Slovakia,Europe
1079,Nicolas Haas,SUI,Empoli,Serie A,2023,27.0,1996.0,1.0,5,3,1,2,2,3,3,100.0,0,1,0,1,1,6,1,0,MF,25-29,Midfielder,Switzerland,Europe
1080,Janik Haberer,GER,Union Berlin,Bundesliga,2023,29.0,1994.0,13.6,36,24,16,13,7,22,45,48.9,23,21,4,17,12,48,18,0,"MF,DF",25-29,Midfielder,Germany,Europe
1081,Robin Hack,GER,Gladbach,Bundesliga,2023,24.0,1998.0,15.0,15,8,6,7,2,4,17,23.5,13,16,0,16,14,29,21,0,"FW,MF",20-24,Forward,Germany,Europe
1082,Antwoine Hackford,ENG,Sheffield Utd,Premier League,2023,19.0,2004.0,0.1,0,0,0,0,0,0,0,,0,0,0,0,0,0,0,0,FW,Under 20,Forward,England,Europe
1083,Munir El Haddadi,MAR,Las Palmas,La Liga,2023,27.0,1995.0,27.2,40,27,18,17,5,17,38,44.7,21,27,1,26,11,51,16,0,FW,25-29,Forward,Morocco,Africa
1084,Jaouen Hadjam,ALG,Nantes,Ligue 1,2023,20.0,2003.0,1.2,6,4,5,1,0,1,2,50.0,1,0,0,0,3,9,2,0,DF,20-24,Defender,Algeria,Africa
1085,Ianis Hagi,ROU,Alavés,La Liga,2023,24.0,1998.0,8.9,17,12,2,14,1,5,12,41.7,7,8,0,8,5,22,4,0,"MF,FW",20-24,Midfielder,Romania,Europe
1086,Amadou Haidara,MLI,RB Leipzig,Bundesliga,2023,25.0,1998.0,17.0,42,27,24,16,2,23,41,56.1,18,28,6,22,21,63,37,0,MF,25-29,Midfielder,Mali,Africa
1087,Massadio Haïdara,MLI,Lens,Ligue 1,2023,30.0,1992.0,8.2,9,8,5,3,1,4,6,66.7,2,7,2,5,11,20,32,3,DF,30-34,Defender,Mali,Africa
1088,Oualid El Hajjam,MAR,Le Havre,Ligue 1,2023,32.0,1991.0,4.4,8,7,5,2,1,2,9,22.2,7,5,1,4,6,14,10,0,"DF,MF",30-34,Defender,Morocco,Africa
1089,Achraf Hakimi,MAR,Paris S-G,Ligue 1,2023,24.0,1998.0,21.5,29,19,14,9,6,17,34,50.0,17,28,4,24,12,41,28,2,DF,20-24,Defender,Morocco,Africa
1090,Lewis Hall,ENG,Newcastle Utd,Premier League,2023,18.0,2004.0,8.7,28,18,17,10,1,17,28,60.7,11,17,2,15,12,40,22,1,DF,Under 20,Defender,England,Europe
1091,Sébastien Haller,CIV,Dortmund,Bundesliga,2023,29.0,1994.0,4.4,1,0,0,1,0,1,1,100.0,0,4,1,3,0,1,7,0,FW,25-29,Forward,Ivory Coast,Africa
1092,Gustavo Hamer,NED,Sheffield Utd,Premier League,2023,26.0,1997.0,32.3,39,21,17,15,7,16,59,27.1,43,33,9,24,29,68,35,0,MF,25-29,Midfielder,Netherlands,Europe
1095,Ridgeciano Haps,SUR,Genoa,Serie A,2023,30.0,1993.0,8.6,7,6,3,2,2,5,8,62.5,3,3,0,3,6,13,11,1,DF,30-34,Defender,Suriname,South America
1096,Genki Haraguchi,JPN,Stuttgart,Bundesliga,2023,32.0,1991.0,0.3,1,1,1,0,0,0,0,,0,0,0,0,0,1,1,0,MF,30-34,Midfielder,Japan,Asia
1097,Amine Harit,MAR,Marseille,Ligue 1,2023,26.0,1997.0,20.2,28,16,8,17,3,13,37,35.1,24,31,4,27,12,40,4,0,"MF,FW",25-29,Midfielder,Morocco,Africa
1098,Luke Harris,WAL,Fulham,Premier League,2023,18.0,2005.0,0.8,1,1,1,0,0,0,1,0.0,1,0,0,0,0,1,0,0,MF,Under 20,Midfielder,Wales,Europe
1099,Jack Harrison,ENG,Everton,Premier League,2023,26.0,1996.0,24.6,37,22,12,12,13,17,49,34.7,32,25,5,20,12,49,24,0,"MF,FW",25-29,Midfielder,England,Europe
1100,Abdou Harroui,NED,Frosinone,Serie A,2023,25.0,1998.0,11.3,23,11,11,11,1,8,16,50.0,8,19,3,16,5,28,8,0,"MF,FW",25-29,Midfielder,Netherlands,Europe
1101,Makoto Hasebe,JPN,Eint Frankfurt,Bundesliga,2023,39.0,1984.0,2.4,4,2,2,2,0,3,6,50.0,3,2,1,1,2,6,5,0,"DF,MF",35-39,Defender,Japan,Asia
1102,Daiki Hashioka,JPN,Luton Town,Premier League,2023,24.0,1999.0,6.6,11,5,6,4,1,5,11,45.5,6,12,7,5,8,19,20,0,DF,20-24,Defender,Japan,Asia
1103,Hans Hateboer,NED,Atalanta,Serie A,2023,29.0,1994.0,12.4,12,5,8,2,2,5,15,33.3,10,21,7,14,4,16,21,0,DF,25-29,Defender,Netherlands,Europe
1104,Pantelis Hatzidiakos,GRE,Cagliari,Serie A,2023,26.0,1997.0,9.5,22,10,12,10,0,10,17,58.8,7,14,5,9,13,35,30,1,DF,25-29,Defender,Greece,Europe
1105,Kai Havertz,GER,Arsenal,Premier League,2023,24.0,1999.0,29.3,35,15,7,21,7,14,39,35.9,25,26,1,25,20,55,22,0,"MF,FW",20-24,Midfielder,Germany,Europe
1106,Thorgan Hazard,BEL,Dortmund,Bundesliga,2023,30.0,1993.0,0.1,0,0,0,0,0,0,0,,0,0,0,0,0,0,0,0,DF,30-34,Defender,Belgium,Europe
1107,Jan Paul van Hecke,NED,Brighton,Premier League,2023,23.0,2000.0,26.3,47,26,25,19,3,27,45,60.0,18,49,27,22,30,77,76,4,DF,20-24,Defender,Netherlands,Europe
1108,Hwang Hee-chan,KOR,Wolves,Premier League,2023,27.0,1996.0,23.5,20,10,11,8,1,9,24,37.5,15,19,1,18,10,30,9,0,"FW,MF",25-29,Forward,South Korea,Asia
1109,Silvan Hefti,SUI,Genoa,Serie A,2023,25.0,1997.0,1.3,6,1,2,3,1,4,7,57.1,3,2,0,2,0,6,1,0,"MF,DF",25-29,Midfielder,Switzerland,Europe
1110,Silvan Hefti,SUI,Montpellier,Ligue 1,2023,25.0,1997.0,7.9,21,15,10,7,4,15,29,51.7,14,7,2,5,8,29,11,0,"DF,FW",25-29,Defender,Switzerland,Europe
1111,Dominique Heintz,GER,Köln,Bundesliga,2023,29.0,1993.0,6.3,12,5,6,6,0,8,12,66.7,4,6,1,5,3,15,28,0,DF,25-29,Defender,Germany,Europe
1112,Dean Henderson,ENG,Crystal Palace,Premier League,2023,26.0,1997.0,18.0,1,1,1,0,0,1,2,50.0,1,0,0,0,0,1,8,2,GK,25-29,Goalkeeper,England,Europe
1113,Liam Henderson,SCO,Empoli,Serie A,2023,27.0,1996.0,0.1,0,0,0,0,0,0,0,,0,0,0,0,0,0,0,0,MF,25-29,Midfielder,Scotland,Europe
1114,Benjamin Henrichs,GER,RB Leipzig,Bundesliga,2023,26.0,1997.0,28.1,68,39,32,26,10,27,58,46.6,31,49,4,45,33,101,37,0,DF,25-29,Defender,Germany,Europe
1115,Henrique,BRA,Lyon,Ligue 1,2023,29.0,1994.0,6.7,10,6,6,4,0,6,11,54.5,5,8,2,6,10,20,3,0,DF,25-29,Defender,Brazil,South America
1115,Henrique,BRA,Lyon,Ligue 1,2023,29.0,1994.0,6.7,10,6,6,4,0,6,11,54.5,5,8,2,6,10,20,3,0,DF,25-29,Defender,Brazil,South America
1115,Henrique,BRA,Lyon,Ligue 1,2023,29.0,1994.0,6.7,10,6,6,4,0,6,11,54.5,5,8,2,6,10,20,3,0,DF,25-29,Defender,Brazil,South America
1115,Henrique,BRA,Lyon,Ligue 1,2023,29.0,1994.0,6.7,10,6,6,4,0,6,11,54.5,5,8,2,6,10,20,3,0,DF,25-29,Defender,Brazil,South America
1115,Henrique,BRA,Lyon,Ligue 1,2023,29.0,1994.0,6.7,10,6,6,4,0,6,11,54.5,5,8,2,6,10,20,3,0,DF,25-29,Defender,Brazil,South America
1115,Henrique,BRA,Lyon,Ligue 1,2023,29.0,1994.0,6.7,10,6,6,4,0,6,11,54.5,5,8,2,6,10,20,3,0,DF,25-29,Defender,Brazil,South America
1115,Henrique,BRA,Lyon,Ligue 1,2023,29.0,1994.0,6.7,10,6,6,4,0,6,11,54.5,5,8,2,6,10,20,3,0,DF,25-29,Defender,Brazil,South America
1115,Henrique,BRA,Lyon,Ligue 1,2023,29.0,1994.0,6.7,10,6,6,4,0,6,11,54.5,5,8,2,6,10,20,3,0,DF,25-29,Defender,Brazil,South America
1115,Henrique,BRA,Lyon,Ligue 1,2023,29.0,1994.0,6.7,10,6,6,4,0,6,11,54.5,5,8,2,6,10,20,3,0,DF,25-29,Defender,Brazil,South America
1115,Henrique,BRA,Lyon,Ligue 1,2023,29.0,1994.0,6.7,10,6,6,4,0,6,11,54.5,5,8,2,6,10,20,3,0,DF,25-29,Defender,Brazil,South America
1115,Henrique,BRA,Lyon,Ligue 1,2023,29.0,1994.0,6.7,10,6,6,4,0,6,11,54.5,5,8,2,6,10,20,3,0,DF,25-29,Defender,Brazil,South America
1115,Henrique,BRA,Lyon,Ligue 1,2023,29.0,1994.0,6.7,10,6,6,4,0,6,11,54.5,5,8,2,6,10,20,3,0,DF,25-29,Defender,Brazil,South America
1115,Henrique,BRA,Lyon,Ligue 1,2023,29.0,1994.0,6.7,10,6,6,4,0,6,11,54.5,5,8,2,6,10,20,3,0,DF,25-29,Defender,Brazil,South America
1115,Henrique,BRA,Lyon,Ligue 1,2023,29.0,1994.0,6.7,10,6,6,4,0,6,11,54.5,5,8,2,6,10,20,3,0,DF,25-29,Defender,Brazil,South America
1115,Henrique,BRA,Lyon,Ligue 1,2023,29.0,1994.0,6.7,10,6,6,4,0,6,11,54.5,5,8,2,6,10,20,3,0,DF,25-29,Defender,Brazil,South America
1115,Henrique,BRA,Lyon,Ligue 1,2023,29.0,1994.0,6.7,10,6,6,4,0,6,11,54.5,5,8,2,6,10,20,3,0,DF,25-29,Defender,Brazil,South America
1116,Luis Henrique,BRA,Marseille,Ligue 1,2023,21.0,2001.0,8.7,8,7,4,1,3,4,7,57.1,3,9,0,9,8,16,3,0,"FW,DF",20-24,Forward,Brazil,South America
1116,Luis Henrique,BRA,Marseille,Ligue 1,2023,21.0,2001.0,8.7,8,7,4,1,3,4,7,57.1,3,9,0,9,8,16,3,0,"FW,DF",20-24,Forward,Brazil,South America
1116,Luis Henrique,BRA,Marseille,Ligue 1,2023,21.0,2001.0,8.7,8,7,4,1,3,4,7,57.1,3,9,0,9,8,16,3,0,"FW,DF",20-24,Forward,Brazil,South America
1116,Luis Henrique,BRA,Marseille,Ligue 1,2023,21.0,2001.0,8.7,8,7,4,1,3,4,7,57.1,3,9,0,9,8,16,3,0,"FW,DF",20-24,Forward,Brazil,South America
1117,Luiz Henrique,BRA,Betis,La Liga,2023,22.0,2001.0,6.8,15,11,4,10,1,9,14,64.3,5,11,0,11,5,20,8,0,FW,20-24,Forward,Brazil,South America
1117,Luiz Henrique,BRA,Betis,La Liga,2023,22.0,2001.0,6.8,15,11,4,10,1,9,14,64.3,5,11,0,11,5,20,8,0,FW,20-24,Forward,Brazil,South America
1117,Luiz Henrique,BRA,Betis,La Liga,2023,22.0,2001.0,6.8,15,11,4,10,1,9,14,64.3,5,11,0,11,5,20,8,0,FW,20-24,Forward,Brazil,South America
1117,Luiz Henrique,BRA,Betis,La Liga,2023,22.0,2001.0,6.8,15,11,4,10,1,9,14,64.3,5,11,0,11,5,20,8,0,FW,20-24,Forward,Brazil,South America
1118,Matheus Henrique,BRA,Sassuolo,Serie A,2023,25.0,1997.0,27.8,43,29,21,18,4,18,43,41.9,25,18,8,10,25,68,31,6,MF,25-29,Midfielder,Brazil,South America
1119,Rico Henry,ENG,Brentford,Premier League,2023,26.0,1997.0,4.5,7,5,3,3,1,6,7,85.7,1,8,3,5,5,12,5,1,DF,25-29,Defender,England,Europe
1120,Thomas Henry,FRA,Hellas Verona,Serie A,2023,28.0,1994.0,3.7,0,0,0,0,0,0,0,,0,0,0,0,0,0,5,0,FW,25-29,Forward,France,Europe
1125,Lucas Hernández,FRA,Paris S-G,Ligue 1,2023,27.0,1996.0,21.2,52,36,28,15,9,29,50,58.0,21,21,5,16,27,79,38,0,DF,25-29,Defender,France,Europe
1127,Theo Hernández,FRA,Milan,Serie A,2023,25.0,1997.0,31.0,30,17,19,11,0,11,22,50.0,11,33,13,20,23,53,42,1,DF,25-29,Defender,France,Europe
1132,Yangel Herrera,VEN,Girona,La Liga,2023,25.0,1998.0,23.4,64,37,28,30,6,30,56,53.6,26,30,8,22,24,88,45,1,MF,25-29,Midfielder,Venezuela,South America
1133,Patrick Herrmann,GER,Gladbach,Bundesliga,2023,32.0,1991.0,1.0,4,4,2,1,1,2,2,100.0,0,1,0,1,1,5,2,0,"FW,DF",30-34,Forward,Germany,Europe
1135,Son Heung-min,KOR,Tottenham,Premier League,2023,31.0,1992.0,32.6,21,13,6,7,8,10,21,47.6,11,4,1,3,8,29,4,0,FW,30-34,Forward,South Korea,Asia
1136,Aaron Hickey,SCO,Brentford,Premier League,2023,21.0,2002.0,7.9,16,9,9,3,4,7,7,100.0,0,7,3,4,3,19,10,0,DF,20-24,Defender,Scotland,Europe
1137,Isak Hien,SWE,Hellas Verona,Serie A,2023,24.0,1999.0,9.6,17,10,10,7,0,10,19,52.6,9,12,5,7,7,24,33,1,DF,20-24,Defender,Sweden,Europe
1138,Isak Hien,SWE,Atalanta,Serie A,2023,24.0,1999.0,10.4,18,12,8,10,0,7,15,46.7,8,12,5,7,14,32,33,0,DF,20-24,Defender,Sweden,Europe
1139,James Hill,ENG,Bournemouth,Premier League,2023,21.0,2002.0,0.8,3,2,1,2,0,1,1,100.0,0,3,2,1,3,6,8,0,DF,20-24,Defender,England,Europe
1140,Piero Hincapié,ECU,Leverkusen,Bundesliga,2023,21.0,2002.0,16.5,35,22,14,17,4,13,17,76.5,4,18,7,11,13,48,43,0,DF,20-24,Defender,Ecuador,South America
1141,Jack Hinshelwood,ENG,Brighton,Premier League,2023,18.0,2005.0,9.7,14,5,7,4,3,5,13,38.5,8,6,2,4,14,28,18,0,DF,Under 20,Defender,England,Europe
1143,Nicolas Höfler,GER,Freiburg,Bundesliga,2023,33.0,1990.0,25.9,63,40,36,20,7,22,49,44.9,27,30,16,14,31,94,45,0,MF,30-34,Midfielder,Germany,Europe
1144,Jonas Hofmann,GER,Leverkusen,Bundesliga,2023,31.0,1992.0,24.5,20,14,6,9,5,10,24,41.7,14,18,0,18,8,28,6,0,MF,30-34,Midfielder,Germany,Europe
1144,Jonas Hofmann,GER,Leverkusen,Bundesliga,2023,31.0,1992.0,24.5,20,14,6,9,5,10,24,41.7,14,18,0,18,8,28,6,0,MF,30-34,Midfielder,Germany,Europe
1144,Jonas Hofmann,GER,Leverkusen,Bundesliga,2023,31.0,1992.0,24.5,20,14,6,9,5,10,24,41.7,14,18,0,18,8,28,6,0,MF,30-34,Midfielder,Germany,Europe
1144,Jonas Hofmann,GER,Leverkusen,Bundesliga,2023,31.0,1992.0,24.5,20,14,6,9,5,10,24,41.7,14,18,0,18,8,28,6,0,MF,30-34,Midfielder,Germany,Europe
1145,Philipp Hofmann,GER,Bochum,Bundesliga,2023,30.0,1993.0,17.5,10,5,4,5,1,4,7,57.1,3,11,2,9,4,14,17,0,FW,30-34,Forward,Germany,Europe
1146,Lucas Höler,GER,Freiburg,Bundesliga,2023,29.0,1994.0,25.6,32,24,14,10,8,4,23,17.4,19,19,4,15,15,47,35,0,"FW,MF",25-29,Forward,Germany,Europe
1147,Mason Holgate,ENG,Sheffield Utd,Premier League,2023,26.0,1996.0,7.9,12,7,5,6,1,5,12,41.7,7,12,5,7,11,23,40,0,DF,25-29,Defender,England,Europe
1148,Fabian Holland,GER,Darmstadt 98,Bundesliga,2023,33.0,1990.0,20.4,47,26,18,21,8,20,37,54.1,17,22,12,10,24,71,29,0,"MF,DF",30-34,Midfielder,Germany,Europe
1149,Benedict Hollerbach,GER,Union Berlin,Bundesliga,2023,22.0,2001.0,14.2,17,11,5,7,5,7,22,31.8,15,28,0,28,4,21,3,0,"FW,MF",20-24,Forward,Germany,Europe
1150,Emil Holm,SWE,Atalanta,Serie A,2023,23.0,2000.0,10.5,28,19,17,9,2,16,36,44.4,20,25,3,22,7,35,25,0,DF,20-24,Defender,Sweden,Europe
1151,Gerrit Holtmann,PHI,Darmstadt 98,Bundesliga,2023,28.0,1995.0,4.4,8,5,3,4,1,7,10,70.0,3,7,0,7,2,10,4,1,"MF,FW",25-29,Midfielder,Philippines,Asia
1152,Martin Hongla,CMR,Hellas Verona,Serie A,2023,25.0,1998.0,12.0,24,13,9,13,2,8,11,72.7,3,8,3,5,7,31,24,0,MF,25-29,Midfielder,Cameroon,Africa
1153,Martin Hongla,CMR,Granada,La Liga,2023,25.0,1998.0,6.2,7,3,2,5,0,3,9,33.3,6,6,3,3,6,13,13,1,"MF,DF",25-29,Midfielder,Cameroon,Africa
1154,Franck Honorat,FRA,Gladbach,Bundesliga,2023,26.0,1996.0,26.1,25,13,13,10,2,11,20,55.0,9,22,3,19,9,34,35,1,"DF,FW",25-29,Defender,France,Europe
1155,Mathias Honsak,AUT,Darmstadt 98,Bundesliga,2023,26.0,1996.0,11.3,14,7,7,6,1,6,20,30.0,14,14,2,12,8,22,25,0,"FW,MF",25-29,Forward,Austria,Europe
1156,Sydney van Hooijdonk,NED,Bologna,Serie A,2023,23.0,2000.0,2.4,3,0,0,2,1,1,2,50.0,1,1,1,0,1,4,4,0,FW,20-24,Forward,Netherlands,Europe
1157,Fraser Hornby,SCO,Darmstadt 98,Bundesliga,2023,23.0,1999.0,2.4,0,0,0,0,0,0,1,0.0,1,2,1,1,0,0,4,0,"FW,MF",20-24,Forward,Scotland,Europe
1158,Lukáš Hrádecký,FIN,Leverkusen,Bundesliga,2023,33.0,1989.0,33.0,0,0,0,0,0,0,1,0.0,1,1,0,1,0,0,10,2,GK,30-34,Goalkeeper,Finland,Europe
1160,Timo Hübers,GER,Köln,Bundesliga,2023,27.0,1996.0,30.9,68,47,51,14,3,49,80,61.3,31,54,28,26,63,131,168,1,DF,25-29,Defender,Germany,Europe
1161,Callum Hudson-Odoi,ENG,Nott'ham Forest,Premier League,2023,22.0,2000.0,20.6,18,8,4,5,9,7,28,25.0,21,16,1,15,7,25,12,1,"FW,MF",20-24,Forward,England,Europe
1162,Will Hughes,ENG,Crystal Palace,Premier League,2023,28.0,1995.0,21.0,61,33,30,20,11,24,48,50.0,24,36,14,22,21,82,25,0,MF,25-29,Midfielder,England,Europe
1165,Mats Hummels,GER,Dortmund,Bundesliga,2023,34.0,1988.0,17.6,52,34,34,12,6,30,53,56.6,23,33,11,22,33,85,82,0,DF,30-34,Defender,Germany,Europe
1166,Denis Huseinbasic,BIH,Köln,Bundesliga,2023,22.0,2001.0,18.1,38,18,17,15,6,20,31,64.5,11,26,1,25,13,51,14,0,MF,20-24,Midfielder,Bosnia and Herzegovina,Europe
1167,Elseid Hysaj,ALB,Lazio,Serie A,2023,29.0,1994.0,13.3,24,14,8,13,3,15,24,62.5,9,16,6,10,17,41,31,0,DF,25-29,Defender,Albania,Europe
1168,Pierre Højbjerg,DEN,Tottenham,Premier League,2023,27.0,1995.0,14.6,32,18,13,17,2,13,34,38.2,21,21,7,14,19,51,30,3,MF,25-29,Midfielder,Denmark,Europe
1169,Rasmus Højlund,DEN,Manchester Utd,Premier League,2023,20.0,2003.0,24.0,11,7,2,3,6,5,13,38.5,8,9,1,8,1,12,19,0,FW,20-24,Forward,Denmark,Europe
1170,Iago,BRA,Augsburg,Bundesliga,2023,26.0,1997.0,18.0,36,17,22,10,4,17,33,51.5,16,39,8,31,18,54,43,0,DF,25-29,Defender,Brazil,South America
1172,Arijon Ibrahimović,GER,Frosinone,Serie A,2023,17.0,2005.0,5.3,7,6,4,2,1,1,9,11.1,8,4,0,4,1,8,3,0,"FW,DF",Under 20,Forward,Germany,Europe
1176,Igor,BRA,Brighton,Premier League,2023,25.0,1998.0,18.2,25,18,7,16,2,17,29,58.6,12,22,9,13,14,39,52,1,DF,25-29,Defender,Brazil,South America
1176,Igor,BRA,Brighton,Premier League,2023,25.0,1998.0,18.2,25,18,7,16,2,17,29,58.6,12,22,9,13,14,39,52,1,DF,25-29,Defender,Brazil,South America
1176,Igor,BRA,Brighton,Premier League,2023,25.0,1998.0,18.2,25,18,7,16,2,17,29,58.6,12,22,9,13,14,39,52,1,DF,25-29,Defender,Brazil,South America
1176,Igor,BRA,Brighton,Premier League,2023,25.0,1998.0,18.2,25,18,7,16,2,17,29,58.6,12,22,9,13,14,39,52,1,DF,25-29,Defender,Brazil,South America
1177,Jonathan Ikone,FRA,Fiorentina,Serie A,2023,25.0,1998.0,18.7,22,11,7,9,6,10,17,58.8,7,12,0,12,3,25,8,0,FW,25-29,Forward,France,Europe
1178,Chukwubuikem Ikwuemesi,NGA,Salernitana,Serie A,2023,21.0,2001.0,11.8,3,1,0,2,1,2,6,33.3,4,1,1,0,1,4,8,0,FW,20-24,Forward,Nigeria,Africa
1181,Samuel Iling-Junior,ENG,Juventus,Serie A,2023,19.0,2003.0,9.0,23,13,9,11,3,11,18,61.1,7,17,5,12,6,29,19,0,"DF,MF",Under 20,Defender,England,Europe
1183,Joel Imasuen,USA,Werder Bremen,Bundesliga,2023,18.0,2004.0,0.0,0,0,0,0,0,0,0,,0,0,0,0,0,0,0,0,FW,Under 20,Forward,United States,North America
1184,Ciro Immobile,ITA,Lazio,Serie A,2023,33.0,1990.0,18.4,11,9,2,5,4,3,14,21.4,11,9,3,6,5,16,11,0,FW,30-34,Forward,Italy,Europe
1185,Gino Infantino,ARG,Fiorentina,Serie A,2023,20.0,2003.0,1.1,1,1,0,1,0,0,1,0.0,1,4,0,4,3,4,1,0,MF,20-24,Midfielder,Argentina,South America
1186,Danny Ings,ENG,West Ham,Premier League,2023,31.0,1992.0,4.5,6,2,0,6,0,4,13,30.8,9,4,1,3,3,9,7,0,FW,30-34,Forward,England,Europe
1187,Bonke Innocent,NGA,Lorient,Ligue 1,2023,27.0,1996.0,2.3,6,4,2,2,2,2,9,22.2,7,2,1,1,4,10,2,0,MF,25-29,Midfielder,Nigeria,Africa
1188,Tim Iroegbunam,ENG,Aston Villa,Premier League,2023,20.0,2003.0,1.8,7,5,4,2,1,4,9,44.4,5,3,0,3,2,9,3,0,MF,20-24,Midfielder,England,Europe
1189,Alexander Isak,SWE,Newcastle Utd,Premier League,2023,23.0,1999.0,25.1,5,0,2,1,2,2,8,25.0,6,16,1,15,6,11,13,0,FW,20-24,Forward,Sweden,Europe
1190,Gustav Isaksen,DEN,Lazio,Serie A,2023,22.0,2001.0,11.9,4,3,2,1,1,1,9,11.1,8,11,1,10,4,8,4,0,FW,20-24,Forward,Denmark,Europe
1192,Thomas Isherwood,SWE,Darmstadt 98,Bundesliga,2023,25.0,1998.0,7.1,11,5,7,3,1,5,9,55.6,4,10,7,3,10,21,34,0,DF,25-29,Defender,Sweden,Europe
1193,Ismaily,BRA,Lille,Ligue 1,2023,33.0,1990.0,27.4,72,47,34,25,13,31,60,51.7,29,33,6,27,32,104,77,0,DF,30-34,Defender,Brazil,South America
1194,Ardian Ismajli,ALB,Empoli,Serie A,2023,26.0,1996.0,22.7,26,16,18,6,2,18,23,78.3,5,28,17,11,23,49,126,1,DF,25-29,Defender,Albania,Europe
1195,Yanis Issoufou,FRA,Montpellier,Ligue 1,2023,16.0,2006.0,0.1,0,0,0,0,0,0,0,,0,0,0,0,0,0,0,0,MF,Under 20,Midfielder,France,Europe
1196,Ko Itakura,JPN,Gladbach,Bundesliga,2023,26.0,1997.0,17.7,34,21,17,15,2,16,26,61.5,10,32,18,14,22,56,62,0,"DF,MF",25-29,Defender,Japan,Asia
1197,Hiroki Ito,JPN,Stuttgart,Bundesliga,2023,24.0,1999.0,24.8,19,18,13,6,0,11,26,42.3,15,29,17,12,29,48,86,2,DF,20-24,Defender,Japan,Asia
1198,Junya Ito,JPN,Reims,Ligue 1,2023,30.0,1993.0,30.2,33,15,11,14,8,10,36,27.8,26,23,1,22,14,47,7,0,"FW,MF",30-34,Forward,Japan,Asia
1200,Alex Iwobi,NGA,Everton,Premier League,2023,27.0,1996.0,1.6,2,0,1,0,1,2,3,66.7,1,2,0,2,1,3,0,0,MF,25-29,Midfielder,Nigeria,Africa
1201,Alex Iwobi,NGA,Fulham,Premier League,2023,27.0,1996.0,24.4,29,18,12,15,2,12,25,48.0,13,16,0,16,14,43,9,0,"FW,MF",25-29,Forward,Nigeria,Africa
1202,Armando Izzo,ITA,Monza,Serie A,2023,31.0,1992.0,18.3,27,17,17,9,1,16,27,59.3,11,20,16,4,27,54,49,1,DF,30-34,Defender,Italy,Europe
1203,Nicolas Jackson,SEN,Chelsea,Premier League,2023,22.0,2001.0,31.1,21,13,5,8,8,5,24,20.8,19,20,5,15,4,25,17,0,FW,20-24,Forward,Senegal,Africa
1204,Jérémy Jacquet,FRA,Rennes,Ligue 1,2023,18.0,2005.0,0.1,1,1,1,0,0,0,1,0.0,1,0,0,0,1,2,0,0,MF,Under 20,Midfielder,France,Europe
1205,Jérémy Jacquet,FRA,Clermont Foot,Ligue 1,2023,18.0,2005.0,2.8,4,3,4,0,0,3,3,100.0,0,7,3,4,6,10,10,0,DF,Under 20,Defender,France,Europe
1206,Lee Jae-sung,KOR,Mainz 05,Bundesliga,2023,30.0,1992.0,23.5,33,20,11,16,6,13,39,33.3,26,22,2,20,27,60,23,0,"MF,FW",30-34,Midfielder,South Korea,Asia
1207,Paul Jaeckel,GER,Union Berlin,Bundesliga,2023,25.0,1998.0,2.6,7,2,4,3,0,5,9,55.6,4,3,2,1,4,11,7,0,DF,25-29,Defender,Germany,Europe
1209,Kristijan Jakić,CRO,Augsburg,Bundesliga,2023,26.0,1997.0,11.7,28,14,14,10,4,15,33,45.5,18,13,1,12,20,48,15,0,MF,25-29,Midfielder,Croatia,Europe
1210,Kristijan Jakić,CRO,Eint Frankfurt,Bundesliga,2023,26.0,1997.0,2.2,3,3,1,2,0,1,3,33.3,2,1,0,1,2,5,2,0,"MF,FW",25-29,Midfielder,Croatia,Europe
1211,Ismail Jakobs,SEN,Monaco,Ligue 1,2023,23.0,1999.0,16.3,57,41,27,21,9,29,47,61.7,18,19,2,17,11,68,40,0,DF,20-24,Defender,Senegal,Africa
1212,Ablie Jallow,GAM,Metz,Ligue 1,2023,24.0,1998.0,10.2,8,5,2,3,3,3,5,60.0,2,4,0,4,8,16,3,0,"MF,FW",20-24,Midfielder,Gambia,Africa
1213,Reece James,ENG,Chelsea,Premier League,2023,23.0,1999.0,4.7,14,9,10,3,1,8,10,80.0,2,4,4,0,3,17,7,1,DF,20-24,Defender,England,Europe
1213,Reece James,ENG,Chelsea,Premier League,2023,23.0,1999.0,4.7,14,9,10,3,1,8,10,80.0,2,4,4,0,3,17,7,1,DF,20-24,Defender,England,Europe
1213,Reece James,ENG,Chelsea,Premier League,2023,23.0,1999.0,4.7,14,9,10,3,1,8,10,80.0,2,4,4,0,3,17,7,1,DF,20-24,Defender,England,Europe
1213,Reece James,ENG,Chelsea,Premier League,2023,23.0,1999.0,4.7,14,9,10,3,1,8,10,80.0,2,4,4,0,3,17,7,1,DF,20-24,Defender,England,Europe
1214,Vitaly Janelt,GER,Brentford,Premier League,2023,25.0,1998.0,33.9,63,38,29,25,9,32,64,50.0,32,35,9,26,36,99,64,3,"MF,DF",25-29,Midfielder,Germany,Europe
1216,Tony Jantschke,GER,Gladbach,Bundesliga,2023,33.0,1990.0,0.3,1,1,1,0,0,1,1,100.0,0,2,2,0,1,2,4,0,"DF,MF",30-34,Defender,Germany,Europe
1217,Adnan Januzaj,BEL,Sevilla,La Liga,2023,28.0,1995.0,2.1,3,3,2,0,1,0,1,0.0,1,2,0,2,1,4,0,0,"FW,MF",25-29,Forward,Belgium,Europe
1218,Nuha Jatta,GAM,RB Leipzig,Bundesliga,2023,17.0,2006.0,0.0,0,0,0,0,0,0,0,,0,0,0,0,0,0,0,0,FW,Under 20,Forward,Gambia,Africa
1220,Luis Javier Suárez,COL,Almería,La Liga,2023,25.0,1997.0,10.2,7,5,2,5,0,2,6,33.3,4,11,0,11,0,7,13,0,FW,25-29,Forward,Colombia,South America
1221,Danley Jean-Jacques,HAI,Metz,Ligue 1,2023,23.0,2000.0,29.8,54,28,24,21,9,19,56,33.9,37,48,7,41,44,98,44,0,MF,20-24,Midfielder,Haiti,North America
1222,Salim El Jebari,MAR,Atlético Madrid,La Liga,2023,19.0,2004.0,0.1,1,0,0,1,0,0,0,,0,0,0,0,0,1,1,0,MF,Under 20,Midfielder,Morocco,Africa
1223,Daniel Jebbison,ENG,Sheffield Utd,Premier League,2023,19.0,2003.0,0.2,0,0,0,0,0,0,0,,0,1,0,1,0,0,0,0,FW,Under 20,Forward,England,Europe
1224,Jeffinho,BRA,Lyon,Ligue 1,2023,23.0,1999.0,3.4,11,4,3,5,3,4,11,36.4,7,1,0,1,0,11,0,0,"FW,MF",20-24,Forward,Brazil,South America
1225,Fredrik Jensen,FIN,Augsburg,Bundesliga,2023,25.0,1997.0,14.9,23,11,9,8,6,14,28,50.0,14,30,1,29,12,35,21,0,"MF,FW",25-29,Midfielder,Finland,Europe
1226,Mathias Jensen,DEN,Brentford,Premier League,2023,27.0,1996.0,24.5,54,32,25,22,7,26,95,27.4,69,41,6,35,23,77,25,1,MF,25-29,Midfielder,Denmark,Europe
1227,Moritz Jenz,GER,Wolfsburg,Bundesliga,2023,24.0,1999.0,19.4,34,24,21,11,2,14,21,66.7,7,29,17,12,26,60,94,0,DF,20-24,Defender,Germany,Europe
1228,Gabriel Jesus,BRA,Arsenal,Premier League,2023,26.0,1997.0,16.4,24,17,11,5,8,5,18,27.8,13,23,1,22,13,37,12,0,FW,25-29,Forward,Brazil,South America
1229,Juan Jesus,BRA,Napoli,Serie A,2023,32.0,1991.0,23.5,42,19,28,12,2,23,33,69.7,10,23,12,11,23,65,67,1,DF,30-34,Defender,Brazil,South America
1231,Raúl Jiménez,MEX,Fulham,Premier League,2023,32.0,1991.0,15.5,18,12,4,8,6,7,20,35.0,13,11,3,8,4,22,13,0,FW,30-34,Forward,Mexico,North America
1232,João Pedro,BRA,Brighton,Premier League,2023,21.0,2001.0,22.7,31,14,10,13,8,14,24,58.3,10,15,2,13,11,42,28,0,"FW,MF",20-24,Forward,Brazil,South America
1232,João Pedro,BRA,Brighton,Premier League,2023,21.0,2001.0,22.7,31,14,10,13,8,14,24,58.3,10,15,2,13,11,42,28,0,"FW,MF",20-24,Forward,Brazil,South America
1232,João Pedro,BRA,Brighton,Premier League,2023,21.0,2001.0,22.7,31,14,10,13,8,14,24,58.3,10,15,2,13,11,42,28,0,"FW,MF",20-24,Forward,Brazil,South America
1232,João Pedro,BRA,Brighton,Premier League,2023,21.0,2001.0,22.7,31,14,10,13,8,14,24,58.3,10,15,2,13,11,42,28,0,"FW,MF",20-24,Forward,Brazil,South America
1232,João Pedro,BRA,Brighton,Premier League,2023,21.0,2001.0,22.7,31,14,10,13,8,14,24,58.3,10,15,2,13,11,42,28,0,"FW,MF",20-24,Forward,Brazil,South America
1232,João Pedro,BRA,Brighton,Premier League,2023,21.0,2001.0,22.7,31,14,10,13,8,14,24,58.3,10,15,2,13,11,42,28,0,"FW,MF",20-24,Forward,Brazil,South America
1232,João Pedro,BRA,Brighton,Premier League,2023,21.0,2001.0,22.7,31,14,10,13,8,14,24,58.3,10,15,2,13,11,42,28,0,"FW,MF",20-24,Forward,Brazil,South America
1232,João Pedro,BRA,Brighton,Premier League,2023,21.0,2001.0,22.7,31,14,10,13,8,14,24,58.3,10,15,2,13,11,42,28,0,"FW,MF",20-24,Forward,Brazil,South America
1232,João Pedro,BRA,Brighton,Premier League,2023,21.0,2001.0,22.7,31,14,10,13,8,14,24,58.3,10,15,2,13,11,42,28,0,"FW,MF",20-24,Forward,Brazil,South America
1232,João Pedro,BRA,Brighton,Premier League,2023,21.0,2001.0,22.7,31,14,10,13,8,14,24,58.3,10,15,2,13,11,42,28,0,"FW,MF",20-24,Forward,Brazil,South America
1232,João Pedro,BRA,Brighton,Premier League,2023,21.0,2001.0,22.7,31,14,10,13,8,14,24,58.3,10,15,2,13,11,42,28,0,"FW,MF",20-24,Forward,Brazil,South America
1232,João Pedro,BRA,Brighton,Premier League,2023,21.0,2001.0,22.7,31,14,10,13,8,14,24,58.3,10,15,2,13,11,42,28,0,"FW,MF",20-24,Forward,Brazil,South America
1232,João Pedro,BRA,Brighton,Premier League,2023,21.0,2001.0,22.7,31,14,10,13,8,14,24,58.3,10,15,2,13,11,42,28,0,"FW,MF",20-24,Forward,Brazil,South America
1232,João Pedro,BRA,Brighton,Premier League,2023,21.0,2001.0,22.7,31,14,10,13,8,14,24,58.3,10,15,2,13,11,42,28,0,"FW,MF",20-24,Forward,Brazil,South America
1232,João Pedro,BRA,Brighton,Premier League,2023,21.0,2001.0,22.7,31,14,10,13,8,14,24,58.3,10,15,2,13,11,42,28,0,"FW,MF",20-24,Forward,Brazil,South America
1232,João Pedro,BRA,Brighton,Premier League,2023,21.0,2001.0,22.7,31,14,10,13,8,14,24,58.3,10,15,2,13,11,42,28,0,"FW,MF",20-24,Forward,Brazil,South America
1232,João Pedro,BRA,Brighton,Premier League,2023,21.0,2001.0,22.7,31,14,10,13,8,14,24,58.3,10,15,2,13,11,42,28,0,"FW,MF",20-24,Forward,Brazil,South America
1232,João Pedro,BRA,Brighton,Premier League,2023,21.0,2001.0,22.7,31,14,10,13,8,14,24,58.3,10,15,2,13,11,42,28,0,"FW,MF",20-24,Forward,Brazil,South America
1232,João Pedro,BRA,Brighton,Premier League,2023,21.0,2001.0,22.7,31,14,10,13,8,14,24,58.3,10,15,2,13,11,42,28,0,"FW,MF",20-24,Forward,Brazil,South America
1232,João Pedro,BRA,Brighton,Premier League,2023,21.0,2001.0,22.7,31,14,10,13,8,14,24,58.3,10,15,2,13,11,42,28,0,"FW,MF",20-24,Forward,Brazil,South America
1232,João Pedro,BRA,Brighton,Premier League,2023,21.0,2001.0,22.7,31,14,10,13,8,14,24,58.3,10,15,2,13,11,42,28,0,"FW,MF",20-24,Forward,Brazil,South America
1232,João Pedro,BRA,Brighton,Premier League,2023,21.0,2001.0,22.7,31,14,10,13,8,14,24,58.3,10,15,2,13,11,42,28,0,"FW,MF",20-24,Forward,Brazil,South America
1232,João Pedro,BRA,Brighton,Premier League,2023,21.0,2001.0,22.7,31,14,10,13,8,14,24,58.3,10,15,2,13,11,42,28,0,"FW,MF",20-24,Forward,Brazil,South America
1232,João Pedro,BRA,Brighton,Premier League,2023,21.0,2001.0,22.7,31,14,10,13,8,14,24,58.3,10,15,2,13,11,42,28,0,"FW,MF",20-24,Forward,Brazil,South America
1232,João Pedro,BRA,Brighton,Premier League,2023,21.0,2001.0,22.7,31,14,10,13,8,14,24,58.3,10,15,2,13,11,42,28,0,"FW,MF",20-24,Forward,Brazil,South America
1232,João Pedro,BRA,Brighton,Premier League,2023,21.0,2001.0,22.7,31,14,10,13,8,14,24,58.3,10,15,2,13,11,42,28,0,"FW,MF",20-24,Forward,Brazil,South America
1232,João Pedro,BRA,Brighton,Premier League,2023,21.0,2001.0,22.7,31,14,10,13,8,14,24,58.3,10,15,2,13,11,42,28,0,"FW,MF",20-24,Forward,Brazil,South America
1232,João Pedro,BRA,Brighton,Premier League,2023,21.0,2001.0,22.7,31,14,10,13,8,14,24,58.3,10,15,2,13,11,42,28,0,"FW,MF",20-24,Forward,Brazil,South America
1232,João Pedro,BRA,Brighton,Premier League,2023,21.0,2001.0,22.7,31,14,10,13,8,14,24,58.3,10,15,2,13,11,42,28,0,"FW,MF",20-24,Forward,Brazil,South America
1232,João Pedro,BRA,Brighton,Premier League,2023,21.0,2001.0,22.7,31,14,10,13,8,14,24,58.3,10,15,2,13,11,42,28,0,"FW,MF",20-24,Forward,Brazil,South America
1232,João Pedro,BRA,Brighton,Premier League,2023,21.0,2001.0,22.7,31,14,10,13,8,14,24,58.3,10,15,2,13,11,42,28,0,"FW,MF",20-24,Forward,Brazil,South America
1232,João Pedro,BRA,Brighton,Premier League,2023,21.0,2001.0,22.7,31,14,10,13,8,14,24,58.3,10,15,2,13,11,42,28,0,"FW,MF",20-24,Forward,Brazil,South America
1232,João Pedro,BRA,Brighton,Premier League,2023,21.0,2001.0,22.7,31,14,10,13,8,14,24,58.3,10,15,2,13,11,42,28,0,"FW,MF",20-24,Forward,Brazil,South America
1232,João Pedro,BRA,Brighton,Premier League,2023,21.0,2001.0,22.7,31,14,10,13,8,14,24,58.3,10,15,2,13,11,42,28,0,"FW,MF",20-24,Forward,Brazil,South America
1232,João Pedro,BRA,Brighton,Premier League,2023,21.0,2001.0,22.7,31,14,10,13,8,14,24,58.3,10,15,2,13,11,42,28,0,"FW,MF",20-24,Forward,Brazil,South America
1232,João Pedro,BRA,Brighton,Premier League,2023,21.0,2001.0,22.7,31,14,10,13,8,14,24,58.3,10,15,2,13,11,42,28,0,"FW,MF",20-24,Forward,Brazil,South America
1232,João Pedro,BRA,Brighton,Premier League,2023,21.0,2001.0,22.7,31,14,10,13,8,14,24,58.3,10,15,2,13,11,42,28,0,"FW,MF",20-24,Forward,Brazil,South America
1232,João Pedro,BRA,Brighton,Premier League,2023,21.0,2001.0,22.7,31,14,10,13,8,14,24,58.3,10,15,2,13,11,42,28,0,"FW,MF",20-24,Forward,Brazil,South America
1232,João Pedro,BRA,Brighton,Premier League,2023,21.0,2001.0,22.7,31,14,10,13,8,14,24,58.3,10,15,2,13,11,42,28,0,"FW,MF",20-24,Forward,Brazil,South America
1232,João Pedro,BRA,Brighton,Premier League,2023,21.0,2001.0,22.7,31,14,10,13,8,14,24,58.3,10,15,2,13,11,42,28,0,"FW,MF",20-24,Forward,Brazil,South America
1232,João Pedro,BRA,Brighton,Premier League,2023,21.0,2001.0,22.7,31,14,10,13,8,14,24,58.3,10,15,2,13,11,42,28,0,"FW,MF",20-24,Forward,Brazil,South America
1232,João Pedro,BRA,Brighton,Premier League,2023,21.0,2001.0,22.7,31,14,10,13,8,14,24,58.3,10,15,2,13,11,42,28,0,"FW,MF",20-24,Forward,Brazil,South America
1232,João Pedro,BRA,Brighton,Premier League,2023,21.0,2001.0,22.7,31,14,10,13,8,14,24,58.3,10,15,2,13,11,42,28,0,"FW,MF",20-24,Forward,Brazil,South America
1232,João Pedro,BRA,Brighton,Premier League,2023,21.0,2001.0,22.7,31,14,10,13,8,14,24,58.3,10,15,2,13,11,42,28,0,"FW,MF",20-24,Forward,Brazil,South America
1232,João Pedro,BRA,Brighton,Premier League,2023,21.0,2001.0,22.7,31,14,10,13,8,14,24,58.3,10,15,2,13,11,42,28,0,"FW,MF",20-24,Forward,Brazil,South America
1232,João Pedro,BRA,Brighton,Premier League,2023,21.0,2001.0,22.7,31,14,10,13,8,14,24,58.3,10,15,2,13,11,42,28,0,"FW,MF",20-24,Forward,Brazil,South America
1232,João Pedro,BRA,Brighton,Premier League,2023,21.0,2001.0,22.7,31,14,10,13,8,14,24,58.3,10,15,2,13,11,42,28,0,"FW,MF",20-24,Forward,Brazil,South America
1232,João Pedro,BRA,Brighton,Premier League,2023,21.0,2001.0,22.7,31,14,10,13,8,14,24,58.3,10,15,2,13,11,42,28,0,"FW,MF",20-24,Forward,Brazil,South America
1232,João Pedro,BRA,Brighton,Premier League,2023,21.0,2001.0,22.7,31,14,10,13,8,14,24,58.3,10,15,2,13,11,42,28,0,"FW,MF",20-24,Forward,Brazil,South America
1232,João Pedro,BRA,Brighton,Premier League,2023,21.0,2001.0,22.7,31,14,10,13,8,14,24,58.3,10,15,2,13,11,42,28,0,"FW,MF",20-24,Forward,Brazil,South America
1232,João Pedro,BRA,Brighton,Premier League,2023,21.0,2001.0,22.7,31,14,10,13,8,14,24,58.3,10,15,2,13,11,42,28,0,"FW,MF",20-24,Forward,Brazil,South America
1232,João Pedro,BRA,Brighton,Premier League,2023,21.0,2001.0,22.7,31,14,10,13,8,14,24,58.3,10,15,2,13,11,42,28,0,"FW,MF",20-24,Forward,Brazil,South America
1232,João Pedro,BRA,Brighton,Premier League,2023,21.0,2001.0,22.7,31,14,10,13,8,14,24,58.3,10,15,2,13,11,42,28,0,"FW,MF",20-24,Forward,Brazil,South America
1232,João Pedro,BRA,Brighton,Premier League,2023,21.0,2001.0,22.7,31,14,10,13,8,14,24,58.3,10,15,2,13,11,42,28,0,"FW,MF",20-24,Forward,Brazil,South America
1232,João Pedro,BRA,Brighton,Premier League,2023,21.0,2001.0,22.7,31,14,10,13,8,14,24,58.3,10,15,2,13,11,42,28,0,"FW,MF",20-24,Forward,Brazil,South America
1232,João Pedro,BRA,Brighton,Premier League,2023,21.0,2001.0,22.7,31,14,10,13,8,14,24,58.3,10,15,2,13,11,42,28,0,"FW,MF",20-24,Forward,Brazil,South America
1232,João Pedro,BRA,Brighton,Premier League,2023,21.0,2001.0,22.7,31,14,10,13,8,14,24,58.3,10,15,2,13,11,42,28,0,"FW,MF",20-24,Forward,Brazil,South America
1232,João Pedro,BRA,Brighton,Premier League,2023,21.0,2001.0,22.7,31,14,10,13,8,14,24,58.3,10,15,2,13,11,42,28,0,"FW,MF",20-24,Forward,Brazil,South America
1232,João Pedro,BRA,Brighton,Premier League,2023,21.0,2001.0,22.7,31,14,10,13,8,14,24,58.3,10,15,2,13,11,42,28,0,"FW,MF",20-24,Forward,Brazil,South America
1232,João Pedro,BRA,Brighton,Premier League,2023,21.0,2001.0,22.7,31,14,10,13,8,14,24,58.3,10,15,2,13,11,42,28,0,"FW,MF",20-24,Forward,Brazil,South America
1232,João Pedro,BRA,Brighton,Premier League,2023,21.0,2001.0,22.7,31,14,10,13,8,14,24,58.3,10,15,2,13,11,42,28,0,"FW,MF",20-24,Forward,Brazil,South America
1232,João Pedro,BRA,Brighton,Premier League,2023,21.0,2001.0,22.7,31,14,10,13,8,14,24,58.3,10,15,2,13,11,42,28,0,"FW,MF",20-24,Forward,Brazil,South America
1232,João Pedro,BRA,Brighton,Premier League,2023,21.0,2001.0,22.7,31,14,10,13,8,14,24,58.3,10,15,2,13,11,42,28,0,"FW,MF",20-24,Forward,Brazil,South America
1232,João Pedro,BRA,Brighton,Premier League,2023,21.0,2001.0,22.7,31,14,10,13,8,14,24,58.3,10,15,2,13,11,42,28,0,"FW,MF",20-24,Forward,Brazil,South America
1232,João Pedro,BRA,Brighton,Premier League,2023,21.0,2001.0,22.7,31,14,10,13,8,14,24,58.3,10,15,2,13,11,42,28,0,"FW,MF",20-24,Forward,Brazil,South America
1232,João Pedro,BRA,Brighton,Premier League,2023,21.0,2001.0,22.7,31,14,10,13,8,14,24,58.3,10,15,2,13,11,42,28,0,"FW,MF",20-24,Forward,Brazil,South America
1232,João Pedro,BRA,Brighton,Premier League,2023,21.0,2001.0,22.7,31,14,10,13,8,14,24,58.3,10,15,2,13,11,42,28,0,"FW,MF",20-24,Forward,Brazil,South America
1232,João Pedro,BRA,Brighton,Premier League,2023,21.0,2001.0,22.7,31,14,10,13,8,14,24,58.3,10,15,2,13,11,42,28,0,"FW,MF",20-24,Forward,Brazil,South America
1232,João Pedro,BRA,Brighton,Premier League,2023,21.0,2001.0,22.7,31,14,10,13,8,14,24,58.3,10,15,2,13,11,42,28,0,"FW,MF",20-24,Forward,Brazil,South America
1232,João Pedro,BRA,Brighton,Premier League,2023,21.0,2001.0,22.7,31,14,10,13,8,14,24,58.3,10,15,2,13,11,42,28,0,"FW,MF",20-24,Forward,Brazil,South America
1232,João Pedro,BRA,Brighton,Premier League,2023,21.0,2001.0,22.7,31,14,10,13,8,14,24,58.3,10,15,2,13,11,42,28,0,"FW,MF",20-24,Forward,Brazil,South America
1232,João Pedro,BRA,Brighton,Premier League,2023,21.0,2001.0,22.7,31,14,10,13,8,14,24,58.3,10,15,2,13,11,42,28,0,"FW,MF",20-24,Forward,Brazil,South America
1232,João Pedro,BRA,Brighton,Premier League,2023,21.0,2001.0,22.7,31,14,10,13,8,14,24,58.3,10,15,2,13,11,42,28,0,"FW,MF",20-24,Forward,Brazil,South America
1232,João Pedro,BRA,Brighton,Premier League,2023,21.0,2001.0,22.7,31,14,10,13,8,14,24,58.3,10,15,2,13,11,42,28,0,"FW,MF",20-24,Forward,Brazil,South America
1232,João Pedro,BRA,Brighton,Premier League,2023,21.0,2001.0,22.7,31,14,10,13,8,14,24,58.3,10,15,2,13,11,42,28,0,"FW,MF",20-24,Forward,Brazil,South America
1232,João Pedro,BRA,Brighton,Premier League,2023,21.0,2001.0,22.7,31,14,10,13,8,14,24,58.3,10,15,2,13,11,42,28,0,"FW,MF",20-24,Forward,Brazil,South America
1232,João Pedro,BRA,Brighton,Premier League,2023,21.0,2001.0,22.7,31,14,10,13,8,14,24,58.3,10,15,2,13,11,42,28,0,"FW,MF",20-24,Forward,Brazil,South America
1232,João Pedro,BRA,Brighton,Premier League,2023,21.0,2001.0,22.7,31,14,10,13,8,14,24,58.3,10,15,2,13,11,42,28,0,"FW,MF",20-24,Forward,Brazil,South America
1232,João Pedro,BRA,Brighton,Premier League,2023,21.0,2001.0,22.7,31,14,10,13,8,14,24,58.3,10,15,2,13,11,42,28,0,"FW,MF",20-24,Forward,Brazil,South America
1232,João Pedro,BRA,Brighton,Premier League,2023,21.0,2001.0,22.7,31,14,10,13,8,14,24,58.3,10,15,2,13,11,42,28,0,"FW,MF",20-24,Forward,Brazil,South America
1232,João Pedro,BRA,Brighton,Premier League,2023,21.0,2001.0,22.7,31,14,10,13,8,14,24,58.3,10,15,2,13,11,42,28,0,"FW,MF",20-24,Forward,Brazil,South America
1233,Joelinton,BRA,Newcastle Utd,Premier League,2023,26.0,1996.0,14.2,39,27,21,15,3,14,38,36.8,24,23,7,16,19,58,11,1,"MF,FW",25-29,Midfielder,Brazil,South America
1234,Ryan John Giles,ENG,Luton Town,Premier League,2023,23.0,2000.0,5.6,8,6,4,3,1,2,7,28.6,5,2,0,2,4,12,22,0,"DF,MF",20-24,Defender,England,Europe
1235,Ben Johnson,ENG,West Ham,Premier League,2023,23.0,2000.0,6.0,11,7,7,3,1,9,14,64.3,5,2,1,1,5,16,14,0,"DF,FW",20-24,Defender,England,Europe
1236,Brennan Johnson,WAL,Tottenham,Premier League,2023,22.0,2001.0,23.2,26,15,14,5,7,12,31,38.7,19,37,1,36,10,36,12,1,FW,20-24,Forward,Wales,Europe
1237,Brennan Johnson,WAL,Nott'ham Forest,Premier League,2023,22.0,2001.0,2.6,4,1,1,1,2,2,4,50.0,2,4,1,3,0,4,0,0,"FW,MF",20-24,Forward,Wales,Europe
1238,Joseph Johnson,ENG,Luton Town,Premier League,2023,17.0,2006.0,0.9,0,0,0,0,0,0,1,0.0,1,0,0,0,0,0,0,0,DF,Under 20,Defender,England,Europe
1239,Sam Johnstone,ENG,Crystal Palace,Premier League,2023,30.0,1993.0,20.0,1,0,1,0,0,1,1,100.0,0,0,0,0,1,2,5,0,GK,30-34,Goalkeeper,England,Europe
1240,Curtis Jones,ENG,Liverpool,Premier League,2023,22.0,2001.0,13.0,27,14,12,12,3,10,23,43.5,13,22,0,22,7,34,8,0,MF,20-24,Midfielder,England,Europe
1241,Frenkie de Jong,NED,Barcelona,La Liga,2023,26.0,1997.0,18.2,43,26,14,23,6,8,19,42.1,11,18,8,10,14,57,28,1,MF,25-29,Midfielder,Netherlands,Europe
1245,Kaio Jorge,BRA,Frosinone,Serie A,2023,21.0,2002.0,9.0,6,4,0,1,5,3,4,75.0,1,6,0,6,1,7,0,0,FW,20-24,Forward,Brazil,South America
1246,Jorginho,ITA,Arsenal,Premier League,2023,31.0,1991.0,10.2,24,10,6,10,8,11,23,47.8,12,17,1,16,12,36,7,1,MF,30-34,Midfielder,Italy,Europe
1246,Jorginho,ITA,Arsenal,Premier League,2023,31.0,1991.0,10.2,24,10,6,10,8,11,23,47.8,12,17,1,16,12,36,7,1,MF,30-34,Midfielder,Italy,Europe
1246,Jorginho,ITA,Arsenal,Premier League,2023,31.0,1991.0,10.2,24,10,6,10,8,11,23,47.8,12,17,1,16,12,36,7,1,MF,30-34,Midfielder,Italy,Europe
1246,Jorginho,ITA,Arsenal,Premier League,2023,31.0,1991.0,10.2,24,10,6,10,8,11,23,47.8,12,17,1,16,12,36,7,1,MF,30-34,Midfielder,Italy,Europe
1246,Jorginho,ITA,Arsenal,Premier League,2023,31.0,1991.0,10.2,24,10,6,10,8,11,23,47.8,12,17,1,16,12,36,7,1,MF,30-34,Midfielder,Italy,Europe
1246,Jorginho,ITA,Arsenal,Premier League,2023,31.0,1991.0,10.2,24,10,6,10,8,11,23,47.8,12,17,1,16,12,36,7,1,MF,30-34,Midfielder,Italy,Europe
1246,Jorginho,ITA,Arsenal,Premier League,2023,31.0,1991.0,10.2,24,10,6,10,8,11,23,47.8,12,17,1,16,12,36,7,1,MF,30-34,Midfielder,Italy,Europe
1246,Jorginho,ITA,Arsenal,Premier League,2023,31.0,1991.0,10.2,24,10,6,10,8,11,23,47.8,12,17,1,16,12,36,7,1,MF,30-34,Midfielder,Italy,Europe
1246,Jorginho,ITA,Arsenal,Premier League,2023,31.0,1991.0,10.2,24,10,6,10,8,11,23,47.8,12,17,1,16,12,36,7,1,MF,30-34,Midfielder,Italy,Europe
1246,Jorginho,ITA,Arsenal,Premier League,2023,31.0,1991.0,10.2,24,10,6,10,8,11,23,47.8,12,17,1,16,12,36,7,1,MF,30-34,Midfielder,Italy,Europe
1246,Jorginho,ITA,Arsenal,Premier League,2023,31.0,1991.0,10.2,24,10,6,10,8,11,23,47.8,12,17,1,16,12,36,7,1,MF,30-34,Midfielder,Italy,Europe
1246,Jorginho,ITA,Arsenal,Premier League,2023,31.0,1991.0,10.2,24,10,6,10,8,11,23,47.8,12,17,1,16,12,36,7,1,MF,30-34,Midfielder,Italy,Europe
1246,Jorginho,ITA,Arsenal,Premier League,2023,31.0,1991.0,10.2,24,10,6,10,8,11,23,47.8,12,17,1,16,12,36,7,1,MF,30-34,Midfielder,Italy,Europe
1246,Jorginho,ITA,Arsenal,Premier League,2023,31.0,1991.0,10.2,24,10,6,10,8,11,23,47.8,12,17,1,16,12,36,7,1,MF,30-34,Midfielder,Italy,Europe
1246,Jorginho,ITA,Arsenal,Premier League,2023,31.0,1991.0,10.2,24,10,6,10,8,11,23,47.8,12,17,1,16,12,36,7,1,MF,30-34,Midfielder,Italy,Europe
1246,Jorginho,ITA,Arsenal,Premier League,2023,31.0,1991.0,10.2,24,10,6,10,8,11,23,47.8,12,17,1,16,12,36,7,1,MF,30-34,Midfielder,Italy,Europe
1247,Willian José,BRA,Betis,La Liga,2023,31.0,1991.0,21.9,7,3,1,2,4,2,5,40.0,3,8,2,6,2,9,15,0,FW,30-34,Forward,Brazil,South America
1249,Diogo Jota,POR,Liverpool,Premier League,2023,26.0,1996.0,12.7,23,13,6,13,4,10,23,43.5,13,9,1,8,7,30,4,0,FW,25-29,Forward,Portugal,Europe
1250,Antoine Joujou,FRA,Le Havre,Ligue 1,2023,20.0,2003.0,8.7,20,12,7,7,6,11,21,52.4,10,11,2,9,7,27,5,0,"FW,MF",20-24,Forward,France,Europe
1255,Mads Juel Andersen,DEN,Luton Town,Premier League,2023,25.0,1997.0,4.4,6,5,4,2,0,4,4,100.0,0,9,6,3,8,14,29,0,DF,25-29,Defender,Denmark,Europe
1256,Christopher Jullien,FRA,Montpellier,Ligue 1,2023,30.0,1993.0,13.7,16,12,11,5,0,6,17,35.3,11,25,20,5,12,28,106,2,DF,30-34,Defender,France,Europe
1257,Anthony Jung,GER,Werder Bremen,Bundesliga,2023,31.0,1991.0,28.7,37,23,21,14,2,18,33,54.5,15,39,17,22,24,61,102,0,DF,30-34,Defender,Germany,Europe
1258,Eli Junior Kroupi,FRA,Lorient,Ligue 1,2023,17.0,2006.0,12.0,7,4,2,2,3,1,9,11.1,8,6,0,6,10,17,5,0,"FW,MF",Under 20,Forward,France,Europe
1259,Hamed Junior Traorè,CIV,Bournemouth,Premier League,2023,23.0,2000.0,0.5,1,0,1,0,0,1,3,33.3,2,3,0,3,0,1,0,0,MF,20-24,Midfielder,Ivory Coast,Africa
1260,Hamed Junior Traorè,CIV,Napoli,Serie A,2023,23.0,2000.0,4.2,4,2,2,0,2,1,6,16.7,5,3,0,3,2,6,1,1,MF,20-24,Midfielder,Ivory Coast,Africa
1261,Vinicius Júnior,BRA,Real Madrid,La Liga,2023,23.0,2000.0,20.7,18,13,5,5,8,3,12,25.0,9,13,0,13,1,19,3,2,FW,20-24,Forward,Brazil,South America
1262,Josip Juranović,CRO,Union Berlin,Bundesliga,2023,27.0,1995.0,14.4,20,14,11,7,2,10,21,47.6,11,17,3,14,12,32,27,1,DF,25-29,Defender,Croatia,Europe
1264,Julian Justvan,GER,Hoffenheim,Bundesliga,2023,25.0,1998.0,0.5,1,0,1,0,0,1,2,50.0,1,1,0,1,0,1,0,0,"FW,MF",25-29,Forward,Germany,Europe
1265,Julian Justvan,GER,Darmstadt 98,Bundesliga,2023,25.0,1998.0,11.4,10,4,2,7,1,3,17,17.6,14,12,2,10,11,21,6,1,"MF,FW",25-29,Midfielder,Germany,Europe
1266,Filip Jørgensen,DEN,Villarreal,La Liga,2023,21.0,2002.0,36.0,3,1,3,0,0,3,4,75.0,1,0,0,0,2,5,10,3,GK,20-24,Goalkeeper,Denmark,Europe
1267,Mathias Jørgensen,DEN,Brentford,Premier League,2023,33.0,1990.0,12.1,17,12,15,1,1,11,19,57.9,8,9,5,4,12,29,40,0,DF,30-34,Defender,Denmark,Europe
1268,Mohamed Kaba,FRA,Lecce,Serie A,2023,21.0,2001.0,15.3,39,23,15,16,8,17,34,50.0,17,22,4,18,12,51,13,0,MF,20-24,Midfielder,France,Europe
1269,Sory Kaba,GUI,Las Palmas,La Liga,2023,28.0,1995.0,8.0,2,0,0,2,0,0,5,0.0,5,6,0,6,0,2,9,0,FW,25-29,Forward,Guinea,Africa
1270,Ozan Kabak,TUR,Hoffenheim,Bundesliga,2023,23.0,2000.0,25.4,48,35,32,14,2,19,33,57.6,14,43,21,22,46,94,106,2,DF,20-24,Defender,Turkey,Asia
1271,Christian Kabasele,BEL,Udinese,Serie A,2023,32.0,1991.0,9.6,10,7,4,5,1,2,11,18.2,9,15,9,6,12,22,56,0,DF,30-34,Defender,Belgium,Europe
1272,Issa Kaboré,BFA,Luton Town,Premier League,2023,22.0,2001.0,19.2,52,28,23,21,8,24,45,53.3,21,22,11,11,16,68,56,2,DF,20-24,Defender,Burkina Faso,Africa
1273,Abdoul Kader Bamba,FRA,Nantes,Ligue 1,2023,29.0,1994.0,6.8,10,7,2,5,3,5,15,33.3,10,4,0,4,4,14,4,1,"FW,MF",25-29,Forward,France,Europe
1274,Yaya Kader Fofana,MLI,Reims,Ligue 1,2023,19.0,2004.0,0.4,3,3,1,1,1,0,1,0.0,1,0,0,0,1,4,0,0,"MF,DF",Under 20,Midfielder,Mali,Africa
1276,Tino Kadewere,ZIM,Lyon,Ligue 1,2023,27.0,1996.0,3.3,1,1,0,1,0,1,5,20.0,4,3,1,2,5,6,7,0,"FW,MF",25-29,Forward,Zimbabwe,Africa
1277,Tino Kadewere,ZIM,Nantes,Ligue 1,2023,27.0,1996.0,8.7,9,4,3,3,3,6,11,54.5,5,10,1,9,10,19,8,0,"FW,MF",25-29,Forward,Zimbabwe,Africa
1278,Kaiky,BRA,Almería,La Liga,2023,19.0,2004.0,5.8,7,4,6,0,1,3,6,50.0,3,9,7,2,3,10,29,1,DF,Under 20,Defender,Brazil,South America
1279,Florian Kainz,AUT,Köln,Bundesliga,2023,30.0,1992.0,24.4,28,20,8,13,7,17,39,43.6,22,20,6,14,13,41,23,1,"MF,FW",30-34,Midfielder,Austria,Europe
1280,Sasa Kalajdzic,AUT,Wolves,Premier League,2023,26.0,1997.0,1.8,6,2,3,2,1,1,2,50.0,1,3,0,3,1,7,6,0,FW,25-29,Forward,Austria,Europe
1281,Sasa Kalajdzic,AUT,Eint Frankfurt,Bundesliga,2023,26.0,1997.0,3.6,2,2,0,2,0,0,0,,0,2,2,0,2,4,6,0,FW,25-29,Forward,Austria,Europe
1282,Arnaud Kalimuendo,FRA,Rennes,Ligue 1,2023,21.0,2002.0,23.8,5,4,2,2,1,2,5,40.0,3,13,2,11,4,9,4,0,FW,20-24,Forward,France,Europe
1283,Yayah Kallon,SLE,Hellas Verona,Serie A,2023,22.0,2001.0,0.0,0,0,0,0,0,0,0,,0,0,0,0,0,0,0,0,FW,20-24,Forward,Sierra Leone,Africa
1284,Gedeon Kalulu,COD,Lorient,Ligue 1,2023,25.0,1997.0,10.8,23,17,13,8,2,12,22,54.5,10,18,2,16,5,28,30,0,DF,25-29,Defender,DR Congo,Africa
1285,Pierre Kalulu,FRA,Milan,Serie A,2023,23.0,2000.0,4.2,5,1,2,3,0,1,2,50.0,1,4,3,1,1,6,12,1,DF,20-24,Defender,France,Europe
1286,Daichi Kamada,JPN,Lazio,Serie A,2023,26.0,1996.0,17.2,53,36,22,22,9,28,52,53.8,24,24,5,19,18,71,7,0,MF,25-29,Midfielder,Japan,Asia
1288,Boubacar Kamara,FRA,Aston Villa,Premier League,2023,23.0,1999.0,18.4,43,29,16,21,6,24,47,51.1,23,21,7,14,21,64,16,0,MF,20-24,Midfielder,France,Europe
1289,Hassane Kamara,CIV,Udinese,Serie A,2023,29.0,1994.0,24.7,45,32,26,13,6,25,38,65.8,13,29,2,27,26,71,66,0,DF,25-29,Defender,Ivory Coast,Africa
1290,Willy Kambwala,FRA,Manchester Utd,Premier League,2023,18.0,2004.0,3.7,3,1,1,2,0,1,3,33.3,2,6,3,3,4,7,14,1,DF,Under 20,Defender,France,Europe
1292,Thomas Kaminski,BEL,Luton Town,Premier League,2023,30.0,1992.0,37.8,2,1,2,0,0,2,6,33.3,4,1,0,1,0,2,14,2,GK,30-34,Goalkeeper,Belgium,Europe
1294,Harry Kane,ENG,Bayern Munich,Bundesliga,2023,30.0,1993.0,31.5,13,9,4,4,5,6,18,33.3,12,12,4,8,6,19,14,0,FW,30-34,Forward,England,Europe
1295,Lee Kang-in,KOR,Paris S-G,Ligue 1,2023,22.0,2001.0,16.3,26,13,7,9,10,15,36,41.7,21,7,0,7,6,32,3,0,"FW,MF",20-24,Forward,South Korea,Asia
1296,Yann Karamoh,FRA,Torino,Serie A,2023,25.0,1998.0,1.8,1,0,0,0,1,0,0,,0,0,0,0,0,1,1,0,"MF,FW",25-29,Midfielder,France,Europe
1297,Yann Karamoh,FRA,Montpellier,Ligue 1,2023,25.0,1998.0,3.2,1,0,0,0,1,1,2,50.0,1,3,0,3,0,1,0,0,"FW,MF",25-29,Forward,France,Europe
1299,Ayman Kari,FRA,Lorient,Ligue 1,2023,18.0,2004.0,9.9,18,14,9,9,0,12,19,63.2,7,19,2,17,6,24,9,1,MF,Under 20,Midfielder,France,Europe
1300,Emir Karic,AUT,Darmstadt 98,Bundesliga,2023,26.0,1997.0,19.8,45,27,23,14,8,21,33,63.6,12,42,11,31,13,58,43,0,DF,25-29,Defender,Austria,Europe
1301,Loris Karius,GER,Newcastle Utd,Premier League,2023,30.0,1993.0,1.0,0,0,0,0,0,0,0,,0,0,0,0,0,0,1,0,GK,30-34,Goalkeeper,Germany,Europe
1302,Jesper Karlsson,SWE,Bologna,Serie A,2023,25.0,1998.0,3.8,3,3,2,1,0,2,8,25.0,6,4,0,4,4,7,1,0,FW,25-29,Forward,Sweden,Europe
1304,Rick Karsdorp,NED,Roma,Serie A,2023,28.0,1995.0,13.2,25,18,11,8,6,16,24,66.7,8,13,4,9,9,34,16,0,DF,25-29,Defender,Netherlands,Europe
1305,Grigoris Kastanos,CYP,Salernitana,Serie A,2023,25.0,1998.0,16.4,23,14,8,9,6,9,20,45.0,11,13,4,9,8,31,9,0,"MF,DF",25-29,Midfielder,Cyprus,Asia
1306,Silas Katompa,COD,Stuttgart,Bundesliga,2023,24.0,1998.0,10.0,5,3,3,2,0,3,12,25.0,9,9,0,9,0,5,4,0,"FW,MF",20-24,Forward,DR Congo,Africa
1307,Panos Katseris,GRE,Lorient,Ligue 1,2023,22.0,2001.0,11.6,26,20,16,8,2,16,25,64.0,9,20,4,16,8,34,18,0,DF,20-24,Defender,Greece,Europe
1308,Mikkel Kaufmann,DEN,Union Berlin,Bundesliga,2023,22.0,2001.0,5.4,6,3,2,3,1,3,10,30.0,7,12,0,12,1,7,4,0,FW,20-24,Forward,Denmark,Europe
1309,Michael Kayode,ITA,Fiorentina,Serie A,2023,19.0,2004.0,22.9,53,30,27,15,11,35,48,72.9,13,25,12,13,18,71,46,2,DF,Under 20,Defender,Italy,Europe
1310,Moise Kean,ITA,Juventus,Serie A,2023,23.0,2000.0,7.3,7,4,3,2,2,1,3,33.3,2,4,1,3,2,9,5,0,FW,20-24,Forward,Italy,Europe
1311,Michael Keane,ENG,Everton,Premier League,2023,30.0,1993.0,4.9,7,3,3,3,1,1,7,14.3,6,5,4,1,5,12,18,1,DF,30-34,Defender,England,Europe
1312,Ibrahima Kebe,MLI,Girona,La Liga,2023,22.0,2000.0,0.1,1,1,0,1,0,0,0,,0,1,0,1,1,2,0,0,MF,20-24,Midfielder,Mali,Africa
1313,Kévin Keben Biakolo,CMR,Toulouse,Ligue 1,2023,19.0,2004.0,5.8,4,2,4,0,0,3,6,50.0,3,7,0,7,8,12,17,0,DF,Under 20,Defender,Cameroon,Africa
1314,Yassine Kechta,MAR,Le Havre,Ligue 1,2023,21.0,2002.0,20.5,46,24,24,19,3,31,73,42.5,42,20,3,17,23,69,16,1,MF,20-24,Midfielder,Morocco,Africa
1315,Thilo Kehrer,GER,West Ham,Premier League,2023,26.0,1996.0,0.2,1,1,0,1,0,0,0,,0,2,2,0,0,1,0,0,"DF,MF",25-29,Defender,Germany,Europe
1316,Thilo Kehrer,GER,Monaco,Ligue 1,2023,26.0,1996.0,14.7,32,22,22,7,3,22,39,56.4,17,18,6,12,30,62,55,0,DF,25-29,Defender,Germany,Europe
1317,Habib Keita,MLI,Clermont Foot,Ligue 1,2023,21.0,2002.0,14.2,34,19,14,15,5,17,28,60.7,11,27,10,17,29,63,30,0,MF,20-24,Midfielder,Mali,Africa
1318,Naby Keïta,GUI,Werder Bremen,Bundesliga,2023,28.0,1995.0,1.2,1,1,1,0,0,0,1,0.0,1,2,0,2,2,3,1,0,"MF,DF",25-29,Midfielder,Guinea,Africa
1319,Yannik Keitel,GER,Freiburg,Bundesliga,2023,23.0,2000.0,10.2,20,15,14,5,1,10,15,66.7,5,17,8,9,12,32,44,3,"DF,MF",20-24,Defender,Germany,Europe
1320,Caoimhín Kelleher,IRL,Liverpool,Premier League,2023,24.0,1998.0,10.0,0,0,0,0,0,0,0,,0,0,0,0,0,0,4,1,GK,20-24,Goalkeeper,Republic of Ireland,Europe
1321,Thomas Keller,GER,Heidenheim,Bundesliga,2023,23.0,1999.0,0.0,0,0,0,0,0,0,0,,0,0,0,0,0,0,0,0,"MF,FW",20-24,Midfielder,Germany,Europe
1322,Lloyd Kelly,ENG,Bournemouth,Premier League,2023,24.0,1998.0,17.3,24,19,10,9,5,14,25,56.0,11,22,12,10,13,37,67,0,DF,20-24,Defender,England,Europe
1323,Omari Kellyman,ENG,Aston Villa,Premier League,2023,17.0,2005.0,0.4,1,0,0,1,0,1,2,50.0,1,0,0,0,0,1,0,0,FW,Under 20,Forward,England,Europe
1324,Aljoscha Kemlein,GER,Union Berlin,Bundesliga,2023,18.0,2004.0,0.3,0,0,0,0,0,0,3,0.0,3,1,0,1,0,0,0,0,MF,Under 20,Midfielder,Germany,Europe
1325,Tobias Kempe,GER,Darmstadt 98,Bundesliga,2023,34.0,1989.0,15.0,20,13,9,8,3,8,24,33.3,16,16,4,12,9,29,12,0,MF,30-34,Midfielder,Germany,Europe
1326,Milos Kerkez,HUN,Bournemouth,Premier League,2023,19.0,2003.0,21.9,47,26,31,13,3,30,42,71.4,12,31,11,20,20,67,60,2,DF,Under 20,Defender,Hungary,Europe
1327,Kaine Kesler-Hayden,ENG,Aston Villa,Premier League,2023,20.0,2002.0,0.1,0,0,0,0,0,0,0,,0,0,0,0,0,0,0,0,"MF,DF",20-24,Midfielder,England,Europe
1328,Reda Khadra,GER,Reims,Ligue 1,2023,22.0,2001.0,15.2,16,10,5,4,7,8,20,40.0,12,8,2,6,3,19,13,0,"FW,MF",20-24,Forward,Germany,Europe
1329,Wahbi Khazri,TUN,Montpellier,Ligue 1,2023,32.0,1991.0,12.6,24,17,8,12,4,14,35,40.0,21,10,0,10,3,27,7,0,FW,30-34,Forward,Tunisia,Africa
1330,Rani Khedira,GER,Union Berlin,Bundesliga,2023,29.0,1994.0,14.9,35,22,15,19,1,17,26,65.4,9,12,5,7,22,57,38,0,MF,25-29,Midfielder,Germany,Europe
1331,Abdukodir Khusanov,UZB,Lens,Ligue 1,2023,19.0,2004.0,9.0,21,12,13,8,0,9,17,52.9,8,13,8,5,13,34,32,2,DF,Under 20,Defender,Uzbekistan,Asia
1333,Luca Kilian,GER,Köln,Bundesliga,2023,23.0,1999.0,7.1,16,9,15,1,0,9,14,64.3,5,12,5,7,7,23,28,0,DF,20-24,Defender,Germany,Europe
1334,Max Kilman,ENG,Wolves,Premier League,2023,26.0,1997.0,38.0,47,21,40,6,1,24,32,75.0,8,64,37,27,39,86,182,4,DF,25-29,Defender,England,Europe
1335,Joshua Kimmich,GER,Bayern Munich,Bundesliga,2023,28.0,1995.0,24.2,45,33,25,15,5,26,39,66.7,13,32,4,28,14,59,28,1,"MF,DF",25-29,Midfielder,Germany,Europe
1337,Simon Kjær,DEN,Milan,Serie A,2023,34.0,1989.0,13.0,24,15,11,11,2,14,22,63.6,8,22,16,6,14,38,46,2,DF,30-34,Defender,Denmark,Europe
1338,Davy Klaassen,NED,Inter,Serie A,2023,30.0,1993.0,2.3,4,2,0,4,0,1,3,33.3,2,5,1,4,3,7,4,0,MF,30-34,Midfielder,Netherlands,Europe
1339,Christoph Klarer,AUT,Darmstadt 98,Bundesliga,2023,23.0,2000.0,26.2,37,22,30,4,3,24,36,66.7,12,31,20,11,21,58,94,1,DF,20-24,Defender,Austria,Europe
1340,Tim Kleindienst,GER,Heidenheim,Bundesliga,2023,27.0,1995.0,31.9,21,12,6,11,4,7,25,28.0,18,32,8,24,12,33,58,0,FW,25-29,Forward,Germany,Europe
1341,Lukas Klostermann,GER,RB Leipzig,Bundesliga,2023,27.0,1996.0,16.0,15,10,7,7,1,4,13,30.8,9,25,12,13,13,28,64,1,DF,25-29,Defender,Germany,Europe
1342,Justin Kluivert,NED,Bournemouth,Premier League,2023,24.0,1999.0,21.3,28,14,5,12,11,8,30,26.7,22,16,1,15,8,36,11,0,"MF,FW",20-24,Midfielder,Netherlands,Europe
1343,Ansgar Knauff,GER,Eint Frankfurt,Bundesliga,2023,21.0,2002.0,23.4,43,26,17,16,10,17,31,54.8,14,40,3,37,20,63,15,0,"MF,DF",20-24,Midfielder,Germany,Europe
1344,Robin Knoche,GER,Union Berlin,Bundesliga,2023,31.0,1992.0,21.3,34,22,27,7,0,19,30,63.3,11,27,19,8,13,47,73,0,DF,30-34,Defender,Germany,Europe
1345,Gregor Kobel,SUI,Dortmund,Bundesliga,2023,25.0,1997.0,26.3,0,0,0,0,0,0,1,0.0,1,0,0,0,0,0,11,0,GK,25-29,Goalkeeper,Switzerland,Europe
1346,Robin Koch,GER,Eint Frankfurt,Bundesliga,2023,27.0,1996.0,30.4,38,23,26,12,0,17,27,63.0,10,33,24,9,32,70,136,2,DF,25-29,Defender,Germany,Europe
1347,Philipp Köhn,SUI,Monaco,Ligue 1,2023,25.0,1998.0,22.0,1,1,1,0,0,1,1,100.0,0,0,0,0,1,2,5,3,GK,25-29,Goalkeeper,Switzerland,Europe
1348,Dominik Kohr,GER,Mainz 05,Bundesliga,2023,29.0,1994.0,24.3,65,42,36,25,4,36,57,63.2,21,27,6,21,43,108,58,0,"DF,MF",25-29,Defender,Germany,Europe
1350,Sead Kolašinac,BIH,Atalanta,Serie A,2023,30.0,1993.0,24.2,44,32,23,19,2,30,49,61.2,19,22,9,13,21,65,47,0,DF,30-34,Defender,Bosnia and Herzegovina,Europe
1351,Luca Koleosho,ITA,Burnley,Premier League,2023,18.0,2004.0,10.8,7,4,2,5,0,2,10,20.0,8,13,0,13,2,9,0,0,"MF,FW",Under 20,Midfielder,Italy,Europe
1352,Randal Kolo Muani,FRA,Paris S-G,Ligue 1,2023,24.0,1998.0,14.1,10,8,5,3,2,5,13,38.5,8,5,0,5,4,14,10,0,"FW,MF",20-24,Forward,France,Europe
1353,Randal Kolo Muani,FRA,Eint Frankfurt,Bundesliga,2023,24.0,1998.0,1.7,0,0,0,0,0,0,0,,0,0,0,0,0,0,1,0,FW,20-24,Forward,France,Europe
1354,Mert Kömür,GER,Augsburg,Bundesliga,2023,18.0,2005.0,1.3,3,3,3,0,0,3,5,60.0,2,0,0,0,0,3,1,0,"MF,DF",Under 20,Midfielder,Germany,Europe
1355,Cheick Konaté,MLI,Clermont Foot,Ligue 1,2023,19.0,2004.0,11.9,26,15,17,9,0,20,36,55.6,16,16,2,14,13,39,21,0,DF,Under 20,Defender,Mali,Africa
1356,Ibrahima Konaté,FRA,Liverpool,Premier League,2023,24.0,1999.0,17.5,36,22,22,13,1,18,24,75.0,6,18,12,6,20,56,51,1,DF,20-24,Defender,France,Europe
1357,Geoffrey Kondogbia,CTA,Marseille,Ligue 1,2023,30.0,1993.0,16.3,48,31,18,25,5,13,32,40.6,19,21,4,17,30,78,25,0,MF,30-34,Midfielder,Central African Republic,Africa
1358,Abdoul Koné,FRA,Reims,Ligue 1,2023,18.0,2005.0,2.1,7,7,5,2,0,4,11,36.4,7,2,0,2,2,9,9,0,DF,Under 20,Defender,France,Europe
1359,Amadou Koné,MLI,Reims,Ligue 1,2023,18.0,2005.0,5.3,13,8,11,2,0,6,10,60.0,4,8,3,5,10,23,10,0,MF,Under 20,Midfielder,Mali,Africa
1360,Ibrahima Koné,MLI,Almería,La Liga,2023,24.0,1999.0,3.1,1,0,1,0,0,1,1,100.0,0,1,0,1,0,1,4,0,FW,20-24,Forward,Mali,Africa
1361,Ibrahima Koné,MLI,Lorient,Ligue 1,2023,24.0,1999.0,0.4,0,0,0,0,0,0,1,0.0,1,0,0,0,0,0,0,0,FW,20-24,Forward,Mali,Africa
1362,Manu Koné,FRA,Gladbach,Bundesliga,2023,22.0,2001.0,17.3,45,26,20,20,5,17,25,68.0,8,22,1,21,15,60,16,1,MF,20-24,Midfielder,France,Europe
1363,Ezri Konsa,ENG,Aston Villa,Premier League,2023,25.0,1997.0,34.1,54,32,28,23,3,23,27,85.2,4,36,20,16,28,82,73,3,DF,25-29,Defender,England,Europe
1364,Teun Koopmeiners,NED,Atalanta,Serie A,2023,25.0,1998.0,29.2,39,24,12,22,5,17,50,34.0,33,33,3,30,10,49,35,0,MF,25-29,Midfielder,Netherlands,Europe
1365,Odilon Kossounou,CIV,Leverkusen,Bundesliga,2023,22.0,2001.0,20.1,30,20,11,12,7,15,26,57.7,11,27,3,24,27,57,43,1,DF,20-24,Defender,Ivory Coast,Africa
1367,N'Guessan Kouadio,CIV,Metz,Ligue 1,2023,20.0,2003.0,1.2,3,1,0,3,0,0,3,0.0,3,3,0,3,1,4,0,0,"MF,FW",20-24,Midfielder,Ivory Coast,Africa
1368,Christian Kouamé,CIV,Fiorentina,Serie A,2023,25.0,1997.0,12.1,13,4,7,6,0,6,10,60.0,4,16,0,16,2,15,10,0,FW,25-29,Forward,Ivory Coast,Africa
1369,Rominigue Kouamé,MLI,Cádiz,La Liga,2023,26.0,1996.0,9.1,14,9,6,7,1,7,15,46.7,8,10,2,8,13,27,10,1,MF,25-29,Midfielder,Mali,Africa
1370,Koffi Kouao,CIV,Metz,Ligue 1,2023,25.0,1998.0,9.6,20,13,12,7,1,11,17,64.7,6,9,6,3,13,33,38,1,DF,25-29,Defender,Ivory Coast,Africa
1372,Therence Koudou,FRA,Reims,Ligue 1,2023,18.0,2004.0,3.5,2,2,1,1,0,0,2,0.0,2,4,3,1,4,6,9,0,DF,Under 20,Defender,France,Europe
1373,Jules Koundé,FRA,Barcelona,La Liga,2023,24.0,1998.0,32.2,37,23,22,10,5,28,51,54.9,23,32,12,20,25,62,83,5,DF,20-24,Defender,France,Europe
1374,Boubakar Kouyaté,MLI,Montpellier,Ligue 1,2023,26.0,1997.0,21.4,49,30,39,8,2,28,51,54.9,23,31,20,11,29,78,123,1,DF,25-29,Defender,Mali,Africa
1375,Cheikhou Kouyaté,SEN,Nott'ham Forest,Premier League,2023,33.0,1989.0,2.4,8,5,3,3,2,1,4,25.0,3,4,1,3,2,10,10,0,MF,30-34,Midfielder,Senegal,Africa
1376,Mateo Kovačić,CRO,Manchester City,Premier League,2023,29.0,1994.0,17.2,36,25,16,15,5,18,28,64.3,10,23,1,22,10,46,10,0,MF,25-29,Midfielder,Croatia,Europe
1377,Viktor Kovalenko,UKR,Empoli,Serie A,2023,27.0,1996.0,6.8,5,2,2,2,1,2,8,25.0,6,12,2,10,1,6,7,0,MF,25-29,Midfielder,Ukraine,Europe
1380,Emil Krafth,SWE,Newcastle Utd,Premier League,2023,28.0,1994.0,10.1,21,14,10,7,4,12,25,48.0,13,8,3,5,9,30,21,0,DF,25-29,Defender,Sweden,Europe
1382,Andrej Kramarić,CRO,Hoffenheim,Bundesliga,2023,32.0,1991.0,24.4,11,2,5,4,2,6,13,46.2,7,14,2,12,10,21,12,2,"MF,FW",30-34,Midfielder,Croatia,Europe
1383,Christoph Kramer,GER,Gladbach,Bundesliga,2023,32.0,1991.0,2.8,10,5,5,5,0,2,14,14.3,12,7,1,6,4,14,6,0,MF,30-34,Midfielder,Germany,Europe
1384,Frans Krätzig,GER,Bayern Munich,Bundesliga,2023,20.0,2003.0,0.6,2,0,2,0,0,1,2,50.0,1,0,0,0,0,2,0,0,DF,20-24,Defender,Germany,Europe
1385,Tom Krauß,GER,Mainz 05,Bundesliga,2023,22.0,2001.0,15.0,57,33,22,31,4,21,58,36.2,37,33,4,29,17,74,28,0,MF,20-24,Midfielder,Germany,Europe
1386,Rasmus Kristensen,DEN,Roma,Serie A,2023,26.0,1997.0,19.4,36,19,25,8,3,28,50,56.0,22,27,7,20,8,44,50,0,DF,25-29,Defender,Denmark,Europe
1387,Thomas Kristensen,DEN,Udinese,Serie A,2023,21.0,2002.0,23.3,35,24,25,10,0,21,33,63.6,12,29,20,9,29,64,118,0,DF,20-24,Defender,Denmark,Europe
1387,Thomas Kristensen,DEN,Udinese,Serie A,2023,21.0,2002.0,23.3,35,24,25,10,0,21,33,63.6,12,29,20,9,29,64,118,0,DF,20-24,Defender,Denmark,Europe
1387,Thomas Kristensen,DEN,Udinese,Serie A,2023,21.0,2002.0,23.3,35,24,25,10,0,21,33,63.6,12,29,20,9,29,64,118,0,DF,20-24,Defender,Denmark,Europe
1387,Thomas Kristensen,DEN,Udinese,Serie A,2023,21.0,2002.0,23.3,35,24,25,10,0,21,33,63.6,12,29,20,9,29,64,118,0,DF,20-24,Defender,Denmark,Europe
1388,Toni Kroos,GER,Real Madrid,La Liga,2023,33.0,1990.0,23.6,53,34,19,25,9,24,59,40.7,35,22,4,18,17,70,11,1,MF,30-34,Midfielder,Germany,Europe
1389,Nikola Krstović,MNE,Lecce,Serie A,2023,23.0,2000.0,26.4,17,6,3,9,5,6,10,60.0,4,12,4,8,4,21,22,0,FW,20-24,Forward,Montenegro,Europe
1390,Rade Krunić,BIH,Milan,Serie A,2023,29.0,1993.0,7.6,10,8,3,6,1,4,9,44.4,5,7,3,4,11,21,14,0,MF,25-29,Midfielder,Bosnia and Herzegovina,Europe
1391,Lukas Kübler,GER,Freiburg,Bundesliga,2023,30.0,1992.0,20.5,50,24,35,13,2,26,42,61.9,16,36,14,22,37,87,57,1,DF,30-34,Defender,Germany,Europe
1392,Takefusa Kubo,JPN,Real Sociedad,La Liga,2023,22.0,2001.0,23.9,26,17,15,6,5,9,23,39.1,14,21,2,19,11,37,8,1,"FW,MF",20-24,Forward,Japan,Asia
1394,Mohammed Kudus,GHA,West Ham,Premier League,2023,22.0,2000.0,27.6,65,47,27,27,11,20,40,50.0,20,25,0,25,11,76,9,1,"FW,MF",20-24,Forward,Ghana,Africa
1395,Christian Kühlwetter,GER,Heidenheim,Bundesliga,2023,27.0,1996.0,0.1,0,0,0,0,0,0,0,,0,0,0,0,0,0,0,0,MF,25-29,Midfielder,Germany,Europe
1396,Dejan Kulusevski,SWE,Tottenham,Premier League,2023,23.0,2000.0,30.7,62,33,19,20,23,25,67,37.3,42,24,1,23,18,80,2,1,"FW,MF",20-24,Forward,Sweden,Europe
1397,Sael Kumbedi,FRA,Lyon,Ligue 1,2023,18.0,2005.0,10.3,30,20,14,12,4,9,22,40.9,13,12,3,9,14,44,18,2,DF,Under 20,Defender,France,Europe
1398,Marash Kumbulla,ALB,Sassuolo,Serie A,2023,23.0,2000.0,4.0,3,2,2,1,0,1,2,50.0,1,8,6,2,0,3,22,0,DF,20-24,Defender,Albania,Europe
1399,Justin Kumi,ITA,Sassuolo,Serie A,2023,19.0,2004.0,0.0,0,0,0,0,0,0,0,,0,0,0,0,0,0,0,0,FW,Under 20,Forward,Italy,Europe
1400,Layvin Kurzawa,FRA,Paris S-G,Ligue 1,2023,30.0,1992.0,0.1,0,0,0,0,0,0,0,,0,0,0,0,0,0,0,0,DF,30-34,Defender,France,Europe
1401,Berkan Kutlu,TUR,Genoa,Serie A,2023,25.0,1998.0,2.2,6,4,5,1,0,3,6,50.0,3,3,0,3,4,10,5,0,MF,25-29,Midfielder,Turkey,Asia
1402,Daler Kuzyaev,RUS,Le Havre,Ligue 1,2023,30.0,1993.0,23.2,34,19,11,13,10,15,43,34.9,28,18,5,13,22,56,18,1,MF,30-34,Midfielder,Russia,Europe
1403,Khvicha Kvaratskhelia,GEO,Napoli,Serie A,2023,22.0,2001.0,30.4,42,21,11,19,12,15,49,30.6,34,15,1,14,13,55,9,0,FW,20-24,Forward,Georgia,Asia
1404,Giorgi Kvernadze,GEO,Frosinone,Serie A,2023,20.0,2003.0,0.7,3,0,2,0,1,2,2,100.0,0,1,0,1,1,4,0,0,"FW,DF",20-24,Forward,Georgia,Asia
1405,Moritz-Broni Kwarteng,GHA,Bochum,Bundesliga,2023,25.0,1998.0,3.1,3,0,0,3,0,1,7,14.3,6,4,0,4,2,5,0,0,FW,25-29,Forward,Ghana,Africa
1406,Grejohn Kyei,FRA,Clermont Foot,Ligue 1,2023,27.0,1995.0,11.4,6,4,2,2,2,2,3,66.7,1,5,1,4,1,7,10,0,FW,25-29,Forward,France,Europe
1407,Giorgos Kyriakopoulos,GRE,Monza,Serie A,2023,27.0,1996.0,19.0,19,10,16,3,0,11,24,45.8,13,18,1,17,13,32,28,0,DF,25-29,Defender,Greece,Europe
1408,Luca de la Torre,USA,Celta Vigo,La Liga,2023,25.0,1998.0,21.7,39,21,12,22,5,22,43,51.2,21,23,4,19,12,51,17,0,MF,25-29,Midfielder,United States,North America
1409,Gaëtan Laborde,FRA,Nice,Ligue 1,2023,29.0,1994.0,21.2,18,12,8,4,6,11,30,36.7,19,20,2,18,6,24,8,1,"FW,MF",25-29,Forward,France,Europe
1410,Alexandre Lacazette,FRA,Lyon,Ligue 1,2023,32.0,1991.0,25.5,19,12,8,9,2,5,17,29.4,12,22,3,19,8,27,9,0,FW,30-34,Forward,France,Europe
1411,Maxence Lacroix,FRA,Wolfsburg,Bundesliga,2023,23.0,2000.0,26.2,48,29,28,18,2,29,41,70.7,12,35,12,23,24,72,121,0,DF,20-24,Defender,France,Europe
1412,Alban Lafont,FRA,Nantes,Ligue 1,2023,24.0,1999.0,27.7,0,0,0,0,0,0,2,0.0,2,0,0,0,0,0,14,0,GK,20-24,Goalkeeper,France,Europe
1414,Aïssa Laïdouni,TUN,Union Berlin,Bundesliga,2023,26.0,1996.0,11.9,21,12,4,12,5,4,12,33.3,8,26,2,24,12,33,14,2,MF,25-29,Midfielder,Tunisia,Africa
1415,Konrad Laimer,AUT,Bayern Munich,Bundesliga,2023,26.0,1997.0,19.7,56,36,25,20,11,22,52,42.3,30,42,6,36,18,74,13,2,"DF,MF",25-29,Defender,Austria,Europe
1416,Stefan Lainer,AUT,Gladbach,Bundesliga,2023,30.0,1992.0,8.3,23,16,15,8,0,14,24,58.3,10,13,6,7,5,28,28,0,"DF,MF",30-34,Defender,Austria,Europe
1417,Kenny Lala,MAD,Brest,Ligue 1,2023,31.0,1991.0,33.0,78,51,39,28,11,30,56,53.6,26,27,6,21,28,106,75,1,DF,30-34,Defender,Madagascar,Africa
1418,Adam Lallana,ENG,Brighton,Premier League,2023,35.0,1988.0,9.4,8,3,4,4,0,0,4,0.0,4,2,1,1,3,11,1,0,"MF,FW",35-39,Midfielder,England,Europe
1419,Mathis Lambourde,FRA,Rennes,Ligue 1,2023,17.0,2006.0,0.1,0,0,0,0,0,0,1,0.0,1,1,0,1,0,0,1,0,FW,Under 20,Forward,France,Europe
1420,Érik Lamela,ARG,Sevilla,La Liga,2023,31.0,1992.0,5.1,21,14,4,10,7,10,15,66.7,5,12,0,12,1,22,5,0,"FW,MF",30-34,Forward,Argentina,South America
1421,Mohamed Lamine Bayo,GUI,Le Havre,Ligue 1,2023,25.0,1998.0,15.4,13,5,2,5,6,2,10,20.0,8,8,1,7,2,15,11,0,FW,25-29,Forward,Guinea,Africa
1422,Didier Lamkel Zé,CMR,Metz,Ligue 1,2023,26.0,1996.0,6.1,7,2,2,4,1,2,5,40.0,3,4,0,4,0,7,11,0,"FW,MF",25-29,Forward,Cameroon,Africa
1423,Tariq Lamptey,GHA,Brighton,Premier League,2023,22.0,2000.0,10.2,21,14,14,5,2,13,22,59.1,9,7,3,4,6,27,6,0,"DF,FW",20-24,Defender,Ghana,Africa
1424,Bruno Langa,MOZ,Almería,La Liga,2023,25.0,1997.0,9.1,17,12,10,5,2,6,14,42.9,8,11,4,7,4,21,33,2,DF,25-29,Defender,Mozambique,Africa
1425,Gianluca Lapadula,PER,Cagliari,Serie A,2023,33.0,1990.0,13.4,1,1,0,0,1,1,10,10.0,9,2,1,1,2,3,5,0,FW,30-34,Forward,Peru,South America
1427,Julien Laporte,FRA,Lorient,Ligue 1,2023,29.0,1993.0,20.2,23,14,15,7,1,16,36,44.4,20,36,26,10,11,34,116,1,DF,25-29,Defender,France,Europe
1428,Cyle Larin,CAN,Mallorca,La Liga,2023,28.0,1995.0,20.3,17,8,6,4,7,2,7,28.6,5,16,5,11,3,20,17,0,FW,25-29,Forward,Canada,North America
1429,Yasser Larouci,ALG,Sheffield Utd,Premier League,2023,22.0,2001.0,5.9,17,9,10,5,2,10,14,71.4,4,6,1,5,7,24,20,1,DF,20-24,Defender,Algeria,Africa
1430,Hugo Larsson,SWE,Eint Frankfurt,Bundesliga,2023,19.0,2004.0,21.0,32,18,18,10,4,15,28,53.6,13,34,7,27,29,61,30,1,MF,Under 20,Midfielder,Sweden,Europe
1431,Jamaal Lascelles,ENG,Newcastle Utd,Premier League,2023,29.0,1993.0,12.0,14,9,7,7,0,6,11,54.5,5,17,12,5,5,19,42,0,DF,25-29,Defender,England,Europe
1434,Armand Lauriente,FRA,Sassuolo,Serie A,2023,24.0,1998.0,32.3,31,20,8,14,9,13,44,29.5,31,29,4,25,15,46,11,0,FW,20-24,Forward,France,Europe
1435,Roméo Lavia,BEL,Chelsea,Premier League,2023,19.0,2004.0,0.4,1,0,0,1,0,0,0,,0,0,0,0,0,1,1,0,MF,Under 20,Midfielder,Belgium,Europe
1436,Lázaro,BRA,Almería,La Liga,2023,21.0,2002.0,3.2,4,1,2,0,2,2,8,25.0,6,4,0,4,1,5,1,0,"FW,MF",20-24,Forward,Brazil,South America
1437,Valentino Lazaro,AUT,Torino,Serie A,2023,27.0,1996.0,22.2,18,11,7,9,2,13,19,68.4,6,14,1,13,8,26,29,0,"DF,MF",25-29,Defender,Austria,Europe
1439,Manuel Lazzari,ITA,Lazio,Serie A,2023,29.0,1993.0,18.6,26,18,13,10,3,18,28,64.3,10,20,4,16,12,38,37,1,DF,25-29,Defender,Italy,Europe
1440,Théo Le Bris,FRA,Lorient,Ligue 1,2023,20.0,2002.0,16.8,35,22,25,7,3,19,40,47.5,21,24,3,21,12,47,42,0,"DF,MF",20-24,Defender,France,Europe
1441,Julien Le Cardinal,FRA,Brest,Ligue 1,2023,25.0,1997.0,5.3,19,11,11,7,1,8,12,66.7,4,6,3,3,13,32,26,0,DF,25-29,Defender,France,Europe
1442,Julien Le Cardinal,FRA,Lens,Ligue 1,2023,25.0,1997.0,0.6,6,2,4,2,0,4,9,44.4,5,2,1,1,0,6,0,0,DF,25-29,Defender,France,Europe
1443,Jérémy Le Douaron,FRA,Brest,Ligue 1,2023,25.0,1998.0,18.0,21,10,7,9,5,11,26,42.3,15,14,1,13,2,23,10,0,FW,25-29,Forward,France,Europe
1444,Enzo Le Fée,FRA,Rennes,Ligue 1,2023,23.0,2000.0,17.0,50,35,23,17,10,23,47,48.9,24,17,3,14,19,69,20,0,MF,20-24,Midfielder,France,Europe
1445,Vincent Le Goff,FRA,Lorient,Ligue 1,2023,33.0,1989.0,6.0,5,0,4,0,1,4,8,50.0,4,11,3,8,3,8,10,0,"DF,MF",30-34,Defender,France,Europe
1447,Nicola Leali,ITA,Genoa,Serie A,2023,30.0,1993.0,2.0,0,0,0,0,0,0,0,,0,0,0,0,0,0,0,0,GK,30-34,Goalkeeper,Italy,Europe
1448,Rafael Leão,POR,Milan,Serie A,2023,24.0,1999.0,27.9,16,10,3,8,5,8,13,61.5,5,15,1,14,9,25,19,0,FW,20-24,Forward,Portugal,Europe
1449,Adrien Lebeau,FRA,Brest,Ligue 1,2023,24.0,1999.0,0.6,0,0,0,0,0,0,3,0.0,3,2,1,1,0,0,1,0,"MF,FW",20-24,Midfielder,France,Europe
1450,Jean-Louis Leca,FRA,Lens,Ligue 1,2023,37.0,1985.0,1.0,0,0,0,0,0,0,0,,0,0,0,0,0,0,1,0,GK,35-39,Goalkeeper,France,Europe
1451,Benjamin Lecomte,FRA,Montpellier,Ligue 1,2023,32.0,1991.0,30.0,0,0,0,0,0,0,1,0.0,1,0,0,0,0,0,16,1,GK,30-34,Goalkeeper,France,Europe
1452,Jeremías Ledesma,ARG,Cádiz,La Liga,2023,30.0,1993.0,33.9,1,1,1,0,0,1,4,25.0,3,0,0,0,0,1,15,3,GK,30-34,Goalkeeper,Argentina,South America
1453,Pierre Lees-Melou,FRA,Brest,Ligue 1,2023,30.0,1993.0,28.0,96,67,51,41,4,49,129,38.0,80,61,11,50,43,139,64,3,MF,30-34,Midfielder,France,Europe
1454,Diogo Leite,POR,Union Berlin,Bundesliga,2023,24.0,1999.0,30.0,52,36,31,15,6,25,51,49.0,26,48,22,26,47,99,155,1,DF,20-24,Defender,Portugal,Europe
1455,Maxim Leitsch,GER,Mainz 05,Bundesliga,2023,25.0,1998.0,4.2,6,3,5,1,0,3,6,50.0,3,2,0,2,4,10,13,0,DF,25-29,Defender,Germany,Europe
1456,Florian Lejeune,FRA,Rayo Vallecano,La Liga,2023,32.0,1991.0,37.0,39,25,26,11,2,19,30,63.3,11,33,18,15,23,62,155,1,DF,30-34,Defender,France,Europe
1459,Thomas Lemar,FRA,Atlético Madrid,La Liga,2023,27.0,1995.0,1.8,3,1,2,1,0,1,2,50.0,1,0,0,0,0,3,0,0,MF,25-29,Midfielder,France,Europe
1460,Mario Lemina,GAB,Wolves,Premier League,2023,29.0,1993.0,33.0,90,58,46,33,11,25,47,53.2,22,36,9,27,41,131,64,0,MF,25-29,Midfielder,Gabon,Africa
1463,Clément Lenglet,FRA,Aston Villa,Premier League,2023,28.0,1995.0,12.8,13,9,7,5,1,7,13,53.8,6,19,11,8,7,20,47,1,DF,25-29,Defender,France,Europe
1464,Bernd Leno,GER,Fulham,Premier League,2023,31.0,1992.0,38.0,0,0,0,0,0,0,0,,0,0,0,0,0,0,14,1,GK,30-34,Goalkeeper,Germany,Europe
1465,Christopher Lenz,GER,RB Leipzig,Bundesliga,2023,28.0,1994.0,0.5,2,1,2,0,0,1,1,100.0,0,0,0,0,2,4,2,0,"DF,MF",25-29,Defender,Germany,Europe
1466,Christopher Lenz,GER,Eint Frankfurt,Bundesliga,2023,28.0,1994.0,0.1,1,1,0,1,0,1,1,100.0,0,0,0,0,0,1,1,0,DF,25-29,Defender,Germany,Europe
1467,Johann Lepenant,FRA,Lyon,Ligue 1,2023,20.0,2002.0,2.8,4,3,2,2,0,1,8,12.5,7,5,0,5,4,8,0,0,MF,20-24,Midfielder,France,Europe
1468,Jefferson Lerma,COL,Crystal Palace,Premier League,2023,28.0,1994.0,26.7,42,25,15,23,4,19,40,47.5,21,31,12,19,36,78,72,0,"MF,DF",25-29,Midfielder,Colombia,South America
1469,Léo Leroy,FRA,Montpellier,Ligue 1,2023,23.0,2000.0,5.5,19,10,8,8,3,6,21,28.6,15,12,3,9,7,26,8,0,MF,20-24,Midfielder,France,Europe
1471,Jamie Leweling,GER,Stuttgart,Bundesliga,2023,22.0,2001.0,16.9,18,10,4,6,8,5,17,29.4,12,21,1,20,5,23,13,0,"FW,MF",20-24,Forward,Germany,Europe
1472,Rico Lewis,ENG,Manchester City,Premier League,2023,18.0,2004.0,9.0,10,7,4,4,2,3,7,42.9,4,7,1,6,4,14,6,0,"DF,MF",Under 20,Defender,England,Europe
1473,Keane Lewis-Potter,ENG,Brentford,Premier League,2023,22.0,2001.0,16.0,17,7,5,11,1,7,15,46.7,8,10,2,8,7,24,23,0,"FW,DF",20-24,Forward,England,Europe
1474,Philipp Lienhart,AUT,Freiburg,Bundesliga,2023,27.0,1996.0,14.1,20,13,14,5,1,13,23,56.5,10,18,11,7,14,34,51,0,DF,25-29,Defender,Austria,Europe
1475,Matthijs de Ligt,NED,Bayern Munich,Bundesliga,2023,23.0,1999.0,15.4,15,12,4,8,3,6,11,54.5,5,14,10,4,19,34,52,0,DF,20-24,Defender,Netherlands,Europe
1476,Victor Lindelöf,SWE,Manchester Utd,Premier League,2023,29.0,1994.0,14.8,15,10,8,7,0,5,13,38.5,8,18,9,9,12,27,40,1,DF,25-29,Defender,Sweden,Europe
1477,Jesper Lindstrøm,DEN,Napoli,Serie A,2023,23.0,2000.0,4.8,8,3,2,3,3,4,8,50.0,4,3,0,3,2,10,6,0,"FW,MF",20-24,Forward,Denmark,Europe
1478,Jesper Lindstrøm,DEN,Eint Frankfurt,Bundesliga,2023,23.0,2000.0,0.9,1,1,1,0,0,0,0,,0,0,0,0,0,1,0,0,FW,20-24,Forward,Denmark,Europe
1480,Samuel Lino,BRA,Atlético Madrid,La Liga,2023,23.0,1999.0,23.1,61,34,32,17,12,35,70,50.0,35,37,1,36,14,75,27,0,"DF,MF",20-24,Defender,Brazil,South America
1481,Luca Lipani,ITA,Sassuolo,Serie A,2023,18.0,2005.0,4.3,9,7,4,3,2,3,11,27.3,8,9,2,7,6,15,7,0,MF,Under 20,Midfielder,Italy,Europe
1484,Valentino Livramento,ENG,Newcastle Utd,Premier League,2023,20.0,2002.0,14.6,23,13,15,6,2,10,21,47.6,11,16,7,9,25,48,41,1,DF,20-24,Defender,England,Europe
1485,Dejan Ljubicic,AUT,Köln,Bundesliga,2023,25.0,1997.0,22.8,43,27,20,18,5,20,43,46.5,23,22,2,20,18,61,11,0,"MF,FW",25-29,Midfielder,Austria,Europe
1489,Gautier Lloris,FRA,Le Havre,Ligue 1,2023,28.0,1995.0,30.9,50,28,40,9,1,28,42,66.7,14,50,30,20,32,82,142,1,DF,25-29,Defender,France,Europe
1490,Abou Lô,SEN,Metz,Ligue 1,2023,23.0,2000.0,2.2,3,1,2,1,0,1,4,25.0,3,5,2,3,4,7,8,0,"MF,DF",20-24,Midfielder,Senegal,Africa
1491,Giovani Lo Celso,ARG,Tottenham,Premier League,2023,27.0,1996.0,5.6,22,13,10,8,4,9,14,64.3,5,4,1,3,5,27,2,0,MF,25-29,Midfielder,Argentina,South America
1492,Stanislav Lobotka,SVK,Napoli,Serie A,2023,28.0,1994.0,36.5,61,39,18,30,13,24,60,40.0,36,30,8,22,30,91,29,0,MF,25-29,Midfielder,Slovakia,Europe
1493,Manuel Locatelli,ITA,Juventus,Serie A,2023,25.0,1998.0,33.4,69,43,24,35,10,31,58,53.4,27,43,17,26,25,94,65,0,MF,25-29,Midfielder,Italy,Europe
1494,Bradley Locko,FRA,Brest,Ligue 1,2023,21.0,2002.0,32.9,97,55,57,34,6,47,80,58.8,33,28,1,27,40,137,69,0,DF,20-24,Defender,France,Europe
1495,Tom Lockyer,WAL,Luton Town,Premier League,2023,28.0,1994.0,13.0,25,16,17,6,2,15,22,68.2,7,23,13,10,23,48,68,0,DF,25-29,Defender,Wales,Europe
1496,Renan Lodi,BRA,Marseille,Ligue 1,2023,25.0,1998.0,13.7,24,16,8,13,3,13,21,61.9,8,7,2,5,16,40,35,0,DF,25-29,Defender,Brazil,South America
1497,Ruben Loftus-Cheek,ENG,Milan,Serie A,2023,27.0,1996.0,23.0,28,18,7,14,7,15,27,55.6,12,24,12,12,9,37,10,1,MF,25-29,Midfielder,England,Europe
1498,Andy Logbo,FRA,Le Havre,Ligue 1,2023,19.0,2004.0,2.8,0,0,0,0,0,0,3,0.0,3,7,3,4,0,0,2,0,FW,Under 20,Forward,France,Europe
1499,Enzo Loiodice,FRA,Las Palmas,La Liga,2023,22.0,2000.0,19.9,62,35,15,34,13,20,42,47.6,22,20,2,18,12,74,16,1,MF,20-24,Midfielder,France,Europe
1500,Sean Longstaff,ENG,Newcastle Utd,Premier League,2023,25.0,1997.0,30.5,54,30,17,29,8,24,63,38.1,39,43,7,36,17,71,23,0,MF,25-29,Midfielder,England,Europe
1501,Ademola Lookman,NGA,Atalanta,Serie A,2023,25.0,1997.0,21.0,20,15,2,11,7,8,22,36.4,14,19,0,19,9,29,0,1,"FW,MF",25-29,Forward,Nigeria,Africa
1502,Noah Loosli,SUI,Bochum,Bundesliga,2023,26.0,1997.0,3.8,10,7,6,4,0,7,14,50.0,7,7,1,6,7,17,18,0,DF,25-29,Defender,Switzerland,Europe
1503,Anthony Lopes,POR,Lyon,Ligue 1,2023,32.0,1990.0,31.0,0,0,0,0,0,0,0,,0,0,0,0,0,0,16,0,GK,30-34,Goalkeeper,Portugal,Europe
1508,Maxime Lopez,FRA,Fiorentina,Serie A,2023,25.0,1997.0,8.9,18,9,5,10,3,6,12,50.0,6,3,1,2,7,25,6,0,MF,25-29,Midfielder,France,Europe
1509,Maxime Lopez,FRA,Sassuolo,Serie A,2023,25.0,1997.0,1.6,2,1,1,1,0,1,2,50.0,1,1,1,0,2,4,0,0,MF,25-29,Midfielder,France,Europe
1512,Dion Lopy,SEN,Almería,La Liga,2023,21.0,2002.0,21.3,62,37,36,20,6,17,44,38.6,27,23,5,18,15,77,22,2,MF,20-24,Midfielder,Senegal,Africa
1513,Anthony Losilla,FRA,Bochum,Bundesliga,2023,37.0,1986.0,28.6,63,37,15,40,8,23,51,45.1,28,37,8,29,25,88,51,0,MF,35-39,Midfielder,France,Europe
1514,Jordan Lotomba,SUI,Nice,Ligue 1,2023,24.0,1998.0,20.0,36,28,18,9,9,25,35,71.4,10,30,9,21,16,52,26,1,DF,20-24,Defender,Switzerland,Europe
1515,Tom Louchet,FRA,Nice,Ligue 1,2023,20.0,2003.0,4.5,14,5,6,6,2,7,11,63.6,4,7,3,4,3,17,9,0,"MF,DF",20-24,Midfielder,France,Europe
1516,Imran Louza,MAR,Lorient,Ligue 1,2023,24.0,1999.0,9.6,13,7,2,8,3,2,8,25.0,6,8,1,7,9,22,4,0,MF,20-24,Midfielder,Morocco,Africa
1517,Matteo Lovato,ITA,Torino,Serie A,2023,23.0,2000.0,6.0,10,7,5,5,0,4,5,80.0,1,9,5,4,13,23,10,0,DF,20-24,Defender,Italy,Europe
1518,Matteo Lovato,ITA,Salernitana,Serie A,2023,23.0,2000.0,10.5,27,14,17,8,2,16,24,66.7,8,14,7,7,18,45,41,1,DF,20-24,Defender,Italy,Europe
1519,Dejan Lovren,CRO,Lyon,Ligue 1,2023,34.0,1989.0,8.0,9,7,6,3,0,3,7,42.9,4,6,5,1,12,21,37,0,DF,30-34,Defender,Croatia,Europe
1521,Max Lowe,ENG,Sheffield Utd,Premier League,2023,26.0,1997.0,5.6,21,10,13,5,3,8,15,53.3,7,10,4,6,5,26,15,0,"DF,MF",25-29,Defender,England,Europe
1524,Lucas,BRA,Cádiz,La Liga,2023,22.0,2001.0,17.1,47,27,32,11,4,32,55,58.2,23,27,4,23,17,64,45,0,DF,20-24,Defender,Brazil,South America
1525,Lorenzo Lucca,ITA,Udinese,Serie A,2023,22.0,2000.0,28.8,19,11,4,11,4,5,20,25.0,15,18,3,15,3,22,36,1,FW,20-24,Forward,Italy,Europe
1526,Jhon Lucumí,COL,Bologna,Serie A,2023,25.0,1998.0,24.6,48,29,31,17,0,27,36,75.0,9,32,17,15,16,64,68,2,DF,25-29,Defender,Colombia,South America
1529,José Luis Palomino,ARG,Atalanta,Serie A,2023,33.0,1990.0,0.3,2,1,1,1,0,1,1,100.0,0,2,1,1,1,3,6,0,DF,30-34,Defender,Argentina,South America
1530,Douglas Luiz,BRA,Aston Villa,Premier League,2023,25.0,1998.0,33.3,58,38,21,27,10,25,53,47.2,28,32,8,24,23,81,18,2,MF,25-29,Midfielder,Brazil,South America
1531,Romelu Lukaku,BEL,Roma,Serie A,2023,30.0,1993.0,29.3,6,5,1,2,3,2,4,50.0,2,7,1,6,0,6,19,1,FW,30-34,Forward,Belgium,Europe
1532,Castello Lukeba,FRA,RB Leipzig,Bundesliga,2023,20.0,2002.0,24.3,19,12,10,9,0,10,12,83.3,2,35,13,22,12,31,94,2,DF,20-24,Defender,France,Europe
1533,Dodi Lukebakio,BEL,Sevilla,La Liga,2023,25.0,1997.0,12.5,5,2,2,2,1,1,6,16.7,5,9,2,7,2,7,5,0,"FW,MF",25-29,Forward,Belgium,Europe
1535,Karlo Lulić,CRO,Frosinone,Serie A,2023,27.0,1996.0,0.2,0,0,0,0,0,0,0,,0,1,0,1,1,1,0,0,MF,25-29,Midfielder,Croatia,Europe
1536,Andriy Lunin,UKR,Real Madrid,La Liga,2023,24.0,1999.0,21.0,0,0,0,0,0,0,1,0.0,1,0,0,0,0,0,15,1,GK,20-24,Goalkeeper,Ukraine,Europe
1537,Sebastiano Luperto,ITA,Empoli,Serie A,2023,26.0,1996.0,37.8,37,26,25,10,2,15,24,62.5,9,46,35,11,32,69,157,1,DF,25-29,Defender,Italy,Europe
1538,Mateus Lusuardi,BRA,Frosinone,Serie A,2023,19.0,2004.0,2.4,2,1,1,1,0,1,3,33.3,2,4,2,2,4,6,8,0,DF,Under 20,Defender,Brazil,South America
1539,Andreas Luthe,GER,Bochum,Bundesliga,2023,36.0,1987.0,1.0,0,0,0,0,0,0,0,,0,0,0,0,0,0,1,0,GK,35-39,Goalkeeper,Germany,Europe
1540,Zito Luvumbo,ANG,Cagliari,Serie A,2023,21.0,2002.0,21.6,9,6,5,2,2,4,15,26.7,11,19,0,19,1,10,2,0,"FW,MF",20-24,Forward,Angola,Africa
1541,Charalambos Lykogiannis,GRE,Bologna,Serie A,2023,29.0,1993.0,10.0,10,6,5,4,1,5,10,50.0,5,15,5,10,5,15,30,0,DF,25-29,Defender,Greece,Europe
1542,Senne Lynen,BEL,Werder Bremen,Bundesliga,2023,24.0,1999.0,20.0,64,38,33,27,4,30,70,42.9,40,41,8,33,41,105,56,0,MF,20-24,Midfielder,Belgium,Europe
1543,Joshua M'Bahia,CIV,Clermont Foot,Ligue 1,2023,18.0,2005.0,0.2,0,0,0,0,0,0,0,,0,0,0,0,0,0,0,0,MF,Under 20,Midfielder,Ivory Coast,Africa
1544,Othmane Maamma,MAR,Montpellier,Ligue 1,2023,17.0,2005.0,1.0,3,3,2,0,1,1,1,100.0,0,3,0,3,0,3,0,0,FW,Under 20,Forward,Morocco,Africa
1545,Ian Maatsen,NED,Chelsea,Premier League,2023,21.0,2002.0,2.3,3,2,1,1,1,0,4,0.0,4,4,0,4,3,6,10,0,"FW,MF",20-24,Forward,Netherlands,Europe
1546,Ian Maatsen,NED,Dortmund,Bundesliga,2023,21.0,2002.0,14.0,30,22,15,9,6,16,30,53.3,14,22,4,18,13,43,26,0,DF,20-24,Defender,Netherlands,Europe
1547,Alexis Mac Allister,ARG,Liverpool,Premier League,2023,24.0,1998.0,28.9,99,55,35,50,14,59,125,47.2,66,65,8,57,35,134,25,1,MF,20-24,Midfielder,Argentina,South America
1548,Deiver Machado,COL,Lens,Ligue 1,2023,29.0,1993.0,12.5,24,18,10,10,4,15,20,75.0,5,13,2,11,7,31,8,0,DF,25-29,Defender,Colombia,South America
1549,Darwin Machís,VEN,Cádiz,La Liga,2023,30.0,1993.0,8.7,23,14,7,9,7,13,24,54.2,11,8,1,7,4,27,2,0,MF,30-34,Midfielder,Venezuela,South America
1550,James Maddison,ENG,Tottenham,Premier League,2023,26.0,1996.0,23.7,33,19,5,18,10,15,29,51.7,14,15,3,12,13,46,10,1,MF,25-29,Midfielder,England,Europe
1551,Noni Madueke,ENG,Chelsea,Premier League,2023,21.0,2002.0,11.7,16,10,8,4,4,11,34,32.4,23,11,0,11,4,20,14,0,FW,20-24,Forward,England,Europe
1553,Gabriel Magalhães,BRA,Arsenal,Premier League,2023,25.0,1997.0,33.8,48,28,24,22,2,17,22,77.3,5,44,33,11,31,79,100,1,DF,25-29,Defender,Brazil,South America
1554,Soungoutou Magassa,FRA,Monaco,Ligue 1,2023,19.0,2003.0,15.0,56,26,22,32,2,26,48,54.2,22,21,4,17,21,77,36,2,"DF,MF",Under 20,Defender,France,Europe
1555,Giulio Maggiore,ITA,Salernitana,Serie A,2023,25.0,1998.0,20.0,49,29,26,22,1,20,42,47.6,22,27,5,22,24,73,38,0,MF,25-29,Midfielder,Italy,Europe
1556,Matej Maglica,CRO,Darmstadt 98,Bundesliga,2023,24.0,1998.0,18.9,35,21,25,10,0,22,36,61.1,14,29,11,18,22,57,92,5,DF,20-24,Defender,Croatia,Europe
1557,Giangiacomo Magnani,ITA,Hellas Verona,Serie A,2023,27.0,1995.0,27.2,33,18,23,10,0,15,25,60.0,10,50,28,22,45,78,118,0,DF,25-29,Defender,Italy,Europe
1558,Hugo Magnetti,FRA,Brest,Ligue 1,2023,25.0,1998.0,26.0,49,27,18,26,5,24,58,41.4,34,19,1,18,18,67,18,0,MF,25-29,Midfielder,France,Europe
1559,Yohann Magnin,FRA,Clermont Foot,Ligue 1,2023,26.0,1997.0,18.7,49,31,12,32,5,22,47,46.8,25,38,13,25,19,68,26,1,MF,25-29,Midfielder,France,Europe
1560,Frank Magri,CMR,Toulouse,Ligue 1,2023,23.0,1999.0,16.0,22,14,5,12,5,15,21,71.4,6,16,4,12,4,26,17,0,"FW,MF",20-24,Forward,Cameroon,Africa
1561,Harry Maguire,ENG,Manchester Utd,Premier League,2023,30.0,1993.0,18.4,24,17,14,10,0,12,22,54.5,10,33,24,9,25,49,83,1,DF,30-34,Defender,England,Europe
1564,Arne Maier,GER,Augsburg,Bundesliga,2023,24.0,1999.0,11.1,14,9,5,8,1,5,14,35.7,9,19,2,17,6,20,11,0,MF,20-24,Midfielder,Germany,Europe
1565,Habib Maïga,CIV,Metz,Ligue 1,2023,27.0,1996.0,1.6,2,2,1,0,1,1,3,33.3,2,2,0,2,4,6,2,0,"MF,FW",25-29,Midfielder,Ivory Coast,Africa
1566,Mike Maignan,FRA,Milan,Serie A,2023,28.0,1995.0,29.0,1,0,1,0,0,1,1,100.0,0,1,0,1,1,2,4,3,GK,25-29,Goalkeeper,France,Europe
1567,Linton Maina,GER,Köln,Bundesliga,2023,24.0,1999.0,21.1,18,15,11,5,2,9,28,32.1,19,12,1,11,6,24,12,0,"FW,MF",20-24,Forward,Germany,Europe
1568,Patrick Mainka,GER,Heidenheim,Bundesliga,2023,28.0,1994.0,34.0,85,49,58,24,3,38,74,51.4,36,66,32,34,49,134,158,1,DF,25-29,Defender,Germany,Europe
1569,Kobbie Mainoo,ENG,Manchester Utd,Premier League,2023,18.0,2005.0,21.4,47,27,20,16,11,21,45,46.7,24,20,12,8,22,69,30,1,MF,Under 20,Midfielder,England,Europe
1570,Ainsley Maitland-Niles,ENG,Lyon,Ligue 1,2023,25.0,1997.0,15.9,34,18,12,14,8,19,37,51.4,18,16,6,10,17,51,29,1,"DF,MF",25-29,Defender,England,Europe
1572,Lovro Majer,CRO,Rennes,Ligue 1,2023,25.0,1998.0,0.2,0,0,0,0,0,0,0,,0,0,0,0,0,0,1,0,MF,25-29,Midfielder,Croatia,Europe
1573,Lovro Majer,CRO,Wolfsburg,Bundesliga,2023,25.0,1998.0,23.4,39,18,17,22,0,12,31,38.7,19,20,1,19,12,51,13,0,"MF,FW",25-29,Midfielder,Croatia,Europe
1574,Jean-Victor Makengo,FRA,Lorient,Ligue 1,2023,25.0,1998.0,5.3,5,4,3,2,0,2,6,33.3,4,12,1,11,8,13,5,0,"MF,FW",25-29,Midfielder,France,Europe
1575,Jordy Makengo,FRA,Freiburg,Bundesliga,2023,21.0,2001.0,11.4,17,11,11,5,1,6,10,60.0,4,16,4,12,11,28,37,0,DF,20-24,Defender,France,Europe
1576,Antoine Makoumbou,CGO,Cagliari,Serie A,2023,25.0,1998.0,30.0,41,24,21,15,5,15,30,50.0,15,23,4,19,16,57,27,2,MF,25-29,Midfielder,Congo,Africa
1578,Julián Malatini,ARG,Werder Bremen,Bundesliga,2023,22.0,2001.0,6.7,18,13,12,3,3,16,24,66.7,8,8,1,7,13,31,26,0,DF,20-24,Defender,Argentina,South America
1579,Daniel Maldini,ITA,Monza,Serie A,2023,21.0,2001.0,3.7,3,2,0,2,1,3,6,50.0,3,2,0,2,2,5,1,0,"MF,FW",20-24,Midfielder,Italy,Europe
1580,Daniel Maldini,ITA,Empoli,Serie A,2023,21.0,2001.0,2.9,4,2,0,2,2,2,2,100.0,0,5,0,5,2,6,2,0,"FW,MF",20-24,Forward,Italy,Europe
1581,Youssef Maleh,MAR,Empoli,Serie A,2023,24.0,1998.0,28.9,74,48,30,36,8,23,52,44.2,29,62,7,55,25,99,29,0,MF,20-24,Midfielder,Morocco,Africa
1582,Donyell Malen,NED,Dortmund,Bundesliga,2023,24.0,1999.0,19.8,11,7,5,3,3,2,6,33.3,4,11,4,7,2,13,8,0,"FW,MF",20-24,Forward,Netherlands,Europe
1583,Ruslan Malinovskyi,UKR,Genoa,Serie A,2023,30.0,1993.0,17.2,35,20,18,11,6,17,41,41.5,24,22,8,14,5,40,16,0,MF,30-34,Midfielder,Ukraine,Europe
1584,Lennard Maloney,USA,Heidenheim,Bundesliga,2023,23.0,1999.0,25.4,43,26,14,24,5,25,59,42.4,34,33,9,24,25,68,88,0,MF,20-24,Midfielder,United States,North America
1585,Aaron Malouda,FRA,Lille,Ligue 1,2023,17.0,2005.0,0.0,0,0,0,0,0,0,0,,0,0,0,0,0,0,0,0,FW,Under 20,Forward,France,Europe
1586,Giorgi Mamardashvili,GEO,Valencia,La Liga,2023,22.0,2000.0,36.5,4,3,4,0,0,4,4,100.0,0,1,0,1,2,6,22,2,GK,20-24,Goalkeeper,Georgia,Asia
1587,David Mamutovic,GER,Mainz 05,Bundesliga,2023,22.0,2000.0,0.1,1,1,0,1,0,1,1,100.0,0,0,0,0,0,1,0,0,"FW,DF",20-24,Forward,Germany,Europe
1588,Wilson Manafá,POR,Granada,La Liga,2023,29.0,1994.0,2.7,6,4,3,2,1,4,7,57.1,3,1,0,1,1,7,4,1,"DF,MF",25-29,Defender,Portugal,Europe
1589,Hianga Mananga Mbock,FRA,Brest,Ligue 1,2023,23.0,1999.0,0.1,1,0,0,0,1,1,2,50.0,1,0,0,0,1,2,0,0,"MF,FW",20-24,Midfielder,France,Europe
1590,Gianluca Mancini,ITA,Roma,Serie A,2023,27.0,1996.0,31.9,34,20,21,11,2,11,27,40.7,16,38,26,12,36,70,77,1,DF,25-29,Defender,Italy,Europe
1591,Marco Mancosu,ITA,Cagliari,Serie A,2023,34.0,1988.0,1.7,3,0,0,2,1,1,2,50.0,1,0,0,0,0,3,0,0,"MF,FW",30-34,Midfielder,Italy,Europe
1592,Steve Mandanda,FRA,Rennes,Ligue 1,2023,38.0,1985.0,34.0,2,0,2,0,0,2,4,50.0,2,0,0,0,0,2,6,1,GK,35-39,Goalkeeper,France,Europe
1593,Christos Mandas,GRE,Lazio,Serie A,2023,21.0,2001.0,8.0,0,0,0,0,0,0,1,0.0,1,0,0,0,1,1,3,1,GK,20-24,Goalkeeper,Greece,Europe
1594,Reinildo Mandava,MOZ,Atlético Madrid,La Liga,2023,29.0,1994.0,8.1,30,22,16,11,3,19,22,86.4,3,10,2,8,15,45,21,0,DF,25-29,Defender,Mozambique,Africa
1595,Aïssa Mandi,ALG,Villarreal,La Liga,2023,31.0,1991.0,12.4,13,8,8,5,0,7,14,50.0,7,10,7,3,8,21,41,0,DF,30-34,Defender,Algeria,Africa
1596,Rolando Mandragora,ITA,Fiorentina,Serie A,2023,26.0,1997.0,17.6,26,11,8,13,5,10,22,45.5,12,14,3,11,9,35,18,1,MF,25-29,Midfielder,Italy,Europe
1597,Orel Mangala,BEL,Nott'ham Forest,Premier League,2023,25.0,1998.0,17.4,27,13,16,10,1,14,29,48.3,15,12,6,6,26,53,32,0,MF,25-29,Midfielder,Belgium,Europe
1598,Orel Mangala,BEL,Lyon,Ligue 1,2023,25.0,1998.0,4.4,5,3,0,2,3,1,3,33.3,2,3,2,1,5,10,6,0,MF,25-29,Midfielder,Belgium,Europe
1599,Vito Mannone,ITA,Lille,Ligue 1,2023,35.0,1988.0,1.0,0,0,0,0,0,0,0,,0,0,0,0,0,0,0,0,GK,35-39,Goalkeeper,Italy,Europe
1600,Kostas Manolas,GRE,Salernitana,Serie A,2023,32.0,1991.0,5.4,9,5,6,3,0,6,8,75.0,2,10,7,3,2,11,20,0,DF,30-34,Defender,Greece,Europe
1602,Braydon Manu,GHA,Darmstadt 98,Bundesliga,2023,26.0,1997.0,1.9,2,0,0,1,1,0,0,,0,1,0,1,0,2,0,0,MF,25-29,Midfielder,Ghana,Africa
1603,Benson Manuel,ANG,Burnley,Premier League,2023,26.0,1997.0,1.3,3,2,2,1,0,0,0,,0,1,0,1,0,3,0,0,"MF,FW",25-29,Midfielder,Angola,Africa
1604,Faitout Maouassa,FRA,Granada,La Liga,2023,25.0,1998.0,2.5,8,5,6,1,1,4,5,80.0,1,6,0,6,1,9,3,0,"DF,MF",25-29,Defender,France,Europe
1605,Faitout Maouassa,FRA,Lens,Ligue 1,2023,25.0,1998.0,0.8,1,1,1,0,0,1,1,100.0,0,1,0,1,0,1,3,0,"MF,DF",25-29,Midfielder,France,Europe
1606,Marcão,BRA,Sevilla,La Liga,2023,27.0,1996.0,3.9,9,6,5,4,0,6,10,60.0,4,8,6,2,4,13,11,1,DF,25-29,Defender,Brazil,South America
1606,Marcão,BRA,Sevilla,La Liga,2023,27.0,1996.0,3.9,9,6,5,4,0,6,10,60.0,4,8,6,2,4,13,11,1,DF,25-29,Defender,Brazil,South America
1606,Marcão,BRA,Sevilla,La Liga,2023,27.0,1996.0,3.9,9,6,5,4,0,6,10,60.0,4,8,6,2,4,13,11,1,DF,25-29,Defender,Brazil,South America
1606,Marcão,BRA,Sevilla,La Liga,2023,27.0,1996.0,3.9,9,6,5,4,0,6,10,60.0,4,8,6,2,4,13,11,1,DF,25-29,Defender,Brazil,South America
1606,Marcão,BRA,Sevilla,La Liga,2023,27.0,1996.0,3.9,9,6,5,4,0,6,10,60.0,4,8,6,2,4,13,11,1,DF,25-29,Defender,Brazil,South America
1606,Marcão,BRA,Sevilla,La Liga,2023,27.0,1996.0,3.9,9,6,5,4,0,6,10,60.0,4,8,6,2,4,13,11,1,DF,25-29,Defender,Brazil,South America
1606,Marcão,BRA,Sevilla,La Liga,2023,27.0,1996.0,3.9,9,6,5,4,0,6,10,60.0,4,8,6,2,4,13,11,1,DF,25-29,Defender,Brazil,South America
1606,Marcão,BRA,Sevilla,La Liga,2023,27.0,1996.0,3.9,9,6,5,4,0,6,10,60.0,4,8,6,2,4,13,11,1,DF,25-29,Defender,Brazil,South America
1606,Marcão,BRA,Sevilla,La Liga,2023,27.0,1996.0,3.9,9,6,5,4,0,6,10,60.0,4,8,6,2,4,13,11,1,DF,25-29,Defender,Brazil,South America
1606,Marcão,BRA,Sevilla,La Liga,2023,27.0,1996.0,3.9,9,6,5,4,0,6,10,60.0,4,8,6,2,4,13,11,1,DF,25-29,Defender,Brazil,South America
1606,Marcão,BRA,Sevilla,La Liga,2023,27.0,1996.0,3.9,9,6,5,4,0,6,10,60.0,4,8,6,2,4,13,11,1,DF,25-29,Defender,Brazil,South America
1606,Marcão,BRA,Sevilla,La Liga,2023,27.0,1996.0,3.9,9,6,5,4,0,6,10,60.0,4,8,6,2,4,13,11,1,DF,25-29,Defender,Brazil,South America
1606,Marcão,BRA,Sevilla,La Liga,2023,27.0,1996.0,3.9,9,6,5,4,0,6,10,60.0,4,8,6,2,4,13,11,1,DF,25-29,Defender,Brazil,South America
1606,Marcão,BRA,Sevilla,La Liga,2023,27.0,1996.0,3.9,9,6,5,4,0,6,10,60.0,4,8,6,2,4,13,11,1,DF,25-29,Defender,Brazil,South America
1606,Marcão,BRA,Sevilla,La Liga,2023,27.0,1996.0,3.9,9,6,5,4,0,6,10,60.0,4,8,6,2,4,13,11,1,DF,25-29,Defender,Brazil,South America
1606,Marcão,BRA,Sevilla,La Liga,2023,27.0,1996.0,3.9,9,6,5,4,0,6,10,60.0,4,8,6,2,4,13,11,1,DF,25-29,Defender,Brazil,South America
1606,Marcão,BRA,Sevilla,La Liga,2023,27.0,1996.0,3.9,9,6,5,4,0,6,10,60.0,4,8,6,2,4,13,11,1,DF,25-29,Defender,Brazil,South America
1606,Marcão,BRA,Sevilla,La Liga,2023,27.0,1996.0,3.9,9,6,5,4,0,6,10,60.0,4,8,6,2,4,13,11,1,DF,25-29,Defender,Brazil,South America
1606,Marcão,BRA,Sevilla,La Liga,2023,27.0,1996.0,3.9,9,6,5,4,0,6,10,60.0,4,8,6,2,4,13,11,1,DF,25-29,Defender,Brazil,South America
1606,Marcão,BRA,Sevilla,La Liga,2023,27.0,1996.0,3.9,9,6,5,4,0,6,10,60.0,4,8,6,2,4,13,11,1,DF,25-29,Defender,Brazil,South America
1606,Marcão,BRA,Sevilla,La Liga,2023,27.0,1996.0,3.9,9,6,5,4,0,6,10,60.0,4,8,6,2,4,13,11,1,DF,25-29,Defender,Brazil,South America
1606,Marcão,BRA,Sevilla,La Liga,2023,27.0,1996.0,3.9,9,6,5,4,0,6,10,60.0,4,8,6,2,4,13,11,1,DF,25-29,Defender,Brazil,South America
1606,Marcão,BRA,Sevilla,La Liga,2023,27.0,1996.0,3.9,9,6,5,4,0,6,10,60.0,4,8,6,2,4,13,11,1,DF,25-29,Defender,Brazil,South America
1606,Marcão,BRA,Sevilla,La Liga,2023,27.0,1996.0,3.9,9,6,5,4,0,6,10,60.0,4,8,6,2,4,13,11,1,DF,25-29,Defender,Brazil,South America
1606,Marcão,BRA,Sevilla,La Liga,2023,27.0,1996.0,3.9,9,6,5,4,0,6,10,60.0,4,8,6,2,4,13,11,1,DF,25-29,Defender,Brazil,South America
1607,Solly March,ENG,Brighton,Premier League,2023,29.0,1994.0,6.2,19,14,9,7,3,8,14,57.1,6,5,0,5,11,30,8,0,"FW,DF",25-29,Forward,England,Europe
1608,Riccardo Marchizza,ITA,Frosinone,Serie A,2023,25.0,1998.0,12.8,7,6,4,3,0,3,13,23.1,10,10,2,8,7,14,33,0,DF,25-29,Defender,Italy,Europe
1609,Gian Marco Ferrari,ITA,Sassuolo,Serie A,2023,31.0,1992.0,25.2,22,10,11,11,0,12,18,66.7,6,28,17,11,25,47,76,0,DF,30-34,Defender,Italy,Europe
1614,José María Giménez,URU,Atlético Madrid,La Liga,2023,28.0,1995.0,14.7,18,10,10,7,1,5,16,31.3,11,16,12,4,10,28,95,0,DF,25-29,Defender,Uruguay,South America
1615,Mariano,DOM,Sevilla,La Liga,2023,29.0,1993.0,2.7,1,1,0,1,0,0,1,0.0,1,1,0,1,0,1,2,0,"FW,MF",25-29,Forward,Dominican Republic,North America
1616,Mirko Marić,CRO,Monza,Serie A,2023,28.0,1995.0,3.2,4,0,2,1,1,0,2,0.0,2,4,0,4,2,6,3,0,FW,25-29,Forward,Croatia,Europe
1618,Răzvan Marin,ROU,Empoli,Serie A,2023,27.0,1996.0,20.2,40,22,13,23,4,19,29,65.5,10,16,4,12,6,46,30,2,MF,25-29,Midfielder,Romania,Europe
1620,Guillermo Maripán,CHI,Monaco,Ligue 1,2023,29.0,1994.0,19.6,22,8,15,6,1,10,27,37.0,17,26,13,13,30,52,106,4,DF,25-29,Defender,Chile,South America
1622,Omar Marmoush,EGY,Eint Frankfurt,Bundesliga,2023,24.0,1999.0,25.6,21,11,7,8,6,6,16,37.5,10,13,0,13,11,32,7,0,"FW,MF",20-24,Forward,Egypt,Africa
1623,Marquinhos,BRA,Nantes,Ligue 1,2023,20.0,2003.0,1.7,3,2,2,0,1,1,4,25.0,3,7,2,5,6,9,1,0,"FW,MF",20-24,Forward,Brazil,South America
1623,Marquinhos,BRA,Nantes,Ligue 1,2023,20.0,2003.0,1.7,3,2,2,0,1,1,4,25.0,3,7,2,5,6,9,1,0,"FW,MF",20-24,Forward,Brazil,South America
1623,Marquinhos,BRA,Nantes,Ligue 1,2023,20.0,2003.0,1.7,3,2,2,0,1,1,4,25.0,3,7,2,5,6,9,1,0,"FW,MF",20-24,Forward,Brazil,South America
1623,Marquinhos,BRA,Nantes,Ligue 1,2023,20.0,2003.0,1.7,3,2,2,0,1,1,4,25.0,3,7,2,5,6,9,1,0,"FW,MF",20-24,Forward,Brazil,South America
1623,Marquinhos,BRA,Nantes,Ligue 1,2023,20.0,2003.0,1.7,3,2,2,0,1,1,4,25.0,3,7,2,5,6,9,1,0,"FW,MF",20-24,Forward,Brazil,South America
1623,Marquinhos,BRA,Nantes,Ligue 1,2023,20.0,2003.0,1.7,3,2,2,0,1,1,4,25.0,3,7,2,5,6,9,1,0,"FW,MF",20-24,Forward,Brazil,South America
1623,Marquinhos,BRA,Nantes,Ligue 1,2023,20.0,2003.0,1.7,3,2,2,0,1,1,4,25.0,3,7,2,5,6,9,1,0,"FW,MF",20-24,Forward,Brazil,South America
1623,Marquinhos,BRA,Nantes,Ligue 1,2023,20.0,2003.0,1.7,3,2,2,0,1,1,4,25.0,3,7,2,5,6,9,1,0,"FW,MF",20-24,Forward,Brazil,South America
1623,Marquinhos,BRA,Nantes,Ligue 1,2023,20.0,2003.0,1.7,3,2,2,0,1,1,4,25.0,3,7,2,5,6,9,1,0,"FW,MF",20-24,Forward,Brazil,South America
1624,Marquinhos,BRA,Paris S-G,Ligue 1,2023,29.0,1994.0,17.1,19,11,10,7,2,11,17,64.7,6,29,19,10,17,36,58,1,DF,25-29,Defender,Brazil,South America
1624,Marquinhos,BRA,Paris S-G,Ligue 1,2023,29.0,1994.0,17.1,19,11,10,7,2,11,17,64.7,6,29,19,10,17,36,58,1,DF,25-29,Defender,Brazil,South America
1624,Marquinhos,BRA,Paris S-G,Ligue 1,2023,29.0,1994.0,17.1,19,11,10,7,2,11,17,64.7,6,29,19,10,17,36,58,1,DF,25-29,Defender,Brazil,South America
1624,Marquinhos,BRA,Paris S-G,Ligue 1,2023,29.0,1994.0,17.1,19,11,10,7,2,11,17,64.7,6,29,19,10,17,36,58,1,DF,25-29,Defender,Brazil,South America
1624,Marquinhos,BRA,Paris S-G,Ligue 1,2023,29.0,1994.0,17.1,19,11,10,7,2,11,17,64.7,6,29,19,10,17,36,58,1,DF,25-29,Defender,Brazil,South America
1624,Marquinhos,BRA,Paris S-G,Ligue 1,2023,29.0,1994.0,17.1,19,11,10,7,2,11,17,64.7,6,29,19,10,17,36,58,1,DF,25-29,Defender,Brazil,South America
1624,Marquinhos,BRA,Paris S-G,Ligue 1,2023,29.0,1994.0,17.1,19,11,10,7,2,11,17,64.7,6,29,19,10,17,36,58,1,DF,25-29,Defender,Brazil,South America
1624,Marquinhos,BRA,Paris S-G,Ligue 1,2023,29.0,1994.0,17.1,19,11,10,7,2,11,17,64.7,6,29,19,10,17,36,58,1,DF,25-29,Defender,Brazil,South America
1624,Marquinhos,BRA,Paris S-G,Ligue 1,2023,29.0,1994.0,17.1,19,11,10,7,2,11,17,64.7,6,29,19,10,17,36,58,1,DF,25-29,Defender,Brazil,South America
1626,Agustín Martegani,ARG,Salernitana,Serie A,2023,23.0,2000.0,8.1,13,7,7,3,3,6,18,33.3,12,4,1,3,4,17,7,1,MF,20-24,Midfielder,Argentina,South America
1627,Eric Martel,GER,Köln,Bundesliga,2023,21.0,2002.0,27.3,70,43,32,34,4,37,67,55.2,30,65,19,46,43,113,80,0,MF,20-24,Midfielder,Germany,Europe
1629,Anthony Martial,FRA,Manchester Utd,Premier League,2023,27.0,1995.0,5.0,4,1,1,1,2,1,1,100.0,0,4,0,4,0,4,3,0,FW,25-29,Forward,France,Europe
1633,Jonas Martin,FRA,Brest,Ligue 1,2023,33.0,1990.0,13.4,43,27,17,24,2,21,36,58.3,15,16,2,14,9,52,28,2,MF,30-34,Midfielder,France,Europe
1635,Gabriel Martinelli,BRA,Arsenal,Premier League,2023,22.0,2001.0,22.4,30,24,9,12,9,13,32,40.6,19,23,1,22,5,35,9,1,FW,20-24,Forward,Brazil,South America
1636,Tommaso Martinelli,ITA,Fiorentina,Serie A,2023,17.0,2006.0,1.0,0,0,0,0,0,0,0,,0,0,0,0,0,0,0,0,GK,Under 20,Goalkeeper,Italy,Europe
1638,Emiliano Martínez,ARG,Aston Villa,Premier League,2023,30.0,1992.0,33.5,0,0,0,0,0,0,0,,0,0,0,0,0,0,12,3,GK,30-34,Goalkeeper,Argentina,South America
1638,Emiliano Martínez,ARG,Aston Villa,Premier League,2023,30.0,1992.0,33.5,0,0,0,0,0,0,0,,0,0,0,0,0,0,12,3,GK,30-34,Goalkeeper,Argentina,South America
1638,Emiliano Martínez,ARG,Aston Villa,Premier League,2023,30.0,1992.0,33.5,0,0,0,0,0,0,0,,0,0,0,0,0,0,12,3,GK,30-34,Goalkeeper,Argentina,South America
1638,Emiliano Martínez,ARG,Aston Villa,Premier League,2023,30.0,1992.0,33.5,0,0,0,0,0,0,0,,0,0,0,0,0,0,12,3,GK,30-34,Goalkeeper,Argentina,South America
1641,Lautaro Martínez,ARG,Inter,Serie A,2023,25.0,1997.0,29.5,22,16,4,13,5,4,19,21.1,15,30,1,29,20,42,10,0,FW,25-29,Forward,Argentina,South America
1642,Lisandro Martínez,ARG,Manchester Utd,Premier League,2023,25.0,1998.0,7.2,12,8,8,4,0,5,12,41.7,7,10,8,2,5,17,26,0,DF,25-29,Defender,Argentina,South America
1644,Lucas Martínez Quarta,ARG,Fiorentina,Serie A,2023,27.0,1996.0,25.5,75,47,43,28,4,36,54,66.7,18,38,14,24,30,105,69,4,DF,25-29,Defender,Argentina,South America
1645,Adam Marušić,MNE,Lazio,Serie A,2023,30.0,1992.0,34.4,45,31,24,19,2,27,49,55.1,22,27,7,20,29,74,63,2,DF,30-34,Defender,Montenegro,Europe
1647,Omar Mascarell,EQG,Mallorca,La Liga,2023,30.0,1993.0,17.5,33,16,16,17,0,18,35,51.4,17,24,8,16,31,64,30,1,MF,30-34,Midfielder,Equatorial Guinea,Africa
1648,Adam Masina,MAR,Udinese,Serie A,2023,29.0,1994.0,0.7,4,0,2,2,0,2,4,50.0,2,2,1,1,2,6,5,0,DF,25-29,Defender,Morocco,Africa
1649,Adam Masina,MAR,Torino,Serie A,2023,29.0,1994.0,11.4,17,12,8,8,1,5,20,25.0,15,12,6,6,11,28,30,0,DF,25-29,Defender,Morocco,Africa
1651,Han-Noah Massengo,FRA,Burnley,Premier League,2023,22.0,2001.0,0.2,1,1,1,0,0,0,0,,0,1,0,1,0,1,0,0,"MF,DF",20-24,Midfielder,France,Europe
1652,Roberto Massimo,GER,Stuttgart,Bundesliga,2023,22.0,2000.0,0.9,1,0,1,0,0,1,2,50.0,1,0,0,0,0,1,1,0,"FW,DF",20-24,Forward,Germany,Europe
1653,Clinton Mata,ANG,Lyon,Ligue 1,2023,30.0,1992.0,24.7,43,24,29,8,6,23,40,57.5,17,35,16,19,40,83,61,0,DF,30-34,Defender,Angola,Africa
1655,Pape Matar Sarr,SEN,Tottenham,Premier League,2023,20.0,2002.0,23.0,34,24,11,17,6,15,36,41.7,21,21,5,16,31,65,28,1,MF,20-24,Midfielder,Senegal,Africa
1656,Eliot Matazo,BEL,Monaco,Ligue 1,2023,21.0,2002.0,1.1,3,1,0,3,0,2,4,50.0,2,1,1,0,3,6,0,0,MF,20-24,Midfielder,Belgium,Europe
1657,Jean-Philippe Mateta,FRA,Crystal Palace,Premier League,2023,26.0,1997.0,25.4,22,15,4,11,7,6,10,60.0,4,13,4,9,4,26,14,0,FW,25-29,Forward,France,Europe
1660,Joël Matip,CMR,Liverpool,Premier League,2023,31.0,1991.0,8.7,12,6,7,4,1,8,12,66.7,4,16,12,4,9,21,43,0,DF,30-34,Defender,Cameroon,Africa
1661,Alex Matos,ENG,Chelsea,Premier League,2023,18.0,2004.0,0.0,0,0,0,0,0,0,0,,0,0,0,0,0,0,0,0,MF,Under 20,Midfielder,England,Europe
1662,Chrislain Matsima,FRA,Clermont Foot,Ligue 1,2023,21.0,2002.0,13.1,18,11,11,7,0,10,18,55.6,8,14,10,4,13,31,74,1,DF,20-24,Defender,France,Europe
1663,Chrislain Matsima,FRA,Monaco,Ligue 1,2023,21.0,2002.0,3.3,9,7,5,3,1,2,7,28.6,5,4,1,3,4,13,4,0,DF,20-24,Defender,France,Europe
1664,Jean Mattéo Bahoya,FRA,Eint Frankfurt,Bundesliga,2023,18.0,2005.0,2.0,3,1,0,3,0,1,4,25.0,3,2,0,2,1,4,1,0,"MF,FW",Under 20,Midfielder,France,Europe
1665,Remi Matthews,ENG,Crystal Palace,Premier League,2023,29.0,1994.0,0.0,0,0,0,0,0,0,0,,0,0,0,0,0,0,1,0,GK,25-29,Goalkeeper,England,Europe
1666,Alan Matturro,URU,Genoa,Serie A,2023,18.0,2004.0,1.2,1,1,1,0,0,1,1,100.0,0,6,3,3,2,3,4,0,DF,Under 20,Defender,Uruguay,South America
1667,Azor Matusiwa,NED,Reims,Ligue 1,2023,25.0,1998.0,15.4,39,27,17,19,3,22,32,68.8,10,21,3,18,33,72,32,1,MF,25-29,Midfielder,Netherlands,Europe
1668,Azor Matusiwa,NED,Rennes,Ligue 1,2023,25.0,1998.0,8.8,7,3,3,4,0,4,7,57.1,3,9,2,7,11,18,17,0,MF,25-29,Midfielder,Netherlands,Europe
1669,Neal Maupay,FRA,Brentford,Premier League,2023,26.0,1996.0,14.7,10,7,4,5,1,3,13,23.1,10,11,0,11,2,12,3,0,FW,25-29,Forward,France,Europe
1670,Neal Maupay,FRA,Everton,Premier League,2023,26.0,1996.0,1.2,0,0,0,0,0,0,1,0.0,1,2,0,2,0,0,1,0,FW,25-29,Forward,France,Europe
1671,Aïman Maurer,MAR,Clermont Foot,Ligue 1,2023,18.0,2004.0,0.6,1,1,1,0,0,1,3,33.3,2,0,0,0,0,1,0,0,"MF,FW",Under 20,Midfielder,Morocco,Africa
1672,Konstantinos Mavropanos,GRE,West Ham,Premier League,2023,25.0,1997.0,16.7,28,16,17,9,2,17,21,81.0,4,21,13,8,23,51,79,3,DF,25-29,Defender,Greece,Europe
1673,Christian Mawissa,FRA,Toulouse,Ligue 1,2023,18.0,2005.0,12.4,22,15,14,4,4,9,23,39.1,14,22,11,11,22,44,41,1,DF,Under 20,Defender,France,Europe
1674,Philipp Max,GER,Eint Frankfurt,Bundesliga,2023,29.0,1993.0,15.0,26,17,6,18,2,19,26,73.1,7,18,1,17,7,33,18,2,DF,25-29,Defender,Germany,Europe
1675,Eric Maxim Choupo-Moting,CMR,Bayern Munich,Bundesliga,2023,34.0,1989.0,8.0,17,12,8,5,4,6,14,42.9,8,5,0,5,7,24,7,0,"MF,FW",30-34,Midfielder,Cameroon,Africa
1676,Luís Maximiano,POR,Almería,La Liga,2023,24.0,1999.0,33.0,0,0,0,0,0,0,1,0.0,1,0,0,0,0,0,19,2,GK,20-24,Goalkeeper,Portugal,Europe
1677,Noam Mayoka-Tika,BEL,Marseille,Ligue 1,2023,19.0,2003.0,0.0,0,0,0,0,0,0,0,,0,0,0,0,0,0,0,0,MF,Under 20,Midfielder,Belgium,Europe
1679,Senny Mayulu,FRA,Paris S-G,Ligue 1,2023,17.0,2006.0,3.6,13,8,6,6,1,6,7,85.7,1,1,0,1,3,16,0,0,"FW,MF",Under 20,Forward,France,Europe
1680,Youssef Maziz,FRA,Metz,Ligue 1,2023,25.0,1998.0,1.4,0,0,0,0,0,0,2,0.0,2,1,0,1,1,1,2,0,"FW,MF",25-29,Forward,France,Europe
1681,Noussair Mazraoui,MAR,Bayern Munich,Bundesliga,2023,25.0,1997.0,13.3,32,21,14,11,7,13,21,61.9,8,14,1,13,20,52,27,1,DF,25-29,Defender,Morocco,Africa
1682,Luca Mazzitelli,ITA,Frosinone,Serie A,2023,27.0,1995.0,24.6,45,23,15,24,6,26,49,53.1,23,23,7,16,19,64,62,0,MF,25-29,Midfielder,Italy,Europe
1683,Pasquale Mazzocchi,ITA,Salernitana,Serie A,2023,28.0,1995.0,14.1,25,19,14,10,1,16,29,55.2,13,14,6,8,5,30,31,0,DF,25-29,Defender,Italy,Europe
1684,Pasquale Mazzocchi,ITA,Napoli,Serie A,2023,28.0,1995.0,4.8,5,2,1,2,2,2,3,66.7,1,5,1,4,1,6,13,0,DF,25-29,Defender,Italy,Europe
1685,Kevin Mbabu,SUI,Augsburg,Bundesliga,2023,28.0,1995.0,22.7,51,39,25,18,8,23,40,57.5,17,29,9,20,24,75,48,0,DF,25-29,Defender,Switzerland,Europe
1686,Noah Mbamba,BEL,Leverkusen,Bundesliga,2023,18.0,2005.0,0.2,0,0,0,0,0,0,0,,0,0,0,0,1,1,0,0,MF,Under 20,Midfielder,Belgium,Europe
1687,Ethan Mbappé,FRA,Paris S-G,Ligue 1,2023,16.0,2006.0,0.5,0,0,0,0,0,0,2,0.0,2,1,0,1,0,0,0,0,"MF,DF",Under 20,Midfielder,France,Europe
1688,Kylian Mbappé,FRA,Paris S-G,Ligue 1,2023,24.0,1998.0,24.0,4,1,1,1,2,4,9,44.4,5,4,0,4,2,6,2,0,FW,20-24,Forward,France,Europe
1689,Malick Mbaye,SEN,Metz,Ligue 1,2023,19.0,2004.0,1.7,5,1,0,1,4,1,2,50.0,1,1,0,1,1,6,2,0,"MF,FW",Under 20,Midfielder,Senegal,Africa
1689,Malick Mbaye,SEN,Metz,Ligue 1,2023,19.0,2004.0,1.7,5,1,0,1,4,1,2,50.0,1,1,0,1,1,6,2,0,"MF,FW",Under 20,Midfielder,Senegal,Africa
1689,Malick Mbaye,SEN,Metz,Ligue 1,2023,19.0,2004.0,1.7,5,1,0,1,4,1,2,50.0,1,1,0,1,1,6,2,0,"MF,FW",Under 20,Midfielder,Senegal,Africa
1689,Malick Mbaye,SEN,Metz,Ligue 1,2023,19.0,2004.0,1.7,5,1,0,1,4,1,2,50.0,1,1,0,1,1,6,2,0,"MF,FW",Under 20,Midfielder,Senegal,Africa
1690,Mamadou Mbaye,SEN,Cádiz,La Liga,2023,25.0,1998.0,3.2,6,3,3,3,0,2,5,40.0,3,10,7,3,5,11,26,0,DF,25-29,Defender,Senegal,Africa
1691,Chancel Mbemba,COD,Marseille,Ligue 1,2023,28.0,1994.0,24.5,33,21,25,7,1,17,30,56.7,13,21,13,8,13,46,95,1,DF,25-29,Defender,DR Congo,Africa
1692,Nolan Mbemba,CGO,Le Havre,Ligue 1,2023,28.0,1995.0,0.2,2,1,0,1,1,1,2,50.0,1,0,0,0,0,2,0,0,MF,25-29,Midfielder,Congo,Africa
1693,Bryan Mbeumo,CMR,Brentford,Premier League,2023,23.0,1999.0,21.8,15,10,6,6,3,5,19,26.3,14,26,2,24,7,22,13,0,FW,20-24,Forward,Cameroon,Africa
1694,Christ Mbondi,FRA,Reims,Ligue 1,2023,18.0,2004.0,0.0,1,1,1,0,0,1,1,100.0,0,0,0,0,0,1,0,0,FW,Under 20,Forward,France,Europe
1696,Nathanael Mbuku,COD,Augsburg,Bundesliga,2023,21.0,2002.0,0.1,0,0,0,0,0,0,0,,0,1,0,1,0,0,0,0,FW,20-24,Forward,DR Congo,Africa
1697,James Mcatee,ENG,Sheffield Utd,Premier League,2023,20.0,2002.0,20.2,32,21,9,13,10,13,33,39.4,20,20,0,20,11,43,18,0,"MF,FW",20-24,Midfielder,England,Europe
1698,James Mcatee,ENG,Manchester City,Premier League,2023,20.0,2002.0,0.0,0,0,0,0,0,0,0,,0,1,0,1,0,0,0,0,MF,20-24,Midfielder,England,Europe
1699,Oliver McBurnie,SCO,Sheffield Utd,Premier League,2023,27.0,1996.0,14.2,17,7,4,7,6,5,12,41.7,7,18,2,16,5,22,28,0,FW,25-29,Forward,Scotland,Europe
1700,James McConnell,ENG,Liverpool,Premier League,2023,18.0,2004.0,0.0,0,0,0,0,0,0,0,,0,1,0,1,1,1,0,0,MF,Under 20,Midfielder,England,Europe
1701,John McGinn,SCO,Aston Villa,Premier League,2023,28.0,1994.0,33.3,59,35,18,34,7,32,77,41.6,45,33,4,29,21,80,21,0,"MF,FW",25-29,Midfielder,Scotland,Europe
1702,Scott McKenna,SCO,Nott'ham Forest,Premier League,2023,26.0,1996.0,4.6,4,0,3,1,0,2,3,66.7,1,6,4,2,5,9,27,0,DF,25-29,Defender,Scotland,Europe
1703,Weston McKennie,USA,Juventus,Serie A,2023,24.0,1998.0,28.8,48,29,31,11,6,17,27,63.0,10,28,7,21,18,66,69,0,"MF,DF",20-24,Midfielder,United States,North America
1704,Dwight McNeil,ENG,Everton,Premier League,2023,23.0,1999.0,32.1,44,27,16,14,14,24,55,43.6,31,44,7,37,22,66,37,0,"MF,FW",20-24,Midfielder,England,Europe
1705,Scott McTominay,SCO,Manchester Utd,Premier League,2023,26.0,1996.0,21.1,49,25,23,24,2,22,33,66.7,11,34,12,22,14,63,54,0,"MF,FW",25-29,Midfielder,Scotland,Europe
1706,Facundo Medina,ARG,Lens,Ligue 1,2023,24.0,1999.0,30.2,64,38,25,31,8,44,69,63.8,25,38,13,25,24,88,59,2,DF,20-24,Defender,Argentina,South America
1707,Ben Mee,ENG,Brentford,Premier League,2023,33.0,1989.0,14.1,26,15,12,12,2,17,22,77.3,5,21,13,8,13,39,63,1,DF,30-34,Defender,England,Europe
1708,Marvin Mehlem,GER,Darmstadt 98,Bundesliga,2023,25.0,1997.0,16.5,28,21,10,14,4,11,27,40.7,16,21,2,19,33,61,15,0,MF,25-29,Midfielder,Germany,Europe
1709,Bamo Meïté,CIV,Marseille,Ligue 1,2023,21.0,2001.0,7.1,16,10,13,3,0,8,12,66.7,4,11,5,6,11,27,35,0,DF,20-24,Defender,Ivory Coast,Africa
1710,Bamo Meïté,CIV,Lorient,Ligue 1,2023,21.0,2001.0,1.6,2,1,2,0,0,0,1,0.0,1,3,2,1,3,5,9,0,DF,20-24,Defender,Ivory Coast,Africa
1711,Hannibal Mejbri,TUN,Manchester Utd,Premier League,2023,20.0,2003.0,1.5,3,3,1,2,0,1,3,33.3,2,1,1,0,0,3,0,0,"MF,FW",20-24,Midfielder,Tunisia,Africa
1712,Hannibal Mejbri,TUN,Sevilla,La Liga,2023,20.0,2003.0,1.2,3,3,1,2,0,0,1,0.0,1,1,0,1,0,3,0,0,MF,20-24,Midfielder,Tunisia,Africa
1716,Arthur Melo,BRA,Fiorentina,Serie A,2023,26.0,1996.0,22.1,45,30,17,24,4,26,42,61.9,16,27,3,24,18,63,8,0,MF,25-29,Midfielder,Brazil,South America
1717,Memphis,NED,Atlético Madrid,La Liga,2023,29.0,1994.0,9.9,5,2,0,3,2,3,6,50.0,3,2,0,2,1,6,0,0,FW,25-29,Forward,Netherlands,Europe
1718,Houboulang Mendes,GNB,Almería,La Liga,2023,25.0,1998.0,4.4,16,13,11,5,0,8,16,50.0,8,4,2,2,1,17,17,1,DF,25-29,Defender,Guinea-Bissau,Africa
1719,Nuno Mendes,POR,Paris S-G,Ligue 1,2023,21.0,2002.0,3.0,5,5,4,1,0,4,7,57.1,3,4,0,4,4,9,2,0,DF,20-24,Defender,Portugal,Europe
1722,Bruno Méndez,URU,Granada,La Liga,2023,23.0,1999.0,14.8,36,17,19,12,5,21,37,56.8,16,24,6,18,26,62,45,0,DF,20-24,Defender,Uruguay,South America
1724,Leonardo Mendicino,ITA,Atalanta,Serie A,2023,17.0,2006.0,0.0,0,0,0,0,0,0,0,,0,0,0,0,0,0,0,0,MF,Under 20,Midfielder,Italy,Europe
1725,Antoine Mendy,FRA,Nice,Ligue 1,2023,19.0,2004.0,4.6,7,5,4,3,0,3,7,42.9,4,4,1,3,8,15,16,0,DF,Under 20,Defender,France,Europe
1726,Benjamin Mendy,FRA,Lorient,Ligue 1,2023,29.0,1994.0,7.9,3,1,2,1,0,1,5,20.0,4,8,2,6,7,10,20,0,DF,25-29,Defender,France,Europe
1727,Ferland Mendy,FRA,Real Madrid,La Liga,2023,28.0,1995.0,19.1,15,10,12,2,1,11,14,78.6,3,12,2,10,13,28,26,1,DF,25-29,Defender,France,Europe
1728,Formose Mendy,SEN,Lorient,Ligue 1,2023,22.0,2001.0,14.0,33,19,24,8,1,20,33,60.6,13,23,12,11,20,53,59,1,DF,20-24,Defender,Senegal,Africa
1728,Formose Mendy,SEN,Lorient,Ligue 1,2023,22.0,2001.0,14.0,33,19,24,8,1,20,33,60.6,13,23,12,11,20,53,59,1,DF,20-24,Defender,Senegal,Africa
1728,Formose Mendy,SEN,Lorient,Ligue 1,2023,22.0,2001.0,14.0,33,19,24,8,1,20,33,60.6,13,23,12,11,20,53,59,1,DF,20-24,Defender,Senegal,Africa
1728,Formose Mendy,SEN,Lorient,Ligue 1,2023,22.0,2001.0,14.0,33,19,24,8,1,20,33,60.6,13,23,12,11,20,53,59,1,DF,20-24,Defender,Senegal,Africa
1729,Nampalys Mendy,SEN,Lens,Ligue 1,2023,31.0,1992.0,11.7,29,18,10,13,6,16,20,80.0,4,11,4,7,14,43,14,1,MF,30-34,Midfielder,Senegal,Africa
1730,Teden Mengi,ENG,Luton Town,Premier League,2023,21.0,2002.0,27.4,54,22,33,20,1,19,30,63.3,11,39,27,12,57,111,140,1,DF,20-24,Defender,England,Europe
1731,Chris Mepham,WAL,Bournemouth,Premier League,2023,25.0,1997.0,6.9,12,11,9,3,0,9,14,64.3,5,13,6,7,7,19,30,1,DF,25-29,Defender,Wales,Europe
1733,Alex Meret,ITA,Napoli,Serie A,2023,26.0,1997.0,30.8,1,0,1,0,0,1,2,50.0,1,0,0,0,0,1,10,1,GK,25-29,Goalkeeper,Italy,Europe
1735,Quentin Merlin,FRA,Marseille,Ligue 1,2023,21.0,2002.0,7.8,13,12,7,5,1,8,20,40.0,12,4,0,4,6,19,14,0,DF,20-24,Defender,France,Europe
1736,Quentin Merlin,FRA,Nantes,Ligue 1,2023,21.0,2002.0,14.3,29,20,15,12,2,16,25,64.0,9,22,1,21,18,47,22,0,DF,20-24,Defender,France,Europe
1737,Junior Messias,BRA,Genoa,Serie A,2023,32.0,1991.0,11.7,26,20,19,5,2,8,19,42.1,11,9,1,8,5,31,22,0,"MF,DF",30-34,Midfielder,Brazil,South America
1738,Thomas Meunier,BEL,Dortmund,Bundesliga,2023,31.0,1991.0,6.5,5,1,3,2,0,3,13,23.1,10,8,2,6,4,9,22,0,DF,30-34,Defender,Belgium,Europe
1739,Bastien Meupiyou,FRA,Nantes,Ligue 1,2023,17.0,2006.0,0.1,0,0,0,0,0,0,0,,0,0,0,0,0,0,1,0,DF,Under 20,Defender,France,Europe
1740,Alexander Meyer,GER,Dortmund,Bundesliga,2023,32.0,1991.0,7.7,1,1,1,0,0,1,1,100.0,0,0,0,0,0,1,2,1,GK,30-34,Goalkeeper,Germany,Europe
1741,Omenuke Mfulu,COD,Las Palmas,La Liga,2023,29.0,1994.0,0.9,4,3,3,1,0,0,1,0.0,1,1,1,0,2,6,5,0,"MF,FW",25-29,Midfielder,DR Congo,Africa
1742,Lucas Michal,FRA,Monaco,Ligue 1,2023,18.0,2005.0,0.1,0,0,0,0,0,0,0,,0,0,0,0,0,0,0,0,FW,Under 20,Forward,France,Europe
1743,Sven Michel,GER,Augsburg,Bundesliga,2023,33.0,1990.0,6.5,7,5,2,1,4,2,7,28.6,5,1,0,1,0,7,4,0,"FW,MF",30-34,Forward,Germany,Europe
1745,Georges Mikautadze,GEO,Metz,Ligue 1,2023,22.0,2000.0,19.4,4,3,1,2,1,0,9,0.0,9,11,0,11,8,12,3,0,FW,20-24,Forward,Georgia,Asia
1747,Lewis Miley,ENG,Newcastle Utd,Premier League,2023,17.0,2006.0,13.4,33,21,6,20,7,15,32,46.9,17,20,3,17,8,41,18,2,MF,Under 20,Midfielder,England,Europe
1750,Éder Militão,BRA,Real Madrid,La Liga,2023,25.0,1998.0,5.5,7,3,4,3,0,6,9,66.7,3,4,3,1,4,11,19,1,DF,25-29,Defender,Brazil,South America
1752,Enzo Millot,FRA,Stuttgart,Bundesliga,2023,21.0,2002.0,24.9,40,22,9,21,10,18,39,46.2,21,24,2,22,16,56,7,1,"MF,FW",20-24,Midfielder,France,Europe
1753,James Milner,ENG,Brighton,Premier League,2023,37.0,1986.0,8.6,20,14,9,10,1,9,14,64.3,5,9,0,9,8,28,16,0,"DF,MF",35-39,Defender,England,Europe
1756,Kim Min-jae,KOR,Bayern Munich,Bundesliga,2023,26.0,1996.0,21.9,37,24,21,11,5,12,24,50.0,12,29,19,10,45,82,70,2,DF,25-29,Defender,South Korea,Asia
1757,Yerry Mina,COL,Fiorentina,Serie A,2023,28.0,1994.0,0.5,1,1,1,0,0,1,2,50.0,1,0,0,0,0,1,2,0,"DF,MF",25-29,Defender,Colombia,South America
1758,Yerry Mina,COL,Cagliari,Serie A,2023,28.0,1994.0,13.5,20,13,14,6,0,13,19,68.4,6,23,14,9,4,24,77,0,DF,25-29,Defender,Colombia,South America
1759,Takumi Minamino,JPN,Monaco,Ligue 1,2023,28.0,1995.0,23.5,34,17,10,13,11,16,54,29.6,38,29,1,28,11,45,8,0,MF,25-29,Midfielder,Japan,Asia
1760,Lucas Mincarelli,FRA,Montpellier,Ligue 1,2023,19.0,2004.0,10.9,29,16,19,6,4,17,34,50.0,17,17,4,13,8,37,27,0,"DF,MF",Under 20,Defender,France,Europe
1761,Tyrone Mings,ENG,Aston Villa,Premier League,2023,30.0,1993.0,0.3,0,0,0,0,0,0,0,,0,0,0,0,1,1,1,0,DF,30-34,Defender,England,Europe
1765,Ignacio Miramon,ARG,Lille,Ligue 1,2023,20.0,2003.0,0.4,1,0,0,1,0,0,1,0.0,1,1,0,1,0,1,0,0,MF,20-24,Midfielder,Argentina,South America
1766,Aleksei Miranchuk,RUS,Atalanta,Serie A,2023,27.0,1995.0,13.1,12,6,6,4,2,5,13,38.5,8,6,1,5,2,14,5,1,"MF,FW",25-29,Midfielder,Russia,Europe
1768,Kevin Miranda,ITA,Sassuolo,Serie A,2023,20.0,2003.0,0.2,0,0,0,0,0,0,0,,0,0,0,0,0,0,1,0,DF,20-24,Defender,Italy,Europe
1769,Antonio Mirante,ITA,Milan,Serie A,2023,40.0,1983.0,2.0,0,0,0,0,0,0,0,,0,0,0,0,0,0,1,0,GK,Over 40,Goalkeeper,Italy,Europe
1770,Fabio Miretti,ITA,Juventus,Serie A,2023,19.0,2003.0,12.3,18,14,6,8,4,10,26,38.5,16,10,1,9,7,25,6,0,MF,Under 20,Midfielder,Italy,Europe
1771,Filippo Missori,ITA,Sassuolo,Serie A,2023,19.0,2004.0,3.0,6,3,2,4,0,4,11,36.4,7,3,2,1,4,10,8,0,DF,Under 20,Defender,Italy,Europe
1772,Tyrick Mitchell,ENG,Crystal Palace,Premier League,2023,23.0,1999.0,35.6,105,60,75,21,9,43,60,71.7,17,63,10,53,26,131,104,0,"DF,MF",20-24,Defender,England,Europe
1773,Kaoru Mitoma,JPN,Brighton,Premier League,2023,26.0,1997.0,16.5,13,6,3,7,3,5,19,26.3,14,15,1,14,5,18,12,0,FW,25-29,Forward,Japan,Asia
1777,Maximilian Mittelstädt,GER,Stuttgart,Bundesliga,2023,26.0,1997.0,23.4,91,51,46,39,6,53,89,59.6,36,36,6,30,46,137,65,0,DF,25-29,Defender,Germany,Europe
1778,Henrikh Mkhitaryan,ARM,Inter,Serie A,2023,34.0,1989.0,30.9,62,34,18,35,9,24,49,49.0,25,23,4,19,29,91,43,0,MF,30-34,Midfielder,Armenia,Asia
1781,Luka Modrić,CRO,Real Madrid,La Liga,2023,37.0,1985.0,18.8,22,15,10,6,6,9,25,36.0,16,13,4,9,21,43,9,0,MF,35-39,Midfielder,Croatia,Europe
1782,Max Moerstedt,GER,Hoffenheim,Bundesliga,2023,17.0,2006.0,0.1,0,0,0,0,0,0,1,0.0,1,0,0,0,0,0,0,0,"DF,FW",Unknown,Defender,Germany,Europe
1783,Terem Moffi,NGA,Nice,Ligue 1,2023,24.0,1999.0,21.7,7,4,0,5,2,3,12,25.0,9,14,1,13,3,10,15,0,FW,20-24,Forward,Nigeria,Africa
1784,Mostafa Mohamed,EGY,Nantes,Ligue 1,2023,25.0,1997.0,22.2,21,14,7,11,3,6,28,21.4,22,21,5,16,12,33,29,0,FW,25-29,Forward,Egypt,Africa
1785,Dion Moise Sahi,CIV,Strasbourg,Ligue 1,2023,21.0,2001.0,7.0,5,5,1,2,2,0,3,0.0,3,11,1,10,1,6,7,0,"MF,FW",20-24,Midfielder,Ivory Coast,Africa
1786,Johan Mojica,COL,Osasuna,La Liga,2023,30.0,1992.0,22.7,30,22,11,15,4,16,25,64.0,9,15,2,13,21,51,40,2,DF,30-34,Defender,Colombia,South America
1788,Nahuel Molina,ARG,Atlético Madrid,La Liga,2023,25.0,1998.0,20.6,38,22,16,18,4,26,54,48.1,28,19,3,16,9,47,36,1,DF,25-29,Defender,Argentina,South America
1789,Florent Mollet,FRA,Nantes,Ligue 1,2023,31.0,1991.0,23.1,18,11,8,6,4,10,31,32.3,21,18,5,13,13,31,17,0,"MF,FW",30-34,Midfielder,France,Europe
1791,Enzo Mongo,FRA,Nantes,Ligue 1,2023,18.0,2005.0,0.1,1,1,1,0,0,1,2,50.0,1,1,1,0,1,2,0,0,DF,Under 20,Defender,France,Europe
1792,Ilario Monterisi,ITA,Frosinone,Serie A,2023,21.0,2001.0,16.3,23,13,14,7,2,12,26,46.2,14,22,18,4,8,31,63,0,DF,20-24,Defender,Italy,Europe
1793,César Montes,MEX,Almería,La Liga,2023,26.0,1997.0,19.9,22,13,13,9,0,9,18,50.0,9,21,9,12,11,33,94,0,DF,25-29,Defender,Mexico,North America
1794,Gonzalo Montiel,ARG,Nott'ham Forest,Premier League,2023,26.0,1997.0,8.9,22,19,12,8,2,16,29,55.2,13,8,3,5,9,31,31,1,DF,25-29,Defender,Argentina,South America
1795,Lorenzo Montipò,ITA,Hellas Verona,Serie A,2023,27.0,1996.0,37.0,1,1,1,0,0,1,3,33.3,2,0,0,0,0,1,25,2,GK,25-29,Goalkeeper,Italy,Europe
1796,Kieffer Moore,WAL,Bournemouth,Premier League,2023,30.0,1992.0,1.2,0,0,0,0,0,0,0,,0,0,0,0,0,0,0,0,"FW,MF",30-34,Forward,Wales,Europe
1797,Mikey Moore,ENG,Tottenham,Premier League,2023,15.0,2007.0,0.0,0,0,0,0,0,0,0,,0,0,0,0,0,0,1,0,MF,Under 20,Midfielder,England,Europe
1799,Diego Moreira,POR,Lyon,Ligue 1,2023,18.0,2004.0,3.0,0,0,0,0,0,0,3,0.0,3,3,0,3,2,2,5,0,"FW,MF",Under 20,Forward,Portugal,Europe
1805,Ilaix Moriba,GUI,Getafe,La Liga,2023,20.0,2003.0,6.7,20,11,3,11,6,4,9,44.4,5,3,1,2,4,24,10,0,"MF,FW",20-24,Midfielder,Guinea,Africa
1807,Nikola Moro,CRO,Bologna,Serie A,2023,25.0,1998.0,9.3,21,16,8,12,1,8,15,53.3,7,14,1,13,7,28,10,0,MF,25-29,Midfielder,Croatia,Europe
1808,Carlton Morris,ENG,Luton Town,Premier League,2023,27.0,1995.0,31.8,15,8,4,6,5,9,15,60.0,6,24,5,19,1,16,53,0,"FW,MF",25-29,Forward,England,Europe
1810,Yerson Mosquera,COL,Villarreal,La Liga,2023,22.0,2001.0,13.7,27,13,18,7,2,12,15,80.0,3,12,2,10,17,44,65,0,DF,20-24,Defender,Colombia,South America
1811,Dany Mota,POR,Monza,Serie A,2023,25.0,1998.0,22.8,13,7,2,5,6,8,17,47.1,9,4,1,3,2,15,18,0,"FW,MF",25-29,Forward,Portugal,Europe
1812,Lebo Mothiba,RSA,Strasbourg,Ligue 1,2023,27.0,1996.0,6.9,5,2,1,4,0,3,4,75.0,1,6,1,5,0,5,11,0,FW,25-29,Forward,South Africa,Africa
1813,Youssoufa Moukoko,GER,Dortmund,Bundesliga,2023,18.0,2004.0,6.9,4,1,2,2,0,3,7,42.9,4,4,1,3,2,6,4,0,FW,Under 20,Forward,Germany,Europe
1814,Steve Mounié,BEN,Brest,Ligue 1,2023,28.0,1994.0,19.7,8,7,0,3,5,3,11,27.3,8,13,3,10,2,10,18,0,FW,25-29,Forward,Benin,Africa
1815,Mason Mount,ENG,Manchester Utd,Premier League,2023,24.0,1999.0,5.7,22,14,6,10,6,6,16,37.5,10,6,1,5,6,28,3,0,"MF,FW",20-24,Midfielder,England,Europe
1816,Samuel Moutoussamy,COD,Nantes,Ligue 1,2023,26.0,1996.0,12.3,38,20,14,17,7,17,37,45.9,20,16,3,13,11,49,13,0,MF,25-29,Midfielder,DR Congo,Africa
1817,Loris Mouyokolo,FRA,Lorient,Ligue 1,2023,22.0,2001.0,1.0,4,1,4,0,0,1,1,100.0,0,1,0,1,0,4,3,0,DF,20-24,Defender,France,Europe
1818,Divin Mubama,ENG,West Ham,Premier League,2023,18.0,2004.0,0.9,0,0,0,0,0,0,0,,0,0,0,0,0,0,0,0,FW,Under 20,Forward,England,Europe
1819,Mykhailo Mudryk,UKR,Chelsea,Premier League,2023,22.0,2001.0,17.5,21,12,9,7,5,10,32,31.3,22,14,1,13,9,30,9,0,FW,20-24,Forward,Ukraine,Europe
1820,François Mughe,CMR,Marseille,Ligue 1,2023,19.0,2004.0,2.0,0,0,0,0,0,0,3,0.0,3,2,0,2,1,1,1,0,"MF,DF",Under 20,Midfielder,Cameroon,Africa
1821,Nordi Mukiele,FRA,Paris S-G,Ligue 1,2023,25.0,1997.0,8.8,12,8,6,5,1,8,15,53.3,7,17,4,13,14,26,28,0,DF,25-29,Defender,France,Europe
1822,Samuele Mulattieri,ITA,Sassuolo,Serie A,2023,22.0,2000.0,5.1,1,1,0,0,1,1,2,50.0,1,7,2,5,1,2,2,0,"FW,MF",20-24,Forward,Italy,Europe
1823,Andreas Müller,GER,Darmstadt 98,Bundesliga,2023,23.0,2000.0,3.9,14,9,8,5,1,4,9,44.4,5,5,2,3,4,18,5,0,MF,20-24,Midfielder,Germany,Europe
1824,Jannik Müller,GER,Darmstadt 98,Bundesliga,2023,29.0,1994.0,12.6,33,16,21,9,3,16,27,59.3,11,24,12,12,17,50,39,1,"DF,MF",25-29,Defender,Germany,Europe
1825,Kevin Müller,GER,Heidenheim,Bundesliga,2023,32.0,1991.0,34.0,3,0,3,0,0,3,5,60.0,2,0,0,0,0,3,6,1,GK,30-34,Goalkeeper,Germany,Europe
1826,Marcus Müller,GER,Mainz 05,Bundesliga,2023,20.0,2002.0,0.2,0,0,0,0,0,0,0,,0,0,0,0,0,0,0,0,MF,20-24,Midfielder,Germany,Europe
1827,Thomas Müller,GER,Bayern Munich,Bundesliga,2023,33.0,1989.0,18.4,26,16,5,10,11,13,35,37.1,22,22,0,22,3,29,6,0,"MF,FW",30-34,Midfielder,Germany,Europe
1828,Abdul Mumin,GHA,Rayo Vallecano,La Liga,2023,25.0,1998.0,18.8,19,10,13,4,2,8,10,80.0,2,27,19,8,22,41,82,1,DF,25-29,Defender,Ghana,Africa
1829,Marshall Munetsi,ZIM,Reims,Ligue 1,2023,27.0,1996.0,24.1,61,39,18,34,9,33,61,54.1,28,21,7,14,14,75,33,0,MF,25-29,Midfielder,Zimbabwe,Africa
1831,Rodrigo Muniz,BRA,Fulham,Premier League,2023,22.0,2001.0,17.7,7,3,1,5,1,1,6,16.7,5,9,3,6,6,13,20,0,FW,20-24,Forward,Brazil,South America
1833,Daniel Muñoz,COL,Crystal Palace,Premier League,2023,27.0,1996.0,16.0,55,35,31,14,10,19,38,50.0,19,29,7,22,24,79,47,0,"DF,MF",25-29,Defender,Colombia,South America
1836,Finley Munroe,ENG,Aston Villa,Premier League,2023,18.0,2005.0,0.0,0,0,0,0,0,0,0,,0,0,0,0,0,0,0,0,MF,Under 20,Midfielder,England,Europe
1838,Luis Muriel,COL,Atalanta,Serie A,2023,32.0,1991.0,4.5,3,2,0,2,1,1,1,100.0,0,4,0,4,1,4,0,0,"FW,MF",30-34,Forward,Colombia,South America
1839,Murillo,BRA,Nott'ham Forest,Premier League,2023,21.0,2002.0,31.0,50,31,36,13,1,19,33,57.6,14,41,24,17,37,87,188,0,DF,20-24,Defender,Brazil,South America
1841,Alex Murphy,IRL,Newcastle Utd,Premier League,2023,19.0,2004.0,0.1,1,1,0,1,0,1,2,50.0,1,1,0,1,1,2,0,0,"DF,FW",Under 20,Defender,Republic of Ireland,Europe
1842,Jacob Murphy,ENG,Newcastle Utd,Premier League,2023,28.0,1995.0,13.2,20,10,8,4,8,12,26,46.2,14,17,0,17,6,26,16,0,"FW,DF",25-29,Forward,England,Europe
1843,Yunus Musah,USA,Milan,Serie A,2023,20.0,2002.0,16.4,25,14,15,6,4,8,15,53.3,7,18,4,14,10,35,16,1,"MF,FW",20-24,Midfielder,United States,North America
1844,Jamal Musiala,GER,Bayern Munich,Bundesliga,2023,20.0,2003.0,19.5,40,25,9,21,10,14,36,38.9,22,25,1,24,16,56,5,0,"MF,FW",20-24,Midfielder,Germany,Europe
1846,Juan Musso,ARG,Atalanta,Serie A,2023,29.0,1994.0,11.0,1,0,1,0,0,1,1,100.0,0,0,0,0,0,1,6,0,GK,25-29,Goalkeeper,Argentina,South America
1847,Kingstone Mutandwa,ZAM,Cagliari,Serie A,2023,20.0,2003.0,0.4,1,0,1,0,0,1,4,25.0,3,1,0,1,0,1,2,0,"FW,MF",20-24,Forward,Zambia,Africa
1848,Yvon Mvogo,SUI,Lorient,Ligue 1,2023,29.0,1994.0,34.0,0,0,0,0,0,0,1,0.0,1,0,0,0,0,0,15,3,GK,25-29,Goalkeeper,Switzerland,Europe
1850,Junior Mwanga,FRA,Strasbourg,Ligue 1,2023,20.0,2003.0,16.1,40,20,23,12,5,12,24,50.0,12,20,5,15,18,58,19,0,"MF,FW",20-24,Midfielder,France,Europe
1851,Phillipp Mwene,AUT,Mainz 05,Bundesliga,2023,29.0,1994.0,22.2,34,15,15,16,3,16,33,48.5,17,27,3,24,17,51,47,0,DF,25-29,Defender,Austria,Europe
1852,Vitaliy Mykolenko,UKR,Everton,Premier League,2023,24.0,1999.0,27.4,69,38,46,21,2,41,66,62.1,25,36,11,25,36,105,92,0,DF,20-24,Defender,Ukraine,Europe
1853,Joakim Mæhle,DEN,Wolfsburg,Bundesliga,2023,26.0,1997.0,27.2,62,39,33,18,11,41,64,64.1,23,43,5,38,29,91,65,0,"DF,MF",25-29,Defender,Denmark,Europe
1854,Obite N'Dicka,CIV,Roma,Serie A,2023,23.0,1999.0,24.1,32,18,12,19,1,12,20,60.0,8,30,16,14,16,48,75,0,DF,20-24,Defender,Ivory Coast,Africa
1855,Kévin N'Doram,FRA,Metz,Ligue 1,2023,27.0,1996.0,17.8,31,22,20,9,2,17,38,44.7,21,17,8,9,27,58,38,0,MF,25-29,Midfielder,France,Europe
1856,Nathan N'Goumou,FRA,Gladbach,Bundesliga,2023,23.0,2000.0,15.4,37,22,17,18,2,16,34,47.1,18,22,0,22,5,42,17,1,"FW,MF",20-24,Forward,France,Europe
1857,Stanley N'Soki,FRA,Hoffenheim,Bundesliga,2023,24.0,1999.0,7.0,21,10,12,8,1,17,29,58.6,12,13,2,11,8,29,33,0,DF,20-24,Defender,France,Europe
1859,Bilal Nadir,FRA,Marseille,Ligue 1,2023,19.0,2003.0,1.3,4,3,2,2,0,1,2,50.0,1,0,0,0,2,6,2,0,"MF,FW",Under 20,Midfielder,France,Europe
1860,Mahamadou Nagida,CMR,Rennes,Ligue 1,2023,18.0,2005.0,1.2,1,1,0,0,1,0,2,0.0,2,2,1,1,4,5,0,0,DF,Under 20,Defender,Cameroon,Africa
1861,Marvelous Nakamba,ZIM,Luton Town,Premier League,2023,29.0,1994.0,12.6,40,24,24,14,2,24,42,57.1,18,23,6,17,11,51,11,1,MF,25-29,Midfielder,Zimbabwe,Africa
1862,Keito Nakamura,JPN,Reims,Ligue 1,2023,23.0,2000.0,15.3,28,11,9,10,9,17,37,45.9,20,15,2,13,6,34,7,0,"FW,MF",20-24,Forward,Japan,Asia
1863,Nahitan Nández,URU,Cagliari,Serie A,2023,27.0,1995.0,26.0,59,40,27,23,9,27,64,42.2,37,25,2,23,19,78,32,0,"MF,DF",25-29,Midfielder,Uruguay,South America
1865,Natan,BRA,Napoli,Serie A,2023,22.0,2001.0,10.6,14,10,10,3,1,5,10,50.0,5,12,9,3,8,22,32,0,DF,20-24,Defender,Brazil,South America
1866,Lapo Nava,ITA,Milan,Serie A,2023,19.0,2004.0,0.0,0,0,0,0,0,0,0,,0,0,0,0,0,0,0,0,GK,Under 20,Goalkeeper,Italy,Europe
1869,Keylor Navas,CRC,Paris S-G,Ligue 1,2023,36.0,1986.0,4.0,0,0,0,0,0,0,0,,0,0,0,0,0,0,2,0,GK,35-39,Goalkeeper,Costa Rica,North America
1870,Michel Ndary Adopo,FRA,Atalanta,Serie A,2023,23.0,2000.0,1.2,4,3,0,3,1,1,1,100.0,0,0,0,0,0,4,2,1,MF,20-24,Midfielder,France,Europe
1872,Bassirou Ndiaye,SEN,Lorient,Ligue 1,2023,21.0,2002.0,1.7,5,2,2,2,1,3,5,60.0,2,1,1,0,1,6,0,0,FW,20-24,Forward,Senegal,Africa
1873,Iliman Ndiaye,SEN,Marseille,Ligue 1,2023,23.0,2000.0,18.0,21,18,5,11,5,11,29,37.9,18,14,2,12,6,27,6,0,"FW,MF",20-24,Forward,Senegal,Africa
1874,Massamba Ndiaye,SEN,Clermont Foot,Ligue 1,2023,21.0,2001.0,4.0,0,0,0,0,0,0,0,,0,0,0,0,0,0,2,0,GK,20-24,Goalkeeper,Senegal,Africa
1875,Rassoul Ndiaye,SEN,Le Havre,Ligue 1,2023,21.0,2001.0,5.8,25,17,8,16,1,12,24,50.0,12,2,1,1,4,29,5,0,"MF,FW",20-24,Midfielder,Senegal,Africa
1876,Michael Ndiweni,ENG,Newcastle Utd,Premier League,2023,19.0,2003.0,0.0,0,0,0,0,0,0,0,,0,0,0,0,0,0,0,0,FW,Under 20,Forward,England,Europe
1877,Cher Ndour,ITA,Paris S-G,Ligue 1,2023,19.0,2004.0,0.3,2,2,0,2,0,1,2,50.0,1,0,0,0,0,2,0,0,MF,Under 20,Midfielder,Italy,Europe
1878,Dan Ndoye,SUI,Bologna,Serie A,2023,22.0,2000.0,19.7,30,15,17,11,2,17,39,43.6,22,20,1,19,10,40,14,0,"FW,MF",20-24,Forward,Switzerland,Europe
1879,Joseph Nduquidi,FRA,Metz,Ligue 1,2023,18.0,2004.0,8.3,11,4,6,3,2,1,9,11.1,8,11,3,8,11,22,15,1,"MF,DF",Under 20,Midfielder,France,Europe
1880,Loïc Nego,HUN,Le Havre,Ligue 1,2023,32.0,1991.0,17.3,37,26,21,12,4,18,30,60.0,12,12,2,10,16,53,17,0,"DF,MF",30-34,Defender,Hungary,Europe
1882,Reiss Nelson,ENG,Arsenal,Premier League,2023,23.0,1999.0,3.0,9,6,5,1,3,8,10,80.0,2,5,1,4,1,10,5,0,FW,20-24,Forward,England,Europe
1883,Zack Nelson,ENG,Luton Town,Premier League,2023,18.0,2004.0,0.1,1,0,1,0,0,0,0,,0,0,0,0,0,1,0,0,"MF,DF",Under 20,Midfielder,England,Europe
1884,Neto,BRA,Bournemouth,Premier League,2023,34.0,1989.0,32.0,0,0,0,0,0,0,0,,0,1,0,1,1,1,12,3,GK,30-34,Goalkeeper,Brazil,South America
1884,Neto,BRA,Bournemouth,Premier League,2023,34.0,1989.0,32.0,0,0,0,0,0,0,0,,0,1,0,1,1,1,12,3,GK,30-34,Goalkeeper,Brazil,South America
1884,Neto,BRA,Bournemouth,Premier League,2023,34.0,1989.0,32.0,0,0,0,0,0,0,0,,0,1,0,1,1,1,12,3,GK,30-34,Goalkeeper,Brazil,South America
1884,Neto,BRA,Bournemouth,Premier League,2023,34.0,1989.0,32.0,0,0,0,0,0,0,0,,0,1,0,1,1,1,12,3,GK,30-34,Goalkeeper,Brazil,South America
1884,Neto,BRA,Bournemouth,Premier League,2023,34.0,1989.0,32.0,0,0,0,0,0,0,0,,0,1,0,1,1,1,12,3,GK,30-34,Goalkeeper,Brazil,South America
1884,Neto,BRA,Bournemouth,Premier League,2023,34.0,1989.0,32.0,0,0,0,0,0,0,0,,0,1,0,1,1,1,12,3,GK,30-34,Goalkeeper,Brazil,South America
1884,Neto,BRA,Bournemouth,Premier League,2023,34.0,1989.0,32.0,0,0,0,0,0,0,0,,0,1,0,1,1,1,12,3,GK,30-34,Goalkeeper,Brazil,South America
1884,Neto,BRA,Bournemouth,Premier League,2023,34.0,1989.0,32.0,0,0,0,0,0,0,0,,0,1,0,1,1,1,12,3,GK,30-34,Goalkeeper,Brazil,South America
1884,Neto,BRA,Bournemouth,Premier League,2023,34.0,1989.0,32.0,0,0,0,0,0,0,0,,0,1,0,1,1,1,12,3,GK,30-34,Goalkeeper,Brazil,South America
1885,Pedro Neto,POR,Wolves,Premier League,2023,23.0,2000.0,16.8,7,3,3,2,2,5,15,33.3,10,5,1,4,5,12,2,0,"FW,MF",20-24,Forward,Portugal,Europe
1886,Luca Netz,GER,Gladbach,Bundesliga,2023,20.0,2003.0,24.7,38,22,19,16,3,23,43,53.5,20,36,10,26,22,60,76,1,DF,20-24,Defender,Germany,Europe
1887,Manuel Neuer,GER,Bayern Munich,Bundesliga,2023,37.0,1986.0,22.8,1,1,1,0,0,0,0,,0,0,0,0,0,1,14,3,GK,35-39,Goalkeeper,Germany,Europe
1888,Florian Neuhaus,GER,Gladbach,Bundesliga,2023,26.0,1997.0,13.6,15,12,7,8,0,8,26,30.8,18,8,6,2,14,29,8,0,MF,25-29,Midfielder,Germany,Europe
1890,Jessic Ngankam,GER,Mainz 05,Bundesliga,2023,23.0,2000.0,2.0,1,1,0,1,0,0,0,,0,3,1,2,3,4,0,0,"FW,MF",20-24,Forward,Germany,Europe
1891,Jessic Ngankam,GER,Eint Frankfurt,Bundesliga,2023,23.0,2000.0,3.1,3,2,1,1,1,0,0,,0,0,0,0,0,3,1,0,FW,20-24,Forward,Germany,Europe
1892,Cyril Ngonge,BEL,Hellas Verona,Serie A,2023,23.0,2000.0,15.9,14,9,5,3,6,5,14,35.7,9,7,1,6,4,18,10,0,"FW,MF",20-24,Forward,Belgium,Europe
1893,Cyril Ngonge,BEL,Napoli,Serie A,2023,23.0,2000.0,3.5,5,3,1,4,0,2,2,100.0,0,2,0,2,0,5,2,0,FW,20-24,Forward,Belgium,Europe
1894,Steve Ngoura,FRA,Le Havre,Ligue 1,2023,18.0,2005.0,2.5,2,1,1,1,0,1,4,25.0,3,0,0,0,0,2,3,0,"FW,MF",Under 20,Forward,France,Europe
1895,Moussa Niakhate,SEN,Nott'ham Forest,Premier League,2023,27.0,1996.0,16.2,42,25,33,9,0,20,25,80.0,5,19,12,7,14,56,51,0,DF,25-29,Defender,Senegal,Africa
1896,M'Baye Niang,SEN,Empoli,Serie A,2023,28.0,1994.0,7.9,3,1,0,1,2,0,6,0.0,6,7,1,6,3,6,10,0,FW,25-29,Forward,Senegal,Africa
1897,Tanguy Nianzou,FRA,Sevilla,La Liga,2023,21.0,2002.0,3.5,12,8,9,2,1,8,11,72.7,3,2,0,2,3,15,9,1,DF,20-24,Defender,France,Europe
1898,Shamar Nicholson,JAM,Clermont Foot,Ligue 1,2023,26.0,1997.0,16.5,6,2,0,4,2,1,4,25.0,3,6,2,4,0,6,15,0,FW,25-29,Forward,Jamaica,North America
1899,Rasmus Nicolaisen,DEN,Toulouse,Ligue 1,2023,26.0,1997.0,32.5,50,30,39,11,0,26,44,59.1,18,44,33,11,42,92,158,1,DF,25-29,Defender,Denmark,Europe
1900,Moritz Nicolas,GER,Gladbach,Bundesliga,2023,25.0,1997.0,27.0,1,0,1,0,0,1,3,33.3,2,0,0,0,0,1,12,5,GK,25-29,Goalkeeper,Germany,Europe
1901,Hans Nicolussi Caviglia,ITA,Juventus,Serie A,2023,23.0,2000.0,3.0,5,2,1,3,1,4,6,66.7,2,5,1,4,0,5,2,0,MF,20-24,Midfielder,Italy,Europe
1903,Justin Njinmah,GER,Werder Bremen,Bundesliga,2023,22.0,2000.0,11.3,5,1,2,2,1,3,9,33.3,6,9,1,8,2,7,6,0,FW,20-24,Forward,Germany,Europe
1904,Eddie Nketiah,ENG,Arsenal,Premier League,2023,24.0,1999.0,12.0,12,7,2,6,4,2,7,28.6,5,11,0,11,4,16,4,0,FW,20-24,Forward,England,Europe
1905,Niels Nkounkou,FRA,Eint Frankfurt,Bundesliga,2023,22.0,2000.0,14.5,54,30,34,17,3,29,64,45.3,35,30,2,28,16,70,30,0,"DF,MF",20-24,Defender,France,Europe
1906,Christopher Nkunku,FRA,Chelsea,Premier League,2023,25.0,1997.0,4.9,5,4,0,4,1,1,2,50.0,1,4,1,3,2,7,4,0,"FW,MF",25-29,Forward,France,Europe
1907,Felix Nmecha,GER,Dortmund,Bundesliga,2023,22.0,2000.0,11.3,19,13,7,8,4,11,22,50.0,11,18,5,13,11,30,19,0,MF,20-24,Midfielder,Germany,Europe
1908,Lukas Nmecha,GER,Wolfsburg,Bundesliga,2023,24.0,1998.0,0.5,1,1,0,0,1,0,0,,0,1,0,1,0,1,0,0,FW,20-24,Forward,Germany,Europe
1910,Joseph Nonge,BEL,Juventus,Serie A,2023,18.0,2005.0,0.3,0,0,0,0,0,0,0,,0,0,0,0,0,0,1,0,MF,Under 20,Midfielder,Belgium,Europe
1912,Arnaud Nordin,FRA,Montpellier,Ligue 1,2023,25.0,1998.0,13.8,12,6,3,5,4,6,16,37.5,10,11,0,11,2,14,10,0,"FW,MF",25-29,Forward,France,Europe
1913,Rhys Norrington-Davies,WAL,Sheffield Utd,Premier League,2023,24.0,1999.0,1.2,1,1,1,0,0,0,1,0.0,1,2,0,2,1,2,2,0,DF,20-24,Defender,Wales,Europe
1915,Tijjani Noslin,NED,Hellas Verona,Serie A,2023,24.0,1999.0,14.9,18,8,5,7,6,6,16,37.5,10,17,2,15,2,20,14,0,"FW,MF",20-24,Forward,Netherlands,Europe
1916,Randy Nteka,ANG,Rayo Vallecano,La Liga,2023,25.0,1997.0,6.4,11,4,1,6,4,4,10,40.0,6,6,1,5,2,13,11,1,"FW,MF",25-29,Forward,Angola,Africa
1917,Ernest Nuamah,GHA,Lyon,Ligue 1,2023,19.0,2003.0,20.4,28,14,18,6,4,12,38,31.6,26,15,1,14,8,36,9,0,"FW,MF",Under 20,Forward,Ghana,Africa
1918,Alexander Nübel,GER,Stuttgart,Bundesliga,2023,26.0,1996.0,30.0,2,2,2,0,0,2,4,50.0,2,0,0,0,0,2,13,4,GK,25-29,Goalkeeper,Germany,Europe
1919,Kasim Nuhu,GHA,Hoffenheim,Bundesliga,2023,28.0,1995.0,0.1,0,0,0,0,0,0,0,,0,0,0,0,0,0,0,0,DF,25-29,Defender,Ghana,Africa
1920,Matheus Nunes,POR,Wolves,Premier League,2023,24.0,1998.0,2.0,3,1,3,0,0,2,6,33.3,4,0,0,0,6,9,1,0,MF,20-24,Midfielder,Portugal,Europe
1921,Matheus Nunes,POR,Manchester City,Premier League,2023,24.0,1998.0,7.3,10,4,1,7,2,5,16,31.3,11,7,1,6,1,11,8,1,MF,20-24,Midfielder,Portugal,Europe
1922,Darwin Núñez,URU,Liverpool,Premier League,2023,24.0,1999.0,22.7,22,12,2,10,10,11,23,47.8,12,18,6,12,3,25,9,0,FW,20-24,Forward,Uruguay,South America
1924,Fabian Nürnberger,BUL,Darmstadt 98,Bundesliga,2023,24.0,1999.0,16.8,29,22,22,6,1,22,41,53.7,19,11,1,10,17,46,26,0,"DF,MF",20-24,Defender,Bulgaria,Europe
1925,Ethan Nwaneri,ENG,Arsenal,Premier League,2023,16.0,2007.0,0.2,0,0,0,0,0,0,0,,0,1,0,1,0,0,0,0,FW,Under 20,Forward,England,Europe
1926,Simeon Nwankwo,NGA,Salernitana,Serie A,2023,31.0,1992.0,7.6,6,3,0,2,4,1,3,33.3,2,7,0,7,0,6,4,0,FW,30-34,Forward,Nigeria,Africa
1927,Gerzino Nyamsi,FRA,Strasbourg,Ligue 1,2023,26.0,1997.0,12.1,18,14,13,5,0,12,18,66.7,6,19,11,8,10,28,43,0,DF,25-29,Defender,France,Europe
1929,Rabby Nzingoula,CGO,Strasbourg,Ligue 1,2023,17.0,2005.0,1.5,3,3,0,3,0,3,4,75.0,1,4,0,4,5,8,0,0,"MF,FW",Under 20,Midfielder,Congo,Africa
1930,M'Bala Nzola,ANG,Fiorentina,Serie A,2023,26.0,1996.0,17.2,11,8,1,4,6,6,7,85.7,1,10,1,9,0,11,22,0,FW,25-29,Forward,Angola,Africa
1931,Christian Nørgaard,DEN,Brentford,Premier League,2023,29.0,1994.0,27.8,81,50,42,31,8,32,87,36.8,55,48,6,42,54,135,50,0,MF,25-29,Midfielder,Denmark,Europe
1932,Jake O'Brien,IRL,Lyon,Ligue 1,2023,22.0,2001.0,26.3,22,16,16,5,1,14,20,70.0,6,23,18,5,12,34,98,1,DF,20-24,Defender,Republic of Ireland,Europe
1933,Mark O'Mahony,IRL,Brighton,Premier League,2023,18.0,2005.0,0.7,1,0,1,0,0,1,2,50.0,1,2,1,1,0,1,1,0,FW,Under 20,Forward,Republic of Ireland,Europe
1934,Dara O'Shea,IRL,Burnley,Premier League,2023,24.0,1999.0,32.1,39,20,22,14,3,11,26,42.3,15,41,30,11,35,74,158,2,DF,20-24,Defender,Republic of Ireland,Europe
1935,Michael Obafemi,IRL,Burnley,Premier League,2023,23.0,2000.0,0.2,0,0,0,0,0,0,0,,0,1,0,1,0,0,0,0,"FW,MF",20-24,Forward,Republic of Ireland,Europe
1936,Adam Obert,SVK,Cagliari,Serie A,2023,20.0,2002.0,10.5,17,9,8,8,1,8,17,47.1,9,13,7,6,21,38,41,1,DF,20-24,Defender,Slovakia,Europe
1937,Pedro Obiang,EQG,Sassuolo,Serie A,2023,31.0,1992.0,5.0,8,4,3,4,1,2,10,20.0,8,6,4,2,8,16,10,0,MF,30-34,Midfielder,Equatorial Guinea,Africa
1939,Brian Ocampo,URU,Cádiz,La Liga,2023,24.0,1999.0,2.8,4,3,1,3,0,2,5,40.0,3,4,0,4,3,7,0,0,"MF,FW",20-24,Midfielder,Uruguay,South America
1940,Lucas Ocampos,ARG,Sevilla,La Liga,2023,29.0,1994.0,31.9,66,47,22,27,17,29,58,50.0,29,34,1,33,21,87,29,0,"FW,MF",25-29,Forward,Argentina,South America
1941,Guillermo Ochoa,MEX,Salernitana,Serie A,2023,38.0,1985.0,21.0,0,0,0,0,0,0,1,0.0,1,0,0,0,0,0,9,1,GK,35-39,Goalkeeper,Mexico,North America
1942,Jens Odgaard,DEN,Bologna,Serie A,2023,24.0,1999.0,4.8,4,4,1,1,2,1,3,33.3,2,9,0,9,1,5,3,0,"FW,MF",20-24,Forward,Denmark,Europe
1943,Wilson Odobert,FRA,Burnley,Premier League,2023,18.0,2004.0,23.3,17,13,8,5,4,6,22,27.3,16,26,2,24,6,23,14,0,"MF,FW",Under 20,Midfielder,France,Europe
1945,Tim Oermann,GER,Bochum,Bundesliga,2023,19.0,2003.0,7.9,19,11,11,4,4,9,14,64.3,5,15,6,9,2,21,22,0,DF,Under 20,Defender,Germany,Europe
1946,Odeluga Offiah,ENG,Brighton,Premier League,2023,20.0,2002.0,1.4,1,0,1,0,0,1,1,100.0,0,0,0,0,1,2,0,0,DF,20-24,Defender,England,Europe
1947,Chiedozie Ogbene,IRL,Luton Town,Premier League,2023,26.0,1997.0,22.2,17,10,10,7,0,12,22,54.5,10,14,3,11,7,24,34,2,"MF,DF",25-29,Midfielder,Republic of Ireland,Europe
1948,Angelo Ogbonna,ITA,West Ham,Premier League,2023,35.0,1988.0,7.1,11,5,9,2,0,6,7,85.7,1,13,10,3,3,14,29,0,DF,35-39,Defender,Italy,Europe
1949,Florent Ogier,FRA,Clermont Foot,Ligue 1,2023,34.0,1989.0,10.5,19,9,13,6,0,11,18,61.1,7,25,19,6,9,28,35,3,DF,30-34,Defender,France,Europe
1950,Noah Okafor,SUI,Milan,Serie A,2023,23.0,2000.0,9.9,6,4,1,4,1,3,10,30.0,7,8,1,7,0,6,10,0,"FW,MF",20-24,Forward,Switzerland,Europe
1951,David Okereke,NGA,Torino,Serie A,2023,25.0,1997.0,2.8,3,1,1,1,1,0,3,0.0,3,2,0,2,1,4,0,0,"FW,MF",25-29,Forward,Nigeria,Africa
1952,Caleb Okoli,ITA,Frosinone,Serie A,2023,22.0,2001.0,32.4,56,34,33,22,1,29,44,65.9,15,48,32,16,29,85,156,4,DF,20-24,Defender,Italy,Europe
1953,Maduka Okoye,NGA,Udinese,Serie A,2023,23.0,1999.0,21.0,0,0,0,0,0,0,0,,0,0,0,0,1,1,4,2,GK,20-24,Goalkeeper,Nigeria,Africa
1954,Masaya Okugawa,JPN,Augsburg,Bundesliga,2023,27.0,1996.0,0.4,0,0,0,0,0,0,0,,0,0,0,0,0,0,2,0,"FW,DF",25-29,Forward,Japan,Asia
1955,Joseph Okumu,KEN,Reims,Ligue 1,2023,26.0,1997.0,19.4,44,28,28,14,2,24,38,63.2,14,27,19,8,35,79,112,2,DF,25-29,Defender,Kenya,Africa
1957,Michael Olakigbe,ENG,Brentford,Premier League,2023,19.0,2004.0,0.7,3,0,2,1,0,2,4,50.0,2,7,0,7,1,4,0,1,"DF,FW",Under 20,Defender,England,Europe
1959,Finn Ole Becker,GER,Hoffenheim,Bundesliga,2023,23.0,2000.0,6.7,10,9,8,2,0,4,17,23.5,13,9,1,8,1,11,10,0,MF,20-24,Midfielder,Germany,Europe
1960,Mathias Olesen,LUX,Köln,Bundesliga,2023,22.0,2001.0,1.2,0,0,0,0,0,0,0,,0,0,0,0,2,2,2,0,"MF,FW",20-24,Midfielder,Luxembourg,Europe
1961,Michael Olise,FRA,Crystal Palace,Premier League,2023,21.0,2001.0,14.2,19,10,7,10,2,8,24,33.3,16,21,0,21,11,30,9,0,"FW,MF",20-24,Forward,France,Europe
1962,Mathías Olivera,URU,Napoli,Serie A,2023,25.0,1997.0,17.4,50,29,29,15,6,23,39,59.0,16,35,6,29,20,70,25,0,DF,25-29,Defender,Uruguay,South America
1964,Robin Olsen,SWE,Aston Villa,Premier League,2023,33.0,1990.0,4.5,0,0,0,0,0,0,0,,0,0,0,0,0,0,1,0,GK,30-34,Goalkeeper,Sweden,Europe
1966,Becir Omeragic,SUI,Montpellier,Ligue 1,2023,21.0,2002.0,25.7,48,29,31,13,4,20,33,60.6,13,51,29,22,27,75,65,0,"DF,MF",20-24,Defender,Switzerland,Europe
1967,Jonas Omlin,SUI,Gladbach,Bundesliga,2023,29.0,1994.0,7.0,1,0,1,0,0,1,1,100.0,0,0,0,0,0,1,3,0,GK,25-29,Goalkeeper,Switzerland,Europe
1968,Andrew Omobamidele,IRL,Nott'ham Forest,Premier League,2023,21.0,2002.0,8.7,10,3,9,1,0,5,8,62.5,3,12,8,4,13,23,42,1,DF,20-24,Defender,Republic of Ireland,Europe
1971,Amadou Onana,BEL,Everton,Premier League,2023,21.0,2001.0,23.2,71,38,32,31,8,21,42,50.0,21,25,6,19,21,92,31,0,MF,20-24,Midfielder,Belgium,Europe
1972,André Onana,CMR,Manchester Utd,Premier League,2023,27.0,1996.0,38.0,2,0,2,0,0,2,2,100.0,0,0,0,0,0,2,11,2,GK,25-29,Goalkeeper,Cameroon,Africa
1973,Jean Onana,CMR,Marseille,Ligue 1,2023,23.0,2000.0,6.3,23,14,6,14,3,13,25,52.0,12,10,2,8,11,34,11,1,MF,20-24,Midfielder,Cameroon,Africa
1974,Ryan One,SCO,Sheffield Utd,Premier League,2023,17.0,2006.0,0.1,0,0,0,0,0,0,0,,0,0,0,0,0,0,0,0,FW,Under 20,Forward,Scotland,Europe
1975,Karim Onisiwo,AUT,Mainz 05,Bundesliga,2023,31.0,1992.0,16.6,17,8,4,6,7,6,11,54.5,5,18,4,14,2,19,7,0,"FW,MF",30-34,Forward,Austria,Europe
1976,Tyler Onyango,ENG,Everton,Premier League,2023,20.0,2003.0,0.0,0,0,0,0,0,0,0,,0,0,0,0,0,0,0,0,MF,20-24,Midfielder,England,Europe
1977,Fred Onyedinma,ENG,Luton Town,Premier League,2023,26.0,1996.0,4.5,10,6,7,3,0,5,12,41.7,7,3,0,3,1,11,13,0,"DF,MF",25-29,Defender,England,Europe
1978,Frank Onyeka,NGA,Brentford,Premier League,2023,25.0,1998.0,12.9,37,24,9,23,5,16,29,55.2,13,15,7,8,23,60,17,0,MF,25-29,Midfielder,Nigeria,Africa
1979,Loïs Openda,BEL,RB Leipzig,Bundesliga,2023,23.0,2000.0,30.0,3,3,0,1,2,0,6,0.0,6,19,3,16,5,8,14,0,FW,20-24,Forward,Belgium,Europe
1980,Royce Openda Owaga,GAB,Lorient,Ligue 1,2023,21.0,2002.0,0.2,0,0,0,0,0,0,0,,0,0,0,0,0,0,0,0,FW,20-24,Forward,Gabon,Africa
1981,Christopher Operi,CIV,Le Havre,Ligue 1,2023,26.0,1997.0,27.2,55,36,37,15,3,32,59,54.2,27,45,7,38,35,90,68,1,DF,25-29,Defender,Ivory Coast,Africa
1982,Leon Opitz,GER,Werder Bremen,Bundesliga,2023,18.0,2005.0,0.2,2,2,1,1,0,2,3,66.7,1,0,0,0,0,2,0,0,"FW,DF",Under 20,Forward,Germany,Europe
1983,Gift Orban,NGA,Lyon,Ligue 1,2023,21.0,2002.0,5.3,4,3,0,1,3,1,4,25.0,3,2,0,2,1,5,2,1,FW,20-24,Forward,Nigeria,Africa
1984,Willi Orban,HUN,RB Leipzig,Bundesliga,2023,30.0,1992.0,17.6,20,12,8,10,2,9,18,50.0,9,22,13,9,16,36,76,1,DF,30-34,Defender,Hungary,Europe
1985,Ivan Ordets,UKR,Bochum,Bundesliga,2023,31.0,1992.0,20.9,19,14,11,6,2,10,17,58.8,7,41,29,12,31,50,130,0,DF,30-34,Defender,Ukraine,Europe
1986,Divock Origi,BEL,Nott'ham Forest,Premier League,2023,28.0,1995.0,6.7,6,4,5,0,1,0,0,,0,6,0,6,2,8,4,0,FW,25-29,Forward,Belgium,Europe
1987,Gaetano Oristanio,ITA,Cagliari,Serie A,2023,20.0,2002.0,12.3,20,10,5,14,1,5,17,29.4,12,11,0,11,9,29,8,0,"FW,MF",20-24,Forward,Italy,Europe
1989,Riccardo Orsolini,ITA,Bologna,Serie A,2023,26.0,1997.0,19.9,23,14,13,4,6,9,30,30.0,21,25,3,22,8,31,19,1,"FW,MF",25-29,Forward,Italy,Europe
1990,Stefan Ortega,GER,Manchester City,Premier League,2023,30.0,1992.0,7.1,0,0,0,0,0,0,0,,0,0,0,0,0,0,2,1,GK,30-34,Goalkeeper,Germany,Europe
1993,Ben Osborn,ENG,Sheffield Utd,Premier League,2023,28.0,1994.0,15.2,22,9,11,9,2,8,17,47.1,9,18,2,16,8,30,30,0,"DF,MF",25-29,Defender,England,Europe
1994,Gabriel Osho,NGA,Luton Town,Premier League,2023,24.0,1998.0,20.5,41,22,21,19,1,16,27,59.3,11,37,20,17,31,72,92,0,DF,20-24,Defender,Nigeria,Africa
1995,Victor Osimhen,NGA,Napoli,Serie A,2023,24.0,1998.0,22.0,9,5,0,4,5,2,4,50.0,2,5,1,4,2,11,18,0,FW,20-24,Forward,Nigeria,Africa
1996,Milutin Osmajić,MNE,Cádiz,La Liga,2023,24.0,1999.0,0.1,0,0,0,0,0,0,0,,0,0,0,0,0,0,0,0,MF,20-24,Midfielder,Montenegro,Europe
1997,Patrick Osterhage,GER,Bochum,Bundesliga,2023,23.0,2000.0,20.7,38,26,14,23,1,17,36,47.2,19,36,9,27,27,65,32,1,MF,20-24,Midfielder,Germany,Europe
1998,William Osula,DEN,Sheffield Utd,Premier League,2023,19.0,2003.0,8.7,2,2,1,0,1,1,2,50.0,1,3,1,2,2,4,9,0,FW,Under 20,Forward,Denmark,Europe
1999,Dango Ouattara,BFA,Bournemouth,Premier League,2023,21.0,2002.0,13.7,45,27,22,11,12,19,34,55.9,15,18,3,15,22,67,35,0,"FW,DF",20-24,Forward,Burkina Faso,Africa
2000,Kassoum Ouattara,FRA,Monaco,Ligue 1,2023,18.0,2004.0,7.1,17,12,8,5,4,9,20,45.0,11,11,0,11,13,30,20,0,"DF,FW",Under 20,Defender,France,Europe
2001,Remi Oudin,FRA,Lecce,Serie A,2023,26.0,1996.0,20.2,26,14,12,12,2,12,19,63.2,7,13,1,12,20,46,22,0,"MF,FW",25-29,Midfielder,France,Europe
2002,Alexandre Oukidja,ALG,Metz,Ligue 1,2023,35.0,1988.0,33.2,2,1,2,0,0,1,2,50.0,1,1,0,1,3,5,24,3,GK,35-39,Goalkeeper,Algeria,Africa
2003,Azzedine Ounahi,MAR,Marseille,Ligue 1,2023,23.0,2000.0,13.4,25,11,9,14,2,11,32,34.4,21,6,1,5,11,36,8,0,MF,20-24,Midfielder,Morocco,Africa
2004,Adam Ounas,ALG,Lille,Ligue 1,2023,26.0,1996.0,4.6,4,3,2,2,0,2,7,28.6,5,2,0,2,6,10,1,0,FW,25-29,Forward,Algeria,Africa
2005,Patrick Ouotro,CIV,Strasbourg,Ligue 1,2023,17.0,2005.0,0.1,0,0,0,0,0,0,0,,0,0,0,0,0,0,0,0,FW,Under 20,Forward,Ivory Coast,Africa
2006,Aiham Ousou,SYR,Cádiz,La Liga,2023,23.0,2000.0,4.8,8,5,6,2,0,5,5,100.0,0,1,0,1,7,15,15,0,DF,20-24,Defender,Syria,Asia
2007,Jesús Owono,EQG,Alavés,La Liga,2023,22.0,2001.0,4.0,0,0,0,0,0,0,0,,0,0,0,0,0,0,3,0,GK,20-24,Goalkeeper,Equatorial Guinea,Africa
2009,Anthony Oyono,GAB,Frosinone,Serie A,2023,22.0,2001.0,13.3,37,26,21,14,2,23,34,67.6,11,17,3,14,9,46,32,0,DF,20-24,Defender,Gabon,Africa
2010,Salih Özcan,TUR,Dortmund,Bundesliga,2023,25.0,1998.0,13.2,20,12,11,8,1,10,18,55.6,8,28,3,25,17,37,18,1,MF,25-29,Midfielder,Turkey,Asia
2011,Cenk Özkacar,TUR,Valencia,La Liga,2023,22.0,2000.0,17.8,26,15,22,4,0,15,23,65.2,8,18,7,11,18,44,84,1,DF,20-24,Defender,Turkey,Asia
2012,David Ozoh,ENG,Crystal Palace,Premier League,2023,18.0,2005.0,1.7,10,6,3,6,1,5,6,83.3,1,2,0,2,0,10,2,0,"MF,DF",Under 20,Midfielder,England,Europe
2014,Willian Pacho,ECU,Eint Frankfurt,Bundesliga,2023,21.0,2001.0,33.0,62,37,38,23,1,31,53,58.5,22,51,22,29,47,109,152,2,DF,20-24,Defender,Ecuador,South America
2015,Gonçalo Paciência,POR,Bochum,Bundesliga,2023,28.0,1994.0,7.2,8,4,2,2,4,3,6,50.0,3,5,0,5,0,8,7,0,"FW,MF",25-29,Forward,Portugal,Europe
2016,Simone Pafundi,ITA,Udinese,Serie A,2023,17.0,2006.0,0.1,0,0,0,0,0,0,0,,0,0,0,0,0,0,0,0,MF,Under 20,Midfielder,Italy,Europe
2017,Riccardo Pagano,ITA,Roma,Serie A,2023,18.0,2004.0,0.6,2,2,1,1,0,0,6,0.0,6,3,2,1,0,2,2,0,"MF,DF",Under 20,Midfielder,Italy,Europe
2018,Pablo Pagis,FRA,Lorient,Ligue 1,2023,20.0,2002.0,1.8,10,6,5,4,1,6,10,60.0,4,2,0,2,3,13,1,0,MF,20-24,Midfielder,France,Europe
2019,Exequiel Palacios,ARG,Leverkusen,Bundesliga,2023,24.0,1998.0,20.3,60,34,28,26,6,26,53,49.1,27,24,0,24,29,89,20,2,MF,20-24,Midfielder,Argentina,South America
2021,João Palhinha,POR,Fulham,Premier League,2023,28.0,1995.0,30.0,152,75,80,60,12,103,152,67.8,49,57,9,48,46,198,58,0,MF,25-29,Midfielder,Portugal,Europe
2022,Nicolas Pallois,FRA,Nantes,Ligue 1,2023,35.0,1987.0,17.7,34,19,21,11,2,19,35,54.3,16,37,26,11,26,60,111,0,DF,35-39,Defender,France,Europe
2023,Cole Palmer,ENG,Chelsea,Premier League,2023,21.0,2002.0,29.0,23,12,9,6,8,8,19,42.1,11,20,2,18,20,43,13,2,"FW,MF",20-24,Forward,England,Europe
2024,Cole Palmer,ENG,Manchester City,Premier League,2023,21.0,2002.0,0.1,0,0,0,0,0,0,0,,0,0,0,0,0,0,0,0,MF,20-24,Midfielder,England,Europe
2025,Emerson Palmieri,ITA,West Ham,Premier League,2023,28.0,1994.0,34.9,106,68,48,42,16,57,90,63.3,33,47,15,32,43,149,96,0,DF,25-29,Defender,Italy,Europe
2026,Joaquín Panichelli,ARG,Alavés,La Liga,2023,20.0,2002.0,2.5,3,3,1,1,1,1,2,50.0,1,1,0,1,1,4,4,0,"FW,MF",20-24,Forward,Argentina,South America
2028,Antonios Papadopoulos,GER,Dortmund,Bundesliga,2023,23.0,1999.0,1.3,6,3,6,0,0,6,7,85.7,1,3,2,1,2,8,7,0,DF,20-24,Defender,Germany,Europe
2029,Christos Papadopoulos,GRE,Genoa,Serie A,2023,18.0,2004.0,0.0,0,0,0,0,0,0,1,0.0,1,0,0,0,0,0,0,0,FW,Under 20,Forward,Greece,Europe
2030,Sokratis Papastathopoulos,GRE,Betis,La Liga,2023,35.0,1988.0,12.6,21,14,16,5,0,13,17,76.5,4,15,9,6,6,27,60,0,DF,35-39,Defender,Greece,Europe
2031,Merveille Papela,GER,Mainz 05,Bundesliga,2023,22.0,2001.0,2.9,5,4,2,3,0,0,4,0.0,4,1,0,1,4,9,2,0,"MF,DF",20-24,Midfielder,Germany,Europe
2033,Lucas Paquetá,BRA,West Ham,Premier League,2023,25.0,1997.0,29.1,71,48,38,26,7,25,52,48.1,27,28,1,27,21,92,28,2,"FW,MF",25-29,Forward,Brazil,South America
2036,Kevin Paredes,USA,Wolfsburg,Bundesliga,2023,20.0,2003.0,15.9,42,21,22,13,7,20,34,58.8,14,27,2,25,23,65,26,0,"FW,MF",20-24,Forward,United States,North America
2037,Leandro Paredes,ARG,Roma,Serie A,2023,29.0,1994.0,29.3,57,36,30,22,5,33,77,42.9,44,26,7,19,29,86,43,1,MF,25-29,Midfielder,Argentina,South America
2039,Fabiano Parisi,ITA,Fiorentina,Serie A,2023,22.0,2000.0,16.2,30,15,11,12,7,15,26,57.7,11,21,5,16,17,47,26,0,DF,20-24,Defender,Italy,Europe
2040,Ben Parkinson,ENG,Newcastle Utd,Premier League,2023,18.0,2005.0,0.3,0,0,0,0,0,0,0,,0,1,0,1,0,0,1,0,FW,Under 20,Forward,England,Europe
2041,Thomas Partey,GHA,Arsenal,Premier League,2023,30.0,1993.0,8.8,14,11,9,4,1,5,10,50.0,5,9,3,6,11,25,9,0,"MF,DF",30-34,Midfielder,Ghana,Africa
2042,Mario Pašalić,CRO,Atalanta,Serie A,2023,28.0,1995.0,22.8,28,17,9,18,1,14,31,45.2,17,29,6,23,16,44,34,0,MF,25-29,Midfielder,Croatia,Europe
2043,Triantafyllos Pasaridīs,GRE,Salernitana,Serie A,2023,27.0,1996.0,5.0,11,7,9,2,0,9,14,64.3,5,7,3,4,3,14,19,0,DF,25-29,Defender,Greece,Europe
2045,Felix Passlack,GER,Bochum,Bundesliga,2023,25.0,1998.0,10.7,21,14,9,10,2,14,24,58.3,10,13,2,11,10,31,21,0,DF,25-29,Defender,Germany,Europe
2047,Rui Patrício,POR,Roma,Serie A,2023,35.0,1988.0,23.0,0,0,0,0,0,0,1,0.0,1,1,0,1,0,0,3,1,GK,35-39,Goalkeeper,Portugal,Europe
2048,Nathan Patterson,SCO,Everton,Premier League,2023,21.0,2001.0,11.2,34,24,21,11,2,14,37,37.8,23,14,3,11,9,43,33,0,DF,20-24,Defender,Scotland,Europe
32,Julen Agirrezabala,ESP,Athletic Club,La Liga,2023,22.0,2000.0,2.6,0,0,0,0,0,0,0,,0,0,0,0,0,0,0,0,GK,20-24,Goalkeeper,Spain,Europe
45,Kristoffer Ajer,NOR,Brentford,Premier League,2023,25.0,1998.0,20.4,38,21,25,9,4,23,36,63.9,13,26,11,15,25,63,79,1,DF,25-29,Defender,Norway,Europe
51,Sergio Akieme,ESP,Almería,La Liga,2023,25.0,1997.0,18.6,27,15,18,7,2,13,16,81.3,3,14,4,10,10,37,34,0,DF,25-29,Defender,Spain,Europe
52,Sergio Akieme,ESP,Reims,Ligue 1,2023,25.0,1997.0,9.1,11,5,6,3,2,8,11,72.7,3,9,3,6,10,21,25,0,DF,25-29,Defender,Spain,Europe
61,Luis Alberto,ESP,Lazio,Serie A,2023,30.0,1992.0,25.7,35,20,16,12,7,15,53,28.3,38,34,4,30,7,42,13,0,MF,30-34,Midfielder,Spain,Europe
62,Raúl Albiol,ESP,Villarreal,La Liga,2023,37.0,1985.0,22.6,25,14,15,9,1,18,27,66.7,9,31,24,7,16,41,102,0,DF,35-39,Defender,Spain,Europe
63,Thiago Alcántara,ESP,Liverpool,Premier League,2023,32.0,1991.0,0.1,0,0,0,0,0,0,0,,0,0,0,0,0,0,0,0,MF,30-34,Midfielder,Spain,Europe
65,Rubén Alcaraz,ESP,Cádiz,La Liga,2023,32.0,1991.0,34.8,97,59,39,52,6,50,121,41.3,71,60,14,46,33,130,55,2,MF,30-34,Midfielder,Spain,Europe
67,Iván Alejo,ESP,Cádiz,La Liga,2023,28.0,1995.0,18.8,40,23,23,11,6,17,57,29.8,40,20,0,20,7,47,17,0,MF,25-29,Midfielder,Spain,Europe
68,Carles Aleñá,ESP,Getafe,La Liga,2023,25.0,1998.0,11.3,24,8,7,14,3,10,24,41.7,14,14,3,11,4,28,13,0,MF,25-29,Midfielder,Spain,Europe
81,Marcos Alonso,ESP,Barcelona,La Liga,2023,32.0,1990.0,2.8,5,3,2,3,0,3,4,75.0,1,2,0,2,4,9,6,0,DF,30-34,Defender,Spain,Europe
82,Adrià Altimira,ESP,Villarreal,La Liga,2023,22.0,2001.0,8.6,16,7,9,6,1,9,24,37.5,15,18,5,13,5,21,18,0,"DF,MF",20-24,Defender,Spain,Europe
83,Sergi Altimira,ESP,Betis,La Liga,2023,21.0,2001.0,6.3,15,8,8,6,1,11,23,47.8,12,12,1,11,9,24,10,0,MF,20-24,Midfielder,Spain,Europe
86,Hugo Álvarez,ESP,Celta Vigo,La Liga,2023,20.0,2003.0,8.5,14,9,8,3,3,9,20,45.0,11,4,1,3,5,19,9,0,"MF,DF",20-24,Midfielder,Spain,Europe
88,Yeray Álvarez,ESP,Athletic Club,La Liga,2023,28.0,1995.0,12.8,18,9,15,3,0,12,19,63.2,7,8,5,3,11,29,34,1,DF,25-29,Defender,Spain,Europe
108,Komnen Andrić,SRB,Clermont Foot,Ligue 1,2023,28.0,1995.0,1.9,2,1,0,1,1,0,4,0.0,4,2,0,2,0,2,1,0,FW,25-29,Forward,Serbia,Europe
110,Miguel Ángel Rubio,ESP,Granada,La Liga,2023,25.0,1998.0,17.3,20,12,14,6,0,14,21,66.7,7,31,18,13,28,48,74,2,DF,25-29,Defender,Spain,Europe
111,Angeliño,ESP,Roma,Serie A,2023,26.0,1997.0,12.7,21,11,12,6,3,11,19,57.9,8,11,5,6,12,33,37,1,DF,25-29,Defender,Spain,Europe
130,Adu Ares,ESP,Athletic Club,La Liga,2023,21.0,2001.0,2.9,8,4,4,2,2,2,3,66.7,1,1,0,1,1,9,0,0,FW,20-24,Forward,Spain,Europe
131,Jesús Areso,ESP,Osasuna,La Liga,2023,24.0,1999.0,29.6,45,24,25,13,7,31,38,81.6,7,36,15,21,18,63,58,0,DF,20-24,Defender,Spain,Europe
134,Iñigo Arguibide,ESP,Osasuna,La Liga,2023,18.0,2005.0,0.2,1,0,0,1,0,0,0,,0,0,0,0,0,1,1,0,DF,Under 20,Defender,Spain,Europe
136,José Arnaiz,ESP,Osasuna,La Liga,2023,28.0,1995.0,10.3,14,8,6,4,4,6,21,28.6,15,11,2,9,3,17,2,0,"FW,MF",25-29,Forward,Spain,Europe
141,Sergio Arribas,ESP,Almería,La Liga,2023,21.0,2001.0,22.7,34,17,16,17,1,14,31,45.2,17,20,1,19,16,50,8,1,"MF,FW",20-24,Midfielder,Spain,Europe
141,Sergio Arribas,ESP,Almería,La Liga,2023,21.0,2001.0,22.7,34,17,16,17,1,14,31,45.2,17,20,1,19,16,50,8,1,"MF,FW",20-24,Midfielder,Spain,Europe
141,Sergio Arribas,ESP,Almería,La Liga,2023,21.0,2001.0,22.7,34,17,16,17,1,14,31,45.2,17,20,1,19,16,50,8,1,"MF,FW",20-24,Midfielder,Spain,Europe
141,Sergio Arribas,ESP,Almería,La Liga,2023,21.0,2001.0,22.7,34,17,16,17,1,14,31,45.2,17,20,1,19,16,50,8,1,"MF,FW",20-24,Midfielder,Spain,Europe
142,Kepa Arrizabalaga,ESP,Real Madrid,La Liga,2023,28.0,1994.0,13.3,0,0,0,0,0,0,1,0.0,1,0,0,0,0,0,4,0,GK,25-29,Goalkeeper,Spain,Europe
145,Marco Asensio,ESP,Paris S-G,Ligue 1,2023,27.0,1996.0,12.4,12,10,4,7,1,4,13,30.8,9,7,0,7,5,17,2,0,"MF,FW",25-29,Midfielder,Spain,Europe
149,Iago Aspas,ESP,Celta Vigo,La Liga,2023,35.0,1987.0,30.1,11,6,4,6,1,1,15,6.7,14,23,3,20,10,21,8,0,FW,35-39,Forward,Spain,Europe
150,Lorenz Assignon,TOG,Burnley,Premier League,2023,23.0,2000.0,13.7,35,17,18,13,4,14,27,51.9,13,22,7,15,19,54,43,1,DF,20-24,Defender,Togo,Africa
151,Lorenz Assignon,TOG,Rennes,Ligue 1,2023,23.0,2000.0,11.2,24,12,12,8,4,9,24,37.5,15,9,4,5,9,33,27,1,DF,20-24,Defender,Togo,Africa
169,César Azpilicueta,ESP,Atlético Madrid,La Liga,2023,33.0,1989.0,15.8,25,14,15,9,1,12,19,63.2,7,25,6,19,16,41,46,0,DF,30-34,Defender,Spain,Europe
174,Srđan Babić,SRB,Almería,La Liga,2023,27.0,1996.0,1.0,2,2,0,2,0,1,1,100.0,0,1,1,0,0,2,2,0,DF,25-29,Defender,Serbia,Europe
181,Alex Baena,ESP,Villarreal,La Liga,2023,22.0,2001.0,28.7,34,21,10,16,8,20,47,42.6,27,23,2,21,13,47,17,1,"MF,FW",20-24,Midfielder,Spain,Europe
186,Stefan Bajcetic,ESP,Liverpool,Premier League,2023,18.0,2004.0,0.3,4,1,3,1,0,3,5,60.0,2,0,0,0,0,4,0,0,MF,Under 20,Midfielder,Spain,Europe
195,Alejandro Balde,ESP,Barcelona,La Liga,2023,19.0,2003.0,15.3,20,11,11,6,3,7,11,63.6,4,14,1,13,5,25,21,1,DF,Under 20,Defender,Spain,Europe
212,Antonín Barák,CZE,Fiorentina,Serie A,2023,28.0,1994.0,9.0,6,2,1,3,2,3,7,42.9,4,5,0,5,2,8,4,0,"MF,FW",25-29,Midfielder,Czech Republic,Europe
218,Kike Barja,ESP,Osasuna,La Liga,2023,26.0,1997.0,3.4,6,2,2,2,2,3,8,37.5,5,2,1,1,2,8,2,0,"FW,MF",25-29,Forward,Spain,Europe
224,Ander Barrenetxea,ESP,Real Sociedad,La Liga,2023,21.0,2001.0,15.9,32,21,7,16,9,10,26,38.5,16,18,1,17,6,38,5,0,"FW,MF",20-24,Forward,Spain,Europe
225,Pablo Barrios,ESP,Atlético Madrid,La Liga,2023,20.0,2003.0,17.3,45,25,15,29,1,19,40,47.5,21,20,3,17,28,73,24,2,MF,20-24,Midfielder,Spain,Europe
227,Marc Bartra,ESP,Betis,La Liga,2023,32.0,1991.0,2.5,4,3,3,1,0,4,5,80.0,1,3,1,2,3,7,10,0,DF,30-34,Defender,Spain,Europe
242,Ihlas Bebou,TOG,Hoffenheim,Bundesliga,2023,29.0,1994.0,18.2,22,12,10,8,4,8,16,50.0,8,13,2,11,14,36,15,0,"FW,DF",25-29,Forward,Togo,Africa
264,Héctor Bellerín,ESP,Betis,La Liga,2023,28.0,1995.0,19.0,34,22,14,16,4,20,53,37.7,33,13,5,8,22,56,40,1,DF,25-29,Defender,Spain,Europe
269,Fran Beltrán,ESP,Celta Vigo,La Liga,2023,24.0,1999.0,27.0,56,32,22,23,11,24,63,38.1,39,28,2,26,18,74,34,0,MF,20-24,Midfielder,Spain,Europe
284,Yuri Berchiche,ESP,Athletic Club,La Liga,2023,33.0,1990.0,21.4,33,25,13,14,6,19,33,57.6,14,28,9,19,20,53,62,0,DF,30-34,Defender,Spain,Europe
285,Álex Berenguer,ESP,Athletic Club,La Liga,2023,28.0,1995.0,17.7,23,14,9,9,5,7,24,29.2,17,23,0,23,5,28,13,0,FW,25-29,Forward,Spain,Europe
286,Bartosz Bereszyński,POL,Empoli,Serie A,2023,31.0,1992.0,19.6,41,25,25,13,3,24,40,60.0,16,22,10,12,21,62,52,0,DF,30-34,Defender,Poland,Europe
288,Sander Berge,NOR,Burnley,Premier League,2023,25.0,1998.0,33.4,76,46,35,36,5,34,58,58.6,24,49,20,29,23,99,60,2,MF,25-29,Midfielder,Norway,Europe
304,Pep Biel,ESP,Augsburg,Bundesliga,2023,26.0,1996.0,3.2,4,3,0,2,2,1,3,33.3,2,2,1,1,2,6,2,0,"MF,FW",25-29,Midfielder,Spain,Europe
305,Jaka Bijol,SVN,Udinese,Serie A,2023,24.0,1999.0,23.2,43,27,34,9,0,22,35,62.9,13,36,21,15,23,66,140,1,DF,20-24,Defender,Slovenia,Europe
315,Antonio Blanco,ESP,Alavés,La Liga,2023,23.0,2000.0,27.0,61,36,29,27,5,31,86,36.0,55,25,2,23,35,96,30,0,MF,20-24,Midfielder,Spain,Europe
316,Rubén Blanco,ESP,Marseille,Ligue 1,2023,28.0,1995.0,1.3,0,0,0,0,0,0,0,,0,0,0,0,0,0,0,0,GK,25-29,Goalkeeper,Spain,Europe
325,Oscar Bobb,NOR,Manchester City,Premier League,2023,20.0,2003.0,3.4,7,3,1,2,4,2,4,50.0,2,4,0,4,5,12,1,0,"FW,MF",20-24,Forward,Norway,Europe
329,Emil Bohinen,NOR,Genoa,Serie A,2023,24.0,1999.0,0.6,1,1,0,1,0,0,0,,0,1,0,1,0,1,3,0,MF,20-24,Midfielder,Norway,Europe
330,Emil Bohinen,NOR,Salernitana,Serie A,2023,24.0,1999.0,5.9,8,6,5,3,0,2,10,20.0,8,8,2,6,14,22,6,1,MF,20-24,Midfielder,Norway,Europe
347,Adri Bosch,ESP,Granada,La Liga,2023,22.0,2001.0,0.3,1,1,1,0,0,0,0,,0,0,0,0,0,1,1,0,DF,20-24,Defender,Spain,Europe
348,Erik Botheim,NOR,Salernitana,Serie A,2023,23.0,2000.0,3.5,2,0,2,0,0,0,1,0.0,1,3,0,3,0,2,2,0,"FW,MF",20-24,Forward,Norway,Europe
365,Conor Bradley,NIR,Liverpool,Premier League,2023,20.0,2003.0,8.4,33,25,14,12,7,24,38,63.2,14,17,1,16,10,43,14,0,DF,20-24,Defender,Northern Ireland,Europe
370,Darko Brašanac,SRB,Osasuna,La Liga,2023,31.0,1992.0,0.5,1,0,1,0,0,1,1,100.0,0,1,0,1,0,1,0,0,MF,30-34,Midfielder,Serbia,Europe
372,Brau,ESP,Granada,La Liga,2023,21.0,2001.0,0.3,1,0,1,0,0,1,1,100.0,0,0,0,0,0,1,2,0,DF,20-24,Defender,Spain,Europe
398,Hugo Bueno,ESP,Wolves,Premier League,2023,20.0,2002.0,8.2,21,14,12,7,2,12,19,63.2,7,17,4,13,6,27,24,0,"DF,MF",20-24,Defender,Spain,Europe
399,Manu Bueno,ESP,Sevilla,La Liga,2023,19.0,2004.0,1.3,4,2,4,0,0,3,3,100.0,0,3,0,3,0,4,1,0,MF,Under 20,Midfielder,Spain,Europe
412,Pablo Busto,ESP,Betis,La Liga,2023,17.0,2005.0,0.5,1,1,0,0,1,1,1,100.0,0,0,0,0,1,2,3,0,DF,Under 20,Defender,Spain,Europe
414,Marcin Bułka,POL,Nice,Ligue 1,2023,23.0,1999.0,34.0,0,0,0,0,0,0,2,0.0,2,0,0,0,0,0,9,3,GK,20-24,Goalkeeper,Poland,Europe
428,José Callejón,ESP,Granada,La Liga,2023,36.0,1987.0,8.9,13,6,10,3,0,8,22,36.4,14,7,1,6,5,18,10,0,"MF,FW",35-39,Midfielder,Spain,Europe
438,Sergio Camello,ESP,Rayo Vallecano,La Liga,2023,22.0,2001.0,18.5,16,5,3,10,3,6,15,40.0,9,10,2,8,3,19,15,0,FW,20-24,Forward,Spain,Europe
439,José Campaña,ESP,Las Palmas,La Liga,2023,30.0,1993.0,1.9,2,2,1,1,0,0,2,0.0,2,3,2,1,2,4,3,0,MF,30-34,Midfielder,Spain,Europe
446,Sergi Canós,ESP,Valencia,La Liga,2023,26.0,1997.0,13.7,23,13,7,11,5,10,24,41.7,14,14,2,12,11,34,9,0,"MF,FW",25-29,Midfielder,Spain,Europe
456,Isaac Carcelen,ESP,Cádiz,La Liga,2023,30.0,1993.0,29.0,50,31,30,15,5,25,45,55.6,20,24,7,17,27,77,87,2,DF,30-34,Defender,Spain,Europe
457,Cárdenas,ESP,Rayo Vallecano,La Liga,2023,26.0,1997.0,1.0,0,0,0,0,0,0,0,,0,0,0,0,0,0,1,0,GK,25-29,Goalkeeper,Spain,Europe
459,Marc Cardona,ESP,Las Palmas,La Liga,2023,28.0,1995.0,8.2,9,8,3,4,2,1,12,8.3,11,5,0,5,2,11,7,0,FW,25-29,Forward,Spain,Europe
460,Sergi Cardona,ESP,Las Palmas,La Liga,2023,24.0,1999.0,31.3,90,55,52,29,9,55,96,57.3,41,45,7,38,46,136,102,0,DF,20-24,Defender,Spain,Europe
464,Carmona,ESP,Getafe,La Liga,2023,21.0,2002.0,14.6,30,21,13,14,3,9,28,32.1,19,15,2,13,21,51,25,0,"DF,MF",20-24,Defender,Spain,Europe
467,Álvaro Carreras,ESP,Granada,La Liga,2023,20.0,2003.0,5.3,13,8,8,4,1,5,11,45.5,6,5,1,4,7,20,9,1,"MF,FW",20-24,Midfielder,Spain,Europe
470,Dani Carvajal,ESP,Real Madrid,La Liga,2023,31.0,1992.0,24.1,47,32,28,15,4,23,42,54.8,19,28,9,19,22,69,54,4,DF,30-34,Defender,Spain,Europe
474,Marc Casado,ESP,Barcelona,La Liga,2023,19.0,2003.0,0.2,1,1,1,0,0,1,1,100.0,0,0,0,0,1,2,2,0,MF,Under 20,Midfielder,Spain,Europe
478,Matty Cash,POL,Aston Villa,Premier League,2023,25.0,1997.0,23.8,54,31,24,24,6,29,59,49.2,30,35,14,21,18,72,59,0,DF,25-29,Defender,Poland,Europe
486,Samu Castillejo,ESP,Sassuolo,Serie A,2023,28.0,1995.0,6.0,12,10,5,5,2,7,19,36.8,12,16,1,15,1,13,3,0,"FW,MF",25-29,Forward,Spain,Europe
487,Jonny Castro,ESP,Wolves,Premier League,2023,29.0,1994.0,0.1,0,0,0,0,0,0,1,0.0,1,1,1,0,0,0,0,0,MF,25-29,Midfielder,Spain,Europe
491,Catena,ESP,Osasuna,La Liga,2023,28.0,1994.0,28.2,33,18,26,6,1,19,35,54.3,16,24,15,9,15,48,119,3,DF,25-29,Defender,Spain,Europe
494,Dani Ceballos,ESP,Real Madrid,La Liga,2023,26.0,1996.0,6.6,10,5,4,5,1,5,14,35.7,9,9,2,7,0,10,4,1,"MF,FW",25-29,Midfielder,Spain,Europe
495,Emil Ceide,NOR,Sassuolo,Serie A,2023,21.0,2001.0,2.0,2,2,1,1,0,1,1,100.0,0,6,1,5,0,2,0,0,"FW,MF",20-24,Forward,Norway,Europe
497,Álex Centelles,ESP,Almería,La Liga,2023,25.0,1997.0,10.9,11,6,9,2,0,8,18,44.4,10,5,2,3,18,29,29,0,DF,25-29,Defender,Spain,Europe
500,Václav Černý,CZE,Wolfsburg,Bundesliga,2023,25.0,1997.0,10.2,8,3,3,4,1,2,14,14.3,12,13,0,13,8,16,6,0,"FW,MF",25-29,Forward,Czech Republic,Europe
515,Pep Chavarría,ESP,Rayo Vallecano,La Liga,2023,25.0,1998.0,13.0,23,18,15,6,2,11,17,64.7,6,15,3,12,6,29,29,1,"DF,MF",25-29,Defender,Spain,Europe
525,Pedro Chirivella,ESP,Nantes,Ligue 1,2023,26.0,1997.0,28.8,50,28,20,29,1,30,76,39.5,46,22,5,17,31,81,28,0,MF,25-29,Midfielder,Spain,Europe
535,Chumi,ESP,Almería,La Liga,2023,24.0,1999.0,27.0,34,22,22,12,0,16,26,61.5,10,38,23,15,14,48,107,3,DF,20-24,Defender,Spain,Europe
536,Víctor Chust,ESP,Cádiz,La Liga,2023,23.0,2000.0,20.7,29,18,23,5,1,18,32,56.3,14,27,21,6,11,40,92,1,DF,20-24,Defender,Spain,Europe
548,Silvi Clúa,ESP,Girona,La Liga,2023,18.0,2005.0,0.0,2,0,2,0,0,2,2,100.0,0,1,0,1,0,2,0,0,MF,Under 20,Midfielder,Spain,Europe
561,Santi Comesaña,ESP,Villarreal,La Liga,2023,26.0,1996.0,18.4,44,26,15,21,8,19,38,50.0,19,33,9,24,22,66,27,1,MF,25-29,Midfielder,Spain,Europe
568,Copete,ESP,Mallorca,La Liga,2023,23.0,1999.0,14.8,45,27,27,17,1,30,43,69.8,13,12,6,6,32,77,47,1,DF,20-24,Defender,Spain,Europe
584,Jaume Costa,ESP,Mallorca,La Liga,2023,35.0,1988.0,18.7,38,22,23,10,5,18,29,62.1,11,14,4,10,16,54,35,0,DF,35-39,Defender,Spain,Europe
590,Vladimír Coufal,CZE,West Ham,Premier League,2023,30.0,1992.0,34.8,64,41,50,12,2,38,75,50.7,37,49,15,34,43,107,97,0,DF,30-34,Defender,Czech Republic,Europe
604,Cristian,ESP,Valencia,La Liga,2023,25.0,1998.0,0.6,0,0,0,0,0,0,0,,0,0,0,0,0,0,0,0,GK,25-29,Goalkeeper,Spain,Europe
604,Cristian,ESP,Valencia,La Liga,2023,25.0,1998.0,0.6,0,0,0,0,0,0,0,,0,0,0,0,0,0,0,0,GK,25-29,Goalkeeper,Spain,Europe
604,Cristian,ESP,Valencia,La Liga,2023,25.0,1998.0,0.6,0,0,0,0,0,0,0,,0,0,0,0,0,0,0,0,GK,25-29,Goalkeeper,Spain,Europe
604,Cristian,ESP,Valencia,La Liga,2023,25.0,1998.0,0.6,0,0,0,0,0,0,0,,0,0,0,0,0,0,0,0,GK,25-29,Goalkeeper,Spain,Europe
605,Juan Cruz Armada,ESP,Osasuna,La Liga,2023,31.0,1992.0,18.5,27,15,16,10,1,17,25,68.0,8,14,7,7,12,39,39,1,DF,30-34,Defender,Spain,Europe
607,Juan Cruz,ESP,Betis,La Liga,2023,23.0,2000.0,0.8,0,0,0,0,0,0,1,0.0,1,0,0,0,0,0,0,0,FW,20-24,Forward,Spain,Europe
607,Juan Cruz,ESP,Betis,La Liga,2023,23.0,2000.0,0.8,0,0,0,0,0,0,1,0.0,1,0,0,0,0,0,0,0,FW,20-24,Forward,Spain,Europe
607,Juan Cruz,ESP,Betis,La Liga,2023,23.0,2000.0,0.8,0,0,0,0,0,0,1,0.0,1,0,0,0,0,0,0,0,FW,20-24,Forward,Spain,Europe
607,Juan Cruz,ESP,Betis,La Liga,2023,23.0,2000.0,0.8,0,0,0,0,0,0,1,0.0,1,0,0,0,0,0,0,0,FW,20-24,Forward,Spain,Europe
609,Pau Cubarsí,ESP,Barcelona,La Liga,2023,16.0,2007.0,17.3,22,14,18,3,1,13,18,72.2,5,20,16,4,12,34,65,0,DF,Under 20,Defender,Spain,Europe
610,Marc Cucurella,ESP,Chelsea,Premier League,2023,25.0,1998.0,19.8,62,38,36,21,5,34,64,53.1,30,36,13,23,22,84,48,0,DF,25-29,Defender,Spain,Europe
611,Iván Cuéllar,ESP,Mallorca,La Liga,2023,39.0,1984.0,1.0,0,0,0,0,0,0,0,,0,0,0,0,0,0,0,0,GK,35-39,Goalkeeper,Spain,Europe
612,Jorge Cuenca,ESP,Villarreal,La Liga,2023,23.0,1999.0,21.8,42,29,26,10,6,19,30,63.3,11,26,15,11,21,63,114,0,DF,20-24,Defender,Spain,Europe
616,Eric Curbelo,ESP,Las Palmas,La Liga,2023,29.0,1994.0,1.1,4,3,2,2,0,3,4,75.0,1,3,1,2,2,6,5,1,"DF,MF",25-29,Defender,Spain,Europe
618,Tomáš Čvančara,CZE,Gladbach,Bundesliga,2023,22.0,2000.0,10.0,4,3,0,2,2,1,3,33.3,2,5,1,4,2,6,8,0,FW,20-24,Forward,Czech Republic,Europe
620,Alberto Dadie,ESP,Real Sociedad,La Liga,2023,21.0,2002.0,0.3,2,1,2,0,0,0,0,,0,1,0,1,0,2,0,0,MF,20-24,Midfielder,Spain,Europe
636,Raimane Daou,COM,Marseille,Ligue 1,2023,18.0,2004.0,0.3,1,1,1,0,0,1,2,50.0,1,0,0,0,0,1,2,0,"DF,MF",Under 20,Defender,Comoros,Africa
638,Sergi Darder,ESP,Mallorca,La Liga,2023,29.0,1993.0,24.0,39,26,13,21,5,12,31,38.7,19,20,4,16,16,55,16,0,MF,25-29,Midfielder,Spain,Europe
651,Paweł Dawidowicz,POL,Hellas Verona,Serie A,2023,28.0,1995.0,23.8,53,30,33,18,2,17,29,58.6,12,17,9,8,24,77,114,1,DF,25-29,Defender,Poland,Europe
697,Assane Diao,ESP,Betis,La Liga,2023,17.0,2005.0,11.6,20,12,5,9,6,6,17,35.3,11,22,4,18,7,27,7,0,FW,Under 20,Forward,Spain,Europe
706,Víctor Díaz,ESP,Granada,La Liga,2023,35.0,1988.0,1.8,5,3,2,3,0,1,3,33.3,2,1,0,1,1,6,8,0,"DF,MF",35-39,Defender,Spain,Europe
728,Djené,TOG,Getafe,La Liga,2023,31.0,1991.0,27.6,34,19,18,13,3,15,26,57.7,11,31,15,16,23,57,70,0,"DF,MF",30-34,Defender,Togo,Africa
731,Marko Dmitrović,SRB,Sevilla,La Liga,2023,31.0,1992.0,13.0,1,1,1,0,0,1,2,50.0,1,0,0,0,1,2,5,0,GK,30-34,Goalkeeper,Serbia,Europe
742,Jaume Doménech,ESP,Valencia,La Liga,2023,32.0,1990.0,0.9,0,0,0,0,0,0,0,,0,0,0,0,0,0,0,0,GK,30-34,Goalkeeper,Spain,Europe
743,Carlos Dominguez,ESP,Celta Vigo,La Liga,2023,22.0,2001.0,17.6,33,21,17,9,7,23,37,62.2,14,24,12,12,22,55,78,0,DF,20-24,Defender,Spain,Europe
744,Mario Dominguez,ESP,Valencia,La Liga,2023,19.0,2004.0,0.3,0,0,0,0,0,0,0,,0,0,0,0,0,0,0,0,FW,Under 20,Forward,Spain,Europe
753,Carlos Dotor,ESP,Celta Vigo,La Liga,2023,22.0,2001.0,7.9,14,7,3,8,3,4,13,30.8,9,12,2,10,4,18,4,0,MF,20-24,Midfielder,Spain,Europe
773,Rubén Duarte,ESP,Alavés,La Liga,2023,27.0,1995.0,20.9,39,20,21,16,2,21,31,67.7,10,21,6,15,23,62,69,0,DF,25-29,Defender,Spain,Europe
783,Hugo Duro,ESP,Valencia,La Liga,2023,23.0,1999.0,33.1,16,8,5,8,3,9,29,31.0,20,24,5,19,5,21,27,0,FW,20-24,Forward,Spain,Europe
786,Aron Dønnum,NOR,Toulouse,Ligue 1,2023,25.0,1998.0,17.7,16,10,3,8,5,7,22,31.8,15,13,0,13,8,24,16,1,"FW,MF",25-29,Forward,Norway,Europe
810,Aritz Elustondo,ESP,Real Sociedad,La Liga,2023,29.0,1994.0,9.0,11,7,5,4,2,6,14,42.9,8,12,10,2,7,18,26,0,DF,25-29,Defender,Spain,Europe
812,Adri Embarba,ESP,Almería,La Liga,2023,31.0,1992.0,27.5,55,37,29,15,11,26,53,49.1,27,37,1,36,15,70,12,0,"FW,MF",30-34,Forward,Spain,Europe
823,Aarón Escandell,ESP,Las Palmas,La Liga,2023,27.0,1995.0,1.7,0,0,0,0,0,0,0,,0,0,0,0,0,0,1,1,GK,25-29,Goalkeeper,Spain,Europe
831,Jonny Evans,NIR,Manchester Utd,Premier League,2023,35.0,1988.0,15.5,22,14,20,2,0,12,21,57.1,9,25,18,7,23,45,76,0,DF,35-39,Defender,Northern Ireland,Europe
836,Łukasz Fabiański,POL,West Ham,Premier League,2023,38.0,1985.0,8.0,1,0,1,0,0,1,2,50.0,1,0,0,0,1,2,4,0,GK,35-39,Goalkeeper,Poland,Europe
843,Fali,ESP,Cádiz,La Liga,2023,29.0,1993.0,28.3,41,26,29,11,1,21,36,58.3,15,38,24,14,27,68,120,0,DF,25-29,Defender,Spain,Europe
846,Ansu Fati,ESP,Brighton,Premier League,2023,20.0,2002.0,5.8,5,3,1,2,2,1,11,9.1,10,8,0,8,3,8,3,0,"MF,FW",20-24,Midfielder,Spain,Europe
847,Ansu Fati,ESP,Barcelona,La Liga,2023,20.0,2002.0,0.6,0,0,0,0,0,0,1,0.0,1,0,0,0,0,0,0,0,"MF,FW",20-24,Midfielder,Spain,Europe
857,Kiko Femenía,ESP,Villarreal,La Liga,2023,32.0,1991.0,17.6,35,25,19,13,3,19,34,55.9,15,21,6,15,31,66,45,0,DF,30-34,Defender,Spain,Europe
862,Aitor Fernández,ESP,Osasuna,La Liga,2023,32.0,1991.0,6.1,0,0,0,0,0,0,1,0.0,1,0,0,0,0,0,5,1,GK,30-34,Goalkeeper,Spain,Europe
862,Aitor Fernández,ESP,Osasuna,La Liga,2023,32.0,1991.0,6.1,0,0,0,0,0,0,1,0.0,1,0,0,0,0,0,5,1,GK,30-34,Goalkeeper,Spain,Europe
862,Aitor Fernández,ESP,Osasuna,La Liga,2023,32.0,1991.0,6.1,0,0,0,0,0,0,1,0.0,1,0,0,0,0,0,5,1,GK,30-34,Goalkeeper,Spain,Europe
862,Aitor Fernández,ESP,Osasuna,La Liga,2023,32.0,1991.0,6.1,0,0,0,0,0,0,1,0.0,1,0,0,0,0,0,5,1,GK,30-34,Goalkeeper,Spain,Europe
863,Álex Fernández,ESP,Cádiz,La Liga,2023,30.0,1992.0,14.3,19,9,10,9,0,11,22,50.0,11,17,5,12,15,34,30,0,MF,30-34,Midfielder,Spain,Europe
864,Carlos Fernández,ESP,Real Sociedad,La Liga,2023,27.0,1996.0,4.5,11,7,3,6,2,0,2,0.0,2,4,0,4,0,11,5,0,FW,25-29,Forward,Spain,Europe
866,Raúl Fernández,ESP,Granada,La Liga,2023,35.0,1988.0,3.1,0,0,0,0,0,0,1,0.0,1,0,0,0,0,0,1,2,GK,35-39,Goalkeeper,Spain,Europe
867,Valery Fernández,ESP,Girona,La Liga,2023,23.0,1999.0,5.6,11,9,4,7,0,6,8,75.0,2,6,1,5,1,12,4,0,"MF,FW",20-24,Midfielder,Spain,Europe
868,Fernando,ESP,Almería,La Liga,2023,33.0,1990.0,4.0,0,0,0,0,0,0,0,,0,1,0,1,0,0,2,0,GK,30-34,Goalkeeper,Spain,Europe
868,Fernando,ESP,Almería,La Liga,2023,33.0,1990.0,4.0,0,0,0,0,0,0,0,,0,1,0,1,0,0,2,0,GK,30-34,Goalkeeper,Spain,Europe
868,Fernando,ESP,Almería,La Liga,2023,33.0,1990.0,4.0,0,0,0,0,0,0,0,,0,1,0,1,0,0,2,0,GK,30-34,Goalkeeper,Spain,Europe
868,Fernando,ESP,Almería,La Liga,2023,33.0,1990.0,4.0,0,0,0,0,0,0,0,,0,1,0,1,0,0,2,0,GK,30-34,Goalkeeper,Spain,Europe
868,Fernando,ESP,Almería,La Liga,2023,33.0,1990.0,4.0,0,0,0,0,0,0,0,,0,1,0,1,0,0,2,0,GK,30-34,Goalkeeper,Spain,Europe
868,Fernando,ESP,Almería,La Liga,2023,33.0,1990.0,4.0,0,0,0,0,0,0,0,,0,1,0,1,0,0,2,0,GK,30-34,Goalkeeper,Spain,Europe
868,Fernando,ESP,Almería,La Liga,2023,33.0,1990.0,4.0,0,0,0,0,0,0,0,,0,1,0,1,0,0,2,0,GK,30-34,Goalkeeper,Spain,Europe
868,Fernando,ESP,Almería,La Liga,2023,33.0,1990.0,4.0,0,0,0,0,0,0,0,,0,1,0,1,0,0,2,0,GK,30-34,Goalkeeper,Spain,Europe
868,Fernando,ESP,Almería,La Liga,2023,33.0,1990.0,4.0,0,0,0,0,0,0,0,,0,1,0,1,0,0,2,0,GK,30-34,Goalkeeper,Spain,Europe
868,Fernando,ESP,Almería,La Liga,2023,33.0,1990.0,4.0,0,0,0,0,0,0,0,,0,1,0,1,0,0,2,0,GK,30-34,Goalkeeper,Spain,Europe
868,Fernando,ESP,Almería,La Liga,2023,33.0,1990.0,4.0,0,0,0,0,0,0,0,,0,1,0,1,0,0,2,0,GK,30-34,Goalkeeper,Spain,Europe
868,Fernando,ESP,Almería,La Liga,2023,33.0,1990.0,4.0,0,0,0,0,0,0,0,,0,1,0,1,0,0,2,0,GK,30-34,Goalkeeper,Spain,Europe
868,Fernando,ESP,Almería,La Liga,2023,33.0,1990.0,4.0,0,0,0,0,0,0,0,,0,1,0,1,0,0,2,0,GK,30-34,Goalkeeper,Spain,Europe
868,Fernando,ESP,Almería,La Liga,2023,33.0,1990.0,4.0,0,0,0,0,0,0,0,,0,1,0,1,0,0,2,0,GK,30-34,Goalkeeper,Spain,Europe
868,Fernando,ESP,Almería,La Liga,2023,33.0,1990.0,4.0,0,0,0,0,0,0,0,,0,1,0,1,0,0,2,0,GK,30-34,Goalkeeper,Spain,Europe
868,Fernando,ESP,Almería,La Liga,2023,33.0,1990.0,4.0,0,0,0,0,0,0,0,,0,1,0,1,0,0,2,0,GK,30-34,Goalkeeper,Spain,Europe
875,Nacho Ferri,ESP,Eint Frankfurt,Bundesliga,2023,18.0,2004.0,0.8,3,3,1,2,0,2,3,66.7,1,0,0,0,0,3,2,0,"FW,MF",Under 20,Forward,Spain,Europe
892,Pablo Fornals,ESP,West Ham,Premier League,2023,27.0,1996.0,4.7,10,6,4,3,3,5,16,31.3,11,8,1,7,6,16,7,0,"MF,FW",25-29,Midfielder,Spain,Europe
893,Pablo Fornals,ESP,Betis,La Liga,2023,27.0,1996.0,12.8,24,16,8,11,5,12,22,54.5,10,14,0,14,22,46,10,2,"FW,MF",25-29,Forward,Spain,Europe
897,Héctor Fort,ESP,Barcelona,La Liga,2023,16.0,2006.0,3.5,6,5,5,1,0,4,10,40.0,6,0,0,0,2,8,4,0,DF,Under 20,Defender,Spain,Europe
903,Przemysław Frankowski,POL,Lens,Ligue 1,2023,28.0,1995.0,24.4,60,39,25,26,9,31,74,41.9,43,30,7,23,25,85,36,0,DF,25-29,Defender,Poland,Europe
911,Jorge de Frutos,ESP,Rayo Vallecano,La Liga,2023,26.0,1997.0,17.2,19,8,5,8,6,7,22,31.8,15,12,0,12,7,26,18,0,"FW,MF",25-29,Forward,Spain,Europe
925,Javi Galán,ESP,Atlético Madrid,La Liga,2023,28.0,1994.0,1.0,5,4,2,2,1,4,5,80.0,1,1,0,1,1,6,3,0,DF,25-29,Defender,Spain,Europe
926,Javi Galán,ESP,Real Sociedad,La Liga,2023,28.0,1994.0,11.9,38,22,15,19,4,15,30,50.0,15,24,1,23,14,52,17,1,DF,25-29,Defender,Spain,Europe
927,Iñigo Ruiz de Galarreta,ESP,Athletic Club,La Liga,2023,29.0,1993.0,23.2,49,31,15,26,8,24,49,49.0,25,18,5,13,12,61,17,0,MF,25-29,Midfielder,Spain,Europe
935,Aleix García,ESP,Girona,La Liga,2023,26.0,1997.0,35.5,49,28,17,26,6,28,54,51.9,26,45,17,28,36,85,53,3,MF,25-29,Midfielder,Spain,Europe
936,Álvaro García,ESP,Rayo Vallecano,La Liga,2023,30.0,1992.0,27.5,34,25,15,10,9,7,34,20.6,27,35,0,35,36,70,33,0,"FW,MF",30-34,Forward,Spain,Europe
936,Álvaro García,ESP,Rayo Vallecano,La Liga,2023,30.0,1992.0,27.5,34,25,15,10,9,7,34,20.6,27,35,0,35,36,70,33,0,"FW,MF",30-34,Forward,Spain,Europe
936,Álvaro García,ESP,Rayo Vallecano,La Liga,2023,30.0,1992.0,27.5,34,25,15,10,9,7,34,20.6,27,35,0,35,36,70,33,0,"FW,MF",30-34,Forward,Spain,Europe
936,Álvaro García,ESP,Rayo Vallecano,La Liga,2023,30.0,1992.0,27.5,34,25,15,10,9,7,34,20.6,27,35,0,35,36,70,33,0,"FW,MF",30-34,Forward,Spain,Europe
936,Álvaro García,ESP,Rayo Vallecano,La Liga,2023,30.0,1992.0,27.5,34,25,15,10,9,7,34,20.6,27,35,0,35,36,70,33,0,"FW,MF",30-34,Forward,Spain,Europe
936,Álvaro García,ESP,Rayo Vallecano,La Liga,2023,30.0,1992.0,27.5,34,25,15,10,9,7,34,20.6,27,35,0,35,36,70,33,0,"FW,MF",30-34,Forward,Spain,Europe
936,Álvaro García,ESP,Rayo Vallecano,La Liga,2023,30.0,1992.0,27.5,34,25,15,10,9,7,34,20.6,27,35,0,35,36,70,33,0,"FW,MF",30-34,Forward,Spain,Europe
936,Álvaro García,ESP,Rayo Vallecano,La Liga,2023,30.0,1992.0,27.5,34,25,15,10,9,7,34,20.6,27,35,0,35,36,70,33,0,"FW,MF",30-34,Forward,Spain,Europe
936,Álvaro García,ESP,Rayo Vallecano,La Liga,2023,30.0,1992.0,27.5,34,25,15,10,9,7,34,20.6,27,35,0,35,36,70,33,0,"FW,MF",30-34,Forward,Spain,Europe
936,Álvaro García,ESP,Rayo Vallecano,La Liga,2023,30.0,1992.0,27.5,34,25,15,10,9,7,34,20.6,27,35,0,35,36,70,33,0,"FW,MF",30-34,Forward,Spain,Europe
936,Álvaro García,ESP,Rayo Vallecano,La Liga,2023,30.0,1992.0,27.5,34,25,15,10,9,7,34,20.6,27,35,0,35,36,70,33,0,"FW,MF",30-34,Forward,Spain,Europe
936,Álvaro García,ESP,Rayo Vallecano,La Liga,2023,30.0,1992.0,27.5,34,25,15,10,9,7,34,20.6,27,35,0,35,36,70,33,0,"FW,MF",30-34,Forward,Spain,Europe
936,Álvaro García,ESP,Rayo Vallecano,La Liga,2023,30.0,1992.0,27.5,34,25,15,10,9,7,34,20.6,27,35,0,35,36,70,33,0,"FW,MF",30-34,Forward,Spain,Europe
936,Álvaro García,ESP,Rayo Vallecano,La Liga,2023,30.0,1992.0,27.5,34,25,15,10,9,7,34,20.6,27,35,0,35,36,70,33,0,"FW,MF",30-34,Forward,Spain,Europe
936,Álvaro García,ESP,Rayo Vallecano,La Liga,2023,30.0,1992.0,27.5,34,25,15,10,9,7,34,20.6,27,35,0,35,36,70,33,0,"FW,MF",30-34,Forward,Spain,Europe
936,Álvaro García,ESP,Rayo Vallecano,La Liga,2023,30.0,1992.0,27.5,34,25,15,10,9,7,34,20.6,27,35,0,35,36,70,33,0,"FW,MF",30-34,Forward,Spain,Europe
937,Dani García,ESP,Athletic Club,La Liga,2023,33.0,1990.0,8.3,17,11,4,7,6,12,24,50.0,12,9,3,6,8,25,11,0,MF,30-34,Midfielder,Spain,Europe
938,David García,ESP,Osasuna,La Liga,2023,29.0,1994.0,25.9,29,18,19,9,1,16,26,61.5,10,40,19,21,18,47,115,2,DF,25-29,Defender,Spain,Europe
938,David García,ESP,Osasuna,La Liga,2023,29.0,1994.0,25.9,29,18,19,9,1,16,26,61.5,10,40,19,21,18,47,115,2,DF,25-29,Defender,Spain,Europe
938,David García,ESP,Osasuna,La Liga,2023,29.0,1994.0,25.9,29,18,19,9,1,16,26,61.5,10,40,19,21,18,47,115,2,DF,25-29,Defender,Spain,Europe
938,David García,ESP,Osasuna,La Liga,2023,29.0,1994.0,25.9,29,18,19,9,1,16,26,61.5,10,40,19,21,18,47,115,2,DF,25-29,Defender,Spain,Europe
939,Eric García,ESP,Barcelona,La Liga,2023,22.0,2001.0,0.6,0,0,0,0,0,0,0,,0,1,1,0,0,0,0,0,DF,20-24,Defender,Spain,Europe
940,Eric García,ESP,Girona,La Liga,2023,22.0,2001.0,29.3,55,37,34,18,3,34,49,69.4,15,36,18,18,30,85,79,2,DF,20-24,Defender,Spain,Europe
941,Fran Garcia,ESP,Real Madrid,La Liga,2023,23.0,1999.0,15.5,25,17,11,12,2,13,31,41.9,18,16,3,13,19,44,28,1,DF,20-24,Defender,Spain,Europe
942,Gonzalo García,ESP,Real Madrid,La Liga,2023,19.0,2004.0,0.2,0,0,0,0,0,0,1,0.0,1,1,1,0,0,0,1,0,"FW,MF",Under 20,Forward,Spain,Europe
942,Gonzalo García,ESP,Real Madrid,La Liga,2023,19.0,2004.0,0.2,0,0,0,0,0,0,1,0.0,1,1,1,0,0,0,1,0,"FW,MF",Under 20,Forward,Spain,Europe
942,Gonzalo García,ESP,Real Madrid,La Liga,2023,19.0,2004.0,0.2,0,0,0,0,0,0,1,0.0,1,1,1,0,0,0,1,0,"FW,MF",Under 20,Forward,Spain,Europe
942,Gonzalo García,ESP,Real Madrid,La Liga,2023,19.0,2004.0,0.2,0,0,0,0,0,0,1,0.0,1,1,1,0,0,0,1,0,"FW,MF",Under 20,Forward,Spain,Europe
943,Jastin García,ESP,Girona,La Liga,2023,19.0,2004.0,0.4,1,0,0,0,1,0,0,,0,0,0,0,0,1,1,0,FW,Under 20,Forward,Spain,Europe
944,Raúl García,ESP,Athletic Club,La Liga,2023,37.0,1986.0,4.7,9,6,2,4,3,4,9,44.4,5,10,1,9,3,12,9,0,"FW,MF",35-39,Forward,Spain,Europe
944,Raúl García,ESP,Athletic Club,La Liga,2023,37.0,1986.0,4.7,9,6,2,4,3,4,9,44.4,5,10,1,9,3,12,9,0,"FW,MF",35-39,Forward,Spain,Europe
944,Raúl García,ESP,Athletic Club,La Liga,2023,37.0,1986.0,4.7,9,6,2,4,3,4,9,44.4,5,10,1,9,3,12,9,0,"FW,MF",35-39,Forward,Spain,Europe
944,Raúl García,ESP,Athletic Club,La Liga,2023,37.0,1986.0,4.7,9,6,2,4,3,4,9,44.4,5,10,1,9,3,12,9,0,"FW,MF",35-39,Forward,Spain,Europe
945,Rubén García,ESP,Osasuna,La Liga,2023,30.0,1993.0,17.2,32,18,8,17,7,13,33,39.4,20,23,3,20,12,44,23,0,"FW,MF",30-34,Forward,Spain,Europe
945,Rubén García,ESP,Osasuna,La Liga,2023,30.0,1993.0,17.2,32,18,8,17,7,13,33,39.4,20,23,3,20,12,44,23,0,"FW,MF",30-34,Forward,Spain,Europe
945,Rubén García,ESP,Osasuna,La Liga,2023,30.0,1993.0,17.2,32,18,8,17,7,13,33,39.4,20,23,3,20,12,44,23,0,"FW,MF",30-34,Forward,Spain,Europe
945,Rubén García,ESP,Osasuna,La Liga,2023,30.0,1993.0,17.2,32,18,8,17,7,13,33,39.4,20,23,3,20,12,44,23,0,"FW,MF",30-34,Forward,Spain,Europe
946,Santiago García,ESP,Getafe,La Liga,2023,21.0,2001.0,0.3,1,0,0,0,1,1,1,100.0,0,0,0,0,0,1,0,0,FW,20-24,Forward,Spain,Europe
946,Santiago García,ESP,Getafe,La Liga,2023,21.0,2001.0,0.3,1,0,0,0,1,1,1,100.0,0,0,0,0,0,1,0,0,FW,20-24,Forward,Spain,Europe
946,Santiago García,ESP,Getafe,La Liga,2023,21.0,2001.0,0.3,1,0,0,0,1,1,1,100.0,0,0,0,0,0,1,0,0,FW,20-24,Forward,Spain,Europe
946,Santiago García,ESP,Getafe,La Liga,2023,21.0,2001.0,0.3,1,0,0,0,1,1,1,100.0,0,0,0,0,0,1,0,0,FW,20-24,Forward,Spain,Europe
948,Unai García,ESP,Osasuna,La Liga,2023,31.0,1992.0,6.2,12,9,9,2,1,5,10,50.0,5,7,1,6,8,20,18,0,DF,30-34,Defender,Spain,Europe
952,Yarek Gasiorowski,ESP,Valencia,La Liga,2023,18.0,2005.0,8.2,22,12,14,5,3,13,19,68.4,6,15,8,7,15,37,50,1,DF,Under 20,Defender,Spain,Europe
956,Gavi,ESP,Barcelona,La Liga,2023,18.0,2004.0,10.5,39,21,20,14,5,18,36,50.0,18,19,3,16,8,47,16,1,"MF,FW",Under 20,Midfielder,Spain,Europe
960,Gelabert,ESP,Toulouse,Ligue 1,2023,22.0,2000.0,8.4,14,8,5,6,3,7,20,35.0,13,8,2,6,5,19,8,0,"MF,FW",20-24,Midfielder,Spain,Europe
972,Bryan Gil,ESP,Tottenham,Premier League,2023,22.0,2001.0,2.3,1,0,0,0,1,1,4,25.0,3,3,0,3,3,4,4,0,"FW,MF",20-24,Forward,Spain,Europe
973,David Gil,ESP,Cádiz,La Liga,2023,29.0,1994.0,4.1,0,0,0,0,0,0,1,0.0,1,0,0,0,0,0,3,0,GK,25-29,Goalkeeper,Spain,Europe
974,Mario Gila,ESP,Lazio,Serie A,2023,22.0,2000.0,20.1,32,14,23,8,1,19,34,55.9,15,27,14,13,20,52,69,0,DF,20-24,Defender,Spain,Europe
994,Moi Gómez,ESP,Osasuna,La Liga,2023,29.0,1994.0,22.3,30,19,7,19,4,9,24,37.5,15,15,1,14,11,41,22,0,"MF,FW",25-29,Midfielder,Spain,Europe
996,Sergio Gómez,ESP,Manchester City,Premier League,2023,22.0,2000.0,0.6,1,0,0,1,0,1,2,50.0,1,0,0,0,1,2,0,0,"FW,MF",20-24,Forward,Spain,Europe
997,Unai Gómez,ESP,Athletic Club,La Liga,2023,20.0,2003.0,9.7,12,10,2,6,4,5,10,50.0,5,13,2,11,2,14,9,0,MF,20-24,Midfielder,Spain,Europe
1000,Édgar González,ESP,Almería,La Liga,2023,26.0,1997.0,28.0,45,21,22,20,3,25,49,51.0,24,48,28,20,38,83,130,3,"DF,MF",25-29,Defender,Spain,Europe
1002,Fabio González,ESP,Las Palmas,La Liga,2023,26.0,1997.0,1.4,2,2,2,0,0,1,2,50.0,1,2,0,2,0,2,0,0,MF,25-29,Midfielder,Spain,Europe
1004,Hugo González,ESP,Valencia,La Liga,2023,20.0,2003.0,1.0,2,1,0,2,0,0,0,,0,0,0,0,0,2,0,0,"MF,FW",20-24,Midfielder,Spain,Europe
1005,Iñaki González,ESP,Las Palmas,La Liga,2023,19.0,2004.0,0.1,1,0,1,0,0,0,0,,0,0,0,0,0,1,1,0,MF,Under 20,Midfielder,Spain,Europe
1006,Joan Gonzàlez,ESP,Lecce,Serie A,2023,21.0,2002.0,14.3,31,18,16,12,3,17,28,60.7,11,20,3,17,5,36,9,0,MF,20-24,Midfielder,Spain,Europe
1008,Urko González,ESP,Real Sociedad,La Liga,2023,22.0,2001.0,1.7,4,1,0,3,1,2,2,100.0,0,1,0,1,1,5,6,0,MF,20-24,Midfielder,Spain,Europe
1014,Andoni Gorosabel,ESP,Alavés,La Liga,2023,26.0,1996.0,31.7,62,42,40,17,5,38,75,50.7,37,24,8,16,28,90,69,0,DF,25-29,Defender,Spain,Europe
1019,Pablo Gozalbez,ESP,Valencia,La Liga,2023,22.0,2001.0,1.1,1,0,0,0,1,1,6,16.7,5,0,0,0,1,2,2,0,"MF,FW",20-24,Midfielder,Spain,Europe
1035,Álex Grimaldo,ESP,Leverkusen,Bundesliga,2023,27.0,1995.0,30.9,45,24,26,10,9,30,55,54.5,25,32,7,25,22,67,41,0,DF,25-29,Defender,Spain,Europe
1040,Vicente Guaita,ESP,Celta Vigo,La Liga,2023,36.0,1987.0,26.7,1,1,1,0,0,1,2,50.0,1,0,0,0,0,1,9,1,GK,35-39,Goalkeeper,Spain,Europe
1042,Sergi Guardiola,ESP,Cádiz,La Liga,2023,32.0,1991.0,5.5,10,7,2,6,2,4,9,44.4,5,10,0,10,0,10,4,0,"FW,MF",30-34,Forward,Spain,Europe
1043,Nemanja Gudelj,SRB,Sevilla,La Liga,2023,31.0,1991.0,19.4,31,24,18,10,3,17,31,54.8,14,17,9,8,27,58,56,0,"DF,MF",30-34,Defender,Serbia,Europe
1050,Javier Guerra,ESP,Valencia,La Liga,2023,20.0,2003.0,27.8,54,24,25,22,7,22,58,37.9,36,27,7,20,18,72,44,0,MF,20-24,Midfielder,Spain,Europe
1054,Ander Guevara,ESP,Alavés,La Liga,2023,26.0,1997.0,32.6,59,32,28,25,6,31,64,48.4,33,34,12,22,13,72,46,1,MF,25-29,Midfielder,Spain,Europe
1059,Hugo Guillamón,ESP,Valencia,La Liga,2023,23.0,2000.0,14.6,24,15,7,14,3,11,17,64.7,6,8,3,5,12,36,25,2,MF,20-24,Midfielder,Spain,Europe
1062,Marc Guiu,ESP,Barcelona,La Liga,2023,17.0,2006.0,0.8,1,0,0,1,0,0,0,,0,0,0,0,0,1,0,0,"FW,MF",Under 20,Forward,Spain,Europe
1066,Gerard Gumbau,ESP,Granada,La Liga,2023,28.0,1994.0,29.7,55,34,21,30,4,23,62,37.1,39,24,5,19,25,80,30,2,MF,25-29,Midfielder,Spain,Europe
1067,Robert Gumny,POL,Augsburg,Bundesliga,2023,25.0,1998.0,5.3,6,5,1,3,2,1,5,20.0,4,13,5,8,7,13,15,0,DF,25-29,Defender,Poland,Europe
1070,Jon Guridi,ESP,Alavés,La Liga,2023,28.0,1995.0,29.8,42,24,10,27,5,12,45,26.7,33,23,3,20,22,64,22,0,MF,25-29,Midfielder,Spain,Europe
1071,Gorka Guruzeta,ESP,Athletic Club,La Liga,2023,26.0,1996.0,24.6,34,23,6,25,3,9,30,30.0,21,36,2,34,17,51,23,0,FW,25-29,Forward,Spain,Europe
1073,Miguel Gutiérrez,ESP,Girona,La Liga,2023,22.0,2001.0,33.7,29,18,11,14,4,13,35,37.1,22,27,11,16,22,51,66,2,DF,20-24,Defender,Spain,Europe
1078,Erling Haaland,NOR,Manchester City,Premier League,2023,23.0,2000.0,28.4,6,3,0,3,3,2,3,66.7,1,11,1,10,2,8,16,0,FW,20-24,Forward,Norway,Europe
1093,Andreas Hanche-Olsen,NOR,Mainz 05,Bundesliga,2023,26.0,1997.0,11.0,20,12,10,8,2,10,16,62.5,6,10,4,6,11,31,41,0,DF,25-29,Defender,Norway,Europe
1094,Isak Hansen-Aarøen,NOR,Werder Bremen,Bundesliga,2023,18.0,2004.0,0.3,0,0,0,0,0,0,1,0.0,1,1,0,1,1,1,0,0,MF,Under 20,Midfielder,Norway,Europe
1122,Mario Hermoso,ESP,Atlético Madrid,La Liga,2023,28.0,1995.0,28.4,46,25,29,13,4,28,51,54.9,23,27,9,18,30,76,93,0,DF,25-29,Defender,Spain,Europe
1123,Javi Hernández,ESP,Cádiz,La Liga,2023,25.0,1998.0,27.9,43,24,26,12,5,25,46,54.3,21,34,9,25,19,62,72,1,DF,25-29,Defender,Spain,Europe
1124,Aridane Hernández,ESP,Rayo Vallecano,La Liga,2023,34.0,1989.0,18.8,10,8,5,4,1,4,11,36.4,7,19,14,5,14,24,98,1,DF,30-34,Defender,Spain,Europe
1126,Luis Hernández,ESP,Cádiz,La Liga,2023,34.0,1989.0,8.0,7,3,4,3,0,4,8,50.0,4,3,2,1,8,15,25,0,DF,30-34,Defender,Spain,Europe
1128,Jorge Herrando,ESP,Osasuna,La Liga,2023,22.0,2001.0,18.3,29,19,23,6,0,12,19,63.2,7,20,11,9,15,44,69,1,DF,20-24,Defender,Spain,Europe
1129,Ander Herrera,ESP,Athletic Club,La Liga,2023,33.0,1989.0,11.4,44,32,11,26,7,20,36,55.6,16,16,6,10,15,59,18,1,MF,30-34,Midfielder,Spain,Europe
1130,Cristian Herrera,ESP,Las Palmas,La Liga,2023,32.0,1991.0,1.8,1,1,0,1,0,1,2,50.0,1,1,0,1,0,1,2,0,"FW,MF",30-34,Forward,Spain,Europe
1131,Sergio Herrera,ESP,Osasuna,La Liga,2023,30.0,1993.0,31.9,2,2,2,0,0,2,3,66.7,1,0,0,0,0,2,22,3,GK,30-34,Goalkeeper,Spain,Europe
1134,Juan Herzog,ESP,Las Palmas,La Liga,2023,20.0,2003.0,3.2,6,5,5,1,0,3,6,50.0,3,4,1,3,2,8,17,0,DF,20-24,Defender,Spain,Europe
1142,Adam Hložek,CZE,Leverkusen,Bundesliga,2023,21.0,2002.0,5.1,10,4,2,4,4,3,7,42.9,4,4,1,3,2,12,1,0,"MF,FW",20-24,Midfielder,Czech Republic,Europe
1159,Xabier Huarte Armendáriz,ESP,Osasuna,La Liga,2023,22.0,2001.0,0.1,0,0,0,0,0,0,0,,0,0,0,0,0,0,0,0,MF,20-24,Midfielder,Spain,Europe
1163,Dean Huijsen,ESP,Roma,Serie A,2023,18.0,2005.0,5.7,10,5,5,5,0,1,4,25.0,3,7,4,3,4,14,26,2,DF,Under 20,Defender,Spain,Europe
1164,Dean Huijsen,ESP,Juventus,Serie A,2023,18.0,2005.0,0.1,0,0,0,0,0,0,0,,0,0,0,0,0,0,1,0,DF,Under 20,Defender,Spain,Europe
1171,Pablo Ibáñez,ESP,Osasuna,La Liga,2023,24.0,1998.0,12.8,18,9,5,7,6,5,21,23.8,16,26,3,23,9,27,17,0,MF,20-24,Midfielder,Spain,Europe
1173,Iglesias,ESP,Getafe,La Liga,2023,25.0,1998.0,15.7,41,22,25,11,5,21,33,63.6,12,18,7,11,16,57,53,0,"DF,FW",25-29,Defender,Spain,Europe
1174,Borja Iglesias,ESP,Betis,La Liga,2023,30.0,1993.0,4.5,0,0,0,0,0,0,3,0.0,3,0,0,0,2,2,2,0,FW,30-34,Forward,Spain,Europe
1175,Borja Iglesias,ESP,Leverkusen,Bundesliga,2023,30.0,1993.0,2.8,1,0,0,1,0,0,1,0.0,1,2,0,2,1,2,1,0,FW,30-34,Forward,Spain,Europe
1179,Andrej Ilic,SRB,Lille,Ligue 1,2023,23.0,2000.0,0.1,0,0,0,0,0,0,0,,0,0,0,0,0,0,0,0,FW,20-24,Forward,Serbia,Europe
1180,Ivan Ilić,SRB,Torino,Serie A,2023,22.0,2001.0,23.3,22,8,9,10,3,13,27,48.1,14,20,7,13,20,42,31,0,MF,20-24,Midfielder,Serbia,Europe
1182,Imanol,ESP,Athletic Club,La Liga,2023,23.0,2000.0,5.8,7,5,1,5,1,5,18,27.8,13,6,0,6,7,14,15,0,DF,20-24,Defender,Spain,Europe
1191,Isco,ESP,Betis,La Liga,2023,31.0,1992.0,25.8,41,27,15,21,5,14,38,36.8,24,19,1,18,10,51,7,0,MF,30-34,Midfielder,Spain,Europe
1199,Diego Iturralde,ESP,Sevilla,La Liga,2023,20.0,2003.0,0.4,0,0,0,0,0,0,0,,0,1,1,0,0,0,2,0,DF,20-24,Defender,Spain,Europe
1208,Filip Jagiełło,POL,Genoa,Serie A,2023,25.0,1997.0,0.4,0,0,0,0,0,0,1,0.0,1,1,1,0,1,1,0,0,MF,25-29,Midfielder,Poland,Europe
1215,Jakub Jankto,CZE,Cagliari,Serie A,2023,27.0,1996.0,9.7,12,9,9,1,2,8,20,40.0,12,5,1,4,5,17,20,0,"MF,FW",25-29,Midfielder,Czech Republic,Europe
1219,Mikel Jauregizar,ESP,Athletic Club,La Liga,2023,19.0,2003.0,1.7,0,0,0,0,0,0,6,0.0,6,5,0,5,0,0,2,0,MF,Under 20,Midfielder,Spain,Europe
1230,Alejandro Jiménez,ESP,Milan,Serie A,2023,18.0,2005.0,0.8,2,1,2,0,0,2,5,40.0,3,0,0,0,0,2,4,0,DF,Under 20,Defender,Spain,Europe
1242,Joan Jordán,ESP,Sevilla,La Liga,2023,29.0,1994.0,4.2,8,7,3,3,2,7,15,46.7,8,4,2,2,4,12,2,0,MF,25-29,Midfielder,Spain,Europe
1243,Jordi,ESP,Getafe,La Liga,2023,22.0,2001.0,6.4,16,11,3,11,2,7,15,46.7,8,7,2,5,8,24,7,0,"MF,DF",20-24,Midfielder,Spain,Europe
1244,Jeremy Jorge,ESP,Getafe,La Liga,2023,20.0,2003.0,0.0,0,0,0,0,0,0,0,,0,0,0,0,0,0,0,0,FW,20-24,Forward,Spain,Europe
1248,Joselu,ESP,Real Madrid,La Liga,2023,33.0,1990.0,18.7,6,3,1,4,1,0,7,0.0,7,11,1,10,6,12,11,0,FW,30-34,Forward,Spain,Europe
1251,Luka Jović,SRB,Milan,Serie A,2023,25.0,1997.0,9.7,6,4,0,3,3,4,6,66.7,2,3,0,3,1,7,9,0,FW,25-29,Forward,Serbia,Europe
1252,Kamil Jóźwiak,POL,Granada,La Liga,2023,25.0,1998.0,6.3,13,10,4,6,3,9,17,52.9,8,4,0,4,2,15,6,0,MF,25-29,Midfielder,Poland,Europe
1253,Juanmi,ESP,Cádiz,La Liga,2023,30.0,1993.0,9.7,9,4,2,7,0,2,9,22.2,7,6,0,6,6,15,3,0,FW,30-34,Forward,Spain,Europe
1254,Juanpe,ESP,Girona,La Liga,2023,32.0,1991.0,8.3,11,8,8,3,0,9,10,90.0,1,17,11,6,7,18,50,1,DF,30-34,Defender,Spain,Europe
1263,David Jurásek,CZE,Hoffenheim,Bundesliga,2023,22.0,2000.0,5.5,14,11,13,1,0,7,17,41.2,10,7,2,5,3,17,22,1,DF,20-24,Defender,Czech Republic,Europe
1275,Pavel Kadeřábek,CZE,Hoffenheim,Bundesliga,2023,31.0,1992.0,26.8,31,19,10,15,6,18,40,45.0,22,22,8,14,23,54,68,0,"DF,FW",30-34,Defender,Czech Republic,Europe
1287,Waren Kamanzi,NOR,Toulouse,Ligue 1,2023,22.0,2000.0,13.2,36,24,16,16,4,13,23,56.5,10,11,3,8,9,45,35,0,"DF,FW",20-24,Defender,Norway,Europe
1291,Jakub Kamiński,POL,Wolfsburg,Bundesliga,2023,21.0,2002.0,5.3,14,5,12,2,0,3,6,50.0,3,3,0,3,2,16,5,0,"FW,MF",20-24,Forward,Poland,Europe
1293,Kevin Kampl,SVN,RB Leipzig,Bundesliga,2023,32.0,1990.0,15.1,19,8,8,9,2,10,21,47.6,11,19,7,12,11,30,14,1,MF,30-34,Midfielder,Slovenia,Europe
1303,Jon Karrikaburu,ESP,Alavés,La Liga,2023,20.0,2002.0,0.2,0,0,0,0,0,0,0,,0,0,0,0,0,0,0,0,"MF,FW",20-24,Midfielder,Spain,Europe
1332,Kiké,ESP,Alavés,La Liga,2023,33.0,1989.0,15.8,8,4,2,3,3,4,9,44.4,5,16,5,11,1,9,12,0,"FW,MF",30-34,Forward,Spain,Europe
1336,Jakub Kiwior,POL,Arsenal,Premier League,2023,23.0,2000.0,10.5,20,12,11,8,1,14,19,73.7,5,11,3,8,8,28,28,1,DF,20-24,Defender,Poland,Europe
1349,Koke,ESP,Atlético Madrid,La Liga,2023,31.0,1992.0,27.7,66,44,27,32,7,36,79,45.6,43,37,12,25,16,82,34,1,MF,30-34,Midfielder,Spain,Europe
1366,Filip Kostić,SRB,Juventus,Serie A,2023,30.0,1992.0,20.2,37,23,20,13,4,17,33,51.5,16,29,8,21,9,46,43,0,DF,30-34,Defender,Serbia,Europe
1371,Tomáš Koubek,CZE,Augsburg,Bundesliga,2023,30.0,1992.0,3.0,0,0,0,0,0,0,0,,0,0,0,0,0,0,1,1,GK,30-34,Goalkeeper,Czech Republic,Europe
1378,Matej Kovar,CZE,Leverkusen,Bundesliga,2023,23.0,2000.0,1.0,0,0,0,0,0,0,0,,0,0,0,0,0,0,0,0,GK,20-24,Goalkeeper,Czech Republic,Europe
1379,Dawid Kownacki,POL,Werder Bremen,Bundesliga,2023,26.0,1997.0,4.2,1,1,1,0,0,1,4,25.0,3,3,1,2,0,1,1,0,FW,25-29,Forward,Poland,Europe
1381,Alex Král,CZE,Union Berlin,Bundesliga,2023,25.0,1998.0,15.2,19,14,7,10,2,8,20,40.0,12,15,4,11,11,30,30,0,MF,25-29,Midfielder,Czech Republic,Europe
1413,Yoel Lago,ESP,Celta Vigo,La Liga,2023,19.0,2004.0,1.0,2,0,2,0,0,0,0,,0,1,0,1,0,2,2,0,DF,Under 20,Defender,Spain,Europe
1426,Aymeric Laporte,ESP,Manchester City,Premier League,2023,29.0,1994.0,0.1,0,0,0,0,0,0,0,,0,1,1,0,0,0,1,0,DF,25-29,Defender,Spain,Europe
1432,Juanmi Latasa,ESP,Getafe,La Liga,2023,22.0,2001.0,17.3,9,7,0,6,3,1,11,9.1,10,9,0,9,4,13,21,0,FW,20-24,Forward,Spain,Europe
1433,Toni Lato,ESP,Mallorca,La Liga,2023,25.0,1997.0,17.2,38,23,19,13,6,16,27,59.3,11,17,3,14,17,55,27,0,DF,25-29,Defender,Spain,Europe
1438,Darko Lazović,SRB,Hellas Verona,Serie A,2023,32.0,1990.0,21.4,26,16,11,6,9,16,31,51.6,15,10,1,9,6,32,14,0,"FW,MF",30-34,Forward,Serbia,Europe
1446,Robin Le Normand,ESP,Real Sociedad,La Liga,2023,26.0,1996.0,27.4,31,22,16,15,0,17,30,56.7,13,26,15,11,28,59,96,1,DF,25-29,Defender,Spain,Europe
1457,Stefan Lekovic,SRB,Villarreal,La Liga,2023,19.0,2004.0,0.3,0,0,0,0,0,0,0,,0,1,1,0,0,0,1,0,DF,Under 20,Defender,Serbia,Europe
1458,Iñigo Lekue,ESP,Athletic Club,La Liga,2023,30.0,1993.0,22.2,40,22,25,10,5,27,53,50.9,26,24,6,18,15,55,50,0,DF,30-34,Defender,Spain,Europe
1461,Álvaro Lemos,ESP,Las Palmas,La Liga,2023,30.0,1993.0,2.8,4,1,1,3,0,0,2,0.0,2,3,1,2,2,6,4,0,DF,30-34,Defender,Spain,Europe
1462,Ruben Lendinez,ESP,Valencia,La Liga,2023,20.0,2003.0,0.1,2,2,0,2,0,1,1,100.0,0,0,0,0,0,2,1,0,DF,20-24,Defender,Spain,Europe
1470,Robert Lewandowski,POL,Barcelona,La Liga,2023,34.0,1988.0,30.6,8,5,0,6,2,4,12,33.3,8,13,4,9,9,17,18,0,FW,30-34,Forward,Poland,Europe
1479,Karol Linetty,POL,Torino,Serie A,2023,28.0,1995.0,20.6,30,21,9,20,1,9,29,31.0,20,24,8,16,23,53,27,1,MF,25-29,Midfielder,Poland,Europe
1482,Pol Lirola,ESP,Frosinone,Serie A,2023,25.0,1997.0,17.1,30,18,14,15,1,17,35,48.6,18,12,1,11,19,49,41,1,DF,25-29,Defender,Spain,Europe
1483,Marcin Listkowski,POL,Lecce,Serie A,2023,25.0,1998.0,0.1,0,0,0,0,0,0,0,,0,0,0,0,0,0,0,0,FW,25-29,Forward,Poland,Europe
1486,Javier Llabrés,ESP,Mallorca,La Liga,2023,20.0,2002.0,2.7,3,1,1,1,1,1,2,50.0,1,1,0,1,3,6,4,0,"MF,FW",20-24,Midfielder,Spain,Europe
1487,Diego Llorente,ESP,Roma,Serie A,2023,29.0,1993.0,24.1,31,19,20,10,1,11,24,45.8,13,40,27,13,22,53,79,0,DF,25-29,Defender,Spain,Europe
1487,Diego Llorente,ESP,Roma,Serie A,2023,29.0,1993.0,24.1,31,19,20,10,1,11,24,45.8,13,40,27,13,22,53,79,0,DF,25-29,Defender,Spain,Europe
1487,Diego Llorente,ESP,Roma,Serie A,2023,29.0,1993.0,24.1,31,19,20,10,1,11,24,45.8,13,40,27,13,22,53,79,0,DF,25-29,Defender,Spain,Europe
1487,Diego Llorente,ESP,Roma,Serie A,2023,29.0,1993.0,24.1,31,19,20,10,1,11,24,45.8,13,40,27,13,22,53,79,0,DF,25-29,Defender,Spain,Europe
1488,Marcos Llorente,ESP,Atlético Madrid,La Liga,2023,28.0,1995.0,28.5,40,23,18,17,5,16,44,36.4,28,36,11,25,14,54,35,0,"MF,DF",25-29,Midfielder,Spain,Europe
1504,David López,ESP,Girona,La Liga,2023,33.0,1989.0,21.8,33,20,21,12,0,17,22,77.3,5,28,19,9,20,53,63,4,DF,30-34,Defender,Spain,Europe
1504,David López,ESP,Girona,La Liga,2023,33.0,1989.0,21.8,33,20,21,12,0,17,22,77.3,5,28,19,9,20,53,63,4,DF,30-34,Defender,Spain,Europe
1504,David López,ESP,Girona,La Liga,2023,33.0,1989.0,21.8,33,20,21,12,0,17,22,77.3,5,28,19,9,20,53,63,4,DF,30-34,Defender,Spain,Europe
1504,David López,ESP,Girona,La Liga,2023,33.0,1989.0,21.8,33,20,21,12,0,17,22,77.3,5,28,19,9,20,53,63,4,DF,30-34,Defender,Spain,Europe
1505,Diego López,ESP,Valencia,La Liga,2023,21.0,2002.0,29.5,37,25,14,16,7,13,56,23.2,43,23,1,22,20,57,12,0,"MF,FW",20-24,Midfielder,Spain,Europe
1505,Diego López,ESP,Valencia,La Liga,2023,21.0,2002.0,29.5,37,25,14,16,7,13,56,23.2,43,23,1,22,20,57,12,0,"MF,FW",20-24,Midfielder,Spain,Europe
1505,Diego López,ESP,Valencia,La Liga,2023,21.0,2002.0,29.5,37,25,14,16,7,13,56,23.2,43,23,1,22,20,57,12,0,"MF,FW",20-24,Midfielder,Spain,Europe
1505,Diego López,ESP,Valencia,La Liga,2023,21.0,2002.0,29.5,37,25,14,16,7,13,56,23.2,43,23,1,22,20,57,12,0,"MF,FW",20-24,Midfielder,Spain,Europe
1505,Diego López,ESP,Valencia,La Liga,2023,21.0,2002.0,29.5,37,25,14,16,7,13,56,23.2,43,23,1,22,20,57,12,0,"MF,FW",20-24,Midfielder,Spain,Europe
1505,Diego López,ESP,Valencia,La Liga,2023,21.0,2002.0,29.5,37,25,14,16,7,13,56,23.2,43,23,1,22,20,57,12,0,"MF,FW",20-24,Midfielder,Spain,Europe
1505,Diego López,ESP,Valencia,La Liga,2023,21.0,2002.0,29.5,37,25,14,16,7,13,56,23.2,43,23,1,22,20,57,12,0,"MF,FW",20-24,Midfielder,Spain,Europe
1505,Diego López,ESP,Valencia,La Liga,2023,21.0,2002.0,29.5,37,25,14,16,7,13,56,23.2,43,23,1,22,20,57,12,0,"MF,FW",20-24,Midfielder,Spain,Europe
1505,Diego López,ESP,Valencia,La Liga,2023,21.0,2002.0,29.5,37,25,14,16,7,13,56,23.2,43,23,1,22,20,57,12,0,"MF,FW",20-24,Midfielder,Spain,Europe
1506,Fermin López,ESP,Barcelona,La Liga,2023,20.0,2003.0,16.1,41,21,15,18,8,14,40,35.0,26,14,1,13,4,45,9,0,"MF,FW",20-24,Midfielder,Spain,Europe
1507,Javi López,ESP,Alavés,La Liga,2023,21.0,2002.0,26.5,23,12,11,9,3,15,26,57.7,11,25,9,16,10,33,77,1,DF,20-24,Defender,Spain,Europe
1507,Javi López,ESP,Alavés,La Liga,2023,21.0,2002.0,26.5,23,12,11,9,3,15,26,57.7,11,25,9,16,10,33,77,1,DF,20-24,Defender,Spain,Europe
1507,Javi López,ESP,Alavés,La Liga,2023,21.0,2002.0,26.5,23,12,11,9,3,15,26,57.7,11,25,9,16,10,33,77,1,DF,20-24,Defender,Spain,Europe
1507,Javi López,ESP,Alavés,La Liga,2023,21.0,2002.0,26.5,23,12,11,9,3,15,26,57.7,11,25,9,16,10,33,77,1,DF,20-24,Defender,Spain,Europe
1510,Pau López,ESP,Marseille,Ligue 1,2023,28.0,1994.0,32.7,0,0,0,0,0,0,2,0.0,2,0,0,0,0,0,10,1,GK,25-29,Goalkeeper,Spain,Europe
1511,Unai López,ESP,Rayo Vallecano,La Liga,2023,27.0,1995.0,23.4,48,24,18,23,7,21,53,39.6,32,24,3,21,16,64,15,2,MF,25-29,Midfielder,Spain,Europe
1520,Sandi Lovrić,SVN,Udinese,Serie A,2023,25.0,1998.0,22.1,25,12,9,11,5,9,23,39.1,14,21,2,19,21,46,24,0,MF,25-29,Midfielder,Slovenia,Europe
1522,Anthony Lozano,HON,Getafe,La Liga,2023,30.0,1993.0,1.0,0,0,0,0,0,0,1,0.0,1,0,0,0,0,0,1,0,"MF,FW",30-34,Midfielder,Honduras,North America
1523,Anthony Lozano,HON,Almería,La Liga,2023,30.0,1993.0,8.6,7,5,2,5,0,4,7,57.1,3,6,1,5,2,9,12,0,FW,30-34,Forward,Honduras,North America
1527,José Luis Gayà,ESP,Valencia,La Liga,2023,28.0,1995.0,19.9,71,36,44,23,4,43,67,64.2,24,18,3,15,11,82,42,0,DF,25-29,Defender,Spain,Europe
1528,José Luis Morales,ESP,Villarreal,La Liga,2023,36.0,1987.0,11.6,5,3,1,4,0,3,13,23.1,10,9,1,8,7,12,4,0,"FW,MF",35-39,Forward,Spain,Europe
1534,Saša Lukić,SRB,Fulham,Premier League,2023,26.0,1996.0,12.5,33,19,9,17,7,18,39,46.2,21,18,5,13,16,49,19,1,MF,25-29,Midfielder,Serbia,Europe
1552,Pablo Maffeo,ESP,Mallorca,La Liga,2023,26.0,1997.0,16.2,35,22,18,13,4,23,40,57.5,17,12,2,10,10,45,23,0,DF,25-29,Defender,Spain,Europe
1562,Jon Magunacelaya,ESP,Real Sociedad,La Liga,2023,23.0,2000.0,1.3,5,3,2,3,0,4,8,50.0,4,3,0,3,0,5,2,0,"FW,MF",20-24,Forward,Spain,Europe
1563,Adel Mahamoud,COM,Nantes,Ligue 1,2023,20.0,2003.0,0.1,0,0,0,0,0,0,1,0.0,1,0,0,0,0,0,0,0,FW,20-24,Forward,Comoros,Africa
1571,Radosław Majecki,POL,Monaco,Ligue 1,2023,23.0,1999.0,12.0,0,0,0,0,0,0,0,,0,1,0,1,0,0,5,1,GK,20-24,Goalkeeper,Poland,Europe
1577,Nemanja Maksimović,SRB,Getafe,La Liga,2023,28.0,1995.0,36.3,65,43,26,31,8,23,41,56.1,18,56,23,33,46,111,61,0,MF,25-29,Midfielder,Serbia,Europe
1601,Javier Manquillo,ESP,Celta Vigo,La Liga,2023,29.0,1994.0,8.3,15,11,6,5,4,8,15,53.3,7,14,3,11,3,18,17,0,"DF,MF",25-29,Defender,Spain,Europe
1610,Óscar de Marcos,ESP,Athletic Club,La Liga,2023,34.0,1989.0,25.1,56,39,26,24,6,42,71,59.2,29,28,6,22,15,71,44,0,DF,30-34,Defender,Spain,Europe
1611,Alberto Marí,ESP,Valencia,La Liga,2023,22.0,2001.0,3.1,4,2,0,1,3,1,1,100.0,0,3,0,3,0,4,5,0,FW,20-24,Forward,Spain,Europe
1612,José Mari,ESP,Cádiz,La Liga,2023,35.0,1987.0,0.2,2,1,0,2,0,1,2,50.0,1,0,0,0,0,2,0,0,"MF,FW",35-39,Midfielder,Spain,Europe
1613,Pablo Marí,ESP,Monza,Serie A,2023,29.0,1993.0,29.1,41,25,34,7,0,22,34,64.7,12,40,25,15,37,78,115,1,DF,25-29,Defender,Spain,Europe
1617,Rafa Marín,ESP,Alavés,La Liga,2023,21.0,2002.0,27.1,32,20,23,9,0,14,27,51.9,13,34,21,13,33,65,129,2,DF,20-24,Defender,Spain,Europe
1619,Diego Mariño,ESP,Almería,La Liga,2023,33.0,1990.0,1.0,0,0,0,0,0,0,0,,0,0,0,0,0,0,1,0,GK,30-34,Goalkeeper,Spain,Europe
1621,Mika Màrmol,ESP,Las Palmas,La Liga,2023,21.0,2002.0,35.3,70,42,44,24,2,35,53,66.0,18,39,19,20,44,114,147,2,DF,20-24,Defender,Spain,Europe
1625,Unai Marrero,ESP,Real Sociedad,La Liga,2023,21.0,2001.0,1.6,0,0,0,0,0,0,0,,0,0,0,0,0,0,0,0,GK,20-24,Goalkeeper,Spain,Europe
1628,Roger Martí,ESP,Cádiz,La Liga,2023,32.0,1991.0,15.1,12,6,1,9,2,2,7,28.6,5,16,1,15,7,19,4,0,FW,30-34,Forward,Spain,Europe
1630,Aarón Martín,ESP,Genoa,Serie A,2023,26.0,1997.0,15.3,21,10,7,10,4,9,22,40.9,13,12,4,8,9,30,15,0,DF,25-29,Defender,Spain,Europe
1631,Iván Martín,ESP,Girona,La Liga,2023,24.0,1999.0,30.3,44,25,22,15,7,22,57,38.6,35,25,3,22,21,65,14,0,MF,20-24,Midfielder,Spain,Europe
1632,Jon Martin,ESP,Real Sociedad,La Liga,2023,17.0,2006.0,0.3,0,0,0,0,0,0,0,,0,0,0,0,0,0,3,0,DF,Under 20,Defender,Spain,Europe
1634,Mario Martín,ESP,Real Madrid,La Liga,2023,19.0,2004.0,0.2,5,1,0,2,3,3,4,75.0,1,2,1,1,0,5,0,0,MF,Under 20,Midfielder,Spain,Europe
1637,Arnau Martinez,ESP,Girona,La Liga,2023,20.0,2003.0,13.8,25,16,17,6,2,15,32,46.9,17,15,5,10,10,35,41,3,DF,20-24,Defender,Spain,Europe
1639,Iñigo Martínez,ESP,Barcelona,La Liga,2023,32.0,1991.0,14.4,10,7,9,1,0,6,8,75.0,2,13,10,3,11,21,50,0,DF,30-34,Defender,Spain,Europe
1640,Josep Martinez,ESP,Genoa,Serie A,2023,25.0,1998.0,36.0,0,0,0,0,0,0,0,,0,0,0,0,1,1,21,3,GK,25-29,Goalkeeper,Spain,Europe
1643,Marc Martínez,ESP,Granada,La Liga,2023,33.0,1990.0,3.0,0,0,0,0,0,0,1,0.0,1,0,0,0,0,0,1,0,GK,30-34,Goalkeeper,Spain,Europe
1646,Marvin,ESP,Las Palmas,La Liga,2023,23.0,2000.0,20.6,39,25,18,17,4,18,36,50.0,18,28,2,26,14,53,18,1,"FW,DF",20-24,Forward,Spain,Europe
1650,Erhan Mašović,SRB,Bochum,Bundesliga,2023,24.0,1998.0,24.7,64,40,37,22,5,37,70,52.9,33,32,10,22,25,89,75,2,"DF,MF",20-24,Defender,Serbia,Europe
1654,Jaime Mata,ESP,Getafe,La Liga,2023,34.0,1988.0,19.9,24,15,12,8,4,11,26,42.3,15,18,1,17,17,41,31,0,"FW,MF",30-34,Forward,Spain,Europe
1658,Nemanja Matić,SRB,Rennes,Ligue 1,2023,34.0,1988.0,11.4,19,10,7,9,3,9,12,75.0,3,15,7,8,27,46,19,0,MF,30-34,Midfielder,Serbia,Europe
1659,Nemanja Matić,SRB,Lyon,Ligue 1,2023,34.0,1988.0,13.9,17,11,8,7,2,9,19,47.4,10,17,6,11,16,33,17,1,MF,30-34,Midfielder,Serbia,Europe
1678,Borja Mayoral,ESP,Getafe,La Liga,2023,26.0,1997.0,23.9,9,5,2,2,5,5,22,22.7,17,7,0,7,4,13,16,0,FW,25-29,Forward,Spain,Europe
1695,Jordi Mboula,ESP,Hellas Verona,Serie A,2023,24.0,1999.0,3.4,4,4,1,2,1,4,7,57.1,3,4,1,3,1,5,0,0,"FW,MF",20-24,Forward,Spain,Europe
1713,Óscar Melendo,ESP,Granada,La Liga,2023,25.0,1997.0,12.5,14,6,4,10,0,4,12,33.3,8,13,0,13,5,19,4,1,"MF,FW",25-29,Midfielder,Spain,Europe
1714,Gonzalo Melero,ESP,Almería,La Liga,2023,29.0,1994.0,12.3,14,8,7,5,2,7,19,36.8,12,12,4,8,4,18,11,0,"MF,FW",25-29,Midfielder,Spain,Europe
1715,Birger Meling,NOR,Rennes,Ligue 1,2023,28.0,1994.0,0.2,1,1,1,0,0,1,1,100.0,0,1,0,1,0,1,0,0,DF,25-29,Defender,Norway,Europe
1720,Tomás Mendes,ESP,Alavés,La Liga,2023,18.0,2004.0,0.1,0,0,0,0,0,0,0,,0,0,0,0,0,0,0,0,MF,Under 20,Midfielder,Spain,Europe
1721,Brais Méndez,ESP,Real Sociedad,La Liga,2023,26.0,1997.0,26.8,42,28,13,20,9,15,43,34.9,28,23,4,19,12,54,21,0,"MF,FW",25-29,Midfielder,Spain,Europe
1723,Diego Méndez,ESP,Rayo Vallecano,La Liga,2023,19.0,2003.0,0.1,1,1,1,0,0,1,1,100.0,0,0,0,0,1,2,0,0,MF,Under 20,Midfielder,Spain,Europe
1732,Jorge Meré,ESP,Cádiz,La Liga,2023,26.0,1997.0,7.5,8,7,6,2,0,4,7,57.1,3,5,3,2,8,16,33,0,DF,25-29,Defender,Spain,Europe
1734,Mikel Merino,ESP,Real Sociedad,La Liga,2023,27.0,1996.0,27.6,77,43,25,34,18,22,48,45.8,26,36,11,25,16,93,55,3,MF,25-29,Midfielder,Spain,Europe
1744,Miguel,ESP,Alavés,La Liga,2023,23.0,1999.0,0.7,0,0,0,0,0,0,0,,0,2,0,2,0,0,0,0,"FW,MF",20-24,Forward,Spain,Europe
1746,Nikola Milenković,SRB,Fiorentina,Serie A,2023,25.0,1997.0,27.9,41,21,24,14,3,22,36,61.1,14,22,14,8,27,68,95,1,DF,25-29,Defender,Serbia,Europe
1748,Arkadiusz Milik,POL,Juventus,Serie A,2023,29.0,1994.0,10.2,9,5,2,5,2,3,5,60.0,2,7,1,6,5,14,3,0,FW,25-29,Forward,Poland,Europe
1749,Vanja Milinković-Savić,SRB,Torino,Serie A,2023,26.0,1997.0,36.0,1,0,1,0,0,1,1,100.0,0,0,0,0,1,2,14,4,GK,25-29,Goalkeeper,Serbia,Europe
1751,Luis Milla,ESP,Getafe,La Liga,2023,28.0,1994.0,23.5,57,33,19,28,10,28,47,59.6,19,20,1,19,32,89,10,0,MF,25-29,Midfielder,Spain,Europe
1754,Jovan Milošević,SRB,Stuttgart,Bundesliga,2023,18.0,2005.0,0.3,0,0,0,0,0,0,0,,0,0,0,0,0,0,0,0,"FW,MF",Under 20,Forward,Serbia,Europe
1755,Marko Milovanović,SRB,Almería,La Liga,2023,19.0,2003.0,3.4,4,4,1,3,0,2,4,50.0,2,2,0,2,0,4,5,0,"FW,MF",Under 20,Forward,Serbia,Europe
1762,Óscar Mingueza,ESP,Celta Vigo,La Liga,2023,24.0,1999.0,33.3,62,38,44,11,7,37,80,46.3,43,38,7,31,17,79,49,2,"DF,MF",20-24,Defender,Spain,Europe
1763,Ignasi Miquel,ESP,Granada,La Liga,2023,30.0,1992.0,33.2,47,30,39,6,2,23,40,57.5,17,32,16,16,45,92,132,4,DF,30-34,Defender,Spain,Europe
1764,Rafa Mir,ESP,Sevilla,La Liga,2023,26.0,1997.0,4.3,2,2,1,1,0,1,2,50.0,1,2,0,2,1,3,1,0,"FW,MF",25-29,Forward,Spain,Europe
1767,Juan Miranda,ESP,Betis,La Liga,2023,23.0,2000.0,20.6,38,24,21,13,4,17,31,54.8,14,31,6,25,19,57,62,0,DF,20-24,Defender,Spain,Europe
1774,Aleksandar Mitrović,SRB,Fulham,Premier League,2023,28.0,1994.0,0.4,0,0,0,0,0,0,0,,0,0,0,0,0,0,0,0,FW,25-29,Forward,Serbia,Europe
1775,Stefan Mitrović,SRB,Hellas Verona,Serie A,2023,20.0,2002.0,4.3,6,3,0,5,1,2,5,40.0,3,6,1,5,0,6,4,0,"FW,MF",20-24,Forward,Serbia,Europe
1776,Stefan Mitrović,SRB,Getafe,La Liga,2023,33.0,1990.0,7.8,9,3,7,2,0,4,8,50.0,4,3,2,1,6,15,26,0,DF,30-34,Defender,Serbia,Europe
1779,Marko Mladenović,SRB,Eint Frankfurt,Bundesliga,2023,18.0,2005.0,0.1,0,0,0,0,0,0,0,,0,0,0,0,0,0,0,0,MF,Under 20,Midfielder,Serbia,Europe
1780,Jakub Moder,POL,Brighton,Premier League,2023,24.0,1999.0,6.9,19,10,9,5,5,9,18,50.0,9,8,2,6,2,21,12,0,"MF,DF",20-24,Midfielder,Poland,Europe
1787,Alberto Moleiro,ESP,Las Palmas,La Liga,2023,19.0,2003.0,20.0,15,6,4,7,4,6,30,20.0,24,11,0,11,7,22,10,0,"FW,MF",Under 20,Forward,Spain,Europe
1790,Jon Moncayola,ESP,Osasuna,La Liga,2023,25.0,1998.0,20.0,27,18,14,10,3,17,42,40.5,25,31,5,26,15,42,21,0,MF,25-29,Midfielder,Spain,Europe
1798,Álvaro Morata,ESP,Atlético Madrid,La Liga,2023,30.0,1992.0,21.2,16,10,4,7,5,3,5,60.0,2,18,3,15,1,17,26,0,FW,30-34,Forward,Spain,Europe
1800,Alberto Moreno,ESP,Villarreal,La Liga,2023,31.0,1992.0,16.5,31,21,19,10,2,10,30,33.3,20,12,2,10,24,55,33,0,DF,30-34,Defender,Spain,Europe
1800,Alberto Moreno,ESP,Villarreal,La Liga,2023,31.0,1992.0,16.5,31,21,19,10,2,10,30,33.3,20,12,2,10,24,55,33,0,DF,30-34,Defender,Spain,Europe
1800,Alberto Moreno,ESP,Villarreal,La Liga,2023,31.0,1992.0,16.5,31,21,19,10,2,10,30,33.3,20,12,2,10,24,55,33,0,DF,30-34,Defender,Spain,Europe
1800,Alberto Moreno,ESP,Villarreal,La Liga,2023,31.0,1992.0,16.5,31,21,19,10,2,10,30,33.3,20,12,2,10,24,55,33,0,DF,30-34,Defender,Spain,Europe
1801,Álex Moreno,ESP,Aston Villa,Premier League,2023,30.0,1993.0,11.5,18,12,18,0,0,12,19,63.2,7,11,2,9,13,31,37,0,DF,30-34,Defender,Spain,Europe
1802,Gerard Moreno,ESP,Villarreal,La Liga,2023,31.0,1992.0,24.6,25,12,10,7,8,11,25,44.0,14,24,7,17,9,34,24,0,FW,30-34,Forward,Spain,Europe
1803,Jorge Moreno,ESP,Osasuna,La Liga,2023,22.0,2001.0,0.2,0,0,0,0,0,0,0,,0,1,0,1,0,0,3,0,DF,20-24,Defender,Spain,Europe
1804,Mateu Morey,ESP,Dortmund,Bundesliga,2023,23.0,2000.0,1.2,2,2,1,1,0,2,4,50.0,2,3,1,2,1,3,3,0,DF,20-24,Defender,Spain,Europe
1806,Manu Morlanes,ESP,Mallorca,La Liga,2023,24.0,1999.0,17.9,50,29,23,26,1,23,53,43.4,30,13,1,12,20,70,21,0,MF,20-24,Midfielder,Spain,Europe
1809,Cristhian Mosquera,ESP,Valencia,La Liga,2023,19.0,2004.0,34.2,57,34,36,18,3,25,39,64.1,14,42,23,19,36,93,137,2,DF,Under 20,Defender,Spain,Europe
1830,Iker Muniain,ESP,Athletic Club,La Liga,2023,30.0,1992.0,6.6,5,1,2,3,0,1,3,33.3,2,4,1,3,0,5,0,0,"MF,FW",30-34,Midfielder,Spain,Europe
1832,Aihen Muñoz,ESP,Real Sociedad,La Liga,2023,25.0,1997.0,12.5,36,21,20,10,6,24,35,68.6,11,16,8,8,9,45,33,0,DF,25-29,Defender,Spain,Europe
1834,Iker Muñoz,ESP,Osasuna,La Liga,2023,20.0,2002.0,20.6,32,18,13,17,2,15,31,48.4,16,16,5,11,11,43,50,0,MF,20-24,Midfielder,Spain,Europe
1835,Javier Muñoz,ESP,Las Palmas,La Liga,2023,28.0,1995.0,29.3,42,23,14,22,6,16,44,36.4,28,40,4,36,20,62,29,1,MF,25-29,Midfielder,Spain,Europe
1849,Joel Mvuka,NOR,Lorient,Ligue 1,2023,20.0,2002.0,2.2,5,3,3,1,1,3,7,42.9,4,1,0,1,2,7,1,0,"DF,FW",20-24,Defender,Norway,Europe
1858,Nacho,ESP,Real Madrid,La Liga,2023,33.0,1990.0,19.4,18,10,9,7,2,6,13,46.2,7,23,13,10,18,36,56,0,DF,30-34,Defender,Spain,Europe
1864,Matija Nastasić,SRB,Mallorca,La Liga,2023,30.0,1993.0,25.1,35,17,26,9,0,24,32,75.0,8,33,20,13,29,64,114,0,DF,30-34,Defender,Serbia,Europe
1867,Roberto Navarro,ESP,Cádiz,La Liga,2023,21.0,2002.0,21.0,46,29,20,21,5,22,43,51.2,21,33,0,33,19,65,7,1,"MF,FW",20-24,Midfielder,Spain,Europe
1868,Jesús Navas,ESP,Sevilla,La Liga,2023,37.0,1985.0,22.3,37,27,21,14,2,22,40,55.0,18,15,7,8,22,59,48,0,DF,35-39,Defender,Spain,Europe
1881,Álvaro Negredo,ESP,Cádiz,La Liga,2023,37.0,1985.0,0.6,0,0,0,0,0,0,0,,0,1,0,1,1,1,0,0,"FW,MF",35-39,Forward,Spain,Europe
1889,Carlos Neva,ESP,Granada,La Liga,2023,27.0,1996.0,35.0,32,21,22,9,1,17,40,42.5,23,39,14,25,30,62,108,2,DF,25-29,Defender,Spain,Europe
1902,Saúl Ñíguez,ESP,Atlético Madrid,La Liga,2023,28.0,1994.0,15.3,64,39,29,29,6,30,49,61.2,19,36,9,27,14,78,56,0,MF,25-29,Midfielder,Spain,Europe
1909,Peru Nolaskoain,ESP,Athletic Club,La Liga,2023,24.0,1998.0,0.1,1,1,1,0,0,1,1,100.0,0,0,0,0,0,1,1,0,"DF,MF",20-24,Defender,Spain,Europe
1911,Jonathan Norbye,NOR,RB Leipzig,Bundesliga,2023,16.0,2007.0,0.0,0,0,0,0,0,0,0,,0,0,0,0,0,0,0,0,MF,Under 20,Midfielder,Norway,Europe
1914,Oliver Norwood,NIR,Sheffield Utd,Premier League,2023,32.0,1991.0,16.0,41,26,18,18,5,20,47,42.6,27,24,9,15,21,62,39,0,MF,30-34,Midfielder,Northern Ireland,Europe
1923,Unai Núñez,ESP,Celta Vigo,La Liga,2023,26.0,1997.0,31.1,51,28,30,19,2,23,49,46.9,26,38,24,14,52,103,153,3,DF,25-29,Defender,Spain,Europe
1928,Ørjan Nyland,NOR,Sevilla,La Liga,2023,32.0,1990.0,24.0,0,0,0,0,0,0,1,0.0,1,0,0,0,0,0,9,1,GK,30-34,Goalkeeper,Norway,Europe
1938,Jan Oblak,SVN,Atlético Madrid,La Liga,2023,30.0,1993.0,38.0,0,0,0,0,0,0,0,,0,0,0,0,0,0,10,0,GK,30-34,Goalkeeper,Slovenia,Europe
1944,Álvaro Odriozola,ESP,Real Sociedad,La Liga,2023,27.0,1995.0,4.4,9,7,7,1,1,5,5,100.0,0,2,1,1,8,17,7,0,DF,25-29,Defender,Spain,Europe
1956,Aingeru Olabarrieta,ESP,Athletic Club,La Liga,2023,17.0,2005.0,0.1,0,0,0,0,0,0,0,,0,0,0,0,0,0,0,0,FW,Under 20,Forward,Spain,Europe
1958,Olasagasti,ESP,Real Sociedad,La Liga,2023,22.0,2000.0,4.0,16,13,4,7,5,5,8,62.5,3,2,0,2,3,19,5,1,MF,20-24,Midfielder,Spain,Europe
1963,Dani Olmo,ESP,RB Leipzig,Bundesliga,2023,25.0,1998.0,16.1,26,18,14,8,4,10,22,45.5,12,7,0,7,13,39,12,1,MF,25-29,Midfielder,Spain,Europe
1965,Warmed Omari,COM,Rennes,Ligue 1,2023,23.0,2000.0,23.0,32,19,23,7,2,16,28,57.1,12,30,20,10,33,65,77,2,DF,20-24,Defender,Comoros,Africa
1969,Samu Omorodion,ESP,Alavés,La Liga,2023,19.0,2004.0,21.3,6,3,1,4,1,0,4,0.0,4,11,2,9,1,7,14,0,FW,Under 20,Forward,Spain,Europe
1970,Samu Omorodion,ESP,Granada,La Liga,2023,19.0,2004.0,0.9,1,1,0,1,0,1,1,100.0,0,0,0,0,0,1,0,0,FW,Under 20,Forward,Spain,Europe
1988,Aimar Oroz,ESP,Osasuna,La Liga,2023,21.0,2001.0,26.0,43,26,18,20,5,13,37,35.1,24,27,2,25,16,59,11,0,MF,20-24,Midfielder,Spain,Europe
1991,Eneko Ortiz,ESP,Alavés,La Liga,2023,20.0,2003.0,0.2,0,0,0,0,0,0,0,,0,0,0,0,0,0,0,0,DF,20-24,Defender,Spain,Europe
1992,Asier Osambela,ESP,Osasuna,La Liga,2023,19.0,2004.0,0.1,2,1,0,1,1,0,0,,0,0,0,0,0,2,0,0,MF,Under 20,Midfielder,Spain,Europe
2008,Mikel Oyarzabal,ESP,Real Sociedad,La Liga,2023,26.0,1997.0,24.0,23,18,7,11,5,7,21,33.3,14,25,4,21,4,27,12,0,"FW,MF",25-29,Forward,Spain,Europe
2013,Jon Pacheco,ESP,Real Sociedad,La Liga,2023,22.0,2001.0,17.0,25,15,21,4,0,14,22,63.6,8,17,6,11,10,35,53,1,DF,20-24,Defender,Spain,Europe
2020,Isaac Palazón Camacho,ESP,Rayo Vallecano,La Liga,2023,28.0,1994.0,31.0,46,25,16,21,9,20,58,34.5,38,29,2,27,16,62,41,0,"MF,FW",25-29,Midfielder,Spain,Europe
2027,Miloš Pantović,SRB,Union Berlin,Bundesliga,2023,27.0,1996.0,0.2,0,0,0,0,0,0,0,,0,0,0,0,0,0,0,0,MF,25-29,Midfielder,Serbia,Europe
2034,Victor Parada,ESP,Alavés,La Liga,2023,21.0,2002.0,0.0,1,1,0,1,0,1,1,100.0,0,0,0,0,0,1,0,0,"FW,MF",20-24,Forward,Spain,Europe
2035,Aitor Paredes,ESP,Athletic Club,La Liga,2023,23.0,2000.0,30.0,20,11,11,9,0,7,14,50.0,7,23,11,12,33,53,104,0,DF,20-24,Defender,Spain,Europe
2038,Daniel Parejo,ESP,Villarreal,La Liga,2023,34.0,1989.0,28.7,43,30,16,21,6,20,46,43.5,26,25,9,16,21,64,29,3,MF,30-34,Midfielder,Spain,Europe
2044,Pascu,ESP,Villarreal,La Liga,2023,20.0,2003.0,0.2,0,0,0,0,0,0,0,,0,0,0,0,0,0,0,0,FW,20-24,Forward,Spain,Europe
2046,Patric,ESP,Lazio,Serie A,2023,30.0,1993.0,17.9,13,8,10,3,0,8,18,44.4,10,15,9,6,6,19,44,0,DF,30-34,Defender,Spain,Europe
1871,Youssouf Ndayishimiye,BDI,Nice,Ligue 1,2023,24.0,1998.0,19.0,31,20,17,12,2,12,23,52.2,11,19,11,8,12,43,47,1,"MF,DF",20-24,Midfielder,Burundi,Africa
2049,Gabriel Paulista,BRA,Atlético Madrid,La Liga,2023,32.0,1990.0,4.5,7,5,4,3,0,3,4,75.0,1,5,3,2,4,11,27,0,DF,30-34,Defender,Brazil,South America
2050,Gabriel Paulista,BRA,Valencia,La Liga,2023,32.0,1990.0,15.5,10,7,8,2,0,6,11,54.5,5,15,7,8,24,34,78,0,DF,30-34,Defender,Brazil,South America
2051,Benjamin Pavard,FRA,Inter,Serie A,2023,27.0,1996.0,18.6,34,21,21,11,2,20,24,83.3,4,25,15,10,32,66,44,1,DF,25-29,Defender,France,Europe
2053,Aleksandar Pavlovic,GER,Bayern Munich,Bundesliga,2023,19.0,2004.0,13.6,28,16,10,14,4,17,33,51.5,16,13,3,10,17,45,12,0,MF,Under 20,Midfielder,Germany,Europe
2054,Leonardo Pavoletti,ITA,Cagliari,Serie A,2023,34.0,1988.0,7.0,1,1,0,0,1,0,1,0.0,1,2,1,1,0,1,7,0,FW,30-34,Forward,Italy,Europe
2055,Martín Payero,ARG,Udinese,Serie A,2023,24.0,1998.0,20.0,54,32,28,19,7,19,46,41.3,27,25,7,18,15,69,21,0,MF,20-24,Midfielder,Argentina,South America
2056,Nicolás Paz,ARG,Real Madrid,La Liga,2023,18.0,2004.0,0.3,0,0,0,0,0,0,0,,0,2,0,2,1,1,0,0,"MF,FW",Under 20,Midfielder,Argentina,South America
2057,Myles Peart-Harris,ENG,Brentford,Premier League,2023,20.0,2002.0,0.1,0,0,0,0,0,0,0,,0,0,0,0,0,0,1,0,"DF,MF",20-24,Defender,England,Europe
2058,Sydie Peck,ENG,Sheffield Utd,Premier League,2023,18.0,2004.0,0.1,0,0,0,0,0,0,0,,0,0,0,0,0,0,0,0,MF,Under 20,Midfielder,England,Europe
2059,Mads Pedersen,DEN,Augsburg,Bundesliga,2023,26.0,1996.0,19.8,64,39,31,27,6,24,44,54.5,20,20,3,17,19,83,46,0,DF,25-29,Defender,Denmark,Europe
2059,Mads Pedersen,DEN,Augsburg,Bundesliga,2023,26.0,1996.0,19.8,64,39,31,27,6,24,44,54.5,20,20,3,17,19,83,46,0,DF,25-29,Defender,Denmark,Europe
2059,Mads Pedersen,DEN,Augsburg,Bundesliga,2023,26.0,1996.0,19.8,64,39,31,27,6,24,44,54.5,20,20,3,17,19,83,46,0,DF,25-29,Defender,Denmark,Europe
2059,Mads Pedersen,DEN,Augsburg,Bundesliga,2023,26.0,1996.0,19.8,64,39,31,27,6,24,44,54.5,20,20,3,17,19,83,46,0,DF,25-29,Defender,Denmark,Europe
2065,Jordan Pefok,USA,Gladbach,Bundesliga,2023,27.0,1996.0,15.8,10,4,0,8,2,3,8,37.5,5,12,3,9,5,15,28,0,FW,25-29,Forward,United States,North America
2066,Jordan Pefok,USA,Union Berlin,Bundesliga,2023,27.0,1996.0,0.3,0,0,0,0,0,0,0,,0,1,1,0,0,0,0,0,FW,25-29,Forward,United States,North America
2067,Dženan Pejčinović,GER,Wolfsburg,Bundesliga,2023,18.0,2005.0,0.4,0,0,0,0,0,0,0,,0,1,0,1,0,0,0,0,FW,Under 20,Forward,Germany,Europe
2069,Pietro Pellegri,ITA,Torino,Serie A,2023,22.0,2001.0,8.4,5,1,1,4,0,1,5,20.0,4,4,1,3,2,7,3,0,FW,20-24,Forward,Italy,Europe
2070,Lorenzo Pellegrini,ITA,Roma,Serie A,2023,27.0,1996.0,20.7,35,20,14,16,5,17,51,33.3,34,28,5,23,20,55,22,0,MF,25-29,Midfielder,Italy,Europe
2071,Luca Pellegrini,ITA,Lazio,Serie A,2023,24.0,1999.0,8.7,18,13,7,10,1,9,17,52.9,8,7,3,4,9,27,20,0,DF,20-24,Defender,Italy,Europe
2074,Facundo Pellistri,URU,Manchester Utd,Premier League,2023,21.0,2001.0,1.9,5,3,4,1,0,1,3,33.3,2,7,1,6,1,6,5,0,"FW,MF",20-24,Forward,Uruguay,South America
2075,Facundo Pellistri,URU,Granada,La Liga,2023,21.0,2001.0,13.7,29,19,12,10,7,6,21,28.6,15,18,0,18,4,33,7,0,"MF,FW",20-24,Midfielder,Uruguay,South America
2076,Andy Pelmard,FRA,Clermont Foot,Ligue 1,2023,23.0,2000.0,33.2,51,38,41,9,1,32,40,80.0,8,37,20,17,33,84,99,2,DF,20-24,Defender,France,Europe
2077,Aurélien Pelon,FRA,Lorient,Ligue 1,2023,19.0,2004.0,1.0,1,0,1,0,0,0,2,0.0,2,2,2,0,0,1,7,0,DF,Under 20,Defender,France,Europe
2078,Faris Pemi Moumbagna,CMR,Marseille,Ligue 1,2023,23.0,2000.0,6.1,2,1,0,2,0,0,3,0.0,3,4,0,4,3,5,1,0,FW,20-24,Forward,Cameroon,Africa
2082,Pepín,EQG,Monza,Serie A,2023,26.0,1996.0,2.7,6,1,1,4,1,2,4,50.0,2,5,2,3,0,6,6,0,"MF,FW",25-29,Midfielder,Equatorial Guinea,Africa
2084,Andreas Pereira,BRA,Fulham,Premier League,2023,27.0,1996.0,29.0,25,12,4,12,9,11,41,26.8,30,16,2,14,4,29,12,0,MF,25-29,Midfielder,Brazil,South America
2085,Danilo Pereira,POR,Paris S-G,Ligue 1,2023,31.0,1991.0,22.2,22,12,14,6,2,9,17,52.9,8,29,26,3,23,45,100,1,DF,30-34,Defender,Portugal,Europe
2086,Mathias Pereira Lage,POR,Brest,Ligue 1,2023,26.0,1996.0,13.2,21,15,7,8,6,7,28,25.0,21,14,5,9,10,31,13,0,"FW,MF",25-29,Forward,Portugal,Europe
2087,Pedro Pereira,POR,Monza,Serie A,2023,25.0,1998.0,9.3,19,13,14,4,1,9,17,52.9,8,15,2,13,4,23,18,0,DF,25-29,Defender,Portugal,Europe
2087,Pedro Pereira,POR,Monza,Serie A,2023,25.0,1998.0,9.3,19,13,14,4,1,9,17,52.9,8,15,2,13,4,23,18,0,DF,25-29,Defender,Portugal,Europe
2087,Pedro Pereira,POR,Monza,Serie A,2023,25.0,1998.0,9.3,19,13,14,4,1,9,17,52.9,8,15,2,13,4,23,18,0,DF,25-29,Defender,Portugal,Europe
2087,Pedro Pereira,POR,Monza,Serie A,2023,25.0,1998.0,9.3,19,13,14,4,1,9,17,52.9,8,15,2,13,4,23,18,0,DF,25-29,Defender,Portugal,Europe
2088,Daniel Peretz,ISR,Bayern Munich,Bundesliga,2023,23.0,2000.0,0.2,0,0,0,0,0,0,0,,0,0,0,0,0,0,0,0,GK,20-24,Goalkeeper,Israel,Asia
2089,Roberto Pereyra,ARG,Udinese,Serie A,2023,32.0,1991.0,20.6,19,9,11,5,3,11,29,37.9,18,20,4,16,7,26,18,0,"FW,MF",30-34,Forward,Argentina,South America
2094,Nehuén Pérez,ARG,Udinese,Serie A,2023,23.0,2000.0,36.0,72,48,42,28,2,39,48,81.3,9,53,26,27,45,117,158,1,DF,20-24,Defender,Argentina,South America
2095,Matteo Perez Vinlöf,SWE,Bayern Munich,Bundesliga,2023,17.0,2005.0,0.2,0,0,0,0,0,0,0,,0,0,0,0,1,1,0,0,FW,Under 20,Forward,Sweden,Europe
2096,Simone Perilli,ITA,Hellas Verona,Serie A,2023,28.0,1995.0,1.0,0,0,0,0,0,0,0,,0,0,0,0,0,0,0,0,GK,25-29,Goalkeeper,Italy,Europe
2097,Mattia Perin,ITA,Juventus,Serie A,2023,30.0,1992.0,2.5,0,0,0,0,0,0,0,,0,0,0,0,0,0,1,0,GK,30-34,Goalkeeper,Italy,Europe
2098,Samuele Perisan,ITA,Empoli,Serie A,2023,25.0,1997.0,1.0,0,0,0,0,0,0,0,,0,0,0,0,0,0,0,0,GK,25-29,Goalkeeper,Italy,Europe
2099,Ivan Perišić,CRO,Tottenham,Premier League,2023,34.0,1989.0,1.1,3,2,1,1,1,3,5,60.0,2,1,0,1,2,5,1,0,FW,30-34,Forward,Croatia,Europe
2100,Romain Perraud,FRA,Nice,Ligue 1,2023,25.0,1997.0,4.1,7,6,5,1,1,4,11,36.4,7,4,0,4,6,13,15,1,"DF,FW",25-29,Defender,France,Europe
2101,Lucas Perrin,FRA,Strasbourg,Ligue 1,2023,24.0,1998.0,30.3,47,30,33,14,0,28,46,60.9,18,45,32,13,28,75,113,0,DF,20-24,Defender,France,Europe
2102,Máximo Perrone,ARG,Las Palmas,La Liga,2023,20.0,2003.0,18.0,42,21,17,22,3,19,39,48.7,20,27,4,23,24,66,21,0,MF,20-24,Midfielder,Argentina,South America
2103,Pavao Pervan,AUT,Wolfsburg,Bundesliga,2023,35.0,1987.0,9.0,0,0,0,0,0,0,0,,0,0,0,0,0,0,4,0,GK,35-39,Goalkeeper,Austria,Europe
2104,Matteo Pessina,ITA,Monza,Serie A,2023,26.0,1997.0,35.8,44,25,20,20,4,23,49,46.9,26,29,11,18,27,71,46,1,MF,25-29,Midfielder,Italy,Europe
2105,Andrea Petagna,ITA,Cagliari,Serie A,2023,28.0,1995.0,11.1,4,2,1,0,3,1,2,50.0,1,6,3,3,1,5,4,0,FW,25-29,Forward,Italy,Europe
2110,Germán Pezzella,ARG,Betis,La Liga,2023,32.0,1991.0,30.7,34,24,24,10,0,23,38,60.5,15,31,18,13,31,65,150,0,DF,30-34,Defender,Argentina,South America
2111,Giuseppe Pezzella,ITA,Empoli,Serie A,2023,25.0,1997.0,12.1,25,14,19,5,1,20,28,71.4,8,17,6,11,2,27,35,0,DF,25-29,Defender,Italy,Europe
2112,Luca Pfeiffer,GER,Darmstadt 98,Bundesliga,2023,26.0,1996.0,18.0,11,6,2,6,3,5,11,45.5,6,5,1,4,2,13,21,0,"FW,MF",25-29,Forward,Germany,Europe
2113,Patric Pfeiffer,GER,Augsburg,Bundesliga,2023,23.0,1999.0,5.7,11,7,6,4,1,5,6,83.3,1,10,6,4,11,22,21,0,DF,20-24,Defender,Germany,Europe
2114,Maximilian Philipp,GER,Freiburg,Bundesliga,2023,29.0,1994.0,3.6,8,5,4,4,0,1,6,16.7,5,7,0,7,1,9,3,0,"FW,MF",25-29,Forward,Germany,Europe
2115,Kalvin Phillips,ENG,West Ham,Premier League,2023,27.0,1995.0,3.4,11,6,2,8,1,5,9,55.6,4,4,1,3,4,15,2,1,MF,25-29,Midfielder,England,Europe
2116,Kalvin Phillips,ENG,Manchester City,Premier League,2023,27.0,1995.0,1.0,3,3,1,1,1,0,0,,0,0,0,0,2,5,2,0,MF,25-29,Midfielder,England,Europe
2117,Jaden Philogene Bidace,ENG,Aston Villa,Premier League,2023,21.0,2002.0,0.0,0,0,0,0,0,0,0,,0,0,0,0,0,0,0,0,FW,20-24,Forward,England,Europe
2119,Roberto Piccoli,ITA,Empoli,Serie A,2023,22.0,2001.0,0.4,1,1,0,0,1,1,1,100.0,0,0,0,0,0,1,0,0,FW,20-24,Forward,Italy,Europe
2120,Roberto Piccoli,ITA,Lecce,Serie A,2023,22.0,2001.0,15.3,10,6,3,5,2,1,4,25.0,3,17,1,16,4,14,16,0,FW,20-24,Forward,Italy,Europe
2121,Florian Pick,GER,Heidenheim,Bundesliga,2023,27.0,1995.0,3.6,4,4,3,0,1,2,3,66.7,1,2,0,2,2,6,2,0,"MF,FW",25-29,Midfielder,Germany,Europe
2122,Jordan Pickford,ENG,Everton,Premier League,2023,29.0,1994.0,38.0,1,0,1,0,0,1,1,100.0,0,3,0,3,0,1,19,1,GK,25-29,Goalkeeper,England,Europe
2123,Amos Pieper,GER,Werder Bremen,Bundesliga,2023,25.0,1998.0,6.6,14,11,8,6,0,7,13,53.8,6,12,7,5,9,23,36,1,DF,25-29,Defender,Germany,Europe
2124,Marvin Pieringer,GER,Heidenheim,Bundesliga,2023,23.0,1999.0,16.8,19,12,5,11,3,8,20,40.0,12,28,4,24,12,31,21,0,"MF,FW",20-24,Midfielder,Germany,Europe
2125,Santiago Pierotti,ARG,Lecce,Serie A,2023,22.0,2001.0,2.2,8,8,2,5,1,2,8,25.0,6,5,0,5,1,9,0,0,"MF,FW",20-24,Midfielder,Argentina,South America
2126,Niccolò Pierozzi,ITA,Salernitana,Serie A,2023,21.0,2001.0,9.7,17,11,13,4,0,11,22,50.0,11,24,7,17,11,28,36,0,DF,20-24,Defender,Italy,Europe
2127,Ronaël Pierre-Gabriel,FRA,Nantes,Ligue 1,2023,25.0,1998.0,6.6,15,9,12,2,1,5,7,71.4,2,13,4,9,8,23,25,0,DF,25-29,Defender,France,Europe
2128,Andrea Pinamonti,ITA,Sassuolo,Serie A,2023,24.0,1999.0,34.2,13,8,1,6,6,5,22,22.7,17,19,2,17,1,14,40,0,FW,20-24,Forward,Italy,Europe
2129,Ethan Pinnock,JAM,Brentford,Premier League,2023,30.0,1993.0,28.0,35,23,22,13,0,9,20,45.0,11,40,24,16,43,78,170,3,DF,30-34,Defender,Jamaica,North America
2131,Carlo Pinsoglio,ITA,Juventus,Serie A,2023,33.0,1990.0,0.5,0,0,0,0,0,0,0,,0,0,0,0,0,0,0,0,GK,30-34,Goalkeeper,Italy,Europe
2132,Lorenzo Pirola,ITA,Salernitana,Serie A,2023,21.0,2002.0,22.1,39,23,25,14,0,15,28,53.6,13,46,30,16,25,64,93,1,DF,20-24,Defender,Italy,Europe
2133,Niccolò Pisilli,ITA,Roma,Serie A,2023,18.0,2004.0,0.1,0,0,0,0,0,0,0,,0,0,0,0,0,0,0,0,MF,Under 20,Midfielder,Italy,Europe
2134,Alassane Pléa,FRA,Gladbach,Bundesliga,2023,30.0,1993.0,21.3,17,7,5,8,4,7,15,46.7,8,11,0,11,2,19,6,0,"FW,MF",30-34,Forward,France,Europe
2135,Tommaso Pobega,ITA,Milan,Serie A,2023,24.0,1999.0,3.5,16,9,11,5,0,6,13,46.2,7,10,2,8,6,22,7,0,MF,20-24,Midfielder,Italy,Europe
2136,Paul Pogba,FRA,Juventus,Serie A,2023,30.0,1993.0,0.6,1,1,0,1,0,1,1,100.0,0,0,0,0,1,2,1,0,MF,30-34,Midfielder,France,Europe
2137,Ole Pohlmann,GER,Dortmund,Bundesliga,2023,22.0,2001.0,0.6,1,0,0,1,0,1,2,50.0,1,0,0,0,0,1,1,0,MF,20-24,Midfielder,Germany,Europe
2138,Matteo Politano,ITA,Napoli,Serie A,2023,29.0,1993.0,26.2,19,8,8,7,4,11,34,32.4,23,9,1,8,15,34,11,1,FW,25-29,Forward,Italy,Europe
2139,Sebastian Polter,GER,Darmstadt 98,Bundesliga,2023,32.0,1991.0,5.0,1,0,1,0,0,0,1,0.0,1,5,1,4,0,1,4,0,FW,30-34,Forward,Germany,Europe
2140,Julien Ponceau,FRA,Lorient,Ligue 1,2023,22.0,2000.0,24.9,32,15,12,14,6,9,30,30.0,21,22,1,21,19,51,20,0,MF,20-24,Midfielder,France,Europe
2141,Marin Pongračić,CRO,Lecce,Serie A,2023,25.0,1997.0,35.8,43,30,22,20,1,19,25,76.0,6,37,26,11,51,94,130,1,DF,25-29,Defender,Croatia,Europe
2142,Nick Pope,ENG,Newcastle Utd,Premier League,2023,31.0,1992.0,14.9,0,0,0,0,0,0,1,0.0,1,0,0,0,0,0,7,2,GK,30-34,Goalkeeper,England,Europe
2146,Stefan Posch,AUT,Bologna,Serie A,2023,26.0,1997.0,26.8,77,46,35,38,4,49,88,55.7,39,27,8,19,18,95,72,0,DF,25-29,Defender,Austria,Europe
2147,Yussuf Poulsen,DEN,RB Leipzig,Bundesliga,2023,29.0,1994.0,13.5,13,8,1,9,3,4,14,28.6,10,13,3,10,4,17,15,0,FW,25-29,Forward,Denmark,Europe
2151,Matteo Prati,ITA,Cagliari,Serie A,2023,19.0,2003.0,21.9,45,25,15,27,3,26,42,61.9,16,29,6,23,15,60,26,1,MF,Under 20,Midfielder,Italy,Europe
2153,Sanjin Prcić,BIH,Strasbourg,Ligue 1,2023,29.0,1993.0,1.0,0,0,0,0,0,0,1,0.0,1,2,1,1,3,3,1,0,MF,25-29,Midfielder,Bosnia and Herzegovina,Europe
2154,Grischa Prömel,GER,Hoffenheim,Bundesliga,2023,28.0,1995.0,23.8,32,18,11,15,6,14,32,43.8,18,22,6,16,22,54,36,0,MF,25-29,Midfielder,Germany,Europe
2155,Ivan Provedel,ITA,Lazio,Serie A,2023,29.0,1994.0,30.0,1,0,1,0,0,1,3,33.3,2,0,0,0,0,1,12,1,GK,25-29,Goalkeeper,Italy,Europe
2157,Gustavo Puerta,COL,Leverkusen,Bundesliga,2023,20.0,2003.0,0.5,5,3,2,2,1,1,2,50.0,1,2,0,2,0,5,0,0,"DF,MF",20-24,Defender,Colombia,South America
2160,Christian Pulisic,USA,Milan,Serie A,2023,24.0,1998.0,28.9,35,26,14,11,10,17,30,56.7,13,20,1,19,10,45,10,1,"FW,MF",20-24,Forward,United States,North America
2161,George Pușcaș,ROU,Genoa,Serie A,2023,27.0,1996.0,2.1,0,0,0,0,0,0,3,0.0,3,1,0,1,0,0,1,0,FW,25-29,Forward,Romania,Europe
2162,Jarell Quansah,ENG,Liverpool,Premier League,2023,20.0,2003.0,13.2,25,22,17,7,1,14,20,70.0,6,16,8,8,17,42,39,1,DF,20-24,Defender,England,Europe
2163,Domingos Quina,POR,Udinese,Serie A,2023,23.0,1999.0,0.1,1,1,1,0,0,0,0,,0,0,0,0,0,1,0,0,MF,20-24,Midfielder,Portugal,Europe
2164,Adrien Rabiot,FRA,Juventus,Serie A,2023,28.0,1995.0,29.5,58,39,22,30,6,30,45,66.7,15,26,6,20,25,83,34,0,MF,25-29,Midfielder,France,Europe
2169,Ionuț Radu,ROU,Bournemouth,Premier League,2023,26.0,1997.0,2.0,0,0,0,0,0,0,0,,0,0,0,0,0,0,0,0,GK,25-29,Goalkeeper,Romania,Europe
2171,Hamza Rafia,TUN,Lecce,Serie A,2023,24.0,1999.0,13.4,44,31,13,27,4,13,30,43.3,17,27,1,26,11,55,13,0,MF,20-24,Midfielder,Tunisia,Africa
2172,Abdellah Raihani,MAR,Atlético Madrid,La Liga,2023,19.0,2004.0,0.1,0,0,0,0,0,0,1,0.0,1,0,0,0,0,0,0,0,FW,Under 20,Forward,Morocco,Africa
2174,Luca Raimund,GER,Stuttgart,Bundesliga,2023,18.0,2005.0,0.3,3,1,2,1,0,0,0,,0,2,0,2,0,3,0,0,"FW,MF",Under 20,Forward,Germany,Europe
2176,Jesurun Rak Sakyi,ENG,Crystal Palace,Premier League,2023,20.0,2002.0,1.5,4,1,3,1,0,2,3,66.7,1,2,0,2,3,7,1,0,"MF,FW",20-24,Midfielder,England,Europe
2177,Ivan Rakitić,CRO,Sevilla,La Liga,2023,35.0,1988.0,15.8,30,16,9,12,9,11,19,57.9,8,16,5,11,14,44,12,0,MF,35-39,Midfielder,Croatia,Europe
2178,Ylber Ramadani,ALB,Lecce,Serie A,2023,27.0,1996.0,33.0,68,41,32,29,7,37,96,38.5,59,54,13,41,44,112,44,0,MF,25-29,Midfielder,Albania,Europe
2179,Largie Ramazani,BEL,Almería,La Liga,2023,22.0,2001.0,17.3,12,7,5,6,1,6,26,23.1,20,16,2,14,34,46,10,0,"FW,MF",20-24,Forward,Belgium,Europe
2183,Gonçalo Ramos,POR,Paris S-G,Ligue 1,2023,22.0,2001.0,15.8,25,15,4,12,9,6,20,30.0,14,12,2,10,5,30,16,0,FW,20-24,Forward,Portugal,Europe
2185,Aaron Ramsdale,ENG,Arsenal,Premier League,2023,25.0,1998.0,6.0,0,0,0,0,0,0,0,,0,0,0,0,0,0,3,2,GK,25-29,Goalkeeper,England,Europe
2186,Aaron Ramsey,ENG,Burnley,Premier League,2023,20.0,2003.0,5.9,17,14,7,5,5,8,16,50.0,8,11,2,9,1,18,10,0,"MF,FW",20-24,Midfielder,England,Europe
2186,Aaron Ramsey,ENG,Burnley,Premier League,2023,20.0,2003.0,5.9,17,14,7,5,5,8,16,50.0,8,11,2,9,1,18,10,0,"MF,FW",20-24,Midfielder,England,Europe
2186,Aaron Ramsey,ENG,Burnley,Premier League,2023,20.0,2003.0,5.9,17,14,7,5,5,8,16,50.0,8,11,2,9,1,18,10,0,"MF,FW",20-24,Midfielder,England,Europe
2186,Aaron Ramsey,ENG,Burnley,Premier League,2023,20.0,2003.0,5.9,17,14,7,5,5,8,16,50.0,8,11,2,9,1,18,10,0,"MF,FW",20-24,Midfielder,England,Europe
2187,Jacob Ramsey,ENG,Aston Villa,Premier League,2023,22.0,2001.0,9.5,16,8,7,6,3,5,15,33.3,10,15,2,13,3,19,8,0,"FW,MF",20-24,Forward,England,Europe
2188,Luca Ranieri,ITA,Fiorentina,Serie A,2023,24.0,1999.0,22.9,14,10,11,1,2,8,13,61.5,5,25,11,14,29,43,64,0,DF,20-24,Defender,Italy,Europe
2189,Filippo Ranocchia,ITA,Empoli,Serie A,2023,22.0,2001.0,5.3,16,11,7,9,0,7,16,43.8,9,9,1,8,3,19,14,0,"MF,DF",20-24,Midfielder,Italy,Europe
2190,Grant Ranos,ARM,Gladbach,Bundesliga,2023,20.0,2003.0,0.5,1,0,0,0,1,0,0,,0,0,0,0,0,1,0,0,"MF,FW",20-24,Midfielder,Armenia,Asia
2191,Raphinha,BRA,Barcelona,La Liga,2023,26.0,1996.0,15.2,14,8,6,6,2,4,18,22.2,14,17,1,16,13,27,11,0,"FW,MF",25-29,Forward,Brazil,South America
2192,Nicolai Rapp,GER,Werder Bremen,Bundesliga,2023,26.0,1996.0,0.8,3,2,2,1,0,2,2,100.0,0,2,0,2,2,5,8,0,DF,25-29,Defender,Germany,Europe
2194,Marcus Rashford,ENG,Manchester Utd,Premier League,2023,25.0,1997.0,25.2,19,12,9,4,6,9,26,34.6,17,15,1,14,4,23,21,0,FW,25-29,Forward,England,Europe
2195,Giacomo Raspadori,ITA,Napoli,Serie A,2023,23.0,2000.0,17.6,21,10,6,10,5,6,15,40.0,9,15,1,14,3,24,7,0,"FW,MF",20-24,Forward,Italy,Europe
2196,Andrei Ratiu,ROU,Rayo Vallecano,La Liga,2023,25.0,1998.0,7.0,12,4,6,5,1,8,15,53.3,7,4,1,3,0,12,12,0,"DF,MF",25-29,Defender,Romania,Europe
2198,David Raum,GER,RB Leipzig,Bundesliga,2023,25.0,1998.0,30.4,58,35,24,29,5,34,58,58.6,24,51,9,42,27,85,82,2,DF,25-29,Defender,Germany,Europe
2199,Federico Ravaglia,ITA,Bologna,Serie A,2023,23.0,1999.0,5.9,0,0,0,0,0,0,0,,0,0,0,0,0,0,2,0,GK,20-24,Goalkeeper,Italy,Europe
2201,Tim Ream,USA,Fulham,Premier League,2023,35.0,1987.0,16.7,20,9,13,5,2,9,18,50.0,9,23,15,8,25,45,61,2,DF,35-39,Defender,United States,North America
2202,Abderrahman Rebbach,ALG,Alavés,La Liga,2023,24.0,1998.0,8.0,9,5,4,2,3,5,15,33.3,10,10,1,9,3,12,7,0,"FW,MF",20-24,Forward,Algeria,Africa
2203,Nathan Redmond,ENG,Burnley,Premier League,2023,29.0,1994.0,1.6,2,1,0,0,2,1,4,25.0,3,1,0,1,0,2,3,0,"FW,MF",25-29,Forward,England,Europe
2204,Harrison Reed,ENG,Fulham,Premier League,2023,28.0,1995.0,14.7,29,18,9,17,3,13,31,41.9,18,19,9,10,11,40,24,0,MF,25-29,Midfielder,England,Europe
2207,Bobby Reid,JAM,Fulham,Premier League,2023,30.0,1993.0,15.8,22,14,5,15,2,4,16,25.0,12,24,2,22,5,27,14,0,FW,30-34,Forward,Jamaica,North America
2208,Tijjani Reijnders,NED,Milan,Serie A,2023,25.0,1998.0,31.3,46,25,10,31,5,21,43,48.8,22,26,8,18,18,64,26,0,MF,25-29,Midfielder,Netherlands,Europe
2210,Reinier,BRA,Frosinone,Serie A,2023,21.0,2002.0,11.8,21,10,6,12,3,5,17,29.4,12,24,4,20,10,31,5,0,"MF,FW",20-24,Midfielder,Brazil,South America
2211,Rocco Reitz,GER,Gladbach,Bundesliga,2023,21.0,2002.0,23.7,61,36,28,29,4,28,55,50.9,27,61,20,41,44,105,31,1,MF,20-24,Midfielder,Germany,Europe
2213,Guillaume Restes,FRA,Toulouse,Ligue 1,2023,18.0,2005.0,34.0,0,0,0,0,0,0,3,0.0,3,0,0,0,0,0,19,1,GK,Under 20,Goalkeeper,France,Europe
2214,Mateo Retegui,ITA,Genoa,Serie A,2023,24.0,1999.0,24.6,17,9,7,8,2,6,20,30.0,14,18,2,16,0,17,30,0,FW,20-24,Forward,Italy,Europe
2215,Marco Reus,GER,Dortmund,Bundesliga,2023,34.0,1989.0,17.8,37,25,20,14,3,12,27,44.4,15,17,2,15,5,42,18,0,"MF,FW",30-34,Midfielder,Germany,Europe
2217,Gio Reyna,USA,Nott'ham Forest,Premier League,2023,20.0,2002.0,2.6,7,3,4,0,3,3,6,50.0,3,3,0,3,2,9,0,0,"FW,MF",20-24,Forward,United States,North America
2218,Gio Reyna,USA,Dortmund,Bundesliga,2023,20.0,2002.0,3.1,9,6,3,4,2,2,5,40.0,3,5,1,4,2,11,5,0,"MF,FW",20-24,Midfielder,United States,North America
2219,Chadi Riad,MAR,Betis,La Liga,2023,20.0,2003.0,24.0,35,24,17,18,0,17,27,63.0,10,23,14,9,23,58,108,0,DF,20-24,Defender,Morocco,Africa
2220,Alexsandro Ribeiro,BRA,Lille,Ligue 1,2023,23.0,1999.0,24.7,32,22,24,8,0,16,31,51.6,15,25,15,10,35,67,116,5,DF,20-24,Defender,Brazil,South America
2221,Rodrigo Ribeiro,POR,Nott'ham Forest,Premier League,2023,18.0,2005.0,0.2,0,0,0,0,0,0,1,0.0,1,1,0,1,1,1,0,0,"MF,FW",Under 20,Midfielder,Portugal,Europe
2221,Rodrigo Ribeiro,POR,Nott'ham Forest,Premier League,2023,18.0,2005.0,0.2,0,0,0,0,0,0,1,0.0,1,1,0,1,1,1,0,0,"MF,FW",Under 20,Midfielder,Portugal,Europe
2221,Rodrigo Ribeiro,POR,Nott'ham Forest,Premier League,2023,18.0,2005.0,0.2,0,0,0,0,0,0,1,0.0,1,1,0,1,1,1,0,0,"MF,FW",Under 20,Midfielder,Portugal,Europe
2221,Rodrigo Ribeiro,POR,Nott'ham Forest,Premier League,2023,18.0,2005.0,0.2,0,0,0,0,0,0,1,0.0,1,1,0,1,1,1,0,0,"MF,FW",Under 20,Midfielder,Portugal,Europe
2222,Samuele Ricci,ITA,Torino,Serie A,2023,21.0,2001.0,26.6,33,18,17,12,4,15,23,65.2,8,21,3,18,27,60,25,0,MF,20-24,Midfielder,Italy,Europe
2223,Declan Rice,ENG,Arsenal,Premier League,2023,24.0,1999.0,35.8,83,51,37,38,8,32,57,56.1,25,37,11,26,44,127,52,0,MF,20-24,Midfielder,England,Europe
2224,Chris Richards,USA,Crystal Palace,Premier League,2023,23.0,2000.0,23.3,46,28,21,22,3,20,30,66.7,10,32,12,20,27,73,109,0,"DF,MF",20-24,Defender,United States,North America
2225,Amir Richardson,MAR,Reims,Ligue 1,2023,21.0,2002.0,15.0,33,23,12,18,3,10,22,45.5,12,26,5,21,15,48,30,0,MF,20-24,Midfielder,Morocco,Africa
2226,Richarlison,BRA,Tottenham,Premier League,2023,26.0,1997.0,16.6,16,11,4,8,4,2,10,20.0,8,32,6,26,8,24,23,0,FW,25-29,Forward,Brazil,South America
2227,Marco Richter,GER,Mainz 05,Bundesliga,2023,25.0,1997.0,8.0,10,4,5,3,2,4,11,36.4,7,9,0,9,2,12,1,0,"MF,FW",25-29,Midfielder,Germany,Europe
2229,Clemens Riedel,GER,Darmstadt 98,Bundesliga,2023,20.0,2003.0,8.4,22,13,16,5,1,15,24,62.5,9,11,3,8,11,33,26,0,DF,20-24,Defender,Germany,Europe
2230,Fabian Rieder,SUI,Rennes,Ligue 1,2023,21.0,2002.0,4.1,13,7,2,9,2,6,11,54.5,5,3,1,2,5,18,2,0,MF,20-24,Midfielder,Switzerland,Europe
2231,Jaïro Riedewald,NED,Crystal Palace,Premier League,2023,26.0,1996.0,2.6,9,3,2,4,3,3,6,50.0,3,0,0,0,2,11,2,0,"MF,FW",25-29,Midfielder,Netherlands,Europe
2232,Manuel Riemann,GER,Bochum,Bundesliga,2023,34.0,1988.0,33.0,2,1,2,0,0,2,4,50.0,2,0,0,0,1,3,25,1,GK,30-34,Goalkeeper,Germany,Europe
2234,Rémy Riou,FRA,Lyon,Ligue 1,2023,35.0,1987.0,3.0,0,0,0,0,0,0,1,0.0,1,0,0,0,0,0,1,1,GK,35-39,Goalkeeper,France,Europe
2238,Matt Ritchie,SCO,Newcastle Utd,Premier League,2023,33.0,1989.0,1.4,5,3,2,2,1,2,4,50.0,2,3,2,1,1,6,5,0,"FW,MF",30-34,Forward,Scotland,Europe
2241,Lucas Robertone,ARG,Almería,La Liga,2023,26.0,1997.0,26.5,61,33,28,23,10,25,50,50.0,25,43,9,34,51,112,43,0,MF,25-29,Midfielder,Argentina,South America
2242,Connor Roberts,WAL,Burnley,Premier League,2023,27.0,1995.0,9.1,12,5,6,4,2,8,17,47.1,9,8,6,2,4,16,25,2,DF,25-29,Defender,Wales,Europe
2243,Andrew Robertson,SCO,Liverpool,Premier League,2023,29.0,1994.0,18.8,35,24,21,11,3,26,43,60.5,17,20,6,14,13,48,40,0,DF,25-29,Defender,Scotland,Europe
2244,Antonee Robinson,USA,Fulham,Premier League,2023,25.0,1997.0,36.3,93,58,60,26,7,52,110,47.3,58,56,8,48,80,173,117,3,DF,25-29,Defender,United States,North America
2245,Jack Robinson,ENG,Sheffield Utd,Premier League,2023,29.0,1993.0,32.1,43,28,29,14,0,25,39,64.1,14,49,33,16,33,76,132,2,DF,25-29,Defender,England,Europe
2247,Sebastian Rode,GER,Eint Frankfurt,Bundesliga,2023,32.0,1990.0,0.7,6,4,0,5,1,4,6,66.7,2,0,0,0,1,7,1,0,MF,30-34,Midfielder,Germany,Europe
2251,Álvaro Rodríguez,URU,Real Madrid,La Liga,2023,19.0,2004.0,0.0,0,0,0,0,0,0,0,,0,0,0,0,0,0,1,0,FW,Under 20,Forward,Uruguay,South America
2255,Guido Rodríguez,ARG,Betis,La Liga,2023,29.0,1994.0,20.5,53,30,21,24,8,34,55,61.8,21,27,6,21,29,82,44,0,MF,25-29,Midfielder,Argentina,South America
2256,Jay Rodriguez,ENG,Burnley,Premier League,2023,34.0,1989.0,9.1,14,9,7,4,3,7,13,53.8,6,11,1,10,1,15,8,0,FW,30-34,Forward,England,Europe
2259,Ricardo Rodríguez,SUI,Torino,Serie A,2023,30.0,1992.0,30.8,45,26,21,22,2,28,45,62.2,17,22,9,13,24,69,64,2,DF,30-34,Defender,Switzerland,Europe
2260,Rodrygo,BRA,Real Madrid,La Liga,2023,22.0,2001.0,26.4,16,15,2,9,5,5,19,26.3,14,14,0,14,8,24,6,0,FW,20-24,Forward,Brazil,South America
2261,Mads Roerslev,DEN,Brentford,Premier League,2023,24.0,1999.0,22.1,48,31,34,9,5,27,54,50.0,27,15,3,12,19,67,71,0,DF,20-24,Defender,Denmark,Europe
2262,Rogério,BRA,Wolfsburg,Bundesliga,2023,25.0,1998.0,10.1,14,6,7,5,2,10,14,71.4,4,16,5,11,5,19,23,1,DF,25-29,Defender,Brazil,South America
2262,Rogério,BRA,Wolfsburg,Bundesliga,2023,25.0,1998.0,10.1,14,6,7,5,2,10,14,71.4,4,16,5,11,5,19,23,1,DF,25-29,Defender,Brazil,South America
2262,Rogério,BRA,Wolfsburg,Bundesliga,2023,25.0,1998.0,10.1,14,6,7,5,2,10,14,71.4,4,16,5,11,5,19,23,1,DF,25-29,Defender,Brazil,South America
2262,Rogério,BRA,Wolfsburg,Bundesliga,2023,25.0,1998.0,10.1,14,6,7,5,2,10,14,71.4,4,16,5,11,5,19,23,1,DF,25-29,Defender,Brazil,South America
2263,Morgan Rogers,ENG,Aston Villa,Premier League,2023,21.0,2002.0,7.1,8,1,3,2,3,2,11,18.2,9,11,0,11,3,11,11,0,"MF,FW",20-24,Midfielder,England,Europe
2264,Merlin Röhl,GER,Freiburg,Bundesliga,2023,21.0,2002.0,16.4,21,13,10,9,2,8,21,38.1,13,27,3,24,9,30,22,0,"MF,FW",20-24,Midfielder,Germany,Europe
2265,Alessio Romagnoli,ITA,Lazio,Serie A,2023,28.0,1995.0,26.8,25,18,14,11,0,16,24,66.7,8,29,17,12,29,54,115,0,DF,25-29,Defender,Italy,Europe
2266,Simone Romagnoli,ITA,Frosinone,Serie A,2023,33.0,1990.0,30.2,35,15,23,11,1,15,20,75.0,5,51,36,15,29,64,147,0,DF,30-34,Defender,Italy,Europe
2268,Cristian Romero,ARG,Tottenham,Premier League,2023,25.0,1998.0,31.0,66,40,35,25,6,32,44,72.7,12,46,22,24,44,110,106,1,DF,25-29,Defender,Argentina,South America
2270,Luka Romero,ARG,Milan,Serie A,2023,18.0,2004.0,1.0,0,0,0,0,0,0,3,0.0,3,2,0,2,0,0,0,0,"FW,MF",Under 20,Forward,Argentina,South America
2271,Luka Romero,ARG,Almería,La Liga,2023,18.0,2004.0,4.9,5,1,2,3,0,2,4,50.0,2,12,1,11,1,6,2,1,FW,Under 20,Forward,Argentina,South America
2273,Valentin Rongier,FRA,Marseille,Ligue 1,2023,28.0,1994.0,9.5,23,12,9,12,2,14,26,53.8,12,16,4,12,15,38,18,0,MF,25-29,Midfielder,France,Europe
2274,Frank Ronstadt,GER,Darmstadt 98,Bundesliga,2023,26.0,1997.0,0.8,1,0,0,1,0,0,1,0.0,1,1,0,1,1,2,3,0,"DF,MF",25-29,Defender,Germany,Europe
2275,Marten de Roon,NED,Atalanta,Serie A,2023,32.0,1991.0,28.9,80,43,36,32,12,35,82,42.7,47,36,10,26,40,120,54,0,"MF,DF",30-34,Midfielder,Netherlands,Europe
2277,Vitor Roque,BRA,Barcelona,La Liga,2023,18.0,2005.0,3.6,3,2,2,0,1,0,2,0.0,2,3,0,3,0,3,5,0,FW,Under 20,Forward,Brazil,South America
2278,Pablo Rosario,NED,Nice,Ligue 1,2023,26.0,1997.0,22.3,36,25,15,16,5,23,34,67.6,11,27,13,14,29,65,39,0,"MF,DF",25-29,Midfielder,Netherlands,Europe
2279,Valentin Rosier,FRA,Nice,Ligue 1,2023,26.0,1996.0,0.6,1,0,1,0,0,0,0,,0,1,0,1,2,3,5,0,"DF,MF",25-29,Defender,France,Europe
2280,Francesco Rossi,ITA,Atalanta,Serie A,2023,32.0,1991.0,0.1,0,0,0,0,0,0,0,,0,0,0,0,0,0,0,0,GK,30-34,Goalkeeper,Italy,Europe
2281,Joe Rothwell,ENG,Bournemouth,Premier League,2023,28.0,1995.0,4.3,7,2,4,2,1,2,8,25.0,6,4,2,2,3,10,2,0,MF,25-29,Midfielder,England,Europe
2282,Anthony Rouault,FRA,Stuttgart,Bundesliga,2023,22.0,2001.0,11.2,21,12,14,5,2,13,21,61.9,8,14,8,6,8,29,28,0,DF,20-24,Defender,France,Europe
2283,Jérôme Roussillon,FRA,Union Berlin,Bundesliga,2023,30.0,1993.0,8.4,16,9,6,7,3,8,12,66.7,4,13,4,9,5,21,26,0,DF,30-34,Defender,France,Europe
2284,Nicolò Rovella,ITA,Lazio,Serie A,2023,21.0,2001.0,14.6,46,28,25,17,4,16,36,44.4,20,27,6,21,23,69,29,0,MF,20-24,Midfielder,Italy,Europe
2286,Ruan,BRA,Sassuolo,Serie A,2023,24.0,1999.0,16.8,25,15,11,10,4,10,18,55.6,8,18,15,3,24,49,68,2,DF,20-24,Defender,Brazil,South America
2287,Pelly Ruddock Mpanzu,COD,Luton Town,Premier League,2023,30.0,1993.0,12.2,13,5,6,6,1,5,9,55.6,4,15,7,8,9,22,16,3,MF,30-34,Midfielder,DR Congo,Africa
2288,Antonio Rüdiger,GER,Real Madrid,La Liga,2023,30.0,1993.0,30.1,26,15,18,4,4,16,20,80.0,4,27,20,7,11,37,89,0,DF,30-34,Defender,Germany,Europe
2289,Fabian Rüdlin,GER,Freiburg,Bundesliga,2023,26.0,1997.0,0.1,1,0,0,0,1,0,0,,0,0,0,0,0,1,0,0,MF,25-29,Midfielder,Germany,Europe
2291,Daniele Rugani,ITA,Juventus,Serie A,2023,29.0,1994.0,13.2,11,9,7,3,1,4,5,80.0,1,11,4,7,9,20,42,0,DF,25-29,Defender,Italy,Europe
2292,Matteo Ruggeri,ITA,Atalanta,Serie A,2023,21.0,2002.0,27.2,29,15,14,7,8,16,30,53.3,14,46,4,42,23,52,44,0,DF,20-24,Defender,Italy,Europe
2293,Mário Rui,POR,Napoli,Serie A,2023,32.0,1991.0,13.4,27,15,17,5,5,14,21,66.7,7,17,2,15,15,42,19,0,DF,30-34,Defender,Portugal,Europe
2298,Frederik Rønnow,DEN,Union Berlin,Bundesliga,2023,30.0,1992.0,33.0,1,1,1,0,0,0,0,,0,0,0,0,1,2,20,2,GK,30-34,Goalkeeper,Denmark,Europe
2299,José Sá,POR,Wolves,Premier League,2023,30.0,1993.0,33.7,0,0,0,0,0,0,1,0.0,1,3,0,3,0,0,21,5,GK,30-34,Goalkeeper,Portugal,Europe
2300,Youssouf Sabaly,SEN,Betis,La Liga,2023,30.0,1993.0,11.6,16,11,12,3,1,8,12,66.7,4,6,3,3,11,27,27,0,DF,30-34,Defender,Senegal,Africa
2301,Emmanuel Sabbi,USA,Le Havre,Ligue 1,2023,25.0,1997.0,17.6,38,19,15,15,8,16,39,41.0,23,26,2,24,19,57,7,0,"FW,MF",25-29,Forward,United States,North America
2302,Stefano Sabelli,ITA,Genoa,Serie A,2023,30.0,1993.0,27.0,50,24,28,19,3,15,46,32.6,31,27,6,21,23,73,35,0,DF,30-34,Defender,Italy,Europe
2303,Marcel Sabitzer,AUT,Dortmund,Bundesliga,2023,29.0,1994.0,21.8,39,24,18,20,1,23,42,54.8,19,31,12,19,12,51,34,0,MF,25-29,Midfielder,Austria,Europe
2304,Falaye Sacko,MLI,Montpellier,Ligue 1,2023,28.0,1995.0,15.4,28,16,13,10,5,21,32,65.6,11,19,7,12,24,52,37,0,DF,25-29,Defender,Mali,Africa
2305,Dominic Sadi,ENG,Bournemouth,Premier League,2023,19.0,2003.0,0.0,0,0,0,0,0,0,0,,0,0,0,0,0,0,0,0,FW,Under 20,Forward,England,Europe
2306,Umar Sadiq,NGA,Real Sociedad,La Liga,2023,26.0,1997.0,12.0,15,10,2,8,5,4,8,50.0,4,9,0,9,0,15,10,0,FW,25-29,Forward,Nigeria,Africa
2307,Alexis Saelemaekers,BEL,Bologna,Serie A,2023,24.0,1999.0,21.0,32,22,13,14,5,12,27,44.4,15,13,1,12,13,45,10,1,"FW,MF",20-24,Forward,Belgium,Europe
2309,Modibo Sagnan,MLI,Montpellier,Ligue 1,2023,24.0,1999.0,11.7,34,22,23,9,2,15,25,60.0,10,13,9,4,15,49,67,0,DF,20-24,Defender,Mali,Africa
2310,Wesley Saïd,FRA,Lens,Ligue 1,2023,28.0,1995.0,11.3,8,4,1,2,5,2,9,22.2,7,4,0,4,4,12,3,0,"FW,MF",25-29,Forward,France,Europe
2311,Théo Sainte-Luce,FRA,Montpellier,Ligue 1,2023,24.0,1998.0,3.8,17,7,10,6,1,11,19,57.9,8,9,4,5,3,20,15,0,DF,20-24,Defender,France,Europe
2312,Bukayo Saka,ENG,Arsenal,Premier League,2023,21.0,2001.0,32.4,66,35,22,24,20,26,59,44.1,33,43,2,41,15,81,24,1,FW,20-24,Forward,England,Europe
2313,Mamadou Sakho,FRA,Montpellier,Ligue 1,2023,33.0,1990.0,0.1,1,1,1,0,0,1,1,100.0,0,0,0,0,0,1,1,0,DF,30-34,Defender,France,Europe
2314,Ibrahim Salah,MAR,Rennes,Ligue 1,2023,21.0,2001.0,5.8,15,7,5,6,4,11,18,61.1,7,4,0,4,10,25,5,0,"FW,MF",20-24,Forward,Morocco,Africa
2315,Mohamed Salah,EGY,Liverpool,Premier League,2023,31.0,1992.0,28.2,17,11,1,8,8,6,21,28.6,15,19,1,18,2,19,1,0,FW,30-34,Forward,Egypt,Africa
2316,Amine Salama,FRA,Reims,Ligue 1,2023,23.0,2000.0,3.5,0,0,0,0,0,0,0,,0,1,0,1,1,1,1,0,FW,20-24,Forward,France,Europe
2318,William Saliba,FRA,Arsenal,Premier League,2023,22.0,2001.0,38.0,41,26,28,12,1,20,27,74.1,7,32,17,15,29,70,81,3,DF,20-24,Defender,France,Europe
2319,Mohammed Salisu,GHA,Monaco,Ligue 1,2023,24.0,1999.0,11.5,27,12,11,13,3,17,26,65.4,9,21,12,9,22,49,44,0,DF,20-24,Defender,Ghana,Africa
2320,Roland Sallai,HUN,Freiburg,Bundesliga,2023,26.0,1997.0,20.4,17,10,5,5,7,8,20,40.0,12,21,1,20,6,23,23,0,"MF,FW",25-29,Midfielder,Hungary,Europe
2324,Diadie Samassékou,MLI,Cádiz,La Liga,2023,27.0,1996.0,1.0,5,3,2,2,1,5,6,83.3,1,0,0,0,3,8,1,0,MF,25-29,Midfielder,Mali,Africa
2325,Diadie Samassékou,MLI,Hoffenheim,Bundesliga,2023,27.0,1996.0,0.0,0,0,0,0,0,0,0,,0,0,0,0,1,1,0,0,MF,25-29,Midfielder,Mali,Africa
2326,Mama Samba Baldé,GNB,Lyon,Ligue 1,2023,27.0,1995.0,6.1,8,5,1,2,5,3,9,33.3,6,0,0,0,3,11,1,1,"FW,MF",25-29,Forward,Guinea-Bissau,Africa
2327,Brice Samba,FRA,Lens,Ligue 1,2023,29.0,1994.0,33.0,1,1,1,0,0,1,1,100.0,0,0,0,0,0,1,10,3,GK,25-29,Goalkeeper,France,Europe
2328,Albert Sambi Lokonga,BEL,Luton Town,Premier League,2023,23.0,1999.0,14.5,29,18,14,12,3,17,24,70.8,7,23,13,10,11,40,14,0,MF,20-24,Midfielder,Belgium,Europe
2329,Junior Sambia,FRA,Salernitana,Serie A,2023,26.0,1996.0,11.5,12,5,8,1,3,6,11,54.5,5,15,7,8,11,23,28,0,"DF,MF",25-29,Defender,France,Europe
2331,Antonio Sanabria,PAR,Torino,Serie A,2023,27.0,1996.0,23.7,18,15,5,9,4,4,9,44.4,5,7,1,6,6,24,12,0,"FW,MF",25-29,Forward,Paraguay,South America
2333,Renato Sanches,POR,Roma,Serie A,2023,25.0,1997.0,1.6,2,1,1,1,0,2,3,66.7,1,2,0,2,0,2,1,0,MF,25-29,Midfielder,Portugal,Europe
2335,Alexis Sánchez,CHI,Inter,Serie A,2023,34.0,1988.0,8.5,7,6,0,5,2,1,4,25.0,3,4,1,3,1,8,3,0,"FW,MF",30-34,Forward,Chile,South America
2337,Davinson Sánchez,COL,Tottenham,Premier League,2023,27.0,1996.0,0.9,0,0,0,0,0,0,0,,0,3,2,1,1,1,2,0,DF,25-29,Defender,Colombia,South America
2341,Jadon Sancho,ENG,Manchester Utd,Premier League,2023,23.0,2000.0,0.9,1,0,1,0,0,1,3,33.3,2,1,0,1,1,2,0,0,"FW,MF",20-24,Forward,England,Europe
2342,Jadon Sancho,ENG,Dortmund,Bundesliga,2023,23.0,2000.0,10.5,5,4,1,3,1,0,4,0.0,4,11,0,11,4,9,6,0,"FW,MF",20-24,Forward,England,Europe
2343,Alex Sandro,BRA,Juventus,Serie A,2023,32.0,1991.0,8.0,13,7,7,6,0,4,5,80.0,1,13,7,6,15,28,23,0,DF,30-34,Defender,Brazil,South America
2344,Ibou Sané,SEN,Metz,Ligue 1,2023,18.0,2005.0,1.4,6,4,2,1,3,2,2,100.0,0,3,0,3,1,7,2,0,"MF,FW",Under 20,Midfielder,Senegal,Africa
2345,Leroy Sané,GER,Bayern Munich,Bundesliga,2023,27.0,1996.0,23.7,15,8,6,6,3,4,19,21.1,15,12,0,12,7,22,3,0,FW,25-29,Forward,Germany,Europe
2346,Sadibou Sané,SEN,Metz,Ligue 1,2023,19.0,2004.0,9.4,19,12,16,2,1,6,7,85.7,1,14,9,5,8,27,64,0,DF,Under 20,Defender,Senegal,Africa
2347,Arouna Sangante,SEN,Le Havre,Ligue 1,2023,21.0,2002.0,29.9,53,33,27,23,3,24,40,60.0,16,35,18,17,66,119,93,2,DF,20-24,Defender,Senegal,Africa
2348,Ibrahim Sangaré,CIV,Nott'ham Forest,Premier League,2023,25.0,1997.0,11.5,42,23,25,13,4,12,29,41.4,17,24,7,17,16,58,21,0,MF,25-29,Midfielder,Ivory Coast,Africa
2349,Morgan Sanson,FRA,Nice,Ligue 1,2023,28.0,1994.0,21.8,26,19,12,7,7,12,31,38.7,19,34,5,29,20,46,16,0,MF,25-29,Midfielder,France,Europe
2350,Nicola Sansone,ITA,Lecce,Serie A,2023,31.0,1991.0,8.5,11,6,6,2,3,5,16,31.3,11,7,1,6,4,15,5,2,"FW,MF",30-34,Forward,Italy,Europe
2351,Baptiste Santamaria,FRA,Rennes,Ligue 1,2023,28.0,1995.0,21.4,52,33,21,25,6,29,46,63.0,17,15,6,9,34,86,33,1,MF,25-29,Midfielder,France,Europe
2353,Andrey Santos,BRA,Nott'ham Forest,Premier League,2023,19.0,2004.0,0.1,0,0,0,0,0,0,0,,0,1,0,1,0,0,0,0,MF,Under 20,Midfielder,Brazil,South America
2354,Andrey Santos,BRA,Strasbourg,Ligue 1,2023,19.0,2004.0,9.2,29,18,15,13,1,17,26,65.4,9,8,0,8,10,39,11,1,MF,Under 20,Midfielder,Brazil,South America
2355,Tiago Santos,POR,Lille,Ligue 1,2023,21.0,2002.0,26.3,63,42,31,19,13,30,52,57.7,22,24,5,19,15,78,37,0,DF,20-24,Defender,Portugal,Europe
2357,Riccardo Saponara,ITA,Hellas Verona,Serie A,2023,31.0,1991.0,3.8,3,1,2,0,1,1,7,14.3,6,4,0,4,0,3,2,0,"FW,MF",30-34,Forward,Italy,Europe
2359,Amin Sarr,SWE,Lyon,Ligue 1,2023,22.0,2001.0,1.1,1,0,0,1,0,0,0,,0,1,0,1,0,1,1,0,"FW,MF",20-24,Forward,Sweden,Europe
2360,Amin Sarr,SWE,Wolfsburg,Bundesliga,2023,22.0,2001.0,4.3,3,2,1,2,0,1,2,50.0,1,6,1,5,2,5,1,0,"FW,MF",20-24,Forward,Sweden,Europe
2361,Bouna Sarr,SEN,Bayern Munich,Bundesliga,2023,31.0,1992.0,1.2,2,0,1,1,0,2,2,100.0,0,3,0,3,0,2,1,0,DF,30-34,Defender,Senegal,Africa
2362,Ismaila Sarr,SEN,Marseille,Ligue 1,2023,25.0,1998.0,16.1,14,8,2,10,2,6,17,35.3,11,21,6,15,13,27,11,0,"FW,MF",25-29,Forward,Senegal,Africa
2363,Mamadou Sarr,FRA,Lyon,Ligue 1,2023,17.0,2005.0,0.1,0,0,0,0,0,0,0,,0,0,0,0,0,0,0,0,DF,Under 20,Defender,France,Europe
2364,Martin Satriano,URU,Brest,Ligue 1,2023,22.0,2001.0,20.7,24,16,6,13,5,10,25,40.0,15,19,7,12,7,31,28,0,FW,20-24,Forward,Uruguay,South America
2365,Téji Savanier,FRA,Montpellier,Ligue 1,2023,31.0,1991.0,30.7,37,20,16,15,6,14,63,22.2,49,36,8,28,33,70,28,1,MF,30-34,Midfielder,France,Europe
2366,Stefan Savić,MNE,Atlético Madrid,La Liga,2023,32.0,1991.0,18.1,27,19,16,7,4,15,30,50.0,15,29,15,14,27,54,61,1,DF,30-34,Defender,Montenegro,Europe
2367,Sávio,BRA,Girona,La Liga,2023,19.0,2004.0,33.1,42,25,14,22,6,16,28,57.1,12,34,0,34,18,60,11,1,"FW,MF",Under 20,Forward,Brazil,South America
2368,Zanos Savva,CYP,Torino,Serie A,2023,17.0,2005.0,0.3,1,1,0,1,0,1,3,33.3,2,0,0,0,0,1,1,0,"DF,MF",Under 20,Defender,Cyprus,Asia
2369,Saba Sazonov,GEO,Torino,Serie A,2023,21.0,2002.0,4.0,9,7,4,5,0,3,3,100.0,0,8,5,3,3,12,22,0,DF,20-24,Defender,Georgia,Asia
2370,Joe Scally,USA,Gladbach,Bundesliga,2023,20.0,2002.0,24.8,41,28,21,17,3,23,40,57.5,17,31,11,20,18,59,78,2,DF,20-24,Defender,United States,North America
2371,Giorgio Scalvini,ITA,Atalanta,Serie A,2023,19.0,2003.0,28.3,53,33,29,19,5,19,40,47.5,21,44,17,27,59,112,71,0,DF,Under 20,Defender,Italy,Europe
2372,Gianluca Scamacca,ITA,Atalanta,Serie A,2023,24.0,1999.0,16.1,15,9,4,5,6,7,14,50.0,7,7,1,6,4,19,9,0,FW,20-24,Forward,Italy,Europe
2373,Dane Scarlett,ENG,Tottenham,Premier League,2023,19.0,2004.0,0.2,1,1,0,0,1,0,1,0.0,1,0,0,0,0,1,0,0,FW,Under 20,Forward,England,Europe
2374,Kevin Schade,GER,Brentford,Premier League,2023,21.0,2001.0,3.7,3,1,1,2,0,0,5,0.0,5,2,0,2,1,4,4,0,"FW,MF",20-24,Forward,Germany,Europe
2375,András Schäfer,HUN,Union Berlin,Bundesliga,2023,24.0,1999.0,13.5,29,16,9,15,5,11,20,55.0,9,25,4,21,20,49,25,0,MF,20-24,Midfielder,Hungary,Europe
2376,Fabian Schär,SUI,Newcastle Utd,Premier League,2023,31.0,1991.0,33.9,42,24,27,13,2,18,40,45.0,22,50,38,12,36,78,133,1,DF,30-34,Defender,Switzerland,Europe
2378,Stefan Schimmer,GER,Heidenheim,Bundesliga,2023,29.0,1994.0,1.7,1,1,0,1,0,0,3,0.0,3,2,0,2,1,2,6,0,"MF,FW",25-29,Midfielder,Germany,Europe
2379,Xaver Schlager,AUT,RB Leipzig,Bundesliga,2023,25.0,1997.0,27.5,81,50,35,38,8,21,53,39.6,32,41,8,33,19,100,27,0,MF,25-29,Midfielder,Austria,Europe
2380,Keven Schlotterbeck,GER,Bochum,Bundesliga,2023,26.0,1997.0,24.3,42,22,26,14,2,25,30,83.3,5,33,23,10,33,75,104,2,DF,25-29,Defender,Germany,Europe
2381,Nico Schlotterbeck,GER,Dortmund,Bundesliga,2023,23.0,1999.0,31.8,70,50,36,27,7,41,65,63.1,24,52,25,27,45,115,101,3,DF,20-24,Defender,Germany,Europe
2382,Jeffrey Schlupp,GHA,Crystal Palace,Premier League,2023,30.0,1992.0,15.0,38,24,14,16,8,9,18,50.0,9,13,2,11,8,46,24,0,"FW,MF",30-34,Forward,Ghana,Africa
2383,Romano Schmid,AUT,Werder Bremen,Bundesliga,2023,23.0,2000.0,28.9,35,20,7,22,6,14,46,30.4,32,36,7,29,11,46,17,2,"MF,FW",20-24,Midfielder,Austria,Europe
2384,Kenneth Schmidt,GER,Freiburg,Bundesliga,2023,21.0,2002.0,0.8,2,2,2,0,0,2,4,50.0,2,1,0,1,1,3,2,0,DF,20-24,Defender,Germany,Europe
2385,Niklas Schmidt,GER,Toulouse,Ligue 1,2023,25.0,1998.0,14.1,36,21,13,19,4,16,33,48.5,17,14,7,7,4,40,13,0,MF,25-29,Midfielder,Germany,Europe
2386,Benno Schmitz,GER,Köln,Bundesliga,2023,28.0,1994.0,12.8,27,15,20,7,0,17,34,50.0,17,19,4,15,7,34,29,0,DF,25-29,Defender,Germany,Europe
2387,Fabian Schnellhardt,GER,Darmstadt 98,Bundesliga,2023,29.0,1994.0,2.6,4,1,2,1,1,1,3,33.3,2,1,0,1,4,8,5,0,MF,25-29,Midfielder,Germany,Europe
2388,Jan Schöppner,GER,Heidenheim,Bundesliga,2023,24.0,1999.0,22.2,48,26,26,20,2,21,42,50.0,21,37,7,30,26,74,57,0,MF,20-24,Midfielder,Germany,Europe
2389,Marcel Schuhen,GER,Darmstadt 98,Bundesliga,2023,30.0,1993.0,31.0,1,0,1,0,0,1,3,33.3,2,0,0,0,2,3,11,4,GK,30-34,Goalkeeper,Germany,Europe
2390,Perr Schuurs,NED,Torino,Serie A,2023,23.0,1999.0,8.6,20,12,11,8,1,3,9,33.3,6,10,2,8,9,29,23,0,DF,20-24,Defender,Netherlands,Europe
2391,Marvin Schwäbe,GER,Köln,Bundesliga,2023,28.0,1995.0,34.0,1,0,1,0,0,1,1,100.0,0,0,0,0,0,1,10,1,GK,25-29,Goalkeeper,Germany,Europe
2392,Alexander Schwolow,GER,Union Berlin,Bundesliga,2023,31.0,1992.0,1.0,0,0,0,0,0,0,0,,0,0,0,0,0,0,2,0,GK,30-34,Goalkeeper,Germany,Europe
2393,Alex Scott,ENG,Bournemouth,Premier League,2023,19.0,2003.0,11.3,24,15,8,10,6,12,28,42.9,16,14,4,10,12,36,18,2,MF,Under 20,Midfielder,England,Europe
2394,Simone Scuffet,ITA,Cagliari,Serie A,2023,27.0,1996.0,31.0,1,0,1,0,0,1,2,50.0,1,1,0,1,1,2,9,0,GK,25-29,Goalkeeper,Italy,Europe
2396,Demba Seck,SEN,Torino,Serie A,2023,22.0,2001.0,4.7,5,3,1,4,0,3,4,75.0,1,1,0,1,1,6,0,0,MF,20-24,Midfielder,Senegal,Africa
2397,Demba Seck,SEN,Frosinone,Serie A,2023,22.0,2001.0,3.3,7,4,2,3,2,4,5,80.0,1,3,0,3,1,8,1,0,"FW,MF",20-24,Forward,Senegal,Africa
2399,Alidu Seidu,GHA,Rennes,Ligue 1,2023,23.0,2000.0,6.6,21,9,17,3,1,14,19,73.7,5,11,3,8,10,31,13,0,DF,20-24,Defender,Ghana,Africa
2400,Alidu Seidu,GHA,Clermont Foot,Ligue 1,2023,23.0,2000.0,12.6,32,24,17,15,0,24,31,77.4,7,15,7,8,25,57,37,0,DF,20-24,Defender,Ghana,Africa
2401,Nicolas Seiwald,AUT,RB Leipzig,Bundesliga,2023,22.0,2001.0,8.0,33,18,16,15,2,16,25,64.0,9,12,2,10,8,41,15,0,MF,20-24,Midfielder,Austria,Europe
2402,Nikola Sekulov,ITA,Juventus,Serie A,2023,21.0,2002.0,0.1,0,0,0,0,0,0,0,,0,0,0,0,0,0,0,0,FW,20-24,Forward,Italy,Europe
2403,Davie Selke,GER,Köln,Bundesliga,2023,28.0,1995.0,14.1,4,2,1,3,0,0,2,0.0,2,5,3,2,0,4,20,0,FW,25-29,Forward,Germany,Europe
2404,Matz Sels,BEL,Nott'ham Forest,Premier League,2023,31.0,1992.0,16.0,0,0,0,0,0,0,0,,0,0,0,0,0,0,11,1,GK,30-34,Goalkeeper,Belgium,Europe
2405,Matz Sels,BEL,Strasbourg,Ligue 1,2023,31.0,1992.0,19.0,0,0,0,0,0,0,0,,0,2,0,2,0,0,13,1,GK,30-34,Goalkeeper,Belgium,Europe
2406,Nélson Semedo,POR,Wolves,Premier League,2023,29.0,1993.0,34.3,79,48,52,19,8,38,64,59.4,26,44,8,36,36,115,85,1,"DF,MF",25-29,Defender,Portugal,Europe
2407,Vivaldo Semedo,POR,Udinese,Serie A,2023,18.0,2005.0,0.1,0,0,0,0,0,0,0,,0,0,0,0,0,0,0,0,FW,Under 20,Forward,Portugal,Europe
2408,Antoine Semenyo,GHA,Bournemouth,Premier League,2023,23.0,2000.0,23.4,24,17,7,9,8,9,27,33.3,18,39,2,37,6,30,21,0,FW,20-24,Forward,Ghana,Africa
2410,Marcos Senesi,ARG,Bournemouth,Premier League,2023,26.0,1997.0,24.9,55,32,28,23,4,24,56,42.9,32,50,23,27,35,90,109,1,DF,25-29,Defender,Argentina,South America
2411,Stefano Sensi,ITA,Inter,Serie A,2023,27.0,1995.0,0.5,1,1,0,1,0,1,3,33.3,2,1,0,1,1,2,0,0,MF,25-29,Midfielder,Italy,Europe
2412,Suat Serdar,GER,Hellas Verona,Serie A,2023,26.0,1997.0,18.4,51,39,24,23,4,22,45,48.9,23,29,7,22,20,71,25,1,MF,25-29,Midfielder,Germany,Europe
2414,Kevin Sessa,GER,Heidenheim,Bundesliga,2023,23.0,2000.0,11.2,17,10,9,6,2,7,16,43.8,9,12,1,11,4,21,17,0,"MF,FW",20-24,Midfielder,Germany,Europe
2415,Aaron Seydel,GER,Darmstadt 98,Bundesliga,2023,27.0,1996.0,6.9,3,2,0,2,1,0,3,0.0,3,8,2,6,1,4,9,0,FW,25-29,Forward,Germany,Europe
2416,Andres Sfait,ROU,Salernitana,Serie A,2023,18.0,2004.0,0.3,1,1,1,0,0,1,2,50.0,1,0,0,0,0,1,0,0,"DF,MF",Under 20,Defender,Romania,Europe
2417,Stephan El Shaarawy,ITA,Roma,Serie A,2023,30.0,1992.0,19.3,21,13,14,4,3,6,15,40.0,9,11,4,7,13,34,15,2,"FW,DF",30-34,Forward,Italy,Europe
2418,Luke Shaw,ENG,Manchester Utd,Premier League,2023,28.0,1995.0,10.7,11,8,7,3,1,9,15,60.0,6,18,11,7,6,17,39,0,DF,25-29,Defender,England,Europe
2419,James Shea,ENG,Luton Town,Premier League,2023,32.0,1991.0,0.2,0,0,0,0,0,0,0,,0,0,0,0,0,0,2,0,GK,30-34,Goalkeeper,England,Europe
2420,Eldor Shomurodov,UZB,Cagliari,Serie A,2023,28.0,1995.0,10.4,11,4,2,6,3,6,10,60.0,4,5,0,5,4,15,4,0,"FW,MF",25-29,Forward,Uzbekistan,Asia
2421,Steven Shpendi,ALB,Empoli,Serie A,2023,20.0,2003.0,4.6,0,0,0,0,0,0,4,0.0,4,2,1,1,1,1,0,0,"FW,MF",20-24,Forward,Albania,Europe
2422,Sofiane Sidi Ali,FRA,Marseille,Ligue 1,2023,28.0,1995.0,0.2,2,0,0,2,0,1,2,50.0,1,1,0,1,2,4,0,0,MF,25-29,Midfielder,France,Europe
2423,Vincent Sierro,SUI,Toulouse,Ligue 1,2023,27.0,1995.0,25.1,41,24,15,20,6,27,77,35.1,50,37,13,24,27,68,33,0,MF,25-29,Midfielder,Switzerland,Europe
2424,Tim Siersleben,GER,Heidenheim,Bundesliga,2023,23.0,2000.0,10.1,27,11,21,6,0,8,20,40.0,12,16,10,6,21,48,29,1,DF,20-24,Defender,Germany,Europe
2425,Kiliann Sildillia,FRA,Freiburg,Bundesliga,2023,21.0,2002.0,20.1,43,19,28,8,7,26,42,61.9,16,33,15,18,22,65,64,0,DF,20-24,Defender,France,Europe
2426,André Silva,POR,Real Sociedad,La Liga,2023,27.0,1995.0,8.1,2,2,0,0,2,0,4,0.0,4,3,0,3,1,3,3,0,FW,25-29,Forward,Portugal,Europe
2426,André Silva,POR,Real Sociedad,La Liga,2023,27.0,1995.0,8.1,2,2,0,0,2,0,4,0.0,4,3,0,3,1,3,3,0,FW,25-29,Forward,Portugal,Europe
2426,André Silva,POR,Real Sociedad,La Liga,2023,27.0,1995.0,8.1,2,2,0,0,2,0,4,0.0,4,3,0,3,1,3,3,0,FW,25-29,Forward,Portugal,Europe
2426,André Silva,POR,Real Sociedad,La Liga,2023,27.0,1995.0,8.1,2,2,0,0,2,0,4,0.0,4,3,0,3,1,3,3,0,FW,25-29,Forward,Portugal,Europe
2426,André Silva,POR,Real Sociedad,La Liga,2023,27.0,1995.0,8.1,2,2,0,0,2,0,4,0.0,4,3,0,3,1,3,3,0,FW,25-29,Forward,Portugal,Europe
2426,André Silva,POR,Real Sociedad,La Liga,2023,27.0,1995.0,8.1,2,2,0,0,2,0,4,0.0,4,3,0,3,1,3,3,0,FW,25-29,Forward,Portugal,Europe
2426,André Silva,POR,Real Sociedad,La Liga,2023,27.0,1995.0,8.1,2,2,0,0,2,0,4,0.0,4,3,0,3,1,3,3,0,FW,25-29,Forward,Portugal,Europe
2426,André Silva,POR,Real Sociedad,La Liga,2023,27.0,1995.0,8.1,2,2,0,0,2,0,4,0.0,4,3,0,3,1,3,3,0,FW,25-29,Forward,Portugal,Europe
2426,André Silva,POR,Real Sociedad,La Liga,2023,27.0,1995.0,8.1,2,2,0,0,2,0,4,0.0,4,3,0,3,1,3,3,0,FW,25-29,Forward,Portugal,Europe
2427,Bernardo Silva,POR,Manchester City,Premier League,2023,28.0,1994.0,28.6,51,23,13,25,13,25,57,43.9,32,32,4,28,17,68,15,1,"MF,FW",25-29,Midfielder,Portugal,Europe
2428,Caio Henrique Oliveira Silva,BRA,Monaco,Ligue 1,2023,26.0,1997.0,6.9,13,7,3,7,3,6,9,66.7,3,8,2,6,6,19,9,0,DF,25-29,Defender,Brazil,South America
2429,Fábio Silva,POR,Wolves,Premier League,2023,21.0,2002.0,2.9,7,4,3,4,0,2,3,66.7,1,1,0,1,2,9,0,0,FW,20-24,Forward,Portugal,Europe
2430,Rui Silva,POR,Betis,La Liga,2023,29.0,1994.0,27.5,0,0,0,0,0,0,3,0.0,3,0,0,0,1,1,13,1,GK,25-29,Goalkeeper,Portugal,Europe
2430,Rui Silva,POR,Betis,La Liga,2023,29.0,1994.0,27.5,0,0,0,0,0,0,3,0.0,3,0,0,0,1,1,13,1,GK,25-29,Goalkeeper,Portugal,Europe
2430,Rui Silva,POR,Betis,La Liga,2023,29.0,1994.0,27.5,0,0,0,0,0,0,3,0.0,3,0,0,0,1,1,13,1,GK,25-29,Goalkeeper,Portugal,Europe
2430,Rui Silva,POR,Betis,La Liga,2023,29.0,1994.0,27.5,0,0,0,0,0,0,3,0.0,3,0,0,0,1,1,13,1,GK,25-29,Goalkeeper,Portugal,Europe
2431,Thiago Silva,BRA,Chelsea,Premier League,2023,38.0,1984.0,28.1,29,15,22,6,1,20,34,58.8,14,33,24,9,26,55,153,4,DF,35-39,Defender,Brazil,South America
2431,Thiago Silva,BRA,Chelsea,Premier League,2023,38.0,1984.0,28.1,29,15,22,6,1,20,34,58.8,14,33,24,9,26,55,153,4,DF,35-39,Defender,Brazil,South America
2431,Thiago Silva,BRA,Chelsea,Premier League,2023,38.0,1984.0,28.1,29,15,22,6,1,20,34,58.8,14,33,24,9,26,55,153,4,DF,35-39,Defender,Brazil,South America
2431,Thiago Silva,BRA,Chelsea,Premier League,2023,38.0,1984.0,28.1,29,15,22,6,1,20,34,58.8,14,33,24,9,26,55,153,4,DF,35-39,Defender,Brazil,South America
2432,Marco Silvestri,ITA,Udinese,Serie A,2023,32.0,1991.0,17.0,0,0,0,0,0,0,3,0.0,3,1,0,1,0,0,5,3,GK,30-34,Goalkeeper,Italy,Europe
2433,Mohamed Simakan,FRA,RB Leipzig,Bundesliga,2023,23.0,2000.0,23.8,48,29,28,19,1,32,44,72.7,12,36,14,22,29,77,69,0,DF,20-24,Defender,France,Europe
2434,Giovanni Simeone,ARG,Napoli,Serie A,2023,28.0,1995.0,8.9,12,4,1,3,8,3,12,25.0,9,11,0,11,1,13,7,0,FW,25-29,Forward,Argentina,South America
2435,Giuliano Simeone,ARG,Alavés,La Liga,2023,20.0,2002.0,7.0,7,5,2,3,2,5,17,29.4,12,10,0,10,5,12,3,0,FW,20-24,Forward,Argentina,South America
2437,Moses Simon,NGA,Nantes,Ligue 1,2023,28.0,1995.0,19.9,7,5,2,5,0,2,8,25.0,6,9,1,8,3,10,5,1,"FW,MF",25-29,Forward,Nigeria,Africa
2439,Xavi Simons,NED,RB Leipzig,Bundesliga,2023,20.0,2003.0,29.5,30,17,10,11,9,15,31,48.4,16,23,0,23,16,46,4,0,MF,20-24,Midfielder,Netherlands,Europe
2440,Wilfried Singo,CIV,Monaco,Ligue 1,2023,22.0,2000.0,24.3,34,25,18,14,2,17,26,65.4,9,27,14,13,51,85,81,2,DF,20-24,Defender,Ivory Coast,Africa
2441,Luis Sinisterra,COL,Bournemouth,Premier League,2023,24.0,1999.0,7.8,23,12,9,10,4,9,16,56.3,7,18,0,18,8,31,4,0,"FW,MF",20-24,Forward,Colombia,South America
2442,Daley Sinkgraven,NED,Las Palmas,La Liga,2023,28.0,1995.0,4.2,11,5,6,5,0,2,8,25.0,6,5,3,2,6,17,9,0,DF,25-29,Defender,Netherlands,Europe
2443,Jailson Siqueira,BRA,Celta Vigo,La Liga,2023,27.0,1995.0,10.0,27,18,22,5,0,13,24,54.2,11,13,5,8,12,39,32,0,"DF,MF",25-29,Defender,Brazil,South America
2444,Ayanda Sishuba,BEL,Lens,Ligue 1,2023,18.0,2005.0,0.7,3,1,0,2,1,1,2,50.0,1,1,0,1,0,3,0,0,"MF,FW",Under 20,Midfielder,Belgium,Europe
2445,Ibrahima Sissoko,MLI,Strasbourg,Ligue 1,2023,25.0,1997.0,18.2,47,33,13,25,9,23,30,76.7,7,21,8,13,19,66,30,0,MF,25-29,Midfielder,Mali,Africa
2446,Moussa Sissoko,FRA,Nantes,Ligue 1,2023,33.0,1989.0,20.2,27,16,13,8,6,12,25,48.0,13,8,2,6,12,39,31,0,MF,30-34,Midfielder,France,Europe
2448,Tim Skarke,GER,Darmstadt 98,Bundesliga,2023,26.0,1996.0,26.7,26,16,12,10,4,10,28,35.7,18,25,2,23,6,32,20,0,"FW,DF",25-29,Forward,Germany,Europe
2449,Ellyes Skhiri,TUN,Eint Frankfurt,Bundesliga,2023,28.0,1995.0,24.1,44,24,18,19,7,19,36,52.8,17,33,4,29,39,83,47,2,MF,25-29,Midfielder,Tunisia,Africa
2450,Oliver Skipp,ENG,Tottenham,Premier League,2023,22.0,2000.0,7.9,18,12,9,6,3,11,18,61.1,7,12,1,11,3,21,9,0,"MF,DF",20-24,Midfielder,England,Europe
2453,Robert Skov,DEN,Hoffenheim,Bundesliga,2023,27.0,1996.0,14.0,24,16,15,8,1,17,36,47.2,19,17,4,13,10,34,23,1,"DF,FW",25-29,Defender,Denmark,Europe
2454,Milan Škriniar,SVK,Paris S-G,Ligue 1,2023,28.0,1995.0,18.1,24,18,17,7,0,14,22,63.6,8,19,10,9,12,36,51,2,DF,25-29,Defender,Slovakia,Europe
2455,Naatan Skyttä,FIN,Toulouse,Ligue 1,2023,21.0,2002.0,1.3,4,4,2,1,1,1,1,100.0,0,0,0,0,0,4,0,0,"MF,FW",20-24,Midfielder,Finland,Europe
2456,Chris Smalling,ENG,Roma,Serie A,2023,33.0,1989.0,4.3,1,1,1,0,0,1,4,25.0,3,6,5,1,5,6,8,0,DF,30-34,Defender,England,Europe
2457,Adam Smith,ENG,Bournemouth,Premier League,2023,32.0,1991.0,23.9,37,23,18,11,8,19,39,48.7,20,28,11,17,21,58,62,0,DF,30-34,Defender,England,Europe
2457,Adam Smith,ENG,Bournemouth,Premier League,2023,32.0,1991.0,23.9,37,23,18,11,8,19,39,48.7,20,28,11,17,21,58,62,0,DF,30-34,Defender,England,Europe
2457,Adam Smith,ENG,Bournemouth,Premier League,2023,32.0,1991.0,23.9,37,23,18,11,8,19,39,48.7,20,28,11,17,21,58,62,0,DF,30-34,Defender,England,Europe
2457,Adam Smith,ENG,Bournemouth,Premier League,2023,32.0,1991.0,23.9,37,23,18,11,8,19,39,48.7,20,28,11,17,21,58,62,0,DF,30-34,Defender,England,Europe
2458,Emile Smith Rowe,ENG,Arsenal,Premier League,2023,23.0,2000.0,3.9,4,1,2,2,0,2,4,50.0,2,3,1,2,3,7,1,0,MF,20-24,Midfielder,England,Europe
2459,Hrvoje Smolčić,CRO,Eint Frankfurt,Bundesliga,2023,22.0,2000.0,3.9,7,3,7,0,0,4,5,80.0,1,3,1,2,6,13,23,1,DF,20-24,Defender,Croatia,Europe
2460,Cédric Soares,POR,Arsenal,Premier League,2023,31.0,1991.0,0.7,0,0,0,0,0,0,0,,0,0,0,0,0,0,0,0,DF,30-34,Defender,Portugal,Europe
2461,Danilo Soares,BRA,Bochum,Bundesliga,2023,31.0,1991.0,3.9,10,6,5,3,2,5,8,62.5,3,6,0,6,7,17,11,0,DF,30-34,Defender,Brazil,South America
2462,Eduard Sobol,UKR,Strasbourg,Ligue 1,2023,28.0,1995.0,0.3,0,0,0,0,0,0,0,,0,0,0,0,0,0,1,0,DF,25-29,Defender,Ukraine,Europe
2464,Andrea Sodero,ITA,Empoli,Serie A,2023,18.0,2004.0,0.1,0,0,0,0,0,0,0,,0,0,0,0,0,0,0,0,MF,Under 20,Midfielder,Italy,Europe
2465,Emran Soglo,ENG,Marseille,Ligue 1,2023,18.0,2005.0,1.2,2,1,0,2,0,1,3,33.3,2,6,0,6,1,3,3,0,"MF,DF",Under 20,Midfielder,England,Europe
2468,Dominic Solanke,ENG,Bournemouth,Premier League,2023,25.0,1997.0,36.9,23,11,3,13,7,10,29,34.5,19,24,5,19,7,30,43,0,FW,25-29,Forward,England,Europe
2471,Jhon Solis,COL,Girona,La Liga,2023,18.0,2004.0,4.3,10,8,4,5,1,4,12,33.3,8,8,3,5,8,18,7,1,MF,Under 20,Midfielder,Colombia,South America
2472,Manor Solomon,ISR,Tottenham,Premier League,2023,24.0,1999.0,2.2,3,3,1,1,1,1,2,50.0,1,4,0,4,3,6,2,0,FW,20-24,Forward,Israel,Asia
2473,Daniele Sommariva,ITA,Genoa,Serie A,2023,26.0,1997.0,0.1,0,0,0,0,0,0,0,,0,0,0,0,0,0,0,0,GK,25-29,Goalkeeper,Italy,Europe
2474,Yann Sommer,SUI,Inter,Serie A,2023,34.0,1988.0,34.0,2,1,2,0,0,2,2,100.0,0,1,0,1,0,2,7,1,GK,30-34,Goalkeeper,Switzerland,Europe
2475,Brandon Soppy,FRA,Torino,Serie A,2023,21.0,2002.0,2.0,2,2,1,1,0,2,6,33.3,4,2,0,2,0,2,3,1,DF,20-24,Defender,France,Europe
2478,Alessandro Sorrentino,ITA,Monza,Serie A,2023,21.0,2002.0,6.1,0,0,0,0,0,0,0,,0,0,0,0,0,0,0,0,GK,20-24,Goalkeeper,Italy,Europe
2479,Borna Sosa,CRO,Stuttgart,Bundesliga,2023,25.0,1998.0,0.5,0,0,0,0,0,0,1,0.0,1,0,0,0,0,0,0,0,"FW,DF",25-29,Forward,Croatia,Europe
2481,Florian Sotoca,FRA,Lens,Ligue 1,2023,32.0,1990.0,28.9,33,22,9,21,3,17,38,44.7,21,41,4,37,20,53,34,0,"MF,FW",30-34,Midfielder,France,Europe
2482,Riccardo Sottil,ITA,Fiorentina,Serie A,2023,24.0,1999.0,12.3,10,5,5,1,4,3,8,37.5,5,12,0,12,2,12,2,0,FW,20-24,Forward,Italy,Europe
2484,Matìas Soulé,ARG,Frosinone,Serie A,2023,20.0,2003.0,34.7,41,27,12,14,15,19,40,47.5,21,38,4,34,18,59,9,0,"FW,MF",20-24,Forward,Argentina,South America
2485,Boubakary Soumaré,FRA,Sevilla,La Liga,2023,24.0,1999.0,25.4,39,28,24,14,1,14,26,53.8,12,25,7,18,26,65,20,1,MF,20-24,Midfielder,France,Europe
2486,Issa Soumaré,SEN,Le Havre,Ligue 1,2023,22.0,2000.0,2.6,2,0,2,0,0,0,4,0.0,4,0,0,0,0,2,2,0,"FW,MF",20-24,Forward,Senegal,Africa
2487,Vinicius Souza,BRA,Sheffield Utd,Premier League,2023,24.0,1999.0,29.6,125,76,59,51,15,41,74,55.4,33,57,17,40,32,157,75,1,MF,20-24,Midfielder,Brazil,South America
2488,Djibril Sow,SUI,Sevilla,La Liga,2023,26.0,1997.0,16.2,28,21,15,8,5,9,25,36.0,16,20,3,17,17,45,8,1,MF,25-29,Midfielder,Switzerland,Europe
2489,Saidou Sow,GUI,Strasbourg,Ligue 1,2023,21.0,2002.0,8.0,20,12,17,3,0,9,13,69.2,4,7,4,3,12,32,36,3,DF,20-24,Defender,Guinea,Africa
2490,Çağlar Söyüncü,TUR,Atlético Madrid,La Liga,2023,27.0,1996.0,1.3,1,1,1,0,0,0,0,,0,1,0,1,1,2,7,0,DF,25-29,Defender,Turkey,Asia
2491,Djed Spence,ENG,Genoa,Serie A,2023,22.0,2000.0,9.5,16,10,12,4,0,8,10,80.0,2,20,5,15,8,24,28,0,DF,20-24,Defender,England,Europe
2492,Stijn Spierings,NED,Toulouse,Ligue 1,2023,27.0,1996.0,16.8,53,40,26,20,7,29,52,55.8,23,22,5,17,26,79,32,0,MF,25-29,Midfielder,Netherlands,Europe
2493,Stijn Spierings,NED,Lens,Ligue 1,2023,27.0,1996.0,1.3,1,0,0,1,0,1,1,100.0,0,2,1,1,2,3,1,0,MF,25-29,Midfielder,Netherlands,Europe
2494,Leonardo Spinazzola,ITA,Roma,Serie A,2023,30.0,1993.0,14.6,15,7,10,5,0,8,18,44.4,10,8,2,6,3,18,15,0,DF,30-34,Defender,Italy,Europe
2495,Marco Sportiello,ITA,Milan,Serie A,2023,31.0,1992.0,7.0,0,0,0,0,0,0,0,,0,0,0,0,0,0,2,0,GK,30-34,Goalkeeper,Italy,Europe
2496,Anton Stach,GER,Hoffenheim,Bundesliga,2023,24.0,1998.0,25.8,73,42,40,27,6,33,63,52.4,30,38,12,26,72,145,67,1,MF,20-24,Midfielder,Germany,Europe
2497,Anton Stach,GER,Mainz 05,Bundesliga,2023,24.0,1998.0,1.9,3,0,2,0,1,2,4,50.0,2,5,0,5,2,5,5,0,MF,20-24,Midfielder,Germany,Europe
2498,Jens Stage,DEN,Werder Bremen,Bundesliga,2023,26.0,1996.0,25.9,52,22,21,23,8,18,50,36.0,32,42,23,19,23,75,55,0,MF,25-29,Midfielder,Denmark,Europe
2499,Benjamin Stambouli,FRA,Reims,Ligue 1,2023,32.0,1990.0,3.2,9,7,3,5,1,6,11,54.5,5,3,1,2,2,11,8,0,MF,30-34,Midfielder,France,Europe
2500,Josip Stanišić,CRO,Leverkusen,Bundesliga,2023,23.0,2000.0,14.0,38,20,19,13,6,22,33,66.7,11,18,3,15,9,47,26,0,DF,20-24,Defender,Croatia,Europe
2501,Carl Starfelt,SWE,Celta Vigo,La Liga,2023,28.0,1995.0,24.6,36,30,30,5,1,19,28,67.9,9,35,28,7,34,70,159,2,DF,25-29,Defender,Sweden,Europe
2502,Niklas Stark,GER,Werder Bremen,Bundesliga,2023,28.0,1995.0,12.1,26,15,13,11,2,12,18,66.7,6,14,7,7,19,45,61,1,DF,25-29,Defender,Germany,Europe
2503,Jason Steele,ENG,Brighton,Premier League,2023,32.0,1990.0,17.0,0,0,0,0,0,0,3,0.0,3,0,0,0,0,0,8,1,GK,30-34,Goalkeeper,England,Europe
2504,Pascal Stenzel,GER,Stuttgart,Bundesliga,2023,27.0,1996.0,11.8,18,8,7,9,2,10,30,33.3,20,22,8,14,15,33,26,0,DF,25-29,Defender,Germany,Europe
2505,Leonidas Stergiou,SUI,Stuttgart,Bundesliga,2023,21.0,2002.0,6.6,15,8,7,7,1,9,13,69.2,4,8,1,7,5,20,13,0,DF,20-24,Defender,Switzerland,Europe
2506,Raheem Sterling,ENG,Chelsea,Premier League,2023,28.0,1994.0,22.0,21,10,7,8,6,12,26,46.2,14,13,0,13,13,34,9,1,"FW,MF",25-29,Forward,England,Europe
2507,Trivante Stewart,JAM,Salernitana,Serie A,2023,23.0,2000.0,1.1,0,0,0,0,0,0,0,,0,1,0,1,0,0,0,0,"FW,MF",20-24,Forward,Jamaica,North America
2508,Angelo Stiller,GER,Hoffenheim,Bundesliga,2023,22.0,2001.0,0.9,0,0,0,0,0,0,1,0.0,1,2,0,2,0,0,3,0,MF,20-24,Midfielder,Germany,Europe
2509,Angelo Stiller,GER,Stuttgart,Bundesliga,2023,22.0,2001.0,29.9,55,33,15,34,6,24,42,57.1,18,41,13,28,28,83,25,2,MF,20-24,Midfielder,Germany,Europe
2510,Kevin Stöger,AUT,Bochum,Bundesliga,2023,29.0,1993.0,29.6,49,30,21,21,7,25,63,39.7,38,46,4,42,19,68,18,0,MF,25-29,Midfielder,Austria,Europe
2511,Filip Stojilković,SUI,Darmstadt 98,Bundesliga,2023,23.0,2000.0,1.7,1,1,0,0,1,0,0,,0,0,0,0,0,1,1,0,"FW,MF",20-24,Forward,Switzerland,Europe
2512,John Stones,ENG,Manchester City,Premier League,2023,29.0,1994.0,11.8,2,1,1,0,1,0,3,0.0,3,11,7,4,10,12,21,0,"DF,MF",25-29,Defender,England,Europe
2513,Thomas Strakosha,ALB,Brentford,Premier League,2023,28.0,1995.0,1.5,0,0,0,0,0,0,0,,0,0,0,0,0,0,0,0,GK,25-29,Goalkeeper,Albania,Europe
2515,Gabriel Strefezza,BRA,Lecce,Serie A,2023,26.0,1997.0,12.4,24,17,8,7,9,14,20,70.0,6,17,0,17,7,31,11,0,FW,25-29,Forward,Brazil,South America
2516,Kevin Strootman,NED,Genoa,Serie A,2023,33.0,1990.0,13.4,34,19,13,18,3,15,31,48.4,16,20,6,14,7,41,22,0,MF,30-34,Midfielder,Netherlands,Europe
2517,Cristhian Stuani,URU,Girona,La Liga,2023,36.0,1986.0,8.9,14,11,4,6,4,4,7,57.1,3,9,2,7,5,19,13,0,FW,35-39,Forward,Uruguay,South America
2519,Damián Suárez,URU,Getafe,La Liga,2023,35.0,1988.0,14.4,36,21,16,16,4,26,45,57.8,19,13,3,10,10,46,31,0,DF,35-39,Defender,Uruguay,South America
2521,Gabriel Suazo,CHI,Toulouse,Ligue 1,2023,25.0,1997.0,26.2,66,32,40,19,7,38,86,44.2,48,37,4,33,26,92,33,0,DF,25-29,Defender,Chile,South America
2522,Isaac Success,NGA,Udinese,Serie A,2023,27.0,1996.0,9.8,6,4,0,5,1,1,3,33.3,2,6,1,5,2,8,11,0,"FW,MF",25-29,Forward,Nigeria,Africa
2523,Niklas Süle,GER,Dortmund,Bundesliga,2023,27.0,1995.0,16.8,18,10,14,3,1,11,16,68.8,5,25,14,11,25,43,58,2,DF,25-29,Defender,Germany,Europe
2524,Ibrahim Sulemana,GHA,Cagliari,Serie A,2023,20.0,2003.0,14.9,36,14,15,15,6,17,27,63.0,10,24,5,19,7,43,23,0,MF,20-24,Midfielder,Ghana,Africa
2525,Tomáš Suslov,SVK,Hellas Verona,Serie A,2023,21.0,2002.0,23.2,42,30,11,22,9,15,47,31.9,32,15,0,15,6,48,8,0,"MF,FW",20-24,Midfielder,Slovakia,Europe
2527,Mattias Svanberg,SWE,Wolfsburg,Bundesliga,2023,24.0,1999.0,19.1,37,17,8,19,10,12,38,31.6,26,25,5,20,21,58,28,0,MF,20-24,Midfielder,Sweden,Europe
2530,Williot Swedberg,SWE,Celta Vigo,La Liga,2023,19.0,2004.0,4.9,9,4,3,6,0,5,8,62.5,3,11,1,10,0,9,4,0,"FW,MF",Under 20,Forward,Sweden,Europe
2532,Abakar Sylla,CIV,Strasbourg,Ligue 1,2023,20.0,2002.0,19.9,54,23,30,19,5,29,40,72.5,11,40,11,29,26,80,70,2,DF,20-24,Defender,Ivory Coast,Africa
2533,Dembo Sylla,GUI,Lorient,Ligue 1,2023,20.0,2002.0,0.5,1,1,0,1,0,0,0,,0,0,0,0,1,2,2,0,DF,20-24,Defender,Guinea,Africa
2534,Issiaga Sylla,GUI,Montpellier,Ligue 1,2023,29.0,1994.0,16.2,28,17,20,6,2,16,34,47.1,18,21,7,14,23,51,53,0,"DF,FW",25-29,Defender,Guinea,Africa
2535,Mamadou Sylla,SEN,Alavés,La Liga,2023,29.0,1994.0,0.2,0,0,0,0,0,0,0,,0,1,1,0,0,0,1,0,"FW,MF",25-29,Forward,Senegal,Africa
2535,Mamadou Sylla,SEN,Alavés,La Liga,2023,29.0,1994.0,0.2,0,0,0,0,0,0,0,,0,1,1,0,0,0,1,0,"FW,MF",25-29,Forward,Senegal,Africa
2535,Mamadou Sylla,SEN,Alavés,La Liga,2023,29.0,1994.0,0.2,0,0,0,0,0,0,0,,0,1,1,0,0,0,1,0,"FW,MF",25-29,Forward,Senegal,Africa
2535,Mamadou Sylla,SEN,Alavés,La Liga,2023,29.0,1994.0,0.2,0,0,0,0,0,0,0,,0,1,1,0,0,0,1,0,"FW,MF",25-29,Forward,Senegal,Africa
2536,Attila Szalai,HUN,Hoffenheim,Bundesliga,2023,25.0,1998.0,3.2,3,1,3,0,0,1,4,25.0,3,6,2,4,1,4,7,0,DF,25-29,Defender,Hungary,Europe
2537,Attila Szalai,HUN,Freiburg,Bundesliga,2023,25.0,1998.0,1.1,1,1,1,0,0,1,2,50.0,1,5,2,3,1,2,11,1,DF,25-29,Defender,Hungary,Europe
2539,Dominik Szoboszlai,HUN,Liverpool,Premier League,2023,22.0,2000.0,23.4,32,19,12,12,8,16,50,32.0,34,37,2,35,15,47,16,1,MF,20-24,Midfielder,Hungary,Europe
2542,Musa Al-Taamari,JOR,Montpellier,Ligue 1,2023,26.0,1997.0,21.4,20,16,10,5,5,9,21,42.9,12,18,2,16,4,24,5,0,FW,25-29,Forward,Jordan,Asia
2543,Nicolás Tagliafico,ARG,Lyon,Ligue 1,2023,30.0,1992.0,23.6,54,34,23,22,9,22,49,44.9,27,25,8,17,28,82,43,0,DF,30-34,Defender,Argentina,South America
2544,Jonathan Tah,GER,Leverkusen,Bundesliga,2023,27.0,1996.0,29.2,19,9,10,7,2,5,16,31.3,11,28,23,5,23,42,97,1,DF,25-29,Defender,Germany,Europe
2545,Montassar Talbi,TUN,Lorient,Ligue 1,2023,25.0,1998.0,24.5,38,22,23,13,2,19,32,59.4,13,39,23,16,32,70,114,0,DF,25-29,Defender,Tunisia,Africa
2547,Adrien Tameze,CMR,Torino,Serie A,2023,29.0,1994.0,23.8,35,16,13,18,4,18,37,48.6,19,24,11,13,47,82,25,2,"DF,MF",25-29,Defender,Cameroon,Africa
2548,Renato Tapia,PER,Celta Vigo,La Liga,2023,28.0,1995.0,14.9,41,29,19,19,3,14,25,56.0,11,31,7,24,21,62,50,1,"MF,DF",25-29,Midfielder,Peru,South America
2549,Edmond Tapsoba,BFA,Leverkusen,Bundesliga,2023,24.0,1999.0,23.2,34,25,17,15,2,17,24,70.8,7,21,10,11,24,58,52,3,DF,20-24,Defender,Burkina Faso,Africa
2550,Matt Targett,ENG,Newcastle Utd,Premier League,2023,27.0,1995.0,0.9,2,0,1,1,0,1,1,100.0,0,1,0,1,0,2,2,0,DF,25-29,Defender,England,Europe
2551,Oussama Targhalline,MAR,Le Havre,Ligue 1,2023,21.0,2002.0,11.4,23,11,16,7,0,15,25,60.0,10,9,3,6,20,43,14,2,MF,20-24,Midfielder,Morocco,Africa
2552,James Tarkowski,ENG,Everton,Premier League,2023,30.0,1992.0,38.0,61,42,46,14,1,27,48,56.3,21,82,56,26,56,117,191,2,DF,30-34,Defender,England,Europe
2554,Jimi Tauriainen,ENG,Chelsea,Premier League,2023,19.0,2004.0,0.0,0,0,0,0,0,0,0,,0,0,0,0,0,0,0,0,FW,Under 20,Forward,England,Europe
2555,Nuno Tavares,POR,Nott'ham Forest,Premier League,2023,23.0,2000.0,5.1,11,7,9,1,1,8,9,88.9,1,6,0,6,1,12,21,0,DF,20-24,Defender,Portugal,Europe
2556,Marcus Tavernier,ENG,Bournemouth,Premier League,2023,24.0,1999.0,23.5,53,34,25,22,6,26,48,54.2,22,31,3,28,5,58,23,0,FW,20-24,Forward,England,Europe
2557,Elayis Tavsan,NED,Hellas Verona,Serie A,2023,22.0,2001.0,0.6,0,0,0,0,0,0,1,0.0,1,0,0,0,0,0,1,0,"MF,FW",20-24,Midfielder,Netherlands,Europe
2558,Charlie Taylor,ENG,Burnley,Premier League,2023,29.0,1993.0,25.9,35,20,19,14,2,17,35,48.6,18,27,11,16,19,54,78,0,DF,25-29,Defender,England,Europe
2559,Marciano Tchami,GNB,Almería,La Liga,2023,19.0,2004.0,0.5,0,0,0,0,0,0,0,,0,0,0,0,0,0,0,0,"FW,MF",Under 20,Forward,Guinea-Bissau,Africa
2560,Loum Tchaouna,FRA,Salernitana,Serie A,2023,19.0,2003.0,23.3,20,10,5,13,2,10,20,50.0,10,20,1,19,4,24,16,1,"FW,MF",Under 20,Forward,France,Europe
2561,Jackson Tchatchoua,CMR,Hellas Verona,Serie A,2023,21.0,2001.0,19.2,39,26,25,12,2,23,48,47.9,25,17,7,10,23,62,49,2,DF,20-24,Defender,Cameroon,Africa
2562,Enzo Tchato,CMR,Montpellier,Ligue 1,2023,20.0,2002.0,12.5,26,17,18,4,4,11,25,44.0,14,20,7,13,11,37,25,0,DF,20-24,Defender,Cameroon,Africa
2563,Aurélien Tchouaméni,FRA,Real Madrid,La Liga,2023,23.0,2000.0,22.1,38,23,19,17,2,9,18,50.0,9,21,13,8,28,66,52,1,"MF,DF",20-24,Midfielder,France,Europe
2564,Mathys Tel,FRA,Bayern Munich,Bundesliga,2023,18.0,2005.0,11.7,12,2,3,4,5,4,6,66.7,2,11,0,11,6,18,6,0,"FW,MF",Under 20,Forward,France,Europe
2565,Nathan Tella,NGA,Leverkusen,Bundesliga,2023,24.0,1999.0,9.1,13,8,6,5,2,5,10,50.0,5,10,0,10,3,16,8,0,"DF,MF",20-24,Defender,Nigeria,Africa
2566,Nahuel Tenaglia,ARG,Alavés,La Liga,2023,27.0,1996.0,12.7,29,19,22,4,3,16,28,57.1,12,14,8,6,12,41,59,0,DF,25-29,Defender,Argentina,South America
2568,Marc-André ter Stegen,GER,Barcelona,La Liga,2023,31.0,1992.0,28.0,0,0,0,0,0,0,0,,0,0,0,0,0,0,3,3,GK,30-34,Goalkeeper,Germany,Europe
2569,Filippo Terracciano,ITA,Hellas Verona,Serie A,2023,20.0,2003.0,14.4,30,19,23,6,1,17,31,54.8,14,24,6,18,20,50,17,0,DF,20-24,Defender,Italy,Europe
2570,Filippo Terracciano,ITA,Milan,Serie A,2023,20.0,2003.0,0.8,2,2,1,1,0,1,3,33.3,2,3,0,3,0,2,1,0,"DF,FW",20-24,Defender,Italy,Europe
2571,Pietro Terracciano,ITA,Fiorentina,Serie A,2023,33.0,1990.0,33.0,1,1,1,0,0,1,3,33.3,2,1,0,1,0,1,8,0,GK,30-34,Goalkeeper,Italy,Europe
2573,Martin Terrier,FRA,Rennes,Ligue 1,2023,26.0,1997.0,17.0,14,9,3,8,3,6,14,42.9,8,21,4,17,9,23,17,0,"FW,MF",25-29,Forward,France,Europe
2574,Kenny Tete,NED,Fulham,Premier League,2023,27.0,1995.0,9.6,27,17,19,6,2,11,19,57.9,8,10,3,7,16,43,35,0,DF,25-29,Defender,Netherlands,Europe
2575,Benjamin Tetteh,GHA,Metz,Ligue 1,2023,26.0,1997.0,3.1,6,6,1,5,0,4,7,57.1,3,0,0,0,0,6,1,0,"FW,MF",25-29,Forward,Ghana,Africa
2576,Teddy Teuma,MLT,Reims,Ligue 1,2023,29.0,1993.0,23.5,54,36,19,21,14,25,62,40.3,37,33,4,29,20,74,6,0,MF,25-29,Midfielder,Malta,Europe
2577,Florian Thauvin,FRA,Udinese,Serie A,2023,30.0,1993.0,19.0,7,4,2,4,1,4,13,30.8,9,9,1,8,3,10,2,0,FW,30-34,Forward,France,Europe
2578,Arthur Theate,BEL,Rennes,Ligue 1,2023,23.0,2000.0,25.5,30,17,19,6,5,24,37,64.9,13,40,23,17,31,61,90,2,DF,20-24,Defender,Belgium,Europe
2579,Norman Theuerkauf,GER,Heidenheim,Bundesliga,2023,36.0,1987.0,14.0,24,16,13,7,4,13,22,59.1,9,16,6,10,14,38,21,0,"MF,DF",35-39,Midfielder,Germany,Europe
2580,Malick Thiaw,GER,Milan,Serie A,2023,21.0,2001.0,18.0,34,17,15,17,2,12,25,48.0,13,23,13,10,13,47,55,0,DF,20-24,Defender,Germany,Europe
2581,Jan Thielmann,GER,Köln,Bundesliga,2023,21.0,2002.0,17.5,28,18,13,9,6,12,24,50.0,12,31,6,25,8,36,28,0,"FW,DF",20-24,Forward,Germany,Europe
2582,Denis Thomalla,GER,Heidenheim,Bundesliga,2023,30.0,1992.0,5.0,9,6,4,4,1,5,11,45.5,6,3,2,1,4,13,13,0,"MF,FW",30-34,Midfielder,Germany,Europe
2583,Luke Thomas,ENG,Sheffield Utd,Premier League,2023,22.0,2001.0,10.2,20,9,13,6,1,8,14,57.1,6,23,5,18,10,30,27,0,DF,20-24,Defender,England,Europe
2584,Adrien Thomasson,FRA,Lens,Ligue 1,2023,29.0,1993.0,13.3,25,14,4,16,5,11,34,32.4,23,14,0,14,9,34,10,1,MF,25-29,Midfielder,France,Europe
2587,Khéphren Thuram,FRA,Nice,Ligue 1,2023,22.0,2001.0,23.4,42,29,13,23,6,20,40,50.0,20,21,10,11,18,60,37,0,MF,20-24,Midfielder,France,Europe
2588,Marcus Thuram,FRA,Inter,Serie A,2023,25.0,1997.0,29.9,23,15,9,9,5,4,13,30.8,9,26,3,23,4,27,19,0,FW,25-29,Forward,France,Europe
2589,Cheikh Tidiane Sabaly,SEN,Metz,Ligue 1,2023,24.0,1999.0,15.3,40,20,23,12,5,16,40,40.0,24,19,2,17,10,50,14,0,"FW,MF",20-24,Forward,Senegal,Africa
2590,Youri Tielemans,BEL,Aston Villa,Premier League,2023,26.0,1997.0,18.0,41,20,17,18,6,16,40,40.0,24,23,3,20,15,56,9,0,"MF,FW",25-29,Midfielder,Belgium,Europe
2591,Kieran Tierney,SCO,Real Sociedad,La Liga,2023,26.0,1997.0,13.8,37,24,16,18,3,18,27,66.7,9,22,8,14,10,47,45,0,DF,25-29,Defender,Scotland,Europe
2592,Phillip Tietz,GER,Augsburg,Bundesliga,2023,26.0,1997.0,26.5,23,14,7,13,3,6,15,40.0,9,17,3,14,6,29,35,0,FW,25-29,Forward,Germany,Europe
2593,Steffen Tigges,GER,Köln,Bundesliga,2023,25.0,1998.0,8.1,10,6,4,5,1,3,7,42.9,4,4,2,2,1,11,12,0,FW,25-29,Forward,Germany,Europe
2594,Antonio Tikvić,CRO,Udinese,Serie A,2023,19.0,2004.0,0.0,0,0,0,0,0,0,0,,0,0,0,0,0,0,0,0,DF,Under 20,Defender,Croatia,Europe
2595,Jurriën Timber,NED,Arsenal,Premier League,2023,22.0,2001.0,0.8,2,2,1,1,0,0,0,,0,1,0,1,0,2,1,0,DF,20-24,Defender,Netherlands,Europe
2596,Jean-Clair Todibo,FRA,Nice,Ligue 1,2023,23.0,1999.0,29.5,58,28,35,17,6,34,56,60.7,22,34,15,19,38,96,97,1,DF,20-24,Defender,France,Europe
2597,Harry Toffolo,ENG,Nott'ham Forest,Premier League,2023,27.0,1995.0,16.2,26,14,20,6,0,15,24,62.5,9,34,13,21,14,40,49,0,DF,25-29,Defender,England,Europe
2598,Umut Tohumcu,GER,Hoffenheim,Bundesliga,2023,18.0,2004.0,11.2,16,12,9,7,0,6,19,31.6,13,11,1,10,6,22,12,0,MF,Under 20,Midfielder,Germany,Europe
2599,Corentin Tolisso,FRA,Lyon,Ligue 1,2023,28.0,1994.0,19.3,33,21,13,11,9,14,33,42.4,19,26,9,17,10,43,18,0,MF,25-29,Midfielder,France,Europe
2600,Jeremy Toljan,GER,Sassuolo,Serie A,2023,28.0,1994.0,23.1,13,10,8,4,1,9,15,60.0,6,17,5,12,16,29,49,1,DF,25-29,Defender,Germany,Europe
2601,Rafael Tolói,ITA,Atalanta,Serie A,2023,32.0,1990.0,10.7,20,9,7,8,5,14,27,51.9,13,9,4,5,13,33,29,0,DF,30-34,Defender,Italy,Europe
2603,Tiago Tomás,POR,Wolfsburg,Bundesliga,2023,21.0,2002.0,11.5,5,2,3,0,2,1,6,16.7,5,13,0,13,3,8,9,0,"FW,MF",20-24,Forward,Portugal,Europe
2604,Takehiro Tomiyasu,JPN,Arsenal,Premier League,2023,24.0,1998.0,12.8,20,9,15,4,1,11,18,61.1,7,10,4,6,18,38,33,0,DF,20-24,Defender,Japan,Asia
2605,James Tomkins,ENG,Crystal Palace,Premier League,2023,34.0,1989.0,0.1,0,0,0,0,0,0,0,,0,0,0,0,1,1,0,0,DF,30-34,Defender,England,Europe
2606,Fikayo Tomori,ENG,Milan,Serie A,2023,25.0,1997.0,23.6,42,24,29,10,3,18,29,62.1,11,34,23,11,26,68,75,1,DF,25-29,Defender,England,Europe
2607,Sandro Tonali,ITA,Newcastle Utd,Premier League,2023,23.0,2000.0,4.9,7,7,4,2,1,3,9,33.3,6,3,0,3,2,9,4,0,MF,20-24,Midfielder,Italy,Europe
2608,Ivan Toney,ENG,Brentford,Premier League,2023,27.0,1996.0,16.1,15,5,2,7,6,6,14,42.9,8,5,1,4,10,25,18,0,FW,25-29,Forward,England,Europe
2615,Fabio Torsiello,ITA,Darmstadt 98,Bundesliga,2023,18.0,2005.0,1.7,1,0,1,0,0,1,8,12.5,7,1,0,1,1,2,1,0,"FW,DF",Under 20,Forward,Italy,Europe
2616,Ahmed Touba,ALG,Lecce,Serie A,2023,25.0,1998.0,3.1,6,4,3,3,0,3,4,75.0,1,4,3,1,7,13,20,0,DF,25-29,Defender,Algeria,Africa
2617,Abdoulaye Touré,GUI,Le Havre,Ligue 1,2023,29.0,1994.0,25.4,47,28,22,22,3,30,60,50.0,30,30,8,22,25,72,33,0,MF,25-29,Midfielder,Guinea,Africa
2617,Abdoulaye Touré,GUI,Le Havre,Ligue 1,2023,29.0,1994.0,25.4,47,28,22,22,3,30,60,50.0,30,30,8,22,25,72,33,0,MF,25-29,Midfielder,Guinea,Africa
2617,Abdoulaye Touré,GUI,Le Havre,Ligue 1,2023,29.0,1994.0,25.4,47,28,22,22,3,30,60,50.0,30,30,8,22,25,72,33,0,MF,25-29,Midfielder,Guinea,Africa
2617,Abdoulaye Touré,GUI,Le Havre,Ligue 1,2023,29.0,1994.0,25.4,47,28,22,22,3,30,60,50.0,30,30,8,22,25,72,33,0,MF,25-29,Midfielder,Guinea,Africa
2618,Souleymane Touré,FRA,Lorient,Ligue 1,2023,20.0,2003.0,22.8,25,12,16,9,0,8,14,57.1,6,38,20,18,36,61,101,2,DF,20-24,Defender,France,Europe
2619,Lucas Tousart,FRA,Union Berlin,Bundesliga,2023,26.0,1997.0,17.5,35,20,14,17,4,17,37,45.9,20,32,9,23,25,60,41,0,MF,25-29,Midfielder,France,Europe
2620,Andros Townsend,ENG,Luton Town,Premier League,2023,32.0,1991.0,13.4,21,13,11,2,8,13,27,48.1,14,12,0,12,5,26,10,0,"MF,FW",30-34,Midfielder,England,Europe
2621,James Trafford,ENG,Burnley,Premier League,2023,20.0,2002.0,28.0,2,1,2,0,0,2,2,100.0,0,0,0,0,1,3,18,1,GK,20-24,Goalkeeper,England,Europe
2623,Bénie Traoré,CIV,Sheffield Utd,Premier League,2023,20.0,2002.0,4.3,4,2,1,2,1,0,4,0.0,4,4,1,3,1,5,1,0,"FW,MF",20-24,Forward,Ivory Coast,Africa
2624,Bénie Traoré,CIV,Nantes,Ligue 1,2023,20.0,2002.0,5.6,8,4,2,5,1,3,7,42.9,4,3,0,3,1,9,1,0,"FW,MF",20-24,Forward,Ivory Coast,Africa
2625,Bertrand Traoré,BFA,Aston Villa,Premier League,2023,27.0,1995.0,0.1,1,1,1,0,0,0,0,,0,0,0,0,0,1,1,0,"DF,FW",25-29,Defender,Burkina Faso,Africa
2626,Bertrand Traoré,BFA,Villarreal,La Liga,2023,27.0,1995.0,6.3,5,4,2,1,2,1,4,25.0,3,6,0,6,1,6,2,0,MF,25-29,Midfielder,Burkina Faso,Africa
2627,Boubacar Traoré,MLI,Wolves,Premier League,2023,21.0,2001.0,9.1,35,23,16,17,2,9,21,42.9,12,12,2,10,5,40,7,0,MF,20-24,Midfielder,Mali,Africa
2628,Chaka Traorè,CIV,Milan,Serie A,2023,18.0,2004.0,0.2,2,1,2,0,0,1,2,50.0,1,1,1,0,0,2,0,0,FW,Under 20,Forward,Ivory Coast,Africa
2629,Daouda Traoré,FRA,Nice,Ligue 1,2023,17.0,2006.0,0.2,0,0,0,0,0,0,0,,0,0,0,0,0,0,0,0,MF,Under 20,Midfielder,France,Europe
2630,Hamari Traoré,MLI,Real Sociedad,La Liga,2023,31.0,1992.0,25.5,44,19,24,17,3,25,43,58.1,18,27,8,19,24,68,59,2,DF,30-34,Defender,Mali,Africa
2631,Ismaël Traoré,CIV,Metz,Ligue 1,2023,36.0,1986.0,24.7,19,12,13,6,0,8,21,38.1,13,33,20,13,30,49,86,0,DF,35-39,Defender,Ivory Coast,Africa
2632,Omar Traoré,GER,Heidenheim,Bundesliga,2023,25.0,1998.0,27.5,60,33,33,21,6,32,56,57.1,24,32,7,25,40,100,54,1,DF,25-29,Defender,Germany,Europe
2633,Kevin Trapp,GER,Eint Frankfurt,Bundesliga,2023,33.0,1990.0,32.0,0,0,0,0,0,0,0,,0,0,0,0,1,1,9,1,GK,30-34,Goalkeeper,Germany,Europe
2634,Mark Travers,IRL,Bournemouth,Premier League,2023,24.0,1999.0,4.0,0,0,0,0,0,0,0,,0,0,0,0,0,0,2,0,GK,20-24,Goalkeeper,Republic of Ireland,Europe
2635,Óscar Trejo,ARG,Rayo Vallecano,La Liga,2023,35.0,1988.0,15.3,27,15,11,9,7,13,21,61.9,8,21,1,20,5,32,9,0,"FW,MF",35-39,Forward,Argentina,South America
2636,Mike Trésor,BEL,Burnley,Premier League,2023,24.0,1999.0,4.7,10,6,9,1,0,8,18,44.4,10,5,0,5,1,11,1,0,"FW,MF",20-24,Forward,Belgium,Europe
2638,Christopher Trimmel,AUT,Union Berlin,Bundesliga,2023,36.0,1987.0,18.3,23,15,12,10,1,13,33,39.4,20,16,3,13,13,36,57,0,DF,35-39,Defender,Austria,Europe
2639,Kieran Trippier,ENG,Newcastle Utd,Premier League,2023,32.0,1990.0,24.8,57,27,30,16,11,37,77,48.1,40,41,8,33,24,81,57,3,DF,30-34,Defender,England,Europe
2640,Leandro Trossard,BEL,Arsenal,Premier League,2023,28.0,1994.0,18.3,27,16,8,9,10,9,25,36.0,16,27,1,26,8,35,6,0,"FW,MF",25-29,Forward,Belgium,Europe
2641,Adrien Truffert,FRA,Rennes,Ligue 1,2023,21.0,2001.0,23.8,39,21,23,10,6,25,40,62.5,15,31,5,26,19,58,49,0,DF,20-24,Defender,France,Europe
2642,Auston Trusty,USA,Sheffield Utd,Premier League,2023,24.0,1998.0,28.6,47,30,31,13,3,21,43,48.8,22,41,22,19,35,82,153,3,DF,20-24,Defender,United States,North America
2643,Kostas Tsimikas,GRE,Liverpool,Premier League,2023,27.0,1996.0,7.5,19,13,9,6,4,9,15,60.0,6,9,1,8,6,25,10,0,DF,25-29,Defender,Greece,Europe
2644,Viktor Tsyhankov,UKR,Girona,La Liga,2023,25.0,1997.0,22.8,29,20,11,13,5,14,26,53.8,12,18,1,17,12,41,24,0,"MF,FW",25-29,Midfielder,Ukraine,Europe
2645,Stefano Turati,ITA,Frosinone,Serie A,2023,21.0,2001.0,30.5,0,0,0,0,0,0,0,,0,0,0,0,0,0,6,3,GK,20-24,Goalkeeper,Italy,Europe
2646,Matt Turner,USA,Nott'ham Forest,Premier League,2023,29.0,1994.0,17.0,0,0,0,0,0,0,0,,0,0,0,0,0,0,8,4,GK,25-29,Goalkeeper,United States,North America
2648,Tuta,BRA,Eint Frankfurt,Bundesliga,2023,24.0,1999.0,28.9,63,33,38,19,6,39,59,66.1,20,29,12,17,36,99,99,0,DF,20-24,Defender,Brazil,South America
2649,Destiny Udogie,ITA,Tottenham,Premier League,2023,20.0,2002.0,26.6,68,33,41,16,11,27,49,55.1,22,27,8,19,37,105,80,5,DF,20-24,Defender,Italy,Europe
2650,Matthieu Udol,FRA,Metz,Ligue 1,2023,27.0,1996.0,30.0,55,37,38,12,5,38,56,67.9,18,62,16,46,50,105,108,0,DF,25-29,Defender,France,Europe
2651,Manuel Ugarte Ribeiro,URU,Paris S-G,Ligue 1,2023,22.0,2001.0,21.5,98,57,39,43,16,43,89,48.3,46,27,6,21,40,138,25,2,MF,20-24,Midfielder,Uruguay,South America
2652,Lesley Ugochukwu,FRA,Chelsea,Premier League,2023,19.0,2004.0,3.3,14,10,4,8,2,4,10,40.0,6,6,2,4,1,15,5,0,MF,Under 20,Midfielder,France,Europe
2653,Lukas Ullrich,GER,Gladbach,Bundesliga,2023,19.0,2004.0,0.5,1,0,1,0,0,1,4,25.0,3,0,0,0,0,1,1,0,"DF,FW",Under 20,Defender,Germany,Europe
2654,Sven Ulreich,GER,Bayern Munich,Bundesliga,2023,34.0,1988.0,11.0,1,0,1,0,0,1,1,100.0,0,0,0,0,0,1,3,2,GK,30-34,Goalkeeper,Germany,Europe
2655,Samuel Umtiti,FRA,Lille,Ligue 1,2023,29.0,1993.0,2.1,1,1,0,1,0,1,4,25.0,3,0,0,0,2,3,4,0,DF,25-29,Defender,France,Europe
2656,Enes Ünal,TUR,Bournemouth,Premier League,2023,26.0,1997.0,3.6,6,4,2,3,1,2,5,40.0,3,4,2,2,1,7,6,0,"FW,MF",25-29,Forward,Turkey,Asia
2657,Enes Ünal,TUR,Getafe,La Liga,2023,26.0,1997.0,1.6,0,0,0,0,0,0,0,,0,1,0,1,0,0,2,0,"FW,MF",25-29,Forward,Turkey,Asia
2658,Deniz Undav,GER,Stuttgart,Bundesliga,2023,27.0,1996.0,23.2,28,13,6,8,14,4,15,26.7,11,17,0,17,6,34,5,0,"FW,MF",25-29,Forward,Germany,Europe
2659,Dayot Upamecano,FRA,Bayern Munich,Bundesliga,2023,24.0,1998.0,19.6,34,21,21,11,2,15,29,51.7,14,19,7,12,19,53,56,3,DF,20-24,Defender,France,Europe
2661,Mark Uth,GER,Köln,Bundesliga,2023,31.0,1991.0,4.1,8,4,2,3,3,4,12,33.3,8,6,0,6,1,9,2,0,"MF,FW",30-34,Midfielder,Germany,Europe
2662,Myrto Uzuni,ALB,Granada,La Liga,2023,28.0,1995.0,27.2,18,14,8,7,3,6,27,22.2,21,19,3,16,4,22,7,0,FW,25-29,Forward,Albania,Europe
2663,Josha Vagnoman,GER,Stuttgart,Bundesliga,2023,22.0,2000.0,13.1,28,18,15,11,2,15,30,50.0,15,11,5,6,2,30,16,1,DF,20-24,Defender,Germany,Europe
2665,Emanuele Valeri,ITA,Frosinone,Serie A,2023,24.0,1998.0,13.1,19,16,10,5,4,10,21,47.6,11,14,3,11,9,28,22,0,DF,20-24,Defender,Italy,Europe
2666,Martin Valjent,SVK,Mallorca,La Liga,2023,27.0,1995.0,26.1,34,18,19,13,2,18,30,60.0,12,26,11,15,29,63,112,1,DF,25-29,Defender,Slovakia,Europe
2669,Federico Valverde,URU,Real Madrid,La Liga,2023,25.0,1998.0,32.3,47,34,22,13,12,24,42,57.1,18,39,2,37,43,90,40,0,MF,25-29,Midfielder,Uruguay,South America
2670,Kévin Van Den Kerkhof,ALG,Metz,Ligue 1,2023,27.0,1996.0,21.3,31,24,11,13,7,13,32,40.6,19,15,2,13,11,42,32,1,"FW,MF",25-29,Forward,Algeria,Africa
2671,Siebe Van Der Heyden,BEL,Mallorca,La Liga,2023,25.0,1998.0,3.2,9,2,7,2,0,4,6,66.7,2,1,1,0,7,16,12,0,DF,25-29,Defender,Belgium,Europe
2672,Virgil van Dijk,NED,Liverpool,Premier League,2023,32.0,1991.0,35.3,40,23,24,13,3,12,14,85.7,2,47,34,13,39,79,144,0,DF,30-34,Defender,Netherlands,Europe
2673,Vanderson,BRA,Monaco,Ligue 1,2023,22.0,2001.0,18.2,60,41,20,30,10,32,70,45.7,38,29,2,27,35,95,37,1,DF,20-24,Defender,Brazil,South America
2673,Vanderson,BRA,Monaco,Ligue 1,2023,22.0,2001.0,18.2,60,41,20,30,10,32,70,45.7,38,29,2,27,35,95,37,1,DF,20-24,Defender,Brazil,South America
2673,Vanderson,BRA,Monaco,Ligue 1,2023,22.0,2001.0,18.2,60,41,20,30,10,32,70,45.7,38,29,2,27,35,95,37,1,DF,20-24,Defender,Brazil,South America
2673,Vanderson,BRA,Monaco,Ligue 1,2023,22.0,2001.0,18.2,60,41,20,30,10,32,70,45.7,38,29,2,27,35,95,37,1,DF,20-24,Defender,Brazil,South America
2674,Raphaël Varane,FRA,Manchester Utd,Premier League,2023,30.0,1993.0,15.3,18,11,10,7,1,10,14,71.4,4,23,18,5,15,33,88,0,DF,30-34,Defender,France,Europe
2675,Ruben Vargas,SUI,Augsburg,Bundesliga,2023,24.0,1998.0,21.8,23,10,6,10,7,10,25,40.0,15,19,4,15,7,30,17,0,"MF,FW",20-24,Midfielder,Switzerland,Europe
2676,Johan Vásquez,MEX,Genoa,Serie A,2023,24.0,1998.0,31.7,51,33,38,11,2,32,50,64.0,18,50,26,24,45,96,113,0,DF,20-24,Defender,Mexico,North America
2682,Matías Vecino,URU,Lazio,Serie A,2023,31.0,1991.0,12.8,32,17,12,20,0,20,31,64.5,11,17,5,12,12,44,21,0,MF,30-34,Midfielder,Uruguay,South America
2684,Alejo Véliz,ARG,Tottenham,Premier League,2023,19.0,2003.0,0.6,1,0,1,0,0,0,0,,0,0,0,0,0,1,0,0,FW,Under 20,Forward,Argentina,South America
2685,Alejo Véliz,ARG,Sevilla,La Liga,2023,19.0,2003.0,0.4,1,0,0,1,0,1,2,50.0,1,0,0,0,0,1,1,0,FW,Under 20,Forward,Argentina,South America
2687,Joël Veltman,NED,Brighton,Premier League,2023,31.0,1992.0,17.6,54,41,32,17,5,39,58,67.2,19,17,7,10,18,72,57,1,DF,30-34,Defender,Netherlands,Europe
2688,Micky van de Ven,NED,Tottenham,Premier League,2023,22.0,2001.0,26.0,49,35,34,12,3,24,33,72.7,9,25,15,10,18,67,78,1,DF,20-24,Defender,Netherlands,Europe
2689,Lorenzo Venuti,ITA,Lecce,Serie A,2023,28.0,1995.0,4.0,6,4,5,1,0,6,10,60.0,4,4,3,1,5,11,14,0,DF,25-29,Defender,Italy,Europe
2690,Bart Verbruggen,NED,Brighton,Premier League,2023,20.0,2002.0,21.0,1,1,1,0,0,1,2,50.0,1,0,0,0,0,1,11,3,GK,20-24,Goalkeeper,Netherlands,Europe
2691,Simone Verdi,ITA,Torino,Serie A,2023,31.0,1992.0,0.0,0,0,0,0,0,0,0,,0,0,0,0,0,0,0,0,FW,30-34,Forward,Italy,Europe
2692,Jordan Veretout,FRA,Marseille,Ligue 1,2023,30.0,1993.0,24.3,38,22,19,13,6,18,39,46.2,21,20,4,16,13,51,25,0,MF,30-34,Midfielder,France,Europe
2693,Arthur Vermeeren,BEL,Atlético Madrid,La Liga,2023,18.0,2005.0,1.8,1,0,0,1,0,0,1,0.0,1,5,0,5,6,7,2,0,MF,Under 20,Midfielder,Belgium,Europe
2694,Yorbe Vertessen,BEL,Union Berlin,Bundesliga,2023,22.0,2001.0,6.6,3,2,0,3,0,1,4,25.0,3,8,0,8,1,4,3,0,"FW,MF",20-24,Forward,Belgium,Europe
2696,Guglielmo Vicario,ITA,Tottenham,Premier League,2023,26.0,1996.0,38.0,0,0,0,0,0,0,1,0.0,1,0,0,0,1,1,31,2,GK,25-29,Goalkeeper,Italy,Europe
2700,Fabio Vieira,POR,Arsenal,Premier League,2023,23.0,2000.0,3.3,3,2,2,0,1,3,3,100.0,0,0,0,0,2,5,2,0,"MF,FW",20-24,Midfielder,Portugal,Europe
2704,Emanuel Vignato,ITA,Salernitana,Serie A,2023,22.0,2000.0,3.5,10,7,4,5,1,5,6,83.3,1,1,0,1,1,11,7,0,"MF,FW",20-24,Midfielder,Italy,Europe
2705,Samuele Vignato,ITA,Monza,Serie A,2023,19.0,2004.0,3.8,6,4,2,3,1,2,3,66.7,1,2,0,2,1,7,1,0,"MF,FW",Under 20,Midfielder,Italy,Europe
2706,Oscar Vilhelmsson,SWE,Darmstadt 98,Bundesliga,2023,19.0,2003.0,15.3,13,6,3,7,3,7,10,70.0,3,15,5,10,3,16,19,0,"FW,MF",Under 20,Forward,Sweden,Europe
2711,Matías Viña,URU,Sassuolo,Serie A,2023,25.0,1997.0,11.3,34,21,22,7,5,20,36,55.6,16,12,2,10,9,43,34,0,DF,25-29,Defender,Uruguay,South America
2712,Rúben Vinagre,POR,Hellas Verona,Serie A,2023,24.0,1999.0,3.1,4,2,1,1,2,3,4,75.0,1,6,3,3,1,5,4,0,"DF,FW",20-24,Defender,Portugal,Europe
2713,Carlos Vinícius,BRA,Fulham,Premier League,2023,28.0,1995.0,3.5,3,2,0,1,2,0,4,0.0,4,4,0,4,0,3,1,0,FW,25-29,Forward,Brazil,South America
2714,Nicolas Viola,ITA,Cagliari,Serie A,2023,33.0,1989.0,13.4,13,9,2,8,3,7,17,41.2,10,9,0,9,2,15,6,0,"MF,FW",30-34,Midfielder,Italy,Europe
2715,Alan Virginius,FRA,Lille,Ligue 1,2023,20.0,2003.0,0.8,1,1,1,0,0,0,1,0.0,1,0,0,0,0,1,0,0,FW,20-24,Forward,France,Europe
2716,Alan Virginius,FRA,Clermont Foot,Ligue 1,2023,20.0,2003.0,10.4,9,5,4,4,1,4,11,36.4,7,7,0,7,3,12,7,0,FW,20-24,Forward,France,Europe
2718,Mattia Viti,ITA,Sassuolo,Serie A,2023,21.0,2002.0,10.9,24,15,14,7,3,10,22,45.5,12,20,10,10,10,34,44,0,DF,20-24,Defender,Italy,Europe
2719,Vitinha,POR,Genoa,Serie A,2023,23.0,2000.0,3.2,2,2,1,0,1,1,2,50.0,1,2,0,2,0,2,2,0,"FW,MF",20-24,Forward,Portugal,Europe
2719,Vitinha,POR,Genoa,Serie A,2023,23.0,2000.0,3.2,2,2,1,0,1,1,2,50.0,1,2,0,2,0,2,2,0,"FW,MF",20-24,Forward,Portugal,Europe
2719,Vitinha,POR,Genoa,Serie A,2023,23.0,2000.0,3.2,2,2,1,0,1,1,2,50.0,1,2,0,2,0,2,2,0,"FW,MF",20-24,Forward,Portugal,Europe
2719,Vitinha,POR,Genoa,Serie A,2023,23.0,2000.0,3.2,2,2,1,0,1,1,2,50.0,1,2,0,2,0,2,2,0,"FW,MF",20-24,Forward,Portugal,Europe
2720,Vitinha,POR,Marseille,Ligue 1,2023,23.0,2000.0,10.3,14,8,3,5,6,3,12,25.0,9,11,2,9,5,19,8,0,FW,20-24,Forward,Portugal,Europe
2720,Vitinha,POR,Marseille,Ligue 1,2023,23.0,2000.0,10.3,14,8,3,5,6,3,12,25.0,9,11,2,9,5,19,8,0,FW,20-24,Forward,Portugal,Europe
2720,Vitinha,POR,Marseille,Ligue 1,2023,23.0,2000.0,10.3,14,8,3,5,6,3,12,25.0,9,11,2,9,5,19,8,0,FW,20-24,Forward,Portugal,Europe
2720,Vitinha,POR,Marseille,Ligue 1,2023,23.0,2000.0,10.3,14,8,3,5,6,3,12,25.0,9,11,2,9,5,19,8,0,FW,20-24,Forward,Portugal,Europe
2721,Vitinha,POR,Paris S-G,Ligue 1,2023,23.0,2000.0,23.6,39,24,12,16,11,16,48,33.3,32,29,11,18,23,62,30,2,MF,20-24,Midfielder,Portugal,Europe
2721,Vitinha,POR,Paris S-G,Ligue 1,2023,23.0,2000.0,23.6,39,24,12,16,11,16,48,33.3,32,29,11,18,23,62,30,2,MF,20-24,Midfielder,Portugal,Europe
2721,Vitinha,POR,Paris S-G,Ligue 1,2023,23.0,2000.0,23.6,39,24,12,16,11,16,48,33.3,32,29,11,18,23,62,30,2,MF,20-24,Midfielder,Portugal,Europe
2721,Vitinha,POR,Paris S-G,Ligue 1,2023,23.0,2000.0,23.6,39,24,12,16,11,16,48,33.3,32,29,11,18,23,62,30,2,MF,20-24,Midfielder,Portugal,Europe
2722,Vitinho,BRA,Burnley,Premier League,2023,24.0,1999.0,25.7,64,34,36,22,6,43,86,50.0,43,44,6,38,12,76,47,4,"DF,MF",20-24,Defender,Brazil,South America
2722,Vitinho,BRA,Burnley,Premier League,2023,24.0,1999.0,25.7,64,34,36,22,6,43,86,50.0,43,44,6,38,12,76,47,4,"DF,MF",20-24,Defender,Brazil,South America
2722,Vitinho,BRA,Burnley,Premier League,2023,24.0,1999.0,25.7,64,34,36,22,6,43,86,50.0,43,44,6,38,12,76,47,4,"DF,MF",20-24,Defender,Brazil,South America
2722,Vitinho,BRA,Burnley,Premier League,2023,24.0,1999.0,25.7,64,34,36,22,6,43,86,50.0,43,44,6,38,12,76,47,4,"DF,MF",20-24,Defender,Brazil,South America
2722,Vitinho,BRA,Burnley,Premier League,2023,24.0,1999.0,25.7,64,34,36,22,6,43,86,50.0,43,44,6,38,12,76,47,4,"DF,MF",20-24,Defender,Brazil,South America
2722,Vitinho,BRA,Burnley,Premier League,2023,24.0,1999.0,25.7,64,34,36,22,6,43,86,50.0,43,44,6,38,12,76,47,4,"DF,MF",20-24,Defender,Brazil,South America
2722,Vitinho,BRA,Burnley,Premier League,2023,24.0,1999.0,25.7,64,34,36,22,6,43,86,50.0,43,44,6,38,12,76,47,4,"DF,MF",20-24,Defender,Brazil,South America
2722,Vitinho,BRA,Burnley,Premier League,2023,24.0,1999.0,25.7,64,34,36,22,6,43,86,50.0,43,44,6,38,12,76,47,4,"DF,MF",20-24,Defender,Brazil,South America
2722,Vitinho,BRA,Burnley,Premier League,2023,24.0,1999.0,25.7,64,34,36,22,6,43,86,50.0,43,44,6,38,12,76,47,4,"DF,MF",20-24,Defender,Brazil,South America
2722,Vitinho,BRA,Burnley,Premier League,2023,24.0,1999.0,25.7,64,34,36,22,6,43,86,50.0,43,44,6,38,12,76,47,4,"DF,MF",20-24,Defender,Brazil,South America
2722,Vitinho,BRA,Burnley,Premier League,2023,24.0,1999.0,25.7,64,34,36,22,6,43,86,50.0,43,44,6,38,12,76,47,4,"DF,MF",20-24,Defender,Brazil,South America
2722,Vitinho,BRA,Burnley,Premier League,2023,24.0,1999.0,25.7,64,34,36,22,6,43,86,50.0,43,44,6,38,12,76,47,4,"DF,MF",20-24,Defender,Brazil,South America
2722,Vitinho,BRA,Burnley,Premier League,2023,24.0,1999.0,25.7,64,34,36,22,6,43,86,50.0,43,44,6,38,12,76,47,4,"DF,MF",20-24,Defender,Brazil,South America
2722,Vitinho,BRA,Burnley,Premier League,2023,24.0,1999.0,25.7,64,34,36,22,6,43,86,50.0,43,44,6,38,12,76,47,4,"DF,MF",20-24,Defender,Brazil,South America
2722,Vitinho,BRA,Burnley,Premier League,2023,24.0,1999.0,25.7,64,34,36,22,6,43,86,50.0,43,44,6,38,12,76,47,4,"DF,MF",20-24,Defender,Brazil,South America
2722,Vitinho,BRA,Burnley,Premier League,2023,24.0,1999.0,25.7,64,34,36,22,6,43,86,50.0,43,44,6,38,12,76,47,4,"DF,MF",20-24,Defender,Brazil,South America
2722,Vitinho,BRA,Burnley,Premier League,2023,24.0,1999.0,25.7,64,34,36,22,6,43,86,50.0,43,44,6,38,12,76,47,4,"DF,MF",20-24,Defender,Brazil,South America
2722,Vitinho,BRA,Burnley,Premier League,2023,24.0,1999.0,25.7,64,34,36,22,6,43,86,50.0,43,44,6,38,12,76,47,4,"DF,MF",20-24,Defender,Brazil,South America
2722,Vitinho,BRA,Burnley,Premier League,2023,24.0,1999.0,25.7,64,34,36,22,6,43,86,50.0,43,44,6,38,12,76,47,4,"DF,MF",20-24,Defender,Brazil,South America
2722,Vitinho,BRA,Burnley,Premier League,2023,24.0,1999.0,25.7,64,34,36,22,6,43,86,50.0,43,44,6,38,12,76,47,4,"DF,MF",20-24,Defender,Brazil,South America
2722,Vitinho,BRA,Burnley,Premier League,2023,24.0,1999.0,25.7,64,34,36,22,6,43,86,50.0,43,44,6,38,12,76,47,4,"DF,MF",20-24,Defender,Brazil,South America
2722,Vitinho,BRA,Burnley,Premier League,2023,24.0,1999.0,25.7,64,34,36,22,6,43,86,50.0,43,44,6,38,12,76,47,4,"DF,MF",20-24,Defender,Brazil,South America
2722,Vitinho,BRA,Burnley,Premier League,2023,24.0,1999.0,25.7,64,34,36,22,6,43,86,50.0,43,44,6,38,12,76,47,4,"DF,MF",20-24,Defender,Brazil,South America
2722,Vitinho,BRA,Burnley,Premier League,2023,24.0,1999.0,25.7,64,34,36,22,6,43,86,50.0,43,44,6,38,12,76,47,4,"DF,MF",20-24,Defender,Brazil,South America
2722,Vitinho,BRA,Burnley,Premier League,2023,24.0,1999.0,25.7,64,34,36,22,6,43,86,50.0,43,44,6,38,12,76,47,4,"DF,MF",20-24,Defender,Brazil,South America
2724,Odisseas Vlachodimos,GRE,Nott'ham Forest,Premier League,2023,29.0,1994.0,5.0,0,0,0,0,0,0,1,0.0,1,0,0,0,0,0,1,0,GK,25-29,Goalkeeper,Greece,Europe
2726,Nikola Vlašić,CRO,Torino,Serie A,2023,25.0,1997.0,29.0,28,16,6,14,8,4,30,13.3,26,26,7,19,11,39,16,0,"MF,FW",25-29,Midfielder,Croatia,Europe
2727,Alessandro Vogliacco,ITA,Genoa,Serie A,2023,24.0,1998.0,13.0,23,15,14,8,1,12,15,80.0,3,16,10,6,30,53,40,1,DF,20-24,Defender,Italy,Europe
2728,Kevin Vogt,GER,Hoffenheim,Bundesliga,2023,31.0,1991.0,14.7,14,10,7,7,0,8,13,61.5,5,16,13,3,9,23,54,0,DF,30-34,Defender,Germany,Europe
2729,Kevin Vogt,GER,Union Berlin,Bundesliga,2023,31.0,1991.0,14.7,10,9,6,4,0,6,12,50.0,6,22,15,7,7,17,72,2,DF,30-34,Defender,Germany,Europe
2731,Kevin Volland,GER,Union Berlin,Bundesliga,2023,31.0,1992.0,14.9,22,9,8,8,6,8,20,40.0,12,8,0,8,6,28,12,0,"FW,MF",30-34,Forward,Germany,Europe
2732,Cristian Volpato,ITA,Sassuolo,Serie A,2023,19.0,2003.0,7.2,16,8,9,6,1,9,25,36.0,16,7,0,7,1,17,5,0,"MF,FW",Under 20,Midfielder,Italy,Europe
2733,Aster Vranckx,BEL,Wolfsburg,Bundesliga,2023,20.0,2002.0,12.8,32,15,11,11,10,15,28,53.6,13,17,6,11,14,46,29,0,MF,20-24,Midfielder,Belgium,Europe
2734,Stefan de Vrij,NED,Inter,Serie A,2023,31.0,1992.0,17.6,18,13,13,4,1,8,15,53.3,7,22,10,12,24,42,51,0,DF,30-34,Defender,Netherlands,Europe
2735,Elye Wahi,FRA,Montpellier,Ligue 1,2023,20.0,2003.0,0.2,0,0,0,0,0,0,0,,0,0,0,0,0,0,0,0,FW,20-24,Forward,France,Europe
2736,Elye Wahi,FRA,Lens,Ligue 1,2023,20.0,2003.0,18.8,6,4,1,3,2,2,10,20.0,8,5,1,4,3,9,3,0,FW,20-24,Forward,France,Europe
2737,Walace,BRA,Udinese,Serie A,2023,28.0,1995.0,36.0,66,43,40,26,0,36,77,46.8,41,43,6,37,43,109,66,1,MF,25-29,Midfielder,Brazil,South America
2738,Luca Waldschmidt,GER,Köln,Bundesliga,2023,27.0,1996.0,12.7,19,12,4,12,3,5,16,31.3,11,18,3,15,6,25,8,1,"MF,FW",25-29,Midfielder,Germany,Europe
2739,Kyle Walker,ENG,Manchester City,Premier League,2023,33.0,1990.0,30.7,38,24,19,17,2,19,39,48.7,20,19,6,13,27,65,40,1,DF,30-34,Defender,England,Europe
2741,Aaron Wan-Bissaka,ENG,Manchester Utd,Premier League,2023,25.0,1997.0,19.8,42,25,18,20,4,19,26,73.1,7,29,15,14,41,83,68,1,DF,25-29,Defender,England,Europe
2742,Joel Ward,ENG,Crystal Palace,Premier League,2023,33.0,1989.0,22.0,45,28,26,18,1,30,47,63.8,17,17,10,7,14,59,94,1,DF,30-34,Defender,England,Europe
2743,James Ward-Prowse,ENG,West Ham,Premier League,2023,28.0,1994.0,33.3,45,29,14,23,8,18,44,40.9,26,31,9,22,38,83,49,0,MF,25-29,Midfielder,England,Europe
2744,Lewis Warrington,ENG,Everton,Premier League,2023,20.0,2002.0,0.0,0,0,0,0,0,0,0,,0,0,0,0,0,0,0,0,FW,20-24,Forward,England,Europe
2745,Deivid Washington,BRA,Chelsea,Premier League,2023,18.0,2005.0,0.1,1,1,1,0,0,0,1,0.0,1,0,0,0,0,1,0,0,"DF,FW",Under 20,Defender,Brazil,South America
2746,Kjell-Arik Wätjen,GER,Dortmund,Bundesliga,2023,17.0,2006.0,1.2,3,2,2,1,0,2,5,40.0,3,1,1,0,0,3,3,0,"MF,FW",Under 20,Midfielder,Germany,Europe
2747,Ollie Watkins,ENG,Aston Villa,Premier League,2023,27.0,1995.0,35.7,12,7,0,5,7,5,11,45.5,6,26,4,22,4,16,20,0,FW,25-29,Forward,England,Europe
2748,Timothy Weah,USA,Juventus,Serie A,2023,23.0,2000.0,14.0,27,20,16,8,3,15,20,75.0,5,12,1,11,5,32,15,0,"DF,FW",20-24,Defender,United States,North America
2749,Adam Webster,ENG,Brighton,Premier League,2023,28.0,1995.0,12.7,14,12,8,5,1,6,18,33.3,12,16,12,4,16,30,43,1,DF,25-29,Defender,England,Europe
2750,Wout Weghorst,NED,Hoffenheim,Bundesliga,2023,30.0,1992.0,22.0,13,6,4,7,2,9,15,60.0,6,25,8,17,6,19,24,0,FW,30-34,Forward,Netherlands,Europe
2751,Julian Weigl,GER,Gladbach,Bundesliga,2023,27.0,1995.0,30.7,66,40,28,32,6,41,67,61.2,26,47,14,33,48,114,61,1,MF,25-29,Midfielder,Germany,Europe
2752,Nelson Weiper,GER,Mainz 05,Bundesliga,2023,18.0,2005.0,1.4,2,1,2,0,0,2,3,66.7,1,1,0,1,1,3,0,0,"FW,MF",Under 20,Forward,Germany,Europe
2753,Mitchell Weiser,GER,Werder Bremen,Bundesliga,2023,29.0,1994.0,29.3,64,38,29,25,10,31,53,58.5,22,36,6,30,20,84,43,0,"DF,MF",25-29,Defender,Germany,Europe
2754,Noah Weißhaupt,GER,Freiburg,Bundesliga,2023,21.0,2001.0,8.4,9,4,6,0,3,5,11,45.5,6,8,1,7,8,17,12,0,"DF,FW",20-24,Defender,Germany,Europe
2755,Shon Weissman,ISR,Salernitana,Serie A,2023,27.0,1996.0,5.5,4,3,2,0,2,0,4,0.0,4,2,1,1,3,7,4,0,"FW,DF",25-29,Forward,Israel,Asia
2756,Shon Weissman,ISR,Granada,La Liga,2023,27.0,1996.0,0.9,1,1,0,0,1,1,4,25.0,3,3,0,3,0,1,1,0,FW,25-29,Forward,Israel,Asia
2757,Danny Welbeck,ENG,Brighton,Premier League,2023,32.0,1990.0,18.8,35,17,9,17,9,10,17,58.8,7,12,0,12,9,44,17,1,"FW,MF",30-34,Forward,England,Europe
2758,Timo Werner,GER,Tottenham,Premier League,2023,27.0,1996.0,9.0,7,4,3,4,0,5,18,27.8,13,12,0,12,3,10,2,0,FW,25-29,Forward,Germany,Europe
2759,Timo Werner,GER,RB Leipzig,Bundesliga,2023,27.0,1996.0,2.3,2,1,0,1,1,0,0,,0,1,0,1,1,3,0,0,"FW,MF",25-29,Forward,Germany,Europe
2760,Adam Wharton,ENG,Crystal Palace,Premier League,2023,19.0,2004.0,14.4,48,32,18,22,8,23,46,50.0,23,17,3,14,20,68,24,1,MF,Under 20,Midfielder,England,Europe
2761,Ethan Wheatley,ENG,Manchester Utd,Premier League,2023,17.0,2006.0,0.2,1,1,0,1,0,1,1,100.0,0,2,0,2,2,3,0,0,FW,Under 20,Forward,England,Europe
2762,Ben White,ENG,Arsenal,Premier League,2023,25.0,1997.0,33.2,48,28,20,22,6,26,58,44.8,32,48,22,26,32,80,77,1,DF,25-29,Defender,England,Europe
2763,Joe White,ENG,Newcastle Utd,Premier League,2023,20.0,2002.0,0.1,1,1,1,0,0,0,0,,0,0,0,0,0,1,0,0,MF,20-24,Midfielder,England,Europe
2764,Silvan Widmer,SUI,Mainz 05,Bundesliga,2023,30.0,1993.0,13.8,23,10,12,8,3,17,28,60.7,11,18,5,13,16,39,37,0,DF,30-34,Defender,Switzerland,Europe
2767,Iñaki Williams,GHA,Athletic Club,La Liga,2023,29.0,1994.0,31.6,24,17,6,8,10,13,34,38.2,21,42,8,34,14,38,29,0,FW,25-29,Forward,Ghana,Africa
2768,Neco Williams,WAL,Nott'ham Forest,Premier League,2023,22.0,2001.0,18.2,69,40,42,18,9,35,56,62.5,21,44,13,31,22,91,53,0,DF,20-24,Defender,Wales,Europe
2770,Willian,BRA,Fulham,Premier League,2023,34.0,1988.0,22.8,18,11,6,7,5,3,21,14.3,18,13,0,13,9,27,12,1,FW,30-34,Forward,Brazil,South America
2770,Willian,BRA,Fulham,Premier League,2023,34.0,1988.0,22.8,18,11,6,7,5,3,21,14.3,18,13,0,13,9,27,12,1,FW,30-34,Forward,Brazil,South America
2770,Willian,BRA,Fulham,Premier League,2023,34.0,1988.0,22.8,18,11,6,7,5,3,21,14.3,18,13,0,13,9,27,12,1,FW,30-34,Forward,Brazil,South America
2770,Willian,BRA,Fulham,Premier League,2023,34.0,1988.0,22.8,18,11,6,7,5,3,21,14.3,18,13,0,13,9,27,12,1,FW,30-34,Forward,Brazil,South America
2771,Joe Willock,ENG,Newcastle Utd,Premier League,2023,23.0,1999.0,4.7,13,7,7,6,0,4,11,36.4,7,7,0,7,1,14,1,0,MF,20-24,Midfielder,England,Europe
2772,Callum Wilson,ENG,Newcastle Utd,Premier League,2023,31.0,1992.0,11.0,5,3,0,2,3,0,4,0.0,4,6,0,6,2,7,4,0,FW,30-34,Forward,England,Europe
2772,Callum Wilson,ENG,Newcastle Utd,Premier League,2023,31.0,1992.0,11.0,5,3,0,2,3,0,4,0.0,4,6,0,6,2,7,4,0,FW,30-34,Forward,England,Europe
2772,Callum Wilson,ENG,Newcastle Utd,Premier League,2023,31.0,1992.0,11.0,5,3,0,2,3,0,4,0.0,4,6,0,6,2,7,4,0,FW,30-34,Forward,England,Europe
2772,Callum Wilson,ENG,Newcastle Utd,Premier League,2023,31.0,1992.0,11.0,5,3,0,2,3,0,4,0.0,4,6,0,6,2,7,4,0,FW,30-34,Forward,England,Europe
2773,Harry Wilson,WAL,Fulham,Premier League,2023,26.0,1997.0,18.0,21,14,9,8,4,11,28,39.3,17,27,3,24,10,31,12,0,FW,25-29,Forward,Wales,Europe
2774,Josh Wilson-Esbrand,ENG,Reims,Ligue 1,2023,20.0,2002.0,5.1,5,4,2,3,0,2,8,25.0,6,5,2,3,6,11,7,0,"DF,MF",20-24,Defender,England,Europe
2775,Patrick Wimmer,AUT,Wolfsburg,Bundesliga,2023,22.0,2001.0,6.5,14,5,5,5,4,8,18,44.4,10,14,0,14,3,17,7,0,"FW,MF",20-24,Forward,Austria,Europe
2776,Jonas Wind,DEN,Wolfsburg,Bundesliga,2023,24.0,1999.0,29.5,13,10,4,6,3,7,17,41.2,10,13,4,9,3,16,21,0,FW,20-24,Forward,Denmark,Europe
2777,Florian Wirtz,GER,Leverkusen,Bundesliga,2023,20.0,2003.0,26.4,27,18,7,14,6,9,29,31.0,20,36,2,34,9,36,3,0,MF,20-24,Midfielder,Germany,Europe
2778,Yoane Wissa,COD,Brentford,Premier League,2023,26.0,1996.0,27.7,28,16,13,10,5,5,20,25.0,15,24,3,21,9,37,15,0,FW,25-29,Forward,DR Congo,Africa
2779,Axel Witsel,BEL,Atlético Madrid,La Liga,2023,34.0,1989.0,30.9,35,21,23,12,0,17,24,70.8,7,40,21,19,16,51,119,0,DF,30-34,Defender,Belgium,Europe
2780,Maximilian Wittek,GER,Bochum,Bundesliga,2023,27.0,1995.0,11.9,23,17,9,11,3,13,21,61.9,8,12,1,11,18,41,23,0,"DF,FW",25-29,Defender,Germany,Europe
2781,Maximilian Wöber,AUT,Gladbach,Bundesliga,2023,25.0,1998.0,23.0,66,31,40,25,1,31,53,58.5,22,47,26,21,38,104,111,0,DF,25-29,Defender,Austria,Europe
2782,Marius Wolf,GER,Dortmund,Bundesliga,2023,28.0,1995.0,13.0,20,12,8,11,1,11,23,47.8,12,12,2,10,8,28,20,0,DF,25-29,Defender,Germany,Europe
2783,Nick Woltemade,GER,Werder Bremen,Bundesliga,2023,21.0,2002.0,13.2,34,23,7,20,7,15,21,71.4,6,12,0,12,5,39,17,0,"FW,MF",20-24,Forward,Germany,Europe
2784,Jeong Woo-yeong,KOR,Stuttgart,Bundesliga,2023,23.0,1999.0,7.0,15,9,6,8,1,6,8,75.0,2,5,0,5,7,22,5,0,"MF,FW",20-24,Midfielder,South Korea,Asia
2785,Chris Wood,NZL,Nott'ham Forest,Premier League,2023,31.0,1991.0,20.1,7,4,1,4,2,3,9,33.3,6,11,3,8,1,8,26,0,FW,30-34,Forward,New Zealand,Oceania
2786,Cauley Woodrow,ENG,Luton Town,Premier League,2023,28.0,1994.0,4.7,16,10,8,4,4,9,16,56.3,7,7,1,6,1,17,14,0,"FW,MF",25-29,Forward,England,Europe
2787,Christopher Wooh,CMR,Rennes,Ligue 1,2023,21.0,2001.0,15.4,18,12,12,6,0,8,15,53.3,7,19,9,10,18,36,51,0,DF,20-24,Defender,Cameroon,Africa
2788,Joe Worrall,ENG,Nott'ham Forest,Premier League,2023,26.0,1997.0,4.9,7,5,6,1,0,3,6,50.0,3,5,4,1,3,10,32,1,DF,25-29,Defender,England,Europe
2790,Granit Xhaka,SUI,Leverkusen,Bundesliga,2023,30.0,1992.0,31.3,29,21,11,14,4,9,30,30.0,21,29,8,21,19,48,42,0,MF,30-34,Midfielder,Switzerland,Europe
2791,Antal Yaakobishvili,HUN,Girona,La Liga,2023,19.0,2004.0,0.7,2,1,1,1,0,1,1,100.0,0,0,0,0,3,5,3,0,DF,Under 20,Defender,Hungary,Europe
2793,Roman Yaremchuk,UKR,Valencia,La Liga,2023,27.0,1995.0,10.3,5,2,1,2,2,3,6,50.0,3,4,0,4,1,6,9,0,FW,25-29,Forward,Ukraine,Europe
2794,Yehor Yarmoliuk,UKR,Brentford,Premier League,2023,19.0,2004.0,7.6,17,11,6,8,3,7,17,41.2,10,17,4,13,6,23,5,0,MF,Under 20,Midfielder,Ukraine,Europe
2795,Ryan Yates,ENG,Nott'ham Forest,Premier League,2023,25.0,1997.0,22.1,66,39,39,21,6,19,34,55.9,15,42,15,27,21,87,44,1,MF,25-29,Midfielder,England,Europe
2796,Yusuf Yazıcı,TUR,Lille,Ligue 1,2023,26.0,1997.0,14.6,19,11,6,9,4,4,15,26.7,11,10,1,9,5,24,5,0,"MF,FW",25-29,Midfielder,Turkey,Asia
2797,Kelvin Yeboah,ITA,Montpellier,Ligue 1,2023,23.0,2000.0,3.1,4,2,2,2,0,1,3,33.3,2,3,2,1,1,5,3,0,FW,20-24,Forward,Italy,Europe
2798,Bertuğ Yıldırım,TUR,Rennes,Ligue 1,2023,21.0,2002.0,5.2,7,5,2,3,2,3,8,37.5,5,8,0,8,0,7,4,0,FW,20-24,Forward,Turkey,Asia
2799,Kenan Yıldız,TUR,Juventus,Serie A,2023,18.0,2005.0,10.6,13,9,5,6,2,4,8,50.0,4,6,0,6,1,14,4,0,"FW,MF",Under 20,Forward,Turkey,Asia
2800,Darlin Yongwa,CMR,Lorient,Ligue 1,2023,22.0,2000.0,12.9,30,23,17,11,2,14,25,56.0,11,14,2,12,15,45,36,0,DF,20-24,Defender,Cameroon,Africa
2801,Leny Yoro,FRA,Lille,Ligue 1,2023,17.0,2005.0,29.7,36,25,27,7,2,17,31,54.8,14,20,14,6,36,72,97,1,DF,Under 20,Defender,France,Europe
2802,Ashley Young,ENG,Everton,Premier League,2023,38.0,1985.0,25.3,53,38,28,19,6,30,54,55.6,24,24,6,18,22,75,50,3,"DF,MF",35-39,Defender,England,Europe
2803,Etienne Youte Kinkoue,FRA,Le Havre,Ligue 1,2023,21.0,2002.0,21.6,15,9,13,2,0,7,11,63.6,4,21,16,5,44,59,104,0,DF,20-24,Defender,France,Europe
2804,Illia Zabarnyi,UKR,Bournemouth,Premier League,2023,20.0,2002.0,37.0,59,32,29,29,1,23,50,46.0,27,53,34,19,33,92,143,4,DF,20-24,Defender,Ukraine,Europe
2805,Mattia Zaccagni,ITA,Lazio,Serie A,2023,28.0,1995.0,21.7,27,16,11,15,1,9,21,42.9,12,26,2,24,21,48,15,0,"FW,MF",25-29,Forward,Italy,Europe
2806,Dan-Axel Zagadou,FRA,Stuttgart,Bundesliga,2023,24.0,1999.0,16.1,21,14,16,5,0,4,8,50.0,4,23,18,5,20,41,78,1,DF,20-24,Defender,France,Europe
2807,Yoram Zague,FRA,Paris S-G,Ligue 1,2023,17.0,2006.0,4.1,18,8,11,4,3,11,24,45.8,13,3,0,3,4,22,9,1,DF,Under 20,Defender,France,Europe
2808,Warren Zaïre-Emery,FRA,Paris S-G,Ligue 1,2023,17.0,2006.0,21.8,51,28,18,24,9,28,51,54.9,23,32,8,24,15,66,22,2,"MF,DF",Under 20,Midfielder,France,Europe
2809,Denis Zakaria,SUI,Monaco,Ligue 1,2023,26.0,1996.0,23.7,38,27,11,20,7,12,30,40.0,18,39,13,26,47,85,41,0,"MF,DF",25-29,Midfielder,Switzerland,Europe
2810,Arsen Zakharyan,RUS,Real Sociedad,La Liga,2023,20.0,2003.0,13.6,22,15,8,11,3,9,22,40.9,13,16,0,16,4,26,10,0,"MF,FW",20-24,Midfielder,Russia,Europe
2813,Andre-Frank Zambo Anguissa,CMR,Napoli,Serie A,2023,27.0,1995.0,31.0,61,33,21,29,11,34,69,49.3,35,40,5,35,28,89,19,1,MF,25-29,Midfielder,Cameroon,Africa
2814,Nicolò Zaniolo,ITA,Aston Villa,Premier League,2023,24.0,1999.0,9.3,19,9,10,7,2,9,17,52.9,8,13,0,13,1,20,11,0,"FW,MF",20-24,Forward,Italy,Europe
2815,Alessandro Zanoli,ITA,Salernitana,Serie A,2023,22.0,2000.0,10.2,16,13,9,7,0,7,12,58.3,5,10,2,8,1,17,17,0,DF,20-24,Defender,Italy,Europe
2816,Alessandro Zanoli,ITA,Napoli,Serie A,2023,22.0,2000.0,0.6,1,1,1,0,0,0,0,,0,0,0,0,1,2,1,0,"DF,FW",20-24,Defender,Italy,Europe
2817,Duván Zapata,COL,Torino,Serie A,2023,32.0,1991.0,32.0,18,7,9,2,7,3,12,25.0,9,20,6,14,7,25,26,0,FW,30-34,Forward,Colombia,South America
2818,Duván Zapata,COL,Atalanta,Serie A,2023,32.0,1991.0,1.2,0,0,0,0,0,0,1,0.0,1,0,0,0,0,0,1,0,FW,30-34,Forward,Colombia,South America
2819,Gabriele Zappa,ITA,Cagliari,Serie A,2023,23.0,1999.0,28.5,54,31,29,16,9,29,41,70.7,12,29,5,24,20,74,75,2,DF,20-24,Defender,Italy,Europe
2820,Davide Zappacosta,ITA,Atalanta,Serie A,2023,31.0,1992.0,20.7,30,20,15,10,5,16,34,47.1,18,29,4,25,5,35,19,0,DF,30-34,Defender,Italy,Europe
2823,Anass Zaroury,MAR,Burnley,Premier League,2023,22.0,2000.0,1.7,1,0,1,0,0,0,4,0.0,4,2,0,2,0,1,1,1,"FW,MF",20-24,Forward,Morocco,Africa
2825,Mehdi Zeffane,ALG,Clermont Foot,Ligue 1,2023,31.0,1992.0,13.7,31,20,17,11,3,17,34,50.0,17,14,3,11,16,47,34,0,"DF,MF",30-34,Defender,Algeria,Africa
2826,Jordan Zemura,ZIM,Udinese,Serie A,2023,23.0,1999.0,11.5,24,16,13,7,4,11,19,57.9,8,5,1,4,13,37,21,0,DF,20-24,Defender,Zimbabwe,Africa
2827,Robin Zentner,GER,Mainz 05,Bundesliga,2023,28.0,1994.0,30.0,2,2,2,0,0,2,5,40.0,3,1,0,1,1,3,19,1,GK,25-29,Goalkeeper,Germany,Europe
2828,Alessio Zerbin,ITA,Monza,Serie A,2023,24.0,1999.0,7.6,18,10,13,2,3,4,13,30.8,9,16,3,13,3,21,5,0,"DF,FW",20-24,Defender,Italy,Europe
2829,Alessio Zerbin,ITA,Napoli,Serie A,2023,24.0,1999.0,1.7,5,2,1,3,1,2,7,28.6,5,1,0,1,0,5,0,0,"FW,DF",20-24,Forward,Italy,Europe
2830,Kevin Zeroli,ITA,Milan,Serie A,2023,18.0,2005.0,0.3,1,1,1,0,0,0,0,,0,1,0,1,0,1,1,0,MF,Under 20,Midfielder,Italy,Europe
2831,Cedric Zesiger,SUI,Wolfsburg,Bundesliga,2023,25.0,1998.0,18.2,19,9,13,4,2,10,22,45.5,12,32,21,11,15,34,88,1,DF,25-29,Defender,Switzerland,Europe
2832,Michael Zetterer,GER,Werder Bremen,Bundesliga,2023,28.0,1995.0,27.0,3,1,3,0,0,3,3,100.0,0,0,0,0,0,3,7,3,GK,25-29,Goalkeeper,Germany,Europe
2833,Nathan Zeze,FRA,Nantes,Ligue 1,2023,18.0,2005.0,11.4,11,6,9,2,0,7,14,50.0,7,12,3,9,12,23,47,1,DF,Under 20,Defender,France,Europe
2837,Christoph Zimmermann,GER,Darmstadt 98,Bundesliga,2023,30.0,1993.0,13.6,33,21,26,7,0,19,39,48.7,20,21,14,7,21,54,66,1,DF,30-34,Defender,Germany,Europe
2838,Oleksandr Zinchenko,UKR,Arsenal,Premier League,2023,26.0,1996.0,19.1,50,30,19,24,7,35,52,67.3,17,18,3,15,20,70,26,2,DF,25-29,Defender,Ukraine,Europe
2839,Joshua Zirkzee,NED,Bologna,Serie A,2023,22.0,2001.0,30.7,32,20,8,15,9,13,24,54.2,11,25,2,23,3,35,36,0,FW,20-24,Forward,Netherlands,Europe
2840,Luc Zogbé,CIV,Brest,Ligue 1,2023,18.0,2005.0,0.1,0,0,0,0,0,0,1,0.0,1,1,1,0,1,1,0,0,DF,Under 20,Defender,Ivory Coast,Africa
2841,Simon Zoller,GER,Bochum,Bundesliga,2023,32.0,1991.0,0.5,0,0,0,0,0,0,0,,0,1,0,1,0,0,0,0,"FW,MF",30-34,Forward,Germany,Europe
2842,Nadir Zortea,ITA,Frosinone,Serie A,2023,24.0,1999.0,14.0,21,14,8,13,0,10,22,45.5,12,13,5,8,4,25,29,1,DF,20-24,Defender,Italy,Europe
2843,Nadir Zortea,ITA,Atalanta,Serie A,2023,24.0,1999.0,1.7,5,4,3,1,1,1,4,25.0,3,2,0,2,1,6,3,0,DF,20-24,Defender,Italy,Europe
2844,Kurt Zouma,FRA,West Ham,Premier League,2023,28.0,1994.0,31.5,23,17,14,9,0,10,16,62.5,6,38,28,10,29,52,160,0,DF,25-29,Defender,France,Europe
2848,Lovro Zvonarek,CRO,Bayern Munich,Bundesliga,2023,18.0,2005.0,1.8,0,0,0,0,0,0,5,0.0,5,3,0,3,0,0,2,0,"FW,MF",Under 20,Forward,Croatia,Europe
2850,Milan Đurić,BIH,Hellas Verona,Serie A,2023,33.0,1990.0,13.4,1,0,0,0,1,0,3,0.0,3,0,0,0,1,2,13,0,FW,30-34,Forward,Bosnia and Herzegovina,Europe
2851,Milan Đurić,BIH,Monza,Serie A,2023,33.0,1990.0,14.0,5,5,0,5,0,2,4,50.0,2,6,2,4,0,5,27,0,FW,30-34,Forward,Bosnia and Herzegovina,Europe
2052,Jiří Pavlenka,CZE,Werder Bremen,Bundesliga,2023,31.0,1992.0,7.0,0,0,0,0,0,0,0,,0,0,0,0,0,0,2,0,GK,30-34,Goalkeeper,Czech Republic,Europe
2060,Marcus Pedersen,NOR,Sassuolo,Serie A,2023,23.0,2000.0,17.9,36,24,25,5,6,21,25,84.0,4,19,5,14,10,46,51,0,DF,20-24,Defender,Norway,Europe
2060,Marcus Pedersen,NOR,Sassuolo,Serie A,2023,23.0,2000.0,17.9,36,24,25,5,6,21,25,84.0,4,19,5,14,10,46,51,0,DF,20-24,Defender,Norway,Europe
2060,Marcus Pedersen,NOR,Sassuolo,Serie A,2023,23.0,2000.0,17.9,36,24,25,5,6,21,25,84.0,4,19,5,14,10,46,51,0,DF,20-24,Defender,Norway,Europe
2060,Marcus Pedersen,NOR,Sassuolo,Serie A,2023,23.0,2000.0,17.9,36,24,25,5,6,21,25,84.0,4,19,5,14,10,46,51,0,DF,20-24,Defender,Norway,Europe
2061,Alfonso Pedraza,ESP,Villarreal,La Liga,2023,27.0,1996.0,12.4,25,9,18,5,2,9,17,52.9,8,16,7,9,13,38,19,0,DF,25-29,Defender,Spain,Europe
2062,Pedri,ESP,Barcelona,La Liga,2023,20.0,2002.0,16.4,33,24,16,13,4,8,27,29.6,19,27,3,24,14,47,10,0,"MF,FW",20-24,Midfielder,Spain,Europe
2063,Pedro,ESP,Lazio,Serie A,2023,36.0,1987.0,9.1,16,12,5,7,4,3,12,25.0,9,16,2,14,3,19,1,0,"FW,MF",35-39,Forward,Spain,Europe
2063,Pedro,ESP,Lazio,Serie A,2023,36.0,1987.0,9.1,16,12,5,7,4,3,12,25.0,9,16,2,14,3,19,1,0,"FW,MF",35-39,Forward,Spain,Europe
2063,Pedro,ESP,Lazio,Serie A,2023,36.0,1987.0,9.1,16,12,5,7,4,3,12,25.0,9,16,2,14,3,19,1,0,"FW,MF",35-39,Forward,Spain,Europe
2063,Pedro,ESP,Lazio,Serie A,2023,36.0,1987.0,9.1,16,12,5,7,4,3,12,25.0,9,16,2,14,3,19,1,0,"FW,MF",35-39,Forward,Spain,Europe
2063,Pedro,ESP,Lazio,Serie A,2023,36.0,1987.0,9.1,16,12,5,7,4,3,12,25.0,9,16,2,14,3,19,1,0,"FW,MF",35-39,Forward,Spain,Europe
2063,Pedro,ESP,Lazio,Serie A,2023,36.0,1987.0,9.1,16,12,5,7,4,3,12,25.0,9,16,2,14,3,19,1,0,"FW,MF",35-39,Forward,Spain,Europe
2063,Pedro,ESP,Lazio,Serie A,2023,36.0,1987.0,9.1,16,12,5,7,4,3,12,25.0,9,16,2,14,3,19,1,0,"FW,MF",35-39,Forward,Spain,Europe
2063,Pedro,ESP,Lazio,Serie A,2023,36.0,1987.0,9.1,16,12,5,7,4,3,12,25.0,9,16,2,14,3,19,1,0,"FW,MF",35-39,Forward,Spain,Europe
2063,Pedro,ESP,Lazio,Serie A,2023,36.0,1987.0,9.1,16,12,5,7,4,3,12,25.0,9,16,2,14,3,19,1,0,"FW,MF",35-39,Forward,Spain,Europe
2063,Pedro,ESP,Lazio,Serie A,2023,36.0,1987.0,9.1,16,12,5,7,4,3,12,25.0,9,16,2,14,3,19,1,0,"FW,MF",35-39,Forward,Spain,Europe
2063,Pedro,ESP,Lazio,Serie A,2023,36.0,1987.0,9.1,16,12,5,7,4,3,12,25.0,9,16,2,14,3,19,1,0,"FW,MF",35-39,Forward,Spain,Europe
2063,Pedro,ESP,Lazio,Serie A,2023,36.0,1987.0,9.1,16,12,5,7,4,3,12,25.0,9,16,2,14,3,19,1,0,"FW,MF",35-39,Forward,Spain,Europe
2063,Pedro,ESP,Lazio,Serie A,2023,36.0,1987.0,9.1,16,12,5,7,4,3,12,25.0,9,16,2,14,3,19,1,0,"FW,MF",35-39,Forward,Spain,Europe
2063,Pedro,ESP,Lazio,Serie A,2023,36.0,1987.0,9.1,16,12,5,7,4,3,12,25.0,9,16,2,14,3,19,1,0,"FW,MF",35-39,Forward,Spain,Europe
2063,Pedro,ESP,Lazio,Serie A,2023,36.0,1987.0,9.1,16,12,5,7,4,3,12,25.0,9,16,2,14,3,19,1,0,"FW,MF",35-39,Forward,Spain,Europe
2063,Pedro,ESP,Lazio,Serie A,2023,36.0,1987.0,9.1,16,12,5,7,4,3,12,25.0,9,16,2,14,3,19,1,0,"FW,MF",35-39,Forward,Spain,Europe
2064,Adrià Pedrosa,ESP,Sevilla,La Liga,2023,25.0,1998.0,19.5,46,26,28,14,4,23,34,67.6,11,26,6,20,15,61,54,0,DF,25-29,Defender,Spain,Europe
2068,Pejiño,ESP,Las Palmas,La Liga,2023,27.0,1996.0,5.6,12,8,3,6,3,6,18,33.3,12,4,0,4,2,14,5,0,FW,25-29,Forward,Spain,Europe
2079,Iñaki Peña,ESP,Barcelona,La Liga,2023,24.0,1999.0,10.0,0,0,0,0,0,0,1,0.0,1,0,0,0,0,0,5,1,GK,20-24,Goalkeeper,Spain,Europe
2080,Marcos Peña,ESP,Almería,La Liga,2023,18.0,2005.0,4.9,19,14,12,7,0,6,12,50.0,6,9,3,6,13,32,8,0,MF,Under 20,Midfielder,Spain,Europe
2081,Rubén Peña,ESP,Osasuna,La Liga,2023,32.0,1991.0,23.2,47,25,22,18,7,20,49,40.8,29,37,8,29,30,77,39,3,"DF,FW",30-34,Defender,Spain,Europe
2083,Alberto Perea,ESP,Granada,La Liga,2023,32.0,1990.0,0.0,0,0,0,0,0,0,2,0.0,2,0,0,0,0,0,0,0,"MF,FW",30-34,Midfielder,Spain,Europe
2090,Ayoze Pérez,ESP,Betis,La Liga,2023,30.0,1993.0,25.5,59,32,16,33,10,21,49,42.9,28,42,4,38,22,81,18,0,FW,30-34,Forward,Spain,Europe
2091,Carles Pérez,ESP,Celta Vigo,La Liga,2023,25.0,1998.0,8.6,13,5,6,5,2,7,18,38.9,11,14,1,13,5,18,8,0,"MF,DF",25-29,Midfielder,Spain,Europe
2092,Francisco Perez,ESP,Valencia,La Liga,2023,20.0,2002.0,22.8,30,17,10,14,6,15,44,34.1,29,19,0,19,14,44,5,0,"MF,FW",20-24,Midfielder,Spain,Europe
2093,Kike Pérez,ESP,Rayo Vallecano,La Liga,2023,26.0,1997.0,9.3,27,11,11,15,1,11,23,47.8,12,11,0,11,8,35,6,0,"MF,FW",25-29,Midfielder,Spain,Europe
2106,Denis Petrić,SRB,Nantes,Ligue 1,2023,35.0,1988.0,0.3,0,0,0,0,0,0,0,,0,0,0,0,0,0,0,0,GK,35-39,Goalkeeper,Serbia,Europe
2107,Njegoš Petrović,SRB,Granada,La Liga,2023,24.0,1999.0,1.7,5,2,4,1,0,2,3,66.7,1,2,0,2,1,6,3,0,"MF,FW",20-24,Midfielder,Serbia,Europe
2108,Đorđe Petrović,SRB,Chelsea,Premier League,2023,23.0,1999.0,22.1,0,0,0,0,0,0,0,,0,0,0,0,0,0,12,3,GK,20-24,Goalkeeper,Serbia,Europe
2109,Jens Petter Hauge,NOR,Eint Frankfurt,Bundesliga,2023,23.0,1999.0,1.6,2,1,1,0,1,2,7,28.6,5,5,1,4,0,2,1,0,"MF,FW",20-24,Midfielder,Norway,Europe
2118,Kamil Piątkowski,POL,Granada,La Liga,2023,23.0,2000.0,5.6,18,10,16,1,1,10,14,71.4,4,6,5,1,8,26,28,1,DF,20-24,Defender,Poland,Europe
2130,Yeremi Pino,ESP,Villarreal,La Liga,2023,20.0,2002.0,5.3,25,18,12,10,3,9,18,50.0,9,11,1,10,5,30,5,0,"MF,FW",20-24,Midfielder,Spain,Europe
2143,Pedro Porro,ESP,Tottenham,Premier League,2023,23.0,1999.0,34.3,91,63,43,34,14,62,120,51.7,58,63,18,45,34,125,102,3,DF,20-24,Defender,Spain,Europe
2144,Portu,ESP,Getafe,La Liga,2023,31.0,1992.0,1.1,5,3,4,0,1,5,6,83.3,1,0,0,0,0,5,0,0,FW,30-34,Forward,Spain,Europe
2145,Portu,ESP,Girona,La Liga,2023,31.0,1992.0,13.2,18,13,3,10,5,3,18,16.7,15,9,1,8,4,22,6,0,"MF,FW",30-34,Midfielder,Spain,Europe
2148,José Pozo,ESP,Rayo Vallecano,La Liga,2023,27.0,1996.0,0.2,1,1,0,1,0,1,1,100.0,0,1,0,1,0,1,0,0,MF,25-29,Midfielder,Spain,Europe
2149,Alejandro Pozo Pozo,ESP,Almería,La Liga,2023,24.0,1999.0,10.8,19,12,11,6,2,12,20,60.0,8,14,4,10,7,26,21,0,"DF,MF",20-24,Defender,Spain,Europe
2150,Beñat Prados,ESP,Athletic Club,La Liga,2023,22.0,2001.0,16.1,45,28,11,23,11,23,42,54.8,19,32,5,27,23,68,27,0,"MF,DF",20-24,Midfielder,Spain,Europe
2152,Abdón Prats,ESP,Mallorca,La Liga,2023,30.0,1992.0,14.1,6,4,2,2,2,3,5,60.0,2,6,3,3,2,8,12,0,"FW,MF",30-34,Forward,Spain,Europe
2156,Marc Pubill,ESP,Almería,La Liga,2023,20.0,2003.0,20.9,47,23,35,8,4,22,39,56.4,17,20,8,12,15,62,83,1,DF,20-24,Defender,Spain,Europe
2158,Antonio Puertas,ESP,Granada,La Liga,2023,31.0,1992.0,8.1,12,8,6,5,1,6,15,40.0,9,5,0,5,6,18,4,0,"MF,FW",30-34,Midfielder,Spain,Europe
2159,Arnau Puigmal,ESP,Almería,La Liga,2023,22.0,2001.0,2.8,2,1,1,1,0,1,3,33.3,2,3,0,3,3,5,2,0,"FW,DF",20-24,Forward,Spain,Europe
2165,Uroš Račić,SRB,Sassuolo,Serie A,2023,25.0,1998.0,9.1,10,4,6,4,0,0,9,0.0,9,16,7,9,7,17,22,0,MF,25-29,Midfielder,Serbia,Europe
2166,Nemanja Radonjić,SRB,Torino,Serie A,2023,27.0,1996.0,4.2,1,1,0,0,1,1,3,33.3,2,3,0,3,0,1,0,0,"MF,FW",25-29,Midfielder,Serbia,Europe
2167,Nemanja Radonjić,SRB,Mallorca,La Liga,2023,27.0,1996.0,3.9,4,2,1,3,0,1,4,25.0,3,2,0,2,3,7,3,0,"MF,DF",25-29,Midfielder,Serbia,Europe
2168,Aleksandar Radovanović,SRB,Almería,La Liga,2023,29.0,1993.0,6.3,8,7,7,1,0,6,6,100.0,0,8,8,0,11,19,48,0,DF,25-29,Defender,Serbia,Europe
2170,Boris Radunović,SRB,Cagliari,Serie A,2023,27.0,1996.0,7.0,0,0,0,0,0,0,0,,0,0,0,0,1,1,1,2,GK,25-29,Goalkeeper,Serbia,Europe
2173,Antonio Raillo,ESP,Mallorca,La Liga,2023,31.0,1991.0,24.4,30,23,18,12,0,17,23,73.9,6,44,30,14,37,67,104,2,DF,30-34,Defender,Spain,Europe
2175,Predrag Rajković,SRB,Mallorca,La Liga,2023,27.0,1995.0,36.0,2,1,2,0,0,2,2,100.0,0,0,0,0,0,2,14,0,GK,25-29,Goalkeeper,Serbia,Europe
2180,Benito Ramírez,ESP,Las Palmas,La Liga,2023,28.0,1995.0,4.3,5,3,2,3,0,3,6,50.0,3,7,1,6,3,8,0,0,"FW,MF",25-29,Forward,Spain,Europe
2181,Sandro Ramírez,ESP,Las Palmas,La Liga,2023,28.0,1995.0,20.1,12,8,4,6,2,6,15,40.0,9,13,1,12,4,16,14,1,FW,25-29,Forward,Spain,Europe
2182,Chris Ramos,ESP,Cádiz,La Liga,2023,26.0,1997.0,29.0,28,15,9,15,4,8,27,29.6,19,23,7,16,9,37,44,0,"FW,MF",25-29,Forward,Spain,Europe
2184,Sergio Ramos,ESP,Sevilla,La Liga,2023,37.0,1986.0,28.0,45,30,32,11,2,27,40,67.5,13,35,30,5,41,86,156,0,DF,35-39,Defender,Spain,Europe
2197,Raúl,ESP,Osasuna,La Liga,2023,22.0,2000.0,15.1,10,4,4,2,4,2,10,20.0,8,9,1,8,5,15,11,0,FW,20-24,Forward,Spain,Europe
2200,David Raya,ESP,Arsenal,Premier League,2023,27.0,1995.0,32.0,1,1,1,0,0,1,1,100.0,0,0,0,0,0,1,8,5,GK,25-29,Goalkeeper,Spain,Europe
2205,Sergio Reguilón,ESP,Manchester Utd,Premier League,2023,26.0,1996.0,4.6,13,8,6,2,5,8,17,47.1,9,10,0,10,5,18,7,0,DF,25-29,Defender,Spain,Europe
2206,Sergio Reguilón,ESP,Brentford,Premier League,2023,26.0,1996.0,12.4,45,20,26,18,1,24,40,60.0,16,23,6,17,16,61,41,1,DF,25-29,Defender,Spain,Europe
2209,Pepe Reina,ESP,Villarreal,La Liga,2023,40.0,1982.0,2.0,0,0,0,0,0,0,0,,0,0,0,0,0,0,1,0,GK,Over 40,Goalkeeper,Spain,Europe
2212,Álex Remiro,ESP,Real Sociedad,La Liga,2023,28.0,1995.0,36.4,0,0,0,0,0,0,0,,0,0,0,0,0,0,24,2,GK,25-29,Goalkeeper,Spain,Europe
2228,Diego Rico,ESP,Getafe,La Liga,2023,30.0,1993.0,28.2,64,48,32,23,9,41,76,53.9,35,25,8,17,41,105,76,0,DF,30-34,Defender,Spain,Europe
2233,Luis Rioja,ESP,Alavés,La Liga,2023,29.0,1993.0,27.8,27,19,10,12,5,14,43,32.6,29,28,1,27,16,43,28,0,"FW,MF",25-29,Forward,Spain,Europe
2235,Rodrigo Riquelme,ESP,Atlético Madrid,La Liga,2023,23.0,2000.0,17.0,30,19,18,4,8,18,46,39.1,28,19,0,19,9,39,20,0,"DF,MF",20-24,Defender,Spain,Europe
2236,Alberto Risco,ESP,Getafe,La Liga,2023,17.0,2005.0,1.5,2,2,1,1,0,0,4,0.0,4,0,0,0,0,2,1,0,MF,Under 20,Midfielder,Spain,Europe
2237,Mihailo Ristić,SRB,Celta Vigo,La Liga,2023,27.0,1995.0,9.0,15,9,9,6,0,9,12,75.0,3,9,2,7,10,25,23,0,"DF,MF",25-29,Defender,Serbia,Europe
2239,Gorka Rivera Alonso,ESP,Getafe,La Liga,2023,18.0,2004.0,0.0,0,0,0,0,0,0,0,,0,0,0,0,0,0,0,0,DF,Under 20,Defender,Spain,Europe
2240,Sergi Roberto,ESP,Barcelona,La Liga,2023,31.0,1992.0,9.6,15,10,4,10,1,3,11,27.3,8,7,2,5,8,23,7,1,"MF,DF",30-34,Midfielder,Spain,Europe
2246,Marc Roca,ESP,Betis,La Liga,2023,26.0,1996.0,22.0,52,36,17,29,6,30,53,56.6,23,29,6,23,17,69,23,1,MF,25-29,Midfielder,Spain,Europe
2248,Sergio Rodelas,ESP,Granada,La Liga,2023,18.0,2004.0,1.4,3,2,1,0,2,0,3,0.0,3,0,0,0,0,3,0,0,"FW,DF",Under 20,Forward,Spain,Europe
2249,Rodri,ESP,Manchester City,Premier League,2023,27.0,1996.0,32.6,70,43,25,33,12,29,60,48.3,31,32,8,24,26,96,41,4,MF,25-29,Midfielder,Spain,Europe
2249,Rodri,ESP,Manchester City,Premier League,2023,27.0,1996.0,32.6,70,43,25,33,12,29,60,48.3,31,32,8,24,26,96,41,4,MF,25-29,Midfielder,Spain,Europe
2249,Rodri,ESP,Manchester City,Premier League,2023,27.0,1996.0,32.6,70,43,25,33,12,29,60,48.3,31,32,8,24,26,96,41,4,MF,25-29,Midfielder,Spain,Europe
2249,Rodri,ESP,Manchester City,Premier League,2023,27.0,1996.0,32.6,70,43,25,33,12,29,60,48.3,31,32,8,24,26,96,41,4,MF,25-29,Midfielder,Spain,Europe
2250,Rodri,ESP,Betis,La Liga,2023,23.0,2000.0,11.7,17,10,6,7,4,8,21,38.1,13,11,0,11,8,25,2,0,"FW,MF",20-24,Forward,Spain,Europe
2250,Rodri,ESP,Betis,La Liga,2023,23.0,2000.0,11.7,17,10,6,7,4,8,21,38.1,13,11,0,11,8,25,2,0,"FW,MF",20-24,Forward,Spain,Europe
2250,Rodri,ESP,Betis,La Liga,2023,23.0,2000.0,11.7,17,10,6,7,4,8,21,38.1,13,11,0,11,8,25,2,0,"FW,MF",20-24,Forward,Spain,Europe
2250,Rodri,ESP,Betis,La Liga,2023,23.0,2000.0,11.7,17,10,6,7,4,8,21,38.1,13,11,0,11,8,25,2,0,"FW,MF",20-24,Forward,Spain,Europe
2252,Óscar Rodríguez Arnaiz,ESP,Getafe,La Liga,2023,25.0,1998.0,10.7,24,13,2,15,7,9,15,60.0,6,12,1,11,5,29,5,0,"MF,FW",25-29,Midfielder,Spain,Europe
2253,Damián Rodríguez,ESP,Celta Vigo,La Liga,2023,20.0,2003.0,2.9,6,3,1,3,2,1,3,33.3,2,4,2,2,1,7,2,0,MF,20-24,Midfielder,Spain,Europe
2254,Dani Rodríguez,ESP,Mallorca,La Liga,2023,35.0,1988.0,29.1,47,24,21,20,6,21,45,46.7,24,34,5,29,15,62,21,0,MF,35-39,Midfielder,Spain,Europe
2254,Dani Rodríguez,ESP,Mallorca,La Liga,2023,35.0,1988.0,29.1,47,24,21,20,6,21,45,46.7,24,34,5,29,15,62,21,0,MF,35-39,Midfielder,Spain,Europe
2254,Dani Rodríguez,ESP,Mallorca,La Liga,2023,35.0,1988.0,29.1,47,24,21,20,6,21,45,46.7,24,34,5,29,15,62,21,0,MF,35-39,Midfielder,Spain,Europe
2254,Dani Rodríguez,ESP,Mallorca,La Liga,2023,35.0,1988.0,29.1,47,24,21,20,6,21,45,46.7,24,34,5,29,15,62,21,0,MF,35-39,Midfielder,Spain,Europe
2257,Kirian Rodríguez,ESP,Las Palmas,La Liga,2023,27.0,1996.0,35.7,52,32,22,25,5,24,67,35.8,43,39,3,36,28,80,23,1,MF,25-29,Midfielder,Spain,Europe
2258,Miguel Rodríguez,ESP,Celta Vigo,La Liga,2023,20.0,2003.0,3.3,6,3,3,1,2,3,9,33.3,6,8,0,8,4,10,0,0,MF,20-24,Midfielder,Spain,Europe
2267,Carlos Romero,ESP,Villarreal,La Liga,2023,21.0,2001.0,2.9,11,5,8,1,2,7,12,58.3,5,3,0,3,1,12,11,0,DF,20-24,Defender,Spain,Europe
2269,Isaac Romero,ESP,Sevilla,La Liga,2023,23.0,2000.0,11.5,6,3,2,2,2,5,9,55.6,4,12,0,12,0,6,11,0,FW,20-24,Forward,Spain,Europe
2272,Oriol Romeu,ESP,Barcelona,La Liga,2023,31.0,1991.0,10.4,34,20,17,14,3,13,24,54.2,11,12,2,10,10,44,18,0,MF,30-34,Midfielder,Spain,Europe
2276,Unai Ropero,ESP,Alavés,La Liga,2023,21.0,2001.0,0.1,0,0,0,0,0,0,0,,0,0,0,0,0,0,0,0,MF,20-24,Midfielder,Spain,Europe
2290,Javier Rueda Garcia,ESP,Celta Vigo,La Liga,2023,21.0,2002.0,0.2,0,0,0,0,0,0,0,,0,0,0,0,0,0,0,0,"MF,DF",20-24,Midfielder,Spain,Europe
2294,Aitor Ruibal,ESP,Betis,La Liga,2023,27.0,1996.0,11.3,46,27,28,13,5,32,59,54.2,27,12,1,11,14,60,33,1,"DF,FW",25-29,Defender,Spain,Europe
2295,Fabián Ruiz Peña,ESP,Paris S-G,Ligue 1,2023,27.0,1996.0,13.3,34,23,17,14,3,23,42,54.8,19,8,2,6,11,45,21,2,MF,25-29,Midfielder,Spain,Europe
2296,Sergio Ruiz,ESP,Granada,La Liga,2023,28.0,1994.0,27.7,83,46,43,36,4,38,84,45.2,46,24,6,18,28,111,43,1,MF,25-29,Midfielder,Spain,Europe
2297,Julian Ryerson,NOR,Dortmund,Bundesliga,2023,25.0,1997.0,19.6,41,23,26,11,4,27,47,57.4,20,31,7,24,10,51,35,3,DF,25-29,Defender,Norway,Europe
2308,Pablo Saenz,ESP,Granada,La Liga,2023,22.0,2001.0,0.2,3,3,2,0,1,1,3,33.3,2,0,0,0,0,3,0,0,MF,20-24,Midfielder,Spain,Europe
2317,Kike Salas,ESP,Sevilla,La Liga,2023,21.0,2002.0,17.8,41,23,26,12,3,22,36,61.1,14,25,14,11,26,67,91,1,DF,20-24,Defender,Spain,Europe
2322,Salvi,ESP,Rayo Vallecano,La Liga,2023,32.0,1991.0,0.3,0,0,0,0,0,0,4,0.0,4,0,0,0,1,1,0,0,MF,30-34,Midfielder,Spain,Europe
2323,Lazar Samardzic,SRB,Udinese,Serie A,2023,21.0,2002.0,26.4,40,19,18,18,4,16,39,41.0,23,26,6,20,10,50,25,0,MF,20-24,Midfielder,Serbia,Europe
2330,Fede San Emeterio,ESP,Cádiz,La Liga,2023,26.0,1997.0,1.7,3,2,2,1,0,1,4,25.0,3,3,2,1,2,5,1,0,MF,25-29,Midfielder,Spain,Europe
2332,Oihan Sancet,ESP,Athletic Club,La Liga,2023,23.0,2000.0,21.9,19,11,3,10,6,8,21,38.1,13,5,1,4,10,29,5,0,MF,20-24,Midfielder,Spain,Europe
2334,Ricard Sánchez,ESP,Granada,La Liga,2023,23.0,2000.0,25.5,29,18,15,8,6,12,24,50.0,12,32,4,28,13,42,64,0,DF,20-24,Defender,Spain,Europe
2336,Antonio Sánchez,ESP,Mallorca,La Liga,2023,26.0,1997.0,16.1,25,11,13,10,2,11,32,34.4,21,24,5,19,13,38,13,0,MF,25-29,Midfielder,Spain,Europe
2338,Juanlu Sánchez,ESP,Sevilla,La Liga,2023,19.0,2003.0,13.1,56,35,34,18,4,34,58,58.6,24,24,7,17,12,68,36,0,DF,Under 20,Defender,Spain,Europe
2339,Manu Sánchez,ESP,Celta Vigo,La Liga,2023,22.0,2000.0,19.7,54,28,21,25,8,31,55,56.4,24,23,3,20,19,73,65,0,"DF,MF",20-24,Defender,Spain,Europe
2340,Robert Sánchez,ESP,Chelsea,Premier League,2023,25.0,1997.0,15.9,0,0,0,0,0,0,0,,0,0,0,0,0,0,11,3,GK,25-29,Goalkeeper,Spain,Europe
2352,Jesús Santiago,ESP,Getafe,La Liga,2023,19.0,2004.0,7.3,17,8,8,5,4,4,7,57.1,3,3,0,3,0,17,8,0,MF,Under 20,Midfielder,Spain,Europe
2356,Paco Sanz,ESP,Almería,La Liga,2023,18.0,2004.0,0.3,0,0,0,0,0,0,1,0.0,1,0,0,0,0,0,4,0,DF,Under 20,Defender,Spain,Europe
2358,Pablo Sarabia,ESP,Wolves,Premier League,2023,31.0,1992.0,19.4,20,13,8,8,4,12,36,33.3,24,17,1,16,10,30,9,0,"MF,FW",30-34,Midfielder,Spain,Europe
2377,Patrik Schick,CZE,Leverkusen,Bundesliga,2023,27.0,1996.0,11.8,6,4,0,3,3,1,5,20.0,4,2,0,2,1,7,7,0,FW,25-29,Forward,Czech Republic,Europe
2398,Aleksandar Sedlar,SRB,Alavés,La Liga,2023,31.0,1991.0,10.5,14,10,10,4,0,10,16,62.5,6,8,4,4,13,27,43,0,DF,30-34,Defender,Serbia,Europe
2409,Marvin Senaya,TOG,Strasbourg,Ligue 1,2023,22.0,2001.0,23.8,72,53,38,25,9,42,68,61.8,26,40,13,27,41,113,68,0,"DF,MF",20-24,Defender,Togo,Africa
2413,Benjamin Šeško,SVN,RB Leipzig,Bundesliga,2023,20.0,2003.0,17.0,13,5,2,7,4,2,9,22.2,7,23,2,21,3,16,27,0,FW,20-24,Forward,Slovenia,Europe
2436,Jan-Carlo Simic,SRB,Milan,Serie A,2023,18.0,2005.0,1.6,1,1,1,0,0,0,0,,0,5,4,1,0,1,3,0,DF,Under 20,Defender,Serbia,Europe
2438,Unai Simón,ESP,Athletic Club,La Liga,2023,26.0,1997.0,35.4,2,1,1,1,0,2,3,66.7,1,0,0,0,1,3,9,0,GK,25-29,Goalkeeper,Spain,Europe
2447,Antonio Sivera,ESP,Alavés,La Liga,2023,26.0,1996.0,34.0,0,0,0,0,0,0,1,0.0,1,0,0,0,0,0,17,1,GK,25-29,Goalkeeper,Spain,Europe
2451,Leo Skiri Østigård,NOR,Napoli,Serie A,2023,23.0,1999.0,18.1,24,12,13,10,1,6,11,54.5,5,18,12,6,16,40,65,0,DF,20-24,Defender,Norway,Europe
2452,Łukasz Skorupski,POL,Bologna,Serie A,2023,32.0,1991.0,32.0,2,2,2,0,0,2,3,66.7,1,0,0,0,1,3,11,3,GK,30-34,Goalkeeper,Poland,Europe
2463,Rubén Sobrino,ESP,Cádiz,La Liga,2023,31.0,1992.0,18.3,52,28,18,26,8,22,51,43.1,29,26,2,24,16,68,18,0,"MF,FW",30-34,Midfielder,Spain,Europe
2466,Alex Sola,ESP,Alavés,La Liga,2023,24.0,1999.0,14.0,27,15,11,9,7,14,26,53.8,12,18,2,16,11,38,16,0,"FW,MF",20-24,Forward,Spain,Europe
2467,Alex Sola,ESP,Real Sociedad,La Liga,2023,24.0,1999.0,0.3,0,0,0,0,0,0,0,,0,0,0,0,1,1,2,0,"DF,MF",20-24,Defender,Spain,Europe
2469,Ola Solbakken,NOR,Roma,Serie A,2023,24.0,1998.0,0.3,0,0,0,0,0,0,0,,0,0,0,0,0,0,0,0,FW,20-24,Forward,Norway,Europe
2470,Carlos Soler,ESP,Paris S-G,Ligue 1,2023,26.0,1997.0,12.1,15,10,9,2,4,6,21,28.6,15,10,3,7,5,20,11,1,"MF,DF",25-29,Midfielder,Spain,Europe
2476,David Soria,ESP,Getafe,La Liga,2023,30.0,1993.0,37.9,0,0,0,0,0,0,2,0.0,2,0,0,0,0,0,21,6,GK,30-34,Goalkeeper,Spain,Europe
2477,Alberto Soro,ESP,Granada,La Liga,2023,24.0,1999.0,0.1,0,0,0,0,0,0,0,,0,0,0,0,0,0,0,0,MF,20-24,Midfielder,Spain,Europe
2480,Hugo Sotelo,ESP,Celta Vigo,La Liga,2023,19.0,2003.0,8.0,19,17,3,13,3,8,20,40.0,12,7,1,6,2,21,5,0,MF,Under 20,Midfielder,Spain,Europe
2483,Tomáš Souček,CZE,West Ham,Premier League,2023,28.0,1995.0,31.9,53,35,24,26,3,21,47,44.7,26,55,28,27,37,90,109,0,MF,25-29,Midfielder,Czech Republic,Europe
2514,Jørgen Strand Larsen,NOR,Celta Vigo,La Liga,2023,23.0,2000.0,31.8,21,11,1,15,5,8,38,21.1,30,15,1,14,5,26,17,0,FW,20-24,Forward,Norway,Europe
2518,Álex Suárez,ESP,Las Palmas,La Liga,2023,30.0,1993.0,28.5,53,36,33,15,5,31,37,83.8,6,33,14,19,18,71,84,0,DF,30-34,Defender,Spain,Europe
2520,Denis Suárez,ESP,Villarreal,La Liga,2023,29.0,1994.0,1.5,0,0,0,0,0,0,2,0.0,2,2,2,0,0,0,4,0,"MF,FW",25-29,Midfielder,Spain,Europe
2526,Suso,ESP,Sevilla,La Liga,2023,29.0,1993.0,16.9,24,17,14,8,2,8,28,28.6,20,9,0,9,5,29,4,0,"MF,FW",25-29,Midfielder,Spain,Europe
2528,Max Svensson,ESP,Osasuna,La Liga,2023,25.0,1998.0,0.0,1,0,0,0,1,0,0,,0,0,0,0,0,1,0,0,FW,Unknown,Forward,Spain,Europe
2528,Max Svensson,ESP,Osasuna,La Liga,2023,25.0,1998.0,0.0,1,0,0,0,1,0,0,,0,0,0,0,0,1,0,0,FW,Unknown,Forward,Spain,Europe
2528,Max Svensson,ESP,Osasuna,La Liga,2023,22.0,2001.0,0.0,1,0,0,0,1,0,0,,0,0,0,0,0,1,0,0,FW,Unknown,Forward,Spain,Europe
2528,Max Svensson,ESP,Osasuna,La Liga,2023,22.0,2001.0,0.0,1,0,0,0,1,0,0,,0,0,0,0,0,1,0,0,FW,Unknown,Forward,Spain,Europe
2529,Mile Svilar,SRB,Roma,Serie A,2023,23.0,1999.0,15.0,0,0,0,0,0,0,0,,0,0,0,0,0,0,2,1,GK,20-24,Goalkeeper,Serbia,Europe
2531,Karol Świderski,POL,Hellas Verona,Serie A,2023,26.0,1997.0,5.6,7,3,1,3,3,2,3,66.7,1,6,4,2,1,8,8,0,"FW,MF",25-29,Forward,Poland,Europe
2538,Wojciech Szczęsny,POL,Juventus,Serie A,2023,33.0,1990.0,35.0,0,0,0,0,0,0,0,,0,0,0,0,1,1,11,2,GK,30-34,Goalkeeper,Poland,Europe
2540,Przemysław Szymiński,POL,Frosinone,Serie A,2023,29.0,1994.0,0.1,0,0,0,0,0,0,0,,0,1,1,0,0,0,0,0,MF,25-29,Midfielder,Poland,Europe
2541,Alexander Sørloth,NOR,Villarreal,La Liga,2023,27.0,1995.0,27.7,6,3,1,2,3,2,6,33.3,4,9,4,5,0,6,26,0,FW,25-29,Forward,Norway,Europe
2546,Yassin Tallal,ESP,Getafe,La Liga,2023,18.0,2005.0,0.0,0,0,0,0,0,0,0,,0,0,0,0,0,0,0,0,FW,Under 20,Forward,Spain,Europe
2553,César Tárrega,ESP,Valencia,La Liga,2023,21.0,2002.0,0.1,0,0,0,0,0,0,0,,0,0,0,0,0,0,2,0,DF,20-24,Defender,Spain,Europe
2567,Arnau Tenas,ESP,Paris S-G,Ligue 1,2023,22.0,2001.0,5.9,0,0,0,0,0,0,0,,0,0,0,0,0,0,0,0,GK,20-24,Goalkeeper,Spain,Europe
2572,Ramón Terrats,ESP,Villarreal,La Liga,2023,22.0,2000.0,8.7,17,13,8,8,1,7,15,46.7,8,11,1,10,3,20,9,0,"MF,DF",20-24,Midfielder,Spain,Europe
2585,Morten Thorsby,NOR,Genoa,Serie A,2023,27.0,1996.0,12.9,19,11,9,8,2,7,14,50.0,7,21,5,16,4,23,20,0,MF,25-29,Midfielder,Norway,Europe
2586,Kristian Thorstvedt,NOR,Sassuolo,Serie A,2023,24.0,1999.0,26.6,40,22,7,28,5,22,44,50.0,22,25,9,16,21,61,36,0,MF,20-24,Midfielder,Norway,Europe
2602,Raúl de Tomás,ESP,Rayo Vallecano,La Liga,2023,28.0,1994.0,14.1,9,5,4,3,2,3,6,50.0,3,3,0,3,1,10,8,0,FW,25-29,Forward,Spain,Europe
2609,Pablo Torre,ESP,Girona,La Liga,2023,20.0,2003.0,7.8,5,2,0,5,0,4,10,40.0,6,10,2,8,4,9,6,1,"MF,FW",20-24,Midfielder,Spain,Europe
2610,Raúl Torrente,ESP,Granada,La Liga,2023,21.0,2001.0,13.9,29,16,20,9,0,17,22,77.3,5,16,10,6,11,40,68,2,DF,20-24,Defender,Spain,Europe
2611,Ferrán Torres,ESP,Barcelona,La Liga,2023,23.0,2000.0,13.5,9,6,1,6,2,5,16,31.3,11,7,1,6,5,14,6,0,FW,20-24,Forward,Spain,Europe
2612,Óliver Torres,ESP,Sevilla,La Liga,2023,28.0,1994.0,18.0,37,22,17,15,5,22,57,38.6,35,40,4,36,6,43,6,0,MF,25-29,Midfielder,Spain,Europe
2613,Pau Torres,ESP,Aston Villa,Premier League,2023,26.0,1997.0,27.4,29,18,17,11,1,14,30,46.7,16,28,12,16,14,43,75,0,DF,25-29,Defender,Spain,Europe
2614,Lucas Torró,ESP,Osasuna,La Liga,2023,29.0,1994.0,19.9,25,15,11,8,6,11,28,39.3,17,10,2,8,33,58,37,0,MF,25-29,Midfielder,Spain,Europe
2622,Adama Traoré,ESP,Fulham,Premier League,2023,27.0,1996.0,4.2,4,3,1,2,1,3,6,50.0,3,2,0,2,1,5,2,0,"FW,MF",25-29,Forward,Spain,Europe
2622,Adama Traoré,ESP,Fulham,Premier League,2023,27.0,1996.0,4.2,4,3,1,2,1,3,6,50.0,3,2,0,2,1,5,2,0,"FW,MF",25-29,Forward,Spain,Europe
2622,Adama Traoré,ESP,Fulham,Premier League,2023,27.0,1996.0,4.2,4,3,1,2,1,3,6,50.0,3,2,0,2,1,5,2,0,"FW,MF",25-29,Forward,Spain,Europe
2622,Adama Traoré,ESP,Fulham,Premier League,2023,27.0,1996.0,4.2,4,3,1,2,1,3,6,50.0,3,2,0,2,1,5,2,0,"FW,MF",25-29,Forward,Spain,Europe
2622,Adama Traoré,ESP,Fulham,Premier League,2023,27.0,1996.0,4.2,4,3,1,2,1,3,6,50.0,3,2,0,2,1,5,2,0,"FW,MF",25-29,Forward,Spain,Europe
2622,Adama Traoré,ESP,Fulham,Premier League,2023,27.0,1996.0,4.2,4,3,1,2,1,3,6,50.0,3,2,0,2,1,5,2,0,"FW,MF",25-29,Forward,Spain,Europe
2622,Adama Traoré,ESP,Fulham,Premier League,2023,27.0,1996.0,4.2,4,3,1,2,1,3,6,50.0,3,2,0,2,1,5,2,0,"FW,MF",25-29,Forward,Spain,Europe
2622,Adama Traoré,ESP,Fulham,Premier League,2023,27.0,1996.0,4.2,4,3,1,2,1,3,6,50.0,3,2,0,2,1,5,2,0,"FW,MF",25-29,Forward,Spain,Europe
2622,Adama Traoré,ESP,Fulham,Premier League,2023,27.0,1996.0,4.2,4,3,1,2,1,3,6,50.0,3,2,0,2,1,5,2,0,"FW,MF",25-29,Forward,Spain,Europe
2622,Adama Traoré,ESP,Fulham,Premier League,2023,27.0,1996.0,4.2,4,3,1,2,1,3,6,50.0,3,2,0,2,1,5,2,0,"FW,MF",25-29,Forward,Spain,Europe
2622,Adama Traoré,ESP,Fulham,Premier League,2023,27.0,1996.0,4.2,4,3,1,2,1,3,6,50.0,3,2,0,2,1,5,2,0,"FW,MF",25-29,Forward,Spain,Europe
2622,Adama Traoré,ESP,Fulham,Premier League,2023,27.0,1996.0,4.2,4,3,1,2,1,3,6,50.0,3,2,0,2,1,5,2,0,"FW,MF",25-29,Forward,Spain,Europe
2622,Adama Traoré,ESP,Fulham,Premier League,2023,27.0,1996.0,4.2,4,3,1,2,1,3,6,50.0,3,2,0,2,1,5,2,0,"FW,MF",25-29,Forward,Spain,Europe
2622,Adama Traoré,ESP,Fulham,Premier League,2023,27.0,1996.0,4.2,4,3,1,2,1,3,6,50.0,3,2,0,2,1,5,2,0,"FW,MF",25-29,Forward,Spain,Europe
2622,Adama Traoré,ESP,Fulham,Premier League,2023,27.0,1996.0,4.2,4,3,1,2,1,3,6,50.0,3,2,0,2,1,5,2,0,"FW,MF",25-29,Forward,Spain,Europe
2622,Adama Traoré,ESP,Fulham,Premier League,2023,27.0,1996.0,4.2,4,3,1,2,1,3,6,50.0,3,2,0,2,1,5,2,0,"FW,MF",25-29,Forward,Spain,Europe
2637,Manu Trigueros,ESP,Villarreal,La Liga,2023,31.0,1991.0,3.4,7,5,6,1,0,4,10,40.0,6,1,1,0,3,10,9,0,MF,30-34,Midfielder,Spain,Europe
2647,Beñat Turrientes,ESP,Real Sociedad,La Liga,2023,21.0,2002.0,18.7,31,17,6,20,5,13,30,43.3,17,19,8,11,6,37,17,0,MF,20-24,Midfielder,Spain,Europe
2660,Kacper Urbanski,POL,Bologna,Serie A,2023,18.0,2004.0,10.3,16,10,5,10,1,6,13,46.2,7,15,1,14,4,20,14,0,"MF,FW",Under 20,Midfielder,Poland,Europe
2664,Óscar Valentín,ESP,Rayo Vallecano,La Liga,2023,28.0,1994.0,29.9,107,66,39,62,6,46,101,45.5,55,62,10,52,35,142,52,1,MF,25-29,Midfielder,Spain,Europe
2667,Jesús Vallejo,ESP,Granada,La Liga,2023,26.0,1997.0,1.2,3,1,1,2,0,2,2,100.0,0,3,2,1,0,3,1,1,DF,25-29,Defender,Spain,Europe
2668,Álvaro Vallés,ESP,Las Palmas,La Liga,2023,26.0,1997.0,36.3,3,2,3,0,0,3,8,37.5,5,0,0,0,0,3,40,1,GK,25-29,Goalkeeper,Spain,Europe
2677,José Luis García Vayá,ESP,Valencia,La Liga,2023,24.0,1998.0,36.7,78,53,36,36,6,37,71,52.1,34,41,10,31,49,127,71,0,MF,20-24,Midfielder,Spain,Europe
2678,Borja Vázquez,ESP,Cádiz,La Liga,2023,18.0,2005.0,0.0,1,0,1,0,0,1,1,100.0,0,0,0,0,0,1,1,0,FW,Under 20,Forward,Spain,Europe
2679,Jesus Vazquez,ESP,Valencia,La Liga,2023,20.0,2003.0,8.0,24,12,13,8,3,10,16,62.5,6,17,4,13,3,27,24,0,"DF,MF",20-24,Defender,Spain,Europe
2680,Kevin Vázquez,ESP,Celta Vigo,La Liga,2023,30.0,1993.0,7.8,15,13,7,7,1,12,21,57.1,9,11,3,8,5,20,25,0,DF,30-34,Defender,Spain,Europe
2681,Lucas Vázquez,ESP,Real Madrid,La Liga,2023,32.0,1991.0,15.8,37,25,22,14,1,18,25,72.0,7,27,5,22,12,49,36,0,DF,30-34,Defender,Spain,Europe
2683,Gabriel Veiga,ESP,Celta Vigo,La Liga,2023,21.0,2002.0,0.2,0,0,0,0,0,0,0,,0,0,0,0,0,0,0,0,FW,20-24,Forward,Spain,Europe
2686,Miloš Veljković,SRB,Werder Bremen,Bundesliga,2023,27.0,1995.0,21.3,31,15,17,13,1,16,31,51.6,15,31,20,11,17,48,57,0,DF,25-29,Defender,Serbia,Europe
2695,Mikel Vesga,ESP,Athletic Club,La Liga,2023,30.0,1993.0,17.0,40,20,11,23,6,19,49,38.8,30,19,7,12,32,72,35,1,MF,30-34,Midfielder,Spain,Europe
2697,Carlos Vicente,ESP,Alavés,La Liga,2023,24.0,1999.0,12.4,16,6,7,7,2,10,25,40.0,15,4,0,4,4,20,9,0,FW,20-24,Forward,Spain,Europe
2698,Nacho Vidal,ESP,Osasuna,La Liga,2023,28.0,1995.0,1.1,5,4,2,2,1,2,5,40.0,3,2,0,2,0,5,6,0,"DF,FW",25-29,Defender,Spain,Europe
2699,Nacho Vidal,ESP,Mallorca,La Liga,2023,28.0,1995.0,4.6,12,5,4,5,3,6,13,46.2,7,5,2,3,3,15,9,0,DF,25-29,Defender,Spain,Europe
2701,Fran Vieites,ESP,Betis,La Liga,2023,24.0,1999.0,3.5,1,0,1,0,0,1,1,100.0,0,0,0,0,0,1,2,1,GK,20-24,Goalkeeper,Spain,Europe
2702,Jonathan Viera,ESP,Las Palmas,La Liga,2023,33.0,1989.0,6.9,6,3,1,2,3,1,9,11.1,8,0,0,0,0,6,1,0,"MF,FW",30-34,Midfielder,Spain,Europe
2703,Jonathan Viera,ESP,Almería,La Liga,2023,33.0,1989.0,10.1,19,9,6,9,4,10,19,52.6,9,4,0,4,4,23,1,0,MF,30-34,Midfielder,Spain,Europe
2707,Toni Villa,ESP,Girona,La Liga,2023,28.0,1995.0,0.1,0,0,0,0,0,0,0,,0,0,0,0,0,0,0,0,FW,25-29,Forward,Spain,Europe
2708,Asier Villalibre,ESP,Athletic Club,La Liga,2023,25.0,1997.0,5.7,2,1,0,0,2,2,2,100.0,0,2,1,1,0,2,6,0,FW,25-29,Forward,Spain,Europe
2709,Gonzalo Villar,ESP,Granada,La Liga,2023,25.0,1998.0,20.0,51,33,26,20,5,26,41,63.4,15,32,10,22,6,57,26,1,MF,25-29,Midfielder,Spain,Europe
2710,Iván Villar,ESP,Celta Vigo,La Liga,2023,26.0,1997.0,11.3,0,0,0,0,0,0,1,0.0,1,0,0,0,0,0,6,0,GK,25-29,Goalkeeper,Spain,Europe
2717,Ricardo Visus,ESP,Betis,La Liga,2023,22.0,2001.0,1.8,2,2,1,1,0,2,2,100.0,0,2,2,0,2,4,9,1,DF,20-24,Defender,Spain,Europe
2723,Daniel Vivian,ESP,Athletic Club,La Liga,2023,24.0,1999.0,32.0,42,28,29,11,2,28,45,62.2,17,49,25,24,31,73,104,0,DF,20-24,Defender,Spain,Europe
2725,Dušan Vlahović,SRB,Juventus,Serie A,2023,23.0,2000.0,25.6,9,5,0,6,3,4,11,36.4,7,4,2,2,1,10,11,0,FW,20-24,Forward,Serbia,Europe
2740,Sebastian Walukiewicz,POL,Empoli,Serie A,2023,23.0,2000.0,22.8,39,28,33,6,0,28,41,68.3,13,50,31,19,15,54,121,0,DF,20-24,Defender,Poland,Europe
2765,Mateusz Wieteska,POL,Cagliari,Serie A,2023,26.0,1997.0,10.7,14,11,9,3,2,3,10,30.0,7,10,5,5,14,28,48,0,DF,25-29,Defender,Poland,Europe
2766,Mateusz Wieteska,POL,Clermont Foot,Ligue 1,2023,26.0,1997.0,1.9,4,1,3,1,0,3,5,60.0,2,4,2,2,5,9,8,0,DF,25-29,Defender,Poland,Europe
2769,Nico Williams,ESP,Athletic Club,La Liga,2023,21.0,2002.0,25.1,31,12,9,15,7,13,36,36.1,23,18,2,16,3,34,4,1,FW,20-24,Forward,Spain,Europe
2789,Xeber,ESP,Alavés,La Liga,2023,26.0,1997.0,3.4,5,5,3,2,0,3,7,42.9,4,2,1,1,1,6,2,0,"FW,MF",25-29,Forward,Spain,Europe
2792,Lamine Yamal,ESP,Barcelona,La Liga,2023,16.0,2007.0,24.5,61,37,32,15,14,18,48,37.5,30,32,0,32,19,80,11,0,FW,Under 20,Forward,Spain,Europe
2811,Joseba Zaldúa,ESP,Cádiz,La Liga,2023,31.0,1992.0,7.8,20,12,17,2,1,13,21,61.9,8,6,4,2,2,22,20,0,DF,30-34,Defender,Spain,Europe
2812,Nicola Zalewski,POL,Roma,Serie A,2023,21.0,2002.0,10.8,20,14,10,9,1,8,22,36.4,14,12,4,8,9,29,17,0,"DF,FW",20-24,Defender,Poland,Europe
2821,Bryan Zaragoza,ESP,Granada,La Liga,2023,22.0,2001.0,18.2,18,9,8,6,4,8,23,34.8,15,9,0,9,3,21,3,0,"MF,FW",20-24,Midfielder,Spain,Europe
2822,Bryan Zaragoza,ESP,Bayern Munich,Bundesliga,2023,22.0,2001.0,2.0,4,4,2,1,1,3,3,100.0,0,0,0,0,2,6,0,0,"FW,MF",20-24,Forward,Spain,Europe
2824,Oier Zarraga,ESP,Udinese,Serie A,2023,24.0,1999.0,4.5,3,3,2,1,0,1,5,20.0,4,5,2,3,5,8,16,1,MF,20-24,Midfielder,Spain,Europe
2835,Piotr Zieliński,POL,Napoli,Serie A,2023,29.0,1994.0,21.4,23,15,6,13,4,12,24,50.0,12,12,1,11,9,32,15,0,MF,25-29,Midfielder,Poland,Europe
2836,David Zima,CZE,Torino,Serie A,2023,22.0,2000.0,1.0,1,1,1,0,0,0,0,,0,0,0,0,3,4,7,0,DF,20-24,Defender,Czech Republic,Europe
2845,Igor Zubeldia,ESP,Real Sociedad,La Liga,2023,26.0,1997.0,28.0,32,25,20,10,2,19,26,73.1,7,28,19,9,32,64,97,3,DF,25-29,Defender,Spain,Europe
2846,Martín Zubimendi,ESP,Real Sociedad,La Liga,2023,24.0,1999.0,29.5,49,27,18,29,2,23,42,54.8,19,33,9,24,37,86,54,0,MF,20-24,Midfielder,Spain,Europe
2847,Szymon Żurkowski,POL,Empoli,Serie A,2023,25.0,1997.0,9.6,15,6,5,8,2,5,15,33.3,10,5,1,4,6,21,11,0,MF,25-29,Midfielder,Poland,Europe
2849,Martin Ødegaard,NOR,Arsenal,Premier League,2023,24.0,1998.0,34.3,49,17,18,21,10,17,58,29.3,41,23,1,22,15,64,5,0,MF,20-24,Midfielder,Norway,Europe
2852,Mateusz Łęgowski,POL,Salernitana,Serie A,2023,20.0,2003.0,12.7,23,12,8,12,3,11,26,42.3,15,13,2,11,7,30,16,0,MF,20-24,Midfielder,Poland,Europe
87,Thierry Ambrose,GLP,Metz,Ligue 1,2020,23.0,1997.0,8.4,7,4,1,1,5,2,12,16.7,10,2,0,2,2,9,4,0,FW,20-24,Forward,France,Europe
160,Ludovic Baal,GUF,Brest,Ligue 1,2020,34.0,1986.0,3.3,6,5,4,1,1,2,5,40.0,3,4,1,3,5,11,5,0,"DF,MF",30-34,Defender,French Guiana,
288,Valon Berisha,KVX,Reims,Ligue 1,2020,27.0,1993.0,18.3,40,23,19,17,4,11,47,23.4,36,14,2,12,25,65,21,1,MF,25-29,Midfielder,Sweden,Europe
393,Patrick Burner,MTQ,Nice,Ligue 1,2020,24.0,1996.0,0.0,0,0,0,0,0,0,0,,0,0,0,0,0,0,0,0,DF,20-24,Defender,Martinique,
394,Patrick Burner,MTQ,Nîmes,Ligue 1,2020,24.0,1996.0,14.6,25,11,14,10,1,13,26,50.0,13,10,3,7,24,49,41,1,DF,20-24,Defender,Martinique,
480,Bersant Celina,KVX,Dijon,Ligue 1,2020,23.0,1996.0,25.5,20,12,8,8,4,7,38,18.4,31,20,2,18,8,28,10,0,"MF,FW",20-24,Midfielder,Yugoslavia (Republic),
644,Grégoire Defrel,MTQ,Sassuolo,Serie A,2020,29.0,1991.0,14.8,13,8,5,5,3,5,13,38.5,8,9,0,9,7,20,5,0,"MF,FW",25-29,Midfielder,France,Europe
1033,Andrew Gravillon,GLP,Lorient,Ligue 1,2020,22.0,1998.0,25.2,26,17,17,9,0,13,28,46.4,15,44,31,13,59,85,118,4,DF,20-24,Defender,,
1121,Christophe Hérelle,MTQ,Brest,Ligue 1,2020,27.0,1992.0,15.3,19,13,12,6,1,10,12,83.3,2,13,9,4,31,50,41,2,DF,25-29,Defender,France,Europe
1175,Blendi Idrizi,KVX,Schalke 04,Bundesliga,2020,22.0,1998.0,2.6,8,4,1,6,1,1,1,100.0,0,6,2,4,3,11,1,0,MF,20-24,Midfielder,Germany,Europe
1287,Atakan Karazor,Türkiye,Stuttgart,Bundesliga,2020,23.0,1996.0,11.5,20,12,12,7,1,13,22,59.1,9,18,8,10,21,41,50,2,"DF,MF",20-24,Defender,Germany,Europe
1576,Mickael Malsa,MTQ,Levante,La Liga,2020,24.0,1995.0,26.0,55,26,28,24,3,23,51,45.1,28,38,9,29,43,98,36,2,MF,20-24,Midfielder,,
1830,Vedat Muriqi,KVX,Lazio,Serie A,2020,26.0,1994.0,9.2,3,1,0,2,1,0,8,0.0,8,9,2,7,3,6,20,0,FW,25-29,Forward,Yugoslavia (Republic),
2175,Milot Rashica,KVX,Werder Bremen,Bundesliga,2020,24.0,1996.0,16.2,24,12,11,11,2,12,23,52.2,11,7,0,7,4,28,6,0,"FW,MF",20-24,Forward,Yugoslavia (Republic),
2198,Elvis Rexhbeçaj,KVX,Köln,Bundesliga,2020,22.0,1997.0,20.4,53,32,17,27,9,19,53,35.8,34,32,7,25,26,79,18,0,"MF,FW",20-24,Midfielder,,
2267,Amir Rrahmani,KVX,Napoli,Serie A,2020,26.0,1994.0,12.2,13,8,7,6,0,6,9,66.7,3,17,14,3,8,21,39,1,DF,25-29,Defender,Yugoslavia (Republic),
2644,Samir Ujkani,KVX,Torino,Serie A,2020,32.0,1988.0,1.0,0,0,0,0,0,0,0,,0,0,0,0,0,0,1,0,GK,30-34,Goalkeeper,Jugoslawien (SFR),
2711,Mërgim Vojvoda,KVX,Torino,Serie A,2020,25.0,1995.0,15.1,24,14,18,5,1,12,22,54.5,10,19,4,15,18,42,35,1,"DF,FW",25-29,Defender,Germany,Europe
2804,Arber Zeneli,KVX,Reims,Ligue 1,2020,25.0,1995.0,14.3,20,10,11,1,8,8,22,36.4,14,12,1,11,3,23,8,0,"MF,FW",25-29,Midfielder,,
660,Grégoire Defrel,MTQ,Sassuolo,Serie A,2023,32.0,1991.0,8.4,17,8,7,5,5,7,15,46.7,8,10,0,10,3,20,9,0,"FW,MF",30-34,Forward,France,Europe
1121,Christophe Hérelle,MTQ,Metz,Ligue 1,2023,30.0,1992.0,18.0,32,15,24,7,1,13,23,56.5,10,16,9,7,18,50,68,2,DF,30-34,Defender,France,Europe
1298,Atakan Karazor,Türkiye,Stuttgart,Bundesliga,2023,26.0,1996.0,29.1,72,44,23,38,11,29,60,48.3,31,37,8,29,27,99,43,0,MF,25-29,Midfielder,Germany,Europe
1393,Mahmut Kücüksahin,Türkiye,Augsburg,Bundesliga,2023,19.0,2004.0,0.0,0,0,0,0,0,0,0,,0,0,0,0,0,0,0,0,MF,Under 20,Midfielder,,
1837,Arijanet Muric,KVX,Burnley,Premier League,2023,24.0,1998.0,10.0,1,1,1,0,0,1,1,100.0,0,0,0,0,0,1,10,4,GK,20-24,Goalkeeper,Switzerland,Europe
1840,Vedat Muriqi,KVX,Mallorca,La Liga,2023,29.0,1994.0,25.9,11,6,4,3,4,2,14,14.3,12,11,4,7,6,17,26,0,FW,25-29,Forward,Yugoslavia (Republic),
1845,Florent Muslija,KVX,Freiburg,Bundesliga,2023,25.0,1998.0,1.2,5,4,3,2,0,2,5,40.0,3,1,0,1,0,5,2,0,"MF,FW",25-29,Midfielder,Germany,Europe
2032,Leart Paqarada,KVX,Köln,Bundesliga,2023,28.0,1994.0,11.9,21,11,9,9,3,11,22,50.0,11,17,5,12,10,31,30,1,DF,25-29,Defender,,
2072,Marco Pellegrino,Argentina,Salernitana,Serie A,2023,21.0,2002.0,6.1,8,6,4,3,1,5,10,50.0,5,11,6,5,10,18,28,0,DF,Unknown,Defender,Argentina,South America
2073,Marco Pellegrino,Argentina,Milan,Serie A,2023,21.0,2002.0,0.8,1,1,0,0,1,0,2,0.0,2,1,1,0,1,2,2,0,DF,Unknown,Defender,Argentina,South America
2193,Elba Rashani,KVX,Clermont Foot,Ligue 1,2023,30.0,1993.0,13.1,30,18,4,17,9,11,24,45.8,13,17,3,14,12,42,15,0,"MF,FW",30-34,Midfielder,,
2216,Elvis Rexhbeçaj,KVX,Augsburg,Bundesliga,2023,25.0,1997.0,22.1,30,19,14,13,3,18,36,50.0,18,32,7,25,20,50,20,0,MF,25-29,Midfielder,,
2285,Amir Rrahmani,KVX,Napoli,Serie A,2023,29.0,1994.0,28.9,33,27,17,14,2,16,32,50.0,16,24,10,14,20,53,90,0,DF,25-29,Defender,Yugoslavia (Republic),
2321,Yoann Salmier,GUF,Le Havre,Ligue 1,2023,30.0,1992.0,17.4,22,10,13,6,3,13,20,65.0,7,21,15,6,21,43,57,0,DF,30-34,Defender,France,Europe
2395,Jérémy Sebas,MTQ,Strasbourg,Ligue 1,2023,20.0,2003.0,4.4,7,1,2,3,2,3,5,60.0,2,3,1,2,1,8,1,0,"FW,MF",20-24,Forward,Martinique,
2730,Mërgim Vojvoda,KVX,Torino,Serie A,2023,28.0,1995.0,15.3,17,8,7,6,4,11,16,68.8,5,12,2,10,13,30,28,0,DF,25-29,Defender,Germany,Europe
2834,Edon Zhegrova,KVX,Lille,Ligue 1,2023,24.0,1999.0,25.4,32,18,9,15,8,14,36,38.9,22,17,1,16,8,40,8,0,FW,20-24,Forward,Germany,Europe
1,Patrick van Aanholt,NED,Crystal Palace,Premier League,2019,28.0,1990.0,27.9,43,23,31,10,2,23,50,46.0,27,31,9,22,45,88,52,1,DF,25-29,Defender,Netherlands,Europe
2,Max Aarons,ENG,Norwich City,Premier League,2019,19.0,2000.0,36.0,48,30,33,9,6,18,36,50.0,18,46,29,17,37,85,97,1,DF,Under 20,Defender,England,Europe
3,Yunis Abdelhamid,MAR,Reims,Ligue 1,2019,31.0,1987.0,28.0,46,33,29,15,2,17,30,56.7,13,26,14,12,47,93,99,1,DF,30-34,Defender,Morocco,Africa
4,Suleiman Abdullahi,NGA,Union Berlin,Bundesliga,2019,22.0,1996.0,1.7,0,0,0,0,0,0,3,0.0,3,2,1,1,1,1,1,0,"FW,MF",20-24,Forward,Nigeria,Africa
5,Mehdi Abeid,ALG,Nantes,Ligue 1,2019,26.0,1992.0,20.2,55,29,18,32,5,20,53,37.7,33,16,3,13,23,78,8,1,MF,25-29,Midfielder,Algeria,Africa
6,Charles Abi,FRA,Saint-Étienne,Ligue 1,2019,19.0,2000.0,6.9,9,9,2,5,2,2,7,28.6,5,2,0,2,4,13,4,0,FW,Under 20,Forward,France,Europe
7,David Abraham,ARG,Eint Frankfurt,Bundesliga,2019,33.0,1986.0,18.8,21,14,16,4,1,15,32,46.9,17,27,11,16,25,46,61,1,DF,30-34,Defender,Argentina,South America
8,Tammy Abraham,ENG,Chelsea,Premier League,2019,21.0,1997.0,24.6,8,4,2,5,1,3,14,21.4,11,20,2,18,6,14,27,0,FW,20-24,Forward,England,Europe
9,Amir Abrashi,ALB,Freiburg,Bundesliga,2019,29.0,1990.0,7.4,16,8,7,8,1,10,19,52.6,9,18,3,15,7,23,16,2,MF,25-29,Midfielder,Albania,Europe
10,Francesco Acerbi,ITA,Lazio,Serie A,2019,31.0,1988.0,35.1,59,29,42,12,5,14,20,70.0,6,40,27,13,42,101,109,1,DF,30-34,Defender,Italy,Europe
11,Che Adams,SCO,Southampton,Premier League,2019,23.0,1996.0,12.3,6,4,1,5,0,1,4,25.0,3,9,1,8,2,8,10,0,FW,20-24,Forward,Scotland,Europe
12,Tyler Adams,USA,RB Leipzig,Bundesliga,2019,20.0,1999.0,10.6,22,15,13,8,1,12,25,48.0,13,16,1,15,14,36,14,0,"MF,DF",20-24,Midfielder,United States,North America
13,Sargis Adamyan,ARM,Hoffenheim,Bundesliga,2019,26.0,1993.0,8.3,11,7,3,6,2,3,21,14.3,18,8,1,7,2,13,4,0,"FW,MF",25-29,Forward,Armenia,Asia
15,Bobby Adekanye,NED,Lazio,Serie A,2019,20.0,1999.0,2.1,3,2,0,3,0,0,5,0.0,5,0,0,0,2,5,1,0,FW,20-24,Forward,Netherlands,Europe
16,Claud Adjapong,ITA,Hellas Verona,Serie A,2019,21.0,1998.0,2.6,5,3,4,1,0,2,3,66.7,1,4,3,1,3,8,7,0,DF,20-24,Defender,Italy,Europe
17,Amine Adli,MAR,Toulouse,Ligue 1,2019,19.0,2000.0,0.5,0,0,0,0,0,0,1,0.0,1,0,0,0,1,1,0,0,"MF,FW",Under 20,Midfielder,Morocco,Africa
18,Yacine Adli,FRA,Bordeaux,Ligue 1,2019,19.0,2000.0,11.3,22,14,4,15,3,11,34,32.4,23,10,0,10,8,30,3,0,MF,Under 20,Midfielder,France,Europe
21,Lumor Agbenyenu,GHA,Mallorca,La Liga,2019,22.0,1996.0,20.1,31,21,19,9,3,16,35,45.7,19,13,2,11,21,52,66,1,DF,20-24,Defender,Ghana,Africa
23,Lucien Agoume,FRA,Inter,Serie A,2019,17.0,2002.0,0.8,3,2,0,2,1,0,0,,0,3,1,2,0,3,0,0,MF,Under 20,Midfielder,France,Europe
24,Kevin Agudelo,COL,Fiorentina,Serie A,2019,20.0,1998.0,0.7,2,1,0,1,1,0,1,0.0,1,1,0,1,1,3,0,0,"MF,FW",20-24,Midfielder,Colombia,South America
25,Kevin Agudelo,COL,Genoa,Serie A,2019,20.0,1998.0,7.4,23,14,9,12,2,10,20,50.0,10,12,1,11,6,29,2,0,"MF,FW",20-24,Midfielder,Colombia,South America
26,Nayef Aguerd,MAR,Dijon,Ligue 1,2019,23.0,1996.0,10.6,13,9,7,5,1,8,12,66.7,4,11,11,0,18,31,54,0,DF,20-24,Defender,Morocco,Africa
27,Sergio Agüero,ARG,Manchester City,Premier League,2019,31.0,1988.0,16.1,7,4,0,4,3,1,8,12.5,7,9,1,8,3,10,2,0,FW,30-34,Forward,Argentina,South America
28,Ruben Aguilar,FRA,Monaco,Ligue 1,2019,26.0,1993.0,11.9,36,22,19,15,2,19,28,67.9,9,6,2,4,11,47,21,0,DF,25-29,Defender,France,Europe
29,Emmanuel Agyemang-Badu,GHA,Hellas Verona,Serie A,2019,28.0,1990.0,2.6,1,1,0,1,0,1,2,50.0,1,2,2,0,1,2,6,0,MF,25-29,Midfielder,Ghana,Africa
30,Jean-Eudes Aholou,CIV,Saint-Étienne,Ligue 1,2019,25.0,1994.0,7.0,16,12,2,11,3,3,9,33.3,6,6,1,5,15,31,10,0,MF,25-29,Midfielder,Ivory Coast,Africa
31,Joseph Aidoo,GHA,Celta Vigo,La Liga,2019,23.0,1995.0,27.8,43,27,30,11,2,13,27,48.1,14,31,14,17,45,88,124,3,DF,20-24,Defender,Ghana,Africa
32,Ola Aina,NGA,Torino,Serie A,2019,22.0,1996.0,23.1,45,24,23,18,4,17,37,45.9,20,24,6,18,41,86,61,0,DF,20-24,Defender,Nigeria,Africa
33,Youssef Aït Bennasser,MAR,Bordeaux,Ligue 1,2019,23.0,1996.0,6.0,11,8,6,4,1,4,24,16.7,20,6,1,5,4,15,10,1,MF,20-24,Midfielder,Morocco,Africa
34,Rayan Aït-Nouri,ALG,Angers,Ligue 1,2019,18.0,2001.0,14.2,29,22,14,8,7,10,21,47.6,11,14,1,13,18,47,33,0,DF,Under 20,Defender,Algeria,Africa
35,Albian Ajeti,SUI,West Ham,Premier League,2019,22.0,1997.0,1.5,1,0,0,0,1,0,0,,0,0,0,0,0,1,0,0,FW,20-24,Forward,Switzerland,Europe
36,Ludovic Ajorque,FRA,Strasbourg,Ligue 1,2019,25.0,1994.0,22.9,15,10,2,10,3,2,13,15.4,11,11,0,11,2,17,20,0,FW,25-29,Forward,France,Europe
37,Manuel Akanji,SUI,Dortmund,Bundesliga,2019,24.0,1995.0,25.7,38,21,23,14,1,12,20,60.0,8,20,11,9,30,68,61,2,DF,20-24,Defender,Switzerland,Europe
38,Marley Aké,FRA,Marseille,Ligue 1,2019,18.0,2001.0,1.1,2,2,1,1,0,1,3,33.3,2,0,0,0,1,3,1,0,"FW,MF",Under 20,Forward,France,Europe
39,Nathan Aké,NED,Bournemouth,Premier League,2019,24.0,1995.0,27.8,31,21,23,8,0,14,23,60.9,9,40,29,11,36,67,152,0,DF,20-24,Defender,Netherlands,Europe
40,Chadrac Akolo,COD,Amiens,Ligue 1,2019,24.0,1995.0,6.0,16,8,8,6,2,5,12,41.7,7,6,1,5,5,21,5,0,"FW,MF",20-24,Forward,DR Congo,Africa
41,Kevin Akpoguma,NGA,Hoffenheim,Bundesliga,2019,24.0,1995.0,12.7,24,16,20,4,0,13,24,54.2,11,21,11,10,13,37,48,0,DF,20-24,Defender,Nigeria,Africa
42,David Alaba,AUT,Bayern Munich,Bundesliga,2019,27.0,1992.0,27.8,30,17,14,15,1,16,25,64.0,9,19,10,9,29,59,40,0,DF,25-29,Defender,Austria,Europe
43,Sofiane Alakouch,MAR,Nîmes,Ligue 1,2019,21.0,1998.0,15.6,45,26,25,13,7,25,48,52.1,23,13,2,11,23,68,39,3,DF,20-24,Defender,Morocco,Africa
44,Lucas Alario,ARG,Leverkusen,Bundesliga,2019,26.0,1992.0,13.0,6,3,0,4,2,1,8,12.5,7,12,2,10,1,7,9,0,FW,25-29,Forward,Argentina,South America
48,Marc Albrighton,ENG,Leicester City,Premier League,2019,29.0,1989.0,9.6,24,17,10,13,1,9,30,30.0,21,19,2,17,10,34,8,0,"MF,DF",25-29,Midfielder,England,Europe
53,Toby Alderweireld,BEL,Tottenham,Premier League,2019,30.0,1989.0,32.9,40,29,24,13,3,11,24,45.8,13,48,32,16,31,71,172,2,DF,30-34,Defender,Belgium,Europe
58,Rúnar Alex Rúnarsson,ISL,Dijon,Ligue 1,2019,24.0,1995.0,10.0,0,0,0,0,0,0,2,0.0,2,0,0,0,0,0,3,3,GK,20-24,Goalkeeper,Iceland,Europe
59,Trent Alexander-Arnold,ENG,Liverpool,Premier League,2019,20.0,1998.0,35.3,55,34,35,17,3,36,78,46.2,42,27,9,18,45,100,84,3,DF,20-24,Defender,England,Europe
60,Enrico Alfonso,ITA,Brescia,Serie A,2019,31.0,1988.0,3.1,0,0,0,0,0,0,0,,0,0,0,0,0,0,2,0,GK,30-34,Goalkeeper,Italy,Europe
61,Rachid Alioui,MAR,Angers,Ligue 1,2019,27.0,1992.0,17.4,8,5,0,7,1,2,13,15.4,11,3,0,3,2,10,9,0,FW,25-29,Forward,Morocco,Africa
62,Alisson,BRA,Liverpool,Premier League,2019,26.0,1992.0,28.3,0,0,0,0,0,0,2,0.0,2,0,0,0,1,1,13,3,GK,25-29,Goalkeeper,Brazil,South America
62,Alisson,BRA,Liverpool,Premier League,2019,26.0,1992.0,28.3,0,0,0,0,0,0,2,0.0,2,0,0,0,1,1,13,3,GK,25-29,Goalkeeper,Brazil,South America
62,Alisson,BRA,Liverpool,Premier League,2019,26.0,1992.0,28.3,0,0,0,0,0,0,2,0.0,2,0,0,0,1,1,13,3,GK,25-29,Goalkeeper,Brazil,South America
62,Alisson,BRA,Liverpool,Premier League,2019,26.0,1992.0,28.3,0,0,0,0,0,0,2,0.0,2,0,0,0,1,1,13,3,GK,25-29,Goalkeeper,Brazil,South America
63,Allan,BRA,Napoli,Serie A,2019,28.0,1991.0,14.2,50,27,20,21,9,18,54,33.3,36,19,3,16,16,66,11,1,MF,25-29,Midfielder,Brazil,South America
63,Allan,BRA,Napoli,Serie A,2019,28.0,1991.0,14.2,50,27,20,21,9,18,54,33.3,36,19,3,16,16,66,11,1,MF,25-29,Midfielder,Brazil,South America
63,Allan,BRA,Napoli,Serie A,2019,28.0,1991.0,14.2,50,27,20,21,9,18,54,33.3,36,19,3,16,16,66,11,1,MF,25-29,Midfielder,Brazil,South America
63,Allan,BRA,Napoli,Serie A,2019,28.0,1991.0,14.2,50,27,20,21,9,18,54,33.3,36,19,3,16,16,66,11,1,MF,25-29,Midfielder,Brazil,South America
64,Dele Alli,ENG,Tottenham,Premier League,2019,23.0,1996.0,20.5,34,16,11,20,3,13,37,35.1,24,35,3,32,17,51,17,2,"MF,FW",20-24,Midfielder,England,Europe
65,Miguel Almirón,PAR,Newcastle Utd,Premier League,2019,25.0,1994.0,33.6,60,39,32,20,8,19,52,36.5,33,25,1,24,31,91,25,0,"MF,FW",25-29,Midfielder,Paraguay,South America
71,Bruno Alves,POR,Parma,Serie A,2019,37.0,1981.0,29.7,17,11,12,5,0,8,13,61.5,5,30,21,9,25,42,150,2,DF,35-39,Defender,Portugal,Europe
71,Bruno Alves,POR,Parma,Serie A,2019,37.0,1981.0,29.7,17,11,12,5,0,8,13,61.5,5,30,21,9,25,42,150,2,DF,35-39,Defender,Portugal,Europe
71,Bruno Alves,POR,Parma,Serie A,2019,37.0,1981.0,29.7,17,11,12,5,0,8,13,61.5,5,30,21,9,25,42,150,2,DF,35-39,Defender,Portugal,Europe
71,Bruno Alves,POR,Parma,Serie A,2019,37.0,1981.0,29.7,17,11,12,5,0,8,13,61.5,5,30,21,9,25,42,150,2,DF,35-39,Defender,Portugal,Europe
72,Steven Alzate,COL,Brighton,Premier League,2019,20.0,1998.0,13.2,33,19,20,11,2,17,27,63.0,10,18,3,15,14,47,13,0,"MF,DF",20-24,Midfielder,Colombia,South America
73,Ibrahim Amadou,FRA,Norwich City,Premier League,2019,26.0,1993.0,8.4,18,11,9,8,1,3,11,27.3,8,8,5,3,16,34,55,1,"DF,MF",25-29,Defender,France,Europe
74,Ibrahim Amadou,FRA,Leganés,La Liga,2019,26.0,1993.0,8.6,16,9,5,9,2,4,11,36.4,7,5,0,5,12,28,6,0,MF,25-29,Midfielder,France,Europe
75,Romain Amalfitano,FRA,Dijon,Ligue 1,2019,29.0,1989.0,18.8,43,27,18,21,4,21,61,34.4,40,23,9,14,36,79,14,2,MF,25-29,Midfielder,France,Europe
76,Amath,SEN,Getafe,La Liga,2019,23.0,1996.0,0.7,2,1,1,1,0,0,5,0.0,5,2,0,2,0,2,0,0,MF,20-24,Midfielder,Senegal,Africa
77,Jordan Amavi,FRA,Marseille,Ligue 1,2019,25.0,1994.0,24.0,55,29,31,19,5,31,64,48.4,33,27,6,21,56,111,97,0,DF,25-29,Defender,France,Europe
79,Kelvin Amian,FRA,Toulouse,Ligue 1,2019,21.0,1998.0,18.1,27,21,21,5,1,14,25,56.0,11,14,7,7,18,45,56,0,DF,20-24,Defender,France,Europe
80,Nadiem Amiri,GER,Leverkusen,Bundesliga,2019,22.0,1996.0,20.6,26,16,7,15,4,16,34,47.1,18,12,2,10,14,40,8,1,"MF,FW",20-24,Midfielder,Germany,Europe
81,Ethan Ampadu,WAL,RB Leipzig,Bundesliga,2019,18.0,2000.0,0.9,5,4,3,2,0,1,1,100.0,0,3,1,2,1,6,3,0,DF,Under 20,Defender,Wales,Europe
82,Opoku Ampomah,GHA,Düsseldorf,Bundesliga,2019,23.0,1996.0,5.6,9,4,3,4,2,3,12,25.0,9,3,0,3,4,13,5,0,"FW,MF",20-24,Forward,Ghana,Africa
83,Sofyan Amrabat,MAR,Hellas Verona,Serie A,2019,22.0,1996.0,32.4,58,36,26,21,11,26,55,47.3,29,29,10,19,31,89,15,1,MF,20-24,Midfielder,Morocco,Africa
84,Joachim Andersen,DEN,Lyon,Ligue 1,2019,23.0,1996.0,17.0,17,9,15,2,0,7,19,36.8,12,16,12,4,10,27,74,2,DF,20-24,Defender,Denmark,Europe
85,Djavan Anderson,NED,Lazio,Serie A,2019,24.0,1995.0,1.9,0,0,0,0,0,0,0,,0,1,0,1,3,3,3,0,"FW,DF",20-24,Forward,Netherlands,Europe
86,Felipe Anderson,BRA,West Ham,Premier League,2019,26.0,1993.0,16.6,46,32,20,21,5,11,47,23.4,36,19,1,18,22,68,11,0,"MF,FW",25-29,Midfielder,Brazil,South America
87,Sebastian Andersson,SWE,Union Berlin,Bundesliga,2019,28.0,1991.0,29.8,20,10,0,12,8,4,19,21.1,15,19,3,16,5,25,36,0,FW,25-29,Forward,Sweden,Europe
88,Florin Andone,ROU,Brighton,Premier League,2019,26.0,1993.0,0.8,1,1,0,1,0,1,1,100.0,0,1,1,0,0,1,1,0,FW,25-29,Forward,Romania,Europe
89,Benjamin André,FRA,Lille,Ligue 1,2019,28.0,1990.0,22.8,72,44,31,35,6,29,74,39.2,45,32,9,23,59,131,40,1,MF,25-29,Midfielder,France,Europe
90,Lorenzo Andrenacci,ITA,Brescia,Serie A,2019,24.0,1995.0,5.9,1,0,1,0,0,1,3,33.3,2,0,0,0,0,1,0,0,GK,20-24,Goalkeeper,Italy,Europe
91,Robert Andrich,GER,Union Berlin,Bundesliga,2019,24.0,1994.0,28.6,52,27,28,18,6,19,60,31.7,41,27,7,20,47,99,36,0,MF,20-24,Midfielder,Germany,Europe
92,Victorien Angban,CIV,Metz,Ligue 1,2019,22.0,1996.0,11.4,23,18,11,11,1,11,24,45.8,13,9,2,7,8,31,5,0,MF,20-24,Midfielder,Ivory Coast,Africa
98,Faustino Anjorin,ENG,Chelsea,Premier League,2019,17.0,2001.0,0.2,0,0,0,0,0,0,0,,0,1,0,1,0,0,0,0,FW,Under 20,Forward,England,Europe
99,Peter Ankersen,DEN,Genoa,Serie A,2019,28.0,1990.0,11.8,16,4,7,7,2,4,13,30.8,9,19,5,14,9,25,25,1,DF,25-29,Defender,Denmark,Europe
100,Cristian Ansaldi,ARG,Torino,Serie A,2019,32.0,1986.0,19.6,37,25,24,7,6,19,34,55.9,15,23,3,20,14,51,20,4,"DF,MF",30-34,Defender,Argentina,South America
101,Janis Antiste,FRA,Toulouse,Ligue 1,2019,16.0,2002.0,0.1,0,0,0,0,0,0,0,,0,0,0,0,0,0,0,0,MF,Under 20,Midfielder,France,Europe
102,Michail Antonio,JAM,West Ham,Premier League,2019,29.0,1990.0,19.6,13,9,5,4,4,4,14,28.6,10,17,2,15,9,22,5,0,FW,25-29,Forward,Jamaica,North America
104,Mirko Antonucci,ITA,Roma,Serie A,2019,20.0,1999.0,0.9,4,3,1,0,3,3,3,100.0,0,2,0,2,2,6,1,0,"FW,MF",20-24,Forward,Italy,Europe
105,Vitorino Antunes,POR,Getafe,La Liga,2019,32.0,1987.0,0.1,0,0,0,0,0,0,0,,0,0,0,0,0,0,1,0,MF,30-34,Midfielder,Portugal,Europe
106,Christopher Antwi-Adjei,GHA,Paderborn 07,Bundesliga,2019,25.0,1994.0,27.4,25,16,13,9,3,9,33,27.3,24,29,2,27,15,40,14,0,"MF,FW",25-29,Midfielder,Ghana,Africa
107,Anuar,MAR,Valladolid,La Liga,2019,24.0,1995.0,2.1,4,2,1,2,1,2,6,33.3,4,7,3,4,5,9,0,0,"MF,FW",20-24,Midfielder,Morocco,Africa
108,Houssem Aouar,ALG,Lyon,Ligue 1,2019,21.0,1998.0,21.7,28,12,6,18,4,10,35,28.6,25,15,1,14,13,41,11,0,"MF,FW",20-24,Midfielder,Algeria,Africa
109,Adil Aouchiche,FRA,Paris S-G,Ligue 1,2019,17.0,2002.0,0.7,3,2,1,2,0,2,4,50.0,2,3,0,3,0,3,0,0,MF,Under 20,Midfielder,France,Europe
110,Dennis Appiah,FRA,Nantes,Ligue 1,2019,27.0,1992.0,17.8,58,35,32,20,6,28,52,53.8,24,9,3,6,23,81,34,0,DF,25-29,Defender,France,Europe
111,Mauro Arambarri,URU,Getafe,La Liga,2019,23.0,1995.0,34.1,72,33,24,40,8,31,69,44.9,38,52,5,47,43,115,40,2,MF,20-24,Midfielder,Uruguay,South America
112,Guilherme Arana,BRA,Atalanta,Serie A,2019,22.0,1997.0,0.9,4,4,1,3,0,3,5,60.0,2,0,0,0,2,6,0,0,DF,20-24,Defender,Brazil,South America
113,Charles Aránguiz,CHI,Leverkusen,Bundesliga,2019,30.0,1989.0,23.5,56,37,19,29,8,27,74,36.5,47,27,6,21,22,78,21,1,MF,30-34,Midfielder,Chile,South America
114,Luiz Araújo,BRA,Lille,Ligue 1,2019,23.0,1996.0,9.2,20,11,3,8,9,5,31,16.1,26,14,0,14,4,24,6,0,"FW,MF",20-24,Forward,Brazil,South America
115,Néstor Araujo,MEX,Celta Vigo,La Liga,2019,27.0,1991.0,32.1,44,27,35,8,1,22,36,61.1,14,26,18,8,52,96,142,0,DF,25-29,Defender,Mexico,North America
116,Ronald Araújo,URU,Barcelona,La Liga,2019,20.0,1999.0,2.6,3,2,2,1,0,1,1,100.0,0,6,2,4,0,3,9,0,DF,20-24,Defender,Uruguay,South America
118,Alphonse Areola,FRA,Real Madrid,La Liga,2019,26.0,1993.0,4.0,0,0,0,0,0,0,0,,0,0,0,0,0,0,0,0,GK,25-29,Goalkeeper,France,Europe
119,Alphonse Areola,FRA,Paris S-G,Ligue 1,2019,26.0,1993.0,3.0,0,0,0,0,0,0,0,,0,0,0,0,0,0,1,1,GK,25-29,Goalkeeper,France,Europe
120,Santiago Arias,COL,Atlético Madrid,La Liga,2019,27.0,1992.0,12.0,36,24,20,12,4,10,18,55.6,8,12,7,5,19,55,20,1,DF,25-29,Defender,Colombia,South America
121,Nicolò Armini,ITA,Lazio,Serie A,2019,18.0,2001.0,0.0,1,1,1,0,0,1,1,100.0,0,0,0,0,0,1,1,0,DF,Under 20,Defender,Italy,Europe
122,Stuart Armstrong,SCO,Southampton,Premier League,2019,27.0,1992.0,19.1,32,19,19,11,2,9,38,23.7,29,22,4,18,11,43,23,1,MF,25-29,Midfielder,Scotland,Europe
125,Maximilian Arnold,GER,Wolfsburg,Bundesliga,2019,25.0,1994.0,31.3,42,24,15,23,4,16,62,25.8,46,25,6,19,25,67,35,0,MF,25-29,Midfielder,Germany,Europe
127,Kwadwo Asamoah,GHA,Inter,Serie A,2019,30.0,1988.0,7.1,10,8,4,5,1,6,14,42.9,8,8,1,7,9,19,13,0,"DF,FW",30-34,Defender,Ghana,Africa
128,Santiago Ascacíbar,ARG,Hertha BSC,Bundesliga,2019,22.0,1997.0,7.0,26,13,15,11,0,11,28,39.3,17,13,2,11,16,42,13,0,MF,20-24,Midfielder,Argentina,South America
133,Roger Assalé,CIV,Leganés,La Liga,2019,25.0,1993.0,5.9,3,2,1,0,2,1,9,11.1,8,8,0,8,0,3,1,0,"FW,MF",25-29,Forward,Ivory Coast,Africa
134,Youcef Atal,ALG,Nice,Ligue 1,2019,23.0,1996.0,11.1,24,11,15,6,3,13,31,41.9,18,12,1,11,24,48,11,1,"FW,DF",20-24,Forward,Algeria,Africa
136,Christian Atsu,GHA,Newcastle Utd,Premier League,2019,27.0,1992.0,8.3,10,8,5,5,0,5,14,35.7,9,19,0,19,5,15,9,0,"MF,FW",25-29,Midfielder,Ghana,Africa
137,Pierre-Emerick Aubameyang,GAB,Arsenal,Premier League,2019,30.0,1989.0,34.8,31,19,10,12,9,12,51,23.5,39,39,1,38,14,45,16,0,FW,30-34,Forward,Gabon,Africa
138,Emil Audero,ITA,Sampdoria,Serie A,2019,22.0,1997.0,36.0,1,1,1,0,0,1,3,33.3,2,0,0,0,0,1,21,1,GK,20-24,Goalkeeper,Italy,Europe
139,Tommaso Augello,ITA,Sampdoria,Serie A,2019,24.0,1994.0,12.6,14,9,6,3,5,5,7,71.4,2,8,0,8,15,29,21,1,DF,20-24,Defender,Italy,Europe
140,Jean-Kévin Augustin,FRA,Monaco,Ligue 1,2019,22.0,1997.0,3.0,3,0,1,2,0,1,6,16.7,5,2,0,2,3,6,0,0,FW,20-24,Forward,France,Europe
141,Ludwig Augustinsson,SWE,Werder Bremen,Bundesliga,2019,25.0,1994.0,10.3,29,12,15,9,5,12,23,52.2,11,19,5,14,10,39,29,0,"DF,MF",25-29,Defender,Sweden,Europe
142,Serge Aurier,CIV,Tottenham,Premier League,2019,26.0,1992.0,30.0,93,69,58,27,8,39,69,56.5,30,38,6,32,47,140,98,2,DF,25-29,Defender,Ivory Coast,Africa
143,Mathias Autret,FRA,Brest,Ligue 1,2019,28.0,1991.0,13.6,23,17,5,11,7,8,25,32.0,17,14,1,13,10,33,3,0,"MF,FW",25-29,Midfielder,France,Europe
144,Ezequiel Ávila,ARG,Osasuna,La Liga,2019,25.0,1994.0,17.7,17,12,6,7,4,6,18,33.3,12,12,0,12,3,20,5,0,FW,25-29,Forward,Argentina,South America
146,Chidozie Awaziem,NGA,Leganés,La Liga,2019,22.0,1997.0,22.2,34,22,29,5,0,16,27,59.3,11,26,15,11,28,62,73,1,DF,20-24,Defender,Nigeria,Africa
147,Taiwo Awoniyi,NGA,Mainz 05,Bundesliga,2019,21.0,1997.0,5.4,2,0,0,2,0,0,4,0.0,4,4,2,2,2,4,3,0,"FW,MF",20-24,Forward,Nigeria,Africa
148,Florian Ayé,FRA,Brescia,Serie A,2019,22.0,1997.0,15.3,17,9,9,5,3,6,13,46.2,7,17,2,15,4,21,18,1,"FW,MF",20-24,Forward,France,Europe
149,Jordan Ayew,GHA,Crystal Palace,Premier League,2019,27.0,1991.0,35.0,48,30,10,22,16,17,49,34.7,32,29,4,25,15,63,21,0,FW,25-29,Forward,Ghana,Africa
150,Kaan Ayhan,TUR,Düsseldorf,Bundesliga,2019,24.0,1994.0,30.3,38,25,26,11,1,20,37,54.1,17,28,15,13,45,83,72,1,DF,20-24,Defender,Turkey,Asia
151,Ramon Azeez,NGA,Granada,La Liga,2019,26.0,1992.0,15.1,11,8,2,8,1,7,19,36.8,12,8,2,6,19,30,11,1,MF,25-29,Midfielder,Nigeria,Africa
154,Iddrisu Baba,GHA,Mallorca,La Liga,2019,23.0,1996.0,32.3,59,37,26,29,4,20,70,28.6,50,31,8,23,39,98,42,0,MF,20-24,Midfielder,Ghana,Africa
155,Khouma Babacar,SEN,Lecce,Serie A,2019,26.0,1993.0,15.8,12,8,2,6,4,1,7,14.3,6,12,3,9,3,15,34,0,FW,25-29,Forward,Senegal,Africa
156,Carlos Bacca,COL,Villarreal,La Liga,2019,32.0,1986.0,7.6,5,1,1,2,2,2,6,33.3,4,4,0,4,0,5,7,0,FW,30-34,Forward,Colombia,South America
157,Milan Badelj,CRO,Fiorentina,Serie A,2019,30.0,1989.0,17.6,29,17,10,16,3,15,50,30.0,35,21,3,18,45,74,34,1,MF,30-34,Midfielder,Croatia,Europe
158,Matthias Bader,GER,Köln,Bundesliga,2019,22.0,1997.0,0.1,1,1,1,0,0,1,2,50.0,1,0,0,0,0,1,1,0,DF,20-24,Defender,Germany,Europe
159,Benoît Badiashile,FRA,Monaco,Ligue 1,2019,18.0,2001.0,15.7,18,12,12,5,1,6,12,50.0,6,20,11,9,27,45,57,1,DF,Under 20,Defender,France,Europe
160,Bastian Badu,FRA,Montpellier,Ligue 1,2019,19.0,2000.0,0.1,0,0,0,0,0,0,0,,0,0,0,0,0,0,0,0,FW,Under 20,Forward,France,Europe
162,Stéphane Bahoken,CMR,Angers,Ligue 1,2019,27.0,1992.0,10.1,7,4,1,2,4,1,7,14.3,6,4,1,3,2,9,2,0,FW,25-29,Forward,Cameroon,Africa
163,Daniel Baier,GER,Augsburg,Bundesliga,2019,35.0,1984.0,21.6,33,17,14,14,5,15,43,34.9,28,19,7,12,58,91,27,0,MF,35-39,Midfielder,Germany,Europe
164,Leon Bailey,JAM,Leverkusen,Bundesliga,2019,21.0,1997.0,12.1,6,3,1,5,0,6,16,37.5,10,9,0,9,8,14,3,0,"FW,MF",20-24,Forward,Jamaica,North America
165,Eric Bailly,CIV,Manchester Utd,Premier League,2019,25.0,1994.0,1.7,0,0,0,0,0,0,1,0.0,1,3,3,0,4,4,7,1,DF,25-29,Defender,Ivory Coast,Africa
166,Dénys Bain,FRA,Brest,Ligue 1,2019,26.0,1993.0,14.1,21,14,15,6,0,9,9,100.0,0,13,10,3,28,49,66,0,DF,25-29,Defender,France,Europe
167,Leighton Baines,ENG,Everton,Premier League,2019,34.0,1984.0,4.5,10,6,6,2,2,8,10,80.0,2,5,2,3,5,15,14,0,DF,30-34,Defender,England,Europe
168,Stefan Bajic,FRA,Saint-Étienne,Ligue 1,2019,17.0,2001.0,1.0,0,0,0,0,0,0,0,,0,1,0,1,0,0,2,0,GK,Under 20,Goalkeeper,France,Europe
169,Tiemoué Bakayoko,FRA,Monaco,Ligue 1,2019,24.0,1994.0,19.1,48,24,16,27,5,29,54,53.7,25,12,4,8,29,77,17,0,MF,20-24,Midfielder,France,Europe
170,Lewis Baker,ENG,Düsseldorf,Bundesliga,2019,24.0,1995.0,6.1,8,5,6,2,0,2,10,20.0,8,5,2,3,2,10,5,0,MF,20-24,Midfielder,England,Europe
171,Mitchel Bakker,NED,Paris S-G,Ligue 1,2019,19.0,2000.0,1.0,2,2,1,1,0,1,1,100.0,0,0,0,0,0,2,2,0,DF,Under 20,Defender,Netherlands,Europe
172,Ridle Baku,GER,Mainz 05,Bundesliga,2019,21.0,1998.0,26.1,54,31,25,22,7,26,53,49.1,27,45,7,38,42,96,57,0,"DF,MF",20-24,Defender,Germany,Europe
173,Fabián Balbuena,PAR,West Ham,Premier League,2019,27.0,1991.0,13.1,17,12,13,3,1,9,25,36.0,16,15,5,10,26,43,75,3,DF,25-29,Defender,Paraguay,South America
174,Keita Baldé,SEN,Monaco,Ligue 1,2019,24.0,1995.0,9.5,6,5,1,1,4,3,9,33.3,6,4,1,3,2,8,7,1,"FW,MF",20-24,Forward,Senegal,Africa
175,George Baldock,GRE,Sheffield Utd,Premier League,2019,26.0,1993.0,38.0,62,43,35,17,10,27,47,57.4,20,26,3,23,34,96,83,3,DF,25-29,Defender,Greece,Europe
176,Gareth Bale,WAL,Real Madrid,La Liga,2019,30.0,1989.0,12.1,9,5,5,2,2,3,14,21.4,11,8,2,6,6,15,9,0,"FW,MF",30-34,Forward,Wales,Europe
178,Leonardo Balerdi,ARG,Dortmund,Bundesliga,2019,20.0,1999.0,1.5,2,1,1,1,0,2,2,100.0,0,0,0,0,4,6,3,0,"DF,MF",20-24,Defender,Argentina,South America
179,Marco Ballarini,ITA,Udinese,Serie A,2019,18.0,2001.0,0.0,0,0,0,0,0,0,0,,0,0,0,0,0,0,0,0,MF,Under 20,Midfielder,Italy,Europe
180,Fodé Ballo-Touré,SEN,Monaco,Ligue 1,2019,22.0,1997.0,18.7,36,25,21,11,4,17,32,53.1,15,10,1,9,24,60,45,0,DF,20-24,Defender,Senegal,Africa
181,Florent Balmont,FRA,Dijon,Ligue 1,2019,39.0,1980.0,4.5,12,6,5,7,0,7,12,58.3,5,6,0,6,1,13,3,0,MF,35-39,Midfielder,France,Europe
182,Mario Balotelli,ITA,Brescia,Serie A,2019,28.0,1990.0,15.6,2,2,0,2,0,0,2,0.0,2,1,1,0,8,10,22,0,FW,25-29,Forward,Italy,Europe
183,Abdoulaye Bamba,CIV,Angers,Ligue 1,2019,29.0,1990.0,6.2,10,7,7,1,2,8,15,53.3,7,4,1,3,4,14,18,0,DF,25-29,Defender,Ivory Coast,Africa
184,Jonathan Bamba,CIV,Lille,Ligue 1,2019,23.0,1996.0,21.5,12,6,5,5,2,7,29,24.1,22,19,3,16,16,28,8,2,"FW,MF",20-24,Forward,Ivory Coast,Africa
185,Éver Banega,ARG,Sevilla,La Liga,2019,31.0,1988.0,27.5,43,28,16,18,9,21,70,30.0,49,19,1,18,15,58,5,0,MF,30-34,Midfielder,Argentina,South America
186,Mattia Bani,ITA,Bologna,Serie A,2019,25.0,1993.0,24.5,47,28,27,19,1,25,36,69.4,11,29,15,14,52,99,92,2,DF,25-29,Defender,Italy,Europe
189,Federico Barba,ITA,Valladolid,La Liga,2019,25.0,1993.0,5.0,12,6,10,2,0,7,9,77.8,2,5,2,3,8,20,12,0,DF,25-29,Defender,Italy,Europe
190,Danilo Barbosa,BRA,Nice,Ligue 1,2019,23.0,1996.0,12.5,28,21,17,9,2,13,29,44.8,16,21,6,15,20,48,38,0,"DF,MF",20-24,Defender,Brazil,South America
191,Melvin Bard,FRA,Lyon,Ligue 1,2019,18.0,2000.0,0.5,0,0,0,0,0,0,0,,0,0,0,0,1,1,0,0,DF,Under 20,Defender,France,Europe
192,Enis Bardhi,MKD,Levante,La Liga,2019,24.0,1995.0,23.5,24,11,7,15,2,8,35,22.9,27,15,4,11,15,39,19,0,MF,20-24,Midfielder,North Macedonia,Europe
193,Phil Bardsley,SCO,Burnley,Premier League,2019,34.0,1985.0,21.0,49,36,16,24,9,24,37,64.9,13,24,11,13,30,79,73,0,DF,30-34,Defender,Scotland,Europe
194,Nicolò Barella,ITA,Inter,Serie A,2019,22.0,1997.0,22.4,36,21,14,15,7,8,37,21.6,29,20,5,15,14,50,14,0,MF,20-24,Midfielder,Italy,Europe
195,Philipp Bargfrede,GER,Werder Bremen,Bundesliga,2019,30.0,1989.0,6.5,15,12,8,5,2,6,23,26.1,17,8,2,6,16,31,15,0,MF,30-34,Midfielder,Germany,Europe
196,Antonino Barillà,ITA,Parma,Serie A,2019,31.0,1988.0,18.8,43,31,22,19,2,16,45,35.6,29,26,8,18,17,60,32,0,MF,30-34,Midfielder,Italy,Europe
198,Ross Barkley,ENG,Chelsea,Premier League,2019,25.0,1993.0,12.3,16,9,6,6,4,5,18,27.8,13,7,2,5,7,23,7,0,MF,25-29,Midfielder,England,Europe
199,Aymen Barkok,MAR,Düsseldorf,Bundesliga,2019,21.0,1998.0,0.9,1,1,0,0,1,0,2,0.0,2,2,0,2,3,4,1,0,"FW,MF",20-24,Forward,Morocco,Africa
200,Ashley Barnes,ENG,Burnley,Premier League,2019,29.0,1989.0,15.0,10,5,3,5,2,3,9,33.3,6,7,2,5,6,16,9,0,FW,25-29,Forward,England,Europe
201,Harvey Barnes,ENG,Leicester City,Premier League,2019,21.0,1997.0,23.1,16,11,7,7,2,5,23,21.7,18,13,3,10,8,24,6,1,"MF,FW",20-24,Midfielder,England,Europe
203,Antonio Barreca,ITA,Genoa,Serie A,2019,24.0,1995.0,12.2,10,7,5,3,2,4,5,80.0,1,12,7,5,1,11,22,0,"DF,FW",20-24,Defender,Italy,Europe
204,Leandro Barreiro Martins,LUX,Mainz 05,Bundesliga,2019,19.0,2000.0,10.4,38,21,16,19,3,14,29,48.3,15,18,3,15,9,47,18,1,MF,Under 20,Midfielder,Luxembourg,Europe
206,Édgar Barreto,PAR,Sampdoria,Serie A,2019,35.0,1984.0,1.0,4,3,0,1,3,2,3,66.7,1,1,0,1,0,4,0,0,MF,35-39,Midfielder,Paraguay,South America
207,Musa Barrow,GAM,Bologna,Serie A,2019,20.0,1998.0,15.0,20,13,11,7,2,6,20,30.0,14,15,0,15,5,25,11,0,"FW,MF",20-24,Forward,Gambia,Africa
208,Musa Barrow,GAM,Atalanta,Serie A,2019,20.0,1998.0,2.1,1,1,0,0,1,1,4,25.0,3,4,0,4,0,1,1,0,"FW,MF",20-24,Forward,Gambia,Africa
209,Fin Bartels,GER,Werder Bremen,Bundesliga,2019,32.0,1987.0,3.8,9,5,4,4,1,3,12,25.0,9,3,1,2,1,10,1,0,"MF,FW",30-34,Midfielder,Germany,Europe
211,Daniele Baselli,ITA,Torino,Serie A,2019,27.0,1992.0,14.2,43,23,17,19,7,13,40,32.5,27,20,4,16,25,68,25,0,MF,25-29,Midfielder,Italy,Europe
212,Chris Basham,ENG,Sheffield Utd,Premier League,2019,31.0,1988.0,36.0,85,48,58,20,7,48,81,59.3,33,38,15,23,77,162,173,1,DF,30-34,Defender,England,Europe
213,Toma Bašić,CRO,Bordeaux,Ligue 1,2019,22.0,1996.0,11.0,26,22,9,16,1,12,27,44.4,15,14,2,12,9,35,12,1,MF,20-24,Midfielder,Croatia,Europe
214,Thomas Basila,FRA,Nantes,Ligue 1,2019,20.0,1999.0,4.6,6,3,2,4,0,4,4,100.0,0,0,0,0,4,10,14,0,DF,20-24,Defender,France,Europe
215,Gil Bastião Dias,POR,Granada,La Liga,2019,22.0,1996.0,4.0,19,14,10,6,3,7,17,41.2,10,4,1,3,3,22,7,0,"MF,DF",20-24,Midfielder,Portugal,Europe
216,Gil Bastião Dias,POR,Monaco,Ligue 1,2019,22.0,1996.0,11.7,53,33,30,21,2,29,58,50.0,29,15,1,14,13,66,22,1,"DF,MF",20-24,Defender,Portugal,Europe
218,Alessandro Bastoni,ITA,Inter,Serie A,2019,20.0,1999.0,21.3,32,17,14,11,7,15,24,62.5,9,18,9,9,26,58,54,0,DF,20-24,Defender,Italy,Europe
219,Bastos,ANG,Lazio,Serie A,2019,28.0,1991.0,8.5,9,5,6,3,0,4,11,36.4,7,13,8,5,13,22,26,0,DF,25-29,Defender,Angola,Africa
220,Oliver Batista-Meier,GER,Bayern Munich,Bundesliga,2019,18.0,2001.0,0.1,0,0,0,0,0,0,2,0.0,2,0,0,0,0,0,0,0,MF,Under 20,Midfielder,Germany,Europe
221,Michy Batshuayi,BEL,Chelsea,Premier League,2019,25.0,1993.0,2.7,4,1,2,2,0,0,5,0.0,5,1,1,0,0,4,1,0,FW,25-29,Forward,Belgium,Europe
222,Cristian Battocchio,ITA,Brest,Ligue 1,2019,27.0,1992.0,15.5,31,24,13,13,5,14,36,38.9,22,13,4,9,19,50,21,0,MF,25-29,Midfielder,Italy,Europe
223,Oliver Baumann,GER,Hoffenheim,Bundesliga,2019,29.0,1990.0,30.0,0,0,0,0,0,0,0,,0,1,0,1,3,3,15,0,GK,25-29,Goalkeeper,Germany,Europe
224,Julian Baumgartlinger,AUT,Leverkusen,Bundesliga,2019,31.0,1988.0,19.9,42,21,15,21,6,18,42,42.9,24,37,4,33,20,62,16,1,MF,30-34,Midfielder,Austria,Europe
225,Christoph Baumgartner,AUT,Hoffenheim,Bundesliga,2019,19.0,1999.0,16.6,32,17,15,16,1,10,37,27.0,27,25,1,24,8,40,13,0,"MF,FW",Under 20,Midfielder,Austria,Europe
226,Noah Joel Sarenren Bazee,NGA,Augsburg,Bundesliga,2019,22.0,1996.0,4.2,4,3,0,4,0,1,4,25.0,3,2,1,1,5,9,4,0,FW,20-24,Forward,Nigeria,Africa
228,Rodrigo Becão,BRA,Udinese,Serie A,2019,23.0,1996.0,24.6,56,25,34,19,3,26,46,56.5,20,40,20,20,45,101,77,0,DF,20-24,Defender,Brazil,South America
229,Sheraldo Becker,SUR,Union Berlin,Bundesliga,2019,24.0,1995.0,6.0,2,1,2,0,0,1,3,33.3,2,1,0,1,0,2,1,0,"MF,FW",20-24,Midfielder,Suriname,South America
230,Timo Becker,GER,Schalke 04,Bundesliga,2019,22.0,1997.0,3.7,10,9,3,6,1,5,9,55.6,4,6,1,5,3,13,8,0,"DF,MF",20-24,Defender,Germany,Europe
232,Asmir Begović,BIH,Milan,Serie A,2019,32.0,1987.0,1.4,0,0,0,0,0,0,0,,0,0,0,0,0,0,0,0,GK,30-34,Goalkeeper,Bosnia and Herzegovina,Europe
233,Valon Behrami,SUI,Genoa,Serie A,2019,34.0,1985.0,12.3,34,26,13,17,4,8,32,25.0,24,25,10,15,9,43,16,0,MF,30-34,Midfielder,Switzerland,Europe
234,Maximilian Beier,GER,Hoffenheim,Bundesliga,2019,16.0,2002.0,1.2,5,2,0,1,4,1,2,50.0,1,2,0,2,0,5,0,0,FW,Under 20,Forward,Germany,Europe
235,Gaëtan Belaud,FRA,Brest,Ligue 1,2019,32.0,1986.0,6.4,13,7,10,2,1,4,8,50.0,4,8,3,5,15,28,15,0,DF,30-34,Defender,France,Europe
236,Ishak Belfodil,ALG,Hoffenheim,Bundesliga,2019,27.0,1992.0,3.0,0,0,0,0,0,0,1,0.0,1,0,0,0,0,0,2,0,"FW,MF",25-29,Forward,Algeria,Africa
237,Haris Belkebla,ALG,Brest,Ligue 1,2019,25.0,1994.0,20.2,44,24,17,17,10,10,28,35.7,18,25,5,20,53,97,21,2,MF,25-29,Midfielder,Algeria,Africa
238,Raoul Bellanova,ITA,Atalanta,Serie A,2019,19.0,2000.0,0.2,0,0,0,0,0,0,0,,0,0,0,0,0,0,0,0,DF,Under 20,Defender,Italy,Europe
239,Raoul Bellanova,ITA,Bordeaux,Ligue 1,2019,19.0,2000.0,0.7,1,1,1,0,0,0,1,0.0,1,0,0,0,0,1,0,0,DF,Under 20,Defender,Italy,Europe
240,Karim Bellarabi,GER,Leverkusen,Bundesliga,2019,29.0,1990.0,15.8,19,11,9,7,3,9,28,32.1,19,16,0,16,10,29,4,0,"FW,DF",25-29,Forward,Germany,Europe
241,Jean-Ricner Bellegarde,FRA,Strasbourg,Ligue 1,2019,21.0,1998.0,16.6,40,27,18,19,3,13,21,61.9,8,16,3,13,22,62,6,0,MF,20-24,Midfielder,France,Europe
243,Andrea Belotti,ITA,Torino,Serie A,2019,25.0,1993.0,33.4,29,16,7,17,5,5,31,16.1,26,23,5,18,5,34,20,1,FW,25-29,Forward,Italy,Europe
245,Sami Ben Amar,MAR,Nîmes,Ligue 1,2019,21.0,1998.0,0.2,1,1,0,0,1,1,1,100.0,0,1,0,1,1,2,0,0,FW,20-24,Forward,Morocco,Africa
246,Hatem Ben Arfa,FRA,Valladolid,La Liga,2019,32.0,1987.0,1.8,0,0,0,0,0,0,4,0.0,4,1,0,1,0,0,0,0,"MF,FW",30-34,Midfielder,France,Europe
247,Wissam Ben Yedder,FRA,Monaco,Ligue 1,2019,28.0,1990.0,24.0,22,16,2,12,8,8,19,42.1,11,12,0,12,4,26,1,0,FW,25-29,Forward,France,Europe
248,Marco Benassi,ITA,Fiorentina,Serie A,2019,24.0,1994.0,10.9,18,12,9,5,4,10,24,41.7,14,11,1,10,4,22,9,0,MF,20-24,Midfielder,Italy,Europe
249,Cristian Benavente,PER,Nantes,Ligue 1,2019,25.0,1994.0,3.9,8,5,2,5,1,2,8,25.0,6,1,0,1,3,11,0,0,"MF,FW",25-29,Midfielder,Peru,South America
250,Lars Bender,GER,Leverkusen,Bundesliga,2019,30.0,1989.0,15.3,42,26,17,20,5,19,38,50.0,19,32,6,26,24,66,30,0,"DF,MF",30-34,Defender,Germany,Europe
251,Sven Bender,GER,Leverkusen,Bundesliga,2019,30.0,1989.0,30.3,53,34,29,17,7,23,48,47.9,25,42,13,29,67,120,88,2,DF,30-34,Defender,Germany,Europe
252,Darío Benedetto,ARG,Marseille,Ligue 1,2019,29.0,1990.0,23.3,12,9,0,9,3,3,18,16.7,15,15,2,13,3,15,23,1,FW,25-29,Forward,Argentina,South America
253,László Bénes,SVK,Gladbach,Bundesliga,2019,21.0,1997.0,10.0,15,8,3,5,7,6,19,31.6,13,6,2,4,8,23,3,1,MF,20-24,Midfielder,Slovakia,Europe
254,Walter Benítez,ARG,Nice,Ligue 1,2019,26.0,1993.0,26.0,1,1,1,0,0,1,3,33.3,2,0,0,0,0,1,8,0,GK,25-29,Goalkeeper,Argentina,South America
255,Loris Benito,SUI,Bordeaux,Ligue 1,2019,27.0,1992.0,21.1,40,25,23,11,6,16,43,37.2,27,14,5,9,29,69,58,1,DF,25-29,Defender,Switzerland,Europe
256,Bilal Benkhedim,FRA,Saint-Étienne,Ligue 1,2019,18.0,2001.0,1.5,3,3,1,1,1,1,4,25.0,3,1,0,1,1,4,0,0,"MF,FW",Under 20,Midfielder,France,Europe
257,Ismaël Bennacer,ALG,Milan,Serie A,2019,21.0,1997.0,27.6,67,47,21,34,12,29,73,39.7,44,25,7,18,54,121,15,2,MF,20-24,Midfielder,Algeria,Africa
258,Ryan Bennett,ENG,Wolves,Premier League,2019,29.0,1990.0,6.7,4,2,4,0,0,2,6,33.3,4,14,8,6,9,13,29,0,DF,25-29,Defender,England,Europe
259,Ryan Bennett,ENG,Leicester City,Premier League,2019,29.0,1990.0,3.7,5,4,3,2,0,4,6,66.7,2,3,1,2,7,12,8,0,DF,25-29,Defender,England,Europe
260,Keanan Bennetts,ENG,Gladbach,Bundesliga,2019,20.0,1999.0,0.0,0,0,0,0,0,0,1,0.0,1,0,0,0,0,0,0,0,MF,20-24,Midfielder,England,Europe
261,Yassine Benrahou,FRA,Bordeaux,Ligue 1,2019,20.0,1999.0,1.9,3,0,1,1,1,2,5,40.0,3,1,0,1,2,5,1,0,"FW,MF",20-24,Forward,France,Europe
262,Yassine Benrahou,FRA,Nîmes,Ligue 1,2019,20.0,1999.0,8.5,13,8,3,3,7,5,16,31.3,11,1,0,1,2,15,0,0,"MF,FW",20-24,Midfielder,France,Europe
263,Ramy Bensebaini,ALG,Gladbach,Bundesliga,2019,24.0,1995.0,16.1,33,17,17,12,4,18,31,58.1,13,24,4,20,38,71,49,0,DF,20-24,Defender,Algeria,Africa
264,Nabil Bentaleb,ALG,Newcastle Utd,Premier League,2019,24.0,1994.0,8.3,23,13,14,9,0,7,25,28.0,18,9,2,7,19,42,9,1,MF,20-24,Midfielder,Algeria,Africa
265,Rodrigo Bentancur,URU,Juventus,Serie A,2019,22.0,1997.0,24.4,58,32,27,18,13,31,66,47.0,35,44,9,35,32,90,34,1,MF,20-24,Midfielder,Uruguay,South America
266,Christian Benteke,BEL,Crystal Palace,Premier League,2019,28.0,1990.0,14.0,9,5,1,6,2,0,10,0.0,10,11,4,7,4,13,28,1,FW,25-29,Forward,Belgium,Europe
267,Romario Benzar,ROU,Lecce,Serie A,2019,27.0,1992.0,1.1,2,2,1,1,0,2,3,66.7,1,1,0,1,0,2,2,0,DF,25-29,Defender,Romania,Europe
268,Karim Benzema,FRA,Real Madrid,La Liga,2019,31.0,1987.0,34.9,18,8,3,11,4,2,16,12.5,14,16,4,12,7,25,30,1,FW,30-34,Forward,France,Europe
269,Yassine Benzia,ALG,Dijon,Ligue 1,2019,24.0,1994.0,1.9,3,2,2,1,0,1,6,16.7,5,4,2,2,3,6,1,0,MF,20-24,Midfielder,Algeria,Africa
270,Domenico Berardi,ITA,Sassuolo,Serie A,2019,24.0,1994.0,27.7,32,16,19,8,5,13,59,22.0,46,31,3,28,33,65,27,0,FW,20-24,Forward,Italy,Europe
274,Jóhann Berg Guðmundsson,ISL,Burnley,Premier League,2019,28.0,1990.0,6.9,4,2,2,2,0,1,8,12.5,7,8,1,7,7,11,9,0,MF,25-29,Midfielder,Iceland,Europe
277,Steven Bergwijn,NED,Tottenham,Premier League,2019,21.0,1997.0,7.8,10,6,3,6,1,4,12,33.3,8,12,0,12,1,11,5,0,"FW,MF",20-24,Forward,Netherlands,Europe
279,Etrit Berisha,ALB,SPAL,Serie A,2019,30.0,1989.0,26.0,3,2,3,0,0,2,3,66.7,1,0,0,0,1,4,9,0,GK,30-34,Goalkeeper,Albania,Europe
283,Bernard,BRA,Everton,Premier League,2019,26.0,1992.0,14.2,32,22,12,14,6,13,44,29.5,31,22,2,20,16,48,7,0,"MF,FW",25-29,Midfielder,Brazil,South America
284,Federico Bernardeschi,ITA,Juventus,Serie A,2019,25.0,1994.0,17.5,13,5,4,5,4,5,25,20.0,20,11,0,11,13,26,12,1,"MF,FW",25-29,Midfielder,Italy,Europe
285,Bernardo,BRA,Brighton,Premier League,2019,24.0,1995.0,7.5,27,16,12,9,6,13,17,76.5,4,7,3,4,6,33,24,0,"DF,MF",20-24,Defender,Brazil,South America
285,Bernardo,BRA,Brighton,Premier League,2019,24.0,1995.0,7.5,27,16,12,9,6,13,17,76.5,4,7,3,4,6,33,24,0,"DF,MF",20-24,Defender,Brazil,South America
285,Bernardo,BRA,Brighton,Premier League,2019,24.0,1995.0,7.5,27,16,12,9,6,13,17,76.5,4,7,3,4,6,33,24,0,"DF,MF",20-24,Defender,Brazil,South America
285,Bernardo,BRA,Brighton,Premier League,2019,24.0,1995.0,7.5,27,16,12,9,6,13,17,76.5,4,7,3,4,6,33,24,0,"DF,MF",20-24,Defender,Brazil,South America
286,Paul Bernardoni,FRA,Nîmes,Ligue 1,2019,22.0,1997.0,24.5,0,0,0,0,0,0,1,0.0,1,0,0,0,0,0,11,1,GK,20-24,Goalkeeper,France,Europe
288,Dimitry Bertaud,COD,Montpellier,Ligue 1,2019,21.0,1998.0,2.2,0,0,0,0,0,0,0,,0,0,0,0,0,0,0,0,GK,20-24,Goalkeeper,DR Congo,Africa
289,Andrea Bertolacci,ITA,Sampdoria,Serie A,2019,28.0,1991.0,5.9,7,4,2,3,2,1,8,12.5,7,4,1,3,2,9,13,0,MF,25-29,Midfielder,Italy,Europe
290,Ryan Bertrand,ENG,Southampton,Premier League,2019,29.0,1989.0,30.5,47,29,22,15,10,26,58,44.8,32,27,12,15,37,84,31,1,DF,25-29,Defender,England,Europe
291,Muhamed Bešić,BIH,Sheffield Utd,Premier League,2019,26.0,1992.0,2.8,8,6,4,4,0,2,5,40.0,3,4,0,4,1,9,6,0,MF,25-29,Midfielder,Bosnia and Herzegovina,Europe
292,Jordan Beyer,GER,Gladbach,Bundesliga,2019,19.0,2000.0,1.2,3,1,3,0,0,0,1,0.0,1,4,2,2,1,4,4,0,DF,Under 20,Defender,Germany,Europe
293,Ermin Bičakčić,BIH,Hoffenheim,Bundesliga,2019,29.0,1990.0,13.1,7,3,5,2,0,4,11,36.4,7,14,8,6,25,32,64,2,DF,25-29,Defender,Bosnia and Herzegovina,Europe
295,Lucas Biglia,ARG,Milan,Serie A,2019,33.0,1986.0,7.6,13,7,7,6,0,4,15,26.7,11,12,4,8,7,20,10,1,MF,30-34,Midfielder,Argentina,South America
296,El Bilal Touré,MLI,Reims,Ligue 1,2019,17.0,2001.0,5.0,3,3,1,0,2,0,0,,0,6,0,6,1,4,1,0,FW,Under 20,Forward,Mali,Africa
297,Philip Billing,DEN,Bournemouth,Premier League,2019,23.0,1996.0,28.1,72,46,30,37,5,17,65,26.2,48,59,16,43,66,138,97,1,MF,20-24,Midfielder,Denmark,Europe
298,Cristiano Biraghi,ITA,Inter,Serie A,2019,26.0,1992.0,17.5,22,6,10,8,4,10,24,41.7,14,21,7,14,13,35,41,0,DF,25-29,Defender,Italy,Europe
299,Davide Biraschi,ITA,Genoa,Serie A,2019,25.0,1994.0,21.9,32,17,17,13,2,15,26,57.7,11,22,12,10,34,66,69,0,DF,25-29,Defender,Italy,Europe
301,Dimitri Bisoli,ITA,Brescia,Serie A,2019,25.0,1994.0,23.9,64,35,34,20,10,30,49,61.2,19,41,7,34,25,89,49,0,MF,25-29,Midfielder,Italy,Europe
302,Yves Bissouma,MLI,Brighton,Premier League,2019,22.0,1996.0,14.0,49,38,24,22,3,17,40,42.5,23,18,2,16,21,70,23,0,MF,20-24,Midfielder,Mali,Africa
303,Leonardo Bittencourt,GER,Hoffenheim,Bundesliga,2019,25.0,1993.0,0.0,1,1,0,0,1,0,0,,0,0,0,0,0,1,0,0,MF,25-29,Midfielder,Germany,Europe
304,Leonardo Bittencourt,GER,Werder Bremen,Bundesliga,2019,25.0,1993.0,21.0,52,28,23,18,11,9,51,17.6,42,20,3,17,12,64,14,0,"FW,MF",25-29,Forward,Germany,Europe
305,Birkir Bjarnason,ISL,Brescia,Serie A,2019,31.0,1988.0,8.9,5,3,1,3,1,2,13,15.4,11,9,4,5,5,10,4,0,"MF,FW",30-34,Midfielder,Iceland,Europe
307,Ludovic Blas,FRA,Nantes,Ligue 1,2019,21.0,1997.0,20.5,26,18,7,15,4,5,26,19.2,21,17,1,16,14,40,11,0,"FW,MF",20-24,Forward,France,Europe
308,Pablo de Blasis,ARG,Eibar,La Liga,2019,31.0,1988.0,17.8,41,32,22,13,6,30,63,47.6,33,13,0,13,24,65,21,0,"DF,MF",30-34,Defender,Argentina,South America
310,Alexis Blin,FRA,Amiens,Ligue 1,2019,22.0,1996.0,20.5,39,25,18,15,6,20,61,32.8,41,25,6,19,16,55,49,0,MF,20-24,Midfielder,France,Europe
311,Jérôme Boateng,GER,Bayern Munich,Bundesliga,2019,30.0,1988.0,20.0,21,14,9,12,0,11,22,50.0,11,15,11,4,33,54,58,1,DF,30-34,Defender,Germany,Europe
312,Kevin-Prince Boateng,GHA,Fiorentina,Serie A,2019,32.0,1987.0,6.7,3,1,0,2,1,2,8,25.0,6,3,0,3,1,4,7,0,FW,30-34,Forward,Ghana,Africa
313,Antonin Bobichon,FRA,Nîmes,Ligue 1,2019,23.0,1995.0,2.0,4,3,1,3,0,3,3,100.0,0,1,0,1,1,5,0,0,MF,20-24,Midfielder,France,Europe
314,Antonin Bobichon,FRA,Angers,Ligue 1,2019,23.0,1995.0,7.2,9,4,4,5,0,2,19,10.5,17,7,0,7,7,16,4,0,MF,20-24,Midfielder,France,Europe
315,Salvatore Bocchetti,ITA,Hellas Verona,Serie A,2019,32.0,1986.0,3.4,5,3,3,2,0,2,3,66.7,1,2,2,0,17,22,23,0,DF,30-34,Defender,Italy,Europe
316,Mathieu Bodmer,FRA,Amiens,Ligue 1,2019,36.0,1982.0,1.0,0,0,0,0,0,0,1,0.0,1,1,1,0,1,1,1,0,"MF,FW",35-39,Midfielder,France,Europe
317,Adam Bodzek,GER,Düsseldorf,Bundesliga,2019,33.0,1985.0,22.4,42,26,21,20,1,14,46,30.4,32,34,11,23,25,67,39,0,MF,30-34,Midfielder,Germany,Europe
318,Jean-Paul Boëtius,NED,Mainz 05,Bundesliga,2019,25.0,1994.0,25.2,63,33,21,31,11,20,57,35.1,37,38,1,37,26,89,6,0,MF,25-29,Midfielder,Netherlands,Europe
319,Sacha Boey,FRA,Rennes,Ligue 1,2019,18.0,2000.0,1.9,6,4,3,1,2,4,8,50.0,4,0,0,0,2,8,5,0,DF,Under 20,Defender,France,Europe
320,Jeremie Boga,CIV,Sassuolo,Serie A,2019,22.0,1997.0,27.9,12,7,3,8,1,6,20,30.0,14,24,0,24,3,15,4,0,FW,20-24,Forward,Ivory Coast,Africa
321,Melayro Bogarde,NED,Hoffenheim,Bundesliga,2019,17.0,2002.0,0.6,2,1,2,0,0,2,2,100.0,0,0,0,0,0,2,3,0,DF,Under 20,Defender,Netherlands,Europe
322,Quentin Boisgard,FRA,Toulouse,Ligue 1,2019,22.0,1997.0,12.7,31,19,10,14,7,14,35,40.0,21,11,0,11,12,43,4,1,"MF,FW",20-24,Midfielder,France,Europe
323,Willy Boly,CIV,Wolves,Premier League,2019,28.0,1991.0,22.0,57,33,36,21,0,25,43,58.1,18,28,11,17,39,96,108,3,DF,25-29,Defender,Ivory Coast,Africa
324,Giacomo Bonaventura,ITA,Milan,Serie A,2019,29.0,1989.0,14.9,16,9,5,6,5,5,17,29.4,12,8,3,5,7,23,10,0,"MF,FW",25-29,Midfielder,Italy,Europe
325,Federico Bonazzoli,ITA,Sampdoria,Serie A,2019,22.0,1997.0,8.3,7,5,1,4,2,0,7,0.0,7,3,0,3,5,12,2,0,FW,20-24,Forward,Italy,Europe
326,Gaëtan Bong,CMR,Brighton,Premier League,2019,31.0,1988.0,0.7,1,0,0,0,1,0,0,,0,1,1,0,0,1,0,0,"DF,MF",30-34,Defender,Cameroon,Africa
327,Kevin Bonifazi,ITA,Torino,Serie A,2019,23.0,1996.0,2.7,9,8,6,3,0,5,6,83.3,1,3,2,1,5,14,10,0,DF,20-24,Defender,Italy,Europe
328,Kevin Bonifazi,ITA,SPAL,Serie A,2019,23.0,1996.0,13.2,16,9,15,1,0,9,18,50.0,9,20,12,8,35,51,50,2,DF,20-24,Defender,Italy,Europe
329,Federico Bonini,ITA,Bologna,Serie A,2019,17.0,2001.0,0.1,0,0,0,0,0,0,0,,0,0,0,0,0,0,0,0,DF,Under 20,Defender,Italy,Europe
330,Leonardo Bonucci,ITA,Juventus,Serie A,2019,32.0,1987.0,34.2,28,17,18,8,2,12,17,70.6,5,32,29,3,31,59,94,2,DF,30-34,Defender,Italy,Europe
331,Fabio Borini,ITA,Hellas Verona,Serie A,2019,28.0,1991.0,9.0,2,1,2,0,0,0,4,0.0,4,3,0,3,13,15,6,0,"MF,FW",25-29,Midfielder,Italy,Europe
332,Fabio Borini,ITA,Milan,Serie A,2019,28.0,1991.0,0.8,2,2,0,0,2,0,2,0.0,2,1,0,1,0,2,3,0,MF,25-29,Midfielder,Italy,Europe
333,Dennis Borkowski,GER,RB Leipzig,Bundesliga,2019,17.0,2002.0,0.1,0,0,0,0,0,0,0,,0,0,0,0,0,0,0,0,FW,Under 20,Forward,Germany,Europe
334,Robin Bormuth,GER,Düsseldorf,Bundesliga,2019,23.0,1995.0,2.0,2,1,2,0,0,2,3,66.7,1,6,5,1,0,2,12,0,DF,20-24,Defender,Germany,Europe
335,Sebastiaan Bornauw,BEL,Köln,Bundesliga,2019,20.0,1999.0,27.2,37,24,24,12,1,20,39,51.3,19,32,12,20,42,79,99,0,DF,20-24,Defender,Belgium,Europe
336,Brandon Borrello,AUS,Freiburg,Bundesliga,2019,24.0,1995.0,3.3,10,4,6,4,0,4,10,40.0,6,7,1,6,1,11,1,0,"MF,FW",20-24,Midfielder,Australia,Oceania
337,Gabriel Boschilia,BRA,Monaco,Ligue 1,2019,23.0,1996.0,1.4,3,1,0,3,0,1,5,20.0,4,1,1,0,2,5,2,0,"MF,FW",20-24,Midfielder,Brazil,South America
338,Denis Bouanga,GAB,Saint-Étienne,Ligue 1,2019,24.0,1994.0,22.7,45,34,10,25,10,20,55,36.4,35,30,0,30,10,55,15,0,"FW,MF",20-24,Forward,Gabon,Africa
339,Hicham Boudaoui,ALG,Nice,Ligue 1,2019,19.0,1999.0,5.4,20,10,6,11,3,9,23,39.1,14,10,3,7,13,33,7,0,"MF,FW",Under 20,Midfielder,Algeria,Africa
340,Ryad Boudebouz,ALG,Saint-Étienne,Ligue 1,2019,29.0,1990.0,17.7,25,16,9,14,2,8,25,32.0,17,14,1,13,7,32,5,0,"MF,FW",25-29,Midfielder,Algeria,Africa
341,Sofiane Boufal,MAR,Southampton,Premier League,2019,25.0,1993.0,8.5,16,8,6,5,5,6,15,40.0,9,17,0,17,4,20,1,0,"MF,FW",25-29,Midfielder,Morocco,Africa
342,Nassim Boujellab,MAR,Schalke 04,Bundesliga,2019,20.0,1999.0,4.7,12,10,5,4,3,5,14,35.7,9,8,1,7,7,19,5,0,"MF,FW",20-24,Midfielder,Morocco,Africa
343,Farid Boulaya,ALG,Metz,Ligue 1,2019,26.0,1993.0,9.1,14,10,7,4,3,7,19,36.8,12,5,0,5,6,20,3,0,FW,25-29,Forward,Algeria,Africa
344,Yassine Bounou,MAR,Sevilla,La Liga,2019,28.0,1991.0,5.5,0,0,0,0,0,0,0,,0,0,0,0,0,0,0,0,GK,25-29,Goalkeeper,Morocco,Africa
345,Mehdi Bourabia,MAR,Sassuolo,Serie A,2019,27.0,1991.0,10.3,19,9,8,10,1,9,22,40.9,13,12,2,10,22,41,23,0,MF,25-29,Midfielder,Morocco,Africa
346,Benjamin Bourigeaud,FRA,Rennes,Ligue 1,2019,25.0,1994.0,21.1,40,12,18,20,2,17,68,25.0,51,38,7,31,20,60,25,0,MF,25-29,Midfielder,France,Europe
347,Bilal Boutobba,FRA,Montpellier,Ligue 1,2019,20.0,1998.0,0.1,0,0,0,0,0,0,1,0.0,1,0,0,0,0,0,0,0,MF,20-24,Midfielder,France,Europe
348,Jarrod Bowen,ENG,West Ham,Premier League,2019,22.0,1996.0,10.2,19,15,7,9,3,4,17,23.5,13,6,0,6,16,35,8,0,"FW,MF",20-24,Forward,England,Europe
349,Dedryck Boyata,BEL,Hertha BSC,Bundesliga,2019,28.0,1990.0,27.1,24,18,17,5,2,4,12,33.3,8,39,32,7,62,86,158,1,DF,25-29,Defender,Belgium,Europe
350,John Boye,GHA,Metz,Ligue 1,2019,32.0,1987.0,23.5,30,19,25,5,0,19,32,59.4,13,31,18,13,31,61,116,0,DF,30-34,Defender,Ghana,Africa
351,Can Bozdogan,GER,Schalke 04,Bundesliga,2019,18.0,2001.0,2.6,8,6,5,3,0,3,12,25.0,9,2,0,2,2,10,2,0,MF,Under 20,Midfielder,Germany,Europe
352,Domagoj Bradarić,CRO,Lille,Ligue 1,2019,19.0,1999.0,15.8,28,11,9,17,2,12,27,44.4,15,16,3,13,22,50,28,0,DF,Under 20,Defender,Croatia,Europe
353,Filip Bradarić,CRO,Celta Vigo,La Liga,2019,27.0,1992.0,7.8,12,9,5,5,2,3,8,37.5,5,12,3,9,17,29,19,0,MF,25-29,Midfielder,Croatia,Europe
354,Robbie Brady,IRL,Burnley,Premier League,2019,27.0,1992.0,5.0,11,9,5,4,2,3,10,30.0,7,10,2,8,5,16,8,0,MF,25-29,Midfielder,Republic of Ireland,Europe
355,Martin Braithwaite,DEN,Barcelona,La Liga,2019,28.0,1991.0,4.5,2,2,2,0,0,0,8,0.0,8,3,0,3,1,3,1,0,"FW,MF",25-29,Forward,Denmark,Europe
356,Martin Braithwaite,DEN,Leganés,La Liga,2019,28.0,1991.0,21.5,13,7,4,5,4,4,12,33.3,8,10,2,8,4,17,9,0,"FW,MF",25-29,Forward,Denmark,Europe
357,Federico Brancolini,ITA,Fiorentina,Serie A,2019,18.0,2001.0,0.1,0,0,0,0,0,0,0,,0,0,0,0,0,0,0,0,GK,Under 20,Goalkeeper,Italy,Europe
359,Julian Brandt,GER,Dortmund,Bundesliga,2019,23.0,1996.0,24.5,48,33,15,21,12,25,55,45.5,30,35,2,33,16,64,10,1,"MF,FW",20-24,Midfielder,Germany,Europe
360,Jarrad Branthwaite,ENG,Everton,Premier League,2019,17.0,2002.0,3.3,8,7,5,3,0,3,5,60.0,2,6,3,3,2,10,12,0,DF,Under 20,Defender,England,Europe
362,Claudio Bravo,CHI,Manchester City,Premier League,2019,36.0,1983.0,3.9,0,0,0,0,0,0,0,,0,0,0,0,0,0,1,1,GK,35-39,Goalkeeper,Chile,South America
363,Josip Brekalo,CRO,Wolfsburg,Bundesliga,2019,21.0,1998.0,18.6,18,8,5,6,7,5,23,21.7,18,26,0,26,16,34,4,0,"MF,FW",20-24,Midfielder,Croatia,Europe
364,Gleison Bremer,BRA,Torino,Serie A,2019,22.0,1997.0,25.2,63,36,37,20,6,20,34,58.8,14,48,22,26,74,137,118,1,DF,20-24,Defender,Brazil,South America
365,Marco Brescianini,ITA,Milan,Serie A,2019,19.0,2000.0,0.3,1,1,1,0,0,0,0,,0,0,0,0,2,3,0,0,MF,Under 20,Midfielder,Italy,Europe
366,Anthony Briançon,FRA,Nîmes,Ligue 1,2019,24.0,1994.0,19.3,29,19,20,9,0,17,34,50.0,17,22,16,6,39,68,80,0,DF,20-24,Defender,France,Europe
367,Jimmy Briand,FRA,Bordeaux,Ligue 1,2019,33.0,1985.0,16.9,12,8,5,4,3,3,13,23.1,10,8,4,4,6,18,12,0,FW,30-34,Forward,France,Europe
368,Yan Brice Eteki,CMR,Granada,La Liga,2019,21.0,1997.0,16.7,37,21,14,18,5,15,31,48.4,16,17,4,13,24,61,20,1,MF,20-24,Midfielder,Cameroon,Africa
369,Armando Broja,ALB,Chelsea,Premier League,2019,17.0,2001.0,0.1,0,0,0,0,0,0,0,,0,0,0,0,0,0,0,0,FW,Under 20,Forward,Albania,Europe
370,Dylan Bronn,TUN,Metz,Ligue 1,2019,24.0,1995.0,9.0,7,5,6,1,0,4,7,57.1,3,11,9,2,6,13,42,0,DF,20-24,Defender,Tunisia,Africa
371,David Brooks,WAL,Bournemouth,Premier League,2019,22.0,1997.0,5.6,5,5,1,2,2,2,14,14.3,12,5,1,4,2,7,1,0,"MF,FW",20-24,Midfielder,Wales,Europe
372,John Brooks,USA,Wolfsburg,Bundesliga,2019,26.0,1993.0,24.7,38,27,27,9,2,24,49,49.0,25,31,12,19,41,79,93,0,DF,25-29,Defender,United States,North America
373,Daniel Brosinski,GER,Mainz 05,Bundesliga,2019,31.0,1988.0,19.0,40,27,13,23,4,15,34,44.1,19,16,2,14,14,54,58,0,DF,30-34,Defender,Germany,Europe
374,Josh Brownhill,ENG,Burnley,Premier League,2019,23.0,1995.0,8.9,14,8,5,7,2,5,13,38.5,8,9,4,5,14,28,18,0,MF,20-24,Midfielder,England,Europe
375,Marcelo Brozović,CRO,Inter,Serie A,2019,26.0,1992.0,30.0,67,35,26,31,10,19,71,26.8,52,26,9,17,46,113,46,2,MF,25-29,Midfielder,Croatia,Europe
376,Gastón Brugman,URU,Parma,Serie A,2019,26.0,1992.0,16.2,47,24,25,15,7,19,46,41.3,27,33,15,18,27,74,19,2,MF,25-29,Midfielder,Uruguay,South America
377,Jeffrey Bruma,NED,Wolfsburg,Bundesliga,2019,27.0,1991.0,9.0,9,5,4,5,0,7,13,53.8,6,6,3,3,13,22,51,1,DF,25-29,Defender,Netherlands,Europe
378,Jeffrey Bruma,NED,Mainz 05,Bundesliga,2019,27.0,1991.0,7.5,12,8,8,4,0,4,6,66.7,2,11,5,6,6,18,34,1,DF,25-29,Defender,Netherlands,Europe
379,Jacob Bruun Larsen,DEN,Hoffenheim,Bundesliga,2019,20.0,1998.0,4.3,3,2,3,0,0,3,8,37.5,5,3,0,3,3,6,1,0,"FW,MF",20-24,Forward,Denmark,Europe
380,Jacob Bruun Larsen,DEN,Dortmund,Bundesliga,2019,20.0,1998.0,0.8,0,0,0,0,0,0,0,,0,0,0,0,0,0,0,0,FW,20-24,Forward,Denmark,Europe
381,Lucas Buadés,FRA,Nîmes,Ligue 1,2019,21.0,1997.0,1.3,4,4,3,1,0,1,5,20.0,4,0,0,0,1,5,3,0,"MF,FW",20-24,Midfielder,France,Europe
382,Ante Budimir,CRO,Mallorca,La Liga,2019,28.0,1991.0,30.7,31,15,4,22,5,7,29,24.1,22,21,4,17,8,39,29,0,FW,25-29,Forward,Croatia,Europe
383,Emi Buendía,ARG,Norwich City,Premier League,2019,22.0,1996.0,27.4,82,39,57,21,4,38,118,32.2,80,58,5,53,23,105,32,2,"FW,MF",20-24,Forward,Argentina,South America
384,Gianluigi Buffon,ITA,Juventus,Serie A,2019,41.0,1978.0,9.0,0,0,0,0,0,0,0,,0,0,0,0,0,0,3,1,GK,Over 40,Goalkeeper,Italy,Europe
385,Marius Bülter,GER,Union Berlin,Bundesliga,2019,26.0,1993.0,25.8,38,22,19,13,6,17,54,31.5,37,37,3,34,11,49,20,1,"MF,FW",25-29,Midfielder,Germany,Europe
386,Esteban Burgos,ARG,Eibar,La Liga,2019,27.0,1992.0,12.4,11,9,9,2,0,5,9,55.6,4,11,6,5,17,28,66,2,DF,25-29,Defender,Argentina,South America
387,Guido Burgstaller,AUT,Schalke 04,Bundesliga,2019,30.0,1989.0,13.7,7,3,0,5,2,4,15,26.7,11,12,3,9,4,11,10,0,FW,30-34,Forward,Austria,Europe
389,Jonathan Burkardt,GER,Mainz 05,Bundesliga,2019,19.0,2000.0,2.8,9,4,2,5,2,3,8,37.5,5,6,1,5,0,9,1,0,"FW,MF",Under 20,Forward,Germany,Europe
390,Oliver Burke,SCO,Alavés,La Liga,2019,22.0,1997.0,15.9,19,14,8,9,2,10,23,43.5,13,24,0,24,8,27,16,0,"MF,FW",20-24,Midfielder,Scotland,Europe
391,Roman Bürki,SUI,Dortmund,Bundesliga,2019,28.0,1990.0,30.8,2,2,2,0,0,2,3,66.7,1,1,0,1,2,4,13,1,GK,25-29,Goalkeeper,Switzerland,Europe
392,Dan Burn,ENG,Brighton,Premier League,2019,27.0,1992.0,32.0,67,42,35,27,5,25,53,47.2,28,44,20,24,42,109,130,0,DF,25-29,Defender,England,Europe
396,Ludovic Butelle,FRA,Angers,Ligue 1,2019,36.0,1983.0,26.0,1,1,1,0,0,1,2,50.0,1,1,0,1,0,1,10,4,GK,35-39,Goalkeeper,France,Europe
398,Sam Byram,ENG,Norwich City,Premier League,2019,25.0,1993.0,14.4,40,22,24,11,5,18,37,48.6,19,16,8,8,26,66,73,0,DF,25-29,Defender,England,Europe
399,Erick Cabaco,URU,Getafe,La Liga,2019,24.0,1995.0,3.0,3,2,1,2,0,0,3,0.0,3,1,1,0,3,6,11,0,DF,20-24,Defender,Uruguay,South America
400,Erick Cabaco,URU,Levante,La Liga,2019,24.0,1995.0,9.0,12,9,9,3,0,4,6,66.7,2,12,7,5,12,24,50,1,DF,20-24,Defender,Uruguay,South America
401,Willy Caballero,ARG,Chelsea,Premier League,2019,37.0,1981.0,5.0,0,0,0,0,0,0,0,,0,0,0,0,0,0,3,0,GK,35-39,Goalkeeper,Argentina,South America
402,Yohan Cabaye,FRA,Saint-Étienne,Ligue 1,2019,33.0,1986.0,9.5,29,18,11,14,4,14,25,56.0,11,10,0,10,22,51,7,1,MF,30-34,Midfielder,France,Europe
405,Leandro Cabrera,URU,Getafe,La Liga,2019,28.0,1991.0,17.0,10,6,5,5,0,5,12,41.7,7,10,4,6,21,31,66,0,DF,25-29,Defender,Uruguay,South America
406,Leandro Cabrera,URU,Espanyol,La Liga,2019,28.0,1991.0,17.0,27,11,17,9,1,17,28,60.7,11,19,12,7,21,48,78,1,DF,25-29,Defender,Uruguay,South America
407,Fabrizio Cacciatore,ITA,Cagliari,Serie A,2019,32.0,1986.0,12.8,14,4,9,4,1,6,9,66.7,3,10,6,4,16,30,44,0,DF,30-34,Defender,Italy,Europe
408,Martín Cáceres,URU,Fiorentina,Serie A,2019,32.0,1987.0,26.2,47,31,34,11,2,16,34,47.1,18,29,13,16,31,78,74,2,DF,30-34,Defender,Uruguay,South America
409,Anthony Caci,FRA,Strasbourg,Ligue 1,2019,22.0,1997.0,7.7,29,17,19,9,1,8,17,47.1,9,15,5,10,19,48,15,1,DF,20-24,Defender,France,Europe
410,Jhonder Cádiz,VEN,Dijon,Ligue 1,2019,24.0,1995.0,8.9,16,8,6,7,3,3,7,42.9,4,4,2,2,1,17,9,0,"FW,MF",20-24,Forward,Venezuela,South America
411,Mathieu Cafaro,FRA,Reims,Ligue 1,2019,22.0,1997.0,10.3,12,6,5,5,2,6,17,35.3,11,13,0,13,2,14,0,0,"FW,MF",20-24,Forward,France,Europe
412,Jonathan Cafu,BRA,Bordeaux,Ligue 1,2019,28.0,1991.0,2.2,7,3,4,3,0,4,7,57.1,3,1,0,1,1,8,3,0,DF,25-29,Defender,Brazil,South America
413,Gary Cahill,ENG,Crystal Palace,Premier League,2019,33.0,1985.0,24.1,15,8,11,4,0,7,15,46.7,8,34,25,9,18,33,114,1,DF,30-34,Defender,England,Europe
414,Felipe Caicedo,ECU,Lazio,Serie A,2019,30.0,1988.0,15.6,17,10,4,7,6,2,11,18.2,9,9,1,8,4,21,2,0,FW,30-34,Forward,Ecuador,South America
415,Arturo Calabresi,ITA,Amiens,Ligue 1,2019,23.0,1996.0,20.9,53,33,29,20,4,33,75,44.0,42,24,11,13,29,82,60,0,DF,20-24,Defender,Italy,Europe
416,Davide Calabria,ITA,Milan,Serie A,2019,22.0,1996.0,18.0,52,33,28,22,2,17,41,41.5,24,23,5,18,21,73,47,1,DF,20-24,Defender,Italy,Europe
417,Riccardo Calafiori,ITA,Roma,Serie A,2019,17.0,2002.0,0.7,0,0,0,0,0,0,1,0.0,1,0,0,0,2,2,0,0,DF,Under 20,Defender,Italy,Europe
418,Mattia Caldara,ITA,Atalanta,Serie A,2019,25.0,1994.0,10.7,21,11,12,8,1,5,11,45.5,6,9,5,4,30,51,22,1,DF,25-29,Defender,Italy,Europe
419,Marco Calderoni,ITA,Lecce,Serie A,2019,30.0,1989.0,22.9,38,25,22,13,3,20,39,51.3,19,27,10,17,37,75,54,1,DF,30-34,Defender,Italy,Europe
421,Duje Ćaleta-Car,CRO,Marseille,Ligue 1,2019,22.0,1996.0,21.0,29,15,17,11,1,18,26,69.2,8,17,6,11,26,55,98,0,DF,20-24,Defender,Croatia,Europe
422,Hakan Çalhanoğlu,TUR,Milan,Serie A,2019,25.0,1994.0,30.0,42,21,15,21,6,12,35,34.3,23,26,2,24,26,68,26,1,"MF,FW",25-29,Midfielder,Turkey,Asia
423,Daniel Caligiuri,ITA,Schalke 04,Bundesliga,2019,31.0,1988.0,25.5,58,37,18,25,15,27,74,36.5,47,67,6,61,25,83,39,0,"MF,FW",30-34,Midfielder,Italy,Europe
425,Jonathan Calleri,ARG,Espanyol,La Liga,2019,25.0,1993.0,20.1,12,8,6,4,2,3,24,12.5,21,11,3,8,7,19,22,0,FW,25-29,Forward,Argentina,South America
426,Dominic Calvert-Lewin,ENG,Everton,Premier League,2019,22.0,1997.0,29.2,7,5,1,4,2,1,10,10.0,9,15,2,13,6,13,36,0,FW,20-24,Forward,England,Europe
427,Mahdi Camara,FRA,Saint-Étienne,Ligue 1,2019,21.0,1998.0,10.0,33,20,12,16,5,18,32,56.3,14,20,2,18,18,51,5,0,MF,20-24,Midfielder,France,Europe
428,Souleymane Camara,SEN,Montpellier,Ligue 1,2019,36.0,1982.0,1.8,0,0,0,0,0,0,2,0.0,2,0,0,0,0,0,1,0,FW,35-39,Forward,Senegal,Africa
431,Eduardo Camavinga,FRA,Rennes,Ligue 1,2019,16.0,2002.0,23.4,105,64,45,56,4,48,96,50.0,48,26,8,18,34,139,35,0,MF,Under 20,Midfielder,France,Europe
436,Emre Can,GER,Juventus,Serie A,2019,25.0,1994.0,3.2,10,7,5,3,2,3,10,30.0,7,4,0,4,2,12,3,0,MF,25-29,Midfielder,Germany,Europe
437,Emre Can,GER,Dortmund,Bundesliga,2019,25.0,1994.0,10.6,19,12,11,7,1,5,12,41.7,7,14,6,8,19,38,15,0,"MF,DF",25-29,Midfielder,Germany,Europe
439,João Cancelo,POR,Manchester City,Premier League,2019,25.0,1994.0,13.4,40,24,21,12,7,24,40,60.0,16,9,2,7,21,61,18,0,DF,25-29,Defender,Portugal,Europe
440,Antonio Candreva,ITA,Inter,Serie A,2019,32.0,1987.0,22.1,11,6,9,1,1,7,29,24.1,22,26,10,16,14,25,33,1,DF,30-34,Defender,Italy,Europe
441,Gianmarco Cangiano,ITA,Bologna,Serie A,2019,17.0,2001.0,0.2,1,1,0,1,0,0,0,,0,0,0,0,1,2,0,0,"FW,MF",Under 20,Forward,Italy,Europe
442,Todd Cantwell,ENG,Norwich City,Premier League,2019,21.0,1998.0,27.7,51,31,19,27,5,26,73,35.6,47,38,2,36,18,69,35,1,"FW,MF",20-24,Forward,England,Europe
444,Pierrick Capelle,FRA,Angers,Ligue 1,2019,32.0,1987.0,19.4,42,32,18,16,8,16,48,33.3,32,17,3,14,21,63,28,0,"MF,DF",30-34,Midfielder,France,Europe
445,Étienne Capoue,FRA,Watford,Premier League,2019,31.0,1988.0,29.2,75,40,38,30,7,37,85,43.5,48,30,11,19,68,143,61,0,MF,30-34,Midfielder,France,Europe
446,Gianluca Caprari,ITA,Sampdoria,Serie A,2019,26.0,1993.0,7.4,9,7,1,6,2,4,13,30.8,9,5,0,5,7,16,1,0,"FW,MF",25-29,Forward,Italy,Europe
447,Gianluca Caprari,ITA,Parma,Serie A,2019,26.0,1993.0,6.5,1,1,0,1,0,0,5,0.0,5,7,2,5,4,5,2,0,"FW,MF",25-29,Forward,Italy,Europe
448,Francesco Caputo,ITA,Sassuolo,Serie A,2019,31.0,1987.0,32.6,7,4,3,2,2,3,11,27.3,8,15,0,15,1,8,8,0,FW,30-34,Forward,Italy,Europe
449,Maxence Caqueret,FRA,Lyon,Ligue 1,2019,19.0,2000.0,6.3,24,15,10,13,1,11,25,44.0,14,14,2,12,9,33,6,1,MF,Under 20,Midfielder,France,Europe
450,Andrea Carboni,ITA,Cagliari,Serie A,2019,18.0,2001.0,4.1,8,4,3,5,0,3,4,75.0,1,6,6,0,7,15,20,0,DF,Under 20,Defender,Italy,Europe
451,Irvin Cardona,FRA,Brest,Ligue 1,2019,21.0,1997.0,16.1,13,8,5,6,2,9,32,28.1,23,8,0,8,1,14,7,0,"FW,MF",20-24,Forward,France,Europe
453,Diego Carlos,BRA,Sevilla,La Liga,2019,26.0,1993.0,34.8,35,23,25,9,1,15,25,60.0,10,33,24,9,37,72,176,1,DF,25-29,Defender,Brazil,South America
454,Lionel Carole,FRA,Strasbourg,Ligue 1,2019,28.0,1991.0,14.1,23,8,15,6,2,13,17,76.5,4,2,1,1,19,42,22,0,DF,25-29,Defender,France,Europe
455,Yannick Carrasco,BEL,Atlético Madrid,La Liga,2019,25.0,1993.0,7.0,11,7,4,4,3,7,21,33.3,14,9,0,9,5,16,2,0,"MF,FW",25-29,Midfielder,Belgium,Europe
456,Daniel Carriço,POR,Sevilla,La Liga,2019,30.0,1988.0,9.4,8,2,4,3,1,1,6,16.7,5,4,3,1,8,16,23,0,DF,30-34,Defender,Portugal,Europe
457,Guido Carrillo,ARG,Leganés,La Liga,2019,28.0,1991.0,13.5,13,10,3,6,4,2,14,14.3,12,9,1,8,3,16,22,0,FW,25-29,Forward,Argentina,South America
458,Andy Carroll,ENG,Newcastle Utd,Premier League,2019,30.0,1989.0,7.0,5,3,3,2,0,2,8,25.0,6,2,1,1,2,7,24,1,FW,30-34,Forward,England,Europe
460,Matis Carvalho,POR,Montpellier,Ligue 1,2019,20.0,1999.0,0.8,0,0,0,0,0,0,1,0.0,1,0,0,0,0,0,1,0,GK,20-24,Goalkeeper,Portugal,Europe
461,William Carvalho,POR,Betis,La Liga,2019,27.0,1992.0,9.9,7,4,4,2,1,4,14,28.6,10,7,5,2,4,11,8,1,MF,25-29,Midfielder,Portugal,Europe
462,Casemiro,BRA,Real Madrid,La Liga,2019,27.0,1992.0,34.3,96,60,43,45,8,39,99,39.4,60,53,10,43,68,164,72,0,MF,25-29,Midfielder,Brazil,South America
463,Moreto Cassamã,GNB,Reims,Ligue 1,2019,21.0,1998.0,6.6,17,11,2,13,2,5,7,71.4,2,7,2,5,5,22,6,0,MF,20-24,Midfielder,Guinea-Bissau,Africa
464,Francesco Cassata,ITA,Genoa,Serie A,2019,22.0,1997.0,16.2,20,10,12,5,3,9,30,30.0,21,12,2,10,11,31,11,0,MF,20-24,Midfielder,Italy,Europe
465,Timothy Castagne,BEL,Atalanta,Serie A,2019,23.0,1995.0,19.7,31,20,9,16,6,13,25,52.0,12,34,5,29,17,48,23,0,DF,20-24,Defender,Belgium,Europe
466,Koen Casteels,BEL,Wolfsburg,Bundesliga,2019,27.0,1992.0,26.0,0,0,0,0,0,0,0,,0,0,0,0,0,0,9,1,GK,25-29,Goalkeeper,Belgium,Europe
467,Jean-Charles Castelletto,CMR,Brest,Ligue 1,2019,24.0,1995.0,20.4,18,9,13,5,0,9,18,50.0,9,20,16,4,33,51,87,1,DF,20-24,Defender,Cameroon,Africa
470,Lucas Castro,ARG,SPAL,Serie A,2019,30.0,1989.0,4.7,13,5,5,5,3,2,4,50.0,2,4,0,4,2,15,3,0,MF,30-34,Midfielder,Argentina,South America
471,Lucas Castro,ARG,Cagliari,Serie A,2019,30.0,1989.0,6.7,7,3,3,4,0,1,12,8.3,11,6,1,5,8,15,14,0,MF,30-34,Midfielder,Argentina,South America
472,Gaetano Castrovilli,ITA,Fiorentina,Serie A,2019,22.0,1997.0,29.7,59,31,25,23,11,18,53,34.0,35,29,2,27,15,74,31,1,MF,20-24,Midfielder,Italy,Europe
473,Danilo Cataldi,ITA,Lazio,Serie A,2019,24.0,1994.0,6.6,17,11,10,5,2,10,20,50.0,10,7,1,6,13,30,10,0,MF,20-24,Midfielder,Italy,Europe
475,Edinson Cavani,URU,Paris S-G,Ligue 1,2019,32.0,1987.0,6.7,5,1,0,2,3,0,3,0.0,3,7,0,7,1,6,2,0,FW,30-34,Forward,Uruguay,South America
478,Federico Ceccherini,ITA,Fiorentina,Serie A,2019,27.0,1992.0,9.3,14,8,11,3,0,10,10,100.0,0,9,5,4,13,27,37,1,DF,25-29,Defender,Italy,Europe
479,Christian Celesia,ITA,Torino,Serie A,2019,17.0,2002.0,0.0,0,0,0,0,0,0,0,,0,0,0,0,0,0,0,0,DF,Under 20,Defender,Italy,Europe
480,Zeki Çelik,TUR,Lille,Ligue 1,2019,22.0,1997.0,23.0,53,28,18,28,7,27,60,45.0,33,24,4,20,26,79,39,0,DF,20-24,Defender,Turkey,Asia
481,Fabien Centonze,FRA,Metz,Ligue 1,2019,23.0,1996.0,28.0,76,49,53,22,1,34,57,59.6,23,30,11,19,59,135,98,0,DF,20-24,Defender,France,Europe
482,Luca Ceppitelli,ITA,Cagliari,Serie A,2019,29.0,1989.0,13.8,22,15,16,6,0,6,11,54.5,5,23,17,6,23,45,66,2,DF,25-29,Defender,Italy,Europe
483,Alberto Cerri,ITA,SPAL,Serie A,2019,23.0,1996.0,4.7,2,1,0,2,0,1,3,33.3,2,1,0,1,0,2,3,0,FW,20-24,Forward,Italy,Europe
484,Alberto Cerri,ITA,Cagliari,Serie A,2019,23.0,1996.0,2.7,3,1,1,0,2,2,6,33.3,4,1,0,1,2,5,4,0,FW,20-24,Forward,Italy,Europe
485,Julian Chabot,GER,Sampdoria,Serie A,2019,21.0,1998.0,6.3,11,7,6,5,0,6,11,54.5,5,3,2,1,15,26,26,0,DF,20-24,Defender,Germany,Europe
486,Florian Chabrolle,FRA,Marseille,Ligue 1,2019,21.0,1998.0,0.2,0,0,0,0,0,0,0,,0,0,0,0,0,0,0,0,MF,20-24,Midfielder,France,Europe
487,Fouad Chafik,MAR,Dijon,Ligue 1,2019,32.0,1986.0,17.0,32,21,22,7,3,17,36,47.2,19,12,5,7,26,58,36,0,DF,30-34,Defender,Morocco,Africa
488,Sofian Chakla,MAR,Villarreal,La Liga,2019,25.0,1993.0,2.0,0,0,0,0,0,0,1,0.0,1,2,1,1,3,3,7,1,DF,25-29,Defender,Morocco,Africa
489,Nathaniel Chalobah,ENG,Watford,Premier League,2019,24.0,1994.0,10.3,30,11,13,13,4,12,27,44.4,15,10,4,6,18,48,20,0,MF,20-24,Midfielder,England,Europe
490,Calum Chambers,ENG,Arsenal,Premier League,2019,24.0,1995.0,12.2,26,10,12,8,6,11,16,68.8,5,13,7,6,16,42,43,1,DF,20-24,Defender,England,Europe
491,Jhon Chancellor,VEN,Brescia,Serie A,2019,27.0,1992.0,24.9,30,14,22,8,0,11,22,50.0,11,34,29,5,34,64,145,3,DF,25-29,Defender,Venezuela,South America
492,Timothy Chandler,USA,Eint Frankfurt,Bundesliga,2019,29.0,1990.0,13.6,22,10,9,8,5,9,16,56.3,7,9,4,5,13,35,21,0,"DF,MF",25-29,Defender,United States,North America
493,Kwon Chang-hoon,KOR,Freiburg,Bundesliga,2019,25.0,1994.0,7.5,7,4,2,3,2,1,10,10.0,9,5,1,4,7,14,14,0,"MF,FW",25-29,Midfielder,South Korea,Asia
494,Gaëtan Charbonnier,FRA,Brest,Ligue 1,2019,30.0,1988.0,22.9,36,16,11,11,14,10,35,28.6,25,19,6,13,7,43,33,1,"FW,MF",30-34,Forward,France,Europe
495,Brendan Chardonnet,FRA,Brest,Ligue 1,2019,24.0,1994.0,9.1,12,6,10,2,0,7,12,58.3,5,8,5,3,15,27,50,0,DF,20-24,Defender,France,Europe
496,Charles,BRA,Eibar,La Liga,2019,35.0,1984.0,14.5,10,5,0,6,4,4,22,18.2,18,7,2,5,7,17,6,0,FW,35-39,Forward,Brazil,South America
496,Charles,BRA,Eibar,La Liga,2019,35.0,1984.0,14.5,10,5,0,6,4,4,22,18.2,18,7,2,5,7,17,6,0,FW,35-39,Forward,Brazil,South America
496,Charles,BRA,Eibar,La Liga,2019,35.0,1984.0,14.5,10,5,0,6,4,4,22,18.2,18,7,2,5,7,17,6,0,FW,35-39,Forward,Brazil,South America
496,Charles,BRA,Eibar,La Liga,2019,35.0,1984.0,14.5,10,5,0,6,4,4,22,18.2,18,7,2,5,7,17,6,0,FW,35-39,Forward,Brazil,South America
496,Charles,BRA,Eibar,La Liga,2019,35.0,1984.0,14.5,10,5,0,6,4,4,22,18.2,18,7,2,5,7,17,6,0,FW,35-39,Forward,Brazil,South America
496,Charles,BRA,Eibar,La Liga,2019,35.0,1984.0,14.5,10,5,0,6,4,4,22,18.2,18,7,2,5,7,17,6,0,FW,35-39,Forward,Brazil,South America
496,Charles,BRA,Eibar,La Liga,2019,35.0,1984.0,14.5,10,5,0,6,4,4,22,18.2,18,7,2,5,7,17,6,0,FW,35-39,Forward,Brazil,South America
496,Charles,BRA,Eibar,La Liga,2019,35.0,1984.0,14.5,10,5,0,6,4,4,22,18.2,18,7,2,5,7,17,6,0,FW,35-39,Forward,Brazil,South America
496,Charles,BRA,Eibar,La Liga,2019,35.0,1984.0,14.5,10,5,0,6,4,4,22,18.2,18,7,2,5,7,17,6,0,FW,35-39,Forward,Brazil,South America
496,Charles,BRA,Eibar,La Liga,2019,35.0,1984.0,14.5,10,5,0,6,4,4,22,18.2,18,7,2,5,7,17,6,0,FW,35-39,Forward,Brazil,South America
496,Charles,BRA,Eibar,La Liga,2019,35.0,1984.0,14.5,10,5,0,6,4,4,22,18.2,18,7,2,5,7,17,6,0,FW,35-39,Forward,Brazil,South America
496,Charles,BRA,Eibar,La Liga,2019,35.0,1984.0,14.5,10,5,0,6,4,4,22,18.2,18,7,2,5,7,17,6,0,FW,35-39,Forward,Brazil,South America
496,Charles,BRA,Eibar,La Liga,2019,35.0,1984.0,14.5,10,5,0,6,4,4,22,18.2,18,7,2,5,7,17,6,0,FW,35-39,Forward,Brazil,South America
496,Charles,BRA,Eibar,La Liga,2019,35.0,1984.0,14.5,10,5,0,6,4,4,22,18.2,18,7,2,5,7,17,6,0,FW,35-39,Forward,Brazil,South America
496,Charles,BRA,Eibar,La Liga,2019,35.0,1984.0,14.5,10,5,0,6,4,4,22,18.2,18,7,2,5,7,17,6,0,FW,35-39,Forward,Brazil,South America
496,Charles,BRA,Eibar,La Liga,2019,35.0,1984.0,14.5,10,5,0,6,4,4,22,18.2,18,7,2,5,7,17,6,0,FW,35-39,Forward,Brazil,South America
497,Xavier Chavalerin,FRA,Reims,Ligue 1,2019,28.0,1991.0,23.9,71,52,29,33,9,19,49,38.8,30,23,8,15,36,107,36,0,MF,25-29,Midfielder,France,Europe
498,Pablo Chavarría,ARG,Mallorca,La Liga,2019,31.0,1988.0,2.3,1,1,0,1,0,0,4,0.0,4,1,1,0,1,2,2,0,"FW,MF",30-34,Forward,Argentina,South America
499,Aurélien Chedjou,CMR,Amiens,Ligue 1,2019,34.0,1985.0,21.9,27,19,18,9,0,10,22,45.5,12,15,11,4,40,67,120,3,DF,30-34,Defender,Cameroon,Africa
500,Pape Cheikh Diop,SEN,Celta Vigo,La Liga,2019,21.0,1997.0,6.7,10,4,6,3,1,2,12,16.7,10,4,2,2,5,15,3,0,MF,20-24,Midfielder,Senegal,Africa
502,Rayan Cherki,FRA,Lyon,Ligue 1,2019,15.0,2003.0,1.6,3,2,0,1,2,3,4,75.0,1,3,0,3,0,3,0,0,"MF,FW",Under 20,Midfielder,France,Europe
503,Denis Cheryshev,RUS,Valencia,La Liga,2019,28.0,1990.0,10.3,16,9,5,4,7,3,17,17.6,14,15,1,14,7,23,10,0,"MF,FW",25-29,Midfielder,Russia,Europe
504,Giorgio Chiellini,ITA,Juventus,Serie A,2019,34.0,1984.0,2.2,3,0,3,0,0,1,1,100.0,0,2,2,0,1,4,9,0,DF,30-34,Defender,Italy,Europe
505,Federico Chiesa,ITA,Fiorentina,Serie A,2019,21.0,1997.0,29.3,38,22,13,15,10,10,52,19.2,42,19,0,19,6,44,6,0,"FW,DF",20-24,Forward,Italy,Europe
506,Ben Chilwell,ENG,Leicester City,Premier League,2019,22.0,1996.0,26.4,43,26,28,13,2,23,52,44.2,29,30,6,24,28,71,68,2,DF,20-24,Defender,England,Europe
507,Vlad Chiricheș,ROU,Sassuolo,Serie A,2019,29.0,1989.0,7.9,14,9,12,2,0,7,10,70.0,3,13,8,5,11,25,28,2,DF,25-29,Defender,Romania,Europe
508,Tahith Chong,NED,Manchester Utd,Premier League,2019,19.0,1999.0,0.4,0,0,0,0,0,0,0,,0,0,0,0,0,0,0,0,"FW,DF",Under 20,Forward,Netherlands,Europe
509,Joris Chotard,FRA,Montpellier,Ligue 1,2019,17.0,2001.0,13.9,30,18,13,17,0,15,35,42.9,20,12,5,7,20,50,12,1,MF,Under 20,Midfielder,France,Europe
510,Hamza Choudhury,ENG,Leicester City,Premier League,2019,21.0,1997.0,9.9,17,8,7,8,2,3,25,12.0,22,15,6,9,24,41,13,0,MF,20-24,Midfielder,England,Europe
511,Mounir Chouiar,FRA,Dijon,Ligue 1,2019,20.0,1999.0,16.7,36,23,13,18,5,12,42,28.6,30,8,0,8,13,49,13,0,"MF,FW",20-24,Midfielder,France,Europe
512,Andreas Christensen,DEN,Chelsea,Premier League,2019,23.0,1996.0,19.5,38,21,25,12,1,15,21,71.4,6,12,8,4,29,67,56,0,DF,20-24,Defender,Denmark,Europe
513,Samuel Chukwueze,NGA,Villarreal,La Liga,2019,20.0,1999.0,22.8,23,14,12,6,5,13,30,43.3,17,15,1,14,10,33,14,1,"FW,MF",20-24,Forward,Nigeria,Africa
514,Darko Churlinov,MKD,Köln,Bundesliga,2019,19.0,2000.0,0.2,1,1,1,0,0,1,2,50.0,1,0,0,0,1,2,0,0,MF,Under 20,Midfielder,North Macedonia,Europe
516,Luca Cigarini,ITA,Cagliari,Serie A,2019,33.0,1986.0,17.8,37,20,23,13,1,16,40,40.0,24,28,10,18,20,57,29,0,MF,30-34,Midfielder,Italy,Europe
518,Jasper Cillessen,NED,Valencia,La Liga,2019,30.0,1989.0,23.3,0,0,0,0,0,0,1,0.0,1,0,0,0,3,3,3,1,GK,30-34,Goalkeeper,Netherlands,Europe
520,Ibrahim Cissé,CIV,Nice,Ligue 1,2019,20.0,1999.0,0.6,1,1,1,0,0,0,0,,0,0,0,0,0,1,6,0,DF,20-24,Defender,Ivory Coast,Africa
520,Ibrahim Cissé,CIV,Nice,Ligue 1,2019,20.0,1999.0,0.6,1,1,1,0,0,0,0,,0,0,0,0,0,1,6,0,DF,20-24,Defender,Ivory Coast,Africa
520,Ibrahim Cissé,CIV,Nice,Ligue 1,2019,20.0,1999.0,0.6,1,1,1,0,0,0,0,,0,0,0,0,0,1,6,0,DF,20-24,Defender,Ivory Coast,Africa
520,Ibrahim Cissé,CIV,Nice,Ligue 1,2019,20.0,1999.0,0.6,1,1,1,0,0,0,0,,0,0,0,0,0,1,6,0,DF,20-24,Defender,Ivory Coast,Africa
521,Ibrahim Cissé,SEN,Angers,Ligue 1,2019,23.0,1996.0,0.7,2,1,0,2,0,0,0,,0,0,0,0,0,2,2,0,DF,20-24,Defender,Senegal,Africa
521,Ibrahim Cissé,SEN,Angers,Ligue 1,2019,23.0,1996.0,0.7,2,1,0,2,0,0,0,,0,0,0,0,0,2,2,0,DF,20-24,Defender,Senegal,Africa
521,Ibrahim Cissé,SEN,Angers,Ligue 1,2019,23.0,1996.0,0.7,2,1,0,2,0,0,0,,0,0,0,0,0,2,2,0,DF,20-24,Defender,Senegal,Africa
521,Ibrahim Cissé,SEN,Angers,Ligue 1,2019,23.0,1996.0,0.7,2,1,0,2,0,0,0,,0,0,0,0,0,2,2,0,DF,20-24,Defender,Senegal,Africa
522,Andrea Cistana,ITA,Brescia,Serie A,2019,22.0,1997.0,20.4,20,8,13,7,0,6,17,35.3,11,38,34,4,33,53,96,1,DF,20-24,Defender,Italy,Europe
523,Ciaran Clark,IRL,Newcastle Utd,Premier League,2019,29.0,1989.0,13.2,20,12,18,2,0,9,15,60.0,6,18,14,4,11,31,82,0,DF,25-29,Defender,Republic of Ireland,Europe
524,Leon Clarke,ENG,Sheffield Utd,Premier League,2019,34.0,1985.0,0.4,0,0,0,0,0,0,0,,0,0,0,0,0,0,2,0,"FW,MF",30-34,Forward,England,Europe
525,Alexis Claude-Maurice,FRA,Nice,Ligue 1,2019,21.0,1998.0,18.1,26,16,8,11,7,13,35,37.1,22,20,4,16,11,37,4,0,"FW,MF",20-24,Forward,France,Europe
526,Christian Clemens,GER,Köln,Bundesliga,2019,27.0,1991.0,0.2,0,0,0,0,0,0,0,,0,1,1,0,0,0,0,0,FW,25-29,Forward,Germany,Europe
529,Denilho Cleonise,NED,Genoa,Serie A,2019,17.0,2001.0,0.5,1,0,1,0,0,0,0,,0,0,0,0,1,2,0,0,FW,Under 20,Forward,Netherlands,Europe
531,Tom Cleverley,ENG,Watford,Premier League,2019,29.0,1989.0,10.8,28,15,8,14,6,9,36,25.0,27,13,1,12,10,38,15,0,MF,25-29,Midfielder,England,Europe
532,Conor Coady,ENG,Wolves,Premier League,2019,26.0,1993.0,38.0,36,23,30,6,0,15,30,50.0,15,22,15,7,28,64,119,2,DF,25-29,Defender,England,Europe
533,Marcus Coco,FRA,Nantes,Ligue 1,2019,23.0,1996.0,0.2,1,0,1,0,0,1,1,100.0,0,0,0,0,0,1,0,0,FW,20-24,Forward,France,Europe
534,Renaud Cohade,FRA,Metz,Ligue 1,2019,34.0,1984.0,8.5,28,20,11,12,5,12,28,42.9,16,14,3,11,8,36,6,0,MF,30-34,Midfielder,France,Europe
536,Séamus Coleman,IRL,Everton,Premier League,2019,30.0,1988.0,20.4,42,31,24,14,4,19,25,76.0,6,21,9,12,24,66,43,1,DF,30-34,Defender,Republic of Ireland,Europe
538,Ebrima Colley,GAM,Atalanta,Serie A,2019,19.0,2000.0,0.9,2,1,1,0,1,1,2,50.0,1,1,0,1,1,3,0,0,FW,Under 20,Forward,Gambia,Africa
539,Omar Colley,GAM,Sampdoria,Serie A,2019,26.0,1992.0,30.8,42,26,27,14,1,12,24,50.0,12,33,22,11,59,101,155,1,DF,25-29,Defender,Gambia,Africa
540,Jamilu Collins,NGA,Paderborn 07,Bundesliga,2019,24.0,1994.0,29.6,69,43,44,21,4,37,62,59.7,25,53,19,34,70,139,91,1,DF,20-24,Defender,Nigeria,Africa
541,Simone Colombi,ITA,Parma,Serie A,2019,28.0,1991.0,4.0,0,0,0,0,0,0,0,,0,0,0,0,0,0,1,0,GK,25-29,Goalkeeper,Italy,Europe
542,Lorenzo Colombo,ITA,Milan,Serie A,2019,17.0,2002.0,0.1,0,0,0,0,0,0,0,,0,0,0,0,0,0,0,0,FW,Under 20,Forward,Italy,Europe
543,Racine Coly,SEN,Nice,Ligue 1,2019,23.0,1995.0,7.2,21,13,15,5,1,9,17,52.9,8,5,0,5,12,33,23,0,"DF,FW",20-24,Defender,Senegal,Africa
544,Kingsley Coman,FRA,Bayern Munich,Bundesliga,2019,23.0,1996.0,16.7,19,11,6,7,6,12,27,44.4,15,9,0,9,4,23,3,0,"FW,MF",20-24,Forward,France,Europe
545,Daniel Congré,FRA,Montpellier,Ligue 1,2019,34.0,1985.0,21.6,37,27,20,16,1,18,38,47.4,20,8,7,1,47,84,66,1,DF,30-34,Defender,France,Europe
546,Aaron Connolly,IRL,Brighton,Premier League,2019,19.0,2000.0,14.0,7,6,1,4,2,3,10,30.0,7,11,0,11,0,7,3,0,FW,Under 20,Forward,Republic of Ireland,Europe
547,Andrea Consigli,ITA,Sassuolo,Serie A,2019,32.0,1987.0,31.0,0,0,0,0,0,0,1,0.0,1,0,0,0,4,4,19,2,GK,30-34,Goalkeeper,Italy,Europe
548,Andrea Conti,ITA,Milan,Serie A,2019,25.0,1994.0,19.2,41,25,23,15,3,21,49,42.9,28,21,8,13,43,84,42,1,DF,25-29,Defender,Italy,Europe
549,Lewis Cook,ENG,Bournemouth,Premier League,2019,22.0,1997.0,15.0,27,14,15,9,3,10,47,21.3,37,17,5,12,17,44,17,1,"MF,FW",20-24,Midfielder,England,Europe
550,Steve Cook,ENG,Bournemouth,Premier League,2019,28.0,1991.0,27.0,22,11,18,4,0,8,20,40.0,12,32,23,9,44,66,153,1,DF,25-29,Defender,England,Europe
551,Francis Coquelin,FRA,Valencia,La Liga,2019,28.0,1991.0,21.2,37,21,25,11,1,16,38,42.1,22,19,9,10,38,75,25,0,MF,25-29,Midfielder,France,Europe
552,Gabriele Corbo,ITA,Bologna,Serie A,2019,19.0,2000.0,1.4,1,1,1,0,0,0,3,0.0,3,2,2,0,4,5,5,0,DF,Under 20,Defender,Italy,Europe
553,Sébastien Corchia,FRA,Espanyol,La Liga,2019,28.0,1990.0,3.0,2,1,2,0,0,2,4,50.0,2,5,2,3,5,7,8,0,DF,25-29,Defender,France,Europe
555,Jhon Córdoba,COL,Köln,Bundesliga,2019,26.0,1993.0,22.2,9,6,1,5,3,3,13,23.1,10,19,1,18,5,14,17,0,FW,25-29,Forward,Colombia,South America
556,Sergio Córdova,VEN,Augsburg,Bundesliga,2019,21.0,1997.0,4.1,3,0,0,2,1,1,10,10.0,9,0,0,0,0,3,3,0,FW,20-24,Forward,Venezuela,South America
557,Benjamin Corgnet,FRA,Strasbourg,Ligue 1,2019,32.0,1987.0,2.9,1,1,1,0,0,1,3,33.3,2,2,0,2,2,3,3,0,"MF,FW",30-34,Midfielder,France,Europe
558,Jack Cork,ENG,Burnley,Premier League,2019,30.0,1989.0,29.0,35,24,10,20,5,12,62,19.4,50,34,12,22,28,63,49,0,MF,30-34,Midfielder,England,Europe
559,Andreas Cornelius,DEN,Parma,Serie A,2019,26.0,1993.0,16.6,9,4,2,5,2,4,11,36.4,7,7,0,7,2,11,26,0,FW,25-29,Forward,Denmark,Europe
560,Maxwel Cornet,CIV,Lyon,Ligue 1,2019,22.0,1996.0,14.8,30,19,18,8,4,13,23,56.5,10,16,1,15,21,51,19,1,"FW,DF",20-24,Forward,Ivory Coast,Africa
561,Quentin Cornette,FRA,Amiens,Ligue 1,2019,25.0,1994.0,3.9,8,3,3,2,3,3,9,33.3,6,7,1,6,6,14,5,0,"FW,MF",25-29,Forward,France,Europe
562,Ángel Correa,ARG,Atlético Madrid,La Liga,2019,24.0,1995.0,22.9,25,9,7,9,9,9,36,25.0,27,23,5,18,14,39,21,0,"MF,FW",20-24,Midfielder,Argentina,South America
563,Joaquín Correa,ARG,Lazio,Serie A,2019,24.0,1994.0,22.2,13,7,3,7,3,5,24,20.8,19,5,1,4,7,20,10,0,FW,20-24,Forward,Argentina,South America
565,Edmilson Correia,GNB,Saint-Étienne,Ligue 1,2019,19.0,2000.0,0.5,0,0,0,0,0,0,1,0.0,1,1,0,1,1,1,0,0,"FW,DF",Under 20,Forward,Guinea-Bissau,Africa
566,Thierry Correia,POR,Valencia,La Liga,2019,20.0,1999.0,2.9,8,3,5,3,0,1,2,50.0,1,5,0,5,2,10,10,0,DF,20-24,Defender,Portugal,Europe
568,Danny da Costa,GER,Eint Frankfurt,Bundesliga,2019,26.0,1993.0,15.4,26,17,14,8,4,6,16,37.5,10,16,1,15,15,41,26,0,"DF,FW",25-29,Defender,Germany,Europe
570,Douglas Costa,BRA,Juventus,Serie A,2019,28.0,1990.0,8.9,2,1,1,1,0,1,12,8.3,11,7,0,7,5,7,5,0,"FW,MF",25-29,Forward,Brazil,South America
572,Angelo da Costa Júnior,BRA,Bologna,Serie A,2019,35.0,1983.0,1.0,0,0,0,0,0,0,0,,0,0,0,0,0,0,0,0,GK,35-39,Goalkeeper,Brazil,South America
573,Nuno da Costa,CPV,Strasbourg,Ligue 1,2019,28.0,1991.0,5.9,15,10,3,8,4,4,10,40.0,6,7,0,7,4,19,3,0,FW,25-29,Forward,Cape Verde,Africa
575,Benoît Costil,FRA,Bordeaux,Ligue 1,2019,32.0,1987.0,28.0,0,0,0,0,0,0,3,0.0,3,0,0,0,2,2,9,0,GK,30-34,Goalkeeper,France,Europe
576,Kalifa Coulibaly,MLI,Nantes,Ligue 1,2019,27.0,1991.0,18.0,11,7,0,5,6,3,5,60.0,2,3,1,2,6,17,32,0,FW,25-29,Forward,Mali,Africa
577,Senou Coulibaly,MLI,Dijon,Ligue 1,2019,24.0,1994.0,7.4,14,7,11,3,0,2,4,50.0,2,11,10,1,10,24,44,1,DF,20-24,Defender,Mali,Africa
578,Yoann Court,FRA,Brest,Ligue 1,2019,29.0,1990.0,16.3,48,26,28,17,3,20,64,31.3,44,21,0,21,15,63,14,0,"FW,MF",25-29,Forward,France,Europe
579,Thibaut Courtois,BEL,Real Madrid,La Liga,2019,27.0,1992.0,34.0,0,0,0,0,0,0,2,0.0,2,0,0,0,2,2,18,2,GK,25-29,Goalkeeper,Belgium,Europe
580,Philippe Coutinho,BRA,Bayern Munich,Bundesliga,2019,27.0,1992.0,15.7,21,15,1,13,7,2,13,15.4,11,9,2,7,6,27,0,0,"MF,FW",25-29,Midfielder,Brazil,South America
581,Nicolas Cozza,FRA,Montpellier,Ligue 1,2019,20.0,1999.0,6.2,5,5,3,2,0,2,3,66.7,1,8,6,2,9,14,18,0,DF,20-24,Defender,France,Europe
582,Alessio Cragno,ITA,Cagliari,Serie A,2019,25.0,1994.0,16.0,0,0,0,0,0,0,0,,0,0,0,0,0,0,10,0,GK,25-29,Goalkeeper,Italy,Europe
583,Aaron Cresswell,ENG,West Ham,Premier League,2019,29.0,1989.0,30.3,43,26,21,18,4,23,46,50.0,23,33,10,23,35,78,75,2,DF,25-29,Defender,England,Europe
584,Domenico Criscito,ITA,Genoa,Serie A,2019,32.0,1986.0,22.8,53,33,34,12,7,24,56,42.9,32,25,13,12,53,106,81,1,DF,30-34,Defender,Italy,Europe
585,Bryan Cristante,ITA,Roma,Serie A,2019,24.0,1995.0,18.0,25,15,6,14,5,8,27,29.6,19,13,4,9,22,47,23,0,MF,20-24,Midfielder,Italy,Europe
586,Sebastián Cristóforo,URU,Fiorentina,Serie A,2019,25.0,1993.0,1.0,5,5,2,2,1,1,5,20.0,4,2,1,1,1,6,0,0,MF,25-29,Midfielder,Uruguay,South America
587,Sebastián Cristóforo,URU,Eibar,La Liga,2019,25.0,1993.0,9.7,35,19,11,14,10,13,32,40.6,19,25,3,22,8,43,2,0,MF,25-29,Midfielder,Uruguay,South America
588,Juan Cuadrado,COL,Juventus,Serie A,2019,31.0,1988.0,29.5,67,43,32,28,7,35,62,56.5,27,22,8,14,35,102,47,0,"DF,FW",30-34,Defender,Colombia,South America
589,Cucho,COL,Mallorca,La Liga,2019,20.0,1999.0,16.5,15,8,6,8,1,6,21,28.6,15,14,1,13,10,25,15,0,"FW,MF",20-24,Forward,Colombia,South America
592,Jaume Cuéllar,BOL,SPAL,Serie A,2019,17.0,2001.0,0.8,1,0,0,0,1,0,1,0.0,1,0,0,0,0,1,0,0,"MF,FW",Under 20,Midfielder,Bolivia,South America
593,Mickaël Cuisance,FRA,Bayern Munich,Bundesliga,2019,19.0,1999.0,3.4,2,1,0,2,0,1,9,11.1,8,1,1,0,3,5,0,0,"MF,FW",Under 20,Midfielder,France,Europe
594,Matheus Cunha,BRA,Hertha BSC,Bundesliga,2019,20.0,1999.0,8.3,10,5,6,4,0,4,11,36.4,7,11,1,10,10,20,1,0,"FW,MF",20-24,Forward,Brazil,South America
595,Matheus Cunha,BRA,RB Leipzig,Bundesliga,2019,20.0,1999.0,3.1,6,2,0,1,5,0,2,0.0,2,5,1,4,1,7,0,0,"FW,MF",20-24,Forward,Brazil,South America
596,Felipe Curcio,BRA,Brescia,Serie A,2019,25.0,1993.0,0.1,0,0,0,0,0,0,0,,0,0,0,0,0,0,0,0,DF,25-29,Defender,Brazil,South America
597,Patrick Cutrone,ITA,Wolves,Premier League,2019,21.0,1998.0,3.3,4,2,2,1,1,1,5,20.0,4,1,1,0,2,6,1,0,FW,20-24,Forward,Italy,Europe
598,Patrick Cutrone,ITA,Fiorentina,Serie A,2019,21.0,1998.0,9.3,4,2,2,1,1,1,15,6.7,14,6,1,5,2,6,6,0,FW,20-24,Forward,Italy,Europe
599,Wylan Cyprien,FRA,Nice,Ligue 1,2019,24.0,1995.0,19.7,17,11,5,12,0,7,27,25.9,20,8,2,6,19,36,16,3,MF,20-24,Midfielder,France,Europe
600,Rafael Czichos,GER,Köln,Bundesliga,2019,29.0,1990.0,24.5,43,34,26,16,1,22,45,48.9,23,24,13,11,35,78,110,1,DF,25-29,Defender,Germany,Europe
601,Lennart-Marten Czyborra,GER,Atalanta,Serie A,2019,20.0,1999.0,0.2,0,0,0,0,0,0,0,,0,2,0,2,0,0,0,0,DF,20-24,Defender,Germany,Europe
602,Marco D'Alessandro,ITA,SPAL,Serie A,2019,28.0,1991.0,8.7,11,8,5,3,3,5,8,62.5,3,11,0,11,5,16,6,0,"MF,DF",25-29,Midfielder,Italy,Europe
603,Danilo D'Ambrosio,ITA,Inter,Serie A,2019,30.0,1988.0,15.6,30,16,16,12,2,16,33,48.5,17,15,4,11,14,44,25,0,DF,30-34,Defender,Italy,Europe
604,Felice D'Amico,ITA,Sampdoria,Serie A,2019,18.0,2000.0,0.0,1,1,0,0,1,0,0,,0,0,0,0,0,1,0,0,MF,Under 20,Midfielder,Italy,Europe
605,Lucas Da Cunha,FRA,Rennes,Ligue 1,2019,18.0,2001.0,0.8,1,0,1,0,0,1,1,100.0,0,0,0,0,0,1,0,0,MF,Under 20,Midfielder,France,Europe
606,Jacopo Da Riva,ITA,Atalanta,Serie A,2019,18.0,2000.0,0.0,0,0,0,0,0,0,0,,0,0,0,0,0,0,0,0,MF,Under 20,Midfielder,Italy,Europe
607,Damien Da Silva,FRA,Rennes,Ligue 1,2019,31.0,1988.0,24.9,27,14,20,5,2,10,19,52.6,9,21,13,8,26,53,143,1,DF,30-34,Defender,France,Europe
608,Moanes Dabbur,ISR,Sevilla,La Liga,2019,27.0,1992.0,0.3,1,1,0,0,1,0,0,,0,1,0,1,0,1,0,0,FW,25-29,Forward,Israel,Asia
609,Moanes Dabbur,ISR,Hoffenheim,Bundesliga,2019,27.0,1992.0,8.5,8,5,1,3,4,3,10,30.0,7,6,2,4,4,12,1,0,FW,25-29,Forward,Israel,Asia
610,Bryan Dabo,BFA,SPAL,Serie A,2019,27.0,1992.0,12.5,18,10,13,4,1,5,15,33.3,10,13,2,11,9,27,14,0,MF,25-29,Midfielder,Burkina Faso,Africa
611,Colin Dagba,FRA,Paris S-G,Ligue 1,2019,20.0,1998.0,7.4,10,4,2,4,4,5,9,55.6,4,6,1,5,6,16,9,0,DF,20-24,Defender,France,Europe
612,Mahmoud Dahoud,GER,Dortmund,Bundesliga,2019,23.0,1996.0,6.2,10,6,4,4,2,6,18,33.3,12,8,2,6,8,18,4,0,MF,20-24,Midfielder,Germany,Europe
613,Leon Dajaku,GER,Bayern Munich,Bundesliga,2019,18.0,2001.0,0.1,0,0,0,0,0,0,1,0.0,1,0,0,0,0,0,0,0,"DF,MF",Under 20,Defender,Germany,Europe
614,Felipe dal Belo,BRA,SPAL,Serie A,2019,35.0,1984.0,11.1,13,6,9,4,0,9,15,60.0,6,14,12,2,9,22,30,0,DF,35-39,Defender,Brazil,South America
615,Christian Dalle Mura,ITA,Fiorentina,Serie A,2019,17.0,2002.0,0.0,0,0,0,0,0,0,0,,0,0,0,0,0,0,0,0,FW,Under 20,Forward,Italy,Europe
616,Diogo Dalot,POR,Manchester Utd,Premier League,2019,20.0,1999.0,0.7,3,2,3,0,0,3,4,75.0,1,1,0,1,2,5,1,0,"DF,MF",20-24,Defender,Portugal,Europe
617,Charlie Daniels,ENG,Bournemouth,Premier League,2019,32.0,1986.0,1.4,1,1,0,1,0,0,1,0.0,1,2,0,2,1,2,5,1,DF,30-34,Defender,England,Europe
618,Danilo,BRA,Juventus,Serie A,2019,28.0,1991.0,16.0,30,20,16,12,2,18,30,60.0,12,12,3,9,26,56,44,0,DF,25-29,Defender,Brazil,South America
618,Danilo,BRA,Juventus,Serie A,2019,28.0,1991.0,16.0,30,20,16,12,2,18,30,60.0,12,12,3,9,26,56,44,0,DF,25-29,Defender,Brazil,South America
618,Danilo,BRA,Juventus,Serie A,2019,28.0,1991.0,16.0,30,20,16,12,2,18,30,60.0,12,12,3,9,26,56,44,0,DF,25-29,Defender,Brazil,South America
618,Danilo,BRA,Juventus,Serie A,2019,28.0,1991.0,16.0,30,20,16,12,2,18,30,60.0,12,12,3,9,26,56,44,0,DF,25-29,Defender,Brazil,South America
618,Danilo,BRA,Juventus,Serie A,2019,28.0,1991.0,16.0,30,20,16,12,2,18,30,60.0,12,12,3,9,26,56,44,0,DF,25-29,Defender,Brazil,South America
618,Danilo,BRA,Juventus,Serie A,2019,28.0,1991.0,16.0,30,20,16,12,2,18,30,60.0,12,12,3,9,26,56,44,0,DF,25-29,Defender,Brazil,South America
618,Danilo,BRA,Juventus,Serie A,2019,28.0,1991.0,16.0,30,20,16,12,2,18,30,60.0,12,12,3,9,26,56,44,0,DF,25-29,Defender,Brazil,South America
618,Danilo,BRA,Juventus,Serie A,2019,28.0,1991.0,16.0,30,20,16,12,2,18,30,60.0,12,12,3,9,26,56,44,0,DF,25-29,Defender,Brazil,South America
618,Danilo,BRA,Juventus,Serie A,2019,28.0,1991.0,16.0,30,20,16,12,2,18,30,60.0,12,12,3,9,26,56,44,0,DF,25-29,Defender,Brazil,South America
618,Danilo,BRA,Juventus,Serie A,2019,28.0,1991.0,16.0,30,20,16,12,2,18,30,60.0,12,12,3,9,26,56,44,0,DF,25-29,Defender,Brazil,South America
618,Danilo,BRA,Juventus,Serie A,2019,28.0,1991.0,16.0,30,20,16,12,2,18,30,60.0,12,12,3,9,26,56,44,0,DF,25-29,Defender,Brazil,South America
618,Danilo,BRA,Juventus,Serie A,2019,28.0,1991.0,16.0,30,20,16,12,2,18,30,60.0,12,12,3,9,26,56,44,0,DF,25-29,Defender,Brazil,South America
618,Danilo,BRA,Juventus,Serie A,2019,28.0,1991.0,16.0,30,20,16,12,2,18,30,60.0,12,12,3,9,26,56,44,0,DF,25-29,Defender,Brazil,South America
618,Danilo,BRA,Juventus,Serie A,2019,28.0,1991.0,16.0,30,20,16,12,2,18,30,60.0,12,12,3,9,26,56,44,0,DF,25-29,Defender,Brazil,South America
618,Danilo,BRA,Juventus,Serie A,2019,28.0,1991.0,16.0,30,20,16,12,2,18,30,60.0,12,12,3,9,26,56,44,0,DF,25-29,Defender,Brazil,South America
618,Danilo,BRA,Juventus,Serie A,2019,28.0,1991.0,16.0,30,20,16,12,2,18,30,60.0,12,12,3,9,26,56,44,0,DF,25-29,Defender,Brazil,South America
618,Danilo,BRA,Juventus,Serie A,2019,28.0,1991.0,16.0,30,20,16,12,2,18,30,60.0,12,12,3,9,26,56,44,0,DF,25-29,Defender,Brazil,South America
618,Danilo,BRA,Juventus,Serie A,2019,28.0,1991.0,16.0,30,20,16,12,2,18,30,60.0,12,12,3,9,26,56,44,0,DF,25-29,Defender,Brazil,South America
618,Danilo,BRA,Juventus,Serie A,2019,28.0,1991.0,16.0,30,20,16,12,2,18,30,60.0,12,12,3,9,26,56,44,0,DF,25-29,Defender,Brazil,South America
618,Danilo,BRA,Juventus,Serie A,2019,28.0,1991.0,16.0,30,20,16,12,2,18,30,60.0,12,12,3,9,26,56,44,0,DF,25-29,Defender,Brazil,South America
618,Danilo,BRA,Juventus,Serie A,2019,28.0,1991.0,16.0,30,20,16,12,2,18,30,60.0,12,12,3,9,26,56,44,0,DF,25-29,Defender,Brazil,South America
618,Danilo,BRA,Juventus,Serie A,2019,28.0,1991.0,16.0,30,20,16,12,2,18,30,60.0,12,12,3,9,26,56,44,0,DF,25-29,Defender,Brazil,South America
618,Danilo,BRA,Juventus,Serie A,2019,28.0,1991.0,16.0,30,20,16,12,2,18,30,60.0,12,12,3,9,26,56,44,0,DF,25-29,Defender,Brazil,South America
618,Danilo,BRA,Juventus,Serie A,2019,28.0,1991.0,16.0,30,20,16,12,2,18,30,60.0,12,12,3,9,26,56,44,0,DF,25-29,Defender,Brazil,South America
618,Danilo,BRA,Juventus,Serie A,2019,28.0,1991.0,16.0,30,20,16,12,2,18,30,60.0,12,12,3,9,26,56,44,0,DF,25-29,Defender,Brazil,South America
618,Danilo,BRA,Juventus,Serie A,2019,28.0,1991.0,16.0,30,20,16,12,2,18,30,60.0,12,12,3,9,26,56,44,0,DF,25-29,Defender,Brazil,South America
618,Danilo,BRA,Juventus,Serie A,2019,28.0,1991.0,16.0,30,20,16,12,2,18,30,60.0,12,12,3,9,26,56,44,0,DF,25-29,Defender,Brazil,South America
618,Danilo,BRA,Juventus,Serie A,2019,28.0,1991.0,16.0,30,20,16,12,2,18,30,60.0,12,12,3,9,26,56,44,0,DF,25-29,Defender,Brazil,South America
618,Danilo,BRA,Juventus,Serie A,2019,28.0,1991.0,16.0,30,20,16,12,2,18,30,60.0,12,12,3,9,26,56,44,0,DF,25-29,Defender,Brazil,South America
618,Danilo,BRA,Juventus,Serie A,2019,28.0,1991.0,16.0,30,20,16,12,2,18,30,60.0,12,12,3,9,26,56,44,0,DF,25-29,Defender,Brazil,South America
618,Danilo,BRA,Juventus,Serie A,2019,28.0,1991.0,16.0,30,20,16,12,2,18,30,60.0,12,12,3,9,26,56,44,0,DF,25-29,Defender,Brazil,South America
618,Danilo,BRA,Juventus,Serie A,2019,28.0,1991.0,16.0,30,20,16,12,2,18,30,60.0,12,12,3,9,26,56,44,0,DF,25-29,Defender,Brazil,South America
618,Danilo,BRA,Juventus,Serie A,2019,28.0,1991.0,16.0,30,20,16,12,2,18,30,60.0,12,12,3,9,26,56,44,0,DF,25-29,Defender,Brazil,South America
618,Danilo,BRA,Juventus,Serie A,2019,28.0,1991.0,16.0,30,20,16,12,2,18,30,60.0,12,12,3,9,26,56,44,0,DF,25-29,Defender,Brazil,South America
618,Danilo,BRA,Juventus,Serie A,2019,28.0,1991.0,16.0,30,20,16,12,2,18,30,60.0,12,12,3,9,26,56,44,0,DF,25-29,Defender,Brazil,South America
618,Danilo,BRA,Juventus,Serie A,2019,28.0,1991.0,16.0,30,20,16,12,2,18,30,60.0,12,12,3,9,26,56,44,0,DF,25-29,Defender,Brazil,South America
618,Danilo,BRA,Juventus,Serie A,2019,28.0,1991.0,16.0,30,20,16,12,2,18,30,60.0,12,12,3,9,26,56,44,0,DF,25-29,Defender,Brazil,South America
618,Danilo,BRA,Juventus,Serie A,2019,28.0,1991.0,16.0,30,20,16,12,2,18,30,60.0,12,12,3,9,26,56,44,0,DF,25-29,Defender,Brazil,South America
618,Danilo,BRA,Juventus,Serie A,2019,28.0,1991.0,16.0,30,20,16,12,2,18,30,60.0,12,12,3,9,26,56,44,0,DF,25-29,Defender,Brazil,South America
618,Danilo,BRA,Juventus,Serie A,2019,28.0,1991.0,16.0,30,20,16,12,2,18,30,60.0,12,12,3,9,26,56,44,0,DF,25-29,Defender,Brazil,South America
618,Danilo,BRA,Juventus,Serie A,2019,28.0,1991.0,16.0,30,20,16,12,2,18,30,60.0,12,12,3,9,26,56,44,0,DF,25-29,Defender,Brazil,South America
618,Danilo,BRA,Juventus,Serie A,2019,28.0,1991.0,16.0,30,20,16,12,2,18,30,60.0,12,12,3,9,26,56,44,0,DF,25-29,Defender,Brazil,South America
618,Danilo,BRA,Juventus,Serie A,2019,28.0,1991.0,16.0,30,20,16,12,2,18,30,60.0,12,12,3,9,26,56,44,0,DF,25-29,Defender,Brazil,South America
618,Danilo,BRA,Juventus,Serie A,2019,28.0,1991.0,16.0,30,20,16,12,2,18,30,60.0,12,12,3,9,26,56,44,0,DF,25-29,Defender,Brazil,South America
618,Danilo,BRA,Juventus,Serie A,2019,28.0,1991.0,16.0,30,20,16,12,2,18,30,60.0,12,12,3,9,26,56,44,0,DF,25-29,Defender,Brazil,South America
618,Danilo,BRA,Juventus,Serie A,2019,28.0,1991.0,16.0,30,20,16,12,2,18,30,60.0,12,12,3,9,26,56,44,0,DF,25-29,Defender,Brazil,South America
618,Danilo,BRA,Juventus,Serie A,2019,28.0,1991.0,16.0,30,20,16,12,2,18,30,60.0,12,12,3,9,26,56,44,0,DF,25-29,Defender,Brazil,South America
618,Danilo,BRA,Juventus,Serie A,2019,28.0,1991.0,16.0,30,20,16,12,2,18,30,60.0,12,12,3,9,26,56,44,0,DF,25-29,Defender,Brazil,South America
618,Danilo,BRA,Juventus,Serie A,2019,28.0,1991.0,16.0,30,20,16,12,2,18,30,60.0,12,12,3,9,26,56,44,0,DF,25-29,Defender,Brazil,South America
619,Arnaut Danjuma,NED,Bournemouth,Premier League,2019,22.0,1997.0,7.0,4,2,3,1,0,1,4,25.0,3,2,0,2,8,12,4,1,MF,20-24,Midfielder,Netherlands,Europe
620,Scott Dann,ENG,Crystal Palace,Premier League,2019,32.0,1987.0,14.1,8,4,7,1,0,8,14,57.1,6,9,7,2,14,22,67,0,DF,30-34,Defender,England,Europe
621,Kevin Danso,AUT,Southampton,Premier League,2019,20.0,1998.0,3.1,6,4,3,3,0,4,7,57.1,3,7,3,4,2,8,7,0,DF,20-24,Defender,Austria,Europe
622,Dante,BRA,Nice,Ligue 1,2019,35.0,1983.0,21.0,34,21,24,10,0,17,25,68.0,8,27,16,11,26,60,79,0,DF,35-39,Defender,Brazil,South America
623,Andrea Danzi,ITA,Hellas Verona,Serie A,2019,20.0,1999.0,0.0,0,0,0,0,0,0,0,,0,0,0,0,0,0,0,0,MF,20-24,Midfielder,Italy,Europe
626,Matteo Darmian,ITA,Parma,Serie A,2019,29.0,1989.0,29.8,81,42,48,30,3,40,83,48.2,43,38,16,22,25,106,78,1,DF,25-29,Defender,Italy,Europe
627,Alphonso Davies,CAN,Bayern Munich,Bundesliga,2019,18.0,2000.0,24.8,70,43,35,24,11,38,58,65.5,20,35,6,29,31,101,51,0,DF,Under 20,Defender,Canada,North America
628,Ben Davies,WAL,Tottenham,Premier League,2019,26.0,1993.0,15.9,28,15,13,11,4,7,21,33.3,14,28,12,16,22,50,47,0,DF,25-29,Defender,Wales,Europe
628,Ben Davies,WAL,Tottenham,Premier League,2019,26.0,1993.0,15.9,28,15,13,11,4,7,21,33.3,14,28,12,16,22,50,47,0,DF,25-29,Defender,Wales,Europe
628,Ben Davies,WAL,Tottenham,Premier League,2019,26.0,1993.0,15.9,28,15,13,11,4,7,21,33.3,14,28,12,16,22,50,47,0,DF,25-29,Defender,Wales,Europe
628,Ben Davies,WAL,Tottenham,Premier League,2019,26.0,1993.0,15.9,28,15,13,11,4,7,21,33.3,14,28,12,16,22,50,47,0,DF,25-29,Defender,Wales,Europe
629,Tom Davies,ENG,Everton,Premier League,2019,21.0,1998.0,22.5,38,17,12,22,4,17,55,30.9,38,12,4,8,35,73,28,0,MF,20-24,Midfielder,England,Europe
629,Tom Davies,ENG,Everton,Premier League,2019,21.0,1998.0,22.5,38,17,12,22,4,17,55,30.9,38,12,4,8,35,73,28,0,MF,20-24,Midfielder,England,Europe
629,Tom Davies,ENG,Everton,Premier League,2019,21.0,1998.0,22.5,38,17,12,22,4,17,55,30.9,38,12,4,8,35,73,28,0,MF,20-24,Midfielder,England,Europe
629,Tom Davies,ENG,Everton,Premier League,2019,21.0,1998.0,22.5,38,17,12,22,4,17,55,30.9,38,12,4,8,35,73,28,0,MF,20-24,Midfielder,England,Europe
630,Keinan Davis,ENG,Aston Villa,Premier League,2019,21.0,1998.0,6.1,1,1,0,1,0,0,3,0.0,3,4,0,4,0,1,3,0,FW,20-24,Forward,England,Europe
632,Craig Dawson,ENG,Watford,Premier League,2019,29.0,1990.0,26.2,29,18,16,13,0,17,31,54.8,14,41,32,9,34,63,116,0,DF,25-29,Defender,England,Europe
633,Kevin De Bruyne,BEL,Manchester City,Premier League,2019,28.0,1991.0,31.0,45,24,8,20,17,18,66,27.3,48,26,4,22,18,63,24,2,MF,25-29,Midfielder,Belgium,Europe
634,Sebastien De Maio,FRA,Udinese,Serie A,2019,32.0,1987.0,16.7,18,11,11,7,0,7,11,63.6,4,28,20,8,32,50,86,2,DF,30-34,Defender,France,Europe
635,Rodrigo De Paul,ARG,Udinese,Serie A,2019,25.0,1994.0,31.4,61,31,31,26,4,27,65,41.5,38,38,3,35,29,90,8,1,MF,25-29,Midfielder,Argentina,South America
636,Mattia De Sciglio,ITA,Juventus,Serie A,2019,26.0,1992.0,5.2,10,8,6,4,0,6,14,42.9,8,5,2,3,8,18,18,1,DF,25-29,Defender,Italy,Europe
637,Lorenzo De Silvestri,ITA,Torino,Serie A,2019,31.0,1988.0,24.9,15,8,4,7,4,11,27,40.7,16,20,7,13,19,34,72,0,DF,30-34,Defender,Italy,Europe
638,Lucas Deaux,FRA,Nîmes,Ligue 1,2019,30.0,1988.0,14.8,49,26,16,29,4,16,45,35.6,29,20,4,16,15,64,19,0,MF,30-34,Midfielder,France,Europe
639,Mathieu Debuchy,FRA,Saint-Étienne,Ligue 1,2019,34.0,1985.0,19.7,44,26,22,15,7,24,47,51.1,23,21,11,10,43,87,59,0,DF,30-34,Defender,France,Europe
640,Troy Deeney,ENG,Watford,Premier League,2019,31.0,1988.0,24.7,19,12,6,10,3,6,29,20.7,23,13,1,12,11,30,27,0,FW,30-34,Forward,England,Europe
642,Alessandro Deiola,ITA,Cagliari,Serie A,2019,23.0,1995.0,0.0,0,0,0,0,0,0,0,,0,0,0,0,1,1,0,0,MF,20-24,Midfielder,Italy,Europe
643,Alessandro Deiola,ITA,Lecce,Serie A,2019,23.0,1995.0,8.0,16,9,9,7,0,9,24,37.5,15,12,4,8,8,24,14,1,MF,20-24,Midfielder,Italy,Europe
644,Romain Del Castillo,FRA,Rennes,Ligue 1,2019,23.0,1996.0,13.8,20,14,5,11,4,6,27,22.2,21,12,2,10,7,27,7,0,"FW,MF",20-24,Forward,France,Europe
645,Thomas Delaine,FRA,Metz,Ligue 1,2019,27.0,1992.0,13.9,25,16,18,6,1,12,21,57.1,9,17,1,16,15,40,28,0,DF,25-29,Defender,France,Europe
646,Thomas Delaney,DEN,Dortmund,Bundesliga,2019,27.0,1991.0,9.2,22,10,10,11,1,9,15,60.0,6,16,7,9,26,48,26,0,MF,25-29,Midfielder,Denmark,Europe
647,Paul Delecroix,FRA,Metz,Ligue 1,2019,30.0,1988.0,1.5,0,0,0,0,0,0,0,,0,0,0,0,0,0,0,0,GK,30-34,Goalkeeper,France,Europe
648,Cristian Dell'Orco,ITA,Lecce,Serie A,2019,25.0,1994.0,11.2,22,12,14,7,1,8,14,57.1,6,11,7,4,16,38,33,0,DF,25-29,Defender,Italy,Europe
649,Andy Delort,ALG,Montpellier,Ligue 1,2019,27.0,1991.0,25.3,28,18,11,9,8,7,27,25.9,20,21,6,15,3,31,10,0,FW,25-29,Forward,Algeria,Africa
650,Fabian Delph,ENG,Everton,Premier League,2019,29.0,1989.0,13.2,26,12,10,13,3,9,22,40.9,13,12,3,9,15,41,19,1,MF,25-29,Midfielder,England,Europe
651,Moussa Dembélé,FRA,Lyon,Ligue 1,2019,23.0,1996.0,24.3,12,7,2,5,5,4,14,28.6,10,14,3,11,5,17,31,0,FW,20-24,Forward,France,Europe
652,Ousmane Dembélé,FRA,Barcelona,La Liga,2019,22.0,1997.0,4.0,2,2,1,1,0,2,5,40.0,3,4,0,4,0,2,0,1,FW,20-24,Forward,France,Europe
653,Merih Demiral,TUR,Juventus,Serie A,2019,21.0,1998.0,4.6,8,7,5,3,0,1,3,33.3,2,4,3,1,4,12,16,1,DF,20-24,Defender,Turkey,Asia
654,Kerem Demirbay,GER,Leverkusen,Bundesliga,2019,26.0,1993.0,17.5,35,19,10,21,4,12,31,38.7,19,19,5,14,22,57,7,1,MF,25-29,Midfielder,Germany,Europe
655,Diego Demme,GER,Napoli,Serie A,2019,27.0,1991.0,10.0,18,8,14,3,1,8,23,34.8,15,9,1,8,8,26,9,0,MF,25-29,Midfielder,Germany,Europe
656,Diego Demme,GER,RB Leipzig,Bundesliga,2019,27.0,1991.0,13.5,41,18,17,19,5,17,42,40.5,25,14,2,12,15,56,14,0,MF,25-29,Midfielder,Germany,Europe
657,Jason Denayer,BEL,Lyon,Ligue 1,2019,24.0,1995.0,23.7,17,13,12,5,0,10,14,71.4,4,32,29,3,20,37,83,0,DF,20-24,Defender,Belgium,Europe
658,Leander Dendoncker,BEL,Wolves,Premier League,2019,24.0,1995.0,31.1,68,31,41,19,8,28,67,41.8,39,39,12,27,38,106,64,2,"MF,DF",20-24,Midfielder,Belgium,Europe
660,Stefano Denswil,SUR,Bologna,Serie A,2019,26.0,1993.0,24.9,49,28,29,19,1,26,44,59.1,18,23,8,15,31,80,68,0,DF,25-29,Defender,Suriname,South America
661,Fabio Depaoli,ITA,Sampdoria,Serie A,2019,22.0,1997.0,20.6,41,28,26,10,5,17,31,54.8,14,29,3,26,16,57,39,0,"MF,DF",20-24,Midfielder,Italy,Europe
662,Kastriot Dermaku,ALB,Parma,Serie A,2019,27.0,1992.0,11.4,13,5,10,3,0,3,5,60.0,2,20,16,4,12,25,61,1,DF,25-29,Defender,Albania,Europe
663,Daniele Dessena,ITA,Brescia,Serie A,2019,32.0,1987.0,20.8,21,11,5,14,2,6,25,24.0,19,11,1,10,11,32,21,0,MF,30-34,Midfielder,Italy,Europe
664,Mattia Destro,ITA,Bologna,Serie A,2019,28.0,1991.0,2.1,3,2,1,2,0,1,3,33.3,2,1,0,1,0,3,0,0,FW,25-29,Forward,Italy,Europe
665,Mattia Destro,ITA,Genoa,Serie A,2019,28.0,1991.0,1.7,0,0,0,0,0,0,0,,0,0,0,0,0,0,1,0,"FW,MF",25-29,Forward,Italy,Europe
667,Deyverson,BRA,Getafe,La Liga,2019,28.0,1991.0,2.3,0,0,0,0,0,0,1,0.0,1,2,1,1,0,0,5,0,FW,25-29,Forward,Brazil,South America
668,Samuel Di Carmine,ITA,Hellas Verona,Serie A,2019,30.0,1988.0,14.4,2,1,0,0,2,0,8,0.0,8,3,0,3,1,3,10,0,"FW,MF",30-34,Forward,Italy,Europe
669,Federico Di Francesco,ITA,SPAL,Serie A,2019,25.0,1994.0,12.0,11,5,2,6,3,3,15,20.0,12,9,1,8,3,14,2,1,FW,25-29,Forward,Italy,Europe
670,Giovanni Di Lorenzo,ITA,Napoli,Serie A,2019,25.0,1993.0,33.0,59,35,27,19,13,32,61,52.5,29,27,11,16,28,87,54,0,DF,25-29,Defender,Italy,Europe
671,Ángel Di María,ARG,Paris S-G,Ligue 1,2019,31.0,1988.0,22.2,17,12,2,8,7,4,34,11.8,30,14,3,11,11,28,1,3,"FW,MF",30-34,Forward,Argentina,South America
672,Boulaye Dia,SEN,Reims,Ligue 1,2019,22.0,1996.0,20.1,15,9,7,6,2,3,10,30.0,7,9,2,7,7,22,16,0,FW,20-24,Forward,Senegal,Africa
673,Fousseni Diabaté,MLI,Amiens,Ligue 1,2019,23.0,1995.0,13.2,16,10,6,6,4,5,16,31.3,11,11,0,11,8,24,3,1,"FW,MF",20-24,Forward,Mali,Africa
674,Moussa Diaby,FRA,Leverkusen,Bundesliga,2019,20.0,1999.0,19.7,10,8,3,7,0,5,15,33.3,10,6,0,6,9,19,4,0,"FW,MF",20-24,Forward,France,Europe
675,Mouctar Diakhaby,GUI,Valencia,La Liga,2019,22.0,1996.0,16.0,11,8,7,3,1,5,8,62.5,3,17,15,2,11,22,73,0,DF,20-24,Defender,Guinea,Africa
676,Bafodé Diakité,FRA,Toulouse,Ligue 1,2019,18.0,2001.0,15.2,23,19,15,8,0,7,13,53.8,6,18,9,9,20,43,75,0,DF,Under 20,Defender,France,Europe
677,Abdou Diallo,SEN,Paris S-G,Ligue 1,2019,23.0,1996.0,13.3,20,11,9,10,1,8,14,57.1,6,9,5,4,10,30,32,0,DF,20-24,Defender,Senegal,Africa
678,Amad Diallo,CIV,Atalanta,Serie A,2019,17.0,2002.0,0.3,1,1,0,1,0,0,0,,0,0,0,0,0,1,0,0,FW,Under 20,Forward,Ivory Coast,Africa
679,Habib Diallo,SEN,Metz,Ligue 1,2019,24.0,1995.0,24.4,2,1,0,2,0,0,6,0.0,6,6,5,1,4,6,43,0,FW,20-24,Forward,Senegal,Africa
680,Ibrahima Diallo,FRA,Brest,Ligue 1,2019,20.0,1999.0,17.3,38,24,15,22,1,12,29,41.4,17,9,2,7,23,61,16,3,MF,20-24,Midfielder,France,Europe
680,Ibrahima Diallo,FRA,Brest,Ligue 1,2019,20.0,1999.0,17.3,38,24,15,22,1,12,29,41.4,17,9,2,7,23,61,16,3,MF,20-24,Midfielder,France,Europe
680,Ibrahima Diallo,FRA,Brest,Ligue 1,2019,20.0,1999.0,17.3,38,24,15,22,1,12,29,41.4,17,9,2,7,23,61,16,3,MF,20-24,Midfielder,France,Europe
680,Ibrahima Diallo,FRA,Brest,Ligue 1,2019,20.0,1999.0,17.3,38,24,15,22,1,12,29,41.4,17,9,2,7,23,61,16,3,MF,20-24,Midfielder,France,Europe
680,Ibrahima Diallo,FRA,Brest,Ligue 1,2019,20.0,1999.0,17.3,38,24,15,22,1,12,29,41.4,17,9,2,7,23,61,16,3,MF,20-24,Midfielder,France,Europe
680,Ibrahima Diallo,FRA,Brest,Ligue 1,2019,20.0,1999.0,17.3,38,24,15,22,1,12,29,41.4,17,9,2,7,23,61,16,3,MF,20-24,Midfielder,France,Europe
680,Ibrahima Diallo,FRA,Brest,Ligue 1,2019,20.0,1999.0,17.3,38,24,15,22,1,12,29,41.4,17,9,2,7,23,61,16,3,MF,20-24,Midfielder,France,Europe
680,Ibrahima Diallo,FRA,Brest,Ligue 1,2019,20.0,1999.0,17.3,38,24,15,22,1,12,29,41.4,17,9,2,7,23,61,16,3,MF,20-24,Midfielder,France,Europe
680,Ibrahima Diallo,FRA,Brest,Ligue 1,2019,20.0,1999.0,17.3,38,24,15,22,1,12,29,41.4,17,9,2,7,23,61,16,3,MF,20-24,Midfielder,France,Europe
681,Moussa Diarra,MLI,Toulouse,Ligue 1,2019,18.0,2000.0,1.0,3,3,2,1,0,1,1,100.0,0,0,0,0,3,6,2,0,DF,Under 20,Defender,Mali,Africa
682,Lucas Dias,FRA,Nîmes,Ligue 1,2019,20.0,1999.0,3.5,1,1,1,0,0,1,1,100.0,0,0,0,0,0,1,2,0,GK,20-24,Goalkeeper,France,Europe
683,Amadou Diawara,GUI,Roma,Serie A,2019,22.0,1997.0,16.9,40,25,14,20,6,8,30,26.7,22,10,1,9,33,73,16,2,MF,20-24,Midfielder,Guinea,Africa
684,Brahim Díaz,MAR,Real Madrid,La Liga,2019,19.0,1999.0,0.7,1,0,0,1,0,0,2,0.0,2,2,0,2,0,1,0,0,FW,Under 20,Forward,Morocco,Africa
686,Bakaye Dibassy,MLI,Amiens,Ligue 1,2019,29.0,1989.0,20.8,26,14,17,8,1,15,20,75.0,5,29,18,11,37,63,78,2,DF,25-29,Defender,Mali,Africa
687,Eric Dier,ENG,Tottenham,Premier League,2019,25.0,1994.0,14.9,21,12,10,10,1,10,20,50.0,10,14,9,5,21,42,65,0,"DF,MF",25-29,Defender,England,Europe
688,Lucas Digne,FRA,Everton,Premier League,2019,26.0,1993.0,33.7,73,49,49,19,5,33,68,48.5,35,39,10,29,42,115,108,0,DF,25-29,Defender,France,Europe
689,Mitchell Dijks,NED,Bologna,Serie A,2019,26.0,1993.0,11.2,13,10,6,5,2,8,12,66.7,4,5,1,4,10,23,23,0,DF,25-29,Defender,Netherlands,Europe
690,Javairô Dilrosun,NED,Hertha BSC,Bundesliga,2019,21.0,1998.0,14.5,15,8,11,1,3,5,13,38.5,8,20,0,20,18,33,10,0,"MF,FW",20-24,Midfielder,Netherlands,Europe
691,Federico Dimarco,ITA,Hellas Verona,Serie A,2019,21.0,1997.0,5.8,11,5,4,4,3,6,10,60.0,4,3,2,1,4,15,11,0,DF,20-24,Defender,Italy,Europe
692,Federico Dimarco,ITA,Inter,Serie A,2019,21.0,1997.0,0.3,1,0,0,1,0,0,0,,0,0,0,0,1,2,1,0,DF,20-24,Defender,Italy,Europe
693,Tristan Dingomé,CMR,Reims,Ligue 1,2019,28.0,1991.0,9.9,10,4,3,6,1,2,12,16.7,10,6,0,6,6,16,1,0,MF,25-29,Midfielder,Cameroon,Africa
694,Lois Diony,FRA,Saint-Étienne,Ligue 1,2019,26.0,1992.0,7.4,15,5,0,11,4,5,9,55.6,4,3,0,3,1,16,0,0,FW,25-29,Forward,France,Europe
695,Issa Diop,FRA,West Ham,Premier League,2019,22.0,1997.0,30.7,27,15,18,9,0,16,25,64.0,9,37,21,16,47,74,166,2,DF,20-24,Defender,France,Europe
696,Papakouli Diop,SEN,Eibar,La Liga,2019,33.0,1986.0,25.0,39,26,13,22,4,18,42,42.9,24,24,7,17,34,73,38,0,MF,30-34,Midfielder,Senegal,Africa
697,Assane Dioussé,SEN,Saint-Étienne,Ligue 1,2019,21.0,1997.0,1.3,1,1,0,1,0,0,3,0.0,3,0,0,0,0,1,2,0,MF,20-24,Midfielder,Senegal,Africa
698,Axel Disasi,FRA,Reims,Ligue 1,2019,21.0,1998.0,27.0,32,21,18,13,1,17,27,63.0,10,29,24,5,26,58,97,0,DF,20-24,Defender,France,Europe
699,Tiago Djaló,POR,Lille,Ligue 1,2019,19.0,2000.0,7.3,9,4,5,3,1,2,7,28.6,5,3,2,1,11,20,28,0,DF,Under 20,Defender,Portugal,Europe
701,Moussa Djenepo,MLI,Southampton,Premier League,2019,21.0,1998.0,10.3,27,21,13,9,5,11,21,52.4,10,15,1,14,9,36,9,0,"MF,DF",20-24,Midfielder,Mali,Africa
702,Koffi Djidji,CIV,Torino,Serie A,2019,26.0,1992.0,9.5,27,12,19,8,0,8,18,44.4,10,28,23,5,15,42,53,1,DF,25-29,Defender,Ivory Coast,Africa
703,Alexander Djiku,GHA,Strasbourg,Ligue 1,2019,24.0,1994.0,22.9,46,32,27,19,0,21,29,72.4,8,14,8,6,55,101,82,4,"DF,MF",20-24,Defender,Ghana,Africa
704,Berat Djimsiti,ALB,Atalanta,Serie A,2019,26.0,1993.0,30.9,42,23,17,23,2,22,39,56.4,17,21,14,7,49,91,92,0,DF,25-29,Defender,Albania,Europe
705,Naïs Djouahra,FRA,Real Sociedad,La Liga,2019,19.0,1999.0,0.3,0,0,0,0,0,0,0,,0,0,0,0,0,0,0,0,FW,Under 20,Forward,France,Europe
707,Matt Doherty,IRL,Wolves,Premier League,2019,27.0,1992.0,31.5,55,29,34,17,4,27,41,65.9,14,34,4,30,40,95,52,1,"MF,DF",25-29,Midfielder,Republic of Ireland,Europe
708,Kasper Dolberg,DEN,Nice,Ligue 1,2019,21.0,1997.0,21.0,10,6,0,3,7,4,17,23.5,13,18,2,16,10,20,24,0,FW,20-24,Forward,Denmark,Europe
709,Keagan Dolly,RSA,Montpellier,Ligue 1,2019,26.0,1993.0,1.6,6,3,1,3,2,2,5,40.0,3,1,0,1,1,7,0,0,MF,25-29,Midfielder,South Africa,Africa
711,Nicolás Domínguez,ARG,Bologna,Serie A,2019,21.0,1998.0,7.8,21,14,15,5,1,7,18,38.9,11,12,2,10,12,33,7,0,MF,20-24,Midfielder,Argentina,South America
712,Giulio Donati,ITA,Lecce,Serie A,2019,29.0,1990.0,19.6,32,21,22,8,2,15,28,53.6,13,19,10,9,25,57,42,0,DF,25-29,Defender,Italy,Europe
713,Ji Dong-won,KOR,Mainz 05,Bundesliga,2019,28.0,1991.0,1.1,0,0,0,0,0,0,1,0.0,1,1,0,1,0,0,0,0,"FW,MF",25-29,Forward,South Korea,Asia
714,Anastasios Donis,GRE,Reims,Ligue 1,2019,22.0,1996.0,6.8,3,2,2,1,0,1,9,11.1,8,2,0,2,1,4,3,0,FW,20-24,Forward,Greece,Europe
715,Alfredo Donnarumma,ITA,Brescia,Serie A,2019,28.0,1990.0,18.7,17,9,3,9,5,6,18,33.3,12,7,0,7,5,22,1,0,FW,25-29,Forward,Italy,Europe
716,Gianluigi Donnarumma,ITA,Milan,Serie A,2019,20.0,1999.0,35.6,1,0,1,0,0,1,2,50.0,1,0,0,0,3,4,25,7,GK,20-24,Goalkeeper,Italy,Europe
718,Bas Dost,NED,Eint Frankfurt,Bundesliga,2019,30.0,1989.0,16.4,11,7,1,7,3,3,7,42.9,4,6,2,4,5,16,22,0,FW,30-34,Forward,Netherlands,Europe
719,Abdoulaye Doucouré,MLI,Watford,Premier League,2019,26.0,1993.0,35.1,64,30,29,29,6,16,57,28.1,41,46,8,38,31,95,32,0,MF,25-29,Midfielder,Mali,Africa
720,Mamadou Doucouré,FRA,Gladbach,Bundesliga,2019,21.0,1998.0,0.0,0,0,0,0,0,0,0,,0,0,0,0,0,0,0,0,MF,20-24,Midfielder,France,Europe
721,Moussa Doumbia,MLI,Reims,Ligue 1,2019,24.0,1994.0,19.1,16,8,5,6,5,7,24,29.2,17,14,1,13,9,25,5,0,"FW,MF",20-24,Forward,Mali,Africa
722,Souleyman Doumbia,CIV,Angers,Ligue 1,2019,22.0,1996.0,5.0,10,4,7,2,1,5,6,83.3,1,5,0,5,6,16,18,0,DF,20-24,Defender,Ivory Coast,Africa
723,Souleyman Doumbia,CIV,Rennes,Ligue 1,2019,22.0,1996.0,1.0,1,1,1,0,0,1,1,100.0,0,2,2,0,0,1,3,0,DF,20-24,Defender,Ivory Coast,Africa
724,Tommy Doyle,ENG,Manchester City,Premier League,2019,17.0,2001.0,0.2,0,0,0,0,0,0,1,0.0,1,0,0,0,0,0,0,0,MF,Under 20,Midfielder,England,Europe
725,Mohamed Dräger,TUN,Paderborn 07,Bundesliga,2019,23.0,1996.0,16.2,32,21,22,8,2,14,33,42.4,19,17,5,12,18,50,39,0,DF,20-24,Defender,Tunisia,Africa
726,Aleksandar Dragović,AUT,Leverkusen,Bundesliga,2019,28.0,1991.0,11.4,18,11,11,6,1,10,21,47.6,11,9,3,6,15,33,39,0,DF,25-29,Defender,Austria,Europe
728,Julian Draxler,GER,Paris S-G,Ligue 1,2019,25.0,1993.0,7.6,13,10,2,9,2,7,15,46.7,8,7,1,6,10,23,1,0,MF,25-29,Midfielder,Germany,Europe
729,Dominick Drexler,GER,Köln,Bundesliga,2019,29.0,1990.0,17.6,34,25,12,19,3,8,32,25.0,24,11,5,6,26,60,11,0,"MF,FW",25-29,Midfielder,Germany,Europe
730,Danny Drinkwater,ENG,Aston Villa,Premier League,2019,29.0,1990.0,2.9,5,3,3,2,0,2,18,11.1,16,5,0,5,5,10,5,1,MF,25-29,Midfielder,England,Europe
731,Danny Drinkwater,ENG,Burnley,Premier League,2019,29.0,1990.0,0.6,2,1,1,1,0,0,1,0.0,1,0,0,0,1,3,0,0,MF,25-29,Midfielder,England,Europe
732,Josip Drmić,SUI,Norwich City,Premier League,2019,26.0,1992.0,7.2,3,2,1,2,0,0,8,0.0,8,6,0,6,1,4,5,1,FW,25-29,Forward,Switzerland,Europe
733,Domingos Duarte,POR,Granada,La Liga,2019,24.0,1995.0,34.3,30,19,24,5,1,11,20,55.0,9,34,24,10,34,64,153,1,DF,20-24,Defender,Portugal,Europe
734,Léo Duarte,BRA,Milan,Serie A,2019,23.0,1996.0,4.5,4,3,0,3,1,1,4,25.0,3,9,6,3,3,7,9,0,DF,20-24,Defender,Brazil,South America
735,Óscar Duarte,CRC,Levante,La Liga,2019,30.0,1989.0,5.4,12,3,11,1,0,3,4,75.0,1,7,6,1,6,18,29,0,DF,30-34,Defender,Costa Rica,North America
737,Edgaras Dubickas,LTU,Lecce,Serie A,2019,21.0,1998.0,0.0,0,0,0,0,0,0,0,,0,0,0,0,0,0,0,0,DF,20-24,Defender,Lithuania,Europe
738,Leo Dubois,FRA,Lyon,Ligue 1,2019,24.0,1994.0,15.0,32,23,20,9,3,13,22,59.1,9,12,4,8,18,50,34,1,DF,20-24,Defender,France,Europe
739,Martin Dúbravka,SVK,Newcastle Utd,Premier League,2019,30.0,1989.0,38.0,1,1,1,0,0,1,2,50.0,1,2,0,2,1,2,17,5,GK,30-34,Goalkeeper,Slovakia,Europe
740,Ondrej Duda,SVK,Norwich City,Premier League,2019,24.0,1994.0,8.0,18,11,9,6,3,7,16,43.8,9,10,2,8,6,24,8,0,MF,20-24,Midfielder,Slovakia,Europe
741,Ondrej Duda,SVK,Hertha BSC,Bundesliga,2019,24.0,1994.0,5.0,6,4,1,2,3,1,10,10.0,9,3,1,2,5,11,5,0,MF,20-24,Midfielder,Slovakia,Europe
742,Shane Duffy,IRL,Brighton,Premier League,2019,27.0,1992.0,13.8,18,9,14,4,0,6,17,35.3,11,13,7,6,21,39,72,0,DF,25-29,Defender,Republic of Ireland,Europe
743,Haris Duljević,BIH,Nîmes,Ligue 1,2019,25.0,1993.0,5.8,11,6,3,7,1,4,12,33.3,8,5,0,5,2,13,1,0,"FW,MF",25-29,Forward,Bosnia and Herzegovina,Europe
744,Paul Dummett,WAL,Newcastle Utd,Premier League,2019,27.0,1991.0,13.6,27,17,19,7,1,21,27,77.8,6,23,9,14,23,50,69,0,DF,25-29,Defender,Wales,Europe
745,Alfred Duncan,GHA,Fiorentina,Serie A,2019,26.0,1993.0,9.9,12,9,11,1,0,2,19,10.5,17,4,0,4,5,17,12,0,MF,25-29,Midfielder,Ghana,Africa
746,Alfred Duncan,GHA,Sassuolo,Serie A,2019,26.0,1993.0,9.4,19,12,8,7,4,6,16,37.5,10,7,0,7,9,28,13,0,MF,25-29,Midfielder,Ghana,Africa
747,Lewis Dunk,ENG,Brighton,Premier League,2019,27.0,1991.0,35.9,40,24,23,17,0,15,34,44.1,19,55,33,22,55,95,125,2,DF,25-29,Defender,England,Europe
748,Erik Durm,GER,Eint Frankfurt,Bundesliga,2019,27.0,1992.0,5.7,13,6,9,2,2,9,17,52.9,8,11,2,9,3,16,11,0,"DF,FW",25-29,Defender,Germany,Europe
749,Riza Durmisi,DEN,Nice,Ligue 1,2019,25.0,1994.0,1.8,1,1,1,0,0,0,0,,0,2,1,1,1,2,3,0,"DF,MF",25-29,Defender,Denmark,Europe
751,Jean-Kevin Duverne,HAI,Brest,Ligue 1,2019,22.0,1997.0,13.1,12,8,5,6,1,2,6,33.3,4,23,8,15,20,32,50,0,DF,20-24,Defender,Haiti,North America
752,Paulo Dybala,ARG,Juventus,Serie A,2019,25.0,1993.0,23.9,19,10,6,9,4,9,39,23.1,30,15,0,15,13,32,3,0,"FW,MF",25-29,Forward,Argentina,South America
753,Edin Džeko,BIH,Roma,Serie A,2019,33.0,1986.0,31.7,16,11,2,7,7,2,13,15.4,11,11,4,7,6,22,33,0,FW,30-34,Forward,Bosnia and Herzegovina,Europe
754,Blerim Džemaili,SUI,Bologna,Serie A,2019,33.0,1986.0,7.8,19,12,3,13,3,4,22,18.2,18,9,3,6,7,26,6,0,MF,30-34,Midfielder,Switzerland,Europe
755,Bruno Ecuele Manga,GAB,Dijon,Ligue 1,2019,31.0,1988.0,28.0,22,15,17,5,0,9,20,45.0,11,34,23,11,37,59,112,2,DF,30-34,Defender,Gabon,Africa
756,Simone Edera,ITA,Torino,Serie A,2019,22.0,1997.0,4.4,13,5,3,7,3,2,12,16.7,10,1,0,1,1,14,3,0,"MF,FW",20-24,Midfielder,Italy,Europe
757,Ederson,BRA,Manchester City,Premier League,2019,25.0,1993.0,34.1,2,2,2,0,0,2,5,40.0,3,0,0,0,3,5,16,6,GK,25-29,Goalkeeper,Brazil,South America
757,Ederson,BRA,Manchester City,Premier League,2019,25.0,1993.0,34.1,2,2,2,0,0,2,5,40.0,3,0,0,0,3,5,16,6,GK,25-29,Goalkeeper,Brazil,South America
757,Ederson,BRA,Manchester City,Premier League,2019,25.0,1993.0,34.1,2,2,2,0,0,2,5,40.0,3,0,0,0,3,5,16,6,GK,25-29,Goalkeeper,Brazil,South America
757,Ederson,BRA,Manchester City,Premier League,2019,25.0,1993.0,34.1,2,2,2,0,0,2,5,40.0,3,0,0,0,3,5,16,6,GK,25-29,Goalkeeper,Brazil,South America
758,John Egan,IRL,Sheffield Utd,Premier League,2019,26.0,1992.0,35.4,44,27,34,10,0,25,45,55.6,20,39,27,12,58,102,171,4,DF,25-29,Defender,Republic of Ireland,Europe
759,Johannes Eggestein,GER,Werder Bremen,Bundesliga,2019,21.0,1998.0,5.7,8,6,2,2,4,3,12,25.0,9,6,0,6,2,10,4,0,"MF,FW",20-24,Midfielder,Germany,Europe
760,Maximilian Eggestein,GER,Werder Bremen,Bundesliga,2019,22.0,1996.0,31.7,40,28,20,18,2,15,43,34.9,28,37,8,29,36,76,57,0,MF,20-24,Midfielder,Germany,Europe
761,Kingsley Ehizibue,NED,Köln,Bundesliga,2019,24.0,1995.0,25.9,79,53,44,30,5,33,53,62.3,20,28,8,20,39,118,79,1,DF,20-24,Defender,Netherlands,Europe
762,Albin Ekdal,SWE,Sampdoria,Serie A,2019,30.0,1989.0,26.5,51,25,18,31,2,24,68,35.3,44,35,14,21,33,84,46,1,MF,30-34,Midfielder,Sweden,Europe
763,Harvey Elliott,ENG,Liverpool,Premier League,2019,16.0,2003.0,0.1,0,0,0,0,0,0,0,,0,0,0,0,0,0,0,0,DF,Under 20,Defender,England,Europe
764,Elif Elmas,MKD,Napoli,Serie A,2019,19.0,1999.0,12.6,16,7,5,6,5,5,20,25.0,15,11,1,10,11,27,4,0,MF,Under 20,Midfielder,North Macedonia,Europe
765,Ilay Elmkies,ISR,Hoffenheim,Bundesliga,2019,19.0,2000.0,0.0,1,1,1,0,0,0,0,,0,0,0,0,0,1,0,0,MF,Under 20,Midfielder,Israel,Asia
766,Ahmed Elmohamady,EGY,Aston Villa,Premier League,2019,31.0,1987.0,11.5,19,9,10,7,2,10,21,47.6,11,11,5,6,13,32,25,1,DF,30-34,Defender,Egypt,Africa
768,Nico Elvedi,SUI,Gladbach,Bundesliga,2019,22.0,1996.0,29.1,45,27,37,8,0,19,38,50.0,19,32,15,17,62,107,112,0,DF,20-24,Defender,Switzerland,Europe
769,Rodrigo Ely,BRA,Alavés,La Liga,2019,25.0,1993.0,23.6,22,13,15,7,0,13,29,44.8,16,23,19,4,32,54,116,0,DF,25-29,Defender,Brazil,South America
771,Breel Embolo,SUI,Gladbach,Bundesliga,2019,22.0,1997.0,17.2,22,11,2,15,5,4,15,26.7,11,12,1,11,8,30,5,0,"FW,MF",20-24,Forward,Switzerland,Europe
772,Emerson,BRA,Betis,La Liga,2019,20.0,1999.0,31.5,74,46,49,19,6,36,79,45.6,43,30,9,21,31,105,57,1,DF,20-24,Defender,Brazil,South America
773,Renaud Emond,BEL,Nantes,Ligue 1,2019,27.0,1991.0,3.2,3,1,0,2,1,1,5,20.0,4,0,0,0,0,3,7,0,FW,25-29,Forward,Belgium,Europe
774,Alan Empereur,BRA,Hellas Verona,Serie A,2019,25.0,1994.0,9.5,16,8,11,4,1,6,10,60.0,4,19,12,7,22,38,36,0,DF,25-29,Defender,Brazil,South America
775,Youssef En-Nesyri,MAR,Leganés,La Liga,2019,22.0,1997.0,15.4,9,7,1,2,6,3,17,17.6,14,15,2,13,5,14,22,0,FW,20-24,Forward,Morocco,Africa
776,Youssef En-Nesyri,MAR,Sevilla,La Liga,2019,22.0,1997.0,8.8,7,5,1,6,0,3,10,30.0,7,9,3,6,5,12,7,0,FW,20-24,Forward,Morocco,Africa
777,Björn Engels,BEL,Aston Villa,Premier League,2019,24.0,1994.0,16.1,11,6,8,2,1,8,13,61.5,5,18,17,1,28,39,86,3,DF,20-24,Defender,Belgium,Europe
780,Christian Eriksen,DEN,Tottenham,Premier League,2019,27.0,1992.0,12.2,19,9,10,8,1,7,24,29.2,17,10,1,9,12,31,16,0,"MF,FW",25-29,Midfielder,Denmark,Europe
781,Christian Eriksen,DEN,Inter,Serie A,2019,27.0,1992.0,7.8,11,6,2,8,1,5,20,25.0,15,3,0,3,0,11,0,0,MF,25-29,Midfielder,Denmark,Europe
782,Gonzalo Escalante,ARG,Eibar,La Liga,2019,26.0,1993.0,18.6,41,22,15,17,9,24,41,58.5,17,22,4,18,29,70,14,0,MF,25-29,Midfielder,Argentina,South America
785,Bernardo Espinosa,COL,Espanyol,La Liga,2019,30.0,1989.0,25.1,24,16,18,4,2,16,28,57.1,12,19,11,8,24,48,108,2,DF,30-34,Defender,Colombia,South America
786,Sebastiano Esposito,ITA,Inter,Serie A,2019,17.0,2002.0,2.2,3,2,0,2,1,0,5,0.0,5,3,0,3,3,6,1,0,FW,Under 20,Forward,Italy,Europe
788,Alexander Esswein,GER,Hertha BSC,Bundesliga,2019,29.0,1990.0,2.4,6,4,4,2,0,3,8,37.5,5,8,1,7,7,13,7,1,"FW,MF",25-29,Forward,Germany,Europe
789,Pervis Estupiñán,ECU,Osasuna,La Liga,2019,21.0,1998.0,33.1,84,45,53,27,4,42,77,54.5,35,30,7,23,58,142,61,6,DF,20-24,Defender,Ecuador,South America
790,Oghenekaro Etebo,NGA,Getafe,La Liga,2019,23.0,1995.0,6.4,12,4,5,7,0,7,12,58.3,5,10,1,9,11,23,4,1,MF,20-24,Midfielder,Nigeria,Africa
793,Antony Evans,ENG,Paderborn 07,Bundesliga,2019,20.0,1998.0,1.7,5,4,1,3,1,1,5,20.0,4,1,1,0,2,7,4,0,"MF,DF",20-24,Midfielder,England,Europe
796,Valentin Eysseric,FRA,Hellas Verona,Serie A,2019,27.0,1992.0,3.9,4,4,1,2,1,0,4,0.0,4,3,0,3,1,5,2,0,"MF,FW",25-29,Midfielder,France,Europe
797,Valentin Eysseric,FRA,Fiorentina,Serie A,2019,27.0,1992.0,0.5,0,0,0,0,0,0,0,,0,1,0,1,0,0,0,0,"FW,MF",25-29,Forward,France,Europe
799,Fabinho,BRA,Liverpool,Premier League,2019,25.0,1993.0,23.1,62,35,20,35,7,26,67,38.8,41,25,2,23,34,96,19,1,MF,25-29,Midfielder,Brazil,South America
799,Fabinho,BRA,Liverpool,Premier League,2019,25.0,1993.0,23.1,62,35,20,35,7,26,67,38.8,41,25,2,23,34,96,19,1,MF,25-29,Midfielder,Brazil,South America
799,Fabinho,BRA,Liverpool,Premier League,2019,25.0,1993.0,23.1,62,35,20,35,7,26,67,38.8,41,25,2,23,34,96,19,1,MF,25-29,Midfielder,Brazil,South America
799,Fabinho,BRA,Liverpool,Premier League,2019,25.0,1993.0,23.1,62,35,20,35,7,26,67,38.8,41,25,2,23,34,96,19,1,MF,25-29,Midfielder,Brazil,South America
799,Fabinho,BRA,Liverpool,Premier League,2019,25.0,1993.0,23.1,62,35,20,35,7,26,67,38.8,41,25,2,23,34,96,19,1,MF,25-29,Midfielder,Brazil,South America
799,Fabinho,BRA,Liverpool,Premier League,2019,25.0,1993.0,23.1,62,35,20,35,7,26,67,38.8,41,25,2,23,34,96,19,1,MF,25-29,Midfielder,Brazil,South America
799,Fabinho,BRA,Liverpool,Premier League,2019,25.0,1993.0,23.1,62,35,20,35,7,26,67,38.8,41,25,2,23,34,96,19,1,MF,25-29,Midfielder,Brazil,South America
799,Fabinho,BRA,Liverpool,Premier League,2019,25.0,1993.0,23.1,62,35,20,35,7,26,67,38.8,41,25,2,23,34,96,19,1,MF,25-29,Midfielder,Brazil,South America
799,Fabinho,BRA,Liverpool,Premier League,2019,25.0,1993.0,23.1,62,35,20,35,7,26,67,38.8,41,25,2,23,34,96,19,1,MF,25-29,Midfielder,Brazil,South America
799,Fabinho,BRA,Liverpool,Premier League,2019,25.0,1993.0,23.1,62,35,20,35,7,26,67,38.8,41,25,2,23,34,96,19,1,MF,25-29,Midfielder,Brazil,South America
799,Fabinho,BRA,Liverpool,Premier League,2019,25.0,1993.0,23.1,62,35,20,35,7,26,67,38.8,41,25,2,23,34,96,19,1,MF,25-29,Midfielder,Brazil,South America
799,Fabinho,BRA,Liverpool,Premier League,2019,25.0,1993.0,23.1,62,35,20,35,7,26,67,38.8,41,25,2,23,34,96,19,1,MF,25-29,Midfielder,Brazil,South America
799,Fabinho,BRA,Liverpool,Premier League,2019,25.0,1993.0,23.1,62,35,20,35,7,26,67,38.8,41,25,2,23,34,96,19,1,MF,25-29,Midfielder,Brazil,South America
799,Fabinho,BRA,Liverpool,Premier League,2019,25.0,1993.0,23.1,62,35,20,35,7,26,67,38.8,41,25,2,23,34,96,19,1,MF,25-29,Midfielder,Brazil,South America
799,Fabinho,BRA,Liverpool,Premier League,2019,25.0,1993.0,23.1,62,35,20,35,7,26,67,38.8,41,25,2,23,34,96,19,1,MF,25-29,Midfielder,Brazil,South America
799,Fabinho,BRA,Liverpool,Premier League,2019,25.0,1993.0,23.1,62,35,20,35,7,26,67,38.8,41,25,2,23,34,96,19,1,MF,25-29,Midfielder,Brazil,South America
799,Fabinho,BRA,Liverpool,Premier League,2019,25.0,1993.0,23.1,62,35,20,35,7,26,67,38.8,41,25,2,23,34,96,19,1,MF,25-29,Midfielder,Brazil,South America
799,Fabinho,BRA,Liverpool,Premier League,2019,25.0,1993.0,23.1,62,35,20,35,7,26,67,38.8,41,25,2,23,34,96,19,1,MF,25-29,Midfielder,Brazil,South America
799,Fabinho,BRA,Liverpool,Premier League,2019,25.0,1993.0,23.1,62,35,20,35,7,26,67,38.8,41,25,2,23,34,96,19,1,MF,25-29,Midfielder,Brazil,South America
799,Fabinho,BRA,Liverpool,Premier League,2019,25.0,1993.0,23.1,62,35,20,35,7,26,67,38.8,41,25,2,23,34,96,19,1,MF,25-29,Midfielder,Brazil,South America
799,Fabinho,BRA,Liverpool,Premier League,2019,25.0,1993.0,23.1,62,35,20,35,7,26,67,38.8,41,25,2,23,34,96,19,1,MF,25-29,Midfielder,Brazil,South America
799,Fabinho,BRA,Liverpool,Premier League,2019,25.0,1993.0,23.1,62,35,20,35,7,26,67,38.8,41,25,2,23,34,96,19,1,MF,25-29,Midfielder,Brazil,South America
799,Fabinho,BRA,Liverpool,Premier League,2019,25.0,1993.0,23.1,62,35,20,35,7,26,67,38.8,41,25,2,23,34,96,19,1,MF,25-29,Midfielder,Brazil,South America
799,Fabinho,BRA,Liverpool,Premier League,2019,25.0,1993.0,23.1,62,35,20,35,7,26,67,38.8,41,25,2,23,34,96,19,1,MF,25-29,Midfielder,Brazil,South America
799,Fabinho,BRA,Liverpool,Premier League,2019,25.0,1993.0,23.1,62,35,20,35,7,26,67,38.8,41,25,2,23,34,96,19,1,MF,25-29,Midfielder,Brazil,South America
800,Fábio,BRA,Nantes,Ligue 1,2019,29.0,1990.0,9.3,38,22,18,20,0,25,35,71.4,10,10,5,5,18,56,19,0,DF,25-29,Defender,Brazil,South America
803,Ralf Fährmann,GER,Norwich City,Premier League,2019,30.0,1988.0,0.2,0,0,0,0,0,0,0,,0,0,0,0,0,0,0,0,GK,30-34,Goalkeeper,Germany,Europe
804,Fayçal Fajr,MAR,Getafe,La Liga,2019,30.0,1988.0,4.5,1,1,0,1,0,0,3,0.0,3,4,0,4,4,5,1,0,MF,30-34,Midfielder,Morocco,Africa
805,Luca Falbo,ITA,Lazio,Serie A,2019,19.0,2000.0,0.0,0,0,0,0,0,0,0,,0,0,0,0,0,0,0,0,DF,Under 20,Defender,Italy,Europe
806,Filippo Falco,ITA,Lecce,Serie A,2019,27.0,1992.0,22.4,13,7,4,5,4,5,18,27.8,13,11,1,10,2,15,1,0,"FW,MF",25-29,Forward,Italy,Europe
808,Wladimiro Falcone,ITA,Sampdoria,Serie A,2019,24.0,1995.0,2.0,0,0,0,0,0,0,0,,0,0,0,0,0,0,0,0,GK,20-24,Goalkeeper,Italy,Europe
809,Simon Falette,GUI,Eint Frankfurt,Bundesliga,2019,27.0,1992.0,1.0,0,0,0,0,0,0,1,0.0,1,3,3,0,3,3,5,0,DF,25-29,Defender,Guinea,Africa
812,Akin Famewo,ENG,Norwich City,Premier League,2019,20.0,1998.0,0.0,0,0,0,0,0,0,0,,0,0,0,0,0,0,0,0,MF,20-24,Midfielder,England,Europe
813,Andri Fannar Baldursson,ISL,Bologna,Serie A,2019,17.0,2002.0,1.6,1,0,0,1,0,0,1,0.0,1,2,0,2,1,2,3,0,MF,Under 20,Midfielder,Iceland,Europe
814,Paolo Faragò,ITA,Cagliari,Serie A,2019,26.0,1993.0,14.9,41,28,21,15,5,23,46,50.0,23,18,9,9,10,51,58,0,"DF,MF",25-29,Defender,Italy,Europe
815,Davide Faraoni,ITA,Hellas Verona,Serie A,2019,27.0,1991.0,35.9,67,37,43,19,5,30,67,44.8,37,50,15,35,36,103,115,0,DF,25-29,Defender,Italy,Europe
816,Mohamed Fares,ALG,SPAL,Serie A,2019,23.0,1996.0,4.7,6,4,3,2,1,2,10,20.0,8,5,3,2,5,11,8,0,"DF,MF",20-24,Defender,Algeria,Africa
817,Diego Farias,BRA,Lecce,Serie A,2019,29.0,1990.0,9.2,9,6,3,5,1,5,18,27.8,13,7,0,7,4,13,4,0,"MF,FW",25-29,Midfielder,Brazil,South America
819,Julien Faussurier,FRA,Brest,Ligue 1,2019,32.0,1987.0,22.0,36,22,23,13,0,21,53,39.6,32,22,7,15,33,69,46,1,DF,30-34,Defender,France,Europe
820,Andrea Favilli,ITA,Genoa,Serie A,2019,22.0,1997.0,7.3,8,7,2,3,3,4,11,36.4,7,5,1,4,0,8,7,0,FW,20-24,Forward,Italy,Europe
821,Federico Fazio,ARG,Roma,Serie A,2019,32.0,1987.0,13.5,19,11,12,6,1,6,11,54.5,5,8,6,2,19,38,52,0,DF,30-34,Defender,Argentina,South America
823,Zouhair Feddal,MAR,Betis,La Liga,2019,30.0,1989.0,15.9,20,13,14,5,1,10,14,71.4,4,15,9,6,23,43,74,0,DF,30-34,Defender,Morocco,Africa
825,Nabil Fekir,FRA,Betis,La Liga,2019,26.0,1993.0,29.3,41,26,14,19,8,12,37,32.4,25,27,3,24,10,51,3,0,"MF,FW",25-29,Midfielder,France,Europe
826,Felipe,BRA,Atlético Madrid,La Liga,2019,30.0,1989.0,23.4,27,19,21,6,0,14,24,58.3,10,18,13,5,40,67,130,0,DF,30-34,Defender,Brazil,South America
826,Felipe,BRA,Atlético Madrid,La Liga,2019,30.0,1989.0,23.4,27,19,21,6,0,14,24,58.3,10,18,13,5,40,67,130,0,DF,30-34,Defender,Brazil,South America
826,Felipe,BRA,Atlético Madrid,La Liga,2019,30.0,1989.0,23.4,27,19,21,6,0,14,24,58.3,10,18,13,5,40,67,130,0,DF,30-34,Defender,Brazil,South America
826,Felipe,BRA,Atlético Madrid,La Liga,2019,30.0,1989.0,23.4,27,19,21,6,0,14,24,58.3,10,18,13,5,40,67,130,0,DF,30-34,Defender,Brazil,South America
827,Luiz Felipe,ITA,Lazio,Serie A,2019,22.0,1997.0,22.5,42,24,24,15,3,19,32,59.4,13,39,30,9,41,83,69,2,DF,20-24,Defender,Italy,Europe
827,Luiz Felipe,ITA,Lazio,Serie A,2019,22.0,1997.0,22.5,42,24,24,15,3,19,32,59.4,13,39,30,9,41,83,69,2,DF,20-24,Defender,Italy,Europe
827,Luiz Felipe,ITA,Lazio,Serie A,2019,22.0,1997.0,22.5,42,24,24,15,3,19,32,59.4,13,39,30,9,41,83,69,2,DF,20-24,Defender,Italy,Europe
827,Luiz Felipe,ITA,Lazio,Serie A,2019,22.0,1997.0,22.5,42,24,24,15,3,19,32,59.4,13,39,30,9,41,83,69,2,DF,20-24,Defender,Italy,Europe
828,Lucas Felippe,BRA,Hellas Verona,Serie A,2019,19.0,2000.0,0.3,1,1,1,0,0,1,1,100.0,0,0,0,0,0,1,0,0,"MF,DF",Under 20,Midfielder,Brazil,South America
829,João Félix,POR,Atlético Madrid,La Liga,2019,19.0,1999.0,19.4,9,3,3,3,3,4,14,28.6,10,4,0,4,10,19,4,1,"FW,MF",Under 20,Forward,Portugal,Europe
830,Ohis Felix Uduokhai,GER,Augsburg,Bundesliga,2019,21.0,1997.0,21.8,43,26,30,12,1,19,29,65.5,10,40,30,10,36,79,125,2,DF,20-24,Defender,Germany,Europe
832,Zinedine Ferhat,ALG,Nîmes,Ligue 1,2019,26.0,1993.0,25.0,26,16,5,16,5,15,46,32.6,31,15,3,12,16,42,18,0,"FW,MF",25-29,Forward,Algeria,Africa
833,Bruno Fernandes,POR,Manchester Utd,Premier League,2019,24.0,1994.0,13.2,22,12,9,9,4,5,38,13.2,33,6,0,6,11,33,16,0,MF,20-24,Midfielder,Portugal,Europe
834,Edimilson Fernandes,SUI,Mainz 05,Bundesliga,2019,23.0,1996.0,16.5,33,20,12,15,6,15,33,45.5,18,17,9,8,32,65,47,1,"MF,DF",20-24,Midfielder,Switzerland,Europe
835,Gedson Fernandes,POR,Tottenham,Premier League,2019,20.0,1999.0,0.8,2,0,2,0,0,0,2,0.0,2,2,0,2,1,3,0,0,"MF,DF",20-24,Midfielder,Portugal,Europe
836,Gelson Fernandes,SUI,Eint Frankfurt,Bundesliga,2019,32.0,1986.0,8.6,30,18,13,17,0,7,21,33.3,14,11,3,8,16,46,9,2,MF,30-34,Midfielder,Switzerland,Europe
837,Matheus Fernandes,BRA,Valladolid,La Liga,2019,21.0,1998.0,1.8,6,2,2,2,2,3,5,60.0,2,4,0,4,2,8,2,0,"MF,FW",20-24,Midfielder,Brazil,South America
841,Federico Fernández,ARG,Newcastle Utd,Premier League,2019,30.0,1989.0,29.1,42,25,30,10,2,23,46,50.0,23,41,28,13,24,66,190,2,DF,30-34,Defender,Argentina,South America
842,Gabriel Fernández,URU,Celta Vigo,La Liga,2019,25.0,1994.0,6.2,1,0,0,1,0,1,3,33.3,2,5,1,4,2,3,2,0,"FW,MF",25-29,Forward,Uruguay,South America
844,Fernandinho,BRA,Manchester City,Premier League,2019,34.0,1985.0,26.6,50,35,32,16,2,29,48,60.4,19,28,16,12,25,75,82,0,DF,30-34,Defender,Brazil,South America
844,Fernandinho,BRA,Manchester City,Premier League,2019,34.0,1985.0,26.6,50,35,32,16,2,29,48,60.4,19,28,16,12,25,75,82,0,DF,30-34,Defender,Brazil,South America
844,Fernandinho,BRA,Manchester City,Premier League,2019,34.0,1985.0,26.6,50,35,32,16,2,29,48,60.4,19,28,16,12,25,75,82,0,DF,30-34,Defender,Brazil,South America
844,Fernandinho,BRA,Manchester City,Premier League,2019,34.0,1985.0,26.6,50,35,32,16,2,29,48,60.4,19,28,16,12,25,75,82,0,DF,30-34,Defender,Brazil,South America
844,Fernandinho,BRA,Manchester City,Premier League,2019,34.0,1985.0,26.6,50,35,32,16,2,29,48,60.4,19,28,16,12,25,75,82,0,DF,30-34,Defender,Brazil,South America
844,Fernandinho,BRA,Manchester City,Premier League,2019,34.0,1985.0,26.6,50,35,32,16,2,29,48,60.4,19,28,16,12,25,75,82,0,DF,30-34,Defender,Brazil,South America
844,Fernandinho,BRA,Manchester City,Premier League,2019,34.0,1985.0,26.6,50,35,32,16,2,29,48,60.4,19,28,16,12,25,75,82,0,DF,30-34,Defender,Brazil,South America
844,Fernandinho,BRA,Manchester City,Premier League,2019,34.0,1985.0,26.6,50,35,32,16,2,29,48,60.4,19,28,16,12,25,75,82,0,DF,30-34,Defender,Brazil,South America
844,Fernandinho,BRA,Manchester City,Premier League,2019,34.0,1985.0,26.6,50,35,32,16,2,29,48,60.4,19,28,16,12,25,75,82,0,DF,30-34,Defender,Brazil,South America
844,Fernandinho,BRA,Manchester City,Premier League,2019,34.0,1985.0,26.6,50,35,32,16,2,29,48,60.4,19,28,16,12,25,75,82,0,DF,30-34,Defender,Brazil,South America
844,Fernandinho,BRA,Manchester City,Premier League,2019,34.0,1985.0,26.6,50,35,32,16,2,29,48,60.4,19,28,16,12,25,75,82,0,DF,30-34,Defender,Brazil,South America
844,Fernandinho,BRA,Manchester City,Premier League,2019,34.0,1985.0,26.6,50,35,32,16,2,29,48,60.4,19,28,16,12,25,75,82,0,DF,30-34,Defender,Brazil,South America
844,Fernandinho,BRA,Manchester City,Premier League,2019,34.0,1985.0,26.6,50,35,32,16,2,29,48,60.4,19,28,16,12,25,75,82,0,DF,30-34,Defender,Brazil,South America
844,Fernandinho,BRA,Manchester City,Premier League,2019,34.0,1985.0,26.6,50,35,32,16,2,29,48,60.4,19,28,16,12,25,75,82,0,DF,30-34,Defender,Brazil,South America
844,Fernandinho,BRA,Manchester City,Premier League,2019,34.0,1985.0,26.6,50,35,32,16,2,29,48,60.4,19,28,16,12,25,75,82,0,DF,30-34,Defender,Brazil,South America
844,Fernandinho,BRA,Manchester City,Premier League,2019,34.0,1985.0,26.6,50,35,32,16,2,29,48,60.4,19,28,16,12,25,75,82,0,DF,30-34,Defender,Brazil,South America
845,Fernando,BRA,Sevilla,La Liga,2019,32.0,1987.0,29.5,62,33,37,24,1,34,58,58.6,24,38,15,23,67,129,73,1,MF,30-34,Midfielder,Brazil,South America
845,Fernando,BRA,Sevilla,La Liga,2019,32.0,1987.0,29.5,62,33,37,24,1,34,58,58.6,24,38,15,23,67,129,73,1,MF,30-34,Midfielder,Brazil,South America
845,Fernando,BRA,Sevilla,La Liga,2019,32.0,1987.0,29.5,62,33,37,24,1,34,58,58.6,24,38,15,23,67,129,73,1,MF,30-34,Midfielder,Brazil,South America
845,Fernando,BRA,Sevilla,La Liga,2019,32.0,1987.0,29.5,62,33,37,24,1,34,58,58.6,24,38,15,23,67,129,73,1,MF,30-34,Midfielder,Brazil,South America
845,Fernando,BRA,Sevilla,La Liga,2019,32.0,1987.0,29.5,62,33,37,24,1,34,58,58.6,24,38,15,23,67,129,73,1,MF,30-34,Midfielder,Brazil,South America
845,Fernando,BRA,Sevilla,La Liga,2019,32.0,1987.0,29.5,62,33,37,24,1,34,58,58.6,24,38,15,23,67,129,73,1,MF,30-34,Midfielder,Brazil,South America
845,Fernando,BRA,Sevilla,La Liga,2019,32.0,1987.0,29.5,62,33,37,24,1,34,58,58.6,24,38,15,23,67,129,73,1,MF,30-34,Midfielder,Brazil,South America
845,Fernando,BRA,Sevilla,La Liga,2019,32.0,1987.0,29.5,62,33,37,24,1,34,58,58.6,24,38,15,23,67,129,73,1,MF,30-34,Midfielder,Brazil,South America
845,Fernando,BRA,Sevilla,La Liga,2019,32.0,1987.0,29.5,62,33,37,24,1,34,58,58.6,24,38,15,23,67,129,73,1,MF,30-34,Midfielder,Brazil,South America
845,Fernando,BRA,Sevilla,La Liga,2019,32.0,1987.0,29.5,62,33,37,24,1,34,58,58.6,24,38,15,23,67,129,73,1,MF,30-34,Midfielder,Brazil,South America
845,Fernando,BRA,Sevilla,La Liga,2019,32.0,1987.0,29.5,62,33,37,24,1,34,58,58.6,24,38,15,23,67,129,73,1,MF,30-34,Midfielder,Brazil,South America
845,Fernando,BRA,Sevilla,La Liga,2019,32.0,1987.0,29.5,62,33,37,24,1,34,58,58.6,24,38,15,23,67,129,73,1,MF,30-34,Midfielder,Brazil,South America
845,Fernando,BRA,Sevilla,La Liga,2019,32.0,1987.0,29.5,62,33,37,24,1,34,58,58.6,24,38,15,23,67,129,73,1,MF,30-34,Midfielder,Brazil,South America
845,Fernando,BRA,Sevilla,La Liga,2019,32.0,1987.0,29.5,62,33,37,24,1,34,58,58.6,24,38,15,23,67,129,73,1,MF,30-34,Midfielder,Brazil,South America
845,Fernando,BRA,Sevilla,La Liga,2019,32.0,1987.0,29.5,62,33,37,24,1,34,58,58.6,24,38,15,23,67,129,73,1,MF,30-34,Midfielder,Brazil,South America
845,Fernando,BRA,Sevilla,La Liga,2019,32.0,1987.0,29.5,62,33,37,24,1,34,58,58.6,24,38,15,23,67,129,73,1,MF,30-34,Midfielder,Brazil,South America
846,Juan Ferney Otero,COL,Amiens,Ligue 1,2019,24.0,1995.0,13.4,17,10,6,9,2,8,24,33.3,16,12,1,11,19,36,10,0,"FW,MF",20-24,Forward,Colombia,South America
847,Alex Ferrari,ITA,Sampdoria,Serie A,2019,25.0,1994.0,11.2,18,13,13,5,0,7,12,58.3,5,13,8,5,12,30,31,0,DF,25-29,Defender,Italy,Europe
848,Facundo Ferreyra,ARG,Espanyol,La Liga,2019,28.0,1991.0,6.4,9,4,4,5,0,3,10,30.0,7,4,0,4,2,11,5,0,"FW,MF",25-29,Forward,Argentina,South America
849,Jordan Ferri,FRA,Montpellier,Ligue 1,2019,27.0,1992.0,12.8,22,13,7,12,3,13,44,29.5,31,9,0,9,10,32,10,0,MF,25-29,Midfielder,France,Europe
850,Oliver Fink,GER,Düsseldorf,Bundesliga,2019,37.0,1982.0,7.5,21,12,7,11,3,5,16,31.3,11,12,1,11,15,36,7,0,"MF,FW",35-39,Midfielder,Germany,Europe
851,Alfreð Finnbogason,ISL,Augsburg,Bundesliga,2019,30.0,1989.0,10.7,11,6,1,9,1,2,7,28.6,5,8,2,6,3,14,8,0,FW,30-34,Forward,Iceland,Europe
852,Roberto Firmino,BRA,Liverpool,Premier League,2019,27.0,1991.0,33.2,37,19,8,14,15,10,43,23.3,33,34,3,31,7,44,11,1,FW,25-29,Forward,Brazil,South America
853,Junior Firpo,DOM,Barcelona,La Liga,2019,22.0,1996.0,11.3,23,15,12,8,3,11,17,64.7,6,15,3,12,17,40,12,1,DF,20-24,Defender,Dominican Republic,North America
854,John Fleck,SCO,Sheffield Utd,Premier League,2019,27.0,1991.0,28.0,36,25,13,14,9,22,64,34.4,42,25,3,22,24,60,26,0,MF,25-29,Midfielder,Scotland,Europe
855,Mark Flekken,NED,Freiburg,Bundesliga,2019,26.0,1993.0,10.0,0,0,0,0,0,0,1,0.0,1,0,0,0,0,0,2,2,GK,25-29,Goalkeeper,Netherlands,Europe
856,Sergio Floccari,ITA,SPAL,Serie A,2019,37.0,1981.0,10.5,8,3,3,1,4,0,13,0.0,13,9,1,8,5,13,1,0,FW,35-39,Forward,Italy,Europe
857,Alessandro Florenzi,ITA,Roma,Serie A,2019,28.0,1991.0,11.1,14,11,8,4,2,7,20,35.0,13,9,3,6,16,30,19,0,"DF,FW",25-29,Defender,Italy,Europe
858,Alessandro Florenzi,ITA,Valencia,La Liga,2019,28.0,1991.0,8.4,13,9,9,4,0,8,18,44.4,10,11,1,10,14,27,21,0,DF,25-29,Defender,Italy,Europe
859,Phil Foden,ENG,Manchester City,Premier League,2019,19.0,2000.0,10.0,14,10,4,6,4,6,19,31.6,13,5,0,5,6,20,2,0,"FW,MF",Under 20,Forward,England,Europe
860,Mamadou Fofana,MLI,Metz,Ligue 1,2019,21.0,1998.0,17.6,57,35,38,15,4,21,41,51.2,20,22,10,12,22,79,61,1,"DF,MF",20-24,Defender,Mali,Africa
861,Seko Fofana,CIV,Udinese,Serie A,2019,24.0,1995.0,25.0,17,12,8,8,1,9,35,25.7,26,20,1,19,17,34,19,0,MF,20-24,Midfielder,Ivory Coast,Africa
862,Wesley Fofana,FRA,Saint-Étienne,Ligue 1,2019,18.0,2000.0,13.5,25,15,16,9,0,12,18,66.7,6,10,5,5,36,61,55,4,DF,Under 20,Defender,France,Europe
863,Youssouf Fofana,FRA,Strasbourg,Ligue 1,2019,20.0,1999.0,11.2,25,17,10,12,3,13,30,43.3,17,11,0,11,14,39,7,0,MF,20-24,Midfielder,France,Europe
864,Youssouf Fofana,FRA,Monaco,Ligue 1,2019,20.0,1999.0,6.8,16,9,6,10,0,8,15,53.3,7,12,2,10,8,24,9,0,MF,20-24,Midfielder,France,Europe
865,Thomas Foket,BEL,Reims,Ligue 1,2019,24.0,1994.0,27.0,61,36,31,23,7,30,48,62.5,18,15,4,11,39,100,59,1,DF,20-24,Defender,Belgium,Europe
866,Lamine Fomba,FRA,Nîmes,Ligue 1,2019,21.0,1998.0,15.3,65,31,20,37,8,21,43,48.8,22,29,4,25,25,90,11,1,MF,20-24,Midfielder,France,Europe
867,José Fonte,POR,Lille,Ligue 1,2019,35.0,1983.0,24.5,19,11,11,7,1,11,22,50.0,11,19,11,8,28,47,90,1,DF,35-39,Defender,Portugal,Europe
869,Emil Forsberg,SWE,RB Leipzig,Bundesliga,2019,27.0,1991.0,12.7,16,10,5,8,3,6,26,23.1,20,15,0,15,5,21,3,0,MF,25-29,Midfielder,Sweden,Europe
870,Hernâni Fortes,POR,Levante,La Liga,2019,27.0,1991.0,7.3,5,2,4,0,1,1,3,33.3,2,3,0,3,4,9,9,0,"MF,FW",25-29,Midfielder,Portugal,Europe
871,Ben Foster,ENG,Watford,Premier League,2019,36.0,1983.0,38.0,1,0,1,0,0,1,3,33.3,2,1,0,1,0,1,16,2,GK,35-39,Goalkeeper,England,Europe
872,Lyle Foster,RSA,Monaco,Ligue 1,2019,18.0,2000.0,0.7,0,0,0,0,0,0,1,0.0,1,0,0,0,0,0,1,0,FW,Under 20,Forward,South Africa,Africa
873,Timothy Fosu-Mensah,NED,Manchester Utd,Premier League,2019,21.0,1998.0,1.5,1,1,0,1,0,1,4,25.0,3,0,0,0,4,5,1,0,DF,20-24,Defender,Netherlands,Europe
874,Dimitri Foulquier,FRA,Watford,Premier League,2019,26.0,1993.0,0.7,1,0,1,0,0,0,0,,0,1,0,1,2,3,2,0,"DF,MF",25-29,Defender,France,Europe
875,Dimitri Foulquier,FRA,Granada,La Liga,2019,26.0,1993.0,12.4,25,11,13,9,3,11,20,55.0,9,8,3,5,16,41,32,0,"DF,MF",25-29,Defender,France,Europe
876,Juan Foyth,ARG,Tottenham,Premier League,2019,21.0,1998.0,0.8,7,3,5,2,0,3,4,75.0,1,1,0,1,1,8,3,1,DF,20-24,Defender,Argentina,South America
877,Gianluca Frabotta,ITA,Juventus,Serie A,2019,20.0,1999.0,1.0,3,1,0,2,1,2,2,100.0,0,2,0,2,1,4,2,0,DF,20-24,Defender,Italy,Europe
878,Raphael Framberger,GER,Augsburg,Bundesliga,2019,23.0,1995.0,13.1,43,25,23,16,4,21,29,72.4,8,23,9,14,20,63,26,0,DF,20-24,Defender,Germany,Europe
879,Simon Francis,ENG,Bournemouth,Premier League,2019,34.0,1985.0,10.8,13,9,11,2,0,11,21,52.4,10,17,12,5,20,33,71,0,DF,30-34,Defender,England,Europe
880,Mike Frantz,GER,Freiburg,Bundesliga,2019,32.0,1986.0,3.9,4,2,1,3,0,2,9,22.2,7,5,3,2,1,5,4,0,MF,30-34,Midfielder,Germany,Europe
881,Ryan Fraser,SCO,Bournemouth,Premier League,2019,25.0,1994.0,23.0,12,6,5,5,2,7,22,31.8,15,15,3,12,15,27,24,0,"MF,FW",25-29,Midfielder,Scotland,Europe
882,Fred,BRA,Manchester Utd,Premier League,2019,26.0,1993.0,24.0,60,32,33,22,5,25,100,25.0,75,44,8,36,38,98,32,0,MF,25-29,Midfielder,Brazil,South America
883,Ryan Fredericks,ENG,West Ham,Premier League,2019,26.0,1992.0,24.9,82,56,59,18,5,41,64,64.1,23,20,10,10,24,106,73,1,DF,25-29,Defender,England,Europe
884,Kieron Freeman,WAL,Sheffield Utd,Premier League,2019,27.0,1992.0,0.1,0,0,0,0,0,0,0,,0,0,0,0,0,0,0,0,FW,25-29,Forward,Wales,Europe
885,Luke Freeman,ENG,Sheffield Utd,Premier League,2019,27.0,1992.0,4.1,6,4,2,2,2,2,8,25.0,6,1,0,1,10,16,6,0,MF,25-29,Midfielder,England,Europe
886,Remo Freuler,SUI,Atalanta,Serie A,2019,27.0,1992.0,26.0,51,30,18,25,8,22,63,34.9,41,41,6,35,28,79,26,0,MF,25-29,Midfielder,Switzerland,Europe
887,Marco Friedl,AUT,Werder Bremen,Bundesliga,2019,21.0,1998.0,24.3,61,39,42,15,4,29,54,53.7,25,29,9,20,34,95,78,0,"DF,MF",20-24,Defender,Austria,Europe
888,Marvin Friedrich,GER,Union Berlin,Bundesliga,2019,23.0,1995.0,31.0,45,31,30,14,1,12,37,32.4,25,46,24,22,42,87,110,0,DF,20-24,Defender,Germany,Europe
889,Samúel Friðjónsson,ISL,Paderborn 07,Bundesliga,2019,23.0,1996.0,2.1,4,1,3,1,0,1,3,33.3,2,4,1,3,4,8,4,0,MF,20-24,Midfielder,Iceland,Europe
891,Christian Fuchs,AUT,Leicester City,Premier League,2019,33.0,1986.0,8.6,14,9,8,6,0,8,19,42.1,11,8,3,5,17,31,33,1,DF,30-34,Defender,Austria,Europe
892,Angelo Fulgini,FRA,Angers,Ligue 1,2019,22.0,1996.0,17.5,28,18,8,15,5,12,23,52.2,11,6,1,5,19,47,10,0,MF,20-24,Midfielder,France,Europe
893,Niclas Füllkrug,GER,Werder Bremen,Bundesliga,2019,26.0,1993.0,4.5,2,2,1,1,0,1,3,33.3,2,3,0,3,3,5,6,0,FW,25-29,Forward,Germany,Europe
894,Ramiro Funes Mori,ARG,Villarreal,La Liga,2019,28.0,1991.0,5.0,5,2,2,3,0,0,2,0.0,2,8,2,6,3,8,9,1,DF,25-29,Defender,Argentina,South America
895,Daniel Fuzato,BRA,Roma,Serie A,2019,22.0,1997.0,1.0,0,0,0,0,0,0,0,,0,0,0,0,0,0,0,0,GK,20-24,Goalkeeper,Brazil,South America
896,Matteo Gabbia,ITA,Milan,Serie A,2019,19.0,1999.0,7.6,7,5,5,2,0,5,8,62.5,3,6,6,0,9,16,21,0,DF,Under 20,Defender,Italy,Europe
897,Manolo Gabbiadini,ITA,Sampdoria,Serie A,2019,27.0,1991.0,22.6,9,7,2,3,4,1,7,14.3,6,12,0,12,10,19,11,0,FW,25-29,Forward,Italy,Europe
898,Gabriel,BRA,Lecce,Serie A,2019,26.0,1992.0,33.3,2,1,2,0,0,2,3,66.7,1,0,0,0,0,2,11,10,GK,25-29,Goalkeeper,Brazil,South America
898,Gabriel,BRA,Lecce,Serie A,2019,26.0,1992.0,33.3,2,1,2,0,0,2,3,66.7,1,0,0,0,0,2,11,10,GK,25-29,Goalkeeper,Brazil,South America
898,Gabriel,BRA,Lecce,Serie A,2019,26.0,1992.0,33.3,2,1,2,0,0,2,3,66.7,1,0,0,0,0,2,11,10,GK,25-29,Goalkeeper,Brazil,South America
898,Gabriel,BRA,Lecce,Serie A,2019,26.0,1992.0,33.3,2,1,2,0,0,2,3,66.7,1,0,0,0,0,2,11,10,GK,25-29,Goalkeeper,Brazil,South America
901,Luca Gagliano,ITA,Cagliari,Serie A,2019,19.0,2000.0,0.6,0,0,0,0,0,0,0,,0,0,0,0,1,1,0,0,FW,Under 20,Forward,Italy,Europe
902,Roberto Gagliardini,ITA,Inter,Serie A,2019,25.0,1994.0,20.0,38,19,12,18,8,14,41,34.1,27,28,8,20,30,68,20,1,MF,25-29,Midfielder,Italy,Europe
903,Riccardo Gagliolo,SWE,Parma,Serie A,2019,29.0,1990.0,28.9,57,32,37,12,8,30,60,50.0,30,35,18,17,53,110,100,0,DF,25-29,Defender,Sweden,Europe
904,Nicolás Gaitán,ARG,Lille,Ligue 1,2019,31.0,1988.0,0.6,1,0,0,1,0,1,1,100.0,0,1,0,1,0,1,1,0,"MF,FW",30-34,Midfielder,Argentina,South America
905,Marvin Gakpa,FRA,Metz,Ligue 1,2019,25.0,1993.0,5.2,10,6,3,4,3,4,8,50.0,4,3,0,3,5,15,1,0,"MF,FW",25-29,Midfielder,France,Europe
908,Kévin Gameiro,FRA,Valencia,La Liga,2019,32.0,1987.0,17.6,17,9,7,6,4,5,21,23.8,16,10,1,9,5,22,5,0,FW,30-34,Forward,France,Europe
910,Idrissa Gana Gueye,SEN,Paris S-G,Ligue 1,2019,29.0,1989.0,18.4,65,34,30,25,10,18,43,41.9,25,29,4,25,33,98,15,0,MF,25-29,Midfielder,Senegal,Africa
911,Ignatius Ganago,CMR,Nice,Ligue 1,2019,20.0,1999.0,13.8,10,6,4,3,3,3,18,16.7,15,8,1,7,4,14,13,0,"FW,MF",20-24,Forward,Cameroon,Africa
912,Ezequiel Garay,ARG,Valencia,La Liga,2019,32.0,1986.0,16.0,12,8,9,2,1,7,11,63.6,4,19,17,2,14,26,71,0,DF,30-34,Defender,Argentina,South America
924,James Garner,ENG,Manchester Utd,Premier League,2019,18.0,2001.0,0.1,0,0,0,0,0,0,1,0.0,1,0,0,0,0,0,1,0,MF,Under 20,Midfielder,England,Europe
927,Daniele Gastaldello,ITA,Brescia,Serie A,2019,36.0,1983.0,4.3,8,5,5,3,0,2,3,66.7,1,6,3,3,5,13,29,1,DF,35-39,Defender,Italy,Europe
928,Dwight Gayle,ENG,Newcastle Utd,Premier League,2019,28.0,1990.0,9.4,12,10,4,6,2,4,8,50.0,4,5,0,5,2,14,9,0,FW,25-29,Forward,England,Europe
929,Paulo Gazzaniga,ARG,Tottenham,Premier League,2019,27.0,1992.0,17.9,0,0,0,0,0,0,0,,0,0,0,0,1,1,4,1,GK,25-29,Goalkeeper,Argentina,South America
930,Jean-Philippe Gbamin,CIV,Everton,Premier League,2019,23.0,1995.0,1.5,4,3,1,1,2,1,2,50.0,1,1,0,1,1,5,4,0,MF,20-24,Midfielder,Ivory Coast,Africa
931,Yann Gboho,FRA,Rennes,Ligue 1,2019,18.0,2001.0,2.5,2,2,1,0,1,0,2,0.0,2,1,0,1,1,3,0,0,FW,Under 20,Forward,France,Europe
934,Dennis Geiger,GER,Hoffenheim,Bundesliga,2019,21.0,1998.0,12.6,12,5,4,6,2,2,16,12.5,14,9,2,7,6,18,4,0,MF,20-24,Midfielder,Germany,Europe
935,Jérémy Gélin,FRA,Rennes,Ligue 1,2019,22.0,1997.0,10.3,14,5,10,2,2,8,13,61.5,5,14,7,7,15,29,33,1,"DF,MF",20-24,Defender,France,Europe
936,Christian Gentner,GER,Union Berlin,Bundesliga,2019,33.0,1985.0,27.1,53,28,16,32,5,22,73,30.1,51,46,8,38,54,107,50,0,MF,30-34,Midfielder,Germany,Europe
937,Yannick Gerhardt,GER,Wolfsburg,Bundesliga,2019,25.0,1994.0,9.2,28,18,7,15,6,8,21,38.1,13,11,3,8,12,40,9,0,MF,25-29,Midfielder,Germany,Europe
938,Valère Germain,FRA,Marseille,Ligue 1,2019,29.0,1990.0,15.0,22,12,6,11,5,6,31,19.4,25,16,3,13,8,30,26,0,FW,25-29,Forward,France,Europe
939,Gervinho,CIV,Parma,Serie A,2019,32.0,1987.0,25.2,12,6,5,6,1,6,17,35.3,11,4,0,4,5,17,3,0,FW,30-34,Forward,Ivory Coast,Africa
940,Anwar El Ghazi,NED,Aston Villa,Premier League,2019,24.0,1995.0,22.8,20,11,12,5,3,8,26,30.8,18,10,1,9,13,33,16,1,"FW,MF",20-24,Forward,Netherlands,Europe
941,Rachid Ghezzal,ALG,Fiorentina,Serie A,2019,27.0,1992.0,9.2,27,15,14,10,3,10,33,30.3,23,6,0,6,11,38,9,0,"MF,FW",25-29,Midfielder,Algeria,Africa
942,Andrea Ghezzi,ITA,Brescia,Serie A,2019,18.0,2001.0,0.4,2,0,0,1,1,1,1,100.0,0,0,0,0,0,2,0,0,"FW,MF",Under 20,Forward,Italy,Europe
943,Paolo Ghiglione,ITA,Genoa,Serie A,2019,22.0,1997.0,19.1,31,16,15,13,3,18,35,51.4,17,17,2,15,9,40,42,1,"DF,FW",20-24,Defender,Italy,Europe
944,Andrea Ghion,ITA,Sassuolo,Serie A,2019,19.0,2000.0,0.5,3,1,1,2,0,1,1,100.0,0,0,0,0,0,3,0,0,"FW,MF",Under 20,Forward,Italy,Europe
945,Saman Ghoddos,IRN,Amiens,Ligue 1,2019,25.0,1993.0,2.6,2,2,0,1,1,1,2,50.0,1,5,0,5,2,4,3,0,FW,25-29,Forward,Iran,Asia
946,Faouzi Ghoulam,ALG,Napoli,Serie A,2019,28.0,1991.0,4.2,6,4,1,4,1,2,5,40.0,3,3,2,1,4,10,8,0,DF,25-29,Defender,Algeria,Africa
947,Morgan Gibbs-White,ENG,Wolves,Premier League,2019,19.0,2000.0,1.4,0,0,0,0,0,0,0,,0,0,0,0,2,2,0,0,"MF,FW",Under 20,Midfielder,England,Europe
948,Niko Gießelmann,GER,Düsseldorf,Bundesliga,2019,27.0,1991.0,22.9,46,31,31,11,4,22,45,48.9,23,23,6,17,27,73,55,1,DF,25-29,Defender,Germany,Europe
952,Billy Gilmour,SCO,Chelsea,Premier League,2019,18.0,2001.0,2.2,5,2,3,2,0,2,4,50.0,2,2,0,2,3,8,3,1,MF,Under 20,Midfielder,Scotland,Europe
953,Daniel Ginczek,GER,Wolfsburg,Bundesliga,2019,28.0,1991.0,8.5,4,3,3,1,0,1,11,9.1,10,3,1,2,1,5,3,0,FW,25-29,Forward,Germany,Europe
954,Matthias Ginter,GER,Gladbach,Bundesliga,2019,25.0,1994.0,30.9,34,20,19,14,1,17,31,54.8,14,27,22,5,34,68,125,3,DF,25-29,Defender,Germany,Europe
955,Andrei Girotto,BRA,Nantes,Ligue 1,2019,27.0,1992.0,24.2,76,53,45,29,2,39,71,54.9,32,32,17,15,34,110,111,1,DF,25-29,Defender,Brazil,South America
956,Olivier Giroud,FRA,Chelsea,Premier League,2019,32.0,1986.0,11.0,8,3,2,5,1,1,11,9.1,10,14,1,13,2,10,13,0,FW,30-34,Forward,France,Europe
957,Klaus Gjasula,ALB,Paderborn 07,Bundesliga,2019,29.0,1989.0,25.3,69,39,30,35,4,30,61,49.2,31,33,6,27,32,101,50,2,MF,25-29,Midfielder,Albania,Europe
959,Serge Gnabry,GER,Bayern Munich,Bundesliga,2019,24.0,1995.0,24.4,36,16,4,19,13,9,29,31.0,20,17,0,17,16,52,2,1,"FW,MF",20-24,Forward,Germany,Europe
960,Joris Gnagnon,FRA,Rennes,Ligue 1,2019,22.0,1997.0,14.2,16,13,14,2,0,10,11,90.9,1,21,17,4,18,34,61,0,DF,20-24,Defender,France,Europe
961,Eddy Gnahoré,FRA,Amiens,Ligue 1,2019,25.0,1993.0,12.6,24,12,7,15,2,8,28,28.6,20,25,4,21,9,33,25,0,MF,25-29,Midfielder,France,Europe
962,Ben Godfrey,ENG,Norwich City,Premier League,2019,21.0,1998.0,29.4,22,14,18,3,1,10,18,55.6,8,41,37,4,25,47,152,3,DF,20-24,Defender,England,Europe
963,Diego Godín,URU,Inter,Serie A,2019,33.0,1986.0,18.1,38,29,19,16,3,18,32,56.3,14,17,7,10,45,83,60,1,DF,30-34,Defender,Uruguay,South America
964,Akaki Gogia,GER,Union Berlin,Bundesliga,2019,27.0,1992.0,1.3,2,1,0,0,2,0,2,0.0,2,2,2,0,0,2,0,0,"MF,FW",25-29,Midfielder,Germany,Europe
965,Mauro Goicoechea,URU,Toulouse,Ligue 1,2019,31.0,1988.0,2.0,0,0,0,0,0,0,0,,0,0,0,0,0,0,1,2,GK,30-34,Goalkeeper,Uruguay,South America
966,Edoardo Goldaniga,ITA,Genoa,Serie A,2019,25.0,1993.0,8.7,4,3,3,1,0,2,5,40.0,3,11,6,5,18,22,25,1,DF,25-29,Defender,Italy,Europe
967,Benjamin Goller,GER,Werder Bremen,Bundesliga,2019,20.0,1999.0,3.2,8,3,3,4,1,3,10,30.0,7,3,0,3,1,9,1,0,"FW,MF",20-24,Forward,Germany,Europe
968,Pierluigi Gollini,ITA,Atalanta,Serie A,2019,24.0,1995.0,32.0,0,0,0,0,0,0,2,0.0,2,0,0,0,0,0,13,2,GK,20-24,Goalkeeper,Italy,Europe
969,Aleksandr Golovin,RUS,Monaco,Ligue 1,2019,23.0,1996.0,22.9,49,27,17,26,6,14,69,20.3,55,28,0,28,31,80,22,0,MF,20-24,Midfielder,Russia,Europe
970,André Gomes,POR,Everton,Premier League,2019,26.0,1993.0,16.2,22,15,7,11,4,8,62,12.9,54,20,3,17,7,29,7,0,MF,25-29,Midfielder,Portugal,Europe
970,André Gomes,POR,Everton,Premier League,2019,26.0,1993.0,16.2,22,15,7,11,4,8,62,12.9,54,20,3,17,7,29,7,0,MF,25-29,Midfielder,Portugal,Europe
970,André Gomes,POR,Everton,Premier League,2019,26.0,1993.0,16.2,22,15,7,11,4,8,62,12.9,54,20,3,17,7,29,7,0,MF,25-29,Midfielder,Portugal,Europe
970,André Gomes,POR,Everton,Premier League,2019,26.0,1993.0,16.2,22,15,7,11,4,8,62,12.9,54,20,3,17,7,29,7,0,MF,25-29,Midfielder,Portugal,Europe
971,Angel Gomes,ENG,Manchester Utd,Premier League,2019,18.0,2000.0,0.2,0,0,0,0,0,0,0,,0,1,0,1,0,0,0,0,MF,Under 20,Midfielder,England,Europe
973,Joe Gomez,ENG,Liverpool,Premier League,2019,22.0,1997.0,22.3,23,16,17,6,0,9,20,45.0,11,15,8,7,38,61,64,2,DF,20-24,Defender,England,Europe
974,Maxi Gómez,URU,Valencia,La Liga,2019,22.0,1996.0,23.8,9,7,1,6,2,4,8,50.0,4,8,1,7,5,14,14,0,FW,20-24,Forward,Uruguay,South America
976,Papu Gómez,ARG,Atalanta,Serie A,2019,31.0,1988.0,31.6,27,13,5,13,9,13,45,28.9,32,24,0,24,17,44,6,1,"MF,FW",30-34,Midfielder,Argentina,South America
979,Alfred Gomis,SEN,Dijon,Ligue 1,2019,25.0,1993.0,18.0,1,0,1,0,0,1,2,50.0,1,2,0,2,0,1,14,2,GK,25-29,Goalkeeper,Senegal,Africa
980,Maxime Gonalons,FRA,Granada,La Liga,2019,30.0,1989.0,16.7,62,38,25,35,2,22,54,40.7,32,27,3,24,20,82,20,1,MF,30-34,Midfielder,France,Europe
981,Mathieu Goncalves,FRA,Toulouse,Ligue 1,2019,18.0,2001.0,3.5,5,3,5,0,0,2,8,25.0,6,4,3,1,4,9,10,0,DF,Under 20,Defender,France,Europe
982,Jérôme Gondorf,GER,Freiburg,Bundesliga,2019,31.0,1988.0,1.3,9,6,7,1,1,3,6,50.0,3,3,2,1,0,9,2,0,MF,30-34,Midfielder,Germany,Europe
988,Anthony Gordon,ENG,Everton,Premier League,2019,18.0,2001.0,4.9,11,7,5,6,0,5,15,33.3,10,6,2,4,8,19,4,0,"MF,FW",Under 20,Midfielder,England,Europe
989,Leon Goretzka,GER,Bayern Munich,Bundesliga,2019,24.0,1995.0,16.8,28,15,7,18,3,10,32,31.3,22,18,2,16,24,52,8,0,MF,20-24,Midfielder,Germany,Europe
991,Robin Gosens,GER,Atalanta,Serie A,2019,25.0,1994.0,29.1,53,27,19,26,8,23,51,45.1,28,38,10,28,39,92,40,0,DF,25-29,Defender,Germany,Europe
992,Dan Gosling,ENG,Bournemouth,Premier League,2019,29.0,1990.0,14.0,26,10,14,9,3,6,27,22.2,21,31,11,20,20,46,26,0,MF,25-29,Midfielder,England,Europe
993,Mario Götze,GER,Dortmund,Bundesliga,2019,27.0,1992.0,5.8,10,7,0,6,4,3,12,25.0,9,3,0,3,2,12,1,0,FW,25-29,Forward,Germany,Europe
994,Prince-Désir Gouano,FRA,Amiens,Ligue 1,2019,25.0,1993.0,3.0,3,1,0,3,0,0,0,,0,6,3,3,2,5,15,0,DF,25-29,Defender,France,Europe
995,Amine Gouiri,ALG,Lyon,Ligue 1,2019,19.0,2000.0,0.0,0,0,0,0,0,0,0,,0,0,0,0,0,0,0,0,FW,Under 20,Forward,Algeria,Africa
996,Jeffrey Gouweleeuw,NED,Augsburg,Bundesliga,2019,28.0,1991.0,18.3,28,16,22,5,1,12,21,57.1,9,15,8,7,37,65,97,0,DF,25-29,Defender,Netherlands,Europe
997,Max Gradel,CIV,Toulouse,Ligue 1,2019,31.0,1987.0,18.2,36,20,17,14,5,12,47,25.5,35,11,1,10,11,47,23,0,"MF,FW",30-34,Midfielder,Ivory Coast,Africa
998,Samuel Grandsir,FRA,Brest,Ligue 1,2019,22.0,1996.0,16.6,34,22,13,16,5,11,30,36.7,19,9,0,9,14,48,5,0,"FW,MF",20-24,Forward,France,Europe
1000,Alberto Grassi,ITA,Parma,Serie A,2019,24.0,1995.0,7.1,10,4,7,3,0,5,13,38.5,8,5,2,3,19,29,9,1,MF,20-24,Midfielder,Italy,Europe
1001,Andre Gray,JAM,Watford,Premier League,2019,28.0,1991.0,8.4,4,3,0,2,2,1,3,33.3,2,4,1,3,1,5,2,0,FW,25-29,Forward,Jamaica,North America
1002,Demarai Gray,JAM,Leicester City,Premier League,2019,23.0,1996.0,6.9,12,6,6,6,0,6,12,50.0,6,7,0,7,5,17,4,0,"MF,FW",20-24,Midfielder,Jamaica,North America
1003,Jack Grealish,ENG,Aston Villa,Premier League,2019,23.0,1995.0,35.9,29,19,12,12,5,13,34,38.2,21,33,12,21,22,51,22,1,"FW,MF",20-24,Forward,England,Europe
1004,Mason Greenwood,ENG,Manchester Utd,Premier League,2019,17.0,2001.0,14.7,17,11,5,6,6,5,20,25.0,15,9,0,9,6,23,6,1,FW,Under 20,Forward,England,Europe
1005,Michael Gregoritsch,AUT,Augsburg,Bundesliga,2019,25.0,1994.0,3.4,2,2,0,2,0,0,4,0.0,4,4,1,3,3,5,7,0,"MF,FW",25-29,Midfielder,Austria,Europe
1006,Michael Gregoritsch,AUT,Schalke 04,Bundesliga,2019,25.0,1994.0,9.2,8,5,0,6,2,0,9,0.0,9,9,1,8,2,10,10,0,FW,25-29,Forward,Austria,Europe
1007,Clément Grenier,FRA,Rennes,Ligue 1,2019,28.0,1991.0,9.3,21,12,6,15,0,11,40,27.5,29,7,2,5,7,28,16,0,MF,25-29,Midfielder,France,Europe
1008,Antoine Griezmann,FRA,Barcelona,La Liga,2019,28.0,1991.0,28.3,33,18,12,11,10,9,34,26.5,25,22,3,19,12,45,20,1,FW,25-29,Forward,France,Europe
1009,Vincenzo Grifo,ITA,Hoffenheim,Bundesliga,2019,26.0,1993.0,0.2,0,0,0,0,0,0,0,,0,0,0,0,0,0,0,0,MF,25-29,Midfielder,Italy,Europe
1010,Vincenzo Grifo,ITA,Freiburg,Bundesliga,2019,26.0,1993.0,18.0,15,10,9,3,3,6,25,24.0,19,13,1,12,14,29,18,1,"MF,FW",25-29,Midfielder,Italy,Europe
1011,Florian Grillitsch,AUT,Hoffenheim,Bundesliga,2019,23.0,1995.0,26.8,59,29,34,24,1,29,61,47.5,32,33,6,27,49,108,41,1,"MF,DF",20-24,Midfielder,Austria,Europe
1012,Jérémy Grimm,FRA,Strasbourg,Ligue 1,2019,32.0,1987.0,0.0,0,0,0,0,0,0,0,,0,0,0,0,0,0,0,0,MF,30-34,Midfielder,France,Europe
1013,Christian Groß,GER,Werder Bremen,Bundesliga,2019,30.0,1989.0,9.7,23,17,16,5,2,9,16,56.3,7,13,7,6,14,37,50,1,"DF,MF",30-34,Defender,Germany,Europe
1014,Pascal Groß,GER,Brighton,Premier League,2019,28.0,1991.0,20.0,36,13,8,21,7,14,39,35.9,25,25,3,22,9,45,7,0,"MF,FW",25-29,Midfielder,Germany,Europe
1015,Carlos Gruezo,ECU,Augsburg,Bundesliga,2019,24.0,1995.0,9.8,28,12,12,15,1,5,24,20.8,19,5,0,5,6,34,5,0,MF,20-24,Midfielder,Ecuador,South America
1018,Andrés Guardado,MEX,Betis,La Liga,2019,32.0,1986.0,22.7,30,14,15,11,4,15,41,36.6,26,15,4,11,18,48,22,1,MF,30-34,Midfielder,Mexico,North America
1021,Gonçalo Guedes,POR,Valencia,La Liga,2019,22.0,1996.0,14.1,19,11,11,7,1,9,32,28.1,23,10,1,9,7,26,1,0,"MF,FW",20-24,Midfielder,Portugal,Europe
1022,Mattéo Guendouzi,FRA,Arsenal,Premier League,2019,20.0,1999.0,19.4,31,16,14,13,4,14,43,32.6,29,21,7,14,29,60,38,2,MF,20-24,Midfielder,France,Europe
1023,Raphaël Guerreiro,POR,Dortmund,Bundesliga,2019,25.0,1993.0,25.9,44,24,18,21,5,20,32,62.5,12,27,3,24,42,86,26,0,"DF,MF",25-29,Defender,Portugal,Europe
1026,Babacar Guèye,SEN,Paderborn 07,Bundesliga,2019,24.0,1994.0,1.2,2,0,0,0,2,0,1,0.0,1,1,1,0,0,2,3,0,FW,20-24,Forward,Senegal,Africa
1027,John Guidetti,SWE,Alavés,La Liga,2019,27.0,1992.0,1.1,2,1,0,1,1,0,0,,0,1,0,1,0,2,0,0,"FW,MF",25-29,Forward,Sweden,Europe
1028,Josuha Guilavogui,FRA,Wolfsburg,Bundesliga,2019,28.0,1990.0,22.9,41,26,17,23,1,10,30,33.3,20,35,9,26,45,86,64,2,"MF,DF",25-29,Midfielder,France,Europe
1029,Frederic Guilbert,FRA,Aston Villa,Premier League,2019,24.0,1994.0,22.7,74,43,48,20,6,36,67,53.7,31,33,10,23,49,123,74,2,"DF,MF",20-24,Defender,France,Europe
1031,Bruno Guimarães,BRA,Lyon,Ligue 1,2019,21.0,1997.0,3.0,12,7,5,6,1,5,10,50.0,5,1,0,1,4,16,1,0,MF,20-24,Midfielder,Brazil,South America
1032,Serhou Guirassy,GUI,Amiens,Ligue 1,2019,23.0,1996.0,21.3,7,3,1,4,2,2,7,28.6,5,13,6,7,4,11,21,0,FW,20-24,Forward,Guinea,Africa
1033,Rafik Guitane,FRA,Rennes,Ligue 1,2019,20.0,1999.0,0.2,0,0,0,0,0,0,0,,0,0,0,0,0,0,0,0,MF,20-24,Midfielder,France,Europe
1034,Péter Gulácsi,HUN,RB Leipzig,Bundesliga,2019,29.0,1990.0,32.0,0,0,0,0,0,0,0,,0,0,0,0,1,1,18,6,GK,25-29,Goalkeeper,Hungary,Europe
1035,Manuel Gulde,GER,Freiburg,Bundesliga,2019,28.0,1991.0,15.2,28,16,17,9,2,15,24,62.5,9,23,13,10,22,50,80,1,DF,25-29,Defender,Germany,Europe
1037,İlkay Gündoğan,GER,Manchester City,Premier League,2019,28.0,1990.0,22.4,27,16,9,11,7,9,41,22.0,32,17,5,12,31,58,13,0,MF,25-29,Midfielder,Germany,Europe
1038,Angus Gunn,SCO,Southampton,Premier League,2019,23.0,1996.0,10.0,1,1,1,0,0,1,3,33.3,2,0,0,0,0,1,1,0,GK,20-24,Goalkeeper,Scotland,Europe
1039,Christian Günter,GER,Freiburg,Bundesliga,2019,26.0,1993.0,33.7,25,11,17,7,1,12,35,34.3,23,29,13,16,14,39,40,0,DF,25-29,Defender,Germany,Europe
1040,Koray Günter,GER,Hellas Verona,Serie A,2019,24.0,1994.0,30.4,39,25,22,15,2,19,29,65.5,10,45,39,6,55,94,131,1,DF,20-24,Defender,Germany,Europe
1041,Régis Gurtner,FRA,Amiens,Ligue 1,2019,32.0,1986.0,28.0,1,1,1,0,0,1,2,50.0,1,0,0,0,0,1,10,4,GK,30-34,Goalkeeper,France,Europe
1042,Luiz Gustavo,BRA,Marseille,Ligue 1,2019,32.0,1987.0,2.1,6,3,3,3,0,3,5,60.0,2,5,2,3,5,11,6,0,MF,30-34,Midfielder,Brazil,South America
1042,Luiz Gustavo,BRA,Marseille,Ligue 1,2019,32.0,1987.0,2.1,6,3,3,3,0,3,5,60.0,2,5,2,3,5,11,6,0,MF,30-34,Midfielder,Brazil,South America
1042,Luiz Gustavo,BRA,Marseille,Ligue 1,2019,32.0,1987.0,2.1,6,3,3,3,0,3,5,60.0,2,5,2,3,5,11,6,0,MF,30-34,Midfielder,Brazil,South America
1042,Luiz Gustavo,BRA,Marseille,Ligue 1,2019,32.0,1987.0,2.1,6,3,3,3,0,3,5,60.0,2,5,2,3,5,11,6,0,MF,30-34,Midfielder,Brazil,South America
1043,Jonathan de Guzmán,NED,Eint Frankfurt,Bundesliga,2019,31.0,1987.0,1.0,1,1,0,1,0,1,7,14.3,6,2,0,2,1,2,0,0,MF,30-34,Midfielder,Netherlands,Europe
1045,Janik Haberer,GER,Freiburg,Bundesliga,2019,25.0,1994.0,19.1,26,18,8,14,4,12,45,26.7,33,25,4,21,25,51,23,0,"MF,FW",25-29,Midfielder,Germany,Europe
1046,Alexander Hack,GER,Mainz 05,Bundesliga,2019,25.0,1993.0,8.9,26,10,19,6,1,16,27,59.3,11,20,9,11,23,49,60,1,DF,25-29,Defender,Germany,Europe
1047,Munir El Haddadi,MAR,Sevilla,La Liga,2019,23.0,1995.0,13.9,19,17,6,11,2,4,21,19.0,17,8,0,8,7,26,8,0,FW,20-24,Forward,Morocco,Africa
1048,André Hahn,GER,Augsburg,Bundesliga,2019,28.0,1990.0,7.8,15,9,7,5,3,5,21,23.8,16,23,5,18,13,28,14,0,"FW,MF",25-29,Forward,Germany,Europe
1049,Amadou Haidara,MLI,RB Leipzig,Bundesliga,2019,21.0,1998.0,8.4,26,16,7,17,2,10,24,41.7,14,14,2,12,8,34,10,1,MF,20-24,Midfielder,Mali,Africa
1050,Achraf Hakimi,MAR,Dortmund,Bundesliga,2019,20.0,1998.0,30.2,60,41,38,14,8,27,64,42.2,37,26,2,24,30,90,27,2,"DF,MF",20-24,Defender,Morocco,Africa
1051,Sébastien Haller,CIV,West Ham,Premier League,2019,25.0,1994.0,25.2,22,15,8,10,4,3,30,10.0,27,19,5,14,8,30,27,0,FW,25-29,Forward,Ivory Coast,Africa
1052,Marcel Halstenberg,GER,RB Leipzig,Bundesliga,2019,27.0,1991.0,28.0,46,31,27,17,2,28,58,48.3,30,37,11,26,46,92,72,2,DF,25-29,Defender,Germany,Europe
1053,Romain Hamouma,FRA,Saint-Étienne,Ligue 1,2019,32.0,1987.0,9.6,12,9,1,5,6,2,12,16.7,10,12,0,12,0,12,4,0,"FW,MF",30-34,Forward,France,Europe
1055,Grant Hanley,SCO,Norwich City,Premier League,2019,27.0,1991.0,14.0,24,15,17,7,0,8,14,57.1,6,25,18,7,31,55,77,1,DF,25-29,Defender,Scotland,Europe
1056,Lukáš Haraslín,SVK,Sassuolo,Serie A,2019,23.0,1996.0,4.3,5,2,1,3,1,2,9,22.2,7,5,0,5,4,9,1,0,FW,20-24,Forward,Slovakia,Europe
1057,Amine Harit,MAR,Schalke 04,Bundesliga,2019,22.0,1997.0,23.4,16,7,8,5,3,6,25,24.0,19,13,0,13,7,23,2,1,"MF,FW",20-24,Midfielder,Morocco,Africa
1058,Martin Harnik,AUT,Werder Bremen,Bundesliga,2019,32.0,1987.0,0.1,0,0,0,0,0,0,0,,0,0,0,0,0,0,0,0,"MF,FW",30-34,Midfielder,Austria,Europe
1059,Makoto Hasebe,JPN,Eint Frankfurt,Bundesliga,2019,35.0,1984.0,21.9,28,20,16,9,3,18,39,46.2,21,38,10,28,26,54,38,0,"DF,MF",35-39,Defender,Japan,Asia
1060,Hans Hateboer,NED,Atalanta,Serie A,2019,25.0,1994.0,26.2,36,23,20,9,7,18,38,47.4,20,22,7,15,10,46,32,1,DF,25-29,Defender,Netherlands,Europe
1061,Kortney Hause,ENG,Aston Villa,Premier League,2019,24.0,1995.0,17.2,21,9,15,5,1,8,15,53.3,7,27,19,8,20,41,98,4,DF,20-24,Defender,England,Europe
1062,Kai Havertz,GER,Leverkusen,Bundesliga,2019,20.0,1999.0,27.3,21,15,5,10,6,6,39,15.4,33,22,0,22,2,23,22,0,"MF,FW",20-24,Midfielder,Germany,Europe
1063,Isaac Hayden,ENG,Newcastle Utd,Premier League,2019,24.0,1995.0,24.7,55,27,33,17,5,20,50,40.0,30,24,7,17,38,93,38,0,MF,20-24,Midfielder,England,Europe
1064,Eden Hazard,BEL,Real Madrid,La Liga,2019,28.0,1991.0,12.0,7,3,2,3,2,3,15,20.0,12,5,0,5,6,13,0,0,"FW,MF",25-29,Forward,Belgium,Europe
1065,Thorgan Hazard,BEL,Dortmund,Bundesliga,2019,26.0,1993.0,26.4,40,27,17,14,9,12,50,24.0,38,29,0,29,13,53,2,1,"FW,MF",25-29,Forward,Belgium,Europe
1066,Tom Heaton,ENG,Aston Villa,Premier League,2019,33.0,1986.0,19.9,3,2,3,0,0,3,4,75.0,1,0,0,0,0,3,6,0,GK,30-34,Goalkeeper,England,Europe
1067,Jonas Hector,GER,Köln,Bundesliga,2019,29.0,1990.0,27.0,76,49,37,34,5,24,75,32.0,51,44,10,34,46,122,38,1,"MF,DF",25-29,Midfielder,Germany,Europe
1068,Dominique Heintz,GER,Freiburg,Bundesliga,2019,25.0,1993.0,27.0,47,30,40,6,1,17,43,39.5,26,38,25,13,41,88,131,1,DF,25-29,Defender,Germany,Europe
1069,Dean Henderson,ENG,Sheffield Utd,Premier League,2019,22.0,1997.0,36.0,0,0,0,0,0,0,0,,0,0,0,0,1,1,13,1,GK,20-24,Goalkeeper,England,Europe
1070,Jordan Henderson,ENG,Liverpool,Premier League,2019,29.0,1990.0,24.9,63,41,18,33,12,22,55,40.0,33,22,4,18,30,93,21,2,MF,25-29,Midfielder,England,Europe
1071,Liam Henderson,SCO,Hellas Verona,Serie A,2019,23.0,1996.0,2.2,3,2,0,3,0,2,3,66.7,1,1,0,1,0,3,4,0,MF,20-24,Midfielder,Scotland,Europe
1072,Jeff Hendrick,IRL,Burnley,Premier League,2019,27.0,1992.0,21.5,18,10,7,8,3,7,27,25.9,20,21,8,13,20,38,20,0,MF,25-29,Midfielder,Republic of Ireland,Europe
1073,Wayne Hennessey,WAL,Crystal Palace,Premier League,2019,32.0,1987.0,3.0,0,0,0,0,0,0,0,,0,0,0,0,1,1,3,1,GK,30-34,Goalkeeper,Wales,Europe
1074,Rouwen Hennings,GER,Düsseldorf,Bundesliga,2019,31.0,1987.0,27.3,11,5,2,7,2,3,18,16.7,15,12,0,12,2,13,33,0,FW,30-34,Forward,Germany,Europe
1075,Benjamin Henrichs,GER,Monaco,Ligue 1,2019,22.0,1997.0,9.9,26,20,16,9,1,14,33,42.4,19,19,4,15,14,40,18,0,"DF,MF",20-24,Defender,Germany,Europe
1076,Dalbert Henrique,BRA,Fiorentina,Serie A,2019,25.0,1993.0,27.6,52,25,35,12,5,18,51,35.3,33,34,4,30,19,71,65,0,"DF,MF",25-29,Defender,Brazil,South America
1080,Javier Hernández,MEX,West Ham,Premier League,2019,31.0,1988.0,1.2,0,0,0,0,0,0,1,0.0,1,0,0,0,1,1,0,0,FW,30-34,Forward,Mexico,North America
1081,Javier Hernández,MEX,Sevilla,La Liga,2019,31.0,1988.0,5.0,6,4,0,4,2,1,6,16.7,5,5,0,5,5,11,1,0,FW,30-34,Forward,Mexico,North America
1083,Lucas Hernández,FRA,Bayern Munich,Bundesliga,2019,23.0,1996.0,10.2,18,9,13,3,2,9,15,60.0,6,6,1,5,15,33,17,0,DF,20-24,Defender,France,Europe
1085,Theo Hernández,FRA,Milan,Serie A,2019,21.0,1997.0,31.3,56,39,32,18,6,33,53,62.3,20,34,6,28,43,99,62,2,DF,20-24,Defender,France,Europe
1086,Hernani,BRA,Parma,Serie A,2019,25.0,1994.0,26.9,61,31,25,31,5,30,112,26.8,82,53,11,42,50,111,51,1,MF,25-29,Midfielder,Brazil,South America
1088,Héctor Herrera,MEX,Atlético Madrid,La Liga,2019,29.0,1990.0,12.5,31,21,9,18,4,13,32,40.6,19,16,7,9,17,48,13,2,MF,25-29,Midfielder,Mexico,North America
1090,Yangel Herrera,VEN,Granada,La Liga,2019,21.0,1998.0,26.3,88,49,25,53,10,36,80,45.0,44,38,9,29,34,122,28,0,MF,20-24,Midfielder,Venezuela,South America
1092,Patrick Herrmann,GER,Gladbach,Bundesliga,2019,28.0,1991.0,16.1,24,11,8,10,6,5,16,31.3,11,21,4,17,11,35,8,0,"FW,MF",25-29,Forward,Germany,Europe
1094,Son Heung-min,KOR,Tottenham,Premier League,2019,27.0,1992.0,27.5,23,15,10,11,2,9,57,15.8,48,23,0,23,19,42,18,1,FW,25-29,Forward,South Korea,Asia
1095,Gonzalo Higuaín,ARG,Juventus,Serie A,2019,31.0,1987.0,20.7,13,7,2,6,5,4,31,12.9,27,12,0,12,6,19,14,0,FW,30-34,Forward,Argentina,South America
1096,Vitorino Hilton,BRA,Montpellier,Ligue 1,2019,41.0,1977.0,27.9,27,17,20,7,0,13,28,46.4,15,22,18,4,49,76,121,1,DF,Over 40,Defender,Brazil,South America
1097,Martin Hinteregger,AUT,Eint Frankfurt,Bundesliga,2019,26.0,1992.0,30.2,66,51,33,30,3,28,57,49.1,29,41,21,20,36,102,96,0,DF,25-29,Defender,Austria,Europe
1098,George Hirst,ENG,Leicester City,Premier League,2019,20.0,1999.0,0.1,0,0,0,0,0,0,0,,0,0,0,0,0,0,0,0,"MF,DF",20-24,Midfielder,England,Europe
1099,Marwin Hitz,SUI,Dortmund,Bundesliga,2019,31.0,1987.0,3.2,0,0,0,0,0,0,0,,0,0,0,0,0,0,0,0,GK,30-34,Goalkeeper,Switzerland,Europe
1100,André Hoffmann,GER,Düsseldorf,Bundesliga,2019,26.0,1993.0,27.0,48,22,30,18,0,16,50,32.0,34,22,9,13,56,104,90,0,DF,25-29,Defender,Germany,Europe
1101,Nicolas Höfler,GER,Freiburg,Bundesliga,2019,29.0,1990.0,30.9,65,40,31,28,6,22,64,34.4,42,58,18,40,71,136,59,3,MF,25-29,Midfielder,Germany,Europe
1102,Jonas Hofmann,GER,Gladbach,Bundesliga,2019,27.0,1992.0,18.1,43,27,22,12,9,22,76,28.9,54,28,3,25,18,61,14,0,"MF,FW",25-29,Midfielder,Germany,Europe
1102,Jonas Hofmann,GER,Gladbach,Bundesliga,2019,27.0,1992.0,18.1,43,27,22,12,9,22,76,28.9,54,28,3,25,18,61,14,0,"MF,FW",25-29,Midfielder,Germany,Europe
1102,Jonas Hofmann,GER,Gladbach,Bundesliga,2019,27.0,1992.0,18.1,43,27,22,12,9,22,76,28.9,54,28,3,25,18,61,14,0,"MF,FW",25-29,Midfielder,Germany,Europe
1102,Jonas Hofmann,GER,Gladbach,Bundesliga,2019,27.0,1992.0,18.1,43,27,22,12,9,22,76,28.9,54,28,3,25,18,61,14,0,"MF,FW",25-29,Midfielder,Germany,Europe
1103,Jonas Hofmann,GER,Schalke 04,Bundesliga,2019,22.0,1997.0,0.0,0,0,0,0,0,0,0,,0,0,0,0,0,0,2,0,MF,20-24,Midfielder,Germany,Europe
1103,Jonas Hofmann,GER,Schalke 04,Bundesliga,2019,22.0,1997.0,0.0,0,0,0,0,0,0,0,,0,0,0,0,0,0,2,0,MF,20-24,Midfielder,Germany,Europe
1103,Jonas Hofmann,GER,Schalke 04,Bundesliga,2019,22.0,1997.0,0.0,0,0,0,0,0,0,0,,0,0,0,0,0,0,2,0,MF,20-24,Midfielder,Germany,Europe
1103,Jonas Hofmann,GER,Schalke 04,Bundesliga,2019,22.0,1997.0,0.0,0,0,0,0,0,0,0,,0,0,0,0,0,0,2,0,MF,20-24,Midfielder,Germany,Europe
1104,Marco Höger,GER,Köln,Bundesliga,2019,29.0,1989.0,7.5,10,6,4,5,1,6,16,37.5,10,14,4,10,6,16,15,0,MF,25-29,Midfielder,Germany,Europe
1105,Rob Holding,ENG,Arsenal,Premier League,2019,23.0,1995.0,6.5,4,2,3,1,0,1,3,33.3,2,10,6,4,5,9,45,1,DF,20-24,Defender,England,Europe
1106,José Holebas,GRE,Watford,Premier League,2019,35.0,1984.0,11.4,26,15,19,7,0,9,28,32.1,19,11,4,7,3,29,33,0,DF,35-39,Defender,Greece,Europe
1107,Lucas Höler,GER,Freiburg,Bundesliga,2019,25.0,1994.0,27.6,35,15,11,16,8,11,46,23.9,35,30,9,21,12,47,38,0,"FW,MF",25-29,Forward,Germany,Europe
1108,Mason Holgate,ENG,Everton,Premier League,2019,22.0,1996.0,22.8,44,26,30,13,1,21,31,67.7,10,26,13,13,34,78,97,0,DF,20-24,Defender,England,Europe
1109,Nathan Holland,ENG,West Ham,Premier League,2019,21.0,1998.0,0.4,3,1,2,1,0,0,0,,0,1,0,1,0,3,0,0,MF,20-24,Midfielder,England,Europe
1110,Gerrit Holtmann,PHI,Paderborn 07,Bundesliga,2019,24.0,1995.0,11.8,24,14,14,6,4,15,37,40.5,22,21,1,20,6,30,8,0,"MF,DF",20-24,Midfielder,Philippines,Asia
1112,Franck Honorat,FRA,Saint-Étienne,Ligue 1,2019,22.0,1996.0,9.4,16,11,7,8,1,8,23,34.8,15,12,1,11,5,21,13,1,"FW,DF",20-24,Forward,France,Europe
1113,Luca Horn,GER,Wolfsburg,Bundesliga,2019,20.0,1998.0,0.1,0,0,0,0,0,0,0,,0,0,0,0,0,0,0,0,DF,20-24,Defender,Germany,Europe
1114,Timo Horn,GER,Köln,Bundesliga,2019,26.0,1993.0,34.0,0,0,0,0,0,0,5,0.0,5,0,0,0,2,2,15,1,GK,25-29,Goalkeeper,Germany,Europe
1115,Krisztofer Horváth,HUN,SPAL,Serie A,2019,17.0,2002.0,0.5,1,1,0,1,0,0,0,,0,0,0,0,0,1,0,0,"FW,DF",Under 20,Forward,Hungary,Europe
1116,Conor Hourihane,IRL,Aston Villa,Premier League,2019,28.0,1991.0,17.0,16,10,4,8,4,10,25,40.0,15,19,4,15,9,25,31,0,MF,25-29,Midfielder,Republic of Ireland,Europe
1117,Lukáš Hrádecký,FIN,Leverkusen,Bundesliga,2019,29.0,1989.0,34.0,0,0,0,0,0,0,1,0.0,1,0,0,0,2,2,19,2,GK,25-29,Goalkeeper,Finland,Europe
1118,Benjamin Hübner,GER,Hoffenheim,Bundesliga,2019,30.0,1989.0,23.0,42,26,33,9,0,23,45,51.1,22,18,13,5,30,72,98,2,DF,30-34,Defender,Germany,Europe
1119,Florian Hübner,GER,Union Berlin,Bundesliga,2019,28.0,1991.0,9.4,16,14,12,4,0,7,17,41.2,10,11,7,4,16,32,39,0,DF,25-29,Defender,Germany,Europe
1120,Callum Hudson-Odoi,ENG,Chelsea,Premier League,2019,18.0,2000.0,9.6,10,4,4,5,1,1,7,14.3,6,9,0,9,5,15,4,1,"FW,MF",Under 20,Forward,England,Europe
1121,Will Hughes,ENG,Watford,Premier League,2019,24.0,1995.0,25.0,75,47,24,41,10,25,67,37.3,42,48,8,40,37,112,28,0,MF,20-24,Midfielder,England,Europe
1122,Mats Hummels,GER,Dortmund,Bundesliga,2019,30.0,1988.0,28.7,57,30,30,26,1,20,38,52.6,18,41,18,23,59,116,110,1,DF,30-34,Defender,Germany,Europe
1123,Uwe Hünemeier,GER,Paderborn 07,Bundesliga,2019,33.0,1986.0,13.4,20,15,9,11,0,10,20,50.0,10,22,12,10,24,44,63,0,DF,30-34,Defender,Germany,Europe
1124,Adrien Hunou,FRA,Rennes,Ligue 1,2019,25.0,1994.0,13.4,21,18,5,11,5,4,21,19.0,17,16,1,15,5,26,5,0,"FW,MF",25-29,Forward,France,Europe
1125,Jannik Huth,GER,Paderborn 07,Bundesliga,2019,25.0,1994.0,6.0,0,0,0,0,0,0,1,0.0,1,0,0,0,0,0,2,0,GK,25-29,Goalkeeper,Germany,Europe
1126,Elseid Hysaj,ALB,Napoli,Serie A,2019,25.0,1994.0,16.5,18,9,13,4,1,12,26,46.2,14,16,3,13,24,42,26,0,DF,25-29,Defender,Albania,Europe
1127,Suk Hyun-jun,KOR,Reims,Ligue 1,2019,28.0,1991.0,2.9,3,3,1,1,1,1,2,50.0,1,1,0,1,1,4,2,0,"FW,MF",25-29,Forward,South Korea,Asia
1128,Pierre Højbjerg,DEN,Southampton,Premier League,2019,23.0,1995.0,30.6,80,49,34,38,8,39,91,42.9,52,44,5,39,46,126,54,2,MF,20-24,Midfielder,Denmark,Europe
1129,Simone Iacoponi,ITA,Parma,Serie A,2019,32.0,1987.0,33.9,49,25,36,12,1,26,42,61.9,16,37,29,8,35,84,140,2,DF,30-34,Defender,Italy,Europe
1130,Iago,BRA,Augsburg,Bundesliga,2019,22.0,1997.0,7.5,19,12,12,7,0,9,18,50.0,9,6,2,4,14,33,27,0,"DF,MF",20-24,Defender,Brazil,South America
1132,Roger Ibanez,BRA,Roma,Serie A,2019,20.0,1998.0,6.8,11,8,6,3,2,5,7,71.4,2,9,6,3,18,29,21,1,DF,20-24,Defender,Brazil,South America
1133,Jordon Ibe,ENG,Bournemouth,Premier League,2019,23.0,1995.0,0.6,2,2,2,0,0,1,1,100.0,0,0,0,0,0,2,1,0,DF,20-24,Defender,England,Europe
1134,Vedad Ibišević,BIH,Hertha BSC,Bundesliga,2019,34.0,1984.0,14.0,4,3,0,1,3,0,3,0.0,3,4,0,4,1,5,15,0,FW,30-34,Forward,Bosnia and Herzegovina,Europe
1136,Didier Ibrahim Ndong,GAB,Dijon,Ligue 1,2019,25.0,1994.0,26.5,62,35,30,31,1,30,59,50.8,29,27,6,21,49,111,31,0,MF,25-29,Midfielder,Gabon,Africa
1137,Zlatan Ibrahimović,SWE,Milan,Serie A,2019,37.0,1981.0,15.1,5,1,0,2,3,1,13,7.7,12,4,3,1,5,10,21,0,FW,35-39,Forward,Sweden,Europe
1138,Mauro Icardi,ARG,Paris S-G,Ligue 1,2019,26.0,1993.0,14.1,4,2,1,3,0,1,10,10.0,9,7,1,6,2,6,11,0,FW,25-29,Forward,Argentina,South America
1139,Adam Idah,IRL,Norwich City,Premier League,2019,18.0,2001.0,2.5,2,2,1,0,1,2,3,66.7,1,4,0,4,0,2,1,0,"FW,MF",Under 20,Forward,Republic of Ireland,Europe
1140,Odion Ighalo,NGA,Manchester Utd,Premier League,2019,30.0,1989.0,1.1,2,2,0,2,0,1,3,33.3,2,1,1,0,0,2,0,0,FW,30-34,Forward,Nigeria,Africa
1142,Igor,BRA,SPAL,Serie A,2019,21.0,1998.0,14.9,24,16,13,10,1,14,20,70.0,6,17,9,8,24,48,37,1,DF,20-24,Defender,Brazil,South America
1142,Igor,BRA,SPAL,Serie A,2019,21.0,1998.0,14.9,24,16,13,10,1,14,20,70.0,6,17,9,8,24,48,37,1,DF,20-24,Defender,Brazil,South America
1142,Igor,BRA,SPAL,Serie A,2019,21.0,1998.0,14.9,24,16,13,10,1,14,20,70.0,6,17,9,8,24,48,37,1,DF,20-24,Defender,Brazil,South America
1142,Igor,BRA,SPAL,Serie A,2019,21.0,1998.0,14.9,24,16,13,10,1,14,20,70.0,6,17,9,8,24,48,37,1,DF,20-24,Defender,Brazil,South America
1143,Igor,BRA,Fiorentina,Serie A,2019,21.0,1998.0,6.8,12,10,8,2,2,6,7,85.7,1,10,4,6,7,19,16,0,DF,20-24,Defender,Brazil,South America
1143,Igor,BRA,Fiorentina,Serie A,2019,21.0,1998.0,6.8,12,10,8,2,2,6,7,85.7,1,10,4,6,7,19,16,0,DF,20-24,Defender,Brazil,South America
1143,Igor,BRA,Fiorentina,Serie A,2019,21.0,1998.0,6.8,12,10,8,2,2,6,7,85.7,1,10,4,6,7,19,16,0,DF,20-24,Defender,Brazil,South America
1143,Igor,BRA,Fiorentina,Serie A,2019,21.0,1998.0,6.8,12,10,8,2,2,6,7,85.7,1,10,4,6,7,19,16,0,DF,20-24,Defender,Brazil,South America
1144,Kelechi Iheanacho,NGA,Leicester City,Premier League,2019,22.0,1996.0,10.7,3,1,1,2,0,1,9,11.1,8,8,1,7,3,6,8,0,FW,20-24,Forward,Nigeria,Africa
1145,Luc Ihorst,GER,Werder Bremen,Bundesliga,2019,19.0,2000.0,0.1,1,1,0,0,1,0,0,,0,1,0,1,0,1,0,0,FW,Under 20,Forward,Germany,Europe
1146,Jonathan Ikone,FRA,Lille,Ligue 1,2019,21.0,1998.0,22.9,15,7,3,7,5,6,24,25.0,18,26,2,24,5,20,3,0,"MF,FW",20-24,Midfielder,France,Europe
1147,Yun Il-lok,KOR,Montpellier,Ligue 1,2019,27.0,1992.0,1.3,1,1,0,1,0,0,4,0.0,4,0,0,0,0,1,0,0,"MF,FW",25-29,Midfielder,South Korea,Asia
1150,Stefan Ilsanker,AUT,RB Leipzig,Bundesliga,2019,30.0,1989.0,4.6,3,1,3,0,0,3,6,50.0,3,6,3,3,7,10,21,0,DF,30-34,Defender,Austria,Europe
1151,Stefan Ilsanker,AUT,Eint Frankfurt,Bundesliga,2019,30.0,1989.0,9.3,23,15,16,7,0,10,23,43.5,13,8,1,7,19,42,26,0,"DF,MF",30-34,Defender,Austria,Europe
1152,Giannelli Imbula,COD,Lecce,Serie A,2019,26.0,1992.0,1.4,2,0,2,0,0,0,1,0.0,1,4,1,3,2,4,0,0,MF,25-29,Midfielder,DR Congo,Africa
1153,Ciro Immobile,ITA,Lazio,Serie A,2019,29.0,1990.0,35.2,8,6,2,4,2,0,24,0.0,24,10,2,8,11,19,7,0,FW,25-29,Forward,Italy,Europe
1154,Roberto Inglese,ITA,Parma,Serie A,2019,27.0,1991.0,8.5,9,6,2,2,5,2,10,20.0,8,8,2,6,2,11,1,0,FW,25-29,Forward,Italy,Europe
1155,Danny Ings,ENG,Southampton,Premier League,2019,27.0,1992.0,31.2,42,25,16,16,10,13,67,19.4,54,62,4,58,9,51,30,1,FW,25-29,Forward,England,Europe
1156,Marcus Ingvartsen,DEN,Union Berlin,Bundesliga,2019,23.0,1996.0,19.1,20,14,5,7,8,9,28,32.1,19,16,1,15,16,36,16,0,"MF,FW",20-24,Midfielder,Denmark,Europe
1157,Lorenzo Insigne,ITA,Napoli,Serie A,2019,28.0,1991.0,31.2,21,15,6,8,7,6,35,17.1,29,13,0,13,30,51,4,1,"FW,MF",25-29,Forward,Italy,Europe
1158,Takashi Inui,JPN,Eibar,La Liga,2019,31.0,1988.0,21.8,20,10,7,8,5,11,34,32.4,23,23,4,19,18,38,12,0,"MF,FW",30-34,Midfielder,Japan,Asia
1159,Artur Ioniță,MDA,Cagliari,Serie A,2019,28.0,1990.0,21.1,38,23,12,22,4,12,37,32.4,25,32,10,22,18,56,24,2,MF,25-29,Midfielder,Moldova,Europe
1160,Alexander Isak,SWE,Real Sociedad,La Liga,2019,19.0,1999.0,16.7,7,2,0,3,4,1,8,12.5,7,8,0,8,3,10,6,0,FW,Under 20,Forward,Sweden,Europe
1162,Nicolas Isimat-Mirin,FRA,Toulouse,Ligue 1,2019,27.0,1991.0,14.0,14,8,8,6,0,5,11,45.5,6,18,12,6,22,36,71,0,DF,25-29,Defender,France,Europe
1165,Gian-Luca Itter,GER,Freiburg,Bundesliga,2019,20.0,1999.0,0.4,1,1,1,0,0,1,1,100.0,0,0,0,0,1,2,4,0,"DF,MF",20-24,Defender,Germany,Europe
1167,Alex Iwobi,NGA,Everton,Premier League,2019,23.0,1996.0,17.7,25,17,8,15,2,12,33,36.4,21,18,2,16,14,39,10,1,"MF,FW",20-24,Midfielder,Nigeria,Africa
1168,Armando Izzo,ITA,Torino,Serie A,2019,27.0,1992.0,29.8,42,24,24,14,4,17,35,48.6,18,44,29,15,71,113,121,1,DF,25-29,Defender,Italy,Europe
1170,Phil Jagielka,ENG,Sheffield Utd,Premier League,2019,36.0,1982.0,2.7,5,4,3,2,0,1,3,33.3,2,5,5,0,4,9,19,0,DF,35-39,Defender,England,Europe
1172,Alireza Jahanbakhsh,IRN,Brighton,Premier League,2019,25.0,1993.0,3.5,8,4,3,2,3,0,2,0.0,2,5,0,5,3,11,2,0,"FW,MF",25-29,Forward,Iran,Asia
1173,Mato Jajalo,BIH,Udinese,Serie A,2019,31.0,1988.0,18.3,44,19,19,22,3,14,38,36.8,24,20,7,13,19,63,19,2,MF,30-34,Midfielder,Bosnia and Herzegovina,Europe
1174,Ismail Jakobs,SEN,Köln,Bundesliga,2019,19.0,1999.0,18.6,34,23,18,9,7,10,23,43.5,13,25,3,22,24,58,30,0,"FW,DF",Under 20,Forward,Senegal,Africa
1175,Christophe Jallet,FRA,Amiens,Ligue 1,2019,35.0,1983.0,9.5,24,16,14,8,2,14,37,37.8,23,8,2,6,18,42,29,0,DF,35-39,Defender,France,Europe
1176,Daniel James,WAL,Manchester Utd,Premier League,2019,21.0,1997.0,25.4,20,10,5,10,5,7,45,15.6,38,23,4,19,7,27,12,0,FW,20-24,Forward,Wales,Europe
1177,Matty James,ENG,Leicester City,Premier League,2019,28.0,1991.0,0.1,0,0,0,0,0,0,0,,0,0,0,0,0,0,0,0,MF,25-29,Midfielder,England,Europe
1178,Reece James,ENG,Chelsea,Premier League,2019,19.0,1999.0,16.8,36,23,18,14,4,11,29,37.9,18,19,8,11,22,58,28,0,DF,Under 20,Defender,England,Europe
1178,Reece James,ENG,Chelsea,Premier League,2019,19.0,1999.0,16.8,36,23,18,14,4,11,29,37.9,18,19,8,11,22,58,28,0,DF,Under 20,Defender,England,Europe
1178,Reece James,ENG,Chelsea,Premier League,2019,19.0,1999.0,16.8,36,23,18,14,4,11,29,37.9,18,19,8,11,22,58,28,0,DF,Under 20,Defender,England,Europe
1178,Reece James,ENG,Chelsea,Premier League,2019,19.0,1999.0,16.8,36,23,18,14,4,11,29,37.9,18,19,8,11,22,58,28,0,DF,Under 20,Defender,England,Europe
1179,Marko Janković,MNE,SPAL,Serie A,2019,24.0,1995.0,1.3,2,1,0,0,2,1,2,50.0,1,2,1,1,0,2,0,0,"FW,DF",20-24,Forward,Montenegro,Europe
1181,Daryl Janmaat,NED,Watford,Premier League,2019,30.0,1989.0,6.7,14,10,8,6,0,6,13,46.2,7,7,2,5,7,21,23,0,DF,30-34,Defender,Netherlands,Europe
1182,Laurent Jans,LUX,Paderborn 07,Bundesliga,2019,26.0,1992.0,17.5,42,25,30,8,4,22,48,45.8,26,25,10,15,19,61,49,1,DF,25-29,Defender,Luxembourg,Europe
1183,Tony Jantschke,GER,Gladbach,Bundesliga,2019,29.0,1990.0,11.2,33,21,23,10,0,15,24,62.5,9,20,11,9,27,60,48,0,DF,25-29,Defender,Germany,Europe
1184,Adnan Januzaj,BEL,Real Sociedad,La Liga,2019,24.0,1995.0,13.0,8,7,3,2,3,3,16,18.8,13,9,1,8,7,15,2,0,"FW,MF",20-24,Forward,Belgium,Europe
1188,Corentin Jean,FRA,Toulouse,Ligue 1,2019,24.0,1995.0,0.1,0,0,0,0,0,0,0,,0,0,0,0,0,0,1,0,DF,20-24,Defender,France,Europe
1189,Benjamin Jeannot,FRA,Dijon,Ligue 1,2019,27.0,1992.0,1.9,2,1,0,1,1,0,4,0.0,4,2,0,2,2,4,4,0,"MF,FW",25-29,Midfielder,France,Europe
1190,Tin Jedvaj,CRO,Augsburg,Bundesliga,2019,23.0,1995.0,29.3,44,26,25,19,0,23,47,48.9,24,36,18,18,60,104,123,1,DF,20-24,Defender,Croatia,Europe
1191,Jemerson,BRA,Monaco,Ligue 1,2019,26.0,1992.0,11.7,28,17,13,14,1,10,21,47.6,11,8,3,5,16,44,24,0,"DF,MF",25-29,Defender,Brazil,South America
1192,Fredrik Jensen,FIN,Augsburg,Bundesliga,2019,21.0,1997.0,5.1,3,1,2,1,0,2,7,28.6,5,7,1,6,1,4,3,0,"MF,FW",20-24,Midfielder,Finland,Europe
1194,Gabriel Jesus,BRA,Manchester City,Premier League,2019,22.0,1997.0,22.6,17,10,4,5,8,7,25,28.0,18,26,1,25,11,28,6,0,FW,20-24,Forward,Brazil,South America
1195,Juan Jesus,BRA,Roma,Serie A,2019,28.0,1991.0,1.5,2,1,2,0,0,0,3,0.0,3,1,0,1,1,3,7,0,DF,25-29,Defender,Brazil,South America
1196,Raúl Jiménez,MEX,Wolves,Premier League,2019,28.0,1991.0,36.0,20,12,6,10,4,3,31,9.7,28,26,0,26,16,36,34,1,FW,25-29,Forward,Mexico,North America
1197,João Pedro,BRA,Watford,Premier League,2019,17.0,2001.0,0.3,0,0,0,0,0,0,0,,0,0,0,0,0,0,0,0,"FW,MF",Under 20,Forward,Brazil,South America
1197,João Pedro,BRA,Watford,Premier League,2019,17.0,2001.0,0.3,0,0,0,0,0,0,0,,0,0,0,0,0,0,0,0,"FW,MF",Under 20,Forward,Brazil,South America
1197,João Pedro,BRA,Watford,Premier League,2019,17.0,2001.0,0.3,0,0,0,0,0,0,0,,0,0,0,0,0,0,0,0,"FW,MF",Under 20,Forward,Brazil,South America
1197,João Pedro,BRA,Watford,Premier League,2019,17.0,2001.0,0.3,0,0,0,0,0,0,0,,0,0,0,0,0,0,0,0,"FW,MF",Under 20,Forward,Brazil,South America
1197,João Pedro,BRA,Watford,Premier League,2019,17.0,2001.0,0.3,0,0,0,0,0,0,0,,0,0,0,0,0,0,0,0,"FW,MF",Under 20,Forward,Brazil,South America
1197,João Pedro,BRA,Watford,Premier League,2019,17.0,2001.0,0.3,0,0,0,0,0,0,0,,0,0,0,0,0,0,0,0,"FW,MF",Under 20,Forward,Brazil,South America
1197,João Pedro,BRA,Watford,Premier League,2019,17.0,2001.0,0.3,0,0,0,0,0,0,0,,0,0,0,0,0,0,0,0,"FW,MF",Under 20,Forward,Brazil,South America
1197,João Pedro,BRA,Watford,Premier League,2019,17.0,2001.0,0.3,0,0,0,0,0,0,0,,0,0,0,0,0,0,0,0,"FW,MF",Under 20,Forward,Brazil,South America
1197,João Pedro,BRA,Watford,Premier League,2019,17.0,2001.0,0.3,0,0,0,0,0,0,0,,0,0,0,0,0,0,0,0,"FW,MF",Under 20,Forward,Brazil,South America
1197,João Pedro,BRA,Watford,Premier League,2019,17.0,2001.0,0.3,0,0,0,0,0,0,0,,0,0,0,0,0,0,0,0,"FW,MF",Under 20,Forward,Brazil,South America
1197,João Pedro,BRA,Watford,Premier League,2019,17.0,2001.0,0.3,0,0,0,0,0,0,0,,0,0,0,0,0,0,0,0,"FW,MF",Under 20,Forward,Brazil,South America
1197,João Pedro,BRA,Watford,Premier League,2019,17.0,2001.0,0.3,0,0,0,0,0,0,0,,0,0,0,0,0,0,0,0,"FW,MF",Under 20,Forward,Brazil,South America
1197,João Pedro,BRA,Watford,Premier League,2019,17.0,2001.0,0.3,0,0,0,0,0,0,0,,0,0,0,0,0,0,0,0,"FW,MF",Under 20,Forward,Brazil,South America
1197,João Pedro,BRA,Watford,Premier League,2019,17.0,2001.0,0.3,0,0,0,0,0,0,0,,0,0,0,0,0,0,0,0,"FW,MF",Under 20,Forward,Brazil,South America
1197,João Pedro,BRA,Watford,Premier League,2019,17.0,2001.0,0.3,0,0,0,0,0,0,0,,0,0,0,0,0,0,0,0,"FW,MF",Under 20,Forward,Brazil,South America
1197,João Pedro,BRA,Watford,Premier League,2019,17.0,2001.0,0.3,0,0,0,0,0,0,0,,0,0,0,0,0,0,0,0,"FW,MF",Under 20,Forward,Brazil,South America
1197,João Pedro,BRA,Watford,Premier League,2019,17.0,2001.0,0.3,0,0,0,0,0,0,0,,0,0,0,0,0,0,0,0,"FW,MF",Under 20,Forward,Brazil,South America
1197,João Pedro,BRA,Watford,Premier League,2019,17.0,2001.0,0.3,0,0,0,0,0,0,0,,0,0,0,0,0,0,0,0,"FW,MF",Under 20,Forward,Brazil,South America
1197,João Pedro,BRA,Watford,Premier League,2019,17.0,2001.0,0.3,0,0,0,0,0,0,0,,0,0,0,0,0,0,0,0,"FW,MF",Under 20,Forward,Brazil,South America
1197,João Pedro,BRA,Watford,Premier League,2019,17.0,2001.0,0.3,0,0,0,0,0,0,0,,0,0,0,0,0,0,0,0,"FW,MF",Under 20,Forward,Brazil,South America
1197,João Pedro,BRA,Watford,Premier League,2019,17.0,2001.0,0.3,0,0,0,0,0,0,0,,0,0,0,0,0,0,0,0,"FW,MF",Under 20,Forward,Brazil,South America
1197,João Pedro,BRA,Watford,Premier League,2019,17.0,2001.0,0.3,0,0,0,0,0,0,0,,0,0,0,0,0,0,0,0,"FW,MF",Under 20,Forward,Brazil,South America
1197,João Pedro,BRA,Watford,Premier League,2019,17.0,2001.0,0.3,0,0,0,0,0,0,0,,0,0,0,0,0,0,0,0,"FW,MF",Under 20,Forward,Brazil,South America
1197,João Pedro,BRA,Watford,Premier League,2019,17.0,2001.0,0.3,0,0,0,0,0,0,0,,0,0,0,0,0,0,0,0,"FW,MF",Under 20,Forward,Brazil,South America
1197,João Pedro,BRA,Watford,Premier League,2019,17.0,2001.0,0.3,0,0,0,0,0,0,0,,0,0,0,0,0,0,0,0,"FW,MF",Under 20,Forward,Brazil,South America
1197,João Pedro,BRA,Watford,Premier League,2019,17.0,2001.0,0.3,0,0,0,0,0,0,0,,0,0,0,0,0,0,0,0,"FW,MF",Under 20,Forward,Brazil,South America
1197,João Pedro,BRA,Watford,Premier League,2019,17.0,2001.0,0.3,0,0,0,0,0,0,0,,0,0,0,0,0,0,0,0,"FW,MF",Under 20,Forward,Brazil,South America
1197,João Pedro,BRA,Watford,Premier League,2019,17.0,2001.0,0.3,0,0,0,0,0,0,0,,0,0,0,0,0,0,0,0,"FW,MF",Under 20,Forward,Brazil,South America
1197,João Pedro,BRA,Watford,Premier League,2019,17.0,2001.0,0.3,0,0,0,0,0,0,0,,0,0,0,0,0,0,0,0,"FW,MF",Under 20,Forward,Brazil,South America
1197,João Pedro,BRA,Watford,Premier League,2019,17.0,2001.0,0.3,0,0,0,0,0,0,0,,0,0,0,0,0,0,0,0,"FW,MF",Under 20,Forward,Brazil,South America
1197,João Pedro,BRA,Watford,Premier League,2019,17.0,2001.0,0.3,0,0,0,0,0,0,0,,0,0,0,0,0,0,0,0,"FW,MF",Under 20,Forward,Brazil,South America
1197,João Pedro,BRA,Watford,Premier League,2019,17.0,2001.0,0.3,0,0,0,0,0,0,0,,0,0,0,0,0,0,0,0,"FW,MF",Under 20,Forward,Brazil,South America
1197,João Pedro,BRA,Watford,Premier League,2019,17.0,2001.0,0.3,0,0,0,0,0,0,0,,0,0,0,0,0,0,0,0,"FW,MF",Under 20,Forward,Brazil,South America
1197,João Pedro,BRA,Watford,Premier League,2019,17.0,2001.0,0.3,0,0,0,0,0,0,0,,0,0,0,0,0,0,0,0,"FW,MF",Under 20,Forward,Brazil,South America
1197,João Pedro,BRA,Watford,Premier League,2019,17.0,2001.0,0.3,0,0,0,0,0,0,0,,0,0,0,0,0,0,0,0,"FW,MF",Under 20,Forward,Brazil,South America
1197,João Pedro,BRA,Watford,Premier League,2019,17.0,2001.0,0.3,0,0,0,0,0,0,0,,0,0,0,0,0,0,0,0,"FW,MF",Under 20,Forward,Brazil,South America
1197,João Pedro,BRA,Watford,Premier League,2019,17.0,2001.0,0.3,0,0,0,0,0,0,0,,0,0,0,0,0,0,0,0,"FW,MF",Under 20,Forward,Brazil,South America
1197,João Pedro,BRA,Watford,Premier League,2019,17.0,2001.0,0.3,0,0,0,0,0,0,0,,0,0,0,0,0,0,0,0,"FW,MF",Under 20,Forward,Brazil,South America
1197,João Pedro,BRA,Watford,Premier League,2019,17.0,2001.0,0.3,0,0,0,0,0,0,0,,0,0,0,0,0,0,0,0,"FW,MF",Under 20,Forward,Brazil,South America
1197,João Pedro,BRA,Watford,Premier League,2019,17.0,2001.0,0.3,0,0,0,0,0,0,0,,0,0,0,0,0,0,0,0,"FW,MF",Under 20,Forward,Brazil,South America
1197,João Pedro,BRA,Watford,Premier League,2019,17.0,2001.0,0.3,0,0,0,0,0,0,0,,0,0,0,0,0,0,0,0,"FW,MF",Under 20,Forward,Brazil,South America
1197,João Pedro,BRA,Watford,Premier League,2019,17.0,2001.0,0.3,0,0,0,0,0,0,0,,0,0,0,0,0,0,0,0,"FW,MF",Under 20,Forward,Brazil,South America
1197,João Pedro,BRA,Watford,Premier League,2019,17.0,2001.0,0.3,0,0,0,0,0,0,0,,0,0,0,0,0,0,0,0,"FW,MF",Under 20,Forward,Brazil,South America
1197,João Pedro,BRA,Watford,Premier League,2019,17.0,2001.0,0.3,0,0,0,0,0,0,0,,0,0,0,0,0,0,0,0,"FW,MF",Under 20,Forward,Brazil,South America
1197,João Pedro,BRA,Watford,Premier League,2019,17.0,2001.0,0.3,0,0,0,0,0,0,0,,0,0,0,0,0,0,0,0,"FW,MF",Under 20,Forward,Brazil,South America
1197,João Pedro,BRA,Watford,Premier League,2019,17.0,2001.0,0.3,0,0,0,0,0,0,0,,0,0,0,0,0,0,0,0,"FW,MF",Under 20,Forward,Brazil,South America
1197,João Pedro,BRA,Watford,Premier League,2019,17.0,2001.0,0.3,0,0,0,0,0,0,0,,0,0,0,0,0,0,0,0,"FW,MF",Under 20,Forward,Brazil,South America
1197,João Pedro,BRA,Watford,Premier League,2019,17.0,2001.0,0.3,0,0,0,0,0,0,0,,0,0,0,0,0,0,0,0,"FW,MF",Under 20,Forward,Brazil,South America
1197,João Pedro,BRA,Watford,Premier League,2019,17.0,2001.0,0.3,0,0,0,0,0,0,0,,0,0,0,0,0,0,0,0,"FW,MF",Under 20,Forward,Brazil,South America
1197,João Pedro,BRA,Watford,Premier League,2019,17.0,2001.0,0.3,0,0,0,0,0,0,0,,0,0,0,0,0,0,0,0,"FW,MF",Under 20,Forward,Brazil,South America
1197,João Pedro,BRA,Watford,Premier League,2019,17.0,2001.0,0.3,0,0,0,0,0,0,0,,0,0,0,0,0,0,0,0,"FW,MF",Under 20,Forward,Brazil,South America
1197,João Pedro,BRA,Watford,Premier League,2019,17.0,2001.0,0.3,0,0,0,0,0,0,0,,0,0,0,0,0,0,0,0,"FW,MF",Under 20,Forward,Brazil,South America
1197,João Pedro,BRA,Watford,Premier League,2019,17.0,2001.0,0.3,0,0,0,0,0,0,0,,0,0,0,0,0,0,0,0,"FW,MF",Under 20,Forward,Brazil,South America
1197,João Pedro,BRA,Watford,Premier League,2019,17.0,2001.0,0.3,0,0,0,0,0,0,0,,0,0,0,0,0,0,0,0,"FW,MF",Under 20,Forward,Brazil,South America
1197,João Pedro,BRA,Watford,Premier League,2019,17.0,2001.0,0.3,0,0,0,0,0,0,0,,0,0,0,0,0,0,0,0,"FW,MF",Under 20,Forward,Brazil,South America
1197,João Pedro,BRA,Watford,Premier League,2019,17.0,2001.0,0.3,0,0,0,0,0,0,0,,0,0,0,0,0,0,0,0,"FW,MF",Under 20,Forward,Brazil,South America
1197,João Pedro,BRA,Watford,Premier League,2019,17.0,2001.0,0.3,0,0,0,0,0,0,0,,0,0,0,0,0,0,0,0,"FW,MF",Under 20,Forward,Brazil,South America
1197,João Pedro,BRA,Watford,Premier League,2019,17.0,2001.0,0.3,0,0,0,0,0,0,0,,0,0,0,0,0,0,0,0,"FW,MF",Under 20,Forward,Brazil,South America
1197,João Pedro,BRA,Watford,Premier League,2019,17.0,2001.0,0.3,0,0,0,0,0,0,0,,0,0,0,0,0,0,0,0,"FW,MF",Under 20,Forward,Brazil,South America
1197,João Pedro,BRA,Watford,Premier League,2019,17.0,2001.0,0.3,0,0,0,0,0,0,0,,0,0,0,0,0,0,0,0,"FW,MF",Under 20,Forward,Brazil,South America
1197,João Pedro,BRA,Watford,Premier League,2019,17.0,2001.0,0.3,0,0,0,0,0,0,0,,0,0,0,0,0,0,0,0,"FW,MF",Under 20,Forward,Brazil,South America
1197,João Pedro,BRA,Watford,Premier League,2019,17.0,2001.0,0.3,0,0,0,0,0,0,0,,0,0,0,0,0,0,0,0,"FW,MF",Under 20,Forward,Brazil,South America
1197,João Pedro,BRA,Watford,Premier League,2019,17.0,2001.0,0.3,0,0,0,0,0,0,0,,0,0,0,0,0,0,0,0,"FW,MF",Under 20,Forward,Brazil,South America
1197,João Pedro,BRA,Watford,Premier League,2019,17.0,2001.0,0.3,0,0,0,0,0,0,0,,0,0,0,0,0,0,0,0,"FW,MF",Under 20,Forward,Brazil,South America
1197,João Pedro,BRA,Watford,Premier League,2019,17.0,2001.0,0.3,0,0,0,0,0,0,0,,0,0,0,0,0,0,0,0,"FW,MF",Under 20,Forward,Brazil,South America
1197,João Pedro,BRA,Watford,Premier League,2019,17.0,2001.0,0.3,0,0,0,0,0,0,0,,0,0,0,0,0,0,0,0,"FW,MF",Under 20,Forward,Brazil,South America
1197,João Pedro,BRA,Watford,Premier League,2019,17.0,2001.0,0.3,0,0,0,0,0,0,0,,0,0,0,0,0,0,0,0,"FW,MF",Under 20,Forward,Brazil,South America
1197,João Pedro,BRA,Watford,Premier League,2019,17.0,2001.0,0.3,0,0,0,0,0,0,0,,0,0,0,0,0,0,0,0,"FW,MF",Under 20,Forward,Brazil,South America
1197,João Pedro,BRA,Watford,Premier League,2019,17.0,2001.0,0.3,0,0,0,0,0,0,0,,0,0,0,0,0,0,0,0,"FW,MF",Under 20,Forward,Brazil,South America
1197,João Pedro,BRA,Watford,Premier League,2019,17.0,2001.0,0.3,0,0,0,0,0,0,0,,0,0,0,0,0,0,0,0,"FW,MF",Under 20,Forward,Brazil,South America
1197,João Pedro,BRA,Watford,Premier League,2019,17.0,2001.0,0.3,0,0,0,0,0,0,0,,0,0,0,0,0,0,0,0,"FW,MF",Under 20,Forward,Brazil,South America
1197,João Pedro,BRA,Watford,Premier League,2019,17.0,2001.0,0.3,0,0,0,0,0,0,0,,0,0,0,0,0,0,0,0,"FW,MF",Under 20,Forward,Brazil,South America
1197,João Pedro,BRA,Watford,Premier League,2019,17.0,2001.0,0.3,0,0,0,0,0,0,0,,0,0,0,0,0,0,0,0,"FW,MF",Under 20,Forward,Brazil,South America
1197,João Pedro,BRA,Watford,Premier League,2019,17.0,2001.0,0.3,0,0,0,0,0,0,0,,0,0,0,0,0,0,0,0,"FW,MF",Under 20,Forward,Brazil,South America
1197,João Pedro,BRA,Watford,Premier League,2019,17.0,2001.0,0.3,0,0,0,0,0,0,0,,0,0,0,0,0,0,0,0,"FW,MF",Under 20,Forward,Brazil,South America
1197,João Pedro,BRA,Watford,Premier League,2019,17.0,2001.0,0.3,0,0,0,0,0,0,0,,0,0,0,0,0,0,0,0,"FW,MF",Under 20,Forward,Brazil,South America
1197,João Pedro,BRA,Watford,Premier League,2019,17.0,2001.0,0.3,0,0,0,0,0,0,0,,0,0,0,0,0,0,0,0,"FW,MF",Under 20,Forward,Brazil,South America
1197,João Pedro,BRA,Watford,Premier League,2019,17.0,2001.0,0.3,0,0,0,0,0,0,0,,0,0,0,0,0,0,0,0,"FW,MF",Under 20,Forward,Brazil,South America
1197,João Pedro,BRA,Watford,Premier League,2019,17.0,2001.0,0.3,0,0,0,0,0,0,0,,0,0,0,0,0,0,0,0,"FW,MF",Under 20,Forward,Brazil,South America
1197,João Pedro,BRA,Watford,Premier League,2019,17.0,2001.0,0.3,0,0,0,0,0,0,0,,0,0,0,0,0,0,0,0,"FW,MF",Under 20,Forward,Brazil,South America
1197,João Pedro,BRA,Watford,Premier League,2019,17.0,2001.0,0.3,0,0,0,0,0,0,0,,0,0,0,0,0,0,0,0,"FW,MF",Under 20,Forward,Brazil,South America
1199,Joelinton,BRA,Newcastle Utd,Premier League,2019,22.0,1996.0,29.8,34,20,7,22,5,9,32,28.1,23,32,6,26,11,45,30,0,FW,20-24,Forward,Brazil,South America
1200,Ben Johnson,ENG,West Ham,Premier League,2019,19.0,2000.0,3.0,8,4,7,1,0,7,10,70.0,3,5,2,3,3,11,11,0,DF,Under 20,Defender,England,Europe
1201,Fabian Johnson,USA,Gladbach,Bundesliga,2019,31.0,1987.0,3.0,5,3,2,2,1,2,4,50.0,2,4,1,3,2,7,3,0,"MF,DF",30-34,Midfielder,United States,North America
1202,Curtis Jones,ENG,Liverpool,Premier League,2019,18.0,2001.0,1.4,4,4,0,1,3,3,4,75.0,1,2,0,2,2,6,1,0,MF,Under 20,Midfielder,England,Europe
1203,Phil Jones,ENG,Manchester Utd,Premier League,2019,27.0,1992.0,1.5,2,2,1,1,0,1,1,100.0,0,2,0,2,2,4,9,1,DF,25-29,Defender,England,Europe
1204,Frenkie de Jong,NED,Barcelona,La Liga,2019,22.0,1997.0,23.5,26,19,7,12,7,7,22,31.8,15,17,7,10,21,47,9,0,MF,20-24,Midfielder,Netherlands,Europe
1205,Luuk de Jong,NED,Sevilla,La Liga,2019,28.0,1990.0,22.9,21,10,4,8,9,6,17,35.3,11,12,1,11,7,28,22,0,FW,25-29,Forward,Netherlands,Europe
1208,Bruno Jordão,POR,Wolves,Premier League,2019,20.0,1998.0,0.1,0,0,0,0,0,0,0,,0,1,0,1,0,0,0,0,FW,20-24,Forward,Portugal,Europe
1209,Jorginho,ITA,Chelsea,Premier League,2019,27.0,1991.0,26.4,66,40,24,34,8,35,91,38.5,56,30,5,25,64,130,27,2,MF,25-29,Midfielder,Italy,Europe
1209,Jorginho,ITA,Chelsea,Premier League,2019,27.0,1991.0,26.4,66,40,24,34,8,35,91,38.5,56,30,5,25,64,130,27,2,MF,25-29,Midfielder,Italy,Europe
1209,Jorginho,ITA,Chelsea,Premier League,2019,27.0,1991.0,26.4,66,40,24,34,8,35,91,38.5,56,30,5,25,64,130,27,2,MF,25-29,Midfielder,Italy,Europe
1209,Jorginho,ITA,Chelsea,Premier League,2019,27.0,1991.0,26.4,66,40,24,34,8,35,91,38.5,56,30,5,25,64,130,27,2,MF,25-29,Midfielder,Italy,Europe
1209,Jorginho,ITA,Chelsea,Premier League,2019,27.0,1991.0,26.4,66,40,24,34,8,35,91,38.5,56,30,5,25,64,130,27,2,MF,25-29,Midfielder,Italy,Europe
1209,Jorginho,ITA,Chelsea,Premier League,2019,27.0,1991.0,26.4,66,40,24,34,8,35,91,38.5,56,30,5,25,64,130,27,2,MF,25-29,Midfielder,Italy,Europe
1209,Jorginho,ITA,Chelsea,Premier League,2019,27.0,1991.0,26.4,66,40,24,34,8,35,91,38.5,56,30,5,25,64,130,27,2,MF,25-29,Midfielder,Italy,Europe
1209,Jorginho,ITA,Chelsea,Premier League,2019,27.0,1991.0,26.4,66,40,24,34,8,35,91,38.5,56,30,5,25,64,130,27,2,MF,25-29,Midfielder,Italy,Europe
1209,Jorginho,ITA,Chelsea,Premier League,2019,27.0,1991.0,26.4,66,40,24,34,8,35,91,38.5,56,30,5,25,64,130,27,2,MF,25-29,Midfielder,Italy,Europe
1209,Jorginho,ITA,Chelsea,Premier League,2019,27.0,1991.0,26.4,66,40,24,34,8,35,91,38.5,56,30,5,25,64,130,27,2,MF,25-29,Midfielder,Italy,Europe
1209,Jorginho,ITA,Chelsea,Premier League,2019,27.0,1991.0,26.4,66,40,24,34,8,35,91,38.5,56,30,5,25,64,130,27,2,MF,25-29,Midfielder,Italy,Europe
1209,Jorginho,ITA,Chelsea,Premier League,2019,27.0,1991.0,26.4,66,40,24,34,8,35,91,38.5,56,30,5,25,64,130,27,2,MF,25-29,Midfielder,Italy,Europe
1209,Jorginho,ITA,Chelsea,Premier League,2019,27.0,1991.0,26.4,66,40,24,34,8,35,91,38.5,56,30,5,25,64,130,27,2,MF,25-29,Midfielder,Italy,Europe
1209,Jorginho,ITA,Chelsea,Premier League,2019,27.0,1991.0,26.4,66,40,24,34,8,35,91,38.5,56,30,5,25,64,130,27,2,MF,25-29,Midfielder,Italy,Europe
1209,Jorginho,ITA,Chelsea,Premier League,2019,27.0,1991.0,26.4,66,40,24,34,8,35,91,38.5,56,30,5,25,64,130,27,2,MF,25-29,Midfielder,Italy,Europe
1209,Jorginho,ITA,Chelsea,Premier League,2019,27.0,1991.0,26.4,66,40,24,34,8,35,91,38.5,56,30,5,25,64,130,27,2,MF,25-29,Midfielder,Italy,Europe
1210,Jesse Joronen,FIN,Brescia,Serie A,2019,26.0,1993.0,29.0,3,1,3,0,0,3,3,100.0,0,0,0,0,6,9,22,0,GK,25-29,Goalkeeper,Finland,Europe
1211,Willian José,BRA,Real Sociedad,La Liga,2019,27.0,1991.0,22.3,5,2,0,4,1,2,8,25.0,6,10,4,6,1,6,16,0,FW,25-29,Forward,Brazil,South America
1214,Diogo Jota,POR,Wolves,Premier League,2019,22.0,1996.0,25.4,28,15,16,10,2,12,48,25.0,36,17,0,17,9,37,10,2,FW,20-24,Forward,Portugal,Europe
1217,Stevan Jovetić,MNE,Monaco,Ligue 1,2019,29.0,1989.0,5.3,2,1,0,1,1,1,5,20.0,4,1,0,1,1,3,5,0,"FW,MF",25-29,Forward,Montenegro,Europe
1221,Lago Junior,CIV,Mallorca,La Liga,2019,28.0,1990.0,24.3,32,19,12,11,9,12,29,41.4,17,23,5,18,14,46,25,0,"MF,FW",25-29,Midfielder,Ivory Coast,Africa
1222,Hamed Junior Traorè,CIV,Sassuolo,Serie A,2019,19.0,2000.0,17.4,31,15,10,15,6,14,39,35.9,25,22,1,21,11,42,7,0,"MF,FW",Under 20,Midfielder,Ivory Coast,Africa
1223,Vinicius Júnior,BRA,Real Madrid,La Liga,2019,19.0,2000.0,15.2,26,16,13,8,5,8,32,25.0,24,14,0,14,3,29,2,0,"FW,MF",Under 20,Forward,Brazil,South America
1224,James Justin,ENG,Leicester City,Premier League,2019,21.0,1998.0,11.2,36,17,22,14,0,15,25,60.0,10,15,7,8,11,47,30,0,"DF,MF",20-24,Defender,England,Europe
1225,Musa Juwara,GAM,Bologna,Serie A,2019,17.0,2001.0,1.7,4,2,1,1,2,1,5,20.0,4,2,1,1,0,4,1,0,"FW,MF",Under 20,Forward,Gambia,Africa
1226,Mathias Jørgensen,DEN,Düsseldorf,Bundesliga,2019,29.0,1990.0,5.5,4,3,3,1,0,2,4,50.0,2,7,3,4,13,17,33,0,DF,25-29,Defender,Denmark,Europe
1227,Ozan Kabak,TUR,Schalke 04,Bundesliga,2019,19.0,2000.0,19.7,37,23,28,9,0,14,21,66.7,7,33,19,14,37,74,97,0,DF,Under 20,Defender,Turkey,Asia
1228,Christian Kabasele,BEL,Watford,Premier League,2019,28.0,1991.0,25.0,37,24,26,11,0,17,32,53.1,15,31,23,8,36,73,127,0,DF,25-29,Defender,Belgium,Europe
1229,Abdoul Kader Bamba,FRA,Nantes,Ligue 1,2019,25.0,1994.0,16.3,19,15,5,9,5,9,30,30.0,21,8,2,6,16,35,8,0,"FW,MF",25-29,Forward,France,Europe
1231,Florian Kainz,AUT,Köln,Bundesliga,2019,26.0,1992.0,17.3,21,13,12,6,3,15,33,45.5,18,26,2,24,13,34,11,0,"FW,MF",25-29,Forward,Austria,Europe
1232,Gaël Kakuta,COD,Amiens,Ligue 1,2019,28.0,1991.0,22.2,46,27,13,27,6,17,48,35.4,31,15,1,14,16,62,8,2,"MF,FW",25-29,Midfielder,DR Congo,Africa
1233,Lovre Kalinić,CRO,Toulouse,Ligue 1,2019,29.0,1990.0,3.4,0,0,0,0,0,0,1,0.0,1,0,0,0,0,0,0,0,GK,25-29,Goalkeeper,Croatia,Europe
1234,Nikola Kalinić,CRO,Roma,Serie A,2019,31.0,1988.0,6.3,2,1,0,2,0,0,0,,0,2,0,2,1,3,1,0,FW,30-34,Forward,Croatia,Europe
1235,Salomon Kalou,CIV,Hertha BSC,Bundesliga,2019,33.0,1985.0,1.6,1,0,1,0,0,0,2,0.0,2,2,0,2,0,1,1,0,"FW,MF",30-34,Forward,Ivory Coast,Africa
1236,Samuel Kalu,NGA,Bordeaux,Ligue 1,2019,21.0,1997.0,15.1,33,17,19,12,2,16,36,44.4,20,13,1,12,24,57,10,0,"DF,FW",20-24,Defender,Nigeria,Africa
1237,Daichi Kamada,JPN,Eint Frankfurt,Bundesliga,2019,22.0,1996.0,21.9,29,20,7,17,5,8,42,19.0,34,16,1,15,10,39,6,0,"MF,FW",20-24,Midfielder,Japan,Asia
1238,François Kamano,GUI,Bordeaux,Ligue 1,2019,23.0,1996.0,7.2,12,6,5,4,3,8,15,53.3,7,5,0,5,3,15,2,0,"DF,MF",20-24,Defender,Guinea,Africa
1239,Boubacar Kamara,FRA,Marseille,Ligue 1,2019,19.0,1999.0,23.8,67,34,37,27,3,27,57,47.4,30,27,14,13,34,101,53,1,"DF,MF",Under 20,Defender,France,Europe
1240,Hassane Kamara,CIV,Reims,Ligue 1,2019,25.0,1994.0,19.0,58,47,40,14,4,24,35,68.6,11,17,2,15,58,116,58,0,"DF,FW",25-29,Defender,Ivory Coast,Africa
1242,Harry Kane,ENG,Tottenham,Premier League,2019,26.0,1993.0,28.7,18,12,3,12,3,4,17,23.5,13,17,7,10,6,24,30,0,FW,25-29,Forward,England,Europe
1243,Lee Kang-in,KOR,Valencia,La Liga,2019,18.0,2001.0,5.0,3,1,0,2,1,3,6,50.0,3,5,0,5,3,6,0,0,"MF,FW",Under 20,Midfielder,South Korea,Asia
1244,Wilfried Kanga,CIV,Angers,Ligue 1,2019,21.0,1998.0,0.8,0,0,0,0,0,0,1,0.0,1,0,0,0,0,0,0,0,FW,20-24,Forward,Ivory Coast,Africa
1245,N'Golo Kanté,FRA,Chelsea,Premier League,2019,28.0,1991.0,19.2,44,20,22,14,8,17,36,47.2,19,29,5,24,44,88,32,2,MF,25-29,Midfielder,France,Europe
1246,Stefanos Kapino,GRE,Werder Bremen,Bundesliga,2019,25.0,1994.0,1.0,0,0,0,0,0,0,0,,0,0,0,0,1,1,0,0,GK,25-29,Goalkeeper,Greece,Europe
1247,Wilfrid Kaptoum,CMR,Betis,La Liga,2019,23.0,1996.0,2.2,5,2,3,2,0,3,3,100.0,0,4,1,3,1,6,3,0,MF,20-24,Midfielder,Cameroon,Africa
1248,Kenan Karaman,TUR,Düsseldorf,Bundesliga,2019,25.0,1994.0,15.0,11,5,2,5,4,4,9,44.4,5,9,4,5,2,13,7,0,"FW,MF",25-29,Forward,Turkey,Asia
1249,Yann Karamoh,FRA,Parma,Serie A,2019,21.0,1998.0,6.4,10,7,5,4,1,3,9,33.3,6,5,0,5,2,12,3,0,"FW,MF",20-24,Forward,France,Europe
1250,Mamoudou Karamoko,FRA,Wolfsburg,Bundesliga,2019,19.0,1999.0,0.1,0,0,0,0,0,0,0,,0,0,0,0,0,0,0,0,MF,Under 20,Midfielder,France,Europe
1251,Florian Kastenmeier,GER,Düsseldorf,Bundesliga,2019,22.0,1997.0,17.0,1,1,1,0,0,0,0,,0,0,0,0,2,3,3,1,GK,20-24,Goalkeeper,Germany,Europe
1252,Noah Katterbach,GER,Köln,Bundesliga,2019,18.0,2001.0,14.6,29,23,21,8,0,11,28,39.3,17,12,1,11,29,58,26,0,DF,Under 20,Defender,Germany,Europe
1253,Moise Kean,ITA,Everton,Premier League,2019,19.0,2000.0,9.5,6,6,5,1,0,0,0,,0,4,0,4,5,11,1,1,FW,Under 20,Forward,Italy,Europe
1254,Michael Keane,ENG,Everton,Premier League,2019,26.0,1993.0,28.4,31,16,18,12,1,14,24,58.3,10,35,28,7,44,75,152,0,DF,25-29,Defender,England,Europe
1255,Thilo Kehrer,GER,Paris S-G,Ligue 1,2019,22.0,1996.0,5.3,10,7,4,5,1,5,10,50.0,5,2,0,2,1,11,2,1,DF,20-24,Defender,Germany,Europe
1256,Jules Keita,GUI,Dijon,Ligue 1,2019,21.0,1998.0,1.8,4,3,2,1,1,1,6,16.7,5,1,0,1,3,7,0,0,"MF,FW",20-24,Midfielder,Guinea,Africa
1257,Naby Keïta,GUI,Liverpool,Premier League,2019,24.0,1995.0,9.1,30,14,8,16,6,11,26,42.3,15,18,0,18,10,40,4,0,MF,20-24,Midfielder,Guinea,Africa
1258,Yannik Keitel,GER,Freiburg,Bundesliga,2019,19.0,2000.0,1.9,2,1,1,1,0,0,6,0.0,6,3,1,2,4,6,4,0,MF,Under 20,Midfielder,Germany,Europe
1259,Lloyd Kelly,ENG,Bournemouth,Premier League,2019,20.0,1998.0,7.1,7,3,3,4,0,6,7,85.7,1,9,5,4,6,13,15,1,DF,20-24,Defender,England,Europe
1260,Martin Kelly,ENG,Crystal Palace,Premier League,2019,29.0,1990.0,17.2,23,18,19,4,0,14,31,45.2,17,18,10,8,16,39,86,1,DF,25-29,Defender,England,Europe
1261,Kenedy,BRA,Getafe,La Liga,2019,23.0,1996.0,6.5,9,5,3,3,3,2,5,40.0,3,10,0,10,11,20,4,0,MF,20-24,Midfielder,Brazil,South America
1262,Jonjoe Kenny,ENG,Schalke 04,Bundesliga,2019,22.0,1997.0,30.2,49,29,24,19,6,26,51,51.0,25,45,10,35,26,75,79,0,DF,20-24,Defender,England,Europe
1263,Franck Kessié,CIV,Milan,Serie A,2019,22.0,1996.0,32.3,54,29,28,18,8,16,52,30.8,36,34,5,29,34,88,32,2,MF,20-24,Midfielder,Ivory Coast,Africa
1264,Saîf-Eddine Khaoui,TUN,Marseille,Ligue 1,2019,24.0,1995.0,1.2,3,1,0,3,0,2,5,40.0,3,2,0,2,1,4,4,0,"MF,FW",20-24,Midfielder,Tunisia,Africa
1265,Wahbi Khazri,TUN,Saint-Étienne,Ligue 1,2019,28.0,1991.0,12.8,17,9,5,7,5,9,27,33.3,18,11,0,11,4,21,0,0,"FW,MF",25-29,Forward,Tunisia,Africa
1266,Rani Khedira,GER,Augsburg,Bundesliga,2019,25.0,1994.0,29.4,60,36,21,35,4,18,45,40.0,27,47,12,35,48,108,62,0,MF,25-29,Midfielder,Germany,Europe
1267,Sami Khedira,GER,Juventus,Serie A,2019,32.0,1987.0,7.6,14,7,3,8,3,4,19,21.1,15,12,1,11,3,17,13,0,MF,30-34,Midfielder,Germany,Europe
1269,Luca Kilian,GER,Paderborn 07,Bundesliga,2019,19.0,1999.0,14.0,33,24,27,6,0,22,41,53.7,19,20,9,11,12,45,67,0,DF,Under 20,Defender,Germany,Europe
1270,Max Kilman,ENG,Wolves,Premier League,2019,22.0,1997.0,2.1,4,2,1,3,0,2,2,100.0,0,1,1,0,4,8,7,0,DF,20-24,Defender,England,Europe
1271,Joshua Kimmich,GER,Bayern Munich,Bundesliga,2019,24.0,1995.0,31.3,52,29,21,20,11,22,55,40.0,33,38,9,29,29,81,29,0,"MF,DF",20-24,Midfielder,Germany,Europe
1272,Presnel Kimpembe,FRA,Paris S-G,Ligue 1,2019,23.0,1995.0,13.6,33,25,25,8,0,14,20,70.0,6,7,3,4,21,54,33,1,DF,20-24,Defender,France,Europe
1274,Simon Kjær,DEN,Atalanta,Serie A,2019,30.0,1989.0,3.2,9,6,1,8,0,3,4,75.0,1,5,4,1,7,16,10,1,DF,30-34,Defender,Denmark,Europe
1275,Simon Kjær,DEN,Milan,Serie A,2019,30.0,1989.0,13.8,22,13,17,5,0,10,18,55.6,8,20,16,4,15,37,52,0,DF,30-34,Defender,Denmark,Europe
1276,Davy Klaassen,NED,Werder Bremen,Bundesliga,2019,26.0,1993.0,32.6,55,43,19,23,13,19,57,33.3,38,46,18,28,38,93,45,2,MF,25-29,Midfielder,Netherlands,Europe
1277,Felix Klaus,GER,Wolfsburg,Bundesliga,2019,26.0,1992.0,7.4,24,16,4,13,7,7,19,36.8,12,10,2,8,3,27,5,0,"MF,FW",25-29,Midfielder,Germany,Europe
1278,Ragnar Klavan,EST,Cagliari,Serie A,2019,33.0,1985.0,26.2,29,16,20,9,0,14,28,50.0,14,29,19,10,25,54,118,1,DF,30-34,Defender,Estonia,Europe
1279,Timm Klose,SUI,Norwich City,Premier League,2019,31.0,1988.0,6.5,8,2,5,2,1,7,11,63.6,4,6,6,0,7,15,29,0,DF,30-34,Defender,Switzerland,Europe
1280,Lukas Klostermann,GER,RB Leipzig,Bundesliga,2019,23.0,1996.0,29.4,45,26,24,16,5,18,31,58.1,13,34,16,18,26,71,101,2,DF,20-24,Defender,Germany,Europe
1281,Justin Kluivert,NED,Roma,Serie A,2019,20.0,1999.0,16.8,17,11,4,8,5,7,16,43.8,9,15,0,15,6,23,7,0,FW,20-24,Forward,Netherlands,Europe
1282,Lukas Klünter,GER,Hertha BSC,Bundesliga,2019,23.0,1996.0,20.9,44,31,26,16,2,20,30,66.7,10,16,4,12,27,71,61,1,DF,20-24,Defender,Germany,Europe
1283,Robin Knoche,GER,Wolfsburg,Bundesliga,2019,27.0,1992.0,17.7,29,14,24,5,0,17,30,56.7,13,19,11,8,27,56,77,1,DF,25-29,Defender,Germany,Europe
1284,Robin Koch,GER,Freiburg,Bundesliga,2019,23.0,1996.0,30.1,34,20,20,13,1,11,26,42.3,15,30,22,8,45,79,94,4,"DF,MF",20-24,Defender,Germany,Europe
1285,Giorgi Kochorashvili,GEO,Levante,La Liga,2019,20.0,1999.0,0.0,0,0,0,0,0,0,0,,0,0,0,0,0,0,0,0,MF,20-24,Midfielder,Georgia,Asia
1286,Jonathan Kodjia,CIV,Aston Villa,Premier League,2019,29.0,1989.0,1.3,0,0,0,0,0,0,1,0.0,1,0,0,0,0,0,1,0,FW,25-29,Forward,Ivory Coast,Africa
1287,Kenan Kodro,BIH,Athletic Club,La Liga,2019,25.0,1993.0,4.0,1,0,0,0,1,0,2,0.0,2,1,0,1,0,1,4,0,"FW,MF",25-29,Forward,Bosnia and Herzegovina,Europe
1288,Dominik Kohr,GER,Eint Frankfurt,Bundesliga,2019,25.0,1994.0,16.1,44,35,15,25,4,18,53,34.0,35,31,11,20,30,74,16,0,MF,25-29,Midfielder,Germany,Europe
1291,Sead Kolašinac,BIH,Arsenal,Premier League,2019,26.0,1993.0,18.9,29,16,18,6,5,12,23,52.2,11,14,4,10,25,54,34,1,DF,25-29,Defender,Bosnia and Herzegovina,Europe
1292,Timothée Kolodziejczak,FRA,Saint-Étienne,Ligue 1,2019,27.0,1991.0,14.5,17,10,13,4,0,9,21,42.9,12,8,3,5,30,47,44,2,DF,25-29,Defender,France,Europe
1293,Ghislain Konan,CIV,Reims,Ligue 1,2019,23.0,1995.0,14.8,43,26,28,14,1,19,28,67.9,9,13,3,10,24,67,34,0,DF,20-24,Defender,Ivory Coast,Africa
1294,Ibrahima Konaté,FRA,RB Leipzig,Bundesliga,2019,20.0,1999.0,6.3,11,6,10,1,0,2,7,28.6,5,9,4,5,5,16,35,1,DF,20-24,Defender,France,Europe
1295,Moussa Konaté,SEN,Amiens,Ligue 1,2019,26.0,1993.0,6.8,3,0,0,3,0,0,2,0.0,2,2,0,2,1,4,1,0,FW,25-29,Forward,Senegal,Africa
1296,Geoffrey Kondogbia,CTA,Valencia,La Liga,2019,26.0,1993.0,20.1,63,40,40,18,5,19,51,37.3,32,25,6,19,57,120,36,2,MF,25-29,Midfielder,Central African Republic,Africa
1297,Lamine Koné,CIV,Strasbourg,Ligue 1,2019,30.0,1989.0,16.4,31,21,20,10,1,12,17,70.6,5,8,5,3,25,56,47,1,DF,30-34,Defender,Ivory Coast,Africa
1298,Manu Koné,FRA,Toulouse,Ligue 1,2019,18.0,2001.0,9.7,35,20,17,14,4,13,30,43.3,17,15,1,14,19,54,10,1,MF,Under 20,Midfielder,France,Europe
1299,Moussa Koné,SEN,Nîmes,Ligue 1,2019,22.0,1996.0,1.6,2,0,1,1,0,1,3,33.3,2,1,0,1,1,3,0,0,"FW,MF",20-24,Forward,Senegal,Africa
1299,Moussa Koné,SEN,Nîmes,Ligue 1,2019,22.0,1996.0,1.6,2,0,1,1,0,1,3,33.3,2,1,0,1,1,3,0,0,"FW,MF",20-24,Forward,Senegal,Africa
1299,Moussa Koné,SEN,Nîmes,Ligue 1,2019,22.0,1996.0,1.6,2,0,1,1,0,1,3,33.3,2,1,0,1,1,3,0,0,"FW,MF",20-24,Forward,Senegal,Africa
1299,Moussa Koné,SEN,Nîmes,Ligue 1,2019,22.0,1996.0,1.6,2,0,1,1,0,1,3,33.3,2,1,0,1,1,3,0,0,"FW,MF",20-24,Forward,Senegal,Africa
1300,Youssouf Koné,MLI,Lyon,Ligue 1,2019,24.0,1995.0,9.1,22,14,17,3,2,12,20,60.0,8,2,1,1,8,30,15,0,DF,20-24,Defender,Mali,Africa
1301,Ezri Konsa,ENG,Aston Villa,Premier League,2019,21.0,1997.0,22.7,18,9,12,6,0,7,16,43.8,9,34,24,10,25,43,70,2,DF,20-24,Defender,England,Europe
1302,Pascal Köpke,GER,Hertha BSC,Bundesliga,2019,23.0,1995.0,1.3,0,0,0,0,0,0,0,,0,0,0,0,0,0,0,0,FW,20-24,Forward,Germany,Europe
1303,Laurent Koscielny,FRA,Bordeaux,Ligue 1,2019,33.0,1985.0,24.3,28,13,24,4,0,10,20,50.0,10,23,19,4,26,54,104,0,DF,30-34,Defender,France,Europe
1305,Christian Kouamé,CIV,Fiorentina,Serie A,2019,21.0,1997.0,3.3,3,2,0,3,0,0,1,0.0,1,5,1,4,1,4,1,0,"FW,MF",20-24,Forward,Ivory Coast,Africa
1306,Christian Kouamé,CIV,Genoa,Serie A,2019,21.0,1997.0,10.2,2,1,0,1,1,0,8,0.0,8,8,2,6,1,3,13,0,FW,20-24,Forward,Ivory Coast,Africa
1308,Kalidou Koulibaly,SEN,Napoli,Serie A,2019,28.0,1991.0,23.4,51,33,30,17,4,17,28,60.7,11,28,16,12,31,82,61,1,DF,25-29,Defender,Senegal,Africa
1309,Efthimis Koulouris,GRE,Toulouse,Ligue 1,2019,23.0,1996.0,17.1,13,8,5,5,3,3,13,23.1,10,8,4,4,3,16,16,0,FW,20-24,Forward,Greece,Europe
1310,Jules Koundé,FRA,Sevilla,La Liga,2019,20.0,1998.0,25.7,23,12,14,5,4,10,18,55.6,8,16,12,4,23,46,91,2,DF,20-24,Defender,France,Europe
1311,Leonardo Koutris,GRE,Mallorca,La Liga,2019,24.0,1995.0,1.0,1,1,0,0,1,1,2,50.0,1,1,1,0,1,2,6,0,DF,20-24,Defender,Greece,Europe
1312,Cheikhou Kouyaté,SEN,Crystal Palace,Premier League,2019,29.0,1989.0,28.1,67,32,43,20,4,26,48,54.2,22,35,11,24,43,110,58,1,"MF,DF",25-29,Midfielder,Senegal,Africa
1313,Mateo Kovačić,CRO,Chelsea,Premier League,2019,25.0,1994.0,23.0,63,38,29,32,2,26,65,40.0,39,15,1,14,22,85,16,1,MF,25-29,Midfielder,Croatia,Europe
1315,İsmail Köybaşı,TUR,Granada,La Liga,2019,30.0,1989.0,2.6,4,4,3,1,0,0,2,0.0,2,4,0,4,5,9,2,0,"DF,FW",30-34,Defender,Turkey,Asia
1316,Thomas Kraft,GER,Hertha BSC,Bundesliga,2019,31.0,1988.0,4.0,0,0,0,0,0,0,0,,0,0,0,0,1,1,0,0,GK,30-34,Goalkeeper,Germany,Europe
1317,Emil Krafth,SWE,Newcastle Utd,Premier League,2019,24.0,1994.0,11.3,18,12,15,2,1,9,20,45.0,11,11,8,3,8,26,45,0,DF,20-24,Defender,Sweden,Europe
1318,Andrej Kramarić,CRO,Hoffenheim,Bundesliga,2019,28.0,1991.0,15.8,2,1,1,0,1,1,7,14.3,6,6,0,6,3,5,4,0,"FW,MF",25-29,Forward,Croatia,Europe
1319,Christoph Kramer,GER,Gladbach,Bundesliga,2019,28.0,1991.0,16.3,45,29,19,21,5,19,49,38.8,30,22,3,19,14,59,19,0,MF,25-29,Midfielder,Germany,Europe
1320,Tom Krauß,GER,RB Leipzig,Bundesliga,2019,18.0,2001.0,0.0,1,1,0,1,0,1,2,50.0,1,0,0,0,0,1,0,0,MF,Under 20,Midfielder,Germany,Europe
1323,Felix Kroos,GER,Union Berlin,Bundesliga,2019,28.0,1991.0,4.2,17,9,9,6,2,8,15,53.3,7,6,3,3,3,20,13,1,"MF,DF",25-29,Midfielder,Germany,Europe
1324,Toni Kroos,GER,Real Madrid,La Liga,2019,29.0,1990.0,29.5,56,28,18,29,9,18,70,25.7,52,27,0,27,23,79,15,0,MF,25-29,Midfielder,Germany,Europe
1325,Tim Krul,NED,Norwich City,Premier League,2019,31.0,1988.0,36.0,0,0,0,0,0,0,1,0.0,1,2,0,2,1,1,13,1,GK,30-34,Goalkeeper,Netherlands,Europe
1326,Rade Krunić,BIH,Milan,Serie A,2019,25.0,1993.0,6.0,16,8,8,5,3,9,16,56.3,7,5,0,5,9,25,5,0,"MF,FW",25-29,Midfielder,Bosnia and Herzegovina,Europe
1327,Lukas Kübler,GER,Freiburg,Bundesliga,2019,26.0,1992.0,2.3,1,1,0,1,0,1,5,20.0,4,2,0,2,1,2,6,0,DF,25-29,Defender,Germany,Europe
1328,Takefusa Kubo,JPN,Mallorca,La Liga,2019,18.0,2001.0,25.7,34,22,16,12,6,15,44,34.1,29,19,1,18,23,57,10,0,"MF,FW",Under 20,Midfielder,Japan,Asia
1329,Juraj Kucka,SVK,Parma,Serie A,2019,32.0,1987.0,21.5,43,22,21,16,6,14,61,23.0,47,21,4,17,29,72,36,0,"MF,FW",30-34,Midfielder,Slovakia,Europe
1330,Dejan Kulusevski,SWE,Parma,Serie A,2019,19.0,2000.0,32.6,41,21,10,24,7,19,64,29.7,45,25,1,24,23,64,17,0,"FW,MF",Under 20,Forward,Sweden,Europe
1331,Marash Kumbulla,ALB,Hellas Verona,Serie A,2019,19.0,2000.0,21.7,40,24,21,17,2,19,36,52.8,17,33,24,9,50,90,86,3,DF,Under 20,Defender,Albania,Europe
1332,Pierre Kunde,CMR,Mainz 05,Bundesliga,2019,24.0,1995.0,20.7,34,17,15,18,1,12,30,40.0,18,16,4,12,26,60,55,0,MF,20-24,Midfielder,Cameroon,Africa
1335,Layvin Kurzawa,FRA,Paris S-G,Ligue 1,2019,26.0,1992.0,9.5,23,16,5,14,4,11,23,47.8,12,12,1,11,18,41,24,1,DF,25-29,Defender,France,Europe
1336,Dereck Kutesa,SUI,Reims,Ligue 1,2019,21.0,1997.0,5.9,6,5,3,2,1,3,9,33.3,6,5,0,5,1,7,1,0,"FW,MF",20-24,Forward,Switzerland,Europe
1337,Ahmed Kutucu,TUR,Schalke 04,Bundesliga,2019,19.0,2000.0,7.5,11,7,3,6,2,4,15,26.7,11,5,0,5,2,13,5,0,"FW,MF",Under 20,Forward,Turkey,Asia
1338,Enock Kwateng,FRA,Bordeaux,Ligue 1,2019,22.0,1997.0,10.9,36,22,17,17,2,22,47,46.8,25,16,6,10,22,58,41,0,DF,20-24,Defender,France,Europe
1339,Giorgos Kyriakopoulos,GRE,Sassuolo,Serie A,2019,23.0,1996.0,18.3,35,18,22,7,6,18,32,56.3,14,19,6,13,18,53,41,0,DF,20-24,Defender,Greece,Europe
1340,Antonino La Gumina,ITA,Sampdoria,Serie A,2019,23.0,1996.0,2.1,0,0,0,0,0,0,0,,0,0,0,0,0,0,1,0,FW,20-24,Forward,Italy,Europe
1341,Andrea La Mantia,ITA,Lecce,Serie A,2019,28.0,1991.0,6.1,1,0,1,0,0,1,5,20.0,4,3,0,3,7,8,11,0,FW,25-29,Forward,Italy,Europe
1342,Gaëtan Laborde,FRA,Montpellier,Ligue 1,2019,25.0,1994.0,24.9,21,12,4,10,7,9,38,23.7,29,21,0,21,7,28,32,1,FW,25-29,Forward,France,Europe
1343,Alexandre Lacazette,FRA,Arsenal,Premier League,2019,28.0,1991.0,20.8,31,16,8,21,2,9,24,37.5,15,14,0,14,7,38,15,0,FW,25-29,Forward,France,Europe
1344,Riccardo Ladinetti,ITA,Cagliari,Serie A,2019,18.0,2000.0,1.4,2,2,0,2,0,1,1,100.0,0,0,0,0,4,6,0,1,MF,Under 20,Midfielder,Italy,Europe
1345,Alban Lafont,FRA,Nantes,Ligue 1,2019,20.0,1999.0,27.0,1,1,1,0,0,1,1,100.0,0,0,0,0,0,1,12,0,GK,20-24,Goalkeeper,France,Europe
1347,Jack Lahne,SWE,Amiens,Ligue 1,2019,17.0,2001.0,0.1,1,1,0,0,1,0,0,,0,0,0,0,0,1,0,0,FW,Under 20,Forward,Sweden,Europe
1348,Konrad Laimer,AUT,RB Leipzig,Bundesliga,2019,22.0,1997.0,23.5,91,45,30,46,15,43,102,42.2,59,51,8,43,34,125,14,0,MF,20-24,Midfielder,Austria,Europe
1349,Stefan Lainer,AUT,Gladbach,Bundesliga,2019,26.0,1992.0,30.1,51,30,25,19,7,24,54,44.4,30,38,7,31,29,80,71,0,DF,25-29,Defender,Austria,Europe
1350,Diego Lainez,MEX,Betis,La Liga,2019,19.0,2000.0,3.9,6,5,2,4,0,5,8,62.5,3,6,0,6,1,7,1,0,"MF,FW",Under 20,Midfielder,Mexico,North America
1351,Kenny Lala,MAD,Strasbourg,Ligue 1,2019,27.0,1991.0,22.7,29,16,17,11,1,11,27,40.7,16,14,5,9,20,49,40,1,"DF,MF",25-29,Defender,Madagascar,Africa
1352,Adam Lallana,ENG,Liverpool,Premier League,2019,31.0,1988.0,4.2,19,9,7,9,3,6,21,28.6,15,7,0,7,5,24,3,0,"MF,FW",30-34,Midfielder,England,Europe
1353,Érik Lamela,ARG,Tottenham,Premier League,2019,27.0,1992.0,13.5,24,20,9,13,2,2,21,9.5,19,12,3,9,8,32,10,0,"MF,FW",25-29,Midfielder,Argentina,South America
1354,Tariq Lamptey,GHA,Chelsea,Premier League,2019,18.0,2000.0,0.4,2,2,1,1,0,2,2,100.0,0,0,0,0,0,2,0,0,DF,Under 20,Defender,Ghana,Africa
1355,Tariq Lamptey,GHA,Brighton,Premier League,2019,18.0,2000.0,6.5,7,6,6,1,0,2,9,22.2,7,6,0,6,16,23,17,0,DF,Under 20,Defender,Ghana,Africa
1356,Loïck Landre,FRA,Nîmes,Ligue 1,2019,27.0,1992.0,10.3,16,9,12,3,1,7,11,63.6,4,12,9,3,17,33,34,0,DF,25-29,Defender,France,Europe
1357,Michael Lang,SUI,Werder Bremen,Bundesliga,2019,28.0,1991.0,6.0,8,5,3,5,0,6,12,50.0,6,5,1,4,7,15,22,0,"DF,FW",25-29,Defender,Switzerland,Europe
1358,Sebastian Langkamp,GER,Werder Bremen,Bundesliga,2019,31.0,1988.0,3.5,3,2,3,0,0,2,4,50.0,2,5,3,2,3,6,11,1,DF,30-34,Defender,Germany,Europe
1359,Henri Lansbury,ENG,Aston Villa,Premier League,2019,28.0,1990.0,2.2,6,2,3,1,2,2,8,25.0,6,4,0,4,0,6,3,0,MF,25-29,Midfielder,England,Europe
1360,Manuel Lanzini,ARG,West Ham,Premier League,2019,26.0,1993.0,15.3,14,9,6,6,2,7,39,17.9,32,9,1,8,10,24,3,0,"MF,FW",25-29,Midfielder,Argentina,South America
1361,Gianluca Lapadula,PER,Lecce,Serie A,2019,29.0,1990.0,19.8,15,8,6,8,1,5,16,31.3,11,2,0,2,1,16,14,0,FW,25-29,Forward,Peru,South America
1363,Danilo Larangeira,BRA,Bologna,Serie A,2019,35.0,1984.0,29.3,34,17,19,15,0,16,28,57.1,12,54,39,15,30,64,99,0,DF,35-39,Defender,Brazil,South America
1365,Gautier Larsonneur,FRA,Brest,Ligue 1,2019,22.0,1997.0,26.6,2,1,2,0,0,2,4,50.0,2,1,0,1,4,6,14,3,GK,20-24,Goalkeeper,France,Europe
1366,Kevin Lasagna,ITA,Udinese,Serie A,2019,26.0,1992.0,28.5,27,14,7,13,7,6,31,19.4,25,23,1,22,10,37,18,1,FW,25-29,Forward,Italy,Europe
1367,Jamaal Lascelles,ENG,Newcastle Utd,Premier League,2019,25.0,1993.0,23.1,14,3,10,4,0,4,9,44.4,5,23,20,3,28,42,116,1,DF,25-29,Defender,England,Europe
1368,Paul Lasne,FRA,Brest,Ligue 1,2019,30.0,1989.0,13.6,25,13,13,11,1,6,20,30.0,14,7,2,5,7,32,5,0,"MF,FW",30-34,Midfielder,France,Europe
1370,Danny Latza,GER,Mainz 05,Bundesliga,2019,29.0,1989.0,15.3,33,19,15,17,1,16,49,32.7,33,22,5,17,17,50,24,0,MF,25-29,Midfielder,Germany,Europe
1371,Vincent Laurini,FRA,Parma,Serie A,2019,30.0,1989.0,9.8,26,22,11,11,4,14,18,77.8,4,10,3,7,11,37,29,0,DF,30-34,Defender,France,Europe
1372,Wesley Lautoa,NCL,Dijon,Ligue 1,2019,31.0,1987.0,20.8,54,29,24,28,2,28,63,44.4,35,31,16,15,42,96,48,2,"MF,DF",30-34,Midfielder,New Caledonia,Oceania
1373,Diego Laxalt,URU,Torino,Serie A,2019,26.0,1993.0,6.6,19,10,10,6,3,6,20,30.0,14,12,4,8,6,25,20,0,"DF,MF",25-29,Defender,Uruguay,South America
1374,Diego Laxalt,URU,Milan,Serie A,2019,26.0,1993.0,1.9,3,3,3,0,0,1,3,33.3,2,4,0,4,0,3,3,0,DF,25-29,Defender,Uruguay,South America
1375,Valentino Lazaro,AUT,Newcastle Utd,Premier League,2019,23.0,1996.0,5.3,13,9,11,2,0,11,18,61.1,7,2,0,2,3,16,4,0,"DF,MF",20-24,Defender,Austria,Europe
1376,Valentino Lazaro,AUT,Inter,Serie A,2019,23.0,1996.0,3.6,6,5,3,2,1,4,8,50.0,4,5,0,5,1,7,8,1,DF,20-24,Defender,Austria,Europe
1378,Manuel Lazzari,ITA,Lazio,Serie A,2019,25.0,1993.0,28.3,20,11,10,7,3,10,31,32.3,21,11,1,10,8,28,34,0,DF,25-29,Defender,Italy,Europe
1379,Mickaël Le Bihan,FRA,Nice,Ligue 1,2019,29.0,1990.0,1.1,0,0,0,0,0,0,2,0.0,2,0,0,0,0,0,2,0,"FW,DF",25-29,Forward,France,Europe
1381,Damien Le Tallec,FRA,Montpellier,Ligue 1,2019,29.0,1990.0,27.3,52,27,20,28,4,24,69,34.8,45,38,18,20,38,90,59,0,"MF,DF",25-29,Midfielder,France,Europe
1382,James Lea Siliki,CMR,Rennes,Ligue 1,2019,23.0,1996.0,12.0,28,16,19,9,0,16,29,55.2,13,15,4,11,12,40,12,0,MF,20-24,Midfielder,Cameroon,Africa
1383,Rafael Leão,POR,Milan,Serie A,2019,20.0,1999.0,15.6,7,4,2,5,0,3,9,33.3,6,4,0,4,0,7,5,0,FW,20-24,Forward,Portugal,Europe
1384,Adrien Lebeau,FRA,Strasbourg,Ligue 1,2019,20.0,1999.0,0.1,1,1,1,0,0,0,1,0.0,1,1,0,1,0,1,0,0,"MF,FW",20-24,Midfielder,France,Europe
1385,Mathew Leckie,AUS,Hertha BSC,Bundesliga,2019,28.0,1991.0,2.2,3,1,1,2,0,2,3,66.7,1,6,0,6,2,5,2,1,"DF,FW",25-29,Defender,Australia,Oceania
1386,Benjamin Lecomte,FRA,Monaco,Ligue 1,2019,28.0,1991.0,28.0,0,0,0,0,0,0,1,0.0,1,1,0,1,0,0,10,5,GK,25-29,Goalkeeper,France,Europe
1387,Pierre Lees-Melou,FRA,Nice,Ligue 1,2019,26.0,1993.0,25.0,63,27,34,21,8,31,88,35.2,57,38,12,26,32,95,43,0,MF,25-29,Midfielder,France,Europe
1388,Jordan Lefort,FRA,Amiens,Ligue 1,2019,25.0,1993.0,9.4,3,2,2,1,0,3,5,60.0,2,4,1,3,9,12,29,0,DF,25-29,Defender,France,Europe
1389,Wu Lei,CHN,Espanyol,La Liga,2019,27.0,1991.0,19.1,13,8,5,6,2,4,38,10.5,34,32,1,31,15,28,19,1,"FW,MF",25-29,Forward,China,Asia
1390,Toni Leistner,GER,Köln,Bundesliga,2019,28.0,1990.0,11.2,19,12,10,9,0,5,13,38.5,8,16,7,9,32,51,57,0,DF,25-29,Defender,Germany,Europe
1391,Moritz Leitner,GER,Norwich City,Premier League,2019,26.0,1992.0,7.6,16,9,8,7,1,9,25,36.0,16,14,4,10,9,25,10,1,MF,25-29,Midfielder,Germany,Europe
1392,Lucas Leiva,BRA,Lazio,Serie A,2019,32.0,1987.0,20.1,60,35,25,31,4,28,72,38.9,44,29,6,23,47,107,34,1,MF,30-34,Midfielder,Brazil,South America
1393,Florian Lejeune,FRA,Newcastle Utd,Premier League,2019,28.0,1991.0,4.9,8,2,6,2,0,4,7,57.1,3,6,2,4,10,18,15,2,DF,25-29,Defender,France,Europe
1395,Nicolas Lemaître,FRA,Reims,Ligue 1,2019,22.0,1997.0,1.0,0,0,0,0,0,0,1,0.0,1,0,0,0,1,1,1,1,GK,20-24,Goalkeeper,France,Europe
1396,Thomas Lemar,FRA,Atlético Madrid,La Liga,2019,23.0,1995.0,10.3,12,8,4,5,3,2,11,18.2,9,14,1,13,6,18,6,0,MF,20-24,Midfielder,France,Europe
1397,Tim Lemperle,GER,Köln,Bundesliga,2019,17.0,2002.0,0.2,0,0,0,0,0,0,0,,0,0,0,0,0,0,0,0,MF,Under 20,Midfielder,Germany,Europe
1398,Clément Lenglet,FRA,Barcelona,La Liga,2019,24.0,1995.0,26.9,44,31,29,15,0,16,32,50.0,16,29,15,14,35,79,79,1,DF,20-24,Defender,France,Europe
1399,Aaron Lennon,ENG,Burnley,Premier League,2019,32.0,1987.0,5.5,14,8,7,4,3,7,10,70.0,3,6,1,5,8,22,3,0,MF,30-34,Midfielder,England,Europe
1400,Bernd Leno,GER,Arsenal,Premier League,2019,27.0,1992.0,29.4,0,0,0,0,0,0,2,0.0,2,0,0,0,0,0,9,2,GK,25-29,Goalkeeper,Germany,Europe
1401,Christopher Lenz,GER,Union Berlin,Bundesliga,2019,24.0,1994.0,25.2,63,37,37,20,6,26,49,53.1,23,46,11,35,43,106,65,0,"DF,MF",20-24,Defender,Germany,Europe
1405,Lukas Lerager,DEN,Genoa,Serie A,2019,26.0,1993.0,15.4,29,19,13,12,4,10,34,29.4,24,20,5,15,8,37,15,1,MF,25-29,Midfielder,Denmark,Europe
1406,Mehdi Léris,ALG,Sampdoria,Serie A,2019,21.0,1998.0,5.7,13,11,4,2,7,7,19,36.8,12,12,4,8,6,19,6,0,"MF,FW",20-24,Midfielder,Algeria,Africa
1407,Jefferson Lerma,COL,Bournemouth,Premier League,2019,24.0,1994.0,30.0,54,32,17,31,6,22,48,45.8,26,28,12,16,57,111,54,1,MF,20-24,Midfielder,Colombia,South America
1408,Karlo Letica,CRO,SPAL,Serie A,2019,22.0,1997.0,10.0,0,0,0,0,0,0,2,0.0,2,0,0,0,0,0,4,3,GK,20-24,Goalkeeper,Croatia,Europe
1411,Aaron Leya Iseka,BEL,Toulouse,Ligue 1,2019,21.0,1997.0,8.6,2,0,0,2,0,0,3,0.0,3,5,0,5,1,3,7,0,FW,20-24,Forward,Belgium,Europe
1412,Stephan Lichtsteiner,SUI,Augsburg,Bundesliga,2019,35.0,1984.0,14.9,23,14,16,5,2,10,22,45.5,12,15,7,8,16,39,35,0,DF,35-39,Defender,Switzerland,Europe
1413,Dimitri Liénard,FRA,Strasbourg,Ligue 1,2019,31.0,1988.0,16.5,37,24,10,22,5,18,39,46.2,21,18,4,14,17,54,25,0,MF,30-34,Midfielder,France,Europe
1414,Philipp Lienhart,AUT,Freiburg,Bundesliga,2019,23.0,1996.0,20.2,11,4,10,1,0,6,13,46.2,7,24,17,7,28,39,86,0,DF,20-24,Defender,Austria,Europe
1415,Matthijs de Ligt,NED,Juventus,Serie A,2019,19.0,1999.0,27.2,25,15,14,10,1,13,23,56.5,10,30,23,7,25,50,101,2,DF,Under 20,Defender,Netherlands,Europe
1416,Isaac Lihadji,FRA,Marseille,Ligue 1,2019,17.0,2002.0,0.3,0,0,0,0,0,0,0,,0,0,0,0,0,0,0,0,MF,Under 20,Midfielder,France,Europe
1418,Anderson Lima,BRA,Lazio,Serie A,2019,19.0,1999.0,0.7,4,0,3,1,0,1,1,100.0,0,4,0,4,0,4,0,0,"MF,DF",Under 20,Midfielder,Brazil,South America
1419,Lucas Lima,BRA,Nantes,Ligue 1,2019,27.0,1991.0,3.0,7,2,4,3,0,2,5,40.0,3,2,0,2,1,8,3,0,"FW,DF",25-29,Forward,Brazil,South America
1420,Anthony Limbombe,BEL,Nantes,Ligue 1,2019,25.0,1994.0,1.7,3,2,1,2,0,1,1,100.0,0,1,0,1,0,3,3,0,"FW,MF",25-29,Forward,Belgium,Europe
1421,Victor Lindelöf,SWE,Manchester Utd,Premier League,2019,25.0,1994.0,34.4,29,15,16,12,1,17,20,85.0,3,25,16,9,26,55,129,0,DF,25-29,Defender,Sweden,Europe
1423,Jesse Lingard,ENG,Manchester Utd,Premier League,2019,26.0,1992.0,10.4,15,8,6,4,5,5,18,27.8,13,5,0,5,3,18,0,0,"MF,FW",25-29,Midfielder,England,Europe
1428,Gautier Lloris,FRA,Nice,Ligue 1,2019,24.0,1995.0,3.0,5,3,5,0,0,4,5,80.0,1,3,3,0,2,7,11,0,DF,20-24,Defender,France,Europe
1429,Hugo Lloris,FRA,Tottenham,Premier League,2019,32.0,1986.0,20.1,0,0,0,0,0,0,0,,0,0,0,0,1,1,3,2,GK,30-34,Goalkeeper,France,Europe
1430,Giovani Lo Celso,ARG,Tottenham,Premier League,2019,23.0,1996.0,16.6,51,29,12,33,6,12,59,20.3,47,20,4,16,9,60,19,0,"MF,FW",20-24,Midfielder,Argentina,South America
1431,Stanislav Lobotka,SVK,Napoli,Serie A,2019,24.0,1994.0,8.4,11,9,3,5,3,5,12,41.7,7,3,1,2,9,20,2,0,MF,20-24,Midfielder,Slovakia,Europe
1432,Stanislav Lobotka,SVK,Celta Vigo,La Liga,2019,24.0,1994.0,15.4,19,11,13,5,1,4,19,21.1,15,8,2,6,8,27,7,0,MF,20-24,Midfielder,Slovakia,Europe
1433,Jürgen Locadia,CUW,Brighton,Premier League,2019,25.0,1993.0,1.0,0,0,0,0,0,0,0,,0,0,0,0,0,0,0,0,"FW,MF",25-29,Forward,Curaçao,Europe
1434,Jürgen Locadia,CUW,Hoffenheim,Bundesliga,2019,25.0,1993.0,5.9,5,4,0,4,1,1,4,25.0,3,1,0,1,0,5,3,0,FW,25-29,Forward,Curaçao,Europe
1435,Manuel Locatelli,ITA,Sassuolo,Serie A,2019,21.0,1998.0,28.7,76,50,35,37,4,33,69,47.8,36,42,14,28,33,109,36,0,MF,20-24,Midfielder,Italy,Europe
1436,Renan Lodi,BRA,Atlético Madrid,La Liga,2019,21.0,1998.0,26.6,73,46,28,35,10,40,65,61.5,25,28,7,21,38,111,56,0,DF,20-24,Defender,Brazil,South America
1437,Ruben Loftus-Cheek,ENG,Chelsea,Premier League,2019,23.0,1996.0,2.3,0,0,0,0,0,0,2,0.0,2,1,1,0,2,2,2,0,"MF,FW",20-24,Midfielder,England,Europe
1438,Enzo Loiodice,FRA,Dijon,Ligue 1,2019,18.0,2000.0,2.1,6,4,1,4,1,1,3,33.3,2,2,0,2,2,8,1,0,MF,Under 20,Midfielder,France,Europe
1439,Kevin Long,IRL,Burnley,Premier League,2019,28.0,1990.0,6.3,7,5,6,1,0,4,9,44.4,5,9,7,2,4,11,31,0,DF,25-29,Defender,Republic of Ireland,Europe
1440,Shane Long,IRL,Southampton,Premier League,2019,32.0,1987.0,15.5,19,10,5,8,6,7,19,36.8,12,12,0,12,4,23,16,0,FW,30-34,Forward,Republic of Ireland,Europe
1441,Matthew Longstaff,ENG,Newcastle Utd,Premier League,2019,19.0,2000.0,6.4,3,1,2,1,0,3,14,21.4,11,4,1,3,5,8,3,0,MF,Under 20,Midfielder,England,Europe
1442,Sean Longstaff,ENG,Newcastle Utd,Premier League,2019,21.0,1997.0,15.3,35,19,17,16,2,20,50,40.0,30,23,5,18,19,54,20,2,MF,20-24,Midfielder,England,Europe
1443,Ademola Lookman,NGA,RB Leipzig,Bundesliga,2019,21.0,1997.0,3.4,6,4,3,1,2,1,1,100.0,0,3,0,3,1,7,0,1,"FW,MF",20-24,Forward,Nigeria,Africa
1444,Anthony Lopes,POR,Lyon,Ligue 1,2019,28.0,1990.0,26.0,0,0,0,0,0,0,0,,0,0,0,0,1,1,11,0,GK,25-29,Goalkeeper,Portugal,Europe
1445,Rony Lopes,POR,Sevilla,La Liga,2019,23.0,1995.0,1.5,0,0,0,0,0,0,0,,0,0,0,0,2,2,0,0,FW,20-24,Forward,Portugal,Europe
1446,Rony Lopes,POR,Monaco,Ligue 1,2019,23.0,1995.0,0.9,1,0,0,1,0,0,0,,0,0,0,0,0,1,0,0,FW,20-24,Forward,Portugal,Europe
1453,Maxime Lopez,FRA,Marseille,Ligue 1,2019,21.0,1997.0,12.3,16,10,5,8,3,4,26,15.4,22,8,2,6,8,24,1,0,"MF,FW",20-24,Midfielder,France,Europe
1458,Albert Lottin,FRA,Bordeaux,Ligue 1,2019,17.0,2001.0,0.5,2,0,2,0,0,1,4,25.0,3,0,0,0,2,4,2,0,MF,Under 20,Midfielder,France,Europe
1459,Imran Louza,MAR,Nantes,Ligue 1,2019,20.0,1999.0,22.3,53,27,18,27,8,19,46,41.3,27,18,2,16,17,70,7,0,"MF,FW",20-24,Midfielder,Morocco,Africa
1460,Matteo Lovato,ITA,Hellas Verona,Serie A,2019,19.0,2000.0,0.1,0,0,0,0,0,0,0,,0,0,0,0,0,0,1,0,DF,Under 20,Defender,Italy,Europe
1461,Dejan Lovren,CRO,Liverpool,Premier League,2019,30.0,1989.0,8.6,13,8,10,3,0,7,12,58.3,5,9,6,3,10,23,42,0,DF,30-34,Defender,Croatia,Europe
1462,Eduard Löwen,GER,Augsburg,Bundesliga,2019,22.0,1997.0,7.5,10,8,6,2,2,6,18,33.3,12,11,2,9,5,15,7,0,MF,20-24,Midfielder,Germany,Europe
1463,Eduard Löwen,GER,Hertha BSC,Bundesliga,2019,22.0,1997.0,3.5,9,6,3,6,0,5,11,45.5,6,2,1,1,7,16,2,0,MF,20-24,Midfielder,Germany,Europe
1464,Matthew Lowton,ENG,Burnley,Premier League,2019,30.0,1989.0,17.0,41,22,20,18,3,22,33,66.7,11,20,6,14,27,68,57,1,DF,30-34,Defender,England,Europe
1465,Hirving Lozano,MEX,Napoli,Serie A,2019,24.0,1995.0,11.4,6,4,1,5,0,2,15,13.3,13,13,0,13,5,11,5,0,"FW,MF",20-24,Forward,Mexico,North America
1467,Jan Luca Rumpf,GER,Paderborn 07,Bundesliga,2019,20.0,1999.0,1.0,0,0,0,0,0,0,0,,0,0,0,0,0,0,2,0,DF,20-24,Defender,Germany,Europe
1468,Jean Lucas,BRA,Lyon,Ligue 1,2019,21.0,1998.0,2.2,16,7,8,5,3,2,9,22.2,7,2,2,0,2,18,0,0,MF,20-24,Midfielder,Brazil,South America
1469,Fabio Lucioni,ITA,Lecce,Serie A,2019,31.0,1987.0,34.8,29,13,20,9,0,14,32,43.8,18,48,38,10,36,65,169,5,DF,30-34,Defender,Italy,Europe
1472,José Luis Palomino,ARG,Atalanta,Serie A,2019,29.0,1990.0,27.6,81,44,46,33,2,28,54,51.9,26,39,14,25,61,142,74,2,DF,25-29,Defender,Argentina,South America
1473,José Luis Rodríguez,PAN,Alavés,La Liga,2019,21.0,1998.0,0.2,0,0,0,0,0,0,2,0.0,2,0,0,0,0,0,0,0,FW,20-24,Forward,Panama,North America
1474,David Luiz,BRA,Arsenal,Premier League,2019,32.0,1987.0,31.2,28,16,14,14,0,13,24,54.2,11,42,37,5,32,60,133,2,DF,30-34,Defender,Brazil,South America
1475,Douglas Luiz,BRA,Aston Villa,Premier League,2019,21.0,1998.0,29.0,46,24,25,17,4,19,65,29.2,46,42,15,27,36,82,54,1,MF,20-24,Midfielder,Brazil,South America
1476,Jordan Lukaku,BEL,Lazio,Serie A,2019,25.0,1994.0,4.4,4,2,1,1,2,2,4,50.0,2,2,1,1,0,4,9,0,DF,25-29,Defender,Belgium,Europe
1477,Romelu Lukaku,BEL,Inter,Serie A,2019,26.0,1993.0,33.1,13,7,4,7,2,3,10,30.0,7,14,6,8,1,14,28,0,FW,25-29,Forward,Belgium,Europe
1478,Dodi Lukebakio,BEL,Hertha BSC,Bundesliga,2019,21.0,1997.0,22.6,25,18,13,8,4,10,28,35.7,18,22,4,18,10,35,14,0,"FW,MF",20-24,Forward,Belgium,Europe
1480,Senad Lulić,BIH,Lazio,Serie A,2019,33.0,1986.0,17.5,21,13,10,7,4,11,41,26.8,30,20,4,16,21,42,28,1,DF,30-34,Defender,Bosnia and Herzegovina,Europe
1481,John Lundstram,ENG,Sheffield Utd,Premier League,2019,25.0,1994.0,27.3,46,30,18,21,7,21,65,32.3,44,18,4,14,33,79,46,1,MF,25-29,Midfielder,England,Europe
1482,Sebastiano Luperto,ITA,Napoli,Serie A,2019,22.0,1996.0,5.9,12,9,7,3,2,6,9,66.7,3,5,3,2,6,18,16,0,DF,20-24,Defender,Italy,Europe
1483,Arnaud Lusamba,COD,Nice,Ligue 1,2019,22.0,1997.0,10.9,20,11,8,10,2,7,23,30.4,16,9,0,9,5,25,6,1,"MF,FW",20-24,Midfielder,DR Congo,Africa
1484,Andreas Luthe,GER,Augsburg,Bundesliga,2019,32.0,1987.0,10.0,1,0,1,0,0,1,2,50.0,1,0,0,0,0,1,5,1,GK,30-34,Goalkeeper,Germany,Europe
1485,Lyanco,BRA,Torino,Serie A,2019,22.0,1997.0,13.1,23,13,9,12,2,7,13,53.8,6,29,19,10,23,46,54,2,DF,20-24,Defender,Brazil,South America
1486,Charalambos Lykogiannis,GRE,Cagliari,Serie A,2019,25.0,1993.0,14.9,14,9,9,3,2,7,18,38.9,11,25,9,16,23,37,71,0,DF,25-29,Defender,Greece,Europe
1487,Yann M'Vila,FRA,Saint-Étienne,Ligue 1,2019,29.0,1990.0,21.6,29,14,12,16,1,12,43,27.9,31,14,4,10,40,69,47,1,"MF,DF",25-29,Midfielder,France,Europe
1488,Alexis Mac Allister,ARG,Brighton,Premier League,2019,20.0,1998.0,3.9,9,5,4,3,2,5,9,55.6,4,12,0,12,1,10,2,0,"MF,FW",20-24,Midfielder,Argentina,South America
1489,Darwin Machís,VEN,Granada,La Liga,2019,26.0,1993.0,23.7,23,13,11,8,4,8,23,34.8,15,22,4,18,31,54,9,0,"FW,MF",25-29,Forward,Venezuela,South America
1490,Yvann Macon,FRA,Saint-Étienne,Ligue 1,2019,20.0,1998.0,1.1,0,0,0,0,0,0,1,0.0,1,2,0,2,3,3,4,0,DF,20-24,Defender,France,Europe
1491,James Maddison,ENG,Leicester City,Premier League,2019,22.0,1996.0,29.2,59,30,13,31,15,23,68,33.8,45,16,0,16,9,68,7,1,MF,20-24,Midfielder,England,Europe
1492,Gabriel Magalhães,BRA,Lille,Ligue 1,2019,21.0,1997.0,23.2,41,29,27,11,3,15,22,68.2,7,27,18,9,22,63,86,2,DF,20-24,Defender,Brazil,South America
1493,Lisandro Magallán,ARG,Alavés,La Liga,2019,25.0,1993.0,13.3,22,15,10,12,0,8,14,57.1,6,17,6,11,16,38,43,1,DF,25-29,Defender,Argentina,South America
1494,Francesco Magnanelli,ITA,Sassuolo,Serie A,2019,34.0,1984.0,15.5,25,13,9,12,4,11,35,31.4,24,12,6,6,19,44,23,1,MF,30-34,Midfielder,Italy,Europe
1495,Giangiacomo Magnani,ITA,Brescia,Serie A,2019,23.0,1995.0,1.3,0,0,0,0,0,0,1,0.0,1,2,2,0,2,2,6,0,DF,20-24,Defender,Italy,Europe
1496,Giangiacomo Magnani,ITA,Sassuolo,Serie A,2019,23.0,1995.0,1.6,0,0,0,0,0,0,0,,0,2,1,1,2,2,7,0,DF,20-24,Defender,Italy,Europe
1497,Hugo Magnetti,FRA,Brest,Ligue 1,2019,21.0,1998.0,2.6,16,10,7,7,2,5,9,55.6,4,4,0,4,7,23,4,0,MF,20-24,Midfielder,France,Europe
1498,Harry Maguire,ENG,Manchester Utd,Premier League,2019,26.0,1993.0,38.0,37,23,23,14,0,18,34,52.9,16,31,22,9,72,109,159,0,DF,25-29,Defender,England,Europe
1499,Abdallahi Mahmoud,MTN,Alavés,La Liga,2019,19.0,2000.0,1.7,4,4,2,1,1,1,6,16.7,5,0,0,0,5,9,2,0,MF,Under 20,Midfielder,Mauritania,Africa
1500,Riyad Mahrez,ALG,Manchester City,Premier League,2019,28.0,1991.0,21.6,28,14,11,9,8,11,38,28.9,27,31,1,30,18,46,8,2,"FW,MF",25-29,Forward,Algeria,Africa
1501,Thiago Maia,BRA,Lille,Ligue 1,2019,22.0,1997.0,0.5,4,4,1,3,0,0,1,0.0,1,0,0,0,1,5,1,0,MF,20-24,Midfielder,Brazil,South America
1502,Arne Maier,GER,Hertha BSC,Bundesliga,2019,20.0,1999.0,5.9,9,7,6,1,2,1,10,10.0,9,5,0,5,7,16,2,1,MF,20-24,Midfielder,Germany,Europe
1503,Habib Maïga,CIV,Metz,Ligue 1,2019,23.0,1996.0,25.2,84,50,36,38,10,24,64,37.5,40,39,4,35,34,118,39,2,MF,20-24,Midfielder,Ivory Coast,Africa
1504,Mike Maignan,FRA,Lille,Ligue 1,2019,24.0,1995.0,28.0,0,0,0,0,0,0,0,,0,0,0,0,2,2,5,0,GK,20-24,Goalkeeper,France,Europe
1505,Ainsley Maitland-Niles,ENG,Arsenal,Premier League,2019,21.0,1997.0,15.4,41,23,34,5,2,22,43,51.2,21,12,3,9,28,69,38,0,DF,20-24,Defender,England,Europe
1506,Josh Maja,NGA,Bordeaux,Ligue 1,2019,20.0,1998.0,8.2,5,2,0,2,3,1,10,10.0,9,8,4,4,1,6,3,0,FW,20-24,Forward,Nigeria,Africa
1507,Abdul Majeed Waris,GHA,Strasbourg,Ligue 1,2019,27.0,1991.0,4.1,6,4,4,2,0,3,8,37.5,5,2,0,2,4,10,0,0,FW,25-29,Forward,Ghana,Africa
1509,Jean-Victor Makengo,FRA,Toulouse,Ligue 1,2019,21.0,1998.0,11.0,14,11,3,10,1,4,13,30.8,9,7,1,6,3,17,5,1,MF,20-24,Midfielder,France,Europe
1512,Kévin Malcuit,MAR,Napoli,Serie A,2019,28.0,1991.0,2.8,8,6,4,3,1,5,6,83.3,1,4,1,3,3,11,2,0,DF,25-29,Defender,Morocco,Africa
1513,Daniel Maldini,ITA,Milan,Serie A,2019,17.0,2001.0,0.3,0,0,0,0,0,0,2,0.0,2,1,0,1,1,1,0,0,"FW,MF",Under 20,Forward,Italy,Europe
1514,Ruslan Malinovskyi,UKR,Atalanta,Serie A,2019,26.0,1993.0,17.1,22,14,2,17,3,9,31,29.0,22,13,2,11,5,27,5,0,"MF,FW",25-29,Midfielder,Ukraine,Europe
1515,Yunus Mallı,TUR,Union Berlin,Bundesliga,2019,27.0,1992.0,7.5,8,3,1,5,2,5,10,50.0,5,2,0,2,7,15,7,0,"MF,FW",25-29,Midfielder,Turkey,Asia
1517,Streli Mamba,GER,Paderborn 07,Bundesliga,2019,25.0,1994.0,16.9,15,9,0,9,6,1,13,7.7,12,12,2,10,6,21,2,0,FW,25-29,Forward,Germany,Europe
1518,Hianga Mananga Mbock,FRA,Brest,Ligue 1,2019,19.0,1999.0,1.6,1,1,1,0,0,0,0,,0,0,0,0,4,5,0,0,MF,Under 20,Midfielder,France,Europe
1519,Vincent Manceau,FRA,Angers,Ligue 1,2019,30.0,1989.0,22.0,34,22,18,13,3,16,36,44.4,20,16,3,13,22,56,51,0,DF,30-34,Defender,France,Europe
1520,Gianluca Mancini,ITA,Roma,Serie A,2019,23.0,1996.0,30.4,49,26,26,18,5,22,44,50.0,22,32,15,17,60,109,98,1,"DF,MF",20-24,Defender,Italy,Europe
1521,Marco Mancosu,ITA,Lecce,Serie A,2019,30.0,1988.0,27.1,32,18,11,16,5,10,46,21.7,36,34,9,25,16,48,15,1,"MF,FW",30-34,Midfielder,Italy,Europe
1522,Steve Mandanda,FRA,Marseille,Ligue 1,2019,34.0,1985.0,26.3,3,1,3,0,0,3,4,75.0,1,0,0,0,1,4,2,4,GK,30-34,Goalkeeper,France,Europe
1523,Reinildo Mandava,MOZ,Lille,Ligue 1,2019,25.0,1994.0,12.3,37,21,23,11,3,25,41,61.0,16,16,1,15,19,56,20,0,"DF,MF",25-29,Defender,Mozambique,Africa
1524,Aïssa Mandi,ALG,Betis,La Liga,2019,27.0,1991.0,28.6,33,15,22,8,3,18,28,64.3,10,29,15,14,38,71,93,0,DF,25-29,Defender,Algeria,Africa
1525,Rolando Mandragora,ITA,Udinese,Serie A,2019,22.0,1997.0,22.8,47,24,15,25,7,15,55,27.3,40,30,5,25,26,73,25,0,MF,20-24,Midfielder,Italy,Europe
1526,Sadio Mané,SEN,Liverpool,Premier League,2019,27.0,1992.0,30.5,44,32,9,20,15,13,40,32.5,27,19,0,19,13,57,11,2,FW,25-29,Forward,Senegal,Africa
1527,Eliaquim Mangala,FRA,Valencia,La Liga,2019,28.0,1991.0,7.5,4,4,3,1,0,1,2,50.0,1,7,6,1,7,11,40,0,DF,25-29,Defender,France,Europe
1528,Thomas Mangani,FRA,Angers,Ligue 1,2019,32.0,1987.0,20.8,33,23,15,16,2,14,47,29.8,33,17,2,15,12,45,20,1,MF,30-34,Midfielder,France,Europe
1529,Massimiliano Mangraviti,ITA,Brescia,Serie A,2019,21.0,1998.0,10.8,8,6,1,6,1,3,6,50.0,3,11,6,5,8,16,43,0,DF,20-24,Defender,Italy,Europe
1530,Kostas Manolas,GRE,Napoli,Serie A,2019,28.0,1991.0,24.2,23,15,13,10,0,10,17,58.8,7,19,14,5,25,48,76,1,DF,25-29,Defender,Greece,Europe
1532,Giacomo Manzari,ITA,Sassuolo,Serie A,2019,18.0,2000.0,0.2,0,0,0,0,0,0,0,,0,0,0,0,0,0,0,0,"FW,MF",Under 20,Forward,Italy,Europe
1534,Faitout Maouassa,FRA,Rennes,Ligue 1,2019,21.0,1998.0,20.0,51,33,27,20,4,14,26,53.8,12,13,5,8,23,74,59,0,DF,20-24,Defender,France,Europe
1535,Fernando Marçal,BRA,Lyon,Ligue 1,2019,30.0,1989.0,9.2,28,18,18,7,3,13,26,50.0,13,7,3,4,26,54,32,0,DF,30-34,Defender,Brazil,South America
1536,Marcelo,BRA,Real Madrid,La Liga,2019,31.0,1988.0,14.4,19,11,8,8,3,9,28,32.1,19,19,2,17,18,37,21,0,DF,30-34,Defender,Brazil,South America
1536,Marcelo,BRA,Real Madrid,La Liga,2019,31.0,1988.0,14.4,19,11,8,8,3,9,28,32.1,19,19,2,17,18,37,21,0,DF,30-34,Defender,Brazil,South America
1536,Marcelo,BRA,Real Madrid,La Liga,2019,31.0,1988.0,14.4,19,11,8,8,3,9,28,32.1,19,19,2,17,18,37,21,0,DF,30-34,Defender,Brazil,South America
1536,Marcelo,BRA,Real Madrid,La Liga,2019,31.0,1988.0,14.4,19,11,8,8,3,9,28,32.1,19,19,2,17,18,37,21,0,DF,30-34,Defender,Brazil,South America
1536,Marcelo,BRA,Real Madrid,La Liga,2019,31.0,1988.0,14.4,19,11,8,8,3,9,28,32.1,19,19,2,17,18,37,21,0,DF,30-34,Defender,Brazil,South America
1536,Marcelo,BRA,Real Madrid,La Liga,2019,31.0,1988.0,14.4,19,11,8,8,3,9,28,32.1,19,19,2,17,18,37,21,0,DF,30-34,Defender,Brazil,South America
1536,Marcelo,BRA,Real Madrid,La Liga,2019,31.0,1988.0,14.4,19,11,8,8,3,9,28,32.1,19,19,2,17,18,37,21,0,DF,30-34,Defender,Brazil,South America
1536,Marcelo,BRA,Real Madrid,La Liga,2019,31.0,1988.0,14.4,19,11,8,8,3,9,28,32.1,19,19,2,17,18,37,21,0,DF,30-34,Defender,Brazil,South America
1536,Marcelo,BRA,Real Madrid,La Liga,2019,31.0,1988.0,14.4,19,11,8,8,3,9,28,32.1,19,19,2,17,18,37,21,0,DF,30-34,Defender,Brazil,South America
1537,Marcelo,BRA,Lyon,Ligue 1,2019,32.0,1987.0,16.7,27,18,18,8,1,16,23,69.6,7,12,11,1,22,49,77,0,DF,30-34,Defender,Brazil,South America
1537,Marcelo,BRA,Lyon,Ligue 1,2019,32.0,1987.0,16.7,27,18,18,8,1,16,23,69.6,7,12,11,1,22,49,77,0,DF,30-34,Defender,Brazil,South America
1537,Marcelo,BRA,Lyon,Ligue 1,2019,32.0,1987.0,16.7,27,18,18,8,1,16,23,69.6,7,12,11,1,22,49,77,0,DF,30-34,Defender,Brazil,South America
1537,Marcelo,BRA,Lyon,Ligue 1,2019,32.0,1987.0,16.7,27,18,18,8,1,16,23,69.6,7,12,11,1,22,49,77,0,DF,30-34,Defender,Brazil,South America
1537,Marcelo,BRA,Lyon,Ligue 1,2019,32.0,1987.0,16.7,27,18,18,8,1,16,23,69.6,7,12,11,1,22,49,77,0,DF,30-34,Defender,Brazil,South America
1537,Marcelo,BRA,Lyon,Ligue 1,2019,32.0,1987.0,16.7,27,18,18,8,1,16,23,69.6,7,12,11,1,22,49,77,0,DF,30-34,Defender,Brazil,South America
1537,Marcelo,BRA,Lyon,Ligue 1,2019,32.0,1987.0,16.7,27,18,18,8,1,16,23,69.6,7,12,11,1,22,49,77,0,DF,30-34,Defender,Brazil,South America
1537,Marcelo,BRA,Lyon,Ligue 1,2019,32.0,1987.0,16.7,27,18,18,8,1,16,23,69.6,7,12,11,1,22,49,77,0,DF,30-34,Defender,Brazil,South America
1537,Marcelo,BRA,Lyon,Ligue 1,2019,32.0,1987.0,16.7,27,18,18,8,1,16,23,69.6,7,12,11,1,22,49,77,0,DF,30-34,Defender,Brazil,South America
1538,Solly March,ENG,Brighton,Premier League,2019,25.0,1994.0,12.7,25,12,16,6,3,9,19,47.4,10,16,4,12,20,45,14,2,"FW,MF",25-29,Forward,England,Europe
1539,Gian Marco Ferrari,ITA,Sassuolo,Serie A,2019,27.0,1992.0,21.1,9,5,6,3,0,4,8,50.0,4,25,22,3,26,35,41,1,DF,25-29,Defender,Italy,Europe
1541,Dario Maresic,AUT,Reims,Ligue 1,2019,19.0,1999.0,1.0,0,0,0,0,0,0,0,,0,1,1,0,1,1,6,0,DF,Under 20,Defender,Austria,Europe
1544,José María Giménez,URU,Atlético Madrid,La Liga,2019,24.0,1995.0,19.5,20,16,18,1,1,7,11,63.6,4,14,7,7,23,43,75,1,DF,20-24,Defender,Uruguay,South America
1545,Mariano,DOM,Real Madrid,La Liga,2019,25.0,1993.0,0.5,0,0,0,0,0,0,1,0.0,1,0,0,0,0,0,0,0,"FW,MF",25-29,Forward,Dominican Republic,North America
1546,Adrian Mariappa,JAM,Watford,Premier League,2019,32.0,1986.0,16.8,20,14,15,4,1,11,30,36.7,19,22,7,15,11,31,73,0,DF,30-34,Defender,Jamaica,North America
1547,Jordan Marié,FRA,Dijon,Ligue 1,2019,27.0,1991.0,2.2,7,5,4,3,0,4,9,44.4,5,3,1,2,4,11,2,0,"MF,FW",25-29,Midfielder,France,Europe
1548,Federico Marigosu,ITA,Cagliari,Serie A,2019,18.0,2001.0,0.3,0,0,0,0,0,0,0,,0,0,0,0,0,0,1,0,MF,Under 20,Midfielder,Italy,Europe
1550,Guillermo Maripán,CHI,Alavés,La Liga,2019,25.0,1994.0,1.0,1,1,1,0,0,1,2,50.0,1,0,0,0,2,3,10,0,DF,25-29,Defender,Chile,South America
1551,Guillermo Maripán,CHI,Monaco,Ligue 1,2019,25.0,1994.0,19.5,42,26,28,13,1,24,41,58.5,17,30,13,17,25,67,69,2,DF,25-29,Defender,Chile,South America
1552,Marlon,BRA,Sassuolo,Serie A,2019,23.0,1995.0,20.2,40,23,24,15,1,17,27,63.0,10,20,13,7,35,75,69,0,DF,20-24,Defender,Brazil,South America
1552,Marlon,BRA,Sassuolo,Serie A,2019,23.0,1995.0,20.2,40,23,24,15,1,17,27,63.0,10,20,13,7,35,75,69,0,DF,20-24,Defender,Brazil,South America
1552,Marlon,BRA,Sassuolo,Serie A,2019,23.0,1995.0,20.2,40,23,24,15,1,17,27,63.0,10,20,13,7,35,75,69,0,DF,20-24,Defender,Brazil,South America
1552,Marlon,BRA,Sassuolo,Serie A,2019,23.0,1995.0,20.2,40,23,24,15,1,17,27,63.0,10,20,13,7,35,75,69,0,DF,20-24,Defender,Brazil,South America
1552,Marlon,BRA,Sassuolo,Serie A,2019,23.0,1995.0,20.2,40,23,24,15,1,17,27,63.0,10,20,13,7,35,75,69,0,DF,20-24,Defender,Brazil,South America
1552,Marlon,BRA,Sassuolo,Serie A,2019,23.0,1995.0,20.2,40,23,24,15,1,17,27,63.0,10,20,13,7,35,75,69,0,DF,20-24,Defender,Brazil,South America
1552,Marlon,BRA,Sassuolo,Serie A,2019,23.0,1995.0,20.2,40,23,24,15,1,17,27,63.0,10,20,13,7,35,75,69,0,DF,20-24,Defender,Brazil,South America
1552,Marlon,BRA,Sassuolo,Serie A,2019,23.0,1995.0,20.2,40,23,24,15,1,17,27,63.0,10,20,13,7,35,75,69,0,DF,20-24,Defender,Brazil,South America
1552,Marlon,BRA,Sassuolo,Serie A,2019,23.0,1995.0,20.2,40,23,24,15,1,17,27,63.0,10,20,13,7,35,75,69,0,DF,20-24,Defender,Brazil,South America
1553,Omar Marmoush,EGY,Wolfsburg,Bundesliga,2019,20.0,1999.0,0.9,1,1,1,0,0,0,0,,0,1,0,1,1,2,0,0,"MF,FW",20-24,Midfielder,Egypt,Africa
1554,Gonzalo Maroni,ARG,Sampdoria,Serie A,2019,20.0,1999.0,2.0,3,1,1,1,1,3,7,42.9,4,1,0,1,3,6,0,0,"MF,FW",20-24,Midfielder,Argentina,South America
1555,Marquinhos,BRA,Paris S-G,Ligue 1,2019,25.0,1994.0,16.4,39,20,17,18,4,11,26,42.3,15,25,8,17,25,64,31,1,"MF,DF",25-29,Midfielder,Brazil,South America
1555,Marquinhos,BRA,Paris S-G,Ligue 1,2019,25.0,1994.0,16.4,39,20,17,18,4,11,26,42.3,15,25,8,17,25,64,31,1,"MF,DF",25-29,Midfielder,Brazil,South America
1555,Marquinhos,BRA,Paris S-G,Ligue 1,2019,25.0,1994.0,16.4,39,20,17,18,4,11,26,42.3,15,25,8,17,25,64,31,1,"MF,DF",25-29,Midfielder,Brazil,South America
1555,Marquinhos,BRA,Paris S-G,Ligue 1,2019,25.0,1994.0,16.4,39,20,17,18,4,11,26,42.3,15,25,8,17,25,64,31,1,"MF,DF",25-29,Midfielder,Brazil,South America
1555,Marquinhos,BRA,Paris S-G,Ligue 1,2019,25.0,1994.0,16.4,39,20,17,18,4,11,26,42.3,15,25,8,17,25,64,31,1,"MF,DF",25-29,Midfielder,Brazil,South America
1555,Marquinhos,BRA,Paris S-G,Ligue 1,2019,25.0,1994.0,16.4,39,20,17,18,4,11,26,42.3,15,25,8,17,25,64,31,1,"MF,DF",25-29,Midfielder,Brazil,South America
1555,Marquinhos,BRA,Paris S-G,Ligue 1,2019,25.0,1994.0,16.4,39,20,17,18,4,11,26,42.3,15,25,8,17,25,64,31,1,"MF,DF",25-29,Midfielder,Brazil,South America
1555,Marquinhos,BRA,Paris S-G,Ligue 1,2019,25.0,1994.0,16.4,39,20,17,18,4,11,26,42.3,15,25,8,17,25,64,31,1,"MF,DF",25-29,Midfielder,Brazil,South America
1555,Marquinhos,BRA,Paris S-G,Ligue 1,2019,25.0,1994.0,16.4,39,20,17,18,4,11,26,42.3,15,25,8,17,25,64,31,1,"MF,DF",25-29,Midfielder,Brazil,South America
1556,Bruno Martella,ITA,Brescia,Serie A,2019,26.0,1992.0,14.1,18,9,14,3,1,9,16,56.3,7,13,7,6,17,35,48,1,DF,25-29,Defender,Italy,Europe
1558,Anthony Martial,FRA,Manchester Utd,Premier League,2019,23.0,1995.0,29.2,15,12,1,4,10,1,16,6.3,15,18,1,17,5,20,17,0,FW,20-24,Forward,France,Europe
1561,David Martin,ENG,West Ham,Premier League,2019,33.0,1986.0,4.8,0,0,0,0,0,0,0,,0,0,0,0,0,0,1,1,GK,30-34,Goalkeeper,England,Europe
1562,Jonas Martin,FRA,Rennes,Ligue 1,2019,29.0,1990.0,1.3,6,2,4,0,2,1,1,100.0,0,2,2,0,0,6,0,0,MF,25-29,Midfielder,France,Europe
1563,Jonas Martin,FRA,Strasbourg,Ligue 1,2019,29.0,1990.0,2.7,5,3,4,0,1,1,3,33.3,2,3,0,3,1,6,3,0,MF,25-29,Midfielder,France,Europe
1564,Josh Martin,ENG,Norwich City,Premier League,2019,17.0,2001.0,0.4,1,0,0,0,1,0,0,,0,1,0,1,1,2,0,0,"FW,MF",Under 20,Forward,England,Europe
1565,Gabriel Martinelli,BRA,Arsenal,Premier League,2019,18.0,2001.0,7.4,20,15,10,6,4,7,20,35.0,13,15,1,14,3,23,8,0,FW,Under 20,Forward,Brazil,South America
1567,Emiliano Martínez,ARG,Arsenal,Premier League,2019,26.0,1992.0,8.6,0,0,0,0,0,0,0,,0,0,0,0,0,0,1,0,GK,25-29,Goalkeeper,Argentina,South America
1567,Emiliano Martínez,ARG,Arsenal,Premier League,2019,26.0,1992.0,8.6,0,0,0,0,0,0,0,,0,0,0,0,0,0,1,0,GK,25-29,Goalkeeper,Argentina,South America
1567,Emiliano Martínez,ARG,Arsenal,Premier League,2019,26.0,1992.0,8.6,0,0,0,0,0,0,0,,0,0,0,0,0,0,1,0,GK,25-29,Goalkeeper,Argentina,South America
1567,Emiliano Martínez,ARG,Arsenal,Premier League,2019,26.0,1992.0,8.6,0,0,0,0,0,0,0,,0,0,0,0,0,0,1,0,GK,25-29,Goalkeeper,Argentina,South America
1572,Lautaro Martínez,ARG,Inter,Serie A,2019,21.0,1997.0,27.2,22,7,2,8,12,4,34,11.8,30,30,2,28,15,37,11,0,FW,20-24,Forward,Argentina,South America
1574,Pablo Martinez,FRA,Nîmes,Ligue 1,2019,30.0,1989.0,26.0,42,21,26,15,1,21,40,52.5,19,34,22,12,58,100,97,0,DF,30-34,Defender,France,Europe
1575,Gelson Martins,POR,Monaco,Ligue 1,2019,24.0,1995.0,18.6,30,22,11,15,4,17,42,40.5,25,9,2,7,19,49,10,1,"DF,FW",20-24,Defender,Portugal,Europe
1576,Adam Marušić,MNE,Lazio,Serie A,2019,26.0,1992.0,10.5,11,6,7,4,0,4,11,36.4,7,14,2,12,14,25,16,0,DF,25-29,Defender,Montenegro,Europe
1577,Omar Mascarell,EQG,Schalke 04,Bundesliga,2019,26.0,1993.0,22.5,42,23,17,22,3,21,57,36.8,36,46,14,32,62,104,40,0,MF,25-29,Midfielder,Equatorial Guinea,Africa
1578,Andrea Masiello,ITA,Genoa,Serie A,2019,33.0,1986.0,14.7,26,15,17,8,1,16,32,50.0,16,8,2,6,26,52,55,2,DF,30-34,Defender,Italy,Europe
1579,Andrea Masiello,ITA,Atalanta,Serie A,2019,33.0,1986.0,6.0,11,4,6,4,1,7,14,50.0,7,6,4,2,10,21,13,0,DF,30-34,Defender,Italy,Europe
1580,Adam Masina,MAR,Watford,Premier League,2019,25.0,1994.0,20.2,38,22,24,11,3,14,37,37.8,23,26,12,14,28,66,66,0,DF,25-29,Defender,Morocco,Africa
1582,Arthur Masuaku,COD,West Ham,Premier League,2019,25.0,1993.0,10.4,41,23,24,13,4,23,39,59.0,16,19,5,14,14,55,23,0,DF,25-29,Defender,DR Congo,Africa
1586,Jean-Philippe Mateta,FRA,Mainz 05,Bundesliga,2019,22.0,1997.0,11.7,2,2,0,2,0,0,6,0.0,6,3,2,1,1,3,11,0,FW,20-24,Forward,France,Europe
1588,Joël Matip,CMR,Liverpool,Premier League,2019,27.0,1991.0,7.8,13,9,4,7,2,4,11,36.4,7,8,4,4,12,25,38,0,DF,25-29,Defender,Cameroon,Africa
1589,Rabbi Matondo,WAL,Schalke 04,Bundesliga,2019,18.0,2000.0,12.9,10,3,3,2,5,3,13,23.1,10,4,0,4,5,15,1,0,"FW,MF",Under 20,Forward,Wales,Europe
1590,Alessandro Matri,ITA,Brescia,Serie A,2019,34.0,1984.0,1.0,1,0,0,0,1,0,0,,0,1,0,1,0,1,1,0,"FW,MF",30-34,Forward,Italy,Europe
1591,Federico Mattiello,ITA,Cagliari,Serie A,2019,24.0,1995.0,10.3,30,21,19,7,4,11,27,40.7,16,20,7,13,18,48,22,0,DF,20-24,Defender,Italy,Europe
1592,Blaise Matuidi,FRA,Juventus,Serie A,2019,32.0,1987.0,24.9,48,27,13,27,8,13,34,38.2,21,35,6,29,22,70,16,0,MF,30-34,Midfielder,France,Europe
1593,Neal Maupay,FRA,Brighton,Premier League,2019,22.0,1996.0,30.7,20,12,1,13,6,9,29,31.0,20,24,0,24,4,24,10,0,FW,20-24,Forward,France,Europe
1594,Stephy Mavididi,ENG,Dijon,Ligue 1,2019,21.0,1998.0,15.5,18,11,7,8,3,10,26,38.5,16,11,0,11,7,25,5,0,"FW,MF",20-24,Forward,England,Europe
1595,Philipp Max,GER,Augsburg,Bundesliga,2019,25.0,1993.0,30.1,42,29,22,16,4,20,45,44.4,25,19,4,15,26,68,50,0,DF,25-29,Defender,Germany,Europe
1596,Alexandru Maxim,ROU,Mainz 05,Bundesliga,2019,29.0,1990.0,1.3,4,2,1,2,1,1,3,33.3,2,0,0,0,1,5,1,0,"MF,DF",25-29,Midfielder,Romania,Europe
1597,Eric Maxim Choupo-Moting,CMR,Paris S-G,Ligue 1,2019,30.0,1989.0,5.0,12,9,3,4,5,4,8,50.0,4,3,0,3,1,13,3,0,"FW,MF",30-34,Forward,Cameroon,Africa
1598,Kévin Mayi,GAB,Brest,Ligue 1,2019,26.0,1993.0,0.0,0,0,0,0,0,0,0,,0,0,0,0,0,0,0,0,"FW,MF",25-29,Forward,Gabon,Africa
1600,Luca Mazzitelli,ITA,Sassuolo,Serie A,2019,23.0,1995.0,0.1,1,1,0,1,0,1,1,100.0,0,0,0,0,0,1,0,0,MF,20-24,Midfielder,Italy,Europe
1601,Kevin Mbabu,SUI,Wolfsburg,Bundesliga,2019,24.0,1995.0,18.8,69,48,39,24,6,35,54,64.8,19,33,10,23,23,92,53,0,DF,20-24,Defender,Switzerland,Europe
1602,Kylian Mbappé,FRA,Paris S-G,Ligue 1,2019,20.0,1998.0,16.8,7,2,1,5,1,3,10,30.0,7,4,0,4,3,10,0,0,FW,20-24,Forward,France,Europe
1603,Ibrahima Mbaye,SEN,Bologna,Serie A,2019,24.0,1994.0,16.7,19,10,13,4,2,7,17,41.2,10,22,11,11,15,34,42,0,DF,20-24,Defender,Senegal,Africa
1604,Loïc Mbe Soh,FRA,Paris S-G,Ligue 1,2019,18.0,2001.0,0.6,2,2,2,0,0,2,2,100.0,0,0,0,0,1,3,0,0,DF,Under 20,Defender,France,Europe
1605,Isaac Mbenza,BEL,Amiens,Ligue 1,2019,23.0,1996.0,0.9,0,0,0,0,0,0,1,0.0,1,0,0,0,0,0,0,0,FW,20-24,Forward,Belgium,Europe
1606,Nathanael Mbuku,COD,Reims,Ligue 1,2019,17.0,2002.0,4.4,4,2,2,2,0,0,3,0.0,3,0,0,0,2,6,1,0,"FW,MF",Under 20,Forward,DR Congo,Africa
1607,James McArthur,SCO,Crystal Palace,Premier League,2019,31.0,1987.0,34.3,88,51,43,34,11,37,106,34.9,69,69,19,50,60,148,56,0,MF,30-34,Midfielder,Scotland,Europe
1608,Oliver McBurnie,SCO,Sheffield Utd,Premier League,2019,23.0,1996.0,23.5,37,22,6,27,4,11,40,27.5,29,25,3,22,15,52,43,0,FW,20-24,Forward,Scotland,Europe
1609,Alex McCarthy,ENG,Southampton,Premier League,2019,29.0,1989.0,28.0,1,1,1,0,0,1,1,100.0,0,1,0,1,0,1,11,3,GK,25-29,Goalkeeper,England,Europe
1610,James McCarthy,IRL,Crystal Palace,Premier League,2019,28.0,1990.0,18.7,82,47,36,36,10,40,76,52.6,36,24,5,19,24,106,11,0,MF,25-29,Midfielder,Republic of Ireland,Europe
1611,John McGinn,SCO,Aston Villa,Premier League,2019,24.0,1994.0,25.7,53,35,19,23,11,18,62,29.0,44,25,1,24,25,78,18,0,MF,20-24,Midfielder,Scotland,Europe
1612,David McGoldrick,IRL,Sheffield Utd,Premier League,2019,31.0,1987.0,20.2,41,26,9,24,8,5,20,25.0,15,14,2,12,3,44,23,0,FW,30-34,Forward,Republic of Ireland,Europe
1614,Weston McKennie,USA,Schalke 04,Bundesliga,2019,20.0,1998.0,23.0,38,20,17,16,5,13,40,32.5,27,38,12,26,46,84,39,0,"MF,DF",20-24,Midfielder,United States,North America
1615,Kenny McLean,SCO,Norwich City,Premier League,2019,27.0,1992.0,33.0,44,29,20,18,6,14,42,33.3,28,32,7,25,38,82,67,2,MF,25-29,Midfielder,Scotland,Europe
1616,Dwight McNeil,ENG,Burnley,Premier League,2019,19.0,1999.0,37.1,47,33,18,22,7,23,71,32.4,48,60,8,52,30,77,34,0,MF,Under 20,Midfielder,England,Europe
1617,Scott McTominay,SCO,Manchester Utd,Premier League,2019,22.0,1996.0,19.7,43,22,14,25,4,17,32,53.1,15,25,5,20,31,74,34,2,MF,20-24,Midfielder,Scotland,Europe
1618,Biagio Meccariello,ITA,Lecce,Serie A,2019,28.0,1991.0,8.5,23,13,15,6,2,12,29,41.4,17,14,2,12,10,33,25,0,DF,25-29,Defender,Italy,Europe
1619,Gary Medel,CHI,Bologna,Serie A,2019,31.0,1987.0,19.8,43,22,15,24,4,16,43,37.2,27,24,8,16,34,77,31,2,MF,30-34,Midfielder,Chile,South America
1620,Ben Mee,ENG,Burnley,Premier League,2019,29.0,1989.0,32.0,41,22,25,16,0,17,29,58.6,12,42,31,11,42,83,165,2,DF,25-29,Defender,England,Europe
1621,Joshua Mees,GER,Union Berlin,Bundesliga,2019,23.0,1996.0,3.6,8,5,3,4,1,4,12,33.3,8,3,0,3,2,10,4,0,"MF,FW",20-24,Midfielder,Germany,Europe
1622,Admir Mehmedi,SUI,Wolfsburg,Bundesliga,2019,28.0,1991.0,13.3,14,6,2,9,3,4,15,26.7,11,10,0,10,5,19,4,0,"MF,FW",25-29,Midfielder,Switzerland,Europe
1623,Soualiho Meïté,FRA,Torino,Serie A,2019,25.0,1994.0,24.5,32,18,14,13,5,12,35,34.3,23,31,6,25,24,56,36,0,MF,25-29,Midfielder,France,Europe
1624,Farid El Melali,ALG,Angers,Ligue 1,2019,22.0,1997.0,3.4,7,5,2,2,3,4,14,28.6,10,5,0,5,2,9,4,0,"MF,FW",20-24,Midfielder,Algeria,Africa
1627,Arthur Melo,BRA,Barcelona,La Liga,2019,22.0,1996.0,13.1,15,10,4,7,4,4,12,33.3,8,9,0,9,4,19,5,2,MF,20-24,Midfielder,Brazil,South America
1628,Memphis,NED,Lyon,Ligue 1,2019,25.0,1994.0,11.3,4,3,2,0,2,0,5,0.0,5,0,0,0,2,6,2,0,"FW,MF",25-29,Forward,Netherlands,Europe
1629,Pedro Mendes,POR,Montpellier,Ligue 1,2019,28.0,1990.0,15.3,28,17,15,13,0,15,24,62.5,9,19,12,7,28,56,42,1,DF,25-29,Defender,Portugal,Europe
1629,Pedro Mendes,POR,Montpellier,Ligue 1,2019,28.0,1990.0,15.3,28,17,15,13,0,15,24,62.5,9,19,12,7,28,56,42,1,DF,25-29,Defender,Portugal,Europe
1629,Pedro Mendes,POR,Montpellier,Ligue 1,2019,28.0,1990.0,15.3,28,17,15,13,0,15,24,62.5,9,19,12,7,28,56,42,1,DF,25-29,Defender,Portugal,Europe
1629,Pedro Mendes,POR,Montpellier,Ligue 1,2019,28.0,1990.0,15.3,28,17,15,13,0,15,24,62.5,9,19,12,7,28,56,42,1,DF,25-29,Defender,Portugal,Europe
1629,Pedro Mendes,POR,Montpellier,Ligue 1,2019,28.0,1990.0,15.3,28,17,15,13,0,15,24,62.5,9,19,12,7,28,56,42,1,DF,25-29,Defender,Portugal,Europe
1629,Pedro Mendes,POR,Montpellier,Ligue 1,2019,28.0,1990.0,15.3,28,17,15,13,0,15,24,62.5,9,19,12,7,28,56,42,1,DF,25-29,Defender,Portugal,Europe
1629,Pedro Mendes,POR,Montpellier,Ligue 1,2019,28.0,1990.0,15.3,28,17,15,13,0,15,24,62.5,9,19,12,7,28,56,42,1,DF,25-29,Defender,Portugal,Europe
1629,Pedro Mendes,POR,Montpellier,Ligue 1,2019,28.0,1990.0,15.3,28,17,15,13,0,15,24,62.5,9,19,12,7,28,56,42,1,DF,25-29,Defender,Portugal,Europe
1629,Pedro Mendes,POR,Montpellier,Ligue 1,2019,28.0,1990.0,15.3,28,17,15,13,0,15,24,62.5,9,19,12,7,28,56,42,1,DF,25-29,Defender,Portugal,Europe
1630,Thiago Mendes,BRA,Lyon,Ligue 1,2019,27.0,1992.0,20.1,43,29,20,19,4,21,45,46.7,24,21,7,14,46,89,36,0,MF,25-29,Midfielder,Brazil,South America
1633,Stiven Mendoza,COL,Amiens,Ligue 1,2019,27.0,1992.0,12.2,12,7,4,5,3,4,22,18.2,18,13,2,11,9,21,3,1,"FW,MF",25-29,Forward,Colombia,South America
1634,Alexandre Mendy,GNB,Brest,Ligue 1,2019,25.0,1994.0,10.0,5,1,1,0,4,1,4,25.0,3,4,1,3,0,5,10,0,FW,25-29,Forward,Guinea-Bissau,Africa
1635,Benjamin Mendy,FRA,Manchester City,Premier League,2019,25.0,1994.0,16.6,18,15,7,7,4,9,27,33.3,18,10,2,8,16,34,21,3,DF,25-29,Defender,France,Europe
1636,Edouard Mendy,SEN,Rennes,Ligue 1,2019,27.0,1992.0,24.0,0,0,0,0,0,0,0,,0,0,0,0,0,0,5,1,GK,25-29,Goalkeeper,Senegal,Africa
1637,Ferland Mendy,FRA,Real Madrid,La Liga,2019,24.0,1995.0,20.1,32,26,20,9,3,14,18,77.8,4,19,5,14,22,54,30,1,DF,20-24,Defender,France,Europe
1638,Nampalys Mendy,SEN,Leicester City,Premier League,2019,27.0,1992.0,3.2,7,5,4,1,2,4,5,80.0,1,4,1,3,6,13,6,0,MF,25-29,Midfielder,Senegal,Africa
1639,Hamza Mendyl,MAR,Dijon,Ligue 1,2019,21.0,1997.0,16.0,49,32,31,14,4,29,46,63.0,17,16,4,12,23,72,47,0,DF,20-24,Defender,Morocco,Africa
1640,Chris Mepham,WAL,Bournemouth,Premier League,2019,21.0,1997.0,10.1,20,9,13,7,0,11,14,78.6,3,17,11,6,17,37,62,1,DF,20-24,Defender,Wales,Europe
1641,Levent Mercan,GER,Schalke 04,Bundesliga,2019,18.0,2000.0,0.8,0,0,0,0,0,0,0,,0,0,0,0,0,0,2,1,"MF,FW",Under 20,Midfielder,Germany,Europe
1643,Alex Meret,ITA,Napoli,Serie A,2019,22.0,1997.0,21.7,0,0,0,0,0,0,2,0.0,2,1,0,1,1,1,7,2,GK,20-24,Goalkeeper,Italy,Europe
1647,Yıldırım Mert Çetin,TUR,Roma,Serie A,2019,22.0,1997.0,2.9,5,1,4,1,0,3,5,60.0,2,4,3,1,4,9,8,1,DF,20-24,Defender,Turkey,Asia
1648,Dries Mertens,BEL,Napoli,Serie A,2019,32.0,1987.0,18.8,13,9,1,8,4,2,27,7.4,25,10,1,9,7,20,4,0,FW,30-34,Forward,Belgium,Europe
1650,Lionel Messi,ARG,Barcelona,La Liga,2019,32.0,1987.0,32.0,21,10,4,7,10,3,21,14.3,18,9,0,9,7,28,1,0,FW,30-34,Forward,Argentina,South America
1651,Thomas Meunier,BEL,Paris S-G,Ligue 1,2019,27.0,1991.0,13.8,27,21,9,12,6,16,26,61.5,10,17,5,12,18,45,19,1,DF,25-29,Defender,Belgium,Europe
1652,Mexer,MOZ,Bordeaux,Ligue 1,2019,30.0,1988.0,16.5,16,11,14,1,1,10,30,33.3,20,14,13,1,15,31,47,0,DF,30-34,Defender,Mozambique,Africa
1653,Max Meyer,GER,Crystal Palace,Premier League,2019,23.0,1995.0,7.3,19,11,10,9,0,8,18,44.4,10,6,1,5,7,26,4,0,"MF,FW",20-24,Midfielder,Germany,Europe
1654,Kingsley Michael,NGA,Bologna,Serie A,2019,19.0,1999.0,0.8,2,1,0,2,0,0,0,,0,0,0,0,1,3,1,0,MF,Under 20,Midfielder,Nigeria,Africa
1656,Sven Michel,GER,Paderborn 07,Bundesliga,2019,29.0,1990.0,15.3,14,12,3,5,6,3,20,15.0,17,13,2,11,7,21,7,0,FW,25-29,Forward,Germany,Europe
1658,Florian Miguel,FRA,Nîmes,Ligue 1,2019,22.0,1996.0,22.8,51,25,27,20,4,31,52,59.6,21,19,4,15,33,84,32,0,DF,20-24,Defender,France,Europe
1659,Georges Mikautadze,GEO,Metz,Ligue 1,2019,18.0,2000.0,0.1,1,0,0,0,1,0,0,,0,0,0,0,0,1,0,0,FW,Under 20,Forward,Georgia,Asia
1663,Éder Militão,BRA,Real Madrid,La Liga,2019,21.0,1998.0,11.4,25,15,15,9,1,10,17,58.8,7,12,6,6,20,45,42,0,DF,20-24,Defender,Brazil,South America
1665,Vincenzo Millico,ITA,Torino,Serie A,2019,18.0,2000.0,2.4,1,0,1,0,0,1,3,33.3,2,2,0,2,0,1,1,0,"MF,FW",Under 20,Midfielder,Italy,Europe
1666,James Milner,ENG,Liverpool,Premier League,2019,33.0,1986.0,10.4,16,10,3,10,3,6,26,23.1,20,12,3,9,7,23,17,1,"MF,DF",30-34,Midfielder,England,Europe
1668,Yerry Mina,COL,Everton,Premier League,2019,24.0,1994.0,25.4,39,22,25,12,2,18,24,75.0,6,20,14,6,28,67,102,1,DF,20-24,Defender,Colombia,South America
1669,Takumi Minamino,JPN,Liverpool,Premier League,2019,24.0,1995.0,2.8,3,3,0,2,1,2,10,20.0,8,3,0,3,0,3,3,0,"FW,MF",20-24,Forward,Japan,Asia
1670,Tyrone Mings,ENG,Aston Villa,Premier League,2019,26.0,1993.0,32.2,15,11,11,3,1,10,13,76.9,3,56,48,8,30,45,190,4,DF,25-29,Defender,England,Europe
1673,Antonio Mirante,ITA,Roma,Serie A,2019,36.0,1983.0,5.0,0,0,0,0,0,0,1,0.0,1,0,0,0,0,0,2,1,GK,35-39,Goalkeeper,Italy,Europe
1674,Simone Missiroli,ITA,SPAL,Serie A,2019,33.0,1986.0,31.1,42,27,18,20,4,13,43,30.2,30,42,27,15,54,96,62,1,MF,30-34,Midfielder,Italy,Europe
1675,Tyrick Mitchell,ENG,Crystal Palace,Premier League,2019,19.0,1999.0,2.2,5,2,2,2,1,1,7,14.3,6,2,0,2,2,7,3,0,DF,Under 20,Defender,England,Europe
1677,Maximilian Mittelstädt,GER,Hertha BSC,Bundesliga,2019,22.0,1997.0,21.0,61,38,31,25,5,26,54,48.1,28,38,6,32,53,114,64,0,"DF,FW",20-24,Defender,Germany,Europe
1678,Henrikh Mkhitaryan,ARM,Arsenal,Premier League,2019,30.0,1989.0,1.2,0,0,0,0,0,0,2,0.0,2,3,0,3,0,0,1,0,FW,30-34,Forward,Armenia,Asia
1679,Henrikh Mkhitaryan,ARM,Roma,Serie A,2019,30.0,1989.0,17.0,32,22,10,17,5,19,45,42.2,26,27,3,24,11,43,6,0,"MF,FW",30-34,Midfielder,Armenia,Asia
1680,Anthony Modeste,FRA,Köln,Bundesliga,2019,31.0,1988.0,12.6,10,5,1,5,4,1,10,10.0,9,5,3,2,0,10,19,0,FW,30-34,Forward,France,Europe
1681,Luka Modrić,CRO,Real Madrid,La Liga,2019,33.0,1985.0,22.2,37,18,9,15,13,16,41,39.0,25,10,2,8,22,59,12,0,MF,30-34,Midfielder,Croatia,Europe
1682,Kevin Möhwald,GER,Werder Bremen,Bundesliga,2019,26.0,1993.0,0.8,2,1,1,1,0,1,2,50.0,1,0,0,0,0,2,1,0,MF,25-29,Midfielder,Germany,Europe
1683,Niklas Moisander,FIN,Werder Bremen,Bundesliga,2019,33.0,1985.0,22.0,27,15,19,6,2,11,26,42.3,15,37,19,18,49,76,85,0,DF,30-34,Defender,Finland,Europe
1685,Florent Mollet,FRA,Montpellier,Ligue 1,2019,27.0,1991.0,18.7,13,11,3,8,2,7,28,25.0,21,9,1,8,9,22,2,0,"MF,FW",25-29,Midfielder,France,Europe
1687,Gabriele Moncini,ITA,SPAL,Serie A,2019,23.0,1996.0,1.7,1,0,0,1,0,0,0,,0,2,1,1,1,2,0,0,"FW,MF",20-24,Forward,Italy,Europe
1688,Thomas Monconduit,FRA,Amiens,Ligue 1,2019,28.0,1991.0,15.2,26,12,6,18,2,9,26,34.6,17,11,4,7,10,36,25,3,MF,25-29,Midfielder,France,Europe
1692,Ilario Monterisi,ITA,Lecce,Serie A,2019,17.0,2001.0,0.0,0,0,0,0,0,0,0,,0,0,0,0,0,0,0,0,DF,Under 20,Defender,Italy,Europe
1695,Simon Moore,ENG,Sheffield Utd,Premier League,2019,29.0,1990.0,2.0,1,0,1,0,0,1,1,100.0,0,0,0,0,0,1,0,1,GK,25-29,Goalkeeper,England,Europe
1696,Aaron Mooy,AUS,Brighton,Premier League,2019,28.0,1990.0,23.2,37,24,9,18,10,6,40,15.0,34,36,7,29,23,60,32,1,"MF,FW",25-29,Midfielder,Australia,Oceania
1697,Wesley Moraes,BRA,Aston Villa,Premier League,2019,22.0,1996.0,19.8,15,8,3,8,4,0,5,0.0,5,10,2,8,4,19,23,0,FW,20-24,Forward,Brazil,South America
1698,Alfredo Morales,USA,Düsseldorf,Bundesliga,2019,29.0,1990.0,19.2,31,15,11,16,4,11,35,31.4,24,17,6,11,18,49,37,0,MF,25-29,Midfielder,United States,North America
1701,Steven Moreira,CPV,Toulouse,Ligue 1,2019,24.0,1994.0,15.4,37,25,21,15,1,19,31,61.3,12,16,3,13,16,53,29,0,DF,20-24,Defender,Cape Verde,Africa
1702,Jérémy Morel,MAD,Rennes,Ligue 1,2019,35.0,1984.0,20.1,15,9,13,1,1,9,20,45.0,11,21,17,4,17,32,59,1,DF,35-39,Defender,Madagascar,Africa
1707,Wes Morgan,JAM,Leicester City,Premier League,2019,35.0,1984.0,4.8,4,1,3,1,0,0,3,0.0,3,5,3,2,7,11,19,0,DF,35-39,Defender,Jamaica,North America
1711,Leonardo Morosini,ITA,Brescia,Serie A,2019,23.0,1995.0,0.3,1,1,1,0,0,0,0,,0,1,0,1,1,2,1,0,"FW,DF",20-24,Forward,Italy,Europe
1712,Ravel Morrison,JAM,Sheffield Utd,Premier League,2019,26.0,1993.0,0.1,0,0,0,0,0,0,0,,0,0,0,0,0,0,0,0,MF,25-29,Midfielder,Jamaica,North America
1713,Victor Moses,NGA,Inter,Serie A,2019,28.0,1990.0,4.7,4,3,1,2,1,2,8,25.0,6,4,0,4,0,4,4,0,DF,25-29,Defender,Nigeria,Africa
1714,Lebo Mothiba,RSA,Strasbourg,Ligue 1,2019,23.0,1996.0,11.6,4,3,1,1,2,1,6,16.7,5,5,0,5,3,7,1,0,FW,20-24,Forward,South Africa,Africa
1715,Harold Moukoudi,CMR,Saint-Étienne,Ligue 1,2019,21.0,1997.0,11.0,28,19,20,7,1,11,14,78.6,3,16,10,6,16,44,42,2,DF,20-24,Defender,Cameroon,Africa
1716,Jessy Moulin,FRA,Saint-Étienne,Ligue 1,2019,33.0,1986.0,5.0,0,0,0,0,0,0,0,,0,0,0,0,1,1,2,0,GK,30-34,Goalkeeper,France,Europe
1717,Mason Mount,ENG,Chelsea,Premier League,2019,20.0,1999.0,31.9,37,17,8,19,10,9,42,21.4,33,25,3,22,16,53,18,0,"MF,FW",20-24,Midfielder,England,Europe
1718,Lucas Moura,BRA,Tottenham,Premier League,2019,26.0,1992.0,24.9,57,33,25,22,10,16,58,27.6,42,29,2,27,15,72,27,0,"FW,MF",25-29,Forward,Brazil,South America
1719,Lys Mousset,FRA,Sheffield Utd,Premier League,2019,23.0,1996.0,13.8,9,5,0,5,4,3,7,42.9,4,3,0,3,4,13,2,0,FW,20-24,Forward,France,Europe
1720,Wesley Moustache,FRA,Nantes,Ligue 1,2019,20.0,1999.0,0.5,0,0,0,0,0,0,0,,0,1,0,1,0,0,2,0,DF,20-24,Defender,France,Europe
1721,João Moutinho,POR,Wolves,Premier League,2019,32.0,1986.0,34.5,93,50,43,41,9,46,139,33.1,93,43,13,30,50,143,18,1,MF,30-34,Midfielder,Portugal,Europe
1721,João Moutinho,POR,Wolves,Premier League,2019,32.0,1986.0,34.5,93,50,43,41,9,46,139,33.1,93,43,13,30,50,143,18,1,MF,30-34,Midfielder,Portugal,Europe
1721,João Moutinho,POR,Wolves,Premier League,2019,32.0,1986.0,34.5,93,50,43,41,9,46,139,33.1,93,43,13,30,50,143,18,1,MF,30-34,Midfielder,Portugal,Europe
1721,João Moutinho,POR,Wolves,Premier League,2019,32.0,1986.0,34.5,93,50,43,41,9,46,139,33.1,93,43,13,30,50,143,18,1,MF,30-34,Midfielder,Portugal,Europe
1722,Samuel Moutoussamy,COD,Nantes,Ligue 1,2019,22.0,1996.0,5.8,4,1,2,1,1,2,7,28.6,5,2,0,2,4,8,7,0,"DF,MF",20-24,Defender,DR Congo,Africa
1725,Nordi Mukiele,FRA,RB Leipzig,Bundesliga,2019,21.0,1997.0,19.8,61,39,39,12,10,25,38,65.8,13,26,4,22,47,108,57,0,"DF,FW",20-24,Defender,France,Europe
1726,Mert Müldür,TUR,Sassuolo,Serie A,2019,20.0,1999.0,14.1,47,27,33,8,6,27,42,64.3,15,10,0,10,22,69,42,0,DF,20-24,Defender,Turkey,Asia
1727,Florian Müller,GER,Mainz 05,Bundesliga,2019,21.0,1997.0,12.5,0,0,0,0,0,0,0,,0,0,0,0,2,2,3,1,GK,20-24,Goalkeeper,Germany,Europe
1728,Thomas Müller,GER,Bayern Munich,Bundesliga,2019,29.0,1989.0,25.1,45,27,7,26,12,22,69,31.9,47,27,3,24,12,57,8,0,"MF,FW",25-29,Midfielder,Germany,Europe
1729,Marshall Munetsi,ZIM,Reims,Ligue 1,2019,23.0,1996.0,9.3,27,19,12,12,3,6,12,50.0,6,13,7,6,12,39,20,1,MF,20-24,Midfielder,Zimbabwe,Africa
1733,Simone Muratore,ITA,Juventus,Serie A,2019,21.0,1998.0,1.8,2,0,0,1,1,1,3,33.3,2,1,0,1,3,5,0,0,MF,20-24,Midfielder,Italy,Europe
1734,Alessandro Murgia,ITA,SPAL,Serie A,2019,22.0,1996.0,19.4,27,17,16,8,3,14,34,41.2,20,10,3,7,18,45,15,0,MF,20-24,Midfielder,Italy,Europe
1735,Luis Muriel,COL,Atalanta,Serie A,2019,28.0,1991.0,14.0,15,9,3,8,4,3,14,21.4,11,12,0,12,4,19,0,0,FW,25-29,Forward,Colombia,South America
1736,Jeison Murillo,COL,Sampdoria,Serie A,2019,27.0,1992.0,7.4,18,6,14,4,0,10,19,52.6,9,8,4,4,10,28,28,0,DF,25-29,Defender,Colombia,South America
1737,Jeison Murillo,COL,Celta Vigo,La Liga,2019,27.0,1992.0,17.0,37,20,30,6,1,18,27,66.7,9,13,9,4,20,57,74,2,DF,25-29,Defender,Colombia,South America
1738,Glenn Murray,ENG,Brighton,Premier League,2019,35.0,1983.0,8.9,5,2,0,3,2,2,9,22.2,7,6,2,4,1,6,12,0,FW,35-39,Forward,England,Europe
1739,Nicola Murru,ITA,Sampdoria,Serie A,2019,24.0,1994.0,25.1,40,22,24,8,8,21,41,51.2,20,22,4,18,27,67,58,0,DF,20-24,Defender,Italy,Europe
1740,Mateo Musacchio,ARG,Milan,Serie A,2019,28.0,1990.0,16.3,15,8,11,4,0,7,20,35.0,13,10,7,3,22,37,50,0,DF,25-29,Defender,Argentina,South America
1741,Torben Müsel,GER,Gladbach,Bundesliga,2019,20.0,1999.0,0.0,0,0,0,0,0,0,0,,0,0,0,0,1,1,0,0,FW,20-24,Forward,Germany,Europe
1742,Jamal Musiala,GER,Bayern Munich,Bundesliga,2019,16.0,2003.0,0.0,0,0,0,0,0,0,0,,0,0,0,0,0,0,0,0,MF,Under 20,Midfielder,Germany,Europe
1743,Juan Musso,ARG,Udinese,Serie A,2019,25.0,1994.0,38.0,0,0,0,0,0,0,1,0.0,1,0,0,0,1,1,18,2,GK,25-29,Goalkeeper,Argentina,South America
1744,Shkodran Mustafi,GER,Arsenal,Premier League,2019,27.0,1992.0,13.4,17,10,11,5,1,6,12,50.0,6,10,6,4,18,35,72,0,DF,25-29,Defender,Germany,Europe
1745,Yoshinori Mutō,JPN,Newcastle Utd,Premier League,2019,27.0,1992.0,2.4,3,2,1,2,0,1,2,50.0,1,0,0,0,0,3,0,0,"MF,FW",25-29,Midfielder,Japan,Asia
1746,Yvon Mvogo,SUI,RB Leipzig,Bundesliga,2019,25.0,1994.0,2.0,0,0,0,0,0,0,0,,0,0,0,0,0,0,0,1,GK,25-29,Goalkeeper,Switzerland,Europe
1747,Phillipp Mwene,AUT,Mainz 05,Bundesliga,2019,25.0,1994.0,3.5,11,5,9,2,0,7,12,58.3,5,10,1,9,3,14,11,0,DF,25-29,Defender,Austria,Europe
1748,Obite N'Dicka,CIV,Eint Frankfurt,Bundesliga,2019,19.0,1999.0,19.1,27,13,13,11,3,15,28,53.6,13,28,6,22,29,56,57,0,DF,Under 20,Defender,Ivory Coast,Africa
1749,Kévin N'Doram,FRA,Metz,Ligue 1,2019,23.0,1996.0,18.3,43,28,19,21,3,17,40,42.5,23,20,8,12,26,69,23,0,MF,20-24,Midfielder,France,Europe
1750,Abdallah N'dour,SEN,Strasbourg,Ligue 1,2019,25.0,1993.0,4.1,5,4,2,3,0,5,10,50.0,5,4,1,3,4,9,5,1,DF,25-29,Defender,Senegal,Africa
1751,Ferris N'Goma,FRA,Brest,Ligue 1,2019,26.0,1993.0,0.3,0,0,0,0,0,0,0,,0,1,0,1,0,0,0,0,"MF,FW",25-29,Midfielder,France,Europe
1752,Nathan N'Goumou,FRA,Toulouse,Ligue 1,2019,19.0,2000.0,0.1,0,0,0,0,0,0,0,,0,0,0,0,0,0,1,0,FW,Under 20,Forward,France,Europe
1753,Georges-Kévin N'Koudou,CMR,Tottenham,Premier League,2019,24.0,1995.0,0.0,0,0,0,0,0,0,1,0.0,1,0,0,0,0,0,0,0,FW,20-24,Forward,Cameroon,Africa
1754,Stanley N'Soki,FRA,Nice,Ligue 1,2019,20.0,1999.0,14.1,40,29,24,16,0,23,42,54.8,19,14,6,8,32,72,37,0,DF,20-24,Defender,France,Europe
1757,Radja Nainggolan,BEL,Cagliari,Serie A,2019,31.0,1988.0,23.0,30,18,9,12,9,9,29,31.0,20,25,6,19,13,43,30,0,MF,30-34,Midfielder,Belgium,Europe
1758,Marvelous Nakamba,ZIM,Aston Villa,Premier League,2019,25.0,1994.0,20.4,55,28,28,20,7,24,67,35.8,43,50,11,39,39,94,38,3,MF,25-29,Midfielder,Zimbabwe,Africa
1759,Naldo,BRA,Espanyol,La Liga,2019,30.0,1988.0,14.8,24,13,15,9,0,7,15,46.7,8,11,7,4,21,45,50,1,DF,30-34,Defender,Brazil,South America
1759,Naldo,BRA,Espanyol,La Liga,2019,30.0,1988.0,14.8,24,13,15,9,0,7,15,46.7,8,11,7,4,21,45,50,1,DF,30-34,Defender,Brazil,South America
1759,Naldo,BRA,Espanyol,La Liga,2019,30.0,1988.0,14.8,24,13,15,9,0,7,15,46.7,8,11,7,4,21,45,50,1,DF,30-34,Defender,Brazil,South America
1759,Naldo,BRA,Espanyol,La Liga,2019,30.0,1988.0,14.8,24,13,15,9,0,7,15,46.7,8,11,7,4,21,45,50,1,DF,30-34,Defender,Brazil,South America
1760,Nahitan Nández,URU,Cagliari,Serie A,2019,23.0,1995.0,32.2,58,38,37,17,4,25,69,36.2,44,30,1,29,25,83,26,0,"MF,DF",20-24,Midfielder,Uruguay,South America
1765,Keylor Navas,CRC,Paris S-G,Ligue 1,2019,32.0,1986.0,21.0,0,0,0,0,0,0,0,,0,1,0,1,0,0,4,2,GK,30-34,Goalkeeper,Costa Rica,North America
1767,Michel Ndary Adopo,FRA,Torino,Serie A,2019,19.0,2000.0,0.0,0,0,0,0,0,0,0,,0,1,1,0,0,0,0,0,"DF,MF",Under 20,Defender,France,Europe
1768,Papa Ndiaga Yade,MTN,Metz,Ligue 1,2019,19.0,2000.0,0.0,0,0,0,0,0,0,0,,0,0,0,0,0,0,0,0,FW,Under 20,Forward,Mauritania,Africa
1769,Wilfred Ndidi,NGA,Leicester City,Premier League,2019,22.0,1996.0,29.7,128,67,56,61,11,45,91,49.5,46,52,6,46,80,208,69,3,MF,20-24,Midfielder,Nigeria,Africa
1770,Emanuele Ndoj,ALB,Brescia,Serie A,2019,22.0,1996.0,6.2,9,6,2,6,1,3,13,23.1,10,7,0,7,5,14,5,0,MF,20-24,Midfielder,Albania,Europe
1771,Tanguy Ndombele,FRA,Tottenham,Premier League,2019,22.0,1996.0,11.2,24,16,10,13,1,9,22,40.9,13,20,3,17,14,38,7,0,MF,20-24,Midfielder,France,Europe
1772,Reiss Nelson,ENG,Arsenal,Premier League,2019,19.0,1999.0,7.0,11,8,5,4,2,7,17,41.2,10,13,2,11,3,14,3,0,FW,Under 20,Forward,England,Europe
1773,Ilija Nestorovski,MKD,Udinese,Serie A,2019,29.0,1990.0,13.9,10,7,5,5,0,6,21,28.6,15,13,2,11,4,14,12,0,FW,25-29,Forward,North Macedonia,Europe
1774,Neto,BRA,Barcelona,La Liga,2019,30.0,1989.0,2.0,0,0,0,0,0,0,0,,0,0,0,0,0,0,1,0,GK,30-34,Goalkeeper,Brazil,South America
1774,Neto,BRA,Barcelona,La Liga,2019,30.0,1989.0,2.0,0,0,0,0,0,0,0,,0,0,0,0,0,0,1,0,GK,30-34,Goalkeeper,Brazil,South America
1774,Neto,BRA,Barcelona,La Liga,2019,30.0,1989.0,2.0,0,0,0,0,0,0,0,,0,0,0,0,0,0,1,0,GK,30-34,Goalkeeper,Brazil,South America
1774,Neto,BRA,Barcelona,La Liga,2019,30.0,1989.0,2.0,0,0,0,0,0,0,0,,0,0,0,0,0,0,1,0,GK,30-34,Goalkeeper,Brazil,South America
1774,Neto,BRA,Barcelona,La Liga,2019,30.0,1989.0,2.0,0,0,0,0,0,0,0,,0,0,0,0,0,0,1,0,GK,30-34,Goalkeeper,Brazil,South America
1774,Neto,BRA,Barcelona,La Liga,2019,30.0,1989.0,2.0,0,0,0,0,0,0,0,,0,0,0,0,0,0,1,0,GK,30-34,Goalkeeper,Brazil,South America
1774,Neto,BRA,Barcelona,La Liga,2019,30.0,1989.0,2.0,0,0,0,0,0,0,0,,0,0,0,0,0,0,1,0,GK,30-34,Goalkeeper,Brazil,South America
1774,Neto,BRA,Barcelona,La Liga,2019,30.0,1989.0,2.0,0,0,0,0,0,0,0,,0,0,0,0,0,0,1,0,GK,30-34,Goalkeeper,Brazil,South America
1774,Neto,BRA,Barcelona,La Liga,2019,30.0,1989.0,2.0,0,0,0,0,0,0,0,,0,0,0,0,0,0,1,0,GK,30-34,Goalkeeper,Brazil,South America
1775,Pedro Neto,POR,Wolves,Premier League,2019,19.0,2000.0,10.4,9,4,3,6,0,4,15,26.7,11,2,0,2,6,15,4,0,"FW,MF",Under 20,Forward,Portugal,Europe
1776,Manuel Neuer,GER,Bayern Munich,Bundesliga,2019,33.0,1986.0,33.0,2,1,1,0,1,2,4,50.0,2,0,0,0,0,2,15,4,GK,30-34,Goalkeeper,Germany,Europe
1777,Florian Neuhaus,GER,Gladbach,Bundesliga,2019,22.0,1997.0,26.2,42,23,13,22,7,12,54,22.2,42,24,4,20,27,69,8,0,MF,20-24,Midfielder,Germany,Europe
1779,Rúben Neves,POR,Wolves,Premier League,2019,22.0,1997.0,34.0,62,33,27,32,3,34,86,39.5,52,38,9,29,56,118,34,1,MF,20-24,Midfielder,Portugal,Europe
1780,Neymar,BRA,Paris S-G,Ligue 1,2019,27.0,1992.0,14.6,12,7,1,9,2,3,21,14.3,18,10,0,10,4,16,1,0,"MF,FW",25-29,Midfielder,Brazil,South America
1781,Jeremy Ngakia,ENG,West Ham,Premier League,2019,18.0,2000.0,4.9,15,7,10,5,0,9,21,42.9,12,6,1,5,7,22,16,0,DF,Under 20,Defender,England,Europe
1782,Jessic Ngankam,GER,Hertha BSC,Bundesliga,2019,19.0,2000.0,0.9,2,2,1,1,0,2,2,100.0,0,2,0,2,0,2,1,0,"FW,MF",Under 20,Forward,Germany,Europe
1783,Muzinga Ngonda,COD,Dijon,Ligue 1,2019,24.0,1994.0,6.0,15,6,10,3,2,7,10,70.0,3,5,4,1,11,26,23,0,DF,20-24,Defender,DR Congo,Africa
1784,Ahmad Ngouyamsa,CHA,Dijon,Ligue 1,2019,18.0,2000.0,0.6,1,0,1,0,0,0,3,0.0,3,1,1,0,1,2,5,0,DF,Under 20,Defender,Chad,Africa
1785,Opa Nguette,SEN,Metz,Ligue 1,2019,25.0,1994.0,20.3,44,28,23,15,6,11,39,28.2,28,17,3,14,12,56,12,0,FW,25-29,Forward,Senegal,Africa
1786,Moussa Niakhate,SEN,Mainz 05,Bundesliga,2019,23.0,1996.0,33.0,35,22,29,6,0,16,29,55.2,13,40,26,14,40,75,124,4,DF,20-24,Defender,Senegal,Africa
1787,Ibrahima Niane,SEN,Metz,Ligue 1,2019,20.0,1999.0,10.6,8,7,2,5,1,5,16,31.3,11,5,1,4,10,18,11,1,FW,20-24,Forward,Senegal,Africa
1788,M'Baye Niang,SEN,Rennes,Ligue 1,2019,24.0,1994.0,23.6,17,10,3,11,3,6,21,28.6,15,10,1,9,5,22,20,0,FW,20-24,Forward,Senegal,Africa
1789,Tanguy Nianzou,FRA,Paris S-G,Ligue 1,2019,17.0,2002.0,5.0,2,1,0,1,1,1,3,33.3,2,4,2,2,3,5,6,0,"DF,MF",Under 20,Defender,France,Europe
1790,Cheikh Niasse,SEN,Lille,Ligue 1,2019,19.0,2000.0,0.2,0,0,0,0,0,0,0,,0,0,0,0,0,0,0,0,MF,Under 20,Midfielder,Senegal,Africa
1791,Oumar Niasse,SEN,Everton,Premier League,2019,29.0,1990.0,0.2,4,0,0,2,2,0,0,,0,0,0,0,1,5,0,0,FW,25-29,Forward,Senegal,Africa
1792,Moritz Nicolas,GER,Union Berlin,Bundesliga,2019,21.0,1997.0,1.0,0,0,0,0,0,0,0,,0,0,0,0,0,0,0,0,GK,20-24,Goalkeeper,Germany,Europe
1793,Florian Niederlechner,GER,Augsburg,Bundesliga,2019,28.0,1990.0,30.2,21,13,7,9,5,4,21,19.0,17,21,5,16,8,29,38,0,"FW,MF",25-29,Forward,Germany,Europe
1795,Casimir Ninga,CHA,Angers,Ligue 1,2019,26.0,1993.0,7.6,5,5,4,0,1,1,5,20.0,4,5,0,5,3,8,2,0,"MF,FW",25-29,Midfielder,Chad,Africa
1797,Timothée Nkada,FRA,Reims,Ligue 1,2019,20.0,1999.0,1.6,1,0,1,0,0,0,1,0.0,1,0,0,0,0,1,1,0,FW,20-24,Forward,France,Europe
1798,Eddie Nketiah,ENG,Arsenal,Premier League,2019,20.0,1999.0,7.0,7,5,3,4,0,2,6,33.3,4,9,0,9,2,9,5,0,FW,20-24,Forward,England,Europe
1799,Nicolas Nkoulou,CMR,Torino,Serie A,2019,29.0,1990.0,29.9,34,24,21,11,2,16,22,72.7,6,40,18,22,70,104,138,2,DF,25-29,Defender,Cameroon,Africa
1800,Christopher Nkunku,FRA,RB Leipzig,Bundesliga,2019,21.0,1997.0,21.4,21,13,4,11,6,9,33,27.3,24,25,2,23,20,41,8,0,"MF,FW",20-24,Midfielder,France,Europe
1801,Lukas Nmecha,GER,Wolfsburg,Bundesliga,2019,20.0,1998.0,1.5,0,0,0,0,0,0,0,,0,0,0,0,0,0,0,0,"MF,FW",20-24,Midfielder,Germany,Europe
1802,Mark Noble,ENG,West Ham,Premier League,2019,32.0,1987.0,29.7,52,30,19,28,5,22,64,34.4,42,20,6,14,20,72,10,1,MF,30-34,Midfielder,England,Europe
1805,Arnaud Nordin,FRA,Saint-Étienne,Ligue 1,2019,21.0,1998.0,10.1,7,3,3,3,1,4,13,30.8,9,11,1,10,4,11,6,0,"FW,MF",20-24,Forward,France,Europe
1808,Alexander Nübel,GER,Schalke 04,Bundesliga,2019,22.0,1996.0,25.7,0,0,0,0,0,0,0,,0,0,0,0,2,2,9,6,GK,20-24,Goalkeeper,Germany,Europe
1809,Kasim Nuhu,GHA,Düsseldorf,Bundesliga,2019,24.0,1995.0,11.1,14,7,12,1,1,9,19,47.4,10,16,12,4,25,39,54,0,DF,20-24,Defender,Ghana,Africa
1811,Bram Nuytinck,NED,Udinese,Serie A,2019,29.0,1990.0,24.7,46,32,30,13,3,17,27,63.0,10,50,32,18,27,73,96,1,DF,25-29,Defender,Netherlands,Europe
1812,Gerzino Nyamsi,FRA,Rennes,Ligue 1,2019,22.0,1997.0,1.3,1,0,1,0,0,0,0,,0,1,0,1,1,2,5,0,DF,20-24,Defender,France,Europe
1814,Allan Nyom,CMR,Getafe,La Liga,2019,31.0,1988.0,26.9,45,25,26,15,4,20,37,54.1,17,24,5,19,14,59,50,1,"DF,MF",30-34,Defender,Cameroon,Africa
1815,Steven Nzonzi,FRA,Rennes,Ligue 1,2019,30.0,1988.0,4.3,5,4,3,1,1,1,2,50.0,1,2,2,0,4,9,18,0,MF,30-34,Midfielder,France,Europe
1816,Jack O'Connell,ENG,Sheffield Utd,Premier League,2019,25.0,1994.0,32.4,23,14,15,6,2,10,20,50.0,10,38,17,21,42,65,154,1,DF,25-29,Defender,England,Europe
1817,Michael Obafemi,IRL,Southampton,Premier League,2019,19.0,2000.0,7.4,7,3,1,3,3,2,14,14.3,12,3,0,3,6,13,0,0,FW,Under 20,Forward,Republic of Ireland,Europe
1818,Pedro Obiang,EQG,Sassuolo,Serie A,2019,27.0,1992.0,18.6,46,31,21,19,6,19,40,47.5,21,24,10,14,21,67,31,1,MF,25-29,Midfielder,Equatorial Guinea,Africa
1821,Lucas Ocampos,ARG,Sevilla,La Liga,2019,25.0,1994.0,30.5,54,31,30,19,5,30,72,41.7,42,33,2,31,22,76,27,0,"FW,MF",25-29,Forward,Argentina,South America
1822,Bastian Oczipka,GER,Schalke 04,Bundesliga,2019,30.0,1989.0,33.5,72,50,42,21,9,36,62,58.1,26,35,6,29,37,109,68,0,DF,30-34,Defender,Germany,Europe
1825,Kelvin Ofori,GHA,Düsseldorf,Bundesliga,2019,18.0,2001.0,0.4,0,0,0,0,0,0,0,,0,0,0,0,0,0,0,0,MF,Under 20,Midfielder,Ghana,Africa
1826,Angelo Ogbonna,ITA,West Ham,Premier League,2019,31.0,1988.0,31.0,38,24,20,14,4,18,32,56.3,14,50,32,18,27,65,134,1,DF,30-34,Defender,Italy,Europe
1827,Stefano Okaka,ITA,Udinese,Serie A,2019,29.0,1989.0,26.8,19,11,6,8,5,7,27,25.9,20,23,2,21,8,27,28,0,FW,25-29,Forward,Italy,Europe
1828,Kwasi Okyere Wriedt,GHA,Bayern Munich,Bundesliga,2019,25.0,1994.0,0.2,0,0,0,0,0,0,0,,0,0,0,0,0,0,0,0,FW,25-29,Forward,Ghana,Africa
1829,Lucas Olaza,URU,Celta Vigo,La Liga,2019,25.0,1994.0,34.9,56,39,36,17,3,39,59,66.1,20,37,10,27,31,87,60,1,DF,25-29,Defender,Uruguay,South America
1831,Christian Oliva,URU,Cagliari,Serie A,2019,23.0,1996.0,5.2,13,7,9,4,0,5,15,33.3,10,5,0,5,7,20,14,0,MF,20-24,Midfielder,Uruguay,South America
1833,Paulo Oliveira,POR,Eibar,La Liga,2019,27.0,1992.0,23.2,31,19,22,8,1,18,30,60.0,12,23,13,10,42,73,107,1,DF,25-29,Defender,Portugal,Europe
1834,Cauly Oliveira Souza,BRA,Paderborn 07,Bundesliga,2019,23.0,1995.0,8.0,11,7,5,5,1,3,11,27.3,8,9,0,9,6,17,1,0,"MF,FW",20-24,Midfielder,Brazil,South America
1835,Mathías Olivera,URU,Getafe,La Liga,2019,21.0,1997.0,20.8,64,40,34,16,14,27,45,60.0,18,32,3,29,23,87,44,0,DF,20-24,Defender,Uruguay,South America
1836,Maximiliano Olivera,URU,Fiorentina,Serie A,2019,27.0,1992.0,0.1,1,0,1,0,0,0,0,,0,0,0,0,0,1,0,0,MF,25-29,Midfielder,Uruguay,South America
1837,Marco Olivieri,ITA,Juventus,Serie A,2019,20.0,1999.0,0.3,1,1,1,0,0,1,2,50.0,1,0,0,0,0,1,0,0,FW,20-24,Forward,Italy,Europe
1839,Robin Olsen,SWE,Cagliari,Serie A,2019,29.0,1990.0,16.9,0,0,0,0,0,0,1,0.0,1,0,0,0,0,0,8,0,GK,25-29,Goalkeeper,Sweden,Europe
1840,Kenneth Omeruo,NGA,Leganés,La Liga,2019,25.0,1993.0,20.8,28,17,25,3,0,11,18,61.1,7,21,12,9,36,64,112,2,DF,25-29,Defender,Nigeria,Africa
1841,Jean Onana,CMR,Lille,Ligue 1,2019,19.0,2000.0,0.9,0,0,0,0,0,0,2,0.0,2,1,0,1,1,1,0,0,MF,Under 20,Midfielder,Cameroon,Africa
1842,Karim Onisiwo,AUT,Mainz 05,Bundesliga,2019,27.0,1992.0,19.2,27,19,6,10,11,5,13,38.5,8,20,3,17,7,34,11,0,FW,25-29,Forward,Austria,Europe
1844,Henry Onyekuru,NGA,Monaco,Ligue 1,2019,22.0,1997.0,1.8,1,1,1,0,0,0,0,,0,1,0,1,1,2,0,0,"MF,FW",20-24,Midfielder,Nigeria,Africa
1845,Nicholas Opoku,GHA,Udinese,Serie A,2019,21.0,1997.0,5.3,13,8,8,3,2,6,11,54.5,5,6,4,2,4,17,19,0,DF,20-24,Defender,Ghana,Africa
1846,Nicholas Opoku,GHA,Amiens,Ligue 1,2019,21.0,1997.0,7.0,7,5,6,1,0,7,14,50.0,7,6,2,4,7,14,32,0,DF,20-24,Defender,Ghana,Africa
1847,Willi Orban,HUN,RB Leipzig,Bundesliga,2019,26.0,1992.0,9.5,20,12,13,7,0,12,20,60.0,8,14,3,11,16,36,52,1,DF,25-29,Defender,Hungary,Europe
1848,Fabián Orellana,CHI,Eibar,La Liga,2019,33.0,1986.0,26.6,29,18,10,6,13,14,52,26.9,38,9,0,9,20,49,2,0,"MF,FW",30-34,Midfielder,Chile,South America
1849,Divock Origi,BEL,Liverpool,Premier League,2019,24.0,1995.0,8.0,12,9,2,5,5,4,9,44.4,5,2,0,2,4,16,5,0,FW,20-24,Forward,Belgium,Europe
1851,Riccardo Orsolini,ITA,Bologna,Serie A,2019,22.0,1997.0,29.8,36,22,21,10,5,12,47,25.5,35,23,1,22,16,52,20,0,"FW,MF",20-24,Forward,Italy,Europe
1852,Yuya Osako,JPN,Werder Bremen,Bundesliga,2019,29.0,1990.0,20.5,29,16,5,19,5,3,29,10.3,26,10,1,9,6,35,13,1,"FW,MF",25-29,Forward,Japan,Asia
1853,Ben Osborn,ENG,Sheffield Utd,Premier League,2019,24.0,1994.0,6.6,15,10,11,3,1,3,16,18.8,13,6,1,5,6,21,7,0,"MF,DF",20-24,Midfielder,England,Europe
1854,Victor Osimhen,NGA,Lille,Ligue 1,2019,20.0,1998.0,25.4,8,4,1,0,7,1,11,9.1,10,8,0,8,11,19,32,0,FW,20-24,Forward,Nigeria,Africa
1855,David Ospina,COL,Napoli,Serie A,2019,30.0,1988.0,16.3,0,0,0,0,0,0,0,,0,0,0,0,0,0,2,1,GK,30-34,Goalkeeper,Colombia,South America
1856,Nicolás Otamendi,ARG,Manchester City,Premier League,2019,31.0,1988.0,19.1,28,14,21,6,1,16,33,48.5,17,15,9,6,21,49,76,2,DF,30-34,Defender,Argentina,South America
1857,Otávio,BRA,Bordeaux,Ligue 1,2019,25.0,1994.0,24.6,80,45,23,52,5,35,82,42.7,47,26,9,17,41,121,40,6,MF,25-29,Midfielder,Brazil,South America
1857,Otávio,BRA,Bordeaux,Ligue 1,2019,25.0,1994.0,24.6,80,45,23,52,5,35,82,42.7,47,26,9,17,41,121,40,6,MF,25-29,Midfielder,Brazil,South America
1857,Otávio,BRA,Bordeaux,Ligue 1,2019,25.0,1994.0,24.6,80,45,23,52,5,35,82,42.7,47,26,9,17,41,121,40,6,MF,25-29,Midfielder,Brazil,South America
1857,Otávio,BRA,Bordeaux,Ligue 1,2019,25.0,1994.0,24.6,80,45,23,52,5,35,82,42.7,47,26,9,17,41,121,40,6,MF,25-29,Midfielder,Brazil,South America
1857,Otávio,BRA,Bordeaux,Ligue 1,2019,25.0,1994.0,24.6,80,45,23,52,5,35,82,42.7,47,26,9,17,41,121,40,6,MF,25-29,Midfielder,Brazil,South America
1857,Otávio,BRA,Bordeaux,Ligue 1,2019,25.0,1994.0,24.6,80,45,23,52,5,35,82,42.7,47,26,9,17,41,121,40,6,MF,25-29,Midfielder,Brazil,South America
1857,Otávio,BRA,Bordeaux,Ligue 1,2019,25.0,1994.0,24.6,80,45,23,52,5,35,82,42.7,47,26,9,17,41,121,40,6,MF,25-29,Midfielder,Brazil,South America
1857,Otávio,BRA,Bordeaux,Ligue 1,2019,25.0,1994.0,24.6,80,45,23,52,5,35,82,42.7,47,26,9,17,41,121,40,6,MF,25-29,Midfielder,Brazil,South America
1857,Otávio,BRA,Bordeaux,Ligue 1,2019,25.0,1994.0,24.6,80,45,23,52,5,35,82,42.7,47,26,9,17,41,121,40,6,MF,25-29,Midfielder,Brazil,South America
1858,Paulo Otávio,BRA,Wolfsburg,Bundesliga,2019,24.0,1994.0,4.2,21,16,11,9,1,10,13,76.9,3,12,2,10,9,30,11,0,DF,20-24,Defender,Brazil,South America
1859,Abou Ouattara,BFA,Lille,Ligue 1,2019,19.0,1999.0,0.1,0,0,0,0,0,0,0,,0,0,0,0,0,0,1,0,FW,Under 20,Forward,Burkina Faso,Africa
1860,Remi Oudin,FRA,Bordeaux,Ligue 1,2019,22.0,1996.0,6.2,9,6,4,4,1,4,14,28.6,10,7,1,6,9,18,5,0,"FW,MF",20-24,Forward,France,Europe
1861,Remi Oudin,FRA,Reims,Ligue 1,2019,22.0,1996.0,15.5,15,7,8,5,2,6,19,31.6,13,16,1,15,18,33,18,1,"FW,MF",20-24,Forward,France,Europe
1862,Alexandre Oukidja,ALG,Metz,Ligue 1,2019,31.0,1988.0,26.5,0,0,0,0,0,0,1,0.0,1,1,0,1,0,0,15,1,GK,30-34,Goalkeeper,Algeria,Africa
1863,Zinédine Ould Khaled,FRA,Angers,Ligue 1,2019,19.0,2000.0,0.7,2,1,0,2,0,2,4,50.0,2,0,0,0,4,6,0,0,MF,Under 20,Midfielder,France,Europe
1864,Adam Ounas,ALG,Nice,Ligue 1,2019,22.0,1996.0,12.5,10,5,2,6,2,5,13,38.5,8,9,1,8,11,21,8,1,"FW,MF",20-24,Forward,Algeria,Africa
1865,Reece Oxford,ENG,Augsburg,Bundesliga,2019,20.0,1998.0,4.2,7,4,2,4,1,2,8,25.0,6,8,5,3,5,12,10,1,MF,20-24,Midfielder,England,Europe
1866,Alex Oxlade-Chamberlain,ENG,Liverpool,Premier League,2019,25.0,1993.0,16.5,18,9,4,6,8,5,21,23.8,16,26,1,25,22,40,10,0,"MF,FW",25-29,Midfielder,England,Europe
1868,Ambroise Oyongo,CMR,Montpellier,Ligue 1,2019,28.0,1991.0,20.2,25,10,16,6,3,16,28,57.1,12,8,0,8,17,42,35,0,"DF,FW",25-29,Defender,Cameroon,Africa
1869,Mesut Özil,GER,Arsenal,Premier League,2019,30.0,1988.0,16.0,17,8,9,7,1,4,23,17.4,19,4,0,4,5,22,1,0,MF,30-34,Midfielder,Germany,Europe
1870,Levin Öztunalı,GER,Mainz 05,Bundesliga,2019,23.0,1996.0,19.8,28,19,13,12,3,12,35,34.3,23,27,1,26,9,37,14,2,"MF,FW",20-24,Midfielder,Germany,Europe
1871,Pablo,BRA,Bordeaux,Ligue 1,2019,28.0,1991.0,24.1,27,15,22,5,0,16,31,51.6,15,25,14,11,40,67,130,2,DF,25-29,Defender,Brazil,South America
1871,Pablo,BRA,Bordeaux,Ligue 1,2019,28.0,1991.0,24.1,27,15,22,5,0,16,31,51.6,15,25,14,11,40,67,130,2,DF,25-29,Defender,Brazil,South America
1871,Pablo,BRA,Bordeaux,Ligue 1,2019,28.0,1991.0,24.1,27,15,22,5,0,16,31,51.6,15,25,14,11,40,67,130,2,DF,25-29,Defender,Brazil,South America
1871,Pablo,BRA,Bordeaux,Ligue 1,2019,28.0,1991.0,24.1,27,15,22,5,0,16,31,51.6,15,25,14,11,40,67,130,2,DF,25-29,Defender,Brazil,South America
1871,Pablo,BRA,Bordeaux,Ligue 1,2019,28.0,1991.0,24.1,27,15,22,5,0,16,31,51.6,15,25,14,11,40,67,130,2,DF,25-29,Defender,Brazil,South America
1871,Pablo,BRA,Bordeaux,Ligue 1,2019,28.0,1991.0,24.1,27,15,22,5,0,16,31,51.6,15,25,14,11,40,67,130,2,DF,25-29,Defender,Brazil,South America
1871,Pablo,BRA,Bordeaux,Ligue 1,2019,28.0,1991.0,24.1,27,15,22,5,0,16,31,51.6,15,25,14,11,40,67,130,2,DF,25-29,Defender,Brazil,South America
1871,Pablo,BRA,Bordeaux,Ligue 1,2019,28.0,1991.0,24.1,27,15,22,5,0,16,31,51.6,15,25,14,11,40,67,130,2,DF,25-29,Defender,Brazil,South America
1871,Pablo,BRA,Bordeaux,Ligue 1,2019,28.0,1991.0,24.1,27,15,22,5,0,16,31,51.6,15,25,14,11,40,67,130,2,DF,25-29,Defender,Brazil,South America
1874,Gonçalo Paciência,POR,Eint Frankfurt,Bundesliga,2019,24.0,1994.0,14.3,9,5,1,4,4,3,13,23.1,10,9,1,8,1,10,11,0,FW,20-24,Forward,Portugal,Europe
1875,Daniele Padelli,ITA,Inter,Serie A,2019,33.0,1985.0,3.0,0,0,0,0,0,0,0,,0,0,0,0,0,0,1,1,GK,30-34,Goalkeeper,Italy,Europe
1876,Marko Pajač,CRO,Genoa,Serie A,2019,26.0,1993.0,8.4,8,4,4,3,1,7,16,43.8,9,6,0,6,8,16,9,0,"DF,FW",25-29,Defender,Croatia,Europe
1877,Vincent Pajot,FRA,Angers,Ligue 1,2019,28.0,1990.0,1.3,2,2,1,1,0,1,1,100.0,0,3,0,3,5,7,0,0,MF,25-29,Midfielder,France,Europe
1878,Vincent Pajot,FRA,Metz,Ligue 1,2019,28.0,1990.0,5.8,16,11,8,7,1,2,4,50.0,2,5,1,4,9,25,13,0,MF,25-29,Midfielder,France,Europe
1879,Rodrigo Palacio,ARG,Bologna,Serie A,2019,37.0,1982.0,28.0,19,11,0,9,10,4,27,14.8,23,17,3,14,5,24,38,2,FW,35-39,Forward,Argentina,South America
1880,Exequiel Palacios,ARG,Leverkusen,Bundesliga,2019,20.0,1998.0,2.0,8,7,4,4,0,2,5,40.0,3,2,0,2,1,9,0,0,MF,20-24,Midfielder,Argentina,South America
1882,Nicolas Pallois,FRA,Nantes,Ligue 1,2019,31.0,1987.0,21.0,47,36,28,17,2,31,55,56.4,24,18,13,5,40,87,77,1,DF,30-34,Defender,France,Europe
1883,Emerson Palmieri,ITA,Chelsea,Premier League,2019,24.0,1994.0,11.4,23,12,8,11,4,10,15,66.7,5,13,1,12,18,41,19,0,DF,20-24,Defender,Italy,Europe
1884,Alberto Paloschi,ITA,SPAL,Serie A,2019,29.0,1990.0,4.9,3,0,3,0,0,2,8,25.0,6,3,0,3,0,3,2,0,FW,25-29,Forward,Italy,Europe
1885,Alberto Paloschi,ITA,Cagliari,Serie A,2019,29.0,1990.0,2.3,0,0,0,0,0,0,1,0.0,1,1,0,1,1,1,3,0,"FW,MF",25-29,Forward,Italy,Europe
1887,Goran Pandev,MKD,Genoa,Serie A,2019,36.0,1983.0,18.7,12,8,2,7,3,3,25,12.0,22,4,1,3,0,12,5,1,"FW,MF",35-39,Forward,North Macedonia,Europe
1888,Jonathan Panzo,ENG,Monaco,Ligue 1,2019,18.0,2000.0,1.2,2,2,2,0,0,1,1,100.0,0,3,1,2,3,5,7,0,DF,Under 20,Defender,England,Europe
1889,Sokratis Papastathopoulos,GRE,Arsenal,Premier League,2019,31.0,1988.0,18.8,25,16,17,7,1,10,21,47.6,11,30,24,6,17,42,68,1,DF,30-34,Defender,Greece,Europe
1890,Andrea Papetti,ITA,Brescia,Serie A,2019,17.0,2002.0,10.2,9,7,8,1,0,4,14,28.6,10,15,11,4,15,24,39,0,DF,Under 20,Defender,Italy,Europe
1891,Lucas Paquetá,BRA,Milan,Serie A,2019,21.0,1997.0,12.3,33,19,12,17,4,14,37,37.8,23,17,2,15,8,41,9,0,"MF,FW",20-24,Midfielder,Brazil,South America
1892,Gaëtan Paquiez,FRA,Nîmes,Ligue 1,2019,25.0,1994.0,17.0,36,25,14,13,9,17,47,36.2,30,18,5,13,33,69,43,0,DF,25-29,Defender,France,Europe
1894,Leandro Paredes,ARG,Paris S-G,Ligue 1,2019,25.0,1994.0,9.0,22,14,7,14,1,13,29,44.8,16,7,1,6,15,37,7,0,MF,25-29,Midfielder,Argentina,South America
1896,Michael Parensen,GER,Union Berlin,Bundesliga,2019,33.0,1986.0,7.0,11,6,5,6,0,5,10,50.0,5,14,8,6,12,23,17,0,DF,30-34,Defender,Germany,Europe
1898,Marco Parolo,ITA,Lazio,Serie A,2019,34.0,1985.0,18.9,54,26,19,27,8,18,46,39.1,28,44,15,29,26,80,49,0,MF,30-34,Midfielder,Italy,Europe
1899,Troy Parrott,IRL,Tottenham,Premier League,2019,17.0,2002.0,0.1,0,0,0,0,0,0,0,,0,0,0,0,0,0,0,0,FW,Under 20,Forward,Republic of Ireland,Europe
1900,Thomas Partey,GHA,Atlético Madrid,La Liga,2019,26.0,1993.0,28.3,70,41,34,30,6,26,58,44.8,32,32,8,24,48,118,41,7,MF,25-29,Midfielder,Ghana,Africa
1901,Mario Pašalić,CRO,Atalanta,Serie A,2019,24.0,1995.0,26.9,47,21,17,18,12,16,52,30.8,36,27,7,20,27,74,22,2,MF,20-24,Midfielder,Croatia,Europe
1902,Javier Pastore,ARG,Roma,Serie A,2019,30.0,1989.0,5.7,14,10,3,5,6,5,12,41.7,7,4,0,4,5,19,5,0,MF,30-34,Midfielder,Argentina,South America
1904,Rui Patrício,POR,Wolves,Premier League,2019,31.0,1988.0,38.0,0,0,0,0,0,0,2,0.0,2,2,0,2,2,2,5,2,GK,30-34,Goalkeeper,Portugal,Europe
1905,Paulinho,BRA,Leverkusen,Bundesliga,2019,19.0,2000.0,3.4,4,3,3,1,0,1,2,50.0,1,5,1,4,1,5,0,0,"MF,FW",Under 20,Midfielder,Brazil,South America
1905,Paulinho,BRA,Leverkusen,Bundesliga,2019,19.0,2000.0,3.4,4,3,3,1,0,1,2,50.0,1,5,1,4,1,5,0,0,"MF,FW",Under 20,Midfielder,Brazil,South America
1905,Paulinho,BRA,Leverkusen,Bundesliga,2019,19.0,2000.0,3.4,4,3,3,1,0,1,2,50.0,1,5,1,4,1,5,0,0,"MF,FW",Under 20,Midfielder,Brazil,South America
1905,Paulinho,BRA,Leverkusen,Bundesliga,2019,19.0,2000.0,3.4,4,3,3,1,0,1,2,50.0,1,5,1,4,1,5,0,0,"MF,FW",Under 20,Midfielder,Brazil,South America
1905,Paulinho,BRA,Leverkusen,Bundesliga,2019,19.0,2000.0,3.4,4,3,3,1,0,1,2,50.0,1,5,1,4,1,5,0,0,"MF,FW",Under 20,Midfielder,Brazil,South America
1905,Paulinho,BRA,Leverkusen,Bundesliga,2019,19.0,2000.0,3.4,4,3,3,1,0,1,2,50.0,1,5,1,4,1,5,0,0,"MF,FW",Under 20,Midfielder,Brazil,South America
1905,Paulinho,BRA,Leverkusen,Bundesliga,2019,19.0,2000.0,3.4,4,3,3,1,0,1,2,50.0,1,5,1,4,1,5,0,0,"MF,FW",Under 20,Midfielder,Brazil,South America
1905,Paulinho,BRA,Leverkusen,Bundesliga,2019,19.0,2000.0,3.4,4,3,3,1,0,1,2,50.0,1,5,1,4,1,5,0,0,"MF,FW",Under 20,Midfielder,Brazil,South America
1905,Paulinho,BRA,Leverkusen,Bundesliga,2019,19.0,2000.0,3.4,4,3,3,1,0,1,2,50.0,1,5,1,4,1,5,0,0,"MF,FW",Under 20,Midfielder,Brazil,South America
1905,Paulinho,BRA,Leverkusen,Bundesliga,2019,19.0,2000.0,3.4,4,3,3,1,0,1,2,50.0,1,5,1,4,1,5,0,0,"MF,FW",Under 20,Midfielder,Brazil,South America
1905,Paulinho,BRA,Leverkusen,Bundesliga,2019,19.0,2000.0,3.4,4,3,3,1,0,1,2,50.0,1,5,1,4,1,5,0,0,"MF,FW",Under 20,Midfielder,Brazil,South America
1905,Paulinho,BRA,Leverkusen,Bundesliga,2019,19.0,2000.0,3.4,4,3,3,1,0,1,2,50.0,1,5,1,4,1,5,0,0,"MF,FW",Under 20,Midfielder,Brazil,South America
1905,Paulinho,BRA,Leverkusen,Bundesliga,2019,19.0,2000.0,3.4,4,3,3,1,0,1,2,50.0,1,5,1,4,1,5,0,0,"MF,FW",Under 20,Midfielder,Brazil,South America
1905,Paulinho,BRA,Leverkusen,Bundesliga,2019,19.0,2000.0,3.4,4,3,3,1,0,1,2,50.0,1,5,1,4,1,5,0,0,"MF,FW",Under 20,Midfielder,Brazil,South America
1905,Paulinho,BRA,Leverkusen,Bundesliga,2019,19.0,2000.0,3.4,4,3,3,1,0,1,2,50.0,1,5,1,4,1,5,0,0,"MF,FW",Under 20,Midfielder,Brazil,South America
1905,Paulinho,BRA,Leverkusen,Bundesliga,2019,19.0,2000.0,3.4,4,3,3,1,0,1,2,50.0,1,5,1,4,1,5,0,0,"MF,FW",Under 20,Midfielder,Brazil,South America
1905,Paulinho,BRA,Leverkusen,Bundesliga,2019,19.0,2000.0,3.4,4,3,3,1,0,1,2,50.0,1,5,1,4,1,5,0,0,"MF,FW",Under 20,Midfielder,Brazil,South America
1905,Paulinho,BRA,Leverkusen,Bundesliga,2019,19.0,2000.0,3.4,4,3,3,1,0,1,2,50.0,1,5,1,4,1,5,0,0,"MF,FW",Under 20,Midfielder,Brazil,South America
1905,Paulinho,BRA,Leverkusen,Bundesliga,2019,19.0,2000.0,3.4,4,3,3,1,0,1,2,50.0,1,5,1,4,1,5,0,0,"MF,FW",Under 20,Midfielder,Brazil,South America
1905,Paulinho,BRA,Leverkusen,Bundesliga,2019,19.0,2000.0,3.4,4,3,3,1,0,1,2,50.0,1,5,1,4,1,5,0,0,"MF,FW",Under 20,Midfielder,Brazil,South America
1905,Paulinho,BRA,Leverkusen,Bundesliga,2019,19.0,2000.0,3.4,4,3,3,1,0,1,2,50.0,1,5,1,4,1,5,0,0,"MF,FW",Under 20,Midfielder,Brazil,South America
1905,Paulinho,BRA,Leverkusen,Bundesliga,2019,19.0,2000.0,3.4,4,3,3,1,0,1,2,50.0,1,5,1,4,1,5,0,0,"MF,FW",Under 20,Midfielder,Brazil,South America
1905,Paulinho,BRA,Leverkusen,Bundesliga,2019,19.0,2000.0,3.4,4,3,3,1,0,1,2,50.0,1,5,1,4,1,5,0,0,"MF,FW",Under 20,Midfielder,Brazil,South America
1905,Paulinho,BRA,Leverkusen,Bundesliga,2019,19.0,2000.0,3.4,4,3,3,1,0,1,2,50.0,1,5,1,4,1,5,0,0,"MF,FW",Under 20,Midfielder,Brazil,South America
1905,Paulinho,BRA,Leverkusen,Bundesliga,2019,19.0,2000.0,3.4,4,3,3,1,0,1,2,50.0,1,5,1,4,1,5,0,0,"MF,FW",Under 20,Midfielder,Brazil,South America
1905,Paulinho,BRA,Leverkusen,Bundesliga,2019,19.0,2000.0,3.4,4,3,3,1,0,1,2,50.0,1,5,1,4,1,5,0,0,"MF,FW",Under 20,Midfielder,Brazil,South America
1905,Paulinho,BRA,Leverkusen,Bundesliga,2019,19.0,2000.0,3.4,4,3,3,1,0,1,2,50.0,1,5,1,4,1,5,0,0,"MF,FW",Under 20,Midfielder,Brazil,South America
1905,Paulinho,BRA,Leverkusen,Bundesliga,2019,19.0,2000.0,3.4,4,3,3,1,0,1,2,50.0,1,5,1,4,1,5,0,0,"MF,FW",Under 20,Midfielder,Brazil,South America
1905,Paulinho,BRA,Leverkusen,Bundesliga,2019,19.0,2000.0,3.4,4,3,3,1,0,1,2,50.0,1,5,1,4,1,5,0,0,"MF,FW",Under 20,Midfielder,Brazil,South America
1905,Paulinho,BRA,Leverkusen,Bundesliga,2019,19.0,2000.0,3.4,4,3,3,1,0,1,2,50.0,1,5,1,4,1,5,0,0,"MF,FW",Under 20,Midfielder,Brazil,South America
1905,Paulinho,BRA,Leverkusen,Bundesliga,2019,19.0,2000.0,3.4,4,3,3,1,0,1,2,50.0,1,5,1,4,1,5,0,0,"MF,FW",Under 20,Midfielder,Brazil,South America
1905,Paulinho,BRA,Leverkusen,Bundesliga,2019,19.0,2000.0,3.4,4,3,3,1,0,1,2,50.0,1,5,1,4,1,5,0,0,"MF,FW",Under 20,Midfielder,Brazil,South America
1905,Paulinho,BRA,Leverkusen,Bundesliga,2019,19.0,2000.0,3.4,4,3,3,1,0,1,2,50.0,1,5,1,4,1,5,0,0,"MF,FW",Under 20,Midfielder,Brazil,South America
1905,Paulinho,BRA,Leverkusen,Bundesliga,2019,19.0,2000.0,3.4,4,3,3,1,0,1,2,50.0,1,5,1,4,1,5,0,0,"MF,FW",Under 20,Midfielder,Brazil,South America
1905,Paulinho,BRA,Leverkusen,Bundesliga,2019,19.0,2000.0,3.4,4,3,3,1,0,1,2,50.0,1,5,1,4,1,5,0,0,"MF,FW",Under 20,Midfielder,Brazil,South America
1905,Paulinho,BRA,Leverkusen,Bundesliga,2019,19.0,2000.0,3.4,4,3,3,1,0,1,2,50.0,1,5,1,4,1,5,0,0,"MF,FW",Under 20,Midfielder,Brazil,South America
1905,Paulinho,BRA,Leverkusen,Bundesliga,2019,19.0,2000.0,3.4,4,3,3,1,0,1,2,50.0,1,5,1,4,1,5,0,0,"MF,FW",Under 20,Midfielder,Brazil,South America
1905,Paulinho,BRA,Leverkusen,Bundesliga,2019,19.0,2000.0,3.4,4,3,3,1,0,1,2,50.0,1,5,1,4,1,5,0,0,"MF,FW",Under 20,Midfielder,Brazil,South America
1905,Paulinho,BRA,Leverkusen,Bundesliga,2019,19.0,2000.0,3.4,4,3,3,1,0,1,2,50.0,1,5,1,4,1,5,0,0,"MF,FW",Under 20,Midfielder,Brazil,South America
1905,Paulinho,BRA,Leverkusen,Bundesliga,2019,19.0,2000.0,3.4,4,3,3,1,0,1,2,50.0,1,5,1,4,1,5,0,0,"MF,FW",Under 20,Midfielder,Brazil,South America
1905,Paulinho,BRA,Leverkusen,Bundesliga,2019,19.0,2000.0,3.4,4,3,3,1,0,1,2,50.0,1,5,1,4,1,5,0,0,"MF,FW",Under 20,Midfielder,Brazil,South America
1905,Paulinho,BRA,Leverkusen,Bundesliga,2019,19.0,2000.0,3.4,4,3,3,1,0,1,2,50.0,1,5,1,4,1,5,0,0,"MF,FW",Under 20,Midfielder,Brazil,South America
1905,Paulinho,BRA,Leverkusen,Bundesliga,2019,19.0,2000.0,3.4,4,3,3,1,0,1,2,50.0,1,5,1,4,1,5,0,0,"MF,FW",Under 20,Midfielder,Brazil,South America
1905,Paulinho,BRA,Leverkusen,Bundesliga,2019,19.0,2000.0,3.4,4,3,3,1,0,1,2,50.0,1,5,1,4,1,5,0,0,"MF,FW",Under 20,Midfielder,Brazil,South America
1905,Paulinho,BRA,Leverkusen,Bundesliga,2019,19.0,2000.0,3.4,4,3,3,1,0,1,2,50.0,1,5,1,4,1,5,0,0,"MF,FW",Under 20,Midfielder,Brazil,South America
1905,Paulinho,BRA,Leverkusen,Bundesliga,2019,19.0,2000.0,3.4,4,3,3,1,0,1,2,50.0,1,5,1,4,1,5,0,0,"MF,FW",Under 20,Midfielder,Brazil,South America
1905,Paulinho,BRA,Leverkusen,Bundesliga,2019,19.0,2000.0,3.4,4,3,3,1,0,1,2,50.0,1,5,1,4,1,5,0,0,"MF,FW",Under 20,Midfielder,Brazil,South America
1905,Paulinho,BRA,Leverkusen,Bundesliga,2019,19.0,2000.0,3.4,4,3,3,1,0,1,2,50.0,1,5,1,4,1,5,0,0,"MF,FW",Under 20,Midfielder,Brazil,South America
1905,Paulinho,BRA,Leverkusen,Bundesliga,2019,19.0,2000.0,3.4,4,3,3,1,0,1,2,50.0,1,5,1,4,1,5,0,0,"MF,FW",Under 20,Midfielder,Brazil,South America
1905,Paulinho,BRA,Leverkusen,Bundesliga,2019,19.0,2000.0,3.4,4,3,3,1,0,1,2,50.0,1,5,1,4,1,5,0,0,"MF,FW",Under 20,Midfielder,Brazil,South America
1905,Paulinho,BRA,Leverkusen,Bundesliga,2019,19.0,2000.0,3.4,4,3,3,1,0,1,2,50.0,1,5,1,4,1,5,0,0,"MF,FW",Under 20,Midfielder,Brazil,South America
1905,Paulinho,BRA,Leverkusen,Bundesliga,2019,19.0,2000.0,3.4,4,3,3,1,0,1,2,50.0,1,5,1,4,1,5,0,0,"MF,FW",Under 20,Midfielder,Brazil,South America
1905,Paulinho,BRA,Leverkusen,Bundesliga,2019,19.0,2000.0,3.4,4,3,3,1,0,1,2,50.0,1,5,1,4,1,5,0,0,"MF,FW",Under 20,Midfielder,Brazil,South America
1905,Paulinho,BRA,Leverkusen,Bundesliga,2019,19.0,2000.0,3.4,4,3,3,1,0,1,2,50.0,1,5,1,4,1,5,0,0,"MF,FW",Under 20,Midfielder,Brazil,South America
1905,Paulinho,BRA,Leverkusen,Bundesliga,2019,19.0,2000.0,3.4,4,3,3,1,0,1,2,50.0,1,5,1,4,1,5,0,0,"MF,FW",Under 20,Midfielder,Brazil,South America
1905,Paulinho,BRA,Leverkusen,Bundesliga,2019,19.0,2000.0,3.4,4,3,3,1,0,1,2,50.0,1,5,1,4,1,5,0,0,"MF,FW",Under 20,Midfielder,Brazil,South America
1905,Paulinho,BRA,Leverkusen,Bundesliga,2019,19.0,2000.0,3.4,4,3,3,1,0,1,2,50.0,1,5,1,4,1,5,0,0,"MF,FW",Under 20,Midfielder,Brazil,South America
1905,Paulinho,BRA,Leverkusen,Bundesliga,2019,19.0,2000.0,3.4,4,3,3,1,0,1,2,50.0,1,5,1,4,1,5,0,0,"MF,FW",Under 20,Midfielder,Brazil,South America
1905,Paulinho,BRA,Leverkusen,Bundesliga,2019,19.0,2000.0,3.4,4,3,3,1,0,1,2,50.0,1,5,1,4,1,5,0,0,"MF,FW",Under 20,Midfielder,Brazil,South America
1905,Paulinho,BRA,Leverkusen,Bundesliga,2019,19.0,2000.0,3.4,4,3,3,1,0,1,2,50.0,1,5,1,4,1,5,0,0,"MF,FW",Under 20,Midfielder,Brazil,South America
1905,Paulinho,BRA,Leverkusen,Bundesliga,2019,19.0,2000.0,3.4,4,3,3,1,0,1,2,50.0,1,5,1,4,1,5,0,0,"MF,FW",Under 20,Midfielder,Brazil,South America
1905,Paulinho,BRA,Leverkusen,Bundesliga,2019,19.0,2000.0,3.4,4,3,3,1,0,1,2,50.0,1,5,1,4,1,5,0,0,"MF,FW",Under 20,Midfielder,Brazil,South America
1905,Paulinho,BRA,Leverkusen,Bundesliga,2019,19.0,2000.0,3.4,4,3,3,1,0,1,2,50.0,1,5,1,4,1,5,0,0,"MF,FW",Under 20,Midfielder,Brazil,South America
1905,Paulinho,BRA,Leverkusen,Bundesliga,2019,19.0,2000.0,3.4,4,3,3,1,0,1,2,50.0,1,5,1,4,1,5,0,0,"MF,FW",Under 20,Midfielder,Brazil,South America
1905,Paulinho,BRA,Leverkusen,Bundesliga,2019,19.0,2000.0,3.4,4,3,3,1,0,1,2,50.0,1,5,1,4,1,5,0,0,"MF,FW",Under 20,Midfielder,Brazil,South America
1905,Paulinho,BRA,Leverkusen,Bundesliga,2019,19.0,2000.0,3.4,4,3,3,1,0,1,2,50.0,1,5,1,4,1,5,0,0,"MF,FW",Under 20,Midfielder,Brazil,South America
1905,Paulinho,BRA,Leverkusen,Bundesliga,2019,19.0,2000.0,3.4,4,3,3,1,0,1,2,50.0,1,5,1,4,1,5,0,0,"MF,FW",Under 20,Midfielder,Brazil,South America
1905,Paulinho,BRA,Leverkusen,Bundesliga,2019,19.0,2000.0,3.4,4,3,3,1,0,1,2,50.0,1,5,1,4,1,5,0,0,"MF,FW",Under 20,Midfielder,Brazil,South America
1905,Paulinho,BRA,Leverkusen,Bundesliga,2019,19.0,2000.0,3.4,4,3,3,1,0,1,2,50.0,1,5,1,4,1,5,0,0,"MF,FW",Under 20,Midfielder,Brazil,South America
1905,Paulinho,BRA,Leverkusen,Bundesliga,2019,19.0,2000.0,3.4,4,3,3,1,0,1,2,50.0,1,5,1,4,1,5,0,0,"MF,FW",Under 20,Midfielder,Brazil,South America
1905,Paulinho,BRA,Leverkusen,Bundesliga,2019,19.0,2000.0,3.4,4,3,3,1,0,1,2,50.0,1,5,1,4,1,5,0,0,"MF,FW",Under 20,Midfielder,Brazil,South America
1905,Paulinho,BRA,Leverkusen,Bundesliga,2019,19.0,2000.0,3.4,4,3,3,1,0,1,2,50.0,1,5,1,4,1,5,0,0,"MF,FW",Under 20,Midfielder,Brazil,South America
1905,Paulinho,BRA,Leverkusen,Bundesliga,2019,19.0,2000.0,3.4,4,3,3,1,0,1,2,50.0,1,5,1,4,1,5,0,0,"MF,FW",Under 20,Midfielder,Brazil,South America
1905,Paulinho,BRA,Leverkusen,Bundesliga,2019,19.0,2000.0,3.4,4,3,3,1,0,1,2,50.0,1,5,1,4,1,5,0,0,"MF,FW",Under 20,Midfielder,Brazil,South America
1905,Paulinho,BRA,Leverkusen,Bundesliga,2019,19.0,2000.0,3.4,4,3,3,1,0,1,2,50.0,1,5,1,4,1,5,0,0,"MF,FW",Under 20,Midfielder,Brazil,South America
1905,Paulinho,BRA,Leverkusen,Bundesliga,2019,19.0,2000.0,3.4,4,3,3,1,0,1,2,50.0,1,5,1,4,1,5,0,0,"MF,FW",Under 20,Midfielder,Brazil,South America
1905,Paulinho,BRA,Leverkusen,Bundesliga,2019,19.0,2000.0,3.4,4,3,3,1,0,1,2,50.0,1,5,1,4,1,5,0,0,"MF,FW",Under 20,Midfielder,Brazil,South America
1905,Paulinho,BRA,Leverkusen,Bundesliga,2019,19.0,2000.0,3.4,4,3,3,1,0,1,2,50.0,1,5,1,4,1,5,0,0,"MF,FW",Under 20,Midfielder,Brazil,South America
1905,Paulinho,BRA,Leverkusen,Bundesliga,2019,19.0,2000.0,3.4,4,3,3,1,0,1,2,50.0,1,5,1,4,1,5,0,0,"MF,FW",Under 20,Midfielder,Brazil,South America
1905,Paulinho,BRA,Leverkusen,Bundesliga,2019,19.0,2000.0,3.4,4,3,3,1,0,1,2,50.0,1,5,1,4,1,5,0,0,"MF,FW",Under 20,Midfielder,Brazil,South America
1905,Paulinho,BRA,Leverkusen,Bundesliga,2019,19.0,2000.0,3.4,4,3,3,1,0,1,2,50.0,1,5,1,4,1,5,0,0,"MF,FW",Under 20,Midfielder,Brazil,South America
1905,Paulinho,BRA,Leverkusen,Bundesliga,2019,19.0,2000.0,3.4,4,3,3,1,0,1,2,50.0,1,5,1,4,1,5,0,0,"MF,FW",Under 20,Midfielder,Brazil,South America
1905,Paulinho,BRA,Leverkusen,Bundesliga,2019,19.0,2000.0,3.4,4,3,3,1,0,1,2,50.0,1,5,1,4,1,5,0,0,"MF,FW",Under 20,Midfielder,Brazil,South America
1905,Paulinho,BRA,Leverkusen,Bundesliga,2019,19.0,2000.0,3.4,4,3,3,1,0,1,2,50.0,1,5,1,4,1,5,0,0,"MF,FW",Under 20,Midfielder,Brazil,South America
1905,Paulinho,BRA,Leverkusen,Bundesliga,2019,19.0,2000.0,3.4,4,3,3,1,0,1,2,50.0,1,5,1,4,1,5,0,0,"MF,FW",Under 20,Midfielder,Brazil,South America
1905,Paulinho,BRA,Leverkusen,Bundesliga,2019,19.0,2000.0,3.4,4,3,3,1,0,1,2,50.0,1,5,1,4,1,5,0,0,"MF,FW",Under 20,Midfielder,Brazil,South America
1905,Paulinho,BRA,Leverkusen,Bundesliga,2019,19.0,2000.0,3.4,4,3,3,1,0,1,2,50.0,1,5,1,4,1,5,0,0,"MF,FW",Under 20,Midfielder,Brazil,South America
1905,Paulinho,BRA,Leverkusen,Bundesliga,2019,19.0,2000.0,3.4,4,3,3,1,0,1,2,50.0,1,5,1,4,1,5,0,0,"MF,FW",Under 20,Midfielder,Brazil,South America
1905,Paulinho,BRA,Leverkusen,Bundesliga,2019,19.0,2000.0,3.4,4,3,3,1,0,1,2,50.0,1,5,1,4,1,5,0,0,"MF,FW",Under 20,Midfielder,Brazil,South America
1905,Paulinho,BRA,Leverkusen,Bundesliga,2019,19.0,2000.0,3.4,4,3,3,1,0,1,2,50.0,1,5,1,4,1,5,0,0,"MF,FW",Under 20,Midfielder,Brazil,South America
1905,Paulinho,BRA,Leverkusen,Bundesliga,2019,19.0,2000.0,3.4,4,3,3,1,0,1,2,50.0,1,5,1,4,1,5,0,0,"MF,FW",Under 20,Midfielder,Brazil,South America
1905,Paulinho,BRA,Leverkusen,Bundesliga,2019,19.0,2000.0,3.4,4,3,3,1,0,1,2,50.0,1,5,1,4,1,5,0,0,"MF,FW",Under 20,Midfielder,Brazil,South America
1905,Paulinho,BRA,Leverkusen,Bundesliga,2019,19.0,2000.0,3.4,4,3,3,1,0,1,2,50.0,1,5,1,4,1,5,0,0,"MF,FW",Under 20,Midfielder,Brazil,South America
1905,Paulinho,BRA,Leverkusen,Bundesliga,2019,19.0,2000.0,3.4,4,3,3,1,0,1,2,50.0,1,5,1,4,1,5,0,0,"MF,FW",Under 20,Midfielder,Brazil,South America
1905,Paulinho,BRA,Leverkusen,Bundesliga,2019,19.0,2000.0,3.4,4,3,3,1,0,1,2,50.0,1,5,1,4,1,5,0,0,"MF,FW",Under 20,Midfielder,Brazil,South America
1905,Paulinho,BRA,Leverkusen,Bundesliga,2019,19.0,2000.0,3.4,4,3,3,1,0,1,2,50.0,1,5,1,4,1,5,0,0,"MF,FW",Under 20,Midfielder,Brazil,South America
1905,Paulinho,BRA,Leverkusen,Bundesliga,2019,19.0,2000.0,3.4,4,3,3,1,0,1,2,50.0,1,5,1,4,1,5,0,0,"MF,FW",Under 20,Midfielder,Brazil,South America
1905,Paulinho,BRA,Leverkusen,Bundesliga,2019,19.0,2000.0,3.4,4,3,3,1,0,1,2,50.0,1,5,1,4,1,5,0,0,"MF,FW",Under 20,Midfielder,Brazil,South America
1905,Paulinho,BRA,Leverkusen,Bundesliga,2019,19.0,2000.0,3.4,4,3,3,1,0,1,2,50.0,1,5,1,4,1,5,0,0,"MF,FW",Under 20,Midfielder,Brazil,South America
1905,Paulinho,BRA,Leverkusen,Bundesliga,2019,19.0,2000.0,3.4,4,3,3,1,0,1,2,50.0,1,5,1,4,1,5,0,0,"MF,FW",Under 20,Midfielder,Brazil,South America
1905,Paulinho,BRA,Leverkusen,Bundesliga,2019,19.0,2000.0,3.4,4,3,3,1,0,1,2,50.0,1,5,1,4,1,5,0,0,"MF,FW",Under 20,Midfielder,Brazil,South America
1905,Paulinho,BRA,Leverkusen,Bundesliga,2019,19.0,2000.0,3.4,4,3,3,1,0,1,2,50.0,1,5,1,4,1,5,0,0,"MF,FW",Under 20,Midfielder,Brazil,South America
1905,Paulinho,BRA,Leverkusen,Bundesliga,2019,19.0,2000.0,3.4,4,3,3,1,0,1,2,50.0,1,5,1,4,1,5,0,0,"MF,FW",Under 20,Midfielder,Brazil,South America
1905,Paulinho,BRA,Leverkusen,Bundesliga,2019,19.0,2000.0,3.4,4,3,3,1,0,1,2,50.0,1,5,1,4,1,5,0,0,"MF,FW",Under 20,Midfielder,Brazil,South America
1905,Paulinho,BRA,Leverkusen,Bundesliga,2019,19.0,2000.0,3.4,4,3,3,1,0,1,2,50.0,1,5,1,4,1,5,0,0,"MF,FW",Under 20,Midfielder,Brazil,South America
1905,Paulinho,BRA,Leverkusen,Bundesliga,2019,19.0,2000.0,3.4,4,3,3,1,0,1,2,50.0,1,5,1,4,1,5,0,0,"MF,FW",Under 20,Midfielder,Brazil,South America
1905,Paulinho,BRA,Leverkusen,Bundesliga,2019,19.0,2000.0,3.4,4,3,3,1,0,1,2,50.0,1,5,1,4,1,5,0,0,"MF,FW",Under 20,Midfielder,Brazil,South America
1905,Paulinho,BRA,Leverkusen,Bundesliga,2019,19.0,2000.0,3.4,4,3,3,1,0,1,2,50.0,1,5,1,4,1,5,0,0,"MF,FW",Under 20,Midfielder,Brazil,South America
1905,Paulinho,BRA,Leverkusen,Bundesliga,2019,19.0,2000.0,3.4,4,3,3,1,0,1,2,50.0,1,5,1,4,1,5,0,0,"MF,FW",Under 20,Midfielder,Brazil,South America
1905,Paulinho,BRA,Leverkusen,Bundesliga,2019,19.0,2000.0,3.4,4,3,3,1,0,1,2,50.0,1,5,1,4,1,5,0,0,"MF,FW",Under 20,Midfielder,Brazil,South America
1905,Paulinho,BRA,Leverkusen,Bundesliga,2019,19.0,2000.0,3.4,4,3,3,1,0,1,2,50.0,1,5,1,4,1,5,0,0,"MF,FW",Under 20,Midfielder,Brazil,South America
1905,Paulinho,BRA,Leverkusen,Bundesliga,2019,19.0,2000.0,3.4,4,3,3,1,0,1,2,50.0,1,5,1,4,1,5,0,0,"MF,FW",Under 20,Midfielder,Brazil,South America
1905,Paulinho,BRA,Leverkusen,Bundesliga,2019,19.0,2000.0,3.4,4,3,3,1,0,1,2,50.0,1,5,1,4,1,5,0,0,"MF,FW",Under 20,Midfielder,Brazil,South America
1905,Paulinho,BRA,Leverkusen,Bundesliga,2019,19.0,2000.0,3.4,4,3,3,1,0,1,2,50.0,1,5,1,4,1,5,0,0,"MF,FW",Under 20,Midfielder,Brazil,South America
1905,Paulinho,BRA,Leverkusen,Bundesliga,2019,19.0,2000.0,3.4,4,3,3,1,0,1,2,50.0,1,5,1,4,1,5,0,0,"MF,FW",Under 20,Midfielder,Brazil,South America
1905,Paulinho,BRA,Leverkusen,Bundesliga,2019,19.0,2000.0,3.4,4,3,3,1,0,1,2,50.0,1,5,1,4,1,5,0,0,"MF,FW",Under 20,Midfielder,Brazil,South America
1905,Paulinho,BRA,Leverkusen,Bundesliga,2019,19.0,2000.0,3.4,4,3,3,1,0,1,2,50.0,1,5,1,4,1,5,0,0,"MF,FW",Under 20,Midfielder,Brazil,South America
1905,Paulinho,BRA,Leverkusen,Bundesliga,2019,19.0,2000.0,3.4,4,3,3,1,0,1,2,50.0,1,5,1,4,1,5,0,0,"MF,FW",Under 20,Midfielder,Brazil,South America
1905,Paulinho,BRA,Leverkusen,Bundesliga,2019,19.0,2000.0,3.4,4,3,3,1,0,1,2,50.0,1,5,1,4,1,5,0,0,"MF,FW",Under 20,Midfielder,Brazil,South America
1905,Paulinho,BRA,Leverkusen,Bundesliga,2019,19.0,2000.0,3.4,4,3,3,1,0,1,2,50.0,1,5,1,4,1,5,0,0,"MF,FW",Under 20,Midfielder,Brazil,South America
1905,Paulinho,BRA,Leverkusen,Bundesliga,2019,19.0,2000.0,3.4,4,3,3,1,0,1,2,50.0,1,5,1,4,1,5,0,0,"MF,FW",Under 20,Midfielder,Brazil,South America
1905,Paulinho,BRA,Leverkusen,Bundesliga,2019,19.0,2000.0,3.4,4,3,3,1,0,1,2,50.0,1,5,1,4,1,5,0,0,"MF,FW",Under 20,Midfielder,Brazil,South America
1905,Paulinho,BRA,Leverkusen,Bundesliga,2019,19.0,2000.0,3.4,4,3,3,1,0,1,2,50.0,1,5,1,4,1,5,0,0,"MF,FW",Under 20,Midfielder,Brazil,South America
1905,Paulinho,BRA,Leverkusen,Bundesliga,2019,19.0,2000.0,3.4,4,3,3,1,0,1,2,50.0,1,5,1,4,1,5,0,0,"MF,FW",Under 20,Midfielder,Brazil,South America
1905,Paulinho,BRA,Leverkusen,Bundesliga,2019,19.0,2000.0,3.4,4,3,3,1,0,1,2,50.0,1,5,1,4,1,5,0,0,"MF,FW",Under 20,Midfielder,Brazil,South America
1905,Paulinho,BRA,Leverkusen,Bundesliga,2019,19.0,2000.0,3.4,4,3,3,1,0,1,2,50.0,1,5,1,4,1,5,0,0,"MF,FW",Under 20,Midfielder,Brazil,South America
1905,Paulinho,BRA,Leverkusen,Bundesliga,2019,19.0,2000.0,3.4,4,3,3,1,0,1,2,50.0,1,5,1,4,1,5,0,0,"MF,FW",Under 20,Midfielder,Brazil,South America
1905,Paulinho,BRA,Leverkusen,Bundesliga,2019,19.0,2000.0,3.4,4,3,3,1,0,1,2,50.0,1,5,1,4,1,5,0,0,"MF,FW",Under 20,Midfielder,Brazil,South America
1905,Paulinho,BRA,Leverkusen,Bundesliga,2019,19.0,2000.0,3.4,4,3,3,1,0,1,2,50.0,1,5,1,4,1,5,0,0,"MF,FW",Under 20,Midfielder,Brazil,South America
1905,Paulinho,BRA,Leverkusen,Bundesliga,2019,19.0,2000.0,3.4,4,3,3,1,0,1,2,50.0,1,5,1,4,1,5,0,0,"MF,FW",Under 20,Midfielder,Brazil,South America
1905,Paulinho,BRA,Leverkusen,Bundesliga,2019,19.0,2000.0,3.4,4,3,3,1,0,1,2,50.0,1,5,1,4,1,5,0,0,"MF,FW",Under 20,Midfielder,Brazil,South America
1905,Paulinho,BRA,Leverkusen,Bundesliga,2019,19.0,2000.0,3.4,4,3,3,1,0,1,2,50.0,1,5,1,4,1,5,0,0,"MF,FW",Under 20,Midfielder,Brazil,South America
1905,Paulinho,BRA,Leverkusen,Bundesliga,2019,19.0,2000.0,3.4,4,3,3,1,0,1,2,50.0,1,5,1,4,1,5,0,0,"MF,FW",Under 20,Midfielder,Brazil,South America
1905,Paulinho,BRA,Leverkusen,Bundesliga,2019,19.0,2000.0,3.4,4,3,3,1,0,1,2,50.0,1,5,1,4,1,5,0,0,"MF,FW",Under 20,Midfielder,Brazil,South America
1905,Paulinho,BRA,Leverkusen,Bundesliga,2019,19.0,2000.0,3.4,4,3,3,1,0,1,2,50.0,1,5,1,4,1,5,0,0,"MF,FW",Under 20,Midfielder,Brazil,South America
1905,Paulinho,BRA,Leverkusen,Bundesliga,2019,19.0,2000.0,3.4,4,3,3,1,0,1,2,50.0,1,5,1,4,1,5,0,0,"MF,FW",Under 20,Midfielder,Brazil,South America
1905,Paulinho,BRA,Leverkusen,Bundesliga,2019,19.0,2000.0,3.4,4,3,3,1,0,1,2,50.0,1,5,1,4,1,5,0,0,"MF,FW",Under 20,Midfielder,Brazil,South America
1905,Paulinho,BRA,Leverkusen,Bundesliga,2019,19.0,2000.0,3.4,4,3,3,1,0,1,2,50.0,1,5,1,4,1,5,0,0,"MF,FW",Under 20,Midfielder,Brazil,South America
1905,Paulinho,BRA,Leverkusen,Bundesliga,2019,19.0,2000.0,3.4,4,3,3,1,0,1,2,50.0,1,5,1,4,1,5,0,0,"MF,FW",Under 20,Midfielder,Brazil,South America
1905,Paulinho,BRA,Leverkusen,Bundesliga,2019,19.0,2000.0,3.4,4,3,3,1,0,1,2,50.0,1,5,1,4,1,5,0,0,"MF,FW",Under 20,Midfielder,Brazil,South America
1905,Paulinho,BRA,Leverkusen,Bundesliga,2019,19.0,2000.0,3.4,4,3,3,1,0,1,2,50.0,1,5,1,4,1,5,0,0,"MF,FW",Under 20,Midfielder,Brazil,South America
1905,Paulinho,BRA,Leverkusen,Bundesliga,2019,19.0,2000.0,3.4,4,3,3,1,0,1,2,50.0,1,5,1,4,1,5,0,0,"MF,FW",Under 20,Midfielder,Brazil,South America
1905,Paulinho,BRA,Leverkusen,Bundesliga,2019,19.0,2000.0,3.4,4,3,3,1,0,1,2,50.0,1,5,1,4,1,5,0,0,"MF,FW",Under 20,Midfielder,Brazil,South America
1905,Paulinho,BRA,Leverkusen,Bundesliga,2019,19.0,2000.0,3.4,4,3,3,1,0,1,2,50.0,1,5,1,4,1,5,0,0,"MF,FW",Under 20,Midfielder,Brazil,South America
1905,Paulinho,BRA,Leverkusen,Bundesliga,2019,19.0,2000.0,3.4,4,3,3,1,0,1,2,50.0,1,5,1,4,1,5,0,0,"MF,FW",Under 20,Midfielder,Brazil,South America
1905,Paulinho,BRA,Leverkusen,Bundesliga,2019,19.0,2000.0,3.4,4,3,3,1,0,1,2,50.0,1,5,1,4,1,5,0,0,"MF,FW",Under 20,Midfielder,Brazil,South America
1905,Paulinho,BRA,Leverkusen,Bundesliga,2019,19.0,2000.0,3.4,4,3,3,1,0,1,2,50.0,1,5,1,4,1,5,0,0,"MF,FW",Under 20,Midfielder,Brazil,South America
1905,Paulinho,BRA,Leverkusen,Bundesliga,2019,19.0,2000.0,3.4,4,3,3,1,0,1,2,50.0,1,5,1,4,1,5,0,0,"MF,FW",Under 20,Midfielder,Brazil,South America
1905,Paulinho,BRA,Leverkusen,Bundesliga,2019,19.0,2000.0,3.4,4,3,3,1,0,1,2,50.0,1,5,1,4,1,5,0,0,"MF,FW",Under 20,Midfielder,Brazil,South America
1905,Paulinho,BRA,Leverkusen,Bundesliga,2019,19.0,2000.0,3.4,4,3,3,1,0,1,2,50.0,1,5,1,4,1,5,0,0,"MF,FW",Under 20,Midfielder,Brazil,South America
1905,Paulinho,BRA,Leverkusen,Bundesliga,2019,19.0,2000.0,3.4,4,3,3,1,0,1,2,50.0,1,5,1,4,1,5,0,0,"MF,FW",Under 20,Midfielder,Brazil,South America
1905,Paulinho,BRA,Leverkusen,Bundesliga,2019,19.0,2000.0,3.4,4,3,3,1,0,1,2,50.0,1,5,1,4,1,5,0,0,"MF,FW",Under 20,Midfielder,Brazil,South America
1905,Paulinho,BRA,Leverkusen,Bundesliga,2019,19.0,2000.0,3.4,4,3,3,1,0,1,2,50.0,1,5,1,4,1,5,0,0,"MF,FW",Under 20,Midfielder,Brazil,South America
1905,Paulinho,BRA,Leverkusen,Bundesliga,2019,19.0,2000.0,3.4,4,3,3,1,0,1,2,50.0,1,5,1,4,1,5,0,0,"MF,FW",Under 20,Midfielder,Brazil,South America
1905,Paulinho,BRA,Leverkusen,Bundesliga,2019,19.0,2000.0,3.4,4,3,3,1,0,1,2,50.0,1,5,1,4,1,5,0,0,"MF,FW",Under 20,Midfielder,Brazil,South America
1905,Paulinho,BRA,Leverkusen,Bundesliga,2019,19.0,2000.0,3.4,4,3,3,1,0,1,2,50.0,1,5,1,4,1,5,0,0,"MF,FW",Under 20,Midfielder,Brazil,South America
1905,Paulinho,BRA,Leverkusen,Bundesliga,2019,19.0,2000.0,3.4,4,3,3,1,0,1,2,50.0,1,5,1,4,1,5,0,0,"MF,FW",Under 20,Midfielder,Brazil,South America
1905,Paulinho,BRA,Leverkusen,Bundesliga,2019,19.0,2000.0,3.4,4,3,3,1,0,1,2,50.0,1,5,1,4,1,5,0,0,"MF,FW",Under 20,Midfielder,Brazil,South America
1905,Paulinho,BRA,Leverkusen,Bundesliga,2019,19.0,2000.0,3.4,4,3,3,1,0,1,2,50.0,1,5,1,4,1,5,0,0,"MF,FW",Under 20,Midfielder,Brazil,South America
1905,Paulinho,BRA,Leverkusen,Bundesliga,2019,19.0,2000.0,3.4,4,3,3,1,0,1,2,50.0,1,5,1,4,1,5,0,0,"MF,FW",Under 20,Midfielder,Brazil,South America
1905,Paulinho,BRA,Leverkusen,Bundesliga,2019,19.0,2000.0,3.4,4,3,3,1,0,1,2,50.0,1,5,1,4,1,5,0,0,"MF,FW",Under 20,Midfielder,Brazil,South America
1905,Paulinho,BRA,Leverkusen,Bundesliga,2019,19.0,2000.0,3.4,4,3,3,1,0,1,2,50.0,1,5,1,4,1,5,0,0,"MF,FW",Under 20,Midfielder,Brazil,South America
1905,Paulinho,BRA,Leverkusen,Bundesliga,2019,19.0,2000.0,3.4,4,3,3,1,0,1,2,50.0,1,5,1,4,1,5,0,0,"MF,FW",Under 20,Midfielder,Brazil,South America
1905,Paulinho,BRA,Leverkusen,Bundesliga,2019,19.0,2000.0,3.4,4,3,3,1,0,1,2,50.0,1,5,1,4,1,5,0,0,"MF,FW",Under 20,Midfielder,Brazil,South America
1905,Paulinho,BRA,Leverkusen,Bundesliga,2019,19.0,2000.0,3.4,4,3,3,1,0,1,2,50.0,1,5,1,4,1,5,0,0,"MF,FW",Under 20,Midfielder,Brazil,South America
1905,Paulinho,BRA,Leverkusen,Bundesliga,2019,19.0,2000.0,3.4,4,3,3,1,0,1,2,50.0,1,5,1,4,1,5,0,0,"MF,FW",Under 20,Midfielder,Brazil,South America
1905,Paulinho,BRA,Leverkusen,Bundesliga,2019,19.0,2000.0,3.4,4,3,3,1,0,1,2,50.0,1,5,1,4,1,5,0,0,"MF,FW",Under 20,Midfielder,Brazil,South America
1905,Paulinho,BRA,Leverkusen,Bundesliga,2019,19.0,2000.0,3.4,4,3,3,1,0,1,2,50.0,1,5,1,4,1,5,0,0,"MF,FW",Under 20,Midfielder,Brazil,South America
1905,Paulinho,BRA,Leverkusen,Bundesliga,2019,19.0,2000.0,3.4,4,3,3,1,0,1,2,50.0,1,5,1,4,1,5,0,0,"MF,FW",Under 20,Midfielder,Brazil,South America
1907,Gabriel Paulista,BRA,Valencia,La Liga,2019,28.0,1990.0,31.1,22,14,17,2,3,15,25,60.0,10,36,29,7,48,70,151,3,DF,25-29,Defender,Brazil,South America
1908,Benjamin Pavard,FRA,Bayern Munich,Bundesliga,2019,23.0,1996.0,31.0,34,22,15,10,9,16,28,57.1,12,28,10,18,52,86,60,0,DF,20-24,Defender,France,Europe
1910,Mateo Pavlović,BIH,Angers,Ligue 1,2019,29.0,1990.0,9.0,8,2,6,2,0,5,7,71.4,2,4,2,2,5,13,38,1,DF,25-29,Defender,Bosnia and Herzegovina,Europe
1911,Leonardo Pavoletti,ITA,Cagliari,Serie A,2019,30.0,1988.0,0.5,0,0,0,0,0,0,0,,0,0,0,0,1,1,3,0,FW,30-34,Forward,Italy,Europe
1912,Dimitri Payet,FRA,Marseille,Ligue 1,2019,32.0,1987.0,21.4,22,12,8,8,6,10,26,38.5,16,8,1,7,8,30,12,0,"FW,MF",30-34,Forward,France,Europe
1913,Nehuén Paz,ARG,Bologna,Serie A,2019,26.0,1993.0,1.3,1,1,0,1,0,0,2,0.0,2,3,3,0,5,6,12,0,DF,25-29,Defender,Argentina,South America
1914,Nehuén Paz,ARG,Lecce,Serie A,2019,26.0,1993.0,9.4,14,5,11,3,0,10,12,83.3,2,12,6,6,20,34,38,1,DF,25-29,Defender,Argentina,South America
1915,Giampaolo Pazzini,ITA,Hellas Verona,Serie A,2019,34.0,1984.0,3.4,1,0,0,1,0,0,4,0.0,4,2,0,2,1,2,4,0,"FW,MF",30-34,Forward,Italy,Europe
1916,Mads Pedersen,DEN,Augsburg,Bundesliga,2019,22.0,1996.0,1.1,4,2,3,0,1,2,6,33.3,4,3,1,2,2,6,0,0,DF,20-24,Defender,Denmark,Europe
1916,Mads Pedersen,DEN,Augsburg,Bundesliga,2019,22.0,1996.0,1.1,4,2,3,0,1,2,6,33.3,4,3,1,2,2,6,0,0,DF,20-24,Defender,Denmark,Europe
1916,Mads Pedersen,DEN,Augsburg,Bundesliga,2019,22.0,1996.0,1.1,4,2,3,0,1,2,6,33.3,4,3,1,2,2,6,0,0,DF,20-24,Defender,Denmark,Europe
1916,Mads Pedersen,DEN,Augsburg,Bundesliga,2019,22.0,1996.0,1.1,4,2,3,0,1,2,6,33.3,4,3,1,2,2,6,0,0,DF,20-24,Defender,Denmark,Europe
1920,Pedro,BRA,Fiorentina,Serie A,2019,22.0,1997.0,0.7,1,1,0,0,1,0,0,,0,1,0,1,0,1,0,0,FW,20-24,Forward,Brazil,South America
1920,Pedro,BRA,Fiorentina,Serie A,2019,22.0,1997.0,0.7,1,1,0,0,1,0,0,,0,1,0,1,0,1,0,0,FW,20-24,Forward,Brazil,South America
1920,Pedro,BRA,Fiorentina,Serie A,2019,22.0,1997.0,0.7,1,1,0,0,1,0,0,,0,1,0,1,0,1,0,0,FW,20-24,Forward,Brazil,South America
1920,Pedro,BRA,Fiorentina,Serie A,2019,22.0,1997.0,0.7,1,1,0,0,1,0,0,,0,1,0,1,0,1,0,0,FW,20-24,Forward,Brazil,South America
1920,Pedro,BRA,Fiorentina,Serie A,2019,22.0,1997.0,0.7,1,1,0,0,1,0,0,,0,1,0,1,0,1,0,0,FW,20-24,Forward,Brazil,South America
1920,Pedro,BRA,Fiorentina,Serie A,2019,22.0,1997.0,0.7,1,1,0,0,1,0,0,,0,1,0,1,0,1,0,0,FW,20-24,Forward,Brazil,South America
1920,Pedro,BRA,Fiorentina,Serie A,2019,22.0,1997.0,0.7,1,1,0,0,1,0,0,,0,1,0,1,0,1,0,0,FW,20-24,Forward,Brazil,South America
1920,Pedro,BRA,Fiorentina,Serie A,2019,22.0,1997.0,0.7,1,1,0,0,1,0,0,,0,1,0,1,0,1,0,0,FW,20-24,Forward,Brazil,South America
1920,Pedro,BRA,Fiorentina,Serie A,2019,22.0,1997.0,0.7,1,1,0,0,1,0,0,,0,1,0,1,0,1,0,0,FW,20-24,Forward,Brazil,South America
1920,Pedro,BRA,Fiorentina,Serie A,2019,22.0,1997.0,0.7,1,1,0,0,1,0,0,,0,1,0,1,0,1,0,0,FW,20-24,Forward,Brazil,South America
1920,Pedro,BRA,Fiorentina,Serie A,2019,22.0,1997.0,0.7,1,1,0,0,1,0,0,,0,1,0,1,0,1,0,0,FW,20-24,Forward,Brazil,South America
1920,Pedro,BRA,Fiorentina,Serie A,2019,22.0,1997.0,0.7,1,1,0,0,1,0,0,,0,1,0,1,0,1,0,0,FW,20-24,Forward,Brazil,South America
1920,Pedro,BRA,Fiorentina,Serie A,2019,22.0,1997.0,0.7,1,1,0,0,1,0,0,,0,1,0,1,0,1,0,0,FW,20-24,Forward,Brazil,South America
1920,Pedro,BRA,Fiorentina,Serie A,2019,22.0,1997.0,0.7,1,1,0,0,1,0,0,,0,1,0,1,0,1,0,0,FW,20-24,Forward,Brazil,South America
1920,Pedro,BRA,Fiorentina,Serie A,2019,22.0,1997.0,0.7,1,1,0,0,1,0,0,,0,1,0,1,0,1,0,0,FW,20-24,Forward,Brazil,South America
1920,Pedro,BRA,Fiorentina,Serie A,2019,22.0,1997.0,0.7,1,1,0,0,1,0,0,,0,1,0,1,0,1,0,0,FW,20-24,Forward,Brazil,South America
1921,João Pedro,ITA,Cagliari,Serie A,2019,27.0,1992.0,35.0,17,11,5,7,5,4,24,16.7,20,35,8,27,9,26,39,0,"FW,MF",25-29,Forward,Italy,Europe
1921,João Pedro,ITA,Cagliari,Serie A,2019,27.0,1992.0,35.0,17,11,5,7,5,4,24,16.7,20,35,8,27,9,26,39,0,"FW,MF",25-29,Forward,Italy,Europe
1921,João Pedro,ITA,Cagliari,Serie A,2019,27.0,1992.0,35.0,17,11,5,7,5,4,24,16.7,20,35,8,27,9,26,39,0,"FW,MF",25-29,Forward,Italy,Europe
1921,João Pedro,ITA,Cagliari,Serie A,2019,27.0,1992.0,35.0,17,11,5,7,5,4,24,16.7,20,35,8,27,9,26,39,0,"FW,MF",25-29,Forward,Italy,Europe
1921,João Pedro,ITA,Cagliari,Serie A,2019,27.0,1992.0,35.0,17,11,5,7,5,4,24,16.7,20,35,8,27,9,26,39,0,"FW,MF",25-29,Forward,Italy,Europe
1921,João Pedro,ITA,Cagliari,Serie A,2019,27.0,1992.0,35.0,17,11,5,7,5,4,24,16.7,20,35,8,27,9,26,39,0,"FW,MF",25-29,Forward,Italy,Europe
1921,João Pedro,ITA,Cagliari,Serie A,2019,27.0,1992.0,35.0,17,11,5,7,5,4,24,16.7,20,35,8,27,9,26,39,0,"FW,MF",25-29,Forward,Italy,Europe
1921,João Pedro,ITA,Cagliari,Serie A,2019,27.0,1992.0,35.0,17,11,5,7,5,4,24,16.7,20,35,8,27,9,26,39,0,"FW,MF",25-29,Forward,Italy,Europe
1921,João Pedro,ITA,Cagliari,Serie A,2019,27.0,1992.0,35.0,17,11,5,7,5,4,24,16.7,20,35,8,27,9,26,39,0,"FW,MF",25-29,Forward,Italy,Europe
1921,João Pedro,ITA,Cagliari,Serie A,2019,27.0,1992.0,35.0,17,11,5,7,5,4,24,16.7,20,35,8,27,9,26,39,0,"FW,MF",25-29,Forward,Italy,Europe
1921,João Pedro,ITA,Cagliari,Serie A,2019,27.0,1992.0,35.0,17,11,5,7,5,4,24,16.7,20,35,8,27,9,26,39,0,"FW,MF",25-29,Forward,Italy,Europe
1921,João Pedro,ITA,Cagliari,Serie A,2019,27.0,1992.0,35.0,17,11,5,7,5,4,24,16.7,20,35,8,27,9,26,39,0,"FW,MF",25-29,Forward,Italy,Europe
1921,João Pedro,ITA,Cagliari,Serie A,2019,27.0,1992.0,35.0,17,11,5,7,5,4,24,16.7,20,35,8,27,9,26,39,0,"FW,MF",25-29,Forward,Italy,Europe
1921,João Pedro,ITA,Cagliari,Serie A,2019,27.0,1992.0,35.0,17,11,5,7,5,4,24,16.7,20,35,8,27,9,26,39,0,"FW,MF",25-29,Forward,Italy,Europe
1921,João Pedro,ITA,Cagliari,Serie A,2019,27.0,1992.0,35.0,17,11,5,7,5,4,24,16.7,20,35,8,27,9,26,39,0,"FW,MF",25-29,Forward,Italy,Europe
1921,João Pedro,ITA,Cagliari,Serie A,2019,27.0,1992.0,35.0,17,11,5,7,5,4,24,16.7,20,35,8,27,9,26,39,0,"FW,MF",25-29,Forward,Italy,Europe
1921,João Pedro,ITA,Cagliari,Serie A,2019,27.0,1992.0,35.0,17,11,5,7,5,4,24,16.7,20,35,8,27,9,26,39,0,"FW,MF",25-29,Forward,Italy,Europe
1921,João Pedro,ITA,Cagliari,Serie A,2019,27.0,1992.0,35.0,17,11,5,7,5,4,24,16.7,20,35,8,27,9,26,39,0,"FW,MF",25-29,Forward,Italy,Europe
1921,João Pedro,ITA,Cagliari,Serie A,2019,27.0,1992.0,35.0,17,11,5,7,5,4,24,16.7,20,35,8,27,9,26,39,0,"FW,MF",25-29,Forward,Italy,Europe
1921,João Pedro,ITA,Cagliari,Serie A,2019,27.0,1992.0,35.0,17,11,5,7,5,4,24,16.7,20,35,8,27,9,26,39,0,"FW,MF",25-29,Forward,Italy,Europe
1921,João Pedro,ITA,Cagliari,Serie A,2019,27.0,1992.0,35.0,17,11,5,7,5,4,24,16.7,20,35,8,27,9,26,39,0,"FW,MF",25-29,Forward,Italy,Europe
1921,João Pedro,ITA,Cagliari,Serie A,2019,27.0,1992.0,35.0,17,11,5,7,5,4,24,16.7,20,35,8,27,9,26,39,0,"FW,MF",25-29,Forward,Italy,Europe
1921,João Pedro,ITA,Cagliari,Serie A,2019,27.0,1992.0,35.0,17,11,5,7,5,4,24,16.7,20,35,8,27,9,26,39,0,"FW,MF",25-29,Forward,Italy,Europe
1921,João Pedro,ITA,Cagliari,Serie A,2019,27.0,1992.0,35.0,17,11,5,7,5,4,24,16.7,20,35,8,27,9,26,39,0,"FW,MF",25-29,Forward,Italy,Europe
1921,João Pedro,ITA,Cagliari,Serie A,2019,27.0,1992.0,35.0,17,11,5,7,5,4,24,16.7,20,35,8,27,9,26,39,0,"FW,MF",25-29,Forward,Italy,Europe
1921,João Pedro,ITA,Cagliari,Serie A,2019,27.0,1992.0,35.0,17,11,5,7,5,4,24,16.7,20,35,8,27,9,26,39,0,"FW,MF",25-29,Forward,Italy,Europe
1921,João Pedro,ITA,Cagliari,Serie A,2019,27.0,1992.0,35.0,17,11,5,7,5,4,24,16.7,20,35,8,27,9,26,39,0,"FW,MF",25-29,Forward,Italy,Europe
1921,João Pedro,ITA,Cagliari,Serie A,2019,27.0,1992.0,35.0,17,11,5,7,5,4,24,16.7,20,35,8,27,9,26,39,0,"FW,MF",25-29,Forward,Italy,Europe
1921,João Pedro,ITA,Cagliari,Serie A,2019,27.0,1992.0,35.0,17,11,5,7,5,4,24,16.7,20,35,8,27,9,26,39,0,"FW,MF",25-29,Forward,Italy,Europe
1921,João Pedro,ITA,Cagliari,Serie A,2019,27.0,1992.0,35.0,17,11,5,7,5,4,24,16.7,20,35,8,27,9,26,39,0,"FW,MF",25-29,Forward,Italy,Europe
1921,João Pedro,ITA,Cagliari,Serie A,2019,27.0,1992.0,35.0,17,11,5,7,5,4,24,16.7,20,35,8,27,9,26,39,0,"FW,MF",25-29,Forward,Italy,Europe
1921,João Pedro,ITA,Cagliari,Serie A,2019,27.0,1992.0,35.0,17,11,5,7,5,4,24,16.7,20,35,8,27,9,26,39,0,"FW,MF",25-29,Forward,Italy,Europe
1921,João Pedro,ITA,Cagliari,Serie A,2019,27.0,1992.0,35.0,17,11,5,7,5,4,24,16.7,20,35,8,27,9,26,39,0,"FW,MF",25-29,Forward,Italy,Europe
1921,João Pedro,ITA,Cagliari,Serie A,2019,27.0,1992.0,35.0,17,11,5,7,5,4,24,16.7,20,35,8,27,9,26,39,0,"FW,MF",25-29,Forward,Italy,Europe
1921,João Pedro,ITA,Cagliari,Serie A,2019,27.0,1992.0,35.0,17,11,5,7,5,4,24,16.7,20,35,8,27,9,26,39,0,"FW,MF",25-29,Forward,Italy,Europe
1921,João Pedro,ITA,Cagliari,Serie A,2019,27.0,1992.0,35.0,17,11,5,7,5,4,24,16.7,20,35,8,27,9,26,39,0,"FW,MF",25-29,Forward,Italy,Europe
1921,João Pedro,ITA,Cagliari,Serie A,2019,27.0,1992.0,35.0,17,11,5,7,5,4,24,16.7,20,35,8,27,9,26,39,0,"FW,MF",25-29,Forward,Italy,Europe
1921,João Pedro,ITA,Cagliari,Serie A,2019,27.0,1992.0,35.0,17,11,5,7,5,4,24,16.7,20,35,8,27,9,26,39,0,"FW,MF",25-29,Forward,Italy,Europe
1921,João Pedro,ITA,Cagliari,Serie A,2019,27.0,1992.0,35.0,17,11,5,7,5,4,24,16.7,20,35,8,27,9,26,39,0,"FW,MF",25-29,Forward,Italy,Europe
1921,João Pedro,ITA,Cagliari,Serie A,2019,27.0,1992.0,35.0,17,11,5,7,5,4,24,16.7,20,35,8,27,9,26,39,0,"FW,MF",25-29,Forward,Italy,Europe
1921,João Pedro,ITA,Cagliari,Serie A,2019,27.0,1992.0,35.0,17,11,5,7,5,4,24,16.7,20,35,8,27,9,26,39,0,"FW,MF",25-29,Forward,Italy,Europe
1921,João Pedro,ITA,Cagliari,Serie A,2019,27.0,1992.0,35.0,17,11,5,7,5,4,24,16.7,20,35,8,27,9,26,39,0,"FW,MF",25-29,Forward,Italy,Europe
1921,João Pedro,ITA,Cagliari,Serie A,2019,27.0,1992.0,35.0,17,11,5,7,5,4,24,16.7,20,35,8,27,9,26,39,0,"FW,MF",25-29,Forward,Italy,Europe
1921,João Pedro,ITA,Cagliari,Serie A,2019,27.0,1992.0,35.0,17,11,5,7,5,4,24,16.7,20,35,8,27,9,26,39,0,"FW,MF",25-29,Forward,Italy,Europe
1921,João Pedro,ITA,Cagliari,Serie A,2019,27.0,1992.0,35.0,17,11,5,7,5,4,24,16.7,20,35,8,27,9,26,39,0,"FW,MF",25-29,Forward,Italy,Europe
1921,João Pedro,ITA,Cagliari,Serie A,2019,27.0,1992.0,35.0,17,11,5,7,5,4,24,16.7,20,35,8,27,9,26,39,0,"FW,MF",25-29,Forward,Italy,Europe
1921,João Pedro,ITA,Cagliari,Serie A,2019,27.0,1992.0,35.0,17,11,5,7,5,4,24,16.7,20,35,8,27,9,26,39,0,"FW,MF",25-29,Forward,Italy,Europe
1921,João Pedro,ITA,Cagliari,Serie A,2019,27.0,1992.0,35.0,17,11,5,7,5,4,24,16.7,20,35,8,27,9,26,39,0,"FW,MF",25-29,Forward,Italy,Europe
1921,João Pedro,ITA,Cagliari,Serie A,2019,27.0,1992.0,35.0,17,11,5,7,5,4,24,16.7,20,35,8,27,9,26,39,0,"FW,MF",25-29,Forward,Italy,Europe
1921,João Pedro,ITA,Cagliari,Serie A,2019,27.0,1992.0,35.0,17,11,5,7,5,4,24,16.7,20,35,8,27,9,26,39,0,"FW,MF",25-29,Forward,Italy,Europe
1921,João Pedro,ITA,Cagliari,Serie A,2019,27.0,1992.0,35.0,17,11,5,7,5,4,24,16.7,20,35,8,27,9,26,39,0,"FW,MF",25-29,Forward,Italy,Europe
1921,João Pedro,ITA,Cagliari,Serie A,2019,27.0,1992.0,35.0,17,11,5,7,5,4,24,16.7,20,35,8,27,9,26,39,0,"FW,MF",25-29,Forward,Italy,Europe
1921,João Pedro,ITA,Cagliari,Serie A,2019,27.0,1992.0,35.0,17,11,5,7,5,4,24,16.7,20,35,8,27,9,26,39,0,"FW,MF",25-29,Forward,Italy,Europe
1921,João Pedro,ITA,Cagliari,Serie A,2019,27.0,1992.0,35.0,17,11,5,7,5,4,24,16.7,20,35,8,27,9,26,39,0,"FW,MF",25-29,Forward,Italy,Europe
1921,João Pedro,ITA,Cagliari,Serie A,2019,27.0,1992.0,35.0,17,11,5,7,5,4,24,16.7,20,35,8,27,9,26,39,0,"FW,MF",25-29,Forward,Italy,Europe
1921,João Pedro,ITA,Cagliari,Serie A,2019,27.0,1992.0,35.0,17,11,5,7,5,4,24,16.7,20,35,8,27,9,26,39,0,"FW,MF",25-29,Forward,Italy,Europe
1921,João Pedro,ITA,Cagliari,Serie A,2019,27.0,1992.0,35.0,17,11,5,7,5,4,24,16.7,20,35,8,27,9,26,39,0,"FW,MF",25-29,Forward,Italy,Europe
1921,João Pedro,ITA,Cagliari,Serie A,2019,27.0,1992.0,35.0,17,11,5,7,5,4,24,16.7,20,35,8,27,9,26,39,0,"FW,MF",25-29,Forward,Italy,Europe
1921,João Pedro,ITA,Cagliari,Serie A,2019,27.0,1992.0,35.0,17,11,5,7,5,4,24,16.7,20,35,8,27,9,26,39,0,"FW,MF",25-29,Forward,Italy,Europe
1921,João Pedro,ITA,Cagliari,Serie A,2019,27.0,1992.0,35.0,17,11,5,7,5,4,24,16.7,20,35,8,27,9,26,39,0,"FW,MF",25-29,Forward,Italy,Europe
1921,João Pedro,ITA,Cagliari,Serie A,2019,27.0,1992.0,35.0,17,11,5,7,5,4,24,16.7,20,35,8,27,9,26,39,0,"FW,MF",25-29,Forward,Italy,Europe
1921,João Pedro,ITA,Cagliari,Serie A,2019,27.0,1992.0,35.0,17,11,5,7,5,4,24,16.7,20,35,8,27,9,26,39,0,"FW,MF",25-29,Forward,Italy,Europe
1921,João Pedro,ITA,Cagliari,Serie A,2019,27.0,1992.0,35.0,17,11,5,7,5,4,24,16.7,20,35,8,27,9,26,39,0,"FW,MF",25-29,Forward,Italy,Europe
1921,João Pedro,ITA,Cagliari,Serie A,2019,27.0,1992.0,35.0,17,11,5,7,5,4,24,16.7,20,35,8,27,9,26,39,0,"FW,MF",25-29,Forward,Italy,Europe
1921,João Pedro,ITA,Cagliari,Serie A,2019,27.0,1992.0,35.0,17,11,5,7,5,4,24,16.7,20,35,8,27,9,26,39,0,"FW,MF",25-29,Forward,Italy,Europe
1921,João Pedro,ITA,Cagliari,Serie A,2019,27.0,1992.0,35.0,17,11,5,7,5,4,24,16.7,20,35,8,27,9,26,39,0,"FW,MF",25-29,Forward,Italy,Europe
1921,João Pedro,ITA,Cagliari,Serie A,2019,27.0,1992.0,35.0,17,11,5,7,5,4,24,16.7,20,35,8,27,9,26,39,0,"FW,MF",25-29,Forward,Italy,Europe
1921,João Pedro,ITA,Cagliari,Serie A,2019,27.0,1992.0,35.0,17,11,5,7,5,4,24,16.7,20,35,8,27,9,26,39,0,"FW,MF",25-29,Forward,Italy,Europe
1921,João Pedro,ITA,Cagliari,Serie A,2019,27.0,1992.0,35.0,17,11,5,7,5,4,24,16.7,20,35,8,27,9,26,39,0,"FW,MF",25-29,Forward,Italy,Europe
1921,João Pedro,ITA,Cagliari,Serie A,2019,27.0,1992.0,35.0,17,11,5,7,5,4,24,16.7,20,35,8,27,9,26,39,0,"FW,MF",25-29,Forward,Italy,Europe
1921,João Pedro,ITA,Cagliari,Serie A,2019,27.0,1992.0,35.0,17,11,5,7,5,4,24,16.7,20,35,8,27,9,26,39,0,"FW,MF",25-29,Forward,Italy,Europe
1921,João Pedro,ITA,Cagliari,Serie A,2019,27.0,1992.0,35.0,17,11,5,7,5,4,24,16.7,20,35,8,27,9,26,39,0,"FW,MF",25-29,Forward,Italy,Europe
1921,João Pedro,ITA,Cagliari,Serie A,2019,27.0,1992.0,35.0,17,11,5,7,5,4,24,16.7,20,35,8,27,9,26,39,0,"FW,MF",25-29,Forward,Italy,Europe
1921,João Pedro,ITA,Cagliari,Serie A,2019,27.0,1992.0,35.0,17,11,5,7,5,4,24,16.7,20,35,8,27,9,26,39,0,"FW,MF",25-29,Forward,Italy,Europe
1921,João Pedro,ITA,Cagliari,Serie A,2019,27.0,1992.0,35.0,17,11,5,7,5,4,24,16.7,20,35,8,27,9,26,39,0,"FW,MF",25-29,Forward,Italy,Europe
1921,João Pedro,ITA,Cagliari,Serie A,2019,27.0,1992.0,35.0,17,11,5,7,5,4,24,16.7,20,35,8,27,9,26,39,0,"FW,MF",25-29,Forward,Italy,Europe
1921,João Pedro,ITA,Cagliari,Serie A,2019,27.0,1992.0,35.0,17,11,5,7,5,4,24,16.7,20,35,8,27,9,26,39,0,"FW,MF",25-29,Forward,Italy,Europe
1921,João Pedro,ITA,Cagliari,Serie A,2019,27.0,1992.0,35.0,17,11,5,7,5,4,24,16.7,20,35,8,27,9,26,39,0,"FW,MF",25-29,Forward,Italy,Europe
1921,João Pedro,ITA,Cagliari,Serie A,2019,27.0,1992.0,35.0,17,11,5,7,5,4,24,16.7,20,35,8,27,9,26,39,0,"FW,MF",25-29,Forward,Italy,Europe
1921,João Pedro,ITA,Cagliari,Serie A,2019,27.0,1992.0,35.0,17,11,5,7,5,4,24,16.7,20,35,8,27,9,26,39,0,"FW,MF",25-29,Forward,Italy,Europe
1921,João Pedro,ITA,Cagliari,Serie A,2019,27.0,1992.0,35.0,17,11,5,7,5,4,24,16.7,20,35,8,27,9,26,39,0,"FW,MF",25-29,Forward,Italy,Europe
1923,Daouda Peeters,BEL,Juventus,Serie A,2019,20.0,1999.0,0.2,1,0,0,1,0,1,1,100.0,0,0,0,0,0,1,0,0,MF,20-24,Midfielder,Belgium,Europe
1924,Jordan Pefok,USA,Rennes,Ligue 1,2019,23.0,1996.0,4.9,7,6,1,4,2,0,2,0.0,2,3,0,3,1,8,2,0,FW,20-24,Forward,United States,North America
1925,Gianluca Pegolo,ITA,Sassuolo,Serie A,2019,38.0,1981.0,5.0,0,0,0,0,0,0,0,,0,0,0,0,0,0,4,0,GK,35-39,Goalkeeper,Italy,Europe
1926,Peter Pekarík,SVK,Hertha BSC,Bundesliga,2019,32.0,1986.0,8.5,14,7,7,3,4,8,20,40.0,12,11,4,7,7,21,31,0,"DF,FW",30-34,Defender,Slovakia,Europe
1927,Yohann Pelé,FRA,Marseille,Ligue 1,2019,36.0,1982.0,1.7,0,0,0,0,0,0,0,,0,0,0,0,0,0,0,0,GK,35-39,Goalkeeper,France,Europe
1928,Lorenzo Pellegrini,ITA,Roma,Serie A,2019,23.0,1996.0,23.3,30,13,9,13,8,12,33,36.4,21,28,0,28,15,45,18,0,MF,20-24,Midfielder,Italy,Europe
1929,Luca Pellegrini,ITA,Cagliari,Serie A,2019,20.0,1999.0,21.2,31,15,20,7,4,15,38,39.5,23,19,2,17,21,52,45,2,DF,20-24,Defender,Italy,Europe
1930,Théo Pellenard,FRA,Angers,Ligue 1,2019,25.0,1994.0,5.1,11,8,6,3,2,6,13,46.2,7,4,0,4,5,16,8,0,DF,25-29,Defender,France,Europe
1931,Andy Pelmard,FRA,Nice,Ligue 1,2019,19.0,2000.0,8.5,22,14,13,9,0,9,11,81.8,2,12,4,8,15,37,28,1,DF,Under 20,Defender,France,Europe
1932,Federico Peluso,ITA,Sassuolo,Serie A,2019,35.0,1984.0,16.8,19,16,8,8,3,8,9,88.9,1,14,9,5,22,41,58,1,DF,35-39,Defender,Italy,Europe
1934,Philipp Pentke,GER,Hoffenheim,Bundesliga,2019,34.0,1985.0,4.0,0,0,0,0,0,0,0,,0,0,0,0,0,0,2,0,GK,30-34,Goalkeeper,Germany,Europe
1935,Nicolas Pépé,CIV,Arsenal,Premier League,2019,24.0,1995.0,22.3,32,17,15,13,4,8,16,50.0,8,15,2,13,8,40,5,0,FW,20-24,Forward,Ivory Coast,Africa
1937,Andreas Pereira,BRA,Manchester Utd,Premier League,2019,23.0,1996.0,16.5,24,13,8,9,7,10,39,25.6,29,13,0,13,7,31,7,0,"MF,FW",20-24,Midfielder,Brazil,South America
1938,Mathias Pereira Lage,POR,Angers,Ligue 1,2019,22.0,1996.0,17.1,30,18,16,13,1,12,37,32.4,25,19,0,19,17,47,9,0,MF,20-24,Midfielder,Portugal,Europe
1939,Ricardo Pereira,POR,Leicester City,Premier League,2019,25.0,1993.0,28.0,119,68,65,36,18,53,106,50.0,53,38,6,32,49,168,86,0,DF,25-29,Defender,Portugal,Europe
1940,Gastón Pereiro,URU,Cagliari,Serie A,2019,24.0,1995.0,3.9,2,2,2,0,0,1,4,25.0,3,1,0,1,0,2,1,1,"MF,FW",20-24,Midfielder,Uruguay,South America
1941,Bruno Peres,BRA,Roma,Serie A,2019,29.0,1990.0,11.7,14,10,10,3,1,8,21,38.1,13,12,3,9,15,29,19,2,DF,25-29,Defender,Brazil,South America
1942,Roberto Pereyra,ARG,Watford,Premier League,2019,28.0,1991.0,18.3,20,8,11,7,2,9,28,32.1,19,21,0,21,14,34,12,1,"FW,MF",25-29,Forward,Argentina,South America
1952,Mattia Perin,ITA,Genoa,Serie A,2019,26.0,1992.0,21.0,1,1,1,0,0,1,1,100.0,0,1,0,1,0,1,5,1,GK,25-29,Goalkeeper,Italy,Europe
1953,Ivan Perišić,CRO,Bayern Munich,Bundesliga,2019,30.0,1989.0,13.4,16,12,5,6,5,8,33,24.2,25,14,3,11,4,20,8,0,"FW,MF",30-34,Forward,Croatia,Europe
1954,Diego Perotti,ARG,Roma,Serie A,2019,31.0,1988.0,9.7,16,13,5,8,3,5,20,25.0,15,14,0,14,3,19,6,0,"FW,MF",30-34,Forward,Argentina,South America
1955,Romain Perraud,FRA,Brest,Ligue 1,2019,21.0,1997.0,18.6,29,14,18,9,2,14,28,50.0,14,24,9,15,27,56,50,0,DF,20-24,Defender,France,Europe
1956,Loïc Perrin,FRA,Saint-Étienne,Ligue 1,2019,33.0,1985.0,19.0,27,20,16,11,0,11,14,78.6,3,23,17,6,39,66,59,0,DF,30-34,Defender,France,Europe
1957,Lucas Perrin,FRA,Marseille,Ligue 1,2019,20.0,1998.0,4.0,5,2,3,2,0,2,7,28.6,5,3,2,1,10,15,17,0,DF,20-24,Defender,France,Europe
1958,Pavao Pervan,AUT,Wolfsburg,Bundesliga,2019,31.0,1987.0,8.0,0,0,0,0,0,0,1,0.0,1,0,0,0,0,0,4,0,GK,30-34,Goalkeeper,Austria,Europe
1959,Matteo Pessina,ITA,Hellas Verona,Serie A,2019,22.0,1997.0,27.7,35,21,9,20,6,12,33,36.4,21,28,8,20,25,60,40,2,MF,20-24,Midfielder,Italy,Europe
1960,Andrea Petagna,ITA,SPAL,Serie A,2019,24.0,1995.0,33.7,9,4,2,7,0,3,17,17.6,14,11,5,6,1,10,27,0,FW,20-24,Forward,Italy,Europe
1961,Nils Petersen,GER,Freiburg,Bundesliga,2019,30.0,1988.0,27.1,19,14,7,9,3,10,28,35.7,18,32,6,26,10,29,67,0,"FW,MF",30-34,Forward,Germany,Europe
1962,Danijel Petković,MNE,Angers,Ligue 1,2019,26.0,1993.0,2.0,0,0,0,0,0,0,0,,0,0,0,0,0,0,2,0,GK,25-29,Goalkeeper,Montenegro,Europe
1964,Jacopo Petriccione,ITA,Lecce,Serie A,2019,24.0,1995.0,23.8,38,20,29,9,0,15,57,26.3,42,20,7,13,28,66,25,2,MF,20-24,Midfielder,Italy,Europe
1965,Germán Pezzella,ARG,Fiorentina,Serie A,2019,28.0,1991.0,31.4,36,18,26,9,1,14,32,43.8,18,31,20,11,55,91,134,1,DF,25-29,Defender,Argentina,South America
1966,Giuseppe Pezzella,ITA,Udinese,Serie A,2019,21.0,1997.0,0.9,0,0,0,0,0,0,0,,0,0,0,0,1,1,4,0,DF,20-24,Defender,Italy,Europe
1967,Giuseppe Pezzella,ITA,Parma,Serie A,2019,21.0,1997.0,10.5,20,12,17,3,0,11,19,57.9,8,13,9,4,6,26,30,0,DF,20-24,Defender,Italy,Europe
1968,Rayan Philippe,FRA,Dijon,Ligue 1,2019,18.0,2000.0,0.3,0,0,0,0,0,0,1,0.0,1,0,0,0,1,1,1,1,FW,Under 20,Forward,France,Europe
1969,Romain Philippoteaux,FRA,Nîmes,Ligue 1,2019,31.0,1988.0,22.2,23,12,11,11,1,9,43,20.9,34,22,1,21,13,36,10,0,"FW,MF",30-34,Forward,France,Europe
1972,Pablo Piatti,ARG,Espanyol,La Liga,2019,30.0,1989.0,0.6,2,2,1,1,0,1,2,50.0,1,1,0,1,0,2,1,0,"DF,MF",30-34,Defender,Argentina,South America
1973,Cristiano Piccini,ITA,Valencia,La Liga,2019,26.0,1992.0,0.8,5,4,1,0,4,4,4,100.0,0,0,0,0,2,7,1,0,DF,25-29,Defender,Italy,Europe
1974,Stefano Piccinini,ITA,Sassuolo,Serie A,2019,16.0,2002.0,0.1,0,0,0,0,0,0,0,,0,0,0,0,0,0,0,0,DF,Under 20,Defender,Italy,Europe
1975,Roberto Piccoli,ITA,Atalanta,Serie A,2019,18.0,2001.0,0.2,0,0,0,0,0,0,0,,0,1,0,1,0,0,0,0,FW,Under 20,Forward,Italy,Europe
1976,Jordan Pickford,ENG,Everton,Premier League,2019,25.0,1994.0,38.0,0,0,0,0,0,0,4,0.0,4,0,0,0,3,3,12,6,GK,25-29,Goalkeeper,England,Europe
1977,Jérémy Pied,FRA,Lille,Ligue 1,2019,30.0,1989.0,5.0,18,10,6,11,1,11,16,68.8,5,8,0,8,7,25,10,0,DF,30-34,Defender,France,Europe
1978,Ronaël Pierre-Gabriel,FRA,Mainz 05,Bundesliga,2019,21.0,1998.0,6.4,16,10,9,6,1,7,13,53.8,6,7,0,7,8,24,31,1,DF,20-24,Defender,France,Europe
1979,Brandon Pierrick,ENG,Crystal Palace,Premier League,2019,17.0,2001.0,0.2,0,0,0,0,0,0,0,,0,0,0,0,0,0,1,0,"MF,FW",Under 20,Midfielder,England,Europe
1980,Erik Pieters,NED,Burnley,Premier League,2019,30.0,1988.0,20.9,54,32,18,29,7,28,69,40.6,41,30,4,26,28,82,60,1,"DF,MF",30-34,Defender,Netherlands,Europe
1982,Andrea Pinamonti,ITA,Genoa,Serie A,2019,20.0,1999.0,24.8,19,12,1,7,11,5,25,20.0,20,19,2,17,9,28,25,0,FW,20-24,Forward,Italy,Europe
1983,Simone Pinna,ITA,Cagliari,Serie A,2019,21.0,1997.0,1.0,1,1,0,1,0,0,0,,0,3,1,2,5,6,4,1,DF,20-24,Defender,Italy,Europe
1984,Carlo Pinsoglio,ITA,Juventus,Serie A,2019,29.0,1990.0,0.2,0,0,0,0,0,0,0,,0,0,0,0,0,0,0,0,GK,25-29,Goalkeeper,Italy,Europe
1987,Lorenzo Pirola,ITA,Inter,Serie A,2019,17.0,2002.0,0.1,0,0,0,0,0,0,0,,0,0,0,0,1,1,0,0,DF,Under 20,Defender,Italy,Europe
1988,Fabio Pisacane,ITA,Cagliari,Serie A,2019,33.0,1986.0,27.1,32,21,22,10,0,21,37,56.8,16,36,28,8,27,59,110,2,DF,30-34,Defender,Italy,Europe
1990,Claudio Pizarro,PER,Werder Bremen,Bundesliga,2019,40.0,1978.0,2.6,2,1,0,1,1,0,1,0.0,1,2,0,2,2,4,2,0,"FW,MF",Over 40,Forward,Peru,South America
1991,Miralem Pjanić,BIH,Juventus,Serie A,2019,29.0,1990.0,25.3,46,21,16,23,7,21,63,33.3,42,29,12,17,32,78,30,0,MF,25-29,Midfielder,Bosnia and Herzegovina,Europe
1993,Marvin Plattenhardt,GER,Hertha BSC,Bundesliga,2019,27.0,1992.0,15.5,18,12,13,4,1,12,17,70.6,5,18,7,11,11,29,47,0,DF,25-29,Defender,Germany,Europe
1994,Alassane Pléa,FRA,Gladbach,Bundesliga,2019,26.0,1993.0,23.8,16,7,5,6,5,8,28,28.6,20,21,2,19,9,25,7,0,FW,25-29,Forward,France,Europe
1995,Thomas Pledl,GER,Düsseldorf,Bundesliga,2019,25.0,1994.0,1.0,4,2,2,2,0,0,1,0.0,1,0,0,0,0,4,1,0,"MF,FW",25-29,Midfielder,Germany,Europe
1996,Daniel Podence,POR,Wolves,Premier League,2019,23.0,1995.0,3.2,3,3,2,0,1,0,2,0.0,2,4,1,3,2,5,1,0,"FW,MF",20-24,Forward,Portugal,Europe
1997,Paul Pogba,FRA,Manchester Utd,Premier League,2019,26.0,1993.0,13.4,20,9,8,8,4,8,16,50.0,8,12,4,8,7,27,10,2,MF,25-29,Midfielder,France,Europe
1998,Joel Pohjanpalo,FIN,Leverkusen,Bundesliga,2019,24.0,1994.0,0.0,0,0,0,0,0,0,0,,0,0,0,0,0,0,0,0,MF,20-24,Midfielder,Finland,Europe
1999,Andrea Poli,ITA,Bologna,Serie A,2019,29.0,1989.0,21.3,44,24,19,21,4,16,52,30.8,36,19,3,16,40,84,11,0,MF,25-29,Midfielder,Italy,Europe
2000,Matteo Politano,ITA,Napoli,Serie A,2019,25.0,1993.0,8.3,12,6,8,2,2,5,14,35.7,9,6,0,6,5,17,3,0,FW,25-29,Forward,Italy,Europe
2001,Matteo Politano,ITA,Inter,Serie A,2019,25.0,1993.0,2.9,0,0,0,0,0,0,2,0.0,2,1,0,1,0,0,1,0,"FW,MF",25-29,Forward,Italy,Europe
2002,Sebastian Polter,GER,Union Berlin,Bundesliga,2019,28.0,1991.0,3.7,2,2,0,1,1,1,3,33.3,2,2,0,2,1,3,1,0,FW,25-29,Forward,Germany,Europe
2003,Marin Pongračić,CRO,Wolfsburg,Bundesliga,2019,21.0,1997.0,10.3,14,9,11,2,1,9,10,90.0,1,11,7,4,19,33,21,1,DF,20-24,Defender,Croatia,Europe
2005,Nick Pope,ENG,Burnley,Premier League,2019,27.0,1992.0,38.0,1,1,1,0,0,1,2,50.0,1,0,0,0,3,4,15,3,GK,25-29,Goalkeeper,England,Europe
2009,Stefan Posch,AUT,Hoffenheim,Bundesliga,2019,22.0,1997.0,25.6,63,34,35,27,1,35,63,55.6,28,57,25,32,40,103,101,1,DF,20-24,Defender,Austria,Europe
2012,Yussuf Poulsen,DEN,RB Leipzig,Bundesliga,2019,25.0,1994.0,13.6,14,10,2,10,2,4,21,19.0,17,12,0,12,4,18,15,0,FW,25-29,Forward,Denmark,Europe
2013,Maxime Poundjé,FRA,Bordeaux,Ligue 1,2019,26.0,1992.0,0.0,0,0,0,0,0,0,0,,0,0,0,0,0,0,0,0,DF,25-29,Defender,France,Europe
2017,Percy Prado,PER,Nantes,Ligue 1,2019,23.0,1996.0,2.1,6,5,3,2,1,5,9,55.6,4,1,0,1,1,7,5,0,DF,20-24,Defender,Peru,South America
2018,Dennis Praet,BEL,Leicester City,Premier League,2019,25.0,1994.0,12.6,33,18,8,21,4,9,29,31.0,20,19,1,18,17,50,12,0,MF,25-29,Midfielder,Belgium,Europe
2020,Sanjin Prcić,BIH,Strasbourg,Ligue 1,2019,25.0,1993.0,0.9,1,0,0,0,1,1,2,50.0,1,1,1,0,1,2,0,0,"MF,FW",25-29,Midfielder,Bosnia and Herzegovina,Europe
2021,Nicolas de Préville,FRA,Bordeaux,Ligue 1,2019,28.0,1991.0,22.2,35,21,9,22,4,18,56,32.1,38,15,3,12,6,41,19,0,"MF,FW",25-29,Midfielder,France,Europe
2022,Sebastian Prödl,AUT,Watford,Premier League,2019,32.0,1987.0,0.6,0,0,0,0,0,0,0,,0,0,0,0,0,0,4,0,DF,30-34,Defender,Austria,Europe
2023,Kai Pröger,GER,Paderborn 07,Bundesliga,2019,27.0,1992.0,23.1,43,22,21,17,5,17,58,29.3,41,34,6,28,14,57,20,1,"MF,FW",25-29,Midfielder,Germany,Europe
2024,Grischa Prömel,GER,Union Berlin,Bundesliga,2019,24.0,1995.0,10.3,14,11,6,6,2,7,19,36.8,12,10,2,8,14,28,9,0,MF,20-24,Midfielder,Germany,Europe
2025,Davy Pröpper,NED,Brighton,Premier League,2019,27.0,1991.0,31.4,64,35,28,28,8,23,74,31.1,51,27,8,19,38,102,36,4,MF,25-29,Midfielder,Netherlands,Europe
2028,Teemu Pukki,FIN,Norwich City,Premier League,2019,29.0,1990.0,32.1,12,6,3,5,4,1,23,4.3,22,13,0,13,6,18,7,0,FW,25-29,Forward,Finland,Europe
2029,Erick Pulgar,CHI,Fiorentina,Serie A,2019,25.0,1994.0,32.8,73,46,25,41,7,22,96,22.9,74,45,15,30,49,122,53,1,MF,25-29,Midfielder,Chile,South America
2030,Christian Pulisic,USA,Chelsea,Premier League,2019,20.0,1998.0,19.1,23,11,13,4,6,7,24,29.2,17,15,0,15,6,29,11,0,FW,20-24,Forward,United States,North America
2031,Ignacio Pussetto,ARG,Watford,Premier League,2019,23.0,1995.0,0.8,7,4,4,2,1,3,8,37.5,5,2,1,1,3,10,4,0,"FW,MF",20-24,Forward,Argentina,South America
2032,Ignacio Pussetto,ARG,Udinese,Serie A,2019,23.0,1995.0,3.8,8,4,4,3,1,1,4,25.0,3,3,0,3,4,12,7,0,"FW,MF",20-24,Forward,Argentina,South America
2033,Fabio Quagliarella,ITA,Sampdoria,Serie A,2019,36.0,1983.0,25.3,9,5,0,6,3,2,30,6.7,28,13,0,13,8,17,15,0,FW,35-39,Forward,Italy,Europe
2034,Robin Quaison,SWE,Mainz 05,Bundesliga,2019,25.0,1993.0,28.9,25,17,15,7,3,11,32,34.4,21,27,5,22,11,36,8,0,"FW,MF",25-29,Forward,Sweden,Europe
2035,Domingos Quina,POR,Watford,Premier League,2019,19.0,1999.0,0.2,2,0,1,1,0,1,2,50.0,1,3,0,3,0,2,0,0,"MF,FW",Under 20,Midfielder,Portugal,Europe
2039,Adrien Rabiot,FRA,Juventus,Serie A,2019,24.0,1995.0,21.2,47,31,16,19,12,15,41,36.6,26,36,6,30,32,79,19,0,MF,20-24,Midfielder,France,Europe
2043,Ionuț Radu,ROU,Genoa,Serie A,2019,22.0,1997.0,17.0,0,0,0,0,0,0,2,0.0,2,0,0,0,1,1,7,1,GK,20-24,Goalkeeper,Romania,Europe
2044,Ștefan Radu,ROU,Lazio,Serie A,2019,32.0,1986.0,25.6,43,25,24,15,4,28,43,65.1,15,19,9,10,34,77,85,0,DF,30-34,Defender,Romania,Europe
2046,Rafael,BRA,Cagliari,Serie A,2019,37.0,1982.0,5.0,0,0,0,0,0,0,0,,0,0,0,0,0,0,3,0,GK,35-39,Goalkeeper,Brazil,South America
2046,Rafael,BRA,Cagliari,Serie A,2019,37.0,1982.0,5.0,0,0,0,0,0,0,0,,0,0,0,0,0,0,3,0,GK,35-39,Goalkeeper,Brazil,South America
2046,Rafael,BRA,Cagliari,Serie A,2019,37.0,1982.0,5.0,0,0,0,0,0,0,0,,0,0,0,0,0,0,3,0,GK,35-39,Goalkeeper,Brazil,South America
2046,Rafael,BRA,Cagliari,Serie A,2019,37.0,1982.0,5.0,0,0,0,0,0,0,0,,0,0,0,0,0,0,3,0,GK,35-39,Goalkeeper,Brazil,South America
2047,Rafael,BRA,Lyon,Ligue 1,2019,29.0,1990.0,7.8,24,16,12,8,4,10,18,55.6,8,6,3,3,10,34,14,0,DF,25-29,Defender,Brazil,South America
2047,Rafael,BRA,Lyon,Ligue 1,2019,29.0,1990.0,7.8,24,16,12,8,4,10,18,55.6,8,6,3,3,10,34,14,0,DF,25-29,Defender,Brazil,South America
2047,Rafael,BRA,Lyon,Ligue 1,2019,29.0,1990.0,7.8,24,16,12,8,4,10,18,55.6,8,6,3,3,10,34,14,0,DF,25-29,Defender,Brazil,South America
2047,Rafael,BRA,Lyon,Ligue 1,2019,29.0,1990.0,7.8,24,16,12,8,4,10,18,55.6,8,6,3,3,10,34,14,0,DF,25-29,Defender,Brazil,South America
2048,Raffael,BRA,Gladbach,Bundesliga,2019,34.0,1985.0,0.7,0,0,0,0,0,0,2,0.0,2,2,0,2,0,0,0,0,"MF,FW",30-34,Midfielder,Brazil,South America
14,Antonio Adán,ESP,Atlético Madrid,La Liga,2019,32.0,1987.0,0.3,0,0,0,0,0,0,0,,0,0,0,0,0,0,0,0,GK,30-34,Goalkeeper,Spain,Europe
19,Adrián,ESP,Liverpool,Premier League,2019,32.0,1987.0,9.7,1,1,1,0,0,1,1,100.0,0,0,0,0,0,1,8,3,GK,30-34,Goalkeeper,Spain,Europe
20,Aritz Aduriz,ESP,Athletic Club,La Liga,2019,38.0,1981.0,2.3,3,2,0,3,0,0,0,,0,0,0,0,0,3,2,0,"FW,MF",35-39,Forward,Spain,Europe
22,Martin Agirregabiria,ESP,Alavés,La Liga,2019,23.0,1996.0,23.3,55,30,32,18,5,30,54,55.6,24,19,7,12,18,73,48,0,DF,20-24,Defender,Spain,Europe
45,Jordi Alba,ESP,Barcelona,La Liga,2019,30.0,1989.0,24.3,20,13,9,7,4,6,27,22.2,21,12,3,9,37,57,40,0,DF,30-34,Defender,Spain,Europe
46,Luis Alberto,ESP,Lazio,Serie A,2019,26.0,1992.0,34.6,50,30,21,19,10,27,82,32.9,55,32,1,31,21,71,9,1,MF,25-29,Midfielder,Spain,Europe
47,Raúl Albiol,ESP,Villarreal,La Liga,2019,33.0,1985.0,36.0,43,23,27,16,0,18,27,66.7,9,29,21,8,42,85,175,2,DF,30-34,Defender,Spain,Europe
49,Paco Alcácer,ESP,Villarreal,La Liga,2019,25.0,1993.0,10.3,3,3,2,1,0,1,7,14.3,6,4,1,3,2,5,10,0,FW,25-29,Forward,Spain,Europe
50,Paco Alcácer,ESP,Dortmund,Bundesliga,2019,25.0,1993.0,5.9,2,2,0,2,0,1,5,20.0,4,4,1,3,2,4,3,0,FW,25-29,Forward,Spain,Europe
51,Thiago Alcántara,ESP,Bayern Munich,Bundesliga,2019,28.0,1991.0,19.7,45,26,17,23,5,12,33,36.4,21,12,3,9,45,90,13,1,MF,25-29,Midfielder,Spain,Europe
52,Rubén Alcaraz,ESP,Valladolid,La Liga,2019,28.0,1991.0,21.4,61,30,37,20,4,30,63,47.6,33,46,15,31,15,76,41,0,MF,25-29,Midfielder,Spain,Europe
54,Haitam Aleesami,NOR,Amiens,Ligue 1,2019,28.0,1991.0,21.3,36,16,25,9,2,18,43,41.9,25,33,10,23,34,70,59,1,DF,25-29,Defender,Norway,Europe
55,Álex Alegría,ESP,Mallorca,La Liga,2019,26.0,1992.0,1.2,1,0,1,0,0,0,0,,0,2,0,2,0,1,0,0,FW,25-29,Forward,Spain,Europe
56,Carles Aleñá,ESP,Barcelona,La Liga,2019,21.0,1998.0,1.9,2,1,1,1,0,1,4,25.0,3,1,0,1,0,2,0,0,MF,20-24,Midfielder,Spain,Europe
57,Carles Aleñá,ESP,Betis,La Liga,2019,21.0,1998.0,8.2,14,9,5,7,2,3,17,17.6,14,4,1,3,1,15,3,0,"MF,FW",20-24,Midfielder,Spain,Europe
66,Marcos Alonso,ESP,Chelsea,Premier League,2019,28.0,1990.0,15.9,28,16,20,6,2,14,33,42.4,19,18,2,16,20,48,32,0,DF,25-29,Defender,Spain,Europe
68,Sergio Álvarez,ESP,Eibar,La Liga,2019,27.0,1992.0,12.7,37,22,11,24,2,8,24,33.3,16,16,2,14,17,54,26,1,"MF,DF",25-29,Midfielder,Spain,Europe
68,Sergio Álvarez,ESP,Eibar,La Liga,2019,27.0,1992.0,12.7,37,22,11,24,2,8,24,33.3,16,16,2,14,17,54,26,1,"MF,DF",25-29,Midfielder,Spain,Europe
68,Sergio Álvarez,ESP,Eibar,La Liga,2019,27.0,1992.0,12.7,37,22,11,24,2,8,24,33.3,16,16,2,14,17,54,26,1,"MF,DF",25-29,Midfielder,Spain,Europe
68,Sergio Álvarez,ESP,Eibar,La Liga,2019,27.0,1992.0,12.7,37,22,11,24,2,8,24,33.3,16,16,2,14,17,54,26,1,"MF,DF",25-29,Midfielder,Spain,Europe
69,Sergio Álvarez,ESP,Celta Vigo,La Liga,2019,32.0,1986.0,2.0,0,0,0,0,0,0,0,,0,0,0,0,0,0,1,0,GK,30-34,Goalkeeper,Spain,Europe
69,Sergio Álvarez,ESP,Celta Vigo,La Liga,2019,32.0,1986.0,2.0,0,0,0,0,0,0,0,,0,0,0,0,0,0,1,0,GK,30-34,Goalkeeper,Spain,Europe
69,Sergio Álvarez,ESP,Celta Vigo,La Liga,2019,32.0,1986.0,2.0,0,0,0,0,0,0,0,,0,0,0,0,0,0,1,0,GK,30-34,Goalkeeper,Spain,Europe
69,Sergio Álvarez,ESP,Celta Vigo,La Liga,2019,32.0,1986.0,2.0,0,0,0,0,0,0,0,,0,0,0,0,0,0,1,0,GK,30-34,Goalkeeper,Spain,Europe
70,Yeray Álvarez,ESP,Athletic Club,La Liga,2019,24.0,1995.0,31.2,36,19,28,7,1,17,30,56.7,13,33,22,11,62,98,138,2,DF,20-24,Defender,Spain,Europe
93,Miguel Ángel Guerrero,ESP,Leganés,La Liga,2019,29.0,1990.0,8.8,1,0,0,1,0,1,10,10.0,9,4,0,4,2,3,4,0,FW,25-29,Forward,Spain,Europe
94,José Ángel,ESP,Eibar,La Liga,2019,29.0,1989.0,26.2,54,31,26,25,3,26,43,60.5,17,23,7,16,33,87,61,1,DF,25-29,Defender,Spain,Europe
95,Miguel Ángel Moyá,ESP,Real Sociedad,La Liga,2019,35.0,1984.0,13.0,0,0,0,0,0,0,1,0.0,1,0,0,0,1,1,6,2,GK,35-39,Goalkeeper,Spain,Europe
96,Angeliño,ESP,Manchester City,Premier League,2019,22.0,1997.0,4.7,5,2,3,1,1,5,7,71.4,2,1,0,1,9,14,15,0,DF,20-24,Defender,Spain,Europe
97,Angeliño,ESP,RB Leipzig,Bundesliga,2019,22.0,1997.0,12.2,15,9,7,5,3,5,15,33.3,10,14,1,13,19,34,24,0,"DF,FW",20-24,Defender,Spain,Europe
103,Antoñito,ESP,Valladolid,La Liga,2019,31.0,1987.0,11.4,26,18,19,7,0,12,20,60.0,8,9,0,9,15,41,20,1,"DF,MF",30-34,Defender,Spain,Europe
117,Anaitz Arbilla,ESP,Eibar,La Liga,2019,32.0,1987.0,22.3,33,20,23,8,2,16,34,47.1,18,20,4,16,29,62,82,0,DF,30-34,Defender,Spain,Europe
123,José Arnaiz,ESP,Osasuna,La Liga,2019,24.0,1995.0,8.8,3,2,0,2,1,0,12,0.0,12,7,0,7,5,8,5,0,"FW,MF",20-24,Forward,Spain,Europe
124,José Arnaiz,ESP,Leganés,La Liga,2019,24.0,1995.0,3.7,3,0,1,2,0,2,5,40.0,3,4,0,4,2,5,1,0,MF,20-24,Midfielder,Spain,Europe
126,Kepa Arrizabalaga,ESP,Chelsea,Premier League,2019,24.0,1994.0,33.0,1,1,1,0,0,1,2,50.0,1,0,0,0,1,2,7,2,GK,20-24,Goalkeeper,Spain,Europe
129,Sergio Asenjo,ESP,Villarreal,La Liga,2019,30.0,1989.0,34.0,0,0,0,0,0,0,2,0.0,2,0,0,0,1,1,15,1,GK,30-34,Goalkeeper,Spain,Europe
130,Marco Asensio,ESP,Real Madrid,La Liga,2019,23.0,1996.0,3.7,4,3,3,1,0,1,4,25.0,3,2,0,2,1,5,4,0,FW,20-24,Forward,Spain,Europe
131,Kristoffer Askildsen,NOR,Sampdoria,Serie A,2019,18.0,2001.0,0.8,1,1,1,0,0,0,0,,0,1,0,1,1,2,0,0,MF,Under 20,Midfielder,Norway,Europe
132,Iago Aspas,ESP,Celta Vigo,La Liga,2019,31.0,1987.0,36.2,29,19,7,9,13,12,45,26.7,33,16,1,15,22,51,7,0,FW,30-34,Forward,Spain,Europe
135,Miguel Atienza,ESP,Eibar,La Liga,2019,20.0,1999.0,0.3,1,1,0,1,0,1,2,50.0,1,1,1,0,2,3,1,0,MF,20-24,Midfielder,Spain,Europe
145,Javier Avilés,ESP,Leganés,La Liga,2019,21.0,1997.0,2.0,9,7,2,7,0,2,4,50.0,2,3,0,3,3,12,1,0,"MF,FW",20-24,Midfielder,Spain,Europe
152,César Azpilicueta,ESP,Chelsea,Premier League,2019,29.0,1989.0,35.9,86,56,40,32,14,35,69,50.7,34,56,21,35,67,153,94,0,DF,25-29,Defender,Spain,Europe
161,Alex Baena,ESP,Villarreal,La Liga,2019,18.0,2001.0,0.2,0,0,0,0,0,0,0,,0,1,0,1,0,0,0,0,MF,Under 20,Midfielder,Spain,Europe
177,Mikel Balenziaga,ESP,Athletic Club,La Liga,2019,31.0,1988.0,6.3,15,10,4,10,1,9,11,81.8,2,4,1,3,2,17,20,0,DF,30-34,Defender,Spain,Europe
187,Antonín Barák,CZE,Udinese,Serie A,2019,24.0,1994.0,2.2,5,4,3,0,2,1,5,20.0,4,6,1,5,0,5,4,0,"MF,FW",20-24,Midfielder,Czech Republic,Europe
188,Antonín Barák,CZE,Lecce,Serie A,2019,24.0,1994.0,15.2,19,10,9,10,0,6,24,25.0,18,18,1,17,9,28,20,2,MF,20-24,Midfielder,Czech Republic,Europe
197,Kike Barja,ESP,Osasuna,La Liga,2019,22.0,1997.0,3.5,1,1,1,0,0,1,1,100.0,0,3,1,2,0,1,2,0,"MF,FW",20-24,Midfielder,Spain,Europe
202,Antonio Barragán,ESP,Betis,La Liga,2019,32.0,1987.0,7.1,7,5,4,2,1,3,6,50.0,3,2,2,0,8,15,22,0,DF,30-34,Defender,Spain,Europe
205,Ander Barrenetxea,ESP,Real Sociedad,La Liga,2019,17.0,2001.0,4.9,12,9,5,5,2,4,10,40.0,6,3,0,3,3,15,4,0,"FW,MF",Under 20,Forward,Spain,Europe
210,Marc Bartra,ESP,Betis,La Liga,2019,28.0,1991.0,28.0,62,34,39,23,0,27,54,50.0,27,45,24,21,35,97,127,0,"DF,MF",25-29,Defender,Spain,Europe
217,Borja Bastón,ESP,Aston Villa,Premier League,2019,26.0,1992.0,0.2,1,0,0,1,0,0,2,0.0,2,1,0,1,0,1,0,1,"MF,FW",25-29,Midfielder,Spain,Europe
227,Ihlas Bebou,TOG,Hoffenheim,Bundesliga,2019,25.0,1994.0,23.4,27,15,9,13,5,8,23,34.8,15,25,4,21,11,38,25,0,"FW,MF",25-29,Forward,Togo,Africa
231,Jan Bednarek,POL,Southampton,Premier League,2019,23.0,1996.0,34.0,65,38,41,18,6,31,61,50.8,30,44,23,21,77,142,198,4,DF,20-24,Defender,Poland,Europe
242,Héctor Bellerín,ESP,Arsenal,Premier League,2019,24.0,1995.0,12.9,20,13,7,11,2,11,29,37.9,18,20,4,16,19,39,27,1,"DF,MF",20-24,Defender,Spain,Europe
244,Fran Beltrán,ESP,Celta Vigo,La Liga,2019,20.0,1999.0,20.3,31,19,15,12,4,11,35,31.4,24,14,1,13,14,45,17,0,MF,20-24,Midfielder,Spain,Europe
271,Yuri Berchiche,ESP,Athletic Club,La Liga,2019,29.0,1990.0,31.7,48,35,32,15,1,21,40,52.5,19,26,4,22,30,78,73,1,DF,25-29,Defender,Spain,Europe
272,Álex Berenguer,ESP,Torino,Serie A,2019,24.0,1995.0,20.3,20,6,6,13,1,8,33,24.2,25,17,1,16,18,38,17,0,"MF,DF",20-24,Midfielder,Spain,Europe
273,Bartosz Bereszyński,POL,Sampdoria,Serie A,2019,27.0,1992.0,26.7,53,35,25,23,5,26,52,50.0,26,38,16,22,35,88,88,1,DF,25-29,Defender,Poland,Europe
275,Markel Bergara,ESP,Getafe,La Liga,2019,33.0,1986.0,0.8,0,0,0,0,0,0,0,,0,0,0,0,0,0,2,0,MF,30-34,Midfielder,Spain,Europe
276,Sander Berge,NOR,Sheffield Utd,Premier League,2019,21.0,1998.0,10.5,22,15,3,14,5,5,10,50.0,5,15,1,14,10,32,16,0,MF,20-24,Midfielder,Norway,Europe
278,Robert Berić,SVN,Saint-Étienne,Ligue 1,2019,28.0,1991.0,4.6,3,2,0,2,1,0,5,0.0,5,2,0,2,4,7,2,0,FW,25-29,Forward,Slovenia,Europe
282,Sergio Bermejo,ESP,Celta Vigo,La Liga,2019,21.0,1997.0,0.1,0,0,0,0,0,0,0,,0,0,0,0,0,0,0,0,"MF,FW",20-24,Midfielder,Spain,Europe
287,Juan Bernat,ESP,Paris S-G,Ligue 1,2019,26.0,1993.0,15.4,42,27,19,16,7,20,51,39.2,31,13,1,12,10,52,26,0,"DF,MF",25-29,Defender,Spain,Europe
294,Pedro Bigas,ESP,Eibar,La Liga,2019,28.0,1990.0,19.7,18,9,11,7,0,9,19,47.4,10,16,10,6,36,54,82,0,DF,25-29,Defender,Spain,Europe
300,Valter Birsa,SVN,Cagliari,Serie A,2019,32.0,1986.0,4.8,10,6,3,6,1,7,21,33.3,14,6,1,5,4,14,3,0,"MF,FW",30-34,Midfielder,Slovenia,Europe
306,Rubén Blanco,ESP,Celta Vigo,La Liga,2019,24.0,1995.0,32.9,1,1,1,0,0,1,1,100.0,0,0,0,0,0,1,14,1,GK,20-24,Goalkeeper,Spain,Europe
309,Alejandro Blesa,ESP,Levante,La Liga,2019,17.0,2002.0,0.0,0,0,0,0,0,0,1,0.0,1,0,0,0,0,0,0,0,MF,Under 20,Midfielder,Spain,Europe
358,Brandon,ESP,Osasuna,La Liga,2019,24.0,1995.0,4.5,5,3,1,3,1,0,5,0.0,5,4,0,4,0,5,1,0,FW,20-24,Forward,Spain,Europe
361,Darko Brašanac,SRB,Osasuna,La Liga,2019,27.0,1992.0,24.9,45,25,14,26,5,15,41,36.6,26,19,4,15,20,65,21,0,MF,25-29,Midfielder,Serbia,Europe
388,Burgui,ESP,Alavés,La Liga,2019,25.0,1993.0,0.2,0,0,0,0,0,0,0,,0,0,0,0,0,0,0,0,MF,25-29,Midfielder,Spain,Europe
394,Sergio Busquets,ESP,Barcelona,La Liga,2019,31.0,1988.0,27.6,80,44,23,43,14,41,71,57.7,30,36,5,31,44,124,24,2,MF,30-34,Midfielder,Spain,Europe
395,Unai Bustinza,ESP,Leganés,La Liga,2019,27.0,1992.0,29.8,66,40,40,19,7,32,53,60.4,21,30,9,21,65,131,77,0,DF,25-29,Defender,Spain,Europe
397,Marcin Bułka,POL,Paris S-G,Ligue 1,2019,19.0,1999.0,1.0,0,0,0,0,0,0,0,,0,0,0,0,0,0,0,0,GK,Under 20,Goalkeeper,Poland,Europe
404,Ariday Cabrera,ESP,Mallorca,La Liga,2019,30.0,1988.0,0.4,1,1,1,0,0,0,1,0.0,1,2,0,2,0,1,0,0,MF,30-34,Midfielder,Spain,Europe
420,Fernando Calero,ESP,Espanyol,La Liga,2019,23.0,1995.0,11.6,14,9,10,4,0,7,15,46.7,8,13,5,8,8,22,42,1,DF,20-24,Defender,Spain,Europe
424,José Callejón,ESP,Napoli,Serie A,2019,32.0,1987.0,24.1,13,9,3,7,3,9,25,36.0,16,15,3,12,10,23,14,1,"FW,MF",30-34,Forward,Spain,Europe
429,Víctor Camarasa,ESP,Crystal Palace,Premier League,2019,25.0,1994.0,0.1,0,0,0,0,0,0,0,,0,0,0,0,0,0,0,0,FW,25-29,Forward,Spain,Europe
430,Víctor Camarasa,ESP,Alavés,La Liga,2019,25.0,1994.0,14.4,18,10,5,10,3,7,18,38.9,11,8,3,5,15,33,12,0,MF,25-29,Midfielder,Spain,Europe
432,Sergio Camello,ESP,Atlético Madrid,La Liga,2019,18.0,2001.0,0.3,0,0,0,0,0,0,0,,0,0,0,0,0,0,0,0,FW,Under 20,Forward,Spain,Europe
433,José Campaña,ESP,Levante,La Liga,2019,26.0,1993.0,35.1,38,25,15,13,10,13,53,24.5,40,30,5,25,44,82,42,2,MF,25-29,Midfielder,Spain,Europe
434,Xisco Campos,ESP,Mallorca,La Liga,2019,37.0,1982.0,5.3,7,4,5,2,0,5,9,55.6,4,8,5,3,11,18,23,0,DF,35-39,Defender,Spain,Europe
435,Víctor Campuzano,ESP,Espanyol,La Liga,2019,22.0,1997.0,9.7,12,9,1,6,5,3,19,15.8,16,8,0,8,2,14,4,0,FW,20-24,Forward,Spain,Europe
438,Sergio Canales,ESP,Betis,La Liga,2019,28.0,1991.0,35.1,25,16,14,6,5,7,28,25.0,21,30,1,29,13,38,16,0,"MF,FW",25-29,Midfielder,Spain,Europe
443,Ander Capa,ESP,Athletic Club,La Liga,2019,27.0,1992.0,31.9,64,36,37,21,6,24,59,40.7,35,26,7,19,28,92,63,0,DF,25-29,Defender,Spain,Europe
452,Marc Cardona,ESP,Osasuna,La Liga,2019,24.0,1995.0,7.8,1,0,0,1,0,0,8,0.0,8,3,1,2,2,3,2,0,FW,20-24,Forward,Spain,Europe
459,Dani Carvajal,ESP,Real Madrid,La Liga,2019,27.0,1992.0,30.4,65,46,33,25,7,23,42,54.8,19,43,14,29,36,101,53,0,DF,25-29,Defender,Spain,Europe
468,Samu Castillejo,ESP,Milan,Serie A,2019,24.0,1995.0,13.4,24,15,10,11,3,9,42,21.4,33,17,2,15,24,48,5,0,"FW,MF",20-24,Forward,Spain,Europe
469,Jonny Castro,ESP,Wolves,Premier League,2019,25.0,1994.0,32.1,91,55,54,26,11,29,82,35.4,53,45,10,35,53,144,45,2,"MF,DF",25-29,Midfielder,Spain,Europe
474,Craig Cathcart,NIR,Watford,Premier League,2019,30.0,1989.0,27.6,41,26,25,15,1,10,24,41.7,14,19,16,3,25,66,136,1,DF,30-34,Defender,Northern Ireland,Europe
476,Santi Cazorla,ESP,Villarreal,La Liga,2019,34.0,1984.0,27.2,48,25,14,21,13,20,57,35.1,37,23,1,22,19,67,16,2,MF,30-34,Midfielder,Spain,Europe
477,Dani Ceballos,ESP,Arsenal,Premier League,2019,22.0,1996.0,18.8,45,23,26,14,5,18,61,29.5,43,14,3,11,32,77,16,1,MF,20-24,Midfielder,Spain,Europe
501,Chema,ESP,Getafe,La Liga,2019,27.0,1992.0,3.4,4,3,1,3,0,1,2,50.0,1,1,0,1,5,9,12,0,DF,25-29,Defender,Spain,Europe
515,Churripi,ESP,Valladolid,La Liga,2019,25.0,1994.0,2.7,1,1,1,0,0,1,1,100.0,0,0,0,0,0,1,2,0,GK,25-29,Goalkeeper,Spain,Europe
517,Per Ciljan Skjelbred,NOR,Hertha BSC,Bundesliga,2019,32.0,1987.0,18.1,50,30,18,29,3,17,41,41.5,24,14,3,11,23,73,17,0,MF,30-34,Midfielder,Norway,Europe
519,Thiago Cionek,POL,SPAL,Serie A,2019,33.0,1986.0,24.1,53,32,36,12,5,22,53,41.5,31,30,11,19,46,99,91,2,DF,30-34,Defender,Poland,Europe
527,Óscar Clemente,ESP,Atlético Madrid,La Liga,2019,20.0,1999.0,0.0,0,0,0,0,0,0,0,,0,1,0,1,0,0,0,0,MF,20-24,Midfielder,Spain,Europe
530,Carlos Clerc,ESP,Levante,La Liga,2019,27.0,1992.0,20.5,28,16,14,13,1,12,20,60.0,8,22,9,13,22,50,61,0,DF,25-29,Defender,Spain,Europe
535,Coke,ESP,Levante,La Liga,2019,32.0,1987.0,11.0,25,18,14,8,3,14,30,46.7,16,9,2,7,13,38,19,0,DF,30-34,Defender,Spain,Europe
537,Álex Collado,ESP,Barcelona,La Liga,2019,20.0,1999.0,0.1,0,0,0,0,0,0,0,,0,0,0,0,0,0,0,0,FW,20-24,Forward,Spain,Europe
554,Iñigo Córdoba,ESP,Athletic Club,La Liga,2019,22.0,1997.0,16.0,33,20,16,12,5,14,52,26.9,38,30,2,28,16,49,13,0,FW,20-24,Forward,Spain,Europe
564,Rober Correa,ESP,Eibar,La Liga,2019,26.0,1992.0,10.3,13,6,8,3,2,6,10,60.0,4,6,4,2,16,29,31,0,DF,25-29,Defender,Spain,Europe
567,Antonio Cortés,ESP,Granada,La Liga,2019,19.0,2000.0,2.0,1,1,0,1,0,0,1,0.0,1,0,0,0,0,1,2,0,"FW,MF",Under 20,Forward,Spain,Europe
569,Diego Costa,ESP,Atlético Madrid,La Liga,2019,30.0,1988.0,15.0,9,5,1,4,4,1,10,10.0,9,4,2,2,3,12,10,0,FW,30-34,Forward,Spain,Europe
569,Diego Costa,ESP,Atlético Madrid,La Liga,2019,30.0,1988.0,15.0,9,5,1,4,4,1,10,10.0,9,4,2,2,3,12,10,0,FW,30-34,Forward,Spain,Europe
569,Diego Costa,ESP,Atlético Madrid,La Liga,2019,30.0,1988.0,15.0,9,5,1,4,4,1,10,10.0,9,4,2,2,3,12,10,0,FW,30-34,Forward,Spain,Europe
569,Diego Costa,ESP,Atlético Madrid,La Liga,2019,30.0,1988.0,15.0,9,5,1,4,4,1,10,10.0,9,4,2,2,3,12,10,0,FW,30-34,Forward,Spain,Europe
571,Jaume Costa,ESP,Valencia,La Liga,2019,31.0,1988.0,15.4,27,23,17,8,2,14,28,50.0,14,11,6,5,24,51,52,1,DF,30-34,Defender,Spain,Europe
574,David Costas,ESP,Celta Vigo,La Liga,2019,24.0,1995.0,3.8,4,3,3,1,0,2,4,50.0,2,3,3,0,8,12,12,0,DF,20-24,Defender,Spain,Europe
590,Marc Cucurella,ESP,Getafe,La Liga,2019,21.0,1998.0,36.0,74,51,23,38,13,24,76,31.6,52,58,8,50,36,110,28,1,"MF,DF",20-24,Midfielder,Spain,Europe
591,Iván Cuéllar,ESP,Leganés,La Liga,2019,35.0,1984.0,27.0,0,0,0,0,0,0,2,0.0,2,0,0,0,0,0,28,2,GK,35-39,Goalkeeper,Spain,Europe
624,Sergi Darder,ESP,Espanyol,La Liga,2019,25.0,1993.0,29.5,47,23,11,26,10,17,58,29.3,41,30,1,29,24,71,23,1,MF,25-29,Midfielder,Spain,Europe
625,Vladimír Darida,CZE,Hertha BSC,Bundesliga,2019,28.0,1990.0,25.1,50,27,14,31,5,11,48,22.9,37,44,7,37,27,77,19,2,MF,25-29,Midfielder,Czech Republic,Europe
631,Paweł Dawidowicz,POL,Hellas Verona,Serie A,2019,24.0,1995.0,7.7,15,12,11,4,0,5,11,45.5,6,6,5,1,12,27,26,0,DF,20-24,Defender,Poland,Europe
659,Kévin Denkey,TOG,Nîmes,Ligue 1,2019,18.0,2000.0,6.7,10,5,1,8,1,6,10,60.0,4,7,0,7,2,12,1,1,FW,Under 20,Forward,Togo,Africa
666,Gerard Deulofeu,ESP,Watford,Premier League,2019,25.0,1994.0,23.3,33,16,18,9,6,12,59,20.3,47,10,0,10,25,58,6,0,FW,25-29,Forward,Spain,Europe
685,Víctor Díaz,ESP,Granada,La Liga,2019,31.0,1988.0,32.0,74,43,38,31,5,31,60,51.7,29,53,23,30,48,122,94,1,DF,30-34,Defender,Spain,Europe
700,Djené,TOG,Getafe,La Liga,2019,27.0,1991.0,34.0,42,32,27,15,0,17,30,56.7,13,20,7,13,34,76,105,1,DF,25-29,Defender,Togo,Africa
706,Marko Dmitrović,SRB,Eibar,La Liga,2019,27.0,1992.0,35.0,3,2,3,0,0,3,5,60.0,2,1,0,1,3,6,24,0,GK,25-29,Goalkeeper,Serbia,Europe
710,Jaume Doménech,ESP,Valencia,La Liga,2019,28.0,1990.0,14.7,0,0,0,0,0,0,1,0.0,1,0,0,0,1,1,3,1,GK,25-29,Goalkeeper,Spain,Europe
717,Mathieu Dossevi,TOG,Toulouse,Ligue 1,2019,31.0,1988.0,19.5,32,20,7,17,8,15,30,50.0,15,17,0,17,14,46,7,0,"MF,FW",30-34,Midfielder,Togo,Africa
727,Bartłomiej Drągowski,POL,Fiorentina,Serie A,2019,21.0,1997.0,31.0,0,0,0,0,0,0,1,0.0,1,0,0,0,3,3,8,1,GK,20-24,Goalkeeper,Poland,Europe
736,Rubén Duarte,ESP,Alavés,La Liga,2019,23.0,1995.0,29.6,61,32,30,28,3,34,60,56.7,26,30,8,22,47,108,71,0,DF,20-24,Defender,Spain,Europe
750,Hugo Duro,ESP,Getafe,La Liga,2019,19.0,1999.0,4.2,6,5,2,2,2,4,8,50.0,4,3,0,3,1,7,3,0,"FW,MF",Under 20,Forward,Spain,Europe
767,Aritz Elustondo,ESP,Real Sociedad,La Liga,2019,25.0,1994.0,16.8,28,17,19,8,1,13,23,56.5,10,21,8,13,15,43,67,0,DF,25-29,Defender,Spain,Europe
770,Adri Embarba,ESP,Espanyol,La Liga,2019,27.0,1992.0,15.2,37,22,16,16,5,16,33,48.5,17,28,4,24,16,53,11,0,"MF,FW",25-29,Midfielder,Spain,Europe
778,Sergi Enrich,ESP,Eibar,La Liga,2019,29.0,1990.0,20.7,17,6,4,8,5,4,21,19.0,17,16,2,14,9,26,12,0,FW,25-29,Forward,Spain,Europe
779,Javier Eraso,ESP,Leganés,La Liga,2019,29.0,1990.0,9.1,11,5,4,5,2,5,15,33.3,10,5,0,5,7,18,5,0,MF,25-29,Midfielder,Spain,Europe
783,Aarón Escandell,ESP,Granada,La Liga,2019,23.0,1995.0,3.0,1,1,1,0,0,1,1,100.0,0,0,0,0,0,1,0,0,GK,20-24,Goalkeeper,Spain,Europe
784,Sergio Escudero,ESP,Sevilla,La Liga,2019,29.0,1989.0,8.6,29,16,17,10,2,19,28,67.9,9,11,1,10,13,42,35,0,DF,25-29,Defender,Spain,Europe
787,Vicente Esquerdo,ESP,Valencia,La Liga,2019,20.0,1999.0,0.2,1,0,1,0,0,0,0,,0,1,0,1,0,1,1,0,"MF,FW",20-24,Midfielder,Spain,Europe
791,Beñat Etxebarria,ESP,Athletic Club,La Liga,2019,32.0,1987.0,4.4,6,1,2,3,1,2,13,15.4,11,6,1,5,4,10,6,0,MF,30-34,Midfielder,Spain,Europe
792,Xabier Etxeita,ESP,Getafe,La Liga,2019,31.0,1987.0,16.1,20,11,11,9,0,12,23,52.2,11,9,5,4,17,37,68,0,DF,30-34,Defender,Spain,Europe
794,Jonny Evans,NIR,Leicester City,Premier League,2019,31.0,1988.0,37.6,48,34,33,14,1,28,39,71.8,11,33,18,15,57,105,174,4,DF,30-34,Defender,Northern Ireland,Europe
795,Edu Expósito,ESP,Eibar,La Liga,2019,22.0,1996.0,25.7,52,28,12,31,9,18,49,36.7,31,20,6,14,31,83,18,1,MF,20-24,Midfielder,Spain,Europe
798,Łukasz Fabiański,POL,West Ham,Premier League,2019,34.0,1985.0,23.5,2,2,2,0,0,2,4,50.0,2,0,0,0,1,3,5,3,GK,30-34,Goalkeeper,Poland,Europe
801,Cesc Fàbregas,ESP,Monaco,Ligue 1,2019,32.0,1987.0,10.3,11,4,6,3,2,6,29,20.7,23,8,1,7,7,18,3,0,MF,30-34,Midfielder,Spain,Europe
802,Fabricio,ESP,Mallorca,La Liga,2019,31.0,1987.0,1.0,0,0,0,0,0,0,0,,0,0,0,0,0,0,0,1,GK,30-34,Goalkeeper,Spain,Europe
807,Eliseo Falcon,ESP,Levante,La Liga,2019,22.0,1997.0,0.8,0,0,0,0,0,0,0,,0,0,0,0,0,0,2,0,DF,20-24,Defender,Spain,Europe
810,Iago Falque,ESP,Torino,Serie A,2019,29.0,1990.0,1.1,0,0,0,0,0,0,1,0.0,1,1,0,1,0,0,0,0,"FW,MF",25-29,Forward,Spain,Europe
811,Iago Falque,ESP,Genoa,Serie A,2019,29.0,1990.0,5.8,7,3,1,4,2,4,8,50.0,4,7,0,7,1,8,4,0,MF,25-29,Midfielder,Spain,Europe
818,Ansu Fati,ESP,Barcelona,La Liga,2019,16.0,2002.0,11.4,16,8,4,7,5,5,15,33.3,10,14,1,13,8,24,3,0,FW,Under 20,Forward,Spain,Europe
822,Aleix Febas,ESP,Mallorca,La Liga,2019,23.0,1996.0,18.8,36,24,13,19,4,12,36,33.3,24,15,0,15,17,53,6,0,"MF,FW",20-24,Midfielder,Spain,Europe
824,Ljubomir Fejsa,SRB,Alavés,La Liga,2019,30.0,1988.0,8.7,19,13,8,10,1,6,23,26.1,17,8,1,7,6,25,13,0,MF,30-34,Midfielder,Serbia,Europe
831,Kiko Femenía,ESP,Watford,Premier League,2019,28.0,1991.0,24.9,68,38,49,17,2,43,80,53.8,37,16,2,14,36,104,49,0,DF,25-29,Defender,Spain,Europe
838,Aitor Fernández,ESP,Levante,La Liga,2019,28.0,1991.0,36.0,1,1,1,0,0,1,1,100.0,0,0,0,0,2,3,18,3,GK,25-29,Goalkeeper,Spain,Europe
838,Aitor Fernández,ESP,Levante,La Liga,2019,28.0,1991.0,36.0,1,1,1,0,0,1,1,100.0,0,0,0,0,2,3,18,3,GK,25-29,Goalkeeper,Spain,Europe
838,Aitor Fernández,ESP,Levante,La Liga,2019,28.0,1991.0,36.0,1,1,1,0,0,1,1,100.0,0,0,0,0,2,3,18,3,GK,25-29,Goalkeeper,Spain,Europe
838,Aitor Fernández,ESP,Levante,La Liga,2019,28.0,1991.0,36.0,1,1,1,0,0,1,1,100.0,0,0,0,0,2,3,18,3,GK,25-29,Goalkeeper,Spain,Europe
839,Andrés Fernández,ESP,Villarreal,La Liga,2019,32.0,1986.0,4.0,0,0,0,0,0,0,0,,0,0,0,0,0,0,2,0,GK,30-34,Goalkeeper,Spain,Europe
840,Carlos Fernández,ESP,Granada,La Liga,2019,23.0,1996.0,24.5,24,15,7,11,6,3,32,9.4,29,25,2,23,11,35,30,0,"FW,MF",20-24,Forward,Spain,Europe
843,Joaquín Fernández,ESP,Valladolid,La Liga,2019,23.0,1996.0,18.4,30,24,17,10,3,9,30,30.0,21,14,10,4,32,62,57,0,"MF,DF",20-24,Midfielder,Spain,Europe
843,Joaquín Fernández,ESP,Valladolid,La Liga,2019,23.0,1996.0,18.4,30,24,17,10,3,9,30,30.0,21,14,10,4,32,62,57,0,"MF,DF",20-24,Midfielder,Spain,Europe
843,Joaquín Fernández,ESP,Valladolid,La Liga,2019,23.0,1996.0,18.4,30,24,17,10,3,9,30,30.0,21,14,10,4,32,62,57,0,"MF,DF",20-24,Midfielder,Spain,Europe
843,Joaquín Fernández,ESP,Valladolid,La Liga,2019,23.0,1996.0,18.4,30,24,17,10,3,9,30,30.0,21,14,10,4,32,62,57,0,"MF,DF",20-24,Midfielder,Spain,Europe
868,Pablo Fornals,ESP,West Ham,Premier League,2019,23.0,1996.0,24.1,46,28,21,18,7,19,64,29.7,45,35,1,34,25,71,15,0,"MF,FW",20-24,Midfielder,Spain,Europe
890,Jorge de Frutos,ESP,Valladolid,La Liga,2019,22.0,1997.0,0.7,2,2,2,0,0,1,2,50.0,1,0,0,0,0,2,1,0,"MF,DF",20-24,Midfielder,Spain,Europe
899,Ruben Gabrielsen,NOR,Toulouse,Ligue 1,2019,27.0,1992.0,7.3,3,2,3,0,0,2,4,50.0,2,5,3,2,8,11,41,0,DF,25-29,Defender,Norway,Europe
900,Mijat Gaćinović,SRB,Eint Frankfurt,Bundesliga,2019,24.0,1995.0,11.6,19,11,7,8,4,6,25,24.0,19,26,2,24,15,34,6,0,"MF,FW",20-24,Midfielder,Serbia,Europe
906,Enric Gallego,ESP,Osasuna,La Liga,2019,32.0,1986.0,9.8,9,5,1,5,3,0,4,0.0,4,10,2,8,4,13,8,0,FW,30-34,Forward,Spain,Europe
907,Enric Gallego,ESP,Getafe,La Liga,2019,32.0,1986.0,1.8,3,1,1,1,1,2,4,50.0,2,2,0,2,2,5,1,0,FW,30-34,Forward,Spain,Europe
909,Fran Gámez,ESP,Mallorca,La Liga,2019,28.0,1991.0,19.6,64,42,32,27,5,33,74,44.6,41,31,11,20,29,93,41,0,DF,25-29,Defender,Spain,Europe
913,Dani García,ESP,Athletic Club,La Liga,2019,29.0,1990.0,33.7,59,30,30,27,2,30,86,34.9,56,25,7,18,52,111,56,1,MF,25-29,Midfielder,Spain,Europe
914,David García,ESP,Osasuna,La Liga,2019,25.0,1994.0,31.0,28,16,15,12,1,14,31,45.2,17,20,16,4,48,76,123,2,DF,25-29,Defender,Spain,Europe
914,David García,ESP,Osasuna,La Liga,2019,25.0,1994.0,31.0,28,16,15,12,1,14,31,45.2,17,20,16,4,48,76,123,2,DF,25-29,Defender,Spain,Europe
914,David García,ESP,Osasuna,La Liga,2019,25.0,1994.0,31.0,28,16,15,12,1,14,31,45.2,17,20,16,4,48,76,123,2,DF,25-29,Defender,Spain,Europe
914,David García,ESP,Osasuna,La Liga,2019,25.0,1994.0,31.0,28,16,15,12,1,14,31,45.2,17,20,16,4,48,76,123,2,DF,25-29,Defender,Spain,Europe
915,Eric García,ESP,Manchester City,Premier League,2019,18.0,2001.0,8.8,6,1,4,2,0,5,9,55.6,4,2,0,2,18,24,33,0,DF,Under 20,Defender,Spain,Europe
916,Javi García,ESP,Betis,La Liga,2019,32.0,1987.0,4.2,2,2,2,0,0,2,3,66.7,1,1,0,1,4,6,15,0,MF,30-34,Midfielder,Spain,Europe
917,Manu García,ESP,Alavés,La Liga,2019,33.0,1986.0,21.9,46,23,11,31,4,17,72,23.6,55,28,12,16,28,74,32,1,MF,30-34,Midfielder,Spain,Europe
917,Manu García,ESP,Alavés,La Liga,2019,33.0,1986.0,21.9,46,23,11,31,4,17,72,23.6,55,28,12,16,28,74,32,1,MF,30-34,Midfielder,Spain,Europe
917,Manu García,ESP,Alavés,La Liga,2019,33.0,1986.0,21.9,46,23,11,31,4,17,72,23.6,55,28,12,16,28,74,32,1,MF,30-34,Midfielder,Spain,Europe
917,Manu García,ESP,Alavés,La Liga,2019,33.0,1986.0,21.9,46,23,11,31,4,17,72,23.6,55,28,12,16,28,74,32,1,MF,30-34,Midfielder,Spain,Europe
918,Raúl García,ESP,Valladolid,La Liga,2019,30.0,1989.0,11.2,20,12,11,7,2,9,22,40.9,13,12,2,10,8,28,30,0,"DF,MF",30-34,Defender,Spain,Europe
918,Raúl García,ESP,Valladolid,La Liga,2019,30.0,1989.0,11.2,20,12,11,7,2,9,22,40.9,13,12,2,10,8,28,30,0,"DF,MF",30-34,Defender,Spain,Europe
918,Raúl García,ESP,Valladolid,La Liga,2019,30.0,1989.0,11.2,20,12,11,7,2,9,22,40.9,13,12,2,10,8,28,30,0,"DF,MF",30-34,Defender,Spain,Europe
918,Raúl García,ESP,Valladolid,La Liga,2019,30.0,1989.0,11.2,20,12,11,7,2,9,22,40.9,13,12,2,10,8,28,30,0,"DF,MF",30-34,Defender,Spain,Europe
919,Raúl García,ESP,Athletic Club,La Liga,2019,33.0,1986.0,31.9,57,37,19,26,12,16,76,21.1,60,46,6,40,24,81,44,0,"MF,FW",30-34,Midfielder,Spain,Europe
919,Raúl García,ESP,Athletic Club,La Liga,2019,33.0,1986.0,31.9,57,37,19,26,12,16,76,21.1,60,46,6,40,24,81,44,0,"MF,FW",30-34,Midfielder,Spain,Europe
919,Raúl García,ESP,Athletic Club,La Liga,2019,33.0,1986.0,31.9,57,37,19,26,12,16,76,21.1,60,46,6,40,24,81,44,0,"MF,FW",30-34,Midfielder,Spain,Europe
919,Raúl García,ESP,Athletic Club,La Liga,2019,33.0,1986.0,31.9,57,37,19,26,12,16,76,21.1,60,46,6,40,24,81,44,0,"MF,FW",30-34,Midfielder,Spain,Europe
920,Raúl García,ESP,Getafe,La Liga,2019,30.0,1989.0,2.7,5,3,2,3,0,3,6,50.0,3,3,1,2,4,9,10,0,DF,30-34,Defender,Spain,Europe
920,Raúl García,ESP,Getafe,La Liga,2019,30.0,1989.0,2.7,5,3,2,3,0,3,6,50.0,3,3,1,2,4,9,10,0,DF,30-34,Defender,Spain,Europe
920,Raúl García,ESP,Getafe,La Liga,2019,30.0,1989.0,2.7,5,3,2,3,0,3,6,50.0,3,3,1,2,4,9,10,0,DF,30-34,Defender,Spain,Europe
920,Raúl García,ESP,Getafe,La Liga,2019,30.0,1989.0,2.7,5,3,2,3,0,3,6,50.0,3,3,1,2,4,9,10,0,DF,30-34,Defender,Spain,Europe
921,Rubén García,ESP,Osasuna,La Liga,2019,26.0,1993.0,24.3,55,30,22,26,7,18,46,39.1,28,34,5,29,11,66,23,1,"MF,FW",25-29,Midfielder,Spain,Europe
921,Rubén García,ESP,Osasuna,La Liga,2019,26.0,1993.0,24.3,55,30,22,26,7,18,46,39.1,28,34,5,29,11,66,23,1,"MF,FW",25-29,Midfielder,Spain,Europe
921,Rubén García,ESP,Osasuna,La Liga,2019,26.0,1993.0,24.3,55,30,22,26,7,18,46,39.1,28,34,5,29,11,66,23,1,"MF,FW",25-29,Midfielder,Spain,Europe
921,Rubén García,ESP,Osasuna,La Liga,2019,26.0,1993.0,24.3,55,30,22,26,7,18,46,39.1,28,34,5,29,11,66,23,1,"MF,FW",25-29,Midfielder,Spain,Europe
922,Unai García,ESP,Osasuna,La Liga,2019,27.0,1992.0,6.0,9,6,4,4,1,5,9,55.6,4,13,9,4,8,17,31,0,DF,25-29,Defender,Spain,Europe
923,Víctor García,ESP,Valladolid,La Liga,2019,21.0,1997.0,1.0,0,0,0,0,0,0,1,0.0,1,1,0,1,0,0,1,0,"FW,MF",20-24,Forward,Spain,Europe
923,Víctor García,ESP,Valladolid,La Liga,2019,21.0,1997.0,1.0,0,0,0,0,0,0,1,0.0,1,1,0,1,0,0,1,0,"FW,MF",20-24,Forward,Spain,Europe
923,Víctor García,ESP,Valladolid,La Liga,2019,21.0,1997.0,1.0,0,0,0,0,0,0,1,0.0,1,1,0,1,0,0,1,0,"FW,MF",20-24,Forward,Spain,Europe
923,Víctor García,ESP,Valladolid,La Liga,2019,21.0,1997.0,1.0,0,0,0,0,0,0,1,0.0,1,1,0,1,0,0,1,0,"FW,MF",20-24,Forward,Spain,Europe
925,Manuel Garrido,ESP,Leganés,La Liga,2019,18.0,2000.0,1.3,0,0,0,0,0,0,6,0.0,6,3,1,2,1,1,0,0,FW,Under 20,Forward,Spain,Europe
926,Mario Gaspar,ESP,Villarreal,La Liga,2019,28.0,1990.0,21.8,35,20,16,16,3,15,31,48.4,16,25,10,15,26,61,69,0,DF,25-29,Defender,Spain,Europe
932,David de Gea,ESP,Manchester Utd,Premier League,2019,28.0,1990.0,38.0,0,0,0,0,0,0,0,,0,0,0,0,0,0,7,4,GK,25-29,Goalkeeper,Spain,Europe
933,Theodor Gebre Selassie,CZE,Werder Bremen,Bundesliga,2019,32.0,1986.0,27.0,36,27,23,10,3,17,35,48.6,18,26,9,17,63,99,81,0,"DF,MF",30-34,Defender,Czech Republic,Europe
949,Rafał Gikiewicz,POL,Union Berlin,Bundesliga,2019,31.0,1987.0,33.0,1,0,1,0,0,1,4,25.0,3,0,0,0,2,3,26,4,GK,30-34,Goalkeeper,Poland,Europe
950,Bryan Gil,ESP,Leganés,La Liga,2019,18.0,2001.0,6.2,8,4,3,4,1,1,8,12.5,7,6,0,6,3,11,1,0,"MF,FW",Under 20,Midfielder,Spain,Europe
951,Bryan Gil,ESP,Sevilla,La Liga,2019,18.0,2001.0,0.7,1,1,0,1,0,0,1,0.0,1,0,0,0,0,1,0,0,FW,Under 20,Forward,Spain,Europe
958,Kamil Glik,POL,Monaco,Ligue 1,2019,31.0,1988.0,23.0,26,14,15,11,0,13,21,61.9,8,23,17,6,27,53,118,0,DF,30-34,Defender,Poland,Europe
972,Ibai Gómez,ESP,Athletic Club,La Liga,2019,29.0,1989.0,7.7,5,3,2,2,1,3,8,37.5,5,4,0,4,3,8,6,0,FW,25-29,Forward,Spain,Europe
975,Moi Gómez,ESP,Villarreal,La Liga,2019,25.0,1994.0,25.8,30,22,9,14,7,11,33,33.3,22,22,2,20,25,55,23,0,"FW,MF",25-29,Forward,Spain,Europe
977,Sergi Gómez,ESP,Sevilla,La Liga,2019,27.0,1992.0,8.0,9,7,7,2,0,4,4,100.0,0,6,6,0,7,16,30,0,DF,25-29,Defender,Spain,Europe
978,Victor Gomez,ESP,Espanyol,La Liga,2019,19.0,2000.0,14.1,13,5,8,4,1,7,20,35.0,13,10,0,10,21,34,31,0,"DF,FW",Under 20,Defender,Spain,Europe
983,Álvaro González,ESP,Marseille,Ligue 1,2019,29.0,1990.0,18.1,19,13,14,4,1,9,13,69.2,4,7,4,3,18,37,65,0,DF,25-29,Defender,Spain,Europe
983,Álvaro González,ESP,Marseille,Ligue 1,2019,29.0,1990.0,18.1,19,13,14,4,1,9,13,69.2,4,7,4,3,18,37,65,0,DF,25-29,Defender,Spain,Europe
983,Álvaro González,ESP,Marseille,Ligue 1,2019,29.0,1990.0,18.1,19,13,14,4,1,9,13,69.2,4,7,4,3,18,37,65,0,DF,25-29,Defender,Spain,Europe
983,Álvaro González,ESP,Marseille,Ligue 1,2019,29.0,1990.0,18.1,19,13,14,4,1,9,13,69.2,4,7,4,3,18,37,65,0,DF,25-29,Defender,Spain,Europe
984,Bruno González,ESP,Getafe,La Liga,2019,29.0,1990.0,2.0,3,2,3,0,0,1,1,100.0,0,2,0,2,0,3,3,0,DF,25-29,Defender,Spain,Europe
985,Bruno González,ESP,Levante,La Liga,2019,29.0,1990.0,5.1,10,8,7,2,1,2,4,50.0,2,7,4,3,2,12,32,0,DF,25-29,Defender,Spain,Europe
986,Édgar González,ESP,Betis,La Liga,2019,22.0,1997.0,7.6,8,3,3,5,0,2,14,14.3,12,4,2,2,10,18,16,0,MF,20-24,Midfielder,Spain,Europe
987,Gonzalo,ESP,Levante,La Liga,2019,22.0,1997.0,0.1,1,0,0,1,0,0,0,,0,0,0,0,0,1,0,0,DF,20-24,Defender,Spain,Europe
990,Andoni Gorosabel,ESP,Real Sociedad,La Liga,2019,22.0,1996.0,7.9,14,8,9,3,2,10,20,50.0,10,13,1,12,13,27,21,0,DF,20-24,Defender,Spain,Europe
999,Esteban Granero,ESP,Espanyol,La Liga,2019,32.0,1987.0,5.3,10,4,5,3,2,5,11,45.5,6,3,2,1,2,12,5,0,MF,30-34,Midfielder,Spain,Europe
1016,Marko Grujić,SRB,Hertha BSC,Bundesliga,2019,23.0,1996.0,26.8,56,34,21,30,5,19,63,30.2,44,43,9,34,22,78,69,0,MF,20-24,Midfielder,Serbia,Europe
1017,Vicente Guaita,ESP,Crystal Palace,Premier League,2019,32.0,1987.0,35.0,1,1,1,0,0,1,2,50.0,1,0,0,0,0,1,18,3,GK,30-34,Goalkeeper,Spain,Europe
1019,Sergi Guardiola,ESP,Valladolid,La Liga,2019,28.0,1991.0,29.5,14,6,3,7,4,4,24,16.7,20,23,0,23,6,20,18,1,FW,25-29,Forward,Spain,Europe
1020,Nemanja Gudelj,SRB,Sevilla,La Liga,2019,27.0,1991.0,13.5,20,14,11,8,1,6,19,31.6,13,17,8,9,12,32,35,1,"MF,DF",25-29,Midfielder,Serbia,Europe
1024,Adrián Guerrero,ESP,Valencia,La Liga,2019,21.0,1998.0,1.4,2,2,1,1,0,2,3,66.7,1,0,0,0,2,4,1,0,DF,20-24,Defender,Spain,Europe
1025,Ander Guevara,ESP,Real Sociedad,La Liga,2019,22.0,1997.0,10.4,27,11,9,17,1,12,30,40.0,18,13,3,10,8,35,15,1,MF,20-24,Midfielder,Spain,Europe
1030,Hugo Guillamón,ESP,Valencia,La Liga,2019,19.0,2000.0,5.5,8,3,5,2,1,5,10,50.0,5,3,2,1,5,13,29,0,DF,Under 20,Defender,Spain,Europe
1044,Erling Haaland,NOR,Dortmund,Bundesliga,2019,19.0,2000.0,11.8,4,2,1,0,3,0,4,0.0,4,7,4,3,4,8,4,0,FW,Under 20,Forward,Norway,Europe
1054,Samir Handanović,SVN,Inter,Serie A,2019,35.0,1984.0,35.0,1,1,1,0,0,0,1,0.0,1,0,0,0,0,1,8,3,GK,35-39,Goalkeeper,Slovenia,Europe
1078,Mario Hermoso,ESP,Atlético Madrid,La Liga,2019,24.0,1995.0,13.5,15,8,12,2,1,11,20,55.0,9,11,5,6,12,27,61,0,DF,20-24,Defender,Spain,Europe
1079,Aridane Hernández,ESP,Osasuna,La Liga,2019,30.0,1989.0,29.0,35,23,22,13,0,15,19,78.9,4,24,15,9,34,69,137,2,DF,30-34,Defender,Spain,Europe
1082,Juan Hernández,ESP,Celta Vigo,La Liga,2019,24.0,1994.0,1.0,0,0,0,0,0,0,0,,0,0,0,0,1,1,0,0,"FW,MF",20-24,Forward,Spain,Europe
1084,Onel Hernández,CUB,Norwich City,Premier League,2019,26.0,1993.0,15.4,27,19,13,11,3,9,31,29.0,22,12,1,11,19,46,10,0,"FW,MF",25-29,Forward,Cuba,North America
1087,Ander Herrera,ESP,Paris S-G,Ligue 1,2019,29.0,1989.0,6.1,19,11,9,9,1,5,14,35.7,9,10,2,8,6,25,4,0,"MF,DF",25-29,Midfielder,Spain,Europe
1089,Sergio Herrera,ESP,Osasuna,La Liga,2019,26.0,1993.0,18.4,1,1,1,0,0,1,4,25.0,3,0,0,0,1,2,13,3,GK,25-29,Goalkeeper,Spain,Europe
1091,Iago Herrerín,ESP,Athletic Club,La Liga,2019,31.0,1988.0,4.7,0,0,0,0,0,0,0,,0,0,0,0,0,0,0,0,GK,30-34,Goalkeeper,Spain,Europe
1093,Pablo Hervías,ESP,Valladolid,La Liga,2019,26.0,1993.0,11.3,24,20,8,14,2,12,22,54.5,10,8,0,8,5,29,0,0,"MF,FW",25-29,Midfielder,Spain,Europe
1111,Josué Homawoo,TOG,Nantes,Ligue 1,2019,21.0,1997.0,0.5,6,2,3,3,0,2,2,100.0,0,3,2,1,2,8,2,0,DF,20-24,Defender,Togo,Africa
1131,Robert Ibáñez,ESP,Osasuna,La Liga,2019,26.0,1993.0,6.0,13,8,4,5,4,7,20,35.0,13,7,0,7,5,18,5,0,"MF,FW",25-29,Midfielder,Spain,Europe
1135,Vicente Iborra,ESP,Villarreal,La Liga,2019,31.0,1988.0,29.4,61,42,31,25,5,30,67,44.8,37,35,16,19,40,101,63,1,MF,30-34,Midfielder,Spain,Europe
1141,Borja Iglesias,ESP,Betis,La Liga,2019,26.0,1993.0,21.4,7,5,1,4,2,0,9,0.0,9,7,4,3,5,12,18,0,FW,25-29,Forward,Spain,Europe
1148,Josip Iličić,SVN,Atalanta,Serie A,2019,31.0,1988.0,18.5,26,19,7,10,9,7,28,25.0,21,9,0,9,9,35,4,0,"FW,MF",30-34,Forward,Slovenia,Europe
1149,Asier Illarramendi,ESP,Real Sociedad,La Liga,2019,29.0,1990.0,2.4,2,2,1,0,1,2,6,33.3,4,2,1,1,5,7,6,0,MF,25-29,Midfielder,Spain,Europe
1161,Isco,ESP,Real Madrid,La Liga,2019,27.0,1992.0,13.1,13,9,2,10,1,5,14,35.7,9,9,0,9,7,20,4,1,"FW,MF",25-29,Forward,Spain,Europe
1163,Jakub Iskra,POL,SPAL,Serie A,2019,16.0,2002.0,0.9,0,0,0,0,0,0,0,,0,0,0,0,1,1,2,0,DF,Under 20,Defender,Poland,Europe
1164,Ismael,ESP,Betis,La Liga,2019,18.0,2000.0,0.9,2,1,1,1,0,1,2,50.0,1,2,1,1,2,4,2,0,MF,Under 20,Midfielder,Spain,Europe
1166,Ander Iturraspe,ESP,Espanyol,La Liga,2019,30.0,1989.0,2.7,2,0,1,1,0,2,5,40.0,3,0,0,0,1,3,7,0,MF,30-34,Midfielder,Spain,Europe
1169,Jacobo,ESP,Celta Vigo,La Liga,2019,22.0,1997.0,0.9,3,3,2,1,0,1,1,100.0,0,0,0,0,0,3,2,0,"DF,MF",20-24,Defender,Spain,Europe
1171,Filip Jagiełło,POL,Genoa,Serie A,2019,21.0,1997.0,6.1,7,2,0,3,4,3,7,42.9,4,4,0,4,5,12,4,0,MF,20-24,Midfielder,Poland,Europe
1180,Jakub Jankto,CZE,Sampdoria,Serie A,2019,23.0,1996.0,23.3,27,13,14,10,3,10,42,23.8,32,30,3,27,22,49,22,0,"MF,FW",20-24,Midfielder,Czech Republic,Europe
1185,Rune Jarstein,NOR,Hertha BSC,Bundesliga,2019,34.0,1984.0,28.3,4,1,4,0,0,2,3,66.7,1,0,0,0,1,5,11,3,GK,30-34,Goalkeeper,Norway,Europe
1186,Jason,ESP,Getafe,La Liga,2019,25.0,1994.0,13.1,29,20,8,16,5,15,33,45.5,18,18,3,15,18,47,9,0,MF,25-29,Midfielder,Spain,Europe
1187,Dennis Jastrzembski,POL,Paderborn 07,Bundesliga,2019,19.0,2000.0,2.0,2,0,1,1,0,0,1,0.0,1,3,0,3,3,5,0,0,"MF,FW",Under 20,Midfielder,Poland,Europe
1193,Jesé,ESP,Paris S-G,Ligue 1,2019,26.0,1993.0,0.0,0,0,0,0,0,0,0,,0,0,0,0,0,0,0,0,FW,25-29,Forward,Spain,Europe
1198,Joaquín,ESP,Betis,La Liga,2019,38.0,1981.0,22.9,14,7,4,8,2,4,11,36.4,7,10,2,8,15,29,22,1,"MF,FW",35-39,Midfielder,Spain,Europe
1206,Jony,ESP,Lazio,Serie A,2019,28.0,1991.0,13.1,13,9,7,4,2,5,23,21.7,18,11,2,9,14,27,17,0,"DF,FW",25-29,Defender,Spain,Europe
1207,Joan Jordán,ESP,Sevilla,La Liga,2019,25.0,1994.0,25.0,64,34,27,31,6,21,76,27.6,55,25,5,20,26,90,20,4,MF,25-29,Midfielder,Spain,Europe
1212,Joselu,ESP,Alavés,La Liga,2019,29.0,1990.0,30.9,26,17,4,12,10,4,32,12.5,28,36,5,31,13,39,46,0,FW,25-29,Forward,Spain,Europe
1213,Jota,ESP,Aston Villa,Premier League,2019,28.0,1991.0,3.7,3,1,2,0,1,2,5,40.0,3,1,0,1,3,6,6,0,"FW,MF",25-29,Forward,Spain,Europe
1213,Jota,ESP,Aston Villa,Premier League,2019,28.0,1991.0,3.7,3,1,2,0,1,2,5,40.0,3,1,0,1,3,6,6,0,"FW,MF",25-29,Forward,Spain,Europe
1213,Jota,ESP,Aston Villa,Premier League,2019,28.0,1991.0,3.7,3,1,2,0,1,2,5,40.0,3,1,0,1,3,6,6,0,"FW,MF",25-29,Forward,Spain,Europe
1213,Jota,ESP,Aston Villa,Premier League,2019,28.0,1991.0,3.7,3,1,2,0,1,2,5,40.0,3,1,0,1,3,6,6,0,"FW,MF",25-29,Forward,Spain,Europe
1213,Jota,ESP,Aston Villa,Premier League,2019,28.0,1991.0,3.7,3,1,2,0,1,2,5,40.0,3,1,0,1,3,6,6,0,"FW,MF",25-29,Forward,Spain,Europe
1213,Jota,ESP,Aston Villa,Premier League,2019,28.0,1991.0,3.7,3,1,2,0,1,2,5,40.0,3,1,0,1,3,6,6,0,"FW,MF",25-29,Forward,Spain,Europe
1213,Jota,ESP,Aston Villa,Premier League,2019,28.0,1991.0,3.7,3,1,2,0,1,2,5,40.0,3,1,0,1,3,6,6,0,"FW,MF",25-29,Forward,Spain,Europe
1213,Jota,ESP,Aston Villa,Premier League,2019,28.0,1991.0,3.7,3,1,2,0,1,2,5,40.0,3,1,0,1,3,6,6,0,"FW,MF",25-29,Forward,Spain,Europe
1213,Jota,ESP,Aston Villa,Premier League,2019,28.0,1991.0,3.7,3,1,2,0,1,2,5,40.0,3,1,0,1,3,6,6,0,"FW,MF",25-29,Forward,Spain,Europe
1215,Vukašin Jovanović,SRB,Bordeaux,Ligue 1,2019,23.0,1996.0,6.4,18,11,12,6,0,14,21,66.7,7,5,3,2,15,33,15,0,DF,20-24,Defender,Serbia,Europe
1216,Dejan Joveljić,SRB,Eint Frankfurt,Bundesliga,2019,19.0,1999.0,1.7,2,2,1,1,0,0,1,0.0,1,0,0,0,0,2,1,0,FW,Under 20,Forward,Serbia,Europe
1218,Luka Jović,SRB,Real Madrid,La Liga,2019,21.0,1997.0,4.8,2,1,0,0,2,1,2,50.0,1,1,0,1,2,4,0,0,FW,20-24,Forward,Serbia,Europe
1219,Juanmi,ESP,Betis,La Liga,2019,26.0,1993.0,2.9,4,1,1,2,1,1,4,25.0,3,1,0,1,0,4,0,0,"FW,MF",25-29,Forward,Spain,Europe
1220,David Juncà,ESP,Celta Vigo,La Liga,2019,25.0,1993.0,2.9,6,5,4,1,1,2,3,66.7,1,4,1,3,2,8,3,0,DF,25-29,Defender,Spain,Europe
1230,Pavel Kadeřábek,CZE,Hoffenheim,Bundesliga,2019,27.0,1992.0,27.5,32,22,17,13,2,13,30,43.3,17,29,7,22,27,59,55,1,"DF,FW",25-29,Defender,Czech Republic,Europe
1241,Kevin Kampl,SVN,RB Leipzig,Bundesliga,2019,28.0,1990.0,7.5,17,11,7,10,0,7,23,30.4,16,7,2,5,16,33,6,0,MF,25-29,Midfielder,Slovenia,Europe
1268,Kiké,ESP,Eibar,La Liga,2019,29.0,1989.0,19.6,13,7,0,5,8,4,12,33.3,8,15,1,14,1,14,9,0,FW,25-29,Forward,Spain,Europe
1273,Joshua King,NOR,Bournemouth,Premier League,2019,27.0,1992.0,22.3,16,6,4,8,4,4,16,25.0,12,20,3,17,8,24,9,0,"FW,MF",25-29,Forward,Norway,Europe
1289,Koke,ESP,Atlético Madrid,La Liga,2019,27.0,1992.0,30.0,70,42,27,30,13,29,89,32.6,60,33,8,25,29,99,28,2,MF,25-29,Midfielder,Spain,Europe
1290,Aleksandar Kolarov,SRB,Roma,Serie A,2019,33.0,1985.0,30.4,37,28,16,16,5,20,37,54.1,17,20,9,11,31,68,57,0,DF,30-34,Defender,Serbia,Europe
1304,Filip Kostić,SRB,Eint Frankfurt,Bundesliga,2019,26.0,1992.0,32.9,59,38,30,20,9,22,59,37.3,37,45,2,43,23,82,16,0,"DF,FW",25-29,Defender,Serbia,Europe
1307,Tomáš Koubek,CZE,Augsburg,Bundesliga,2019,26.0,1992.0,24.0,3,2,3,0,0,3,11,27.3,8,1,0,1,1,4,23,3,GK,25-29,Goalkeeper,Czech Republic,Europe
1314,Dawid Kownacki,POL,Düsseldorf,Bundesliga,2019,22.0,1997.0,12.1,13,8,5,7,1,9,20,45.0,11,13,2,11,6,19,8,0,"FW,MF",20-24,Forward,Poland,Europe
1321,Ladislav Krejčí,CZE,Bologna,Serie A,2019,27.0,1992.0,11.7,15,10,6,7,2,9,19,47.4,10,7,4,3,10,25,23,0,DF,25-29,Defender,Czech Republic,Europe
1322,Rene Krhin,SVN,Nantes,Ligue 1,2019,29.0,1990.0,3.6,4,3,1,3,0,2,2,100.0,0,1,0,1,6,10,17,0,"DF,MF",25-29,Defender,Slovenia,Europe
1333,Jasmin Kurtić,SVN,SPAL,Serie A,2019,30.0,1989.0,15.7,20,7,8,8,4,6,27,22.2,21,14,2,12,10,30,20,1,MF,30-34,Midfielder,Slovenia,Europe
1334,Jasmin Kurtić,SVN,Parma,Serie A,2019,30.0,1989.0,18.5,32,23,19,10,3,13,35,37.1,22,19,5,14,15,47,27,2,"MF,FW",30-34,Midfielder,Slovenia,Europe
1346,Víctor Laguardia,ESP,Alavés,La Liga,2019,29.0,1989.0,29.5,21,15,15,6,0,16,30,53.3,14,24,18,6,37,58,131,1,DF,25-29,Defender,Spain,Europe
1362,Aymeric Laporte,ESP,Manchester City,Premier League,2019,25.0,1994.0,12.2,13,6,6,7,0,4,9,44.4,5,6,5,1,20,33,26,1,DF,25-29,Defender,Spain,Europe
1364,Larra,ESP,Athletic Club,La Liga,2019,21.0,1997.0,2.8,2,2,0,1,1,0,0,,0,1,0,1,0,2,0,0,"FW,MF",20-24,Forward,Spain,Europe
1369,Toni Lato,ESP,Osasuna,La Liga,2019,21.0,1997.0,5.2,22,15,11,8,3,9,10,90.0,1,9,1,8,8,30,13,1,"DF,MF",20-24,Defender,Spain,Europe
1377,Darko Lazović,SRB,Hellas Verona,Serie A,2019,28.0,1990.0,36.0,26,16,14,8,4,14,27,51.9,13,15,4,11,23,49,53,0,DF,25-29,Defender,Serbia,Europe
1380,Robin Le Normand,ESP,Real Sociedad,La Liga,2019,22.0,1996.0,26.6,48,27,33,15,0,26,35,74.3,9,20,7,13,20,68,99,0,DF,20-24,Defender,Spain,Europe
1394,Iñigo Lekue,ESP,Athletic Club,La Liga,2019,26.0,1993.0,6.9,22,12,14,6,2,11,14,78.6,3,7,0,7,3,25,11,0,"FW,DF",25-29,Forward,Spain,Europe
1403,Pedro León,ESP,Eibar,La Liga,2019,32.0,1986.0,21.1,28,20,8,9,11,12,25,48.0,13,18,1,17,19,47,7,0,"MF,FW",30-34,Midfielder,Spain,Europe
1404,Sergio León,ESP,Levante,La Liga,2019,30.0,1989.0,7.5,3,3,0,3,0,2,4,50.0,2,3,0,3,1,4,2,0,FW,30-34,Forward,Spain,Europe
1409,Robert Lewandowski,POL,Bayern Munich,Bundesliga,2019,30.0,1988.0,30.7,18,9,3,9,6,3,15,20.0,12,13,1,12,7,25,13,0,FW,30-34,Forward,Poland,Europe
1410,Jamal Lewis,NIR,Norwich City,Premier League,2019,21.0,1998.0,25.6,51,35,42,6,3,22,36,61.1,14,27,12,15,25,76,68,0,DF,20-24,Defender,Northern Ireland,Europe
1417,Lillo,ESP,Osasuna,La Liga,2019,30.0,1989.0,2.2,4,2,2,2,0,1,1,100.0,0,2,1,1,2,6,8,0,DF,30-34,Defender,Spain,Europe
1422,Karol Linetty,POL,Sampdoria,Serie A,2019,24.0,1995.0,22.4,61,32,24,25,12,21,65,32.3,44,26,3,23,26,87,17,0,MF,20-24,Midfielder,Poland,Europe
1424,Pol Lirola,ESP,Fiorentina,Serie A,2019,21.0,1997.0,29.4,34,20,18,10,6,21,38,55.3,17,16,4,12,26,60,52,0,DF,20-24,Defender,Spain,Europe
1425,Diego Llorente,ESP,Real Sociedad,La Liga,2019,25.0,1993.0,25.9,30,14,20,9,1,16,28,57.1,12,14,7,7,28,58,101,5,DF,25-29,Defender,Spain,Europe
1425,Diego Llorente,ESP,Real Sociedad,La Liga,2019,25.0,1993.0,25.9,30,14,20,9,1,16,28,57.1,12,14,7,7,28,58,101,5,DF,25-29,Defender,Spain,Europe
1425,Diego Llorente,ESP,Real Sociedad,La Liga,2019,25.0,1993.0,25.9,30,14,20,9,1,16,28,57.1,12,14,7,7,28,58,101,5,DF,25-29,Defender,Spain,Europe
1425,Diego Llorente,ESP,Real Sociedad,La Liga,2019,25.0,1993.0,25.9,30,14,20,9,1,16,28,57.1,12,14,7,7,28,58,101,5,DF,25-29,Defender,Spain,Europe
1426,Fernando Llorente,ESP,Napoli,Serie A,2019,34.0,1985.0,5.6,0,0,0,0,0,0,1,0.0,1,4,0,4,1,1,3,0,FW,30-34,Forward,Spain,Europe
1427,Marcos Llorente,ESP,Atlético Madrid,La Liga,2019,24.0,1995.0,15.2,29,15,7,16,6,7,21,33.3,14,24,4,20,14,43,9,0,"MF,FW",20-24,Midfielder,Spain,Europe
1447,Adrián López,ESP,Osasuna,La Liga,2019,31.0,1988.0,16.0,7,5,1,5,1,2,19,10.5,17,6,2,4,4,11,8,0,FW,30-34,Forward,Spain,Europe
1447,Adrián López,ESP,Osasuna,La Liga,2019,31.0,1988.0,16.0,7,5,1,5,1,2,19,10.5,17,6,2,4,4,11,8,0,FW,30-34,Forward,Spain,Europe
1447,Adrián López,ESP,Osasuna,La Liga,2019,31.0,1988.0,16.0,7,5,1,5,1,2,19,10.5,17,6,2,4,4,11,8,0,FW,30-34,Forward,Spain,Europe
1447,Adrián López,ESP,Osasuna,La Liga,2019,31.0,1988.0,16.0,7,5,1,5,1,2,19,10.5,17,6,2,4,4,11,8,0,FW,30-34,Forward,Spain,Europe
1448,David López,ESP,Espanyol,La Liga,2019,29.0,1989.0,27.3,38,20,15,20,3,13,41,31.7,28,28,13,15,35,73,63,3,"DF,MF",25-29,Defender,Spain,Europe
1448,David López,ESP,Espanyol,La Liga,2019,29.0,1989.0,27.3,38,20,15,20,3,13,41,31.7,28,28,13,15,35,73,63,3,"DF,MF",25-29,Defender,Spain,Europe
1448,David López,ESP,Espanyol,La Liga,2019,29.0,1989.0,27.3,38,20,15,20,3,13,41,31.7,28,28,13,15,35,73,63,3,"DF,MF",25-29,Defender,Spain,Europe
1448,David López,ESP,Espanyol,La Liga,2019,29.0,1989.0,27.3,38,20,15,20,3,13,41,31.7,28,28,13,15,35,73,63,3,"DF,MF",25-29,Defender,Spain,Europe
1449,Diego López,ESP,Espanyol,La Liga,2019,37.0,1981.0,35.9,2,2,2,0,0,1,2,50.0,1,0,0,0,2,4,8,1,GK,35-39,Goalkeeper,Spain,Europe
1449,Diego López,ESP,Espanyol,La Liga,2019,37.0,1981.0,35.9,2,2,2,0,0,1,2,50.0,1,0,0,0,2,4,8,1,GK,35-39,Goalkeeper,Spain,Europe
1449,Diego López,ESP,Espanyol,La Liga,2019,37.0,1981.0,35.9,2,2,2,0,0,1,2,50.0,1,0,0,0,2,4,8,1,GK,35-39,Goalkeeper,Spain,Europe
1449,Diego López,ESP,Espanyol,La Liga,2019,37.0,1981.0,35.9,2,2,2,0,0,1,2,50.0,1,0,0,0,2,4,8,1,GK,35-39,Goalkeeper,Spain,Europe
1449,Diego López,ESP,Espanyol,La Liga,2019,37.0,1981.0,35.9,2,2,2,0,0,1,2,50.0,1,0,0,0,2,4,8,1,GK,35-39,Goalkeeper,Spain,Europe
1449,Diego López,ESP,Espanyol,La Liga,2019,37.0,1981.0,35.9,2,2,2,0,0,1,2,50.0,1,0,0,0,2,4,8,1,GK,35-39,Goalkeeper,Spain,Europe
1449,Diego López,ESP,Espanyol,La Liga,2019,37.0,1981.0,35.9,2,2,2,0,0,1,2,50.0,1,0,0,0,2,4,8,1,GK,35-39,Goalkeeper,Spain,Europe
1449,Diego López,ESP,Espanyol,La Liga,2019,37.0,1981.0,35.9,2,2,2,0,0,1,2,50.0,1,0,0,0,2,4,8,1,GK,35-39,Goalkeeper,Spain,Europe
1449,Diego López,ESP,Espanyol,La Liga,2019,37.0,1981.0,35.9,2,2,2,0,0,1,2,50.0,1,0,0,0,2,4,8,1,GK,35-39,Goalkeeper,Spain,Europe
1450,Javi López,ESP,Alavés,La Liga,2019,17.0,2002.0,1.0,6,5,4,2,0,4,5,80.0,1,1,1,0,1,7,5,0,DF,Under 20,Defender,Spain,Europe
1450,Javi López,ESP,Alavés,La Liga,2019,17.0,2002.0,1.0,6,5,4,2,0,4,5,80.0,1,1,1,0,1,7,5,0,DF,Under 20,Defender,Spain,Europe
1450,Javi López,ESP,Alavés,La Liga,2019,17.0,2002.0,1.0,6,5,4,2,0,4,5,80.0,1,1,1,0,1,7,5,0,DF,Under 20,Defender,Spain,Europe
1450,Javi López,ESP,Alavés,La Liga,2019,17.0,2002.0,1.0,6,5,4,2,0,4,5,80.0,1,1,1,0,1,7,5,0,DF,Under 20,Defender,Spain,Europe
1451,Javi López,ESP,Espanyol,La Liga,2019,33.0,1986.0,15.4,47,34,23,18,6,19,40,47.5,21,12,6,6,21,68,38,2,DF,30-34,Defender,Spain,Europe
1451,Javi López,ESP,Espanyol,La Liga,2019,33.0,1986.0,15.4,47,34,23,18,6,19,40,47.5,21,12,6,6,21,68,38,2,DF,30-34,Defender,Spain,Europe
1451,Javi López,ESP,Espanyol,La Liga,2019,33.0,1986.0,15.4,47,34,23,18,6,19,40,47.5,21,12,6,6,21,68,38,2,DF,30-34,Defender,Spain,Europe
1451,Javi López,ESP,Espanyol,La Liga,2019,33.0,1986.0,15.4,47,34,23,18,6,19,40,47.5,21,12,6,6,21,68,38,2,DF,30-34,Defender,Spain,Europe
1452,Lluis López,ESP,Espanyol,La Liga,2019,22.0,1997.0,3.3,4,2,3,1,0,2,2,100.0,0,4,0,4,1,5,6,1,DF,20-24,Defender,Spain,Europe
1454,Pau López,ESP,Roma,Serie A,2019,24.0,1994.0,32.0,1,0,1,0,0,1,5,20.0,4,0,0,0,1,2,10,3,GK,20-24,Goalkeeper,Spain,Europe
1455,Roberto López,ESP,Real Sociedad,La Liga,2019,19.0,2000.0,0.6,4,2,1,1,2,2,2,100.0,0,0,0,0,0,4,0,0,"FW,MF",Under 20,Forward,Spain,Europe
1456,Unai López,ESP,Athletic Club,La Liga,2019,23.0,1995.0,19.9,30,22,8,18,4,10,41,24.4,31,13,2,11,18,48,12,1,MF,20-24,Midfielder,Spain,Europe
1457,Iker Losada,ESP,Celta Vigo,La Liga,2019,17.0,2001.0,0.1,0,0,0,0,0,0,0,,0,0,0,0,0,0,0,0,"MF,FW",Under 20,Midfielder,Spain,Europe
1466,Pol Lozano,ESP,Espanyol,La Liga,2019,19.0,1999.0,1.9,5,3,3,2,0,3,7,42.9,4,3,0,3,1,6,2,0,MF,Under 20,Midfielder,Spain,Europe
1470,José Luis Gayà,ESP,Valencia,La Liga,2019,24.0,1995.0,22.1,44,30,29,12,3,28,41,68.3,13,22,9,13,18,62,48,1,DF,20-24,Defender,Spain,Europe
1471,José Luis Morales,ESP,Levante,La Liga,2019,32.0,1987.0,28.0,17,8,5,9,3,6,34,17.6,28,14,1,13,6,23,5,1,"FW,MF",30-34,Forward,Spain,Europe
1479,Saša Lukić,SRB,Torino,Serie A,2019,22.0,1996.0,20.7,29,17,8,19,2,10,35,28.6,25,21,7,14,29,58,15,0,MF,20-24,Midfielder,Serbia,Europe
1508,Žan Majer,SVN,Lecce,Serie A,2019,27.0,1992.0,18.5,39,18,19,12,8,17,56,30.4,39,27,6,21,26,65,18,1,MF,25-29,Midfielder,Slovenia,Europe
1510,Nemanja Maksimović,SRB,Getafe,La Liga,2019,24.0,1995.0,32.2,49,28,12,31,6,10,44,22.7,34,37,7,30,56,105,30,1,MF,20-24,Midfielder,Serbia,Europe
1511,Nikola Maksimović,SRB,Napoli,Serie A,2019,27.0,1991.0,20.0,35,24,21,14,0,10,21,47.6,11,19,11,8,30,65,64,1,DF,25-29,Defender,Serbia,Europe
1516,Hugo Mallo,ESP,Celta Vigo,La Liga,2019,28.0,1991.0,21.8,62,42,44,16,2,27,48,56.3,21,24,8,16,22,84,97,1,DF,25-29,Defender,Spain,Europe
1531,Javier Manquillo,ESP,Newcastle Utd,Premier League,2019,25.0,1994.0,17.8,39,26,27,8,4,24,38,63.2,14,14,2,12,18,57,56,0,DF,25-29,Defender,Spain,Europe
1533,Myziane Maolida,COM,Nice,Ligue 1,2019,20.0,1999.0,7.5,14,10,5,6,3,5,12,41.7,7,8,0,8,3,17,3,0,"FW,MF",20-24,Forward,Comoros,Africa
1540,Óscar de Marcos,ESP,Athletic Club,La Liga,2019,30.0,1989.0,6.0,5,3,2,1,2,3,6,50.0,3,6,0,6,8,13,8,0,"DF,FW",30-34,Defender,Spain,Europe
1542,Miguel Marí,ESP,Eibar,La Liga,2019,22.0,1997.0,0.1,0,0,0,0,0,0,0,,0,0,0,0,0,0,0,0,MF,20-24,Midfielder,Spain,Europe
1543,Pablo Marí,ESP,Arsenal,Premier League,2019,25.0,1993.0,1.3,2,1,2,0,0,0,0,,0,0,0,0,1,3,10,0,DF,25-29,Defender,Spain,Europe
1549,Adrián Marín,ESP,Alavés,La Liga,2019,22.0,1997.0,9.5,22,15,14,6,2,13,15,86.7,2,13,4,9,13,35,32,0,DF,20-24,Defender,Spain,Europe
1557,Roger Martí,ESP,Levante,La Liga,2019,28.0,1991.0,25.2,18,11,8,7,3,7,29,24.1,22,14,0,14,6,24,17,0,FW,25-29,Forward,Spain,Europe
1559,Aarón Martín,ESP,Mainz 05,Bundesliga,2019,22.0,1997.0,19.9,29,15,17,8,4,9,22,40.9,13,11,5,6,30,59,36,0,DF,20-24,Defender,Spain,Europe
1560,Daniel Martín,ESP,Betis,La Liga,2019,21.0,1998.0,5.9,0,0,0,0,0,0,0,,0,0,0,0,0,0,3,0,GK,20-24,Goalkeeper,Spain,Europe
1566,Álex Martínez,ESP,Granada,La Liga,2019,28.0,1990.0,0.2,0,0,0,0,0,0,0,,0,0,0,0,0,0,0,0,DF,25-29,Defender,Spain,Europe
1568,Iñigo Martínez,ESP,Athletic Club,La Liga,2019,28.0,1991.0,33.0,48,30,33,13,2,27,47,57.4,20,28,13,15,39,87,140,0,DF,25-29,Defender,Spain,Europe
1569,Javi Martínez,ESP,Osasuna,La Liga,2019,19.0,1999.0,0.1,0,0,0,0,0,0,0,,0,0,0,0,0,0,1,0,MF,Under 20,Midfielder,Spain,Europe
1569,Javi Martínez,ESP,Osasuna,La Liga,2019,19.0,1999.0,0.1,0,0,0,0,0,0,0,,0,0,0,0,0,0,1,0,MF,Under 20,Midfielder,Spain,Europe
1569,Javi Martínez,ESP,Osasuna,La Liga,2019,19.0,1999.0,0.1,0,0,0,0,0,0,0,,0,0,0,0,0,0,1,0,MF,Under 20,Midfielder,Spain,Europe
1569,Javi Martínez,ESP,Osasuna,La Liga,2019,19.0,1999.0,0.1,0,0,0,0,0,0,0,,0,0,0,0,0,0,1,0,MF,Under 20,Midfielder,Spain,Europe
1570,Javi Martínez,ESP,Bayern Munich,Bundesliga,2019,30.0,1988.0,7.5,16,12,9,7,0,9,11,81.8,2,9,8,1,18,34,30,0,"DF,MF",30-34,Defender,Spain,Europe
1570,Javi Martínez,ESP,Bayern Munich,Bundesliga,2019,30.0,1988.0,7.5,16,12,9,7,0,9,11,81.8,2,9,8,1,18,34,30,0,"DF,MF",30-34,Defender,Spain,Europe
1570,Javi Martínez,ESP,Bayern Munich,Bundesliga,2019,30.0,1988.0,7.5,16,12,9,7,0,9,11,81.8,2,9,8,1,18,34,30,0,"DF,MF",30-34,Defender,Spain,Europe
1570,Javi Martínez,ESP,Bayern Munich,Bundesliga,2019,30.0,1988.0,7.5,16,12,9,7,0,9,11,81.8,2,9,8,1,18,34,30,0,"DF,MF",30-34,Defender,Spain,Europe
1571,José Martínez,ESP,Granada,La Liga,2019,26.0,1993.0,13.2,21,16,12,8,1,14,25,56.0,11,6,4,2,18,39,46,0,DF,25-29,Defender,Spain,Europe
1573,Pablo Martínez,ESP,Levante,La Liga,2019,21.0,1998.0,0.4,2,0,1,1,0,0,1,0.0,1,0,0,0,0,2,2,0,MF,20-24,Midfielder,Spain,Europe
1573,Pablo Martínez,ESP,Levante,La Liga,2019,21.0,1998.0,0.4,2,0,1,1,0,0,1,0.0,1,0,0,0,0,2,2,0,MF,20-24,Midfielder,Spain,Europe
1573,Pablo Martínez,ESP,Levante,La Liga,2019,21.0,1998.0,0.4,2,0,1,1,0,0,1,0.0,1,0,0,0,0,2,2,0,MF,20-24,Midfielder,Spain,Europe
1573,Pablo Martínez,ESP,Levante,La Liga,2019,21.0,1998.0,0.4,2,0,1,1,0,0,1,0.0,1,0,0,0,0,2,2,0,MF,20-24,Midfielder,Spain,Europe
1581,Jordi Masip,ESP,Valladolid,La Liga,2019,30.0,1989.0,35.0,1,1,1,0,0,0,2,0.0,2,0,0,0,1,2,7,3,GK,30-34,Goalkeeper,Spain,Europe
1583,Jaime Mata,ESP,Getafe,La Liga,2019,30.0,1988.0,30.5,21,13,3,11,7,3,20,15.0,17,16,1,15,7,28,15,0,FW,30-34,Forward,Spain,Europe
1584,Juan Mata,ESP,Manchester Utd,Premier League,2019,31.0,1988.0,8.4,7,3,1,5,1,2,7,28.6,5,5,1,4,0,7,2,0,"MF,FW",30-34,Midfielder,Spain,Europe
1585,Aleš Matějů,CZE,Brescia,Serie A,2019,23.0,1996.0,28.3,48,27,33,9,6,23,45,51.1,22,41,24,17,37,85,109,3,DF,20-24,Defender,Czech Republic,Europe
1587,Nemanja Matić,SRB,Manchester Utd,Premier League,2019,30.0,1988.0,17.6,46,24,23,19,4,20,43,46.5,23,21,8,13,22,68,28,1,MF,30-34,Midfielder,Serbia,Europe
1599,Borja Mayoral,ESP,Levante,La Liga,2019,22.0,1997.0,23.8,12,3,4,6,2,2,13,15.4,11,11,0,11,4,16,6,0,FW,20-24,Forward,Spain,Europe
1613,Michael McGovern,NIR,Norwich City,Premier League,2019,35.0,1984.0,1.8,0,0,0,0,0,0,0,,0,0,0,0,0,0,1,1,GK,35-39,Goalkeeper,Northern Ireland,Europe
1625,Óscar Melendo,ESP,Espanyol,La Liga,2019,21.0,1997.0,12.4,10,4,4,4,2,4,12,33.3,8,7,2,5,2,12,3,0,"MF,FW",20-24,Midfielder,Spain,Europe
1626,Gonzalo Melero,ESP,Levante,La Liga,2019,25.0,1994.0,13.7,20,13,9,9,2,7,27,25.9,20,12,3,9,9,29,15,1,MF,25-29,Midfielder,Spain,Europe
1631,Brais Méndez,ESP,Celta Vigo,La Liga,2019,22.0,1997.0,16.4,26,11,14,9,3,12,39,30.8,27,20,0,20,12,38,23,1,"MF,FW",20-24,Midfielder,Spain,Europe
1632,Édgar Méndez,ESP,Alavés,La Liga,2019,29.0,1990.0,9.6,11,7,4,6,1,5,13,38.5,8,10,2,8,5,16,7,0,"MF,FW",25-29,Midfielder,Spain,Europe
1642,Jorge Meré,ESP,Köln,Bundesliga,2019,22.0,1997.0,6.9,6,5,2,4,0,1,2,50.0,1,13,11,2,14,20,30,0,DF,20-24,Defender,Spain,Europe
1644,Fran Mérida,ESP,Osasuna,La Liga,2019,29.0,1990.0,12.9,27,15,11,10,6,9,27,33.3,18,15,4,11,25,52,10,0,MF,25-29,Midfielder,Spain,Europe
1645,Mikel Merino,ESP,Real Sociedad,La Liga,2019,23.0,1996.0,34.9,79,52,20,44,15,28,86,32.6,58,46,8,38,51,130,52,0,MF,20-24,Midfielder,Spain,Europe
1646,Sabin Merino,ESP,Leganés,La Liga,2019,27.0,1992.0,0.9,0,0,0,0,0,0,0,,0,0,0,0,0,0,0,0,FW,25-29,Forward,Spain,Europe
1649,Roque Mesa,ESP,Leganés,La Liga,2019,30.0,1989.0,22.4,40,21,17,18,5,13,44,29.5,31,13,4,9,11,51,8,0,MF,30-34,Midfielder,Spain,Europe
1655,Míchel,ESP,Valladolid,La Liga,2019,31.0,1988.0,24.2,50,28,26,19,5,22,75,29.3,53,22,4,18,33,83,41,1,MF,30-34,Midfielder,Spain,Europe
1657,Miguel,ESP,Valladolid,La Liga,2019,19.0,1999.0,2.6,2,1,1,0,1,1,2,50.0,1,3,1,2,0,2,1,0,FW,Under 20,Forward,Spain,Europe
1660,Nikola Milenković,SRB,Fiorentina,Serie A,2019,21.0,1997.0,36.2,46,25,30,16,0,11,31,35.5,20,39,21,18,29,75,129,1,DF,20-24,Defender,Serbia,Europe
1661,Arkadiusz Milik,POL,Napoli,Serie A,2019,25.0,1994.0,19.4,12,5,4,1,7,3,11,27.3,8,11,1,10,2,14,12,0,FW,25-29,Forward,Poland,Europe
1662,Sergej Milinković-Savić,SRB,Lazio,Serie A,2019,24.0,1995.0,33.7,60,35,25,24,11,15,79,19.0,64,67,16,51,37,97,60,1,MF,20-24,Midfielder,Serbia,Europe
1664,Luka Milivojević,SRB,Crystal Palace,Premier League,2019,28.0,1991.0,27.9,61,32,32,25,4,35,84,41.7,49,30,7,23,42,103,39,4,MF,25-29,Midfielder,Serbia,Europe
1667,Santi Mina,ESP,Celta Vigo,La Liga,2019,23.0,1995.0,21.6,13,8,8,5,0,5,38,13.2,33,19,2,17,10,23,27,0,"FW,MF",20-24,Forward,Spain,Europe
1671,Jorge Miramón,ESP,Levante,La Liga,2019,30.0,1989.0,27.0,52,27,35,13,4,26,45,57.8,19,30,8,22,46,98,61,1,DF,30-34,Defender,Spain,Europe
1672,Juan Miranda,ESP,Schalke 04,Bundesliga,2019,19.0,2000.0,8.7,14,10,8,6,0,6,18,33.3,12,12,4,8,10,24,27,1,DF,Under 20,Defender,Spain,Europe
1676,Stefan Mitrović,SRB,Strasbourg,Ligue 1,2019,29.0,1990.0,22.8,15,9,10,5,0,6,14,42.9,8,14,9,5,23,38,90,3,DF,25-29,Defender,Serbia,Europe
1684,Jorge Molina,ESP,Getafe,La Liga,2019,37.0,1982.0,21.0,8,2,0,4,4,0,12,0.0,12,13,2,11,4,12,18,0,FW,35-39,Forward,Spain,Europe
1686,Jon Moncayola,ESP,Osasuna,La Liga,2019,21.0,1998.0,16.6,52,30,26,22,4,27,54,50.0,27,29,5,24,16,68,23,1,"MF,DF",20-24,Midfielder,Spain,Europe
1689,Nacho Monreal,ESP,Arsenal,Premier League,2019,33.0,1986.0,3.0,1,1,1,0,0,1,3,33.3,2,3,1,2,3,4,10,0,DF,30-34,Defender,Spain,Europe
1690,Nacho Monreal,ESP,Real Sociedad,La Liga,2019,33.0,1986.0,26.6,38,16,26,9,3,22,42,52.4,20,20,4,16,43,81,66,0,DF,30-34,Defender,Spain,Europe
1691,Joan Monterde,ESP,Levante,La Liga,2019,21.0,1997.0,0.1,0,0,0,0,0,0,0,,0,0,0,0,0,0,0,0,MF,20-24,Midfielder,Spain,Europe
1693,Ángel Montoro,ESP,Granada,La Liga,2019,31.0,1988.0,10.8,19,8,8,9,2,3,13,23.1,10,10,1,9,13,32,15,0,MF,30-34,Midfielder,Spain,Europe
1694,Martín Montoya,ESP,Brighton,Premier League,2019,28.0,1991.0,21.1,57,29,31,20,6,30,56,53.6,26,19,5,14,24,81,40,0,"DF,MF",25-29,Defender,Spain,Europe
1699,Álvaro Morata,ESP,Atlético Madrid,La Liga,2019,26.0,1992.0,23.3,17,8,4,9,4,1,13,7.7,12,12,2,10,5,22,23,0,FW,25-29,Forward,Spain,Europe
1700,Jan Morávek,CZE,Augsburg,Bundesliga,2019,29.0,1989.0,5.3,23,12,9,14,0,11,24,45.8,13,4,1,3,8,31,11,0,MF,25-29,Midfielder,Czech Republic,Europe
1703,Alberto Moreno,ESP,Villarreal,La Liga,2019,27.0,1992.0,16.3,27,16,15,11,1,9,25,36.0,16,15,3,12,25,52,36,0,DF,25-29,Defender,Spain,Europe
1703,Alberto Moreno,ESP,Villarreal,La Liga,2019,27.0,1992.0,16.3,27,16,15,11,1,9,25,36.0,16,15,3,12,25,52,36,0,DF,25-29,Defender,Spain,Europe
1703,Alberto Moreno,ESP,Villarreal,La Liga,2019,27.0,1992.0,16.3,27,16,15,11,1,9,25,36.0,16,15,3,12,25,52,36,0,DF,25-29,Defender,Spain,Europe
1703,Alberto Moreno,ESP,Villarreal,La Liga,2019,27.0,1992.0,16.3,27,16,15,11,1,9,25,36.0,16,15,3,12,25,52,36,0,DF,25-29,Defender,Spain,Europe
1704,Álex Moreno,ESP,Betis,La Liga,2019,26.0,1993.0,25.2,37,20,27,8,2,12,32,37.5,20,21,8,13,23,60,47,1,DF,25-29,Defender,Spain,Europe
1705,Gerard Moreno,ESP,Villarreal,La Liga,2019,27.0,1992.0,30.5,19,8,4,10,5,5,46,10.9,41,19,3,16,10,29,51,0,"FW,MF",25-29,Forward,Spain,Europe
1706,Mateu Morey,ESP,Dortmund,Bundesliga,2019,19.0,2000.0,2.2,7,3,2,4,1,4,10,40.0,6,4,0,4,5,12,3,0,"DF,MF",Under 20,Defender,Spain,Europe
1708,Manu Morlanes,ESP,Villarreal,La Liga,2019,20.0,1999.0,2.8,7,3,3,4,0,2,9,22.2,7,1,1,0,2,9,2,0,MF,20-24,Midfielder,Spain,Europe
1709,Raúl Moro,ESP,Lazio,Serie A,2019,16.0,2002.0,0.0,0,0,0,0,0,0,0,,0,0,0,0,0,0,0,0,FW,Under 20,Forward,Spain,Europe
1710,Loren Morón,ESP,Betis,La Liga,2019,25.0,1993.0,22.6,18,12,6,7,5,9,23,39.1,14,25,6,19,9,27,13,0,FW,25-29,Forward,Spain,Europe
1723,Toni Moya,ESP,Atlético Madrid,La Liga,2019,21.0,1998.0,0.0,0,0,0,0,0,0,0,,0,0,0,0,0,0,0,0,MF,20-24,Midfielder,Spain,Europe
1724,Javi Moyano,ESP,Valladolid,La Liga,2019,33.0,1986.0,24.7,19,8,11,8,0,8,20,40.0,12,18,5,13,27,46,63,0,DF,30-34,Defender,Spain,Europe
1730,Iker Muniain,ESP,Athletic Club,La Liga,2019,26.0,1992.0,26.5,26,19,11,10,5,4,24,16.7,20,9,0,9,12,38,7,0,"FW,MF",25-29,Forward,Spain,Europe
1731,Aihen Muñoz,ESP,Real Sociedad,La Liga,2019,21.0,1997.0,10.9,28,18,13,12,3,18,27,66.7,9,13,2,11,2,30,19,0,DF,20-24,Defender,Spain,Europe
1732,Javier Muñoz,ESP,Alavés,La Liga,2019,24.0,1995.0,0.6,0,0,0,0,0,0,0,,0,1,1,0,0,0,0,0,"FW,MF",20-24,Forward,Spain,Europe
1755,Nacho,ESP,Valladolid,La Liga,2019,30.0,1989.0,21.0,43,22,24,15,4,17,48,35.4,31,36,8,28,25,68,61,0,DF,30-34,Defender,Spain,Europe
1756,Nacho,ESP,Real Madrid,La Liga,2019,29.0,1990.0,4.9,11,6,6,3,2,6,10,60.0,4,5,3,2,12,23,18,1,DF,25-29,Defender,Spain,Europe
1761,Matija Nastasić,SRB,Schalke 04,Bundesliga,2019,26.0,1993.0,15.2,26,16,17,9,0,14,17,82.4,3,28,16,12,22,48,79,0,DF,25-29,Defender,Serbia,Europe
1762,Marc Navarro,ESP,Leganés,La Liga,2019,24.0,1995.0,2.4,3,3,2,1,0,1,1,100.0,0,2,1,1,0,3,3,0,"FW,DF",20-24,Forward,Spain,Europe
1763,Ximo Navarro,ESP,Alavés,La Liga,2019,29.0,1990.0,21.1,34,19,17,15,2,16,28,57.1,12,20,7,13,52,86,76,2,DF,25-29,Defender,Spain,Europe
1763,Ximo Navarro,ESP,Alavés,La Liga,2019,29.0,1990.0,21.1,34,19,17,15,2,16,28,57.1,12,20,7,13,52,86,76,2,DF,25-29,Defender,Spain,Europe
1763,Ximo Navarro,ESP,Alavés,La Liga,2019,29.0,1990.0,21.1,34,19,17,15,2,16,28,57.1,12,20,7,13,52,86,76,2,DF,25-29,Defender,Spain,Europe
1763,Ximo Navarro,ESP,Alavés,La Liga,2019,29.0,1990.0,21.1,34,19,17,15,2,16,28,57.1,12,20,7,13,52,86,76,2,DF,25-29,Defender,Spain,Europe
1764,Jesús Navas,ESP,Sevilla,La Liga,2019,33.0,1985.0,37.4,27,15,16,7,4,15,32,46.9,17,20,7,13,31,58,70,0,DF,30-34,Defender,Spain,Europe
1766,Raúl Navas,ESP,Osasuna,La Liga,2019,31.0,1988.0,7.9,10,5,4,6,0,4,13,30.8,9,10,4,6,18,28,30,0,DF,30-34,Defender,Spain,Europe
1778,Carlos Neva,ESP,Granada,La Liga,2019,23.0,1996.0,24.5,16,11,12,3,1,9,21,42.9,12,15,2,13,28,44,60,0,DF,20-24,Defender,Spain,Europe
1794,Saúl Ñíguez,ESP,Atlético Madrid,La Liga,2019,24.0,1994.0,34.1,95,59,44,42,9,39,88,44.3,49,58,13,45,55,150,68,1,"MF,DF",20-24,Midfielder,Spain,Europe
1796,Fernando Niño,ESP,Villarreal,La Liga,2019,18.0,2000.0,0.9,1,0,0,1,0,1,2,50.0,1,0,0,0,0,1,2,0,FW,Under 20,Forward,Spain,Europe
1803,Nolito,ESP,Sevilla,La Liga,2019,32.0,1986.0,10.0,21,12,5,11,5,7,20,35.0,13,7,0,7,1,22,1,0,FW,30-34,Forward,Spain,Europe
1804,Nolito,ESP,Celta Vigo,La Liga,2019,32.0,1986.0,3.6,7,5,5,2,0,3,8,37.5,5,4,1,3,1,8,4,0,"MF,FW",30-34,Midfielder,Spain,Europe
1806,Håvard Nordtveit,NOR,Hoffenheim,Bundesliga,2019,29.0,1990.0,7.8,4,1,3,1,0,3,7,42.9,4,17,12,5,13,17,45,0,DF,25-29,Defender,Norway,Europe
1807,Oliver Norwood,NIR,Sheffield Utd,Premier League,2019,28.0,1991.0,34.3,66,37,35,24,7,28,97,28.9,69,34,12,22,47,113,40,1,MF,25-29,Midfielder,Northern Ireland,Europe
1810,Unai Núñez,ESP,Athletic Club,La Liga,2019,22.0,1997.0,17.5,13,10,10,2,1,6,16,37.5,10,25,17,8,23,36,71,0,DF,20-24,Defender,Spain,Europe
1813,Ørjan Nyland,NOR,Aston Villa,Premier League,2019,28.0,1990.0,6.0,0,0,0,0,0,0,0,,0,0,0,0,0,0,1,1,GK,25-29,Goalkeeper,Norway,Europe
1819,Jan Oblak,SVN,Atlético Madrid,La Liga,2019,26.0,1993.0,37.7,0,0,0,0,0,0,0,,0,0,0,0,1,1,4,2,GK,25-29,Goalkeeper,Slovenia,Europe
1820,Rafel Obrador,ESP,Mallorca,La Liga,2019,15.0,2004.0,0.0,0,0,0,0,0,0,1,0.0,1,0,0,0,0,0,1,0,DF,Under 20,Defender,Spain,Europe
1823,Álvaro Odriozola,ESP,Real Madrid,La Liga,2019,23.0,1995.0,3.8,5,2,4,0,1,5,8,62.5,3,4,0,4,2,7,8,0,DF,20-24,Defender,Spain,Europe
1824,Álvaro Odriozola,ESP,Bayern Munich,Bundesliga,2019,23.0,1995.0,1.7,2,2,1,0,1,2,3,66.7,1,1,0,1,1,3,2,0,DF,20-24,Defender,Spain,Europe
1830,Oier Olazábal,ESP,Espanyol,La Liga,2019,29.0,1989.0,2.0,0,0,0,0,0,0,0,,0,1,0,1,0,0,0,0,GK,25-29,Goalkeeper,Spain,Europe
1832,Kiko Olivas,ESP,Valladolid,La Liga,2019,30.0,1988.0,32.7,33,16,25,7,1,13,35,37.1,22,30,16,14,61,94,112,2,DF,30-34,Defender,Spain,Europe
1838,Dani Olmo,ESP,RB Leipzig,Bundesliga,2019,21.0,1998.0,8.3,20,14,5,10,5,1,13,7.7,12,7,1,6,4,24,6,0,"MF,FW",20-24,Midfielder,Spain,Europe
1843,Javier Ontiveros,ESP,Villarreal,La Liga,2019,21.0,1997.0,9.9,29,14,13,14,2,8,35,22.9,27,13,1,12,5,34,7,0,"FW,MF",20-24,Forward,Spain,Europe
1850,Aimar Oroz,ESP,Osasuna,La Liga,2019,17.0,2001.0,0.1,0,0,0,0,0,0,0,,0,1,0,1,0,0,0,0,FW,Under 20,Forward,Spain,Europe
1867,Mikel Oyarzabal,ESP,Real Sociedad,La Liga,2019,22.0,1997.0,33.9,36,15,13,15,8,16,46,34.8,30,32,2,30,13,49,19,1,"FW,MF",20-24,Forward,Spain,Europe
1872,Fernando Pacheco,ESP,Alavés,La Liga,2019,27.0,1992.0,26.2,1,0,1,0,0,1,3,33.3,2,0,0,0,0,1,10,0,GK,25-29,Goalkeeper,Spain,Europe
1872,Fernando Pacheco,ESP,Alavés,La Liga,2019,27.0,1992.0,26.2,1,0,1,0,0,1,3,33.3,2,0,0,0,0,1,10,0,GK,25-29,Goalkeeper,Spain,Europe
1872,Fernando Pacheco,ESP,Alavés,La Liga,2019,27.0,1992.0,26.2,1,0,1,0,0,1,3,33.3,2,0,0,0,0,1,10,0,GK,25-29,Goalkeeper,Spain,Europe
1872,Fernando Pacheco,ESP,Alavés,La Liga,2019,27.0,1992.0,26.2,1,0,1,0,0,1,3,33.3,2,0,0,0,0,1,10,0,GK,25-29,Goalkeeper,Spain,Europe
1873,Jon Pacheco,ESP,Real Sociedad,La Liga,2019,18.0,2001.0,0.9,0,0,0,0,0,0,0,,0,1,0,1,0,0,2,0,DF,Under 20,Defender,Spain,Europe
1881,Sergi Palencia,ESP,Saint-Étienne,Ligue 1,2019,23.0,1996.0,5.2,16,10,6,10,0,5,7,71.4,2,6,1,5,8,24,4,0,DF,20-24,Defender,Spain,Europe
1886,Martin Palumbo,NOR,Udinese,Serie A,2019,17.0,2002.0,0.0,0,0,0,0,0,0,0,,0,0,0,0,0,0,0,0,MF,Under 20,Midfielder,Norway,Europe
1893,Rubén Pardo,ESP,Bordeaux,Ligue 1,2019,26.0,1992.0,2.1,3,2,2,1,0,2,3,66.7,1,0,0,0,1,4,2,1,MF,25-29,Midfielder,Spain,Europe
1895,Daniel Parejo,ESP,Valencia,La Liga,2019,30.0,1989.0,33.6,67,41,29,32,6,32,101,31.7,69,38,11,27,22,89,20,2,MF,30-34,Midfielder,Spain,Europe
1897,Miquel Parera,ESP,Mallorca,La Liga,2019,23.0,1996.0,1.0,0,0,0,0,0,0,0,,0,0,0,0,0,0,0,0,GK,20-24,Goalkeeper,Spain,Europe
1903,Patric,ESP,Lazio,Serie A,2019,26.0,1993.0,18.6,34,20,24,7,3,18,25,72.0,7,19,9,10,15,49,45,0,DF,25-29,Defender,Spain,Europe
1906,Paulino,ESP,Alavés,La Liga,2019,22.0,1997.0,0.8,0,0,0,0,0,0,1,0.0,1,1,0,1,1,1,0,0,"FW,MF",20-24,Forward,Spain,Europe
1909,Jiří Pavlenka,CZE,Werder Bremen,Bundesliga,2019,27.0,1992.0,33.0,1,0,1,0,0,1,2,50.0,1,1,0,1,5,6,11,3,GK,25-29,Goalkeeper,Czech Republic,Europe
1917,Alfonso Pedraza,ESP,Betis,La Liga,2019,23.0,1996.0,15.0,30,19,16,11,3,19,33,57.6,14,18,6,12,16,46,26,1,DF,20-24,Defender,Spain,Europe
1918,Marc Pedraza,ESP,Mallorca,La Liga,2019,32.0,1987.0,1.4,1,1,1,0,0,1,5,20.0,4,0,0,0,4,5,1,0,MF,30-34,Midfielder,Spain,Europe
1919,Pedro,ESP,Chelsea,Premier League,2019,32.0,1987.0,7.3,15,7,5,9,1,3,15,20.0,12,9,0,9,9,24,1,0,"FW,MF",30-34,Forward,Spain,Europe
1919,Pedro,ESP,Chelsea,Premier League,2019,32.0,1987.0,7.3,15,7,5,9,1,3,15,20.0,12,9,0,9,9,24,1,0,"FW,MF",30-34,Forward,Spain,Europe
1919,Pedro,ESP,Chelsea,Premier League,2019,32.0,1987.0,7.3,15,7,5,9,1,3,15,20.0,12,9,0,9,9,24,1,0,"FW,MF",30-34,Forward,Spain,Europe
1919,Pedro,ESP,Chelsea,Premier League,2019,32.0,1987.0,7.3,15,7,5,9,1,3,15,20.0,12,9,0,9,9,24,1,0,"FW,MF",30-34,Forward,Spain,Europe
1919,Pedro,ESP,Chelsea,Premier League,2019,32.0,1987.0,7.3,15,7,5,9,1,3,15,20.0,12,9,0,9,9,24,1,0,"FW,MF",30-34,Forward,Spain,Europe
1919,Pedro,ESP,Chelsea,Premier League,2019,32.0,1987.0,7.3,15,7,5,9,1,3,15,20.0,12,9,0,9,9,24,1,0,"FW,MF",30-34,Forward,Spain,Europe
1919,Pedro,ESP,Chelsea,Premier League,2019,32.0,1987.0,7.3,15,7,5,9,1,3,15,20.0,12,9,0,9,9,24,1,0,"FW,MF",30-34,Forward,Spain,Europe
1919,Pedro,ESP,Chelsea,Premier League,2019,32.0,1987.0,7.3,15,7,5,9,1,3,15,20.0,12,9,0,9,9,24,1,0,"FW,MF",30-34,Forward,Spain,Europe
1919,Pedro,ESP,Chelsea,Premier League,2019,32.0,1987.0,7.3,15,7,5,9,1,3,15,20.0,12,9,0,9,9,24,1,0,"FW,MF",30-34,Forward,Spain,Europe
1919,Pedro,ESP,Chelsea,Premier League,2019,32.0,1987.0,7.3,15,7,5,9,1,3,15,20.0,12,9,0,9,9,24,1,0,"FW,MF",30-34,Forward,Spain,Europe
1919,Pedro,ESP,Chelsea,Premier League,2019,32.0,1987.0,7.3,15,7,5,9,1,3,15,20.0,12,9,0,9,9,24,1,0,"FW,MF",30-34,Forward,Spain,Europe
1919,Pedro,ESP,Chelsea,Premier League,2019,32.0,1987.0,7.3,15,7,5,9,1,3,15,20.0,12,9,0,9,9,24,1,0,"FW,MF",30-34,Forward,Spain,Europe
1919,Pedro,ESP,Chelsea,Premier League,2019,32.0,1987.0,7.3,15,7,5,9,1,3,15,20.0,12,9,0,9,9,24,1,0,"FW,MF",30-34,Forward,Spain,Europe
1919,Pedro,ESP,Chelsea,Premier League,2019,32.0,1987.0,7.3,15,7,5,9,1,3,15,20.0,12,9,0,9,9,24,1,0,"FW,MF",30-34,Forward,Spain,Europe
1919,Pedro,ESP,Chelsea,Premier League,2019,32.0,1987.0,7.3,15,7,5,9,1,3,15,20.0,12,9,0,9,9,24,1,0,"FW,MF",30-34,Forward,Spain,Europe
1919,Pedro,ESP,Chelsea,Premier League,2019,32.0,1987.0,7.3,15,7,5,9,1,3,15,20.0,12,9,0,9,9,24,1,0,"FW,MF",30-34,Forward,Spain,Europe
1922,Adrià Pedrosa,ESP,Espanyol,La Liga,2019,21.0,1998.0,12.1,19,13,8,9,2,7,25,28.0,18,12,1,11,11,30,32,0,"DF,MF",20-24,Defender,Spain,Europe
1933,Rubén Peña,ESP,Villarreal,La Liga,2019,28.0,1991.0,21.2,42,24,23,19,0,17,50,34.0,33,25,8,17,35,77,58,2,DF,25-29,Defender,Spain,Europe
1936,Luis Perea,ESP,Osasuna,La Liga,2019,21.0,1997.0,0.2,0,0,0,0,0,0,0,,0,0,0,0,0,0,1,0,FW,20-24,Forward,Spain,Europe
1943,Ayoze Pérez,ESP,Leicester City,Premier League,2019,26.0,1993.0,22.3,45,28,14,26,5,8,54,14.8,46,33,1,32,14,59,9,1,"MF,FW",25-29,Midfielder,Spain,Europe
1944,Carles Pérez,ESP,Roma,Serie A,2019,21.0,1998.0,6.3,12,8,4,6,2,3,10,30.0,7,6,1,5,3,15,1,0,"FW,MF",20-24,Forward,Spain,Europe
1945,Carles Pérez,ESP,Barcelona,La Liga,2019,21.0,1998.0,5.3,7,4,2,2,3,3,15,20.0,12,5,2,3,1,8,1,0,FW,20-24,Forward,Spain,Europe
1946,Iñigo Pérez,ESP,Osasuna,La Liga,2019,31.0,1988.0,12.0,15,11,3,7,5,8,22,36.4,14,7,1,6,12,27,6,0,MF,30-34,Midfielder,Spain,Europe
1947,Juan Pérez,ESP,Osasuna,La Liga,2019,23.0,1996.0,2.0,1,1,1,0,0,1,2,50.0,1,0,0,0,0,1,0,0,GK,20-24,Goalkeeper,Spain,Europe
1948,Kike Pérez,ESP,Valladolid,La Liga,2019,22.0,1997.0,2.4,6,1,1,3,2,3,7,42.9,4,1,0,1,10,16,4,0,"MF,FW",20-24,Midfielder,Spain,Europe
1949,Lucas Pérez,ESP,Alavés,La Liga,2019,30.0,1988.0,27.7,12,6,2,8,2,3,13,23.1,10,13,2,11,2,14,0,0,FW,30-34,Forward,Spain,Europe
1950,Rubén Pérez,ESP,Leganés,La Liga,2019,30.0,1989.0,24.4,50,27,21,23,6,16,47,34.0,31,21,4,17,38,88,33,0,MF,30-34,Midfielder,Spain,Europe
1951,Samu Pérez,ESP,Valladolid,La Liga,2019,22.0,1997.0,0.3,0,0,0,0,0,0,0,,0,0,0,0,0,0,0,0,GK,20-24,Goalkeeper,Spain,Europe
1963,Denis Petrić,SRB,Nantes,Ligue 1,2019,31.0,1988.0,1.0,1,1,1,0,0,1,1,100.0,0,0,0,0,0,1,0,0,GK,30-34,Goalkeeper,Serbia,Europe
1970,Krzysztof Piątek,POL,Milan,Serie A,2019,24.0,1995.0,13.1,9,4,0,7,2,3,11,27.3,8,5,2,3,3,12,10,0,FW,20-24,Forward,Poland,Europe
1971,Krzysztof Piątek,POL,Hertha BSC,Bundesliga,2019,24.0,1995.0,10.1,5,4,1,1,3,0,11,0.0,11,7,0,7,5,10,3,0,FW,20-24,Forward,Poland,Europe
1981,Tomás Pina Isla,ESP,Alavés,La Liga,2019,31.0,1987.0,14.9,37,22,13,21,3,12,24,50.0,12,15,5,10,16,53,31,0,MF,30-34,Midfielder,Spain,Europe
1985,Pipa,ESP,Espanyol,La Liga,2019,21.0,1998.0,5.3,9,8,5,4,0,4,6,66.7,2,8,0,8,6,15,17,0,"DF,FW",20-24,Defender,Spain,Europe
1986,Gerard Piqué,ESP,Barcelona,La Liga,2019,32.0,1987.0,34.4,32,23,20,11,1,16,26,61.5,10,39,24,15,36,68,157,0,DF,30-34,Defender,Spain,Europe
1989,Łukasz Piszczek,POL,Dortmund,Bundesliga,2019,34.0,1985.0,23.4,45,32,27,16,2,28,50,56.0,22,27,11,16,26,71,47,1,DF,30-34,Defender,Poland,Europe
1992,Óscar Plano,ESP,Valladolid,La Liga,2019,28.0,1991.0,27.8,48,30,25,19,4,20,61,32.8,41,36,3,33,35,83,29,0,MF,25-29,Midfielder,Spain,Europe
2004,Pere Pons,ESP,Alavés,La Liga,2019,26.0,1993.0,12.1,28,16,14,12,2,12,26,46.2,14,16,3,13,12,40,8,1,MF,25-29,Midfielder,Spain,Europe
2006,Pedro Porro,ESP,Valladolid,La Liga,2019,19.0,1999.0,8.2,18,10,11,7,0,10,18,55.6,8,3,0,3,7,25,19,1,"DF,MF",Under 20,Defender,Spain,Europe
2007,Francisco Portillo,ESP,Getafe,La Liga,2019,29.0,1990.0,4.2,11,6,3,6,2,4,12,33.3,8,2,0,2,2,13,3,0,MF,25-29,Midfielder,Spain,Europe
2008,Portu,ESP,Real Sociedad,La Liga,2019,27.0,1992.0,26.6,32,21,10,15,7,13,33,39.4,20,28,3,25,13,45,5,0,"FW,MF",25-29,Forward,Spain,Europe
2010,Sergio Postigo,ESP,Levante,La Liga,2019,30.0,1988.0,26.4,32,15,23,7,2,11,18,61.1,7,24,15,9,34,66,132,1,DF,30-34,Defender,Spain,Europe
2014,Darío Poveda,ESP,Atlético Madrid,La Liga,2019,22.0,1997.0,0.1,1,0,0,1,0,0,0,,0,0,0,0,0,1,0,0,MF,20-24,Midfielder,Spain,Europe
2015,Alejandro Pozo Pozo,ESP,Mallorca,La Liga,2019,20.0,1999.0,16.6,38,24,30,6,2,19,38,50.0,19,23,2,21,23,61,29,1,DF,20-24,Defender,Spain,Europe
2016,Alejandro Pozo Pozo,ESP,Sevilla,La Liga,2019,20.0,1999.0,0.4,1,1,1,0,0,1,1,100.0,0,0,0,0,0,1,1,0,"MF,FW",20-24,Midfielder,Spain,Europe
2019,Abdón Prats,ESP,Mallorca,La Liga,2019,26.0,1992.0,3.1,1,1,0,0,1,0,1,0.0,1,1,0,1,0,1,1,0,FW,25-29,Forward,Spain,Europe
2026,Antonio Puertas,ESP,Granada,La Liga,2019,27.0,1992.0,28.5,37,24,8,18,11,16,53,30.2,37,21,3,18,12,49,21,0,"FW,MF",25-29,Forward,Spain,Europe
2027,Riqui Puig,ESP,Barcelona,La Liga,2019,19.0,1999.0,5.7,11,7,1,9,1,5,17,29.4,12,2,0,2,5,16,1,0,MF,Under 20,Midfielder,Spain,Europe
2036,Quini,ESP,Granada,La Liga,2019,29.0,1989.0,8.0,25,14,16,7,2,13,22,59.1,9,5,1,4,10,35,14,0,DF,25-29,Defender,Spain,Europe
2037,Xavi Quintillà,ESP,Villarreal,La Liga,2019,22.0,1996.0,17.5,22,12,14,4,4,10,20,50.0,10,11,4,7,12,34,35,0,DF,20-24,Defender,Spain,Europe
2038,Quique,ESP,Eibar,La Liga,2019,29.0,1990.0,5.4,2,1,1,0,1,0,0,,0,3,0,3,0,2,3,0,"FW,MF",25-29,Forward,Spain,Europe
2040,Nemanja Radoja,SRB,Levante,La Liga,2019,26.0,1993.0,22.1,43,19,27,16,0,15,46,32.6,31,21,4,17,23,66,24,0,MF,25-29,Midfielder,Serbia,Europe
2041,Nemanja Radonjić,SRB,Marseille,Ligue 1,2019,23.0,1996.0,9.8,10,3,4,3,3,6,17,35.3,11,7,0,7,2,12,7,0,"FW,MF",20-24,Forward,Serbia,Europe
2042,Ivan Radovanović,SRB,Genoa,Serie A,2019,30.0,1988.0,14.6,27,14,18,9,0,10,26,38.5,16,17,3,14,8,35,39,0,MF,30-34,Midfielder,Serbia,Europe
2045,Boris Radunović,SRB,Hellas Verona,Serie A,2019,23.0,1996.0,3.0,0,0,0,0,0,0,0,,0,0,0,0,0,0,1,0,GK,20-24,Goalkeeper,Serbia,Europe
2049,Rafinha,BRA,Barcelona,La Liga,2019,26.0,1993.0,2.1,3,2,1,1,1,1,2,50.0,1,0,0,0,1,4,0,0,"FW,MF",25-29,Forward,Brazil,South America
2049,Rafinha,BRA,Barcelona,La Liga,2019,26.0,1993.0,2.1,3,2,1,1,1,1,2,50.0,1,0,0,0,1,4,0,0,"FW,MF",25-29,Forward,Brazil,South America
2049,Rafinha,BRA,Barcelona,La Liga,2019,26.0,1993.0,2.1,3,2,1,1,1,1,2,50.0,1,0,0,0,1,4,0,0,"FW,MF",25-29,Forward,Brazil,South America
2049,Rafinha,BRA,Barcelona,La Liga,2019,26.0,1993.0,2.1,3,2,1,1,1,1,2,50.0,1,0,0,0,1,4,0,0,"FW,MF",25-29,Forward,Brazil,South America
2049,Rafinha,BRA,Barcelona,La Liga,2019,26.0,1993.0,2.1,3,2,1,1,1,1,2,50.0,1,0,0,0,1,4,0,0,"FW,MF",25-29,Forward,Brazil,South America
2049,Rafinha,BRA,Barcelona,La Liga,2019,26.0,1993.0,2.1,3,2,1,1,1,1,2,50.0,1,0,0,0,1,4,0,0,"FW,MF",25-29,Forward,Brazil,South America
2049,Rafinha,BRA,Barcelona,La Liga,2019,26.0,1993.0,2.1,3,2,1,1,1,1,2,50.0,1,0,0,0,1,4,0,0,"FW,MF",25-29,Forward,Brazil,South America
2049,Rafinha,BRA,Barcelona,La Liga,2019,26.0,1993.0,2.1,3,2,1,1,1,1,2,50.0,1,0,0,0,1,4,0,0,"FW,MF",25-29,Forward,Brazil,South America
2049,Rafinha,BRA,Barcelona,La Liga,2019,26.0,1993.0,2.1,3,2,1,1,1,1,2,50.0,1,0,0,0,1,4,0,0,"FW,MF",25-29,Forward,Brazil,South America
2049,Rafinha,BRA,Barcelona,La Liga,2019,26.0,1993.0,2.1,3,2,1,1,1,1,2,50.0,1,0,0,0,1,4,0,0,"FW,MF",25-29,Forward,Brazil,South America
2049,Rafinha,BRA,Barcelona,La Liga,2019,26.0,1993.0,2.1,3,2,1,1,1,1,2,50.0,1,0,0,0,1,4,0,0,"FW,MF",25-29,Forward,Brazil,South America
2049,Rafinha,BRA,Barcelona,La Liga,2019,26.0,1993.0,2.1,3,2,1,1,1,1,2,50.0,1,0,0,0,1,4,0,0,"FW,MF",25-29,Forward,Brazil,South America
2049,Rafinha,BRA,Barcelona,La Liga,2019,26.0,1993.0,2.1,3,2,1,1,1,1,2,50.0,1,0,0,0,1,4,0,0,"FW,MF",25-29,Forward,Brazil,South America
2049,Rafinha,BRA,Barcelona,La Liga,2019,26.0,1993.0,2.1,3,2,1,1,1,1,2,50.0,1,0,0,0,1,4,0,0,"FW,MF",25-29,Forward,Brazil,South America
2049,Rafinha,BRA,Barcelona,La Liga,2019,26.0,1993.0,2.1,3,2,1,1,1,1,2,50.0,1,0,0,0,1,4,0,0,"FW,MF",25-29,Forward,Brazil,South America
2049,Rafinha,BRA,Barcelona,La Liga,2019,26.0,1993.0,2.1,3,2,1,1,1,1,2,50.0,1,0,0,0,1,4,0,0,"FW,MF",25-29,Forward,Brazil,South America
2050,Rafinha,BRA,Celta Vigo,La Liga,2019,26.0,1993.0,23.5,71,37,29,37,5,20,62,32.3,42,37,4,33,33,104,25,0,MF,25-29,Midfielder,Brazil,South America
2050,Rafinha,BRA,Celta Vigo,La Liga,2019,26.0,1993.0,23.5,71,37,29,37,5,20,62,32.3,42,37,4,33,33,104,25,0,MF,25-29,Midfielder,Brazil,South America
2050,Rafinha,BRA,Celta Vigo,La Liga,2019,26.0,1993.0,23.5,71,37,29,37,5,20,62,32.3,42,37,4,33,33,104,25,0,MF,25-29,Midfielder,Brazil,South America
2050,Rafinha,BRA,Celta Vigo,La Liga,2019,26.0,1993.0,23.5,71,37,29,37,5,20,62,32.3,42,37,4,33,33,104,25,0,MF,25-29,Midfielder,Brazil,South America
2050,Rafinha,BRA,Celta Vigo,La Liga,2019,26.0,1993.0,23.5,71,37,29,37,5,20,62,32.3,42,37,4,33,33,104,25,0,MF,25-29,Midfielder,Brazil,South America
2050,Rafinha,BRA,Celta Vigo,La Liga,2019,26.0,1993.0,23.5,71,37,29,37,5,20,62,32.3,42,37,4,33,33,104,25,0,MF,25-29,Midfielder,Brazil,South America
2050,Rafinha,BRA,Celta Vigo,La Liga,2019,26.0,1993.0,23.5,71,37,29,37,5,20,62,32.3,42,37,4,33,33,104,25,0,MF,25-29,Midfielder,Brazil,South America
2050,Rafinha,BRA,Celta Vigo,La Liga,2019,26.0,1993.0,23.5,71,37,29,37,5,20,62,32.3,42,37,4,33,33,104,25,0,MF,25-29,Midfielder,Brazil,South America
2050,Rafinha,BRA,Celta Vigo,La Liga,2019,26.0,1993.0,23.5,71,37,29,37,5,20,62,32.3,42,37,4,33,33,104,25,0,MF,25-29,Midfielder,Brazil,South America
2050,Rafinha,BRA,Celta Vigo,La Liga,2019,26.0,1993.0,23.5,71,37,29,37,5,20,62,32.3,42,37,4,33,33,104,25,0,MF,25-29,Midfielder,Brazil,South America
2050,Rafinha,BRA,Celta Vigo,La Liga,2019,26.0,1993.0,23.5,71,37,29,37,5,20,62,32.3,42,37,4,33,33,104,25,0,MF,25-29,Midfielder,Brazil,South America
2050,Rafinha,BRA,Celta Vigo,La Liga,2019,26.0,1993.0,23.5,71,37,29,37,5,20,62,32.3,42,37,4,33,33,104,25,0,MF,25-29,Midfielder,Brazil,South America
2050,Rafinha,BRA,Celta Vigo,La Liga,2019,26.0,1993.0,23.5,71,37,29,37,5,20,62,32.3,42,37,4,33,33,104,25,0,MF,25-29,Midfielder,Brazil,South America
2050,Rafinha,BRA,Celta Vigo,La Liga,2019,26.0,1993.0,23.5,71,37,29,37,5,20,62,32.3,42,37,4,33,33,104,25,0,MF,25-29,Midfielder,Brazil,South America
2050,Rafinha,BRA,Celta Vigo,La Liga,2019,26.0,1993.0,23.5,71,37,29,37,5,20,62,32.3,42,37,4,33,33,104,25,0,MF,25-29,Midfielder,Brazil,South America
2050,Rafinha,BRA,Celta Vigo,La Liga,2019,26.0,1993.0,23.5,71,37,29,37,5,20,62,32.3,42,37,4,33,33,104,25,0,MF,25-29,Midfielder,Brazil,South America
2051,Daniele Ragatzu,ITA,Cagliari,Serie A,2019,27.0,1991.0,3.5,3,2,0,2,1,1,3,33.3,2,1,0,1,1,4,5,0,"MF,FW",25-29,Midfielder,Italy,Europe
2052,Baba Rahman,GHA,Mallorca,La Liga,2019,25.0,1994.0,1.2,3,2,2,0,1,0,0,,0,2,1,1,1,4,2,0,DF,25-29,Defender,Ghana,Africa
2055,Ivan Rakitić,CRO,Barcelona,La Liga,2019,31.0,1988.0,17.7,27,14,8,15,4,10,28,35.7,18,19,6,13,15,42,18,1,MF,30-34,Midfielder,Croatia,Europe
2056,Benito Raman,BEL,Schalke 04,Bundesliga,2019,24.0,1994.0,17.8,18,9,4,9,5,7,24,29.2,17,11,1,10,7,25,1,0,FW,20-24,Forward,Belgium,Europe
2057,Gastón Ramírez,URU,Sampdoria,Serie A,2019,28.0,1990.0,15.5,32,21,7,16,9,8,30,26.7,22,28,2,26,11,43,10,0,"MF,FW",25-29,Midfielder,Uruguay,South America
2060,Adrián Ramos,COL,Granada,La Liga,2019,33.0,1986.0,2.5,6,2,0,2,4,2,3,66.7,1,2,0,2,1,7,1,0,"FW,MF",30-34,Forward,Colombia,South America
2062,Aaron Ramsdale,ENG,Bournemouth,Premier League,2019,21.0,1998.0,37.0,4,3,4,0,0,3,3,100.0,0,0,0,0,0,4,25,1,GK,20-24,Goalkeeper,England,Europe
2063,Aaron Ramsey,WAL,Juventus,Serie A,2019,28.0,1990.0,11.7,20,15,6,8,6,6,24,25.0,18,18,3,15,11,31,12,0,MF,25-29,Midfielder,Wales,Europe
2063,Aaron Ramsey,WAL,Juventus,Serie A,2019,28.0,1990.0,11.7,20,15,6,8,6,6,24,25.0,18,18,3,15,11,31,12,0,MF,25-29,Midfielder,Wales,Europe
2063,Aaron Ramsey,WAL,Juventus,Serie A,2019,28.0,1990.0,11.7,20,15,6,8,6,6,24,25.0,18,18,3,15,11,31,12,0,MF,25-29,Midfielder,Wales,Europe
2063,Aaron Ramsey,WAL,Juventus,Serie A,2019,28.0,1990.0,11.7,20,15,6,8,6,6,24,25.0,18,18,3,15,11,31,12,0,MF,25-29,Midfielder,Wales,Europe
2064,Darren Randolph,IRL,West Ham,Premier League,2019,32.0,1987.0,2.0,0,0,0,0,0,0,0,,0,0,0,0,0,0,2,0,GK,30-34,Goalkeeper,Republic of Ireland,Europe
2065,Luca Ranieri,ITA,Fiorentina,Serie A,2019,20.0,1999.0,2.6,2,2,2,0,0,2,3,66.7,1,1,0,1,2,4,7,0,DF,20-24,Defender,Italy,Europe
2066,Andrea Ranocchia,ITA,Inter,Serie A,2019,31.0,1988.0,5.8,17,10,10,7,0,5,8,62.5,3,11,6,5,8,25,18,0,DF,30-34,Defender,Italy,Europe
2067,Raphinha,BRA,Rennes,Ligue 1,2019,22.0,1996.0,18.8,22,18,5,12,5,10,32,31.3,22,23,1,22,17,39,14,1,"MF,FW",20-24,Midfielder,Brazil,South America
2068,Tobias Raschl,GER,Dortmund,Bundesliga,2019,19.0,2000.0,0.3,0,0,0,0,0,0,1,0.0,1,1,0,1,0,0,0,0,MF,Under 20,Midfielder,Germany,Europe
2069,Marcus Rashford,ENG,Manchester Utd,Premier League,2019,21.0,1997.0,29.4,13,9,1,6,6,9,23,39.1,14,23,0,23,10,23,19,0,FW,20-24,Forward,England,Europe
2071,Giacomo Raspadori,ITA,Sassuolo,Serie A,2019,19.0,2000.0,2.9,8,6,5,2,1,3,4,75.0,1,5,0,5,1,9,0,0,"MF,FW",Under 20,Midfielder,Italy,Europe
2073,Ante Rebić,CRO,Milan,Serie A,2019,25.0,1993.0,15.5,16,11,4,9,3,7,34,20.6,27,14,1,13,3,19,12,0,"FW,MF",25-29,Forward,Croatia,Europe
2074,Ante Rebić,CRO,Eint Frankfurt,Bundesliga,2019,25.0,1993.0,1.0,1,0,0,1,0,0,0,,0,0,0,0,0,1,1,0,"FW,MF",25-29,Forward,Croatia,Europe
2077,Daishawn Redan,NED,Hertha BSC,Bundesliga,2019,18.0,2001.0,0.2,0,0,0,0,0,0,1,0.0,1,0,0,0,0,0,0,0,MF,Under 20,Midfielder,Netherlands,Europe
2078,Nathan Redmond,ENG,Southampton,Premier League,2019,25.0,1994.0,30.7,49,29,17,23,9,21,57,36.8,36,39,2,37,16,65,16,0,"MF,FW",25-29,Midfielder,England,Europe
2079,Fabian Reese,GER,Schalke 04,Bundesliga,2019,21.0,1997.0,1.0,1,1,1,0,0,0,0,,0,1,1,0,0,1,1,0,FW,20-24,Forward,Germany,Europe
2080,Vasco Regini,ITA,Sampdoria,Serie A,2019,28.0,1990.0,1.9,4,2,3,1,0,0,0,,0,4,2,2,1,5,6,0,DF,25-29,Defender,Italy,Europe
2081,Vasco Regini,ITA,Parma,Serie A,2019,28.0,1990.0,0.6,0,0,0,0,0,0,0,,0,0,0,0,0,0,3,0,DF,25-29,Defender,Italy,Europe
2083,Ken Reichel,GER,Union Berlin,Bundesliga,2019,32.0,1986.0,5.9,6,3,2,3,1,3,13,23.1,10,8,1,7,9,15,12,0,DF,30-34,Defender,Germany,Europe
2087,Jeff Reine-Adélaïde,FRA,Angers,Ligue 1,2019,21.0,1998.0,0.9,3,1,1,2,0,1,1,100.0,0,1,0,1,0,3,1,0,MF,20-24,Midfielder,France,Europe
2088,Jeff Reine-Adélaïde,FRA,Lyon,Ligue 1,2019,21.0,1998.0,8.7,10,8,3,3,4,5,13,38.5,8,3,1,2,7,17,4,0,"MF,FW",20-24,Midfielder,France,Europe
2089,Karim Rekik,NED,Hertha BSC,Bundesliga,2019,24.0,1994.0,14.0,16,10,10,6,0,3,6,50.0,3,23,15,8,18,34,44,0,DF,20-24,Defender,Netherlands,Europe
2091,Loïc Rémy,FRA,Lille,Ligue 1,2019,32.0,1987.0,10.7,4,1,0,3,1,0,4,0.0,4,1,1,0,0,4,7,0,FW,30-34,Forward,France,Europe
2092,Panagiotis Retsos,GRE,Leverkusen,Bundesliga,2019,20.0,1998.0,1.3,6,3,4,2,0,1,4,25.0,3,2,0,2,2,8,2,0,DF,20-24,Defender,Greece,Europe
2093,Marco Reus,GER,Dortmund,Bundesliga,2019,30.0,1989.0,16.6,26,16,5,11,10,3,19,15.8,16,17,2,15,9,35,11,0,"MF,FW",30-34,Midfielder,Germany,Europe
2095,Gio Reyna,USA,Dortmund,Bundesliga,2019,16.0,2002.0,3.9,6,2,1,5,0,1,4,25.0,3,3,0,3,0,6,2,0,"MF,FW",Under 20,Midfielder,United States,North America
2096,Baptiste Reynet,FRA,Toulouse,Ligue 1,2019,28.0,1990.0,22.6,1,1,1,0,0,1,3,33.3,2,0,0,0,0,1,12,0,GK,25-29,Goalkeeper,France,Europe
2098,Lucas Ribeiro,BRA,Hoffenheim,Bundesliga,2019,20.0,1999.0,0.7,1,0,1,0,0,0,3,0.0,3,1,0,1,1,2,1,0,MF,20-24,Midfielder,Brazil,South America
2099,Franck Ribéry,FRA,Fiorentina,Serie A,2019,36.0,1983.0,15.7,20,14,7,10,3,4,20,20.0,16,9,0,9,3,23,3,0,FW,35-39,Forward,France,Europe
2100,Davide Riccardi,ITA,Lecce,Serie A,2019,23.0,1996.0,0.2,0,0,0,0,0,0,1,0.0,1,0,0,0,0,0,1,0,DF,20-24,Defender,Italy,Europe
2101,Declan Rice,ENG,West Ham,Premier League,2019,20.0,1999.0,38.0,116,60,64,48,4,47,98,48.0,51,41,9,32,77,193,55,0,MF,20-24,Midfielder,England,Europe
2102,Chris Richards,USA,Bayern Munich,Bundesliga,2019,19.0,2000.0,0.1,0,0,0,0,0,0,0,,0,0,0,0,0,0,1,0,DF,Under 20,Defender,United States,North America
2103,Richarlison,BRA,Everton,Premier League,2019,22.0,1997.0,34.1,70,47,28,28,14,27,56,48.2,29,34,4,30,12,82,42,0,"FW,MF",20-24,Forward,Brazil,South America
2104,Marco Richter,GER,Augsburg,Bundesliga,2019,21.0,1997.0,25.3,21,16,7,9,5,14,51,27.5,37,15,0,15,24,45,17,0,"MF,FW",20-24,Midfielder,Germany,Europe
2107,Jaïro Riedewald,NED,Crystal Palace,Premier League,2019,22.0,1996.0,8.5,14,10,4,10,0,7,11,63.6,4,7,2,5,17,31,23,1,"DF,MF",20-24,Defender,Netherlands,Europe
2108,Emiliano Rigoni,ARG,Sampdoria,Serie A,2019,26.0,1993.0,4.8,5,4,2,1,2,3,10,30.0,7,5,1,4,3,8,1,0,"MF,FW",25-29,Midfielder,Argentina,South America
2109,Tomás Rincón,VEN,Torino,Serie A,2019,31.0,1988.0,30.0,56,25,23,25,8,23,65,35.4,42,20,3,17,36,92,62,0,MF,30-34,Midfielder,Venezuela,South America
2111,Renaud Ripart,FRA,Nîmes,Ligue 1,2019,26.0,1993.0,22.5,39,23,17,20,2,18,46,39.1,28,17,2,15,12,51,37,0,"FW,DF",25-29,Forward,France,Europe
2113,Andrea Rispoli,ITA,Lecce,Serie A,2019,30.0,1988.0,21.2,24,18,14,9,1,15,30,50.0,15,28,7,21,32,56,62,1,DF,30-34,Defender,Italy,Europe
2114,Marcel Risse,GER,Köln,Bundesliga,2019,29.0,1989.0,1.5,3,2,3,0,0,1,1,100.0,0,1,0,1,1,4,1,0,"MF,FW",25-29,Midfielder,Germany,Europe
2116,Matt Ritchie,SCO,Newcastle Utd,Premier League,2019,29.0,1989.0,14.6,22,15,9,10,3,3,15,20.0,12,20,5,15,14,36,31,1,"DF,MF",25-29,Defender,Scotland,Europe
2117,Marlon Ritter,GER,Paderborn 07,Bundesliga,2019,24.0,1994.0,4.8,7,5,5,2,0,4,9,44.4,5,7,0,7,8,15,3,0,MF,20-24,Midfielder,Germany,Europe
2119,Maxence Rivera,FRA,Saint-Étienne,Ligue 1,2019,17.0,2002.0,0.3,0,0,0,0,0,0,1,0.0,1,1,0,1,0,0,0,0,"MF,FW",Under 20,Midfielder,France,Europe
2124,Patrick Roberts,ENG,Norwich City,Premier League,2019,22.0,1997.0,0.3,0,0,0,0,0,0,0,,0,0,0,0,0,0,0,0,"FW,MF",20-24,Forward,England,Europe
2125,Andrew Robertson,SCO,Liverpool,Premier League,2019,25.0,1994.0,34.6,54,31,17,25,12,27,61,44.3,34,29,7,22,38,92,72,1,DF,25-29,Defender,Scotland,Europe
2126,Callum Robinson,IRL,Sheffield Utd,Premier League,2019,24.0,1995.0,7.5,6,3,2,2,2,2,7,28.6,5,3,0,3,7,13,3,0,"FW,MF",20-24,Forward,Republic of Ireland,Europe
2127,Jack Robinson,ENG,Sheffield Utd,Premier League,2019,25.0,1993.0,5.6,10,5,5,5,0,1,6,16.7,5,12,5,7,8,18,24,0,DF,25-29,Defender,England,Europe
2131,Sebastian Rode,GER,Eint Frankfurt,Bundesliga,2019,28.0,1990.0,21.5,58,33,27,27,4,17,59,28.8,42,32,5,27,34,92,13,0,MF,25-29,Midfielder,Germany,Europe
2134,Kévin Rodrigues,POR,Leganés,La Liga,2019,25.0,1994.0,21.5,56,31,31,17,8,25,46,54.3,21,30,3,27,31,87,26,1,"DF,MF",25-29,Defender,Portugal,Europe
2135,Kévin Rodrigues,POR,Real Sociedad,La Liga,2019,25.0,1994.0,0.1,1,0,1,0,0,1,1,100.0,0,0,0,0,0,1,0,0,DF,25-29,Defender,Portugal,Europe
2139,Guido Rodríguez,ARG,Betis,La Liga,2019,25.0,1994.0,10.4,24,16,11,11,2,15,25,60.0,10,13,4,9,10,34,21,0,MF,25-29,Midfielder,Argentina,South America
2140,James Rodríguez,COL,Real Madrid,La Liga,2019,28.0,1991.0,4.7,17,13,6,8,3,6,12,50.0,6,3,0,3,3,20,1,0,"MF,FW",25-29,Midfielder,Colombia,South America
2141,Jay Rodriguez,ENG,Burnley,Premier League,2019,30.0,1989.0,22.4,29,19,4,13,12,8,33,24.2,25,33,6,27,5,34,12,0,FW,30-34,Forward,England,Europe
2143,Ricardo Rodríguez,SUI,Milan,Serie A,2019,26.0,1992.0,4.3,6,1,2,2,2,2,6,33.3,4,3,2,1,5,11,17,0,DF,25-29,Defender,Switzerland,Europe
2144,Rodrygo,BRA,Real Madrid,La Liga,2019,18.0,2001.0,11.3,6,1,2,3,1,2,21,9.5,19,13,0,13,10,16,5,0,FW,Under 20,Forward,Brazil,South America
2145,Jack Rodwell,ENG,Sheffield Utd,Premier League,2019,28.0,1991.0,0.2,0,0,0,0,0,0,0,,0,0,0,0,0,0,1,0,MF,25-29,Midfielder,England,Europe
2146,Marko Rog,CRO,Cagliari,Serie A,2019,24.0,1995.0,25.7,69,47,31,29,9,22,84,26.2,62,40,12,28,22,91,23,0,MF,20-24,Midfielder,Croatia,Europe
2147,Agustín Rogel,URU,Toulouse,Ligue 1,2019,21.0,1997.0,9.5,15,8,12,3,0,7,13,53.8,6,13,10,3,11,26,35,2,DF,20-24,Defender,Uruguay,South America
2148,Rogério,BRA,Sassuolo,Serie A,2019,21.0,1998.0,11.3,22,14,12,8,2,16,23,69.6,7,13,3,10,9,31,34,0,DF,20-24,Defender,Brazil,South America
2148,Rogério,BRA,Sassuolo,Serie A,2019,21.0,1998.0,11.3,22,14,12,8,2,16,23,69.6,7,13,3,10,9,31,34,0,DF,20-24,Defender,Brazil,South America
2148,Rogério,BRA,Sassuolo,Serie A,2019,21.0,1998.0,11.3,22,14,12,8,2,16,23,69.6,7,13,3,10,9,31,34,0,DF,20-24,Defender,Brazil,South America
2148,Rogério,BRA,Sassuolo,Serie A,2019,21.0,1998.0,11.3,22,14,12,8,2,16,23,69.6,7,13,3,10,9,31,34,0,DF,20-24,Defender,Brazil,South America
2149,Marcos Rojo,ARG,Manchester Utd,Premier League,2019,29.0,1990.0,1.4,3,1,2,1,0,1,2,50.0,1,2,1,1,0,3,6,0,DF,25-29,Defender,Argentina,South America
2150,Filippo Romagna,ITA,Sassuolo,Serie A,2019,22.0,1997.0,16.4,7,6,2,5,0,5,6,83.3,1,24,17,7,10,17,69,0,DF,20-24,Defender,Italy,Europe
2151,Alessio Romagnoli,ITA,Milan,Serie A,2019,24.0,1995.0,34.3,46,25,28,15,3,16,27,59.3,11,32,18,14,56,102,157,1,DF,20-24,Defender,Italy,Europe
2153,Cristian Romero,ARG,Genoa,Serie A,2019,21.0,1998.0,28.6,52,35,36,12,4,12,41,29.3,29,59,33,26,75,127,116,2,DF,20-24,Defender,Argentina,South America
2154,Luka Romero,ARG,Mallorca,La Liga,2019,14.0,2004.0,0.1,0,0,0,0,0,0,0,,0,0,0,0,0,0,0,0,FW,Under 20,Forward,Argentina,South America
2156,Rômulo,ITA,Brescia,Serie A,2019,32.0,1987.0,19.1,30,19,12,14,4,12,34,35.3,22,18,1,17,8,38,12,1,MF,30-34,Midfielder,Italy,Europe
2156,Rômulo,ITA,Brescia,Serie A,2019,32.0,1987.0,19.1,30,19,12,14,4,12,34,35.3,22,18,1,17,8,38,12,1,MF,30-34,Midfielder,Italy,Europe
2156,Rômulo,ITA,Brescia,Serie A,2019,32.0,1987.0,19.1,30,19,12,14,4,12,34,35.3,22,18,1,17,8,38,12,1,MF,30-34,Midfielder,Italy,Europe
2156,Rômulo,ITA,Brescia,Serie A,2019,32.0,1987.0,19.1,30,19,12,14,4,12,34,35.3,22,18,1,17,8,38,12,1,MF,30-34,Midfielder,Italy,Europe
2156,Rômulo,ITA,Brescia,Serie A,2019,32.0,1987.0,19.1,30,19,12,14,4,12,34,35.3,22,18,1,17,8,38,12,1,MF,30-34,Midfielder,Italy,Europe
2156,Rômulo,ITA,Brescia,Serie A,2019,32.0,1987.0,19.1,30,19,12,14,4,12,34,35.3,22,18,1,17,8,38,12,1,MF,30-34,Midfielder,Italy,Europe
2156,Rômulo,ITA,Brescia,Serie A,2019,32.0,1987.0,19.1,30,19,12,14,4,12,34,35.3,22,18,1,17,8,38,12,1,MF,30-34,Midfielder,Italy,Europe
2156,Rômulo,ITA,Brescia,Serie A,2019,32.0,1987.0,19.1,30,19,12,14,4,12,34,35.3,22,18,1,17,8,38,12,1,MF,30-34,Midfielder,Italy,Europe
2156,Rômulo,ITA,Brescia,Serie A,2019,32.0,1987.0,19.1,30,19,12,14,4,12,34,35.3,22,18,1,17,8,38,12,1,MF,30-34,Midfielder,Italy,Europe
2156,Rômulo,ITA,Brescia,Serie A,2019,32.0,1987.0,19.1,30,19,12,14,4,12,34,35.3,22,18,1,17,8,38,12,1,MF,30-34,Midfielder,Italy,Europe
2156,Rômulo,ITA,Brescia,Serie A,2019,32.0,1987.0,19.1,30,19,12,14,4,12,34,35.3,22,18,1,17,8,38,12,1,MF,30-34,Midfielder,Italy,Europe
2156,Rômulo,ITA,Brescia,Serie A,2019,32.0,1987.0,19.1,30,19,12,14,4,12,34,35.3,22,18,1,17,8,38,12,1,MF,30-34,Midfielder,Italy,Europe
2156,Rômulo,ITA,Brescia,Serie A,2019,32.0,1987.0,19.1,30,19,12,14,4,12,34,35.3,22,18,1,17,8,38,12,1,MF,30-34,Midfielder,Italy,Europe
2156,Rômulo,ITA,Brescia,Serie A,2019,32.0,1987.0,19.1,30,19,12,14,4,12,34,35.3,22,18,1,17,8,38,12,1,MF,30-34,Midfielder,Italy,Europe
2156,Rômulo,ITA,Brescia,Serie A,2019,32.0,1987.0,19.1,30,19,12,14,4,12,34,35.3,22,18,1,17,8,38,12,1,MF,30-34,Midfielder,Italy,Europe
2156,Rômulo,ITA,Brescia,Serie A,2019,32.0,1987.0,19.1,30,19,12,14,4,12,34,35.3,22,18,1,17,8,38,12,1,MF,30-34,Midfielder,Italy,Europe
2157,Rômulo,ITA,Genoa,Serie A,2019,32.0,1987.0,0.2,2,1,1,1,0,0,0,,0,0,0,0,0,2,1,0,DF,30-34,Defender,Italy,Europe
2157,Rômulo,ITA,Genoa,Serie A,2019,32.0,1987.0,0.2,2,1,1,1,0,0,0,,0,0,0,0,0,2,1,0,DF,30-34,Defender,Italy,Europe
2157,Rômulo,ITA,Genoa,Serie A,2019,32.0,1987.0,0.2,2,1,1,1,0,0,0,,0,0,0,0,0,2,1,0,DF,30-34,Defender,Italy,Europe
2157,Rômulo,ITA,Genoa,Serie A,2019,32.0,1987.0,0.2,2,1,1,1,0,0,0,,0,0,0,0,0,2,1,0,DF,30-34,Defender,Italy,Europe
2157,Rômulo,ITA,Genoa,Serie A,2019,32.0,1987.0,0.2,2,1,1,1,0,0,0,,0,0,0,0,0,2,1,0,DF,30-34,Defender,Italy,Europe
2157,Rômulo,ITA,Genoa,Serie A,2019,32.0,1987.0,0.2,2,1,1,1,0,0,0,,0,0,0,0,0,2,1,0,DF,30-34,Defender,Italy,Europe
2157,Rômulo,ITA,Genoa,Serie A,2019,32.0,1987.0,0.2,2,1,1,1,0,0,0,,0,0,0,0,0,2,1,0,DF,30-34,Defender,Italy,Europe
2157,Rômulo,ITA,Genoa,Serie A,2019,32.0,1987.0,0.2,2,1,1,1,0,0,0,,0,0,0,0,0,2,1,0,DF,30-34,Defender,Italy,Europe
2157,Rômulo,ITA,Genoa,Serie A,2019,32.0,1987.0,0.2,2,1,1,1,0,0,0,,0,0,0,0,0,2,1,0,DF,30-34,Defender,Italy,Europe
2157,Rômulo,ITA,Genoa,Serie A,2019,32.0,1987.0,0.2,2,1,1,1,0,0,0,,0,0,0,0,0,2,1,0,DF,30-34,Defender,Italy,Europe
2157,Rômulo,ITA,Genoa,Serie A,2019,32.0,1987.0,0.2,2,1,1,1,0,0,0,,0,0,0,0,0,2,1,0,DF,30-34,Defender,Italy,Europe
2157,Rômulo,ITA,Genoa,Serie A,2019,32.0,1987.0,0.2,2,1,1,1,0,0,0,,0,0,0,0,0,2,1,0,DF,30-34,Defender,Italy,Europe
2157,Rômulo,ITA,Genoa,Serie A,2019,32.0,1987.0,0.2,2,1,1,1,0,0,0,,0,0,0,0,0,2,1,0,DF,30-34,Defender,Italy,Europe
2157,Rômulo,ITA,Genoa,Serie A,2019,32.0,1987.0,0.2,2,1,1,1,0,0,0,,0,0,0,0,0,2,1,0,DF,30-34,Defender,Italy,Europe
2157,Rômulo,ITA,Genoa,Serie A,2019,32.0,1987.0,0.2,2,1,1,1,0,0,0,,0,0,0,0,0,2,1,0,DF,30-34,Defender,Italy,Europe
2157,Rômulo,ITA,Genoa,Serie A,2019,32.0,1987.0,0.2,2,1,1,1,0,0,0,,0,0,0,0,0,2,1,0,DF,30-34,Defender,Italy,Europe
2158,Cristiano Ronaldo,POR,Juventus,Serie A,2019,34.0,1985.0,32.4,14,10,3,3,8,4,20,20.0,16,10,3,7,6,20,21,1,FW,30-34,Forward,Portugal,Europe
2159,Facundo Roncaglia,ARG,Osasuna,La Liga,2019,32.0,1987.0,14.2,24,20,12,10,2,11,20,55.0,9,18,3,15,22,46,46,0,DF,30-34,Defender,Argentina,South America
2160,Valentin Rongier,FRA,Marseille,Ligue 1,2019,24.0,1994.0,19.9,76,51,25,41,10,22,63,34.9,41,30,4,26,36,112,16,2,MF,20-24,Midfielder,France,Europe
2161,Valentin Rongier,FRA,Nantes,Ligue 1,2019,24.0,1994.0,3.0,5,4,0,2,3,3,5,60.0,2,4,0,4,2,7,0,0,MF,20-24,Midfielder,France,Europe
2162,Marten de Roon,NED,Atalanta,Serie A,2019,28.0,1991.0,30.2,77,43,36,29,12,34,75,45.3,41,32,8,24,46,123,45,0,"MF,DF",25-29,Midfielder,Netherlands,Europe
2163,Roberto Rosales,VEN,Leganés,La Liga,2019,30.0,1988.0,20.8,42,23,23,17,2,19,43,44.2,24,17,4,13,30,72,48,0,DF,30-34,Defender,Venezuela,South America
2164,Antonio Rosati,ITA,Torino,Serie A,2019,36.0,1983.0,1.0,0,0,0,0,0,0,0,,0,0,0,0,0,0,0,1,GK,35-39,Goalkeeper,Italy,Europe
2165,Danny Rose,ENG,Tottenham,Premier League,2019,29.0,1990.0,9.9,18,11,6,10,2,9,20,45.0,11,14,6,8,8,26,34,2,DF,25-29,Defender,England,Europe
2166,Danny Rose,ENG,Newcastle Utd,Premier League,2019,29.0,1990.0,9.6,21,12,11,8,2,12,21,57.1,9,11,4,7,10,31,14,1,DF,25-29,Defender,England,Europe
2167,Luca Rossettini,ITA,Lecce,Serie A,2019,34.0,1985.0,25.1,25,14,18,7,0,17,34,50.0,17,31,22,9,35,60,126,1,DF,30-34,Defender,Italy,Europe
2168,Francesco Rossi,ITA,Atalanta,Serie A,2019,28.0,1991.0,0.1,0,0,0,0,0,0,0,,0,0,0,0,0,0,0,0,GK,25-29,Goalkeeper,Italy,Europe
2169,Jérôme Roussillon,FRA,Wolfsburg,Bundesliga,2019,26.0,1993.0,26.3,48,29,26,18,4,15,29,51.7,14,33,5,28,30,78,58,0,DF,25-29,Defender,France,Europe
2170,Nolan Roux,FRA,Nîmes,Ligue 1,2019,31.0,1988.0,6.5,5,2,1,3,1,1,3,33.3,2,2,0,2,4,9,5,0,FW,30-34,Forward,France,Europe
2171,Nicolò Rovella,ITA,Genoa,Serie A,2019,17.0,2001.0,1.2,0,0,0,0,0,0,1,0.0,1,0,0,0,4,4,0,0,MF,Under 20,Midfielder,Italy,Europe
2175,Antonio Rüdiger,GER,Chelsea,Premier League,2019,26.0,1993.0,19.0,28,18,19,7,2,16,25,64.0,9,15,9,6,16,44,59,1,DF,25-29,Defender,Germany,Europe
2176,Sebastian Rudy,GER,Hoffenheim,Bundesliga,2019,29.0,1990.0,30.4,73,49,31,29,13,28,75,37.3,47,26,5,21,27,100,38,0,"MF,DF",25-29,Midfielder,Germany,Europe
2177,Stéphane Ruffier,FRA,Saint-Étienne,Ligue 1,2019,32.0,1986.0,22.0,0,0,0,0,0,0,0,,0,0,0,0,0,0,5,3,GK,30-34,Goalkeeper,France,Europe
2178,Dion Ruffo Luci,ITA,Bologna,Serie A,2019,18.0,2001.0,0.0,0,0,0,0,0,0,0,,0,0,0,0,0,0,0,0,MF,Under 20,Midfielder,Italy,Europe
2179,Daniele Rugani,ITA,Juventus,Serie A,2019,25.0,1994.0,7.7,8,6,4,4,0,4,5,80.0,1,4,4,0,11,19,18,0,DF,25-29,Defender,Italy,Europe
2180,Mário Rui,POR,Napoli,Serie A,2019,28.0,1991.0,21.8,31,17,12,12,7,11,29,37.9,18,24,5,19,21,52,43,0,DF,25-29,Defender,Portugal,Europe
2183,Gerónimo Rulli,ARG,Montpellier,Ligue 1,2019,27.0,1992.0,25.0,3,1,3,0,0,3,4,75.0,1,1,0,1,2,5,9,1,GK,25-29,Goalkeeper,Argentina,South America
2184,Lukas Rupp,GER,Norwich City,Premier League,2019,28.0,1991.0,7.7,15,9,7,5,3,5,17,29.4,12,11,0,11,15,30,4,0,"FW,MF",25-29,Forward,Germany,Europe
2185,Lukas Rupp,GER,Hoffenheim,Bundesliga,2019,28.0,1991.0,3.8,9,4,3,5,1,3,6,50.0,3,5,0,5,5,14,3,0,MF,25-29,Midfielder,Germany,Europe
2186,Mathew Ryan,AUS,Brighton,Premier League,2019,27.0,1992.0,38.0,1,1,1,0,0,1,4,25.0,3,0,0,0,2,3,13,2,GK,25-29,Goalkeeper,Australia,Oceania
2188,Frederik Rønnow,DEN,Eint Frankfurt,Bundesliga,2019,26.0,1992.0,9.0,0,0,0,0,0,0,1,0.0,1,0,0,0,0,0,1,0,GK,25-29,Goalkeeper,Denmark,Europe
2189,Roli Pereira de Sa,FRA,Nantes,Ligue 1,2019,22.0,1996.0,0.1,0,0,0,0,0,0,0,,0,0,0,0,0,0,0,0,MF,20-24,Midfielder,France,Europe
2190,Victor Sá,BRA,Wolfsburg,Bundesliga,2019,25.0,1994.0,18.1,35,22,12,17,6,10,38,26.3,28,31,1,30,9,44,9,0,"MF,FW",25-29,Midfielder,Brazil,South America
2191,Youssouf Sabaly,SEN,Bordeaux,Ligue 1,2019,26.0,1993.0,10.1,18,11,9,4,5,6,22,27.3,16,8,1,7,18,36,23,0,DF,25-29,Defender,Senegal,Africa
2192,Stefano Sabelli,ITA,Brescia,Serie A,2019,26.0,1993.0,35.2,83,44,51,28,4,50,106,47.2,56,40,13,27,58,141,107,0,DF,25-29,Defender,Italy,Europe
2193,Abdelhamid Sabiri,MAR,Paderborn 07,Bundesliga,2019,22.0,1996.0,11.6,20,16,6,11,3,9,27,33.3,18,9,2,7,8,28,18,1,MF,20-24,Midfielder,Morocco,Africa
2194,Marcel Sabitzer,AUT,RB Leipzig,Bundesliga,2019,25.0,1994.0,27.8,39,25,15,18,6,19,56,33.9,37,27,4,23,23,62,25,0,"MF,FW",25-29,Midfielder,Austria,Europe
2195,Ihsan Sacko,FRA,Nice,Ligue 1,2019,22.0,1997.0,1.6,1,1,1,0,0,0,1,0.0,1,0,0,0,0,1,0,0,FW,20-24,Forward,France,Europe
2196,Alexis Saelemaekers,BEL,Milan,Serie A,2019,20.0,1999.0,7.6,14,8,5,7,2,6,20,30.0,14,13,1,12,8,22,1,0,"FW,DF",20-24,Forward,Belgium,Europe
2198,Nuri Şahin,TUR,Werder Bremen,Bundesliga,2019,30.0,1988.0,13.9,27,16,10,14,3,11,35,31.4,24,15,7,8,37,64,38,0,MF,30-34,Midfielder,Turkey,Asia
2199,Wesley Saïd,FRA,Toulouse,Ligue 1,2019,24.0,1995.0,12.9,20,9,8,10,2,2,13,15.4,11,6,0,6,9,29,8,0,"MF,FW",20-24,Midfielder,France,Europe
2200,Allan Saint-Maximin,FRA,Newcastle Utd,Premier League,2019,22.0,1997.0,20.7,13,8,7,4,2,4,18,22.2,14,5,2,3,9,22,6,0,"MF,FW",20-24,Midfielder,France,Europe
2201,Théo Sainte-Luce,FRA,Nîmes,Ligue 1,2019,20.0,1998.0,0.2,0,0,0,0,0,0,0,,0,0,0,0,0,0,0,0,"MF,DF",20-24,Midfielder,France,Europe
2203,Romain Saïss,MAR,Wolves,Premier League,2019,29.0,1990.0,30.1,55,38,37,15,3,32,46,69.6,14,31,16,15,55,110,127,3,DF,25-29,Defender,Morocco,Africa
2204,Bukayo Saka,ENG,Arsenal,Premier League,2019,17.0,2001.0,19.5,36,21,21,8,7,19,37,51.4,18,12,3,9,12,48,19,0,"DF,FW",Under 20,Defender,England,Europe
2205,Hiroki Sakai,JPN,Marseille,Ligue 1,2019,29.0,1990.0,18.0,57,36,26,24,7,25,40,62.5,15,20,5,15,23,80,34,1,DF,25-29,Defender,Japan,Asia
2206,Mamadou Sakho,FRA,Crystal Palace,Premier League,2019,29.0,1990.0,10.3,7,5,5,1,1,2,5,40.0,3,12,5,7,20,27,46,2,DF,25-29,Defender,France,Europe
2207,Jacopo Sala,ITA,SPAL,Serie A,2019,27.0,1991.0,9.5,29,24,17,11,1,17,31,54.8,14,4,0,4,13,42,15,1,DF,25-29,Defender,Italy,Europe
2208,Mohamed Salah,EGY,Liverpool,Premier League,2019,27.0,1992.0,32.0,16,6,1,4,11,5,22,22.7,17,3,1,2,8,24,2,1,FW,25-29,Forward,Egypt,Africa
2210,Eddie Salcedo,ITA,Hellas Verona,Serie A,2019,17.0,2001.0,7.6,3,1,2,0,1,0,5,0.0,5,4,0,4,1,4,2,0,"FW,MF",Under 20,Forward,Italy,Europe
2211,William Saliba,FRA,Saint-Étienne,Ligue 1,2019,18.0,2001.0,11.0,19,9,15,3,1,5,10,50.0,5,13,4,9,21,40,36,1,DF,Under 20,Defender,France,Europe
2212,Yannis Salibur,FRA,Mallorca,La Liga,2019,28.0,1991.0,0.9,0,0,0,0,0,0,4,0.0,4,0,0,0,1,1,1,0,"MF,FW",25-29,Midfielder,France,Europe
2213,Romain Salin,FRA,Rennes,Ligue 1,2019,35.0,1984.0,4.0,0,0,0,0,0,0,1,0.0,1,0,0,0,0,0,3,0,GK,35-39,Goalkeeper,France,Europe
2214,Mohammed Salisu,GHA,Valladolid,La Liga,2019,20.0,1999.0,30.3,41,24,28,13,0,21,34,61.8,13,32,26,6,35,76,158,3,DF,20-24,Defender,Ghana,Africa
2215,Roland Sallai,HUN,Freiburg,Bundesliga,2019,22.0,1997.0,12.9,17,10,4,9,4,7,20,35.0,13,12,2,10,7,24,4,0,"MF,FW",20-24,Midfielder,Hungary,Europe
2217,Diadie Samassékou,MLI,Hoffenheim,Bundesliga,2019,23.0,1996.0,14.6,37,18,14,17,6,12,34,35.3,22,25,8,17,40,77,27,1,MF,20-24,Midfielder,Mali,Africa
2218,Mbwana Samatta,TAN,Aston Villa,Premier League,2019,26.0,1992.0,10.5,6,4,0,3,3,1,8,12.5,7,7,0,7,1,7,6,0,FW,25-29,Forward,Tanzania,Africa
2219,Mama Samba Baldé,GNB,Dijon,Ligue 1,2019,23.0,1995.0,18.6,24,13,9,8,7,7,30,23.3,23,17,0,17,7,31,24,0,"FW,MF",20-24,Forward,Guinea-Bissau,Africa
2220,Junior Sambia,FRA,Montpellier,Ligue 1,2019,22.0,1996.0,6.5,8,6,4,2,2,3,13,23.1,10,4,0,4,8,16,6,0,"DF,MF",20-24,Defender,France,Europe
2221,Frédéric Sammaritano,FRA,Dijon,Ligue 1,2019,33.0,1986.0,5.8,9,7,4,4,1,4,11,36.4,7,6,1,5,2,11,3,1,"MF,FW",30-34,Midfielder,France,Europe
2224,Antonio Sanabria,PAR,Genoa,Serie A,2019,23.0,1996.0,15.4,14,11,2,7,5,3,14,21.4,11,13,1,12,5,19,12,1,FW,20-24,Forward,Paraguay,South America
2226,Renato Sanches,POR,Lille,Ligue 1,2019,21.0,1997.0,16.5,28,15,9,15,4,8,33,24.2,25,19,1,18,15,43,10,1,"MF,FW",20-24,Midfielder,Portugal,Europe
2227,Renato Sanches,POR,Bayern Munich,Bundesliga,2019,21.0,1997.0,0.1,0,0,0,0,0,0,0,,0,0,0,0,0,0,0,0,MF,20-24,Midfielder,Portugal,Europe
2228,Alexis Sánchez,CHI,Inter,Serie A,2019,30.0,1988.0,10.3,9,7,1,4,4,5,13,38.5,8,7,0,7,3,12,1,0,FW,30-34,Forward,Chile,South America
2229,Carlos Sánchez,COL,West Ham,Premier League,2019,33.0,1986.0,1.3,1,0,0,1,0,1,1,100.0,0,1,0,1,2,3,1,0,MF,30-34,Midfielder,Colombia,South America
2230,Davinson Sánchez,COL,Tottenham,Premier League,2019,23.0,1996.0,27.0,44,27,32,12,0,22,44,50.0,22,40,28,12,34,78,128,5,DF,20-24,Defender,Colombia,South America
2235,Jadon Sancho,ENG,Dortmund,Bundesliga,2019,19.0,2000.0,25.4,14,11,6,6,2,8,24,33.3,16,8,0,8,14,28,6,0,"FW,MF",Under 20,Forward,England,Europe
2236,Alex Sandro,BRA,Juventus,Serie A,2019,28.0,1991.0,26.5,44,26,23,14,7,12,33,36.4,21,26,6,20,47,91,46,3,DF,25-29,Defender,Brazil,South America
2237,Leroy Sané,GER,Manchester City,Premier League,2019,23.0,1996.0,0.1,0,0,0,0,0,0,0,,0,0,0,0,0,0,0,0,FW,20-24,Forward,Germany,Europe
2238,Salif Sané,SEN,Schalke 04,Bundesliga,2019,28.0,1990.0,12.5,16,9,12,4,0,11,19,57.9,8,19,7,12,21,37,50,0,DF,25-29,Defender,Senegal,Africa
2240,Ibrahim Sangaré,CIV,Toulouse,Ligue 1,2019,21.0,1997.0,24.2,84,54,37,42,5,33,74,44.6,41,28,10,18,39,123,49,4,MF,20-24,Midfielder,Ivory Coast,Africa
2242,Yaya Sanogo,FRA,Toulouse,Ligue 1,2019,26.0,1993.0,10.1,6,3,2,3,1,1,2,50.0,1,4,1,3,7,13,14,0,FW,25-29,Forward,France,Europe
2243,Morgan Sanson,FRA,Marseille,Ligue 1,2019,24.0,1994.0,24.1,60,28,20,29,11,13,52,25.0,39,39,5,34,23,83,9,0,MF,20-24,Midfielder,France,Europe
2244,Nicola Sansone,ITA,Bologna,Serie A,2019,27.0,1991.0,25.2,34,20,12,18,4,15,59,25.4,44,21,0,21,11,45,9,0,"FW,MF",25-29,Forward,Italy,Europe
2245,Baptiste Santamaria,FRA,Angers,Ligue 1,2019,24.0,1995.0,27.8,91,53,39,43,9,35,79,44.3,44,27,5,22,43,134,36,0,MF,20-24,Midfielder,France,Europe
2246,Federico Santander,PAR,Bologna,Serie A,2019,28.0,1991.0,8.6,13,8,3,0,10,1,4,25.0,3,3,0,3,7,20,12,0,FW,25-29,Forward,Paraguay,South America
2247,Davide Santon,ITA,Roma,Serie A,2019,28.0,1991.0,6.9,11,6,6,5,0,6,17,35.3,11,2,1,1,11,22,13,0,DF,25-29,Defender,Italy,Europe
2248,Samir Santos,BRA,Udinese,Serie A,2019,24.0,1994.0,17.2,35,27,24,8,3,12,23,52.2,11,16,6,10,33,68,64,1,DF,20-24,Defender,Brazil,South America
2249,Riccardo Saponara,ITA,Genoa,Serie A,2019,27.0,1991.0,1.9,4,3,2,2,0,0,2,0.0,2,2,1,1,0,4,2,0,"MF,FW",25-29,Midfielder,Italy,Europe
2250,Riccardo Saponara,ITA,Lecce,Serie A,2019,27.0,1991.0,10.5,12,8,4,8,0,6,13,46.2,7,2,0,2,5,17,7,0,"MF,FW",25-29,Midfielder,Italy,Europe
2253,Marcelo Saracchi,URU,RB Leipzig,Bundesliga,2019,21.0,1998.0,2.0,8,6,2,5,1,5,6,83.3,1,3,1,2,1,9,5,0,DF,20-24,Defender,Uruguay,South America
2254,Josh Sargent,USA,Werder Bremen,Bundesliga,2019,19.0,2000.0,15.7,11,6,5,4,2,2,12,16.7,10,17,1,16,14,25,21,0,FW,Under 20,Forward,United States,North America
2255,Bouna Sarr,SEN,Marseille,Ligue 1,2019,27.0,1992.0,24.0,60,37,30,19,11,30,53,56.6,23,17,1,16,32,92,38,0,"DF,FW",25-29,Defender,Senegal,Africa
2256,Ismaila Sarr,SEN,Watford,Premier League,2019,21.0,1998.0,22.5,11,10,5,2,4,5,23,21.7,18,9,1,8,18,29,10,0,"FW,MF",20-24,Forward,Senegal,Africa
2257,Malang Sarr,FRA,Nice,Ligue 1,2019,20.0,1999.0,16.2,19,11,13,6,0,9,22,40.9,13,10,4,6,38,57,31,4,DF,20-24,Defender,France,Europe
2258,Sidy Sarr,SEN,Nîmes,Ligue 1,2019,23.0,1996.0,12.9,35,18,15,16,4,11,34,32.4,23,13,3,10,15,50,18,0,MF,20-24,Midfielder,Senegal,Africa
2260,Téji Savanier,FRA,Montpellier,Ligue 1,2019,27.0,1991.0,16.9,52,39,16,30,6,25,77,32.5,52,10,0,10,35,87,21,1,MF,25-29,Midfielder,France,Europe
2261,Stefan Savić,MNE,Atlético Madrid,La Liga,2019,28.0,1991.0,22.0,22,17,11,10,1,11,18,61.1,7,16,9,7,24,46,91,1,DF,25-29,Defender,Montenegro,Europe
2262,Fabian Schär,SUI,Newcastle Utd,Premier League,2019,27.0,1991.0,18.6,39,21,25,14,0,19,40,47.5,21,35,18,17,47,86,74,2,"DF,MF",25-29,Defender,Switzerland,Europe
2263,Louis Schaub,AUT,Köln,Bundesliga,2019,24.0,1994.0,6.9,15,12,2,9,4,5,14,35.7,9,10,1,9,3,18,2,0,MF,20-24,Midfielder,Austria,Europe
2264,Ezequiel Schelotto,ITA,Brighton,Premier League,2019,30.0,1989.0,4.0,4,3,1,2,1,2,8,25.0,6,3,0,3,7,11,14,0,DF,30-34,Defender,Italy,Europe
2266,Julian Schieber,GER,Augsburg,Bundesliga,2019,30.0,1989.0,0.5,1,1,0,1,0,0,0,,0,0,0,0,0,1,0,0,FW,30-34,Forward,Germany,Europe
2267,Kingsley Schindler,GHA,Köln,Bundesliga,2019,26.0,1993.0,9.4,8,5,3,5,0,4,12,33.3,8,6,1,5,6,14,17,0,"FW,MF",25-29,Forward,Ghana,Africa
2268,Xaver Schlager,AUT,Wolfsburg,Bundesliga,2019,21.0,1997.0,19.1,47,29,13,30,4,14,44,31.8,30,16,2,14,17,64,12,0,MF,20-24,Midfielder,Austria,Europe
2269,Keven Schlotterbeck,GER,Union Berlin,Bundesliga,2019,22.0,1997.0,21.5,52,27,36,15,1,17,29,58.6,12,40,21,19,40,92,113,1,DF,20-24,Defender,Germany,Europe
2270,Nico Schlotterbeck,GER,Freiburg,Bundesliga,2019,19.0,1999.0,4.1,6,3,4,2,0,2,5,40.0,3,7,5,2,3,9,20,1,DF,Under 20,Defender,Germany,Europe
2271,Jeffrey Schlupp,GHA,Crystal Palace,Premier League,2019,26.0,1992.0,11.5,18,9,10,7,1,6,16,37.5,10,11,3,8,13,31,15,0,"FW,MF",25-29,Forward,Ghana,Africa
2272,Kasper Schmeichel,DEN,Leicester City,Premier League,2019,32.0,1986.0,38.0,1,1,1,0,0,1,2,50.0,1,0,0,0,1,2,4,2,GK,30-34,Goalkeeper,Denmark,Europe
2273,Marcel Schmelzer,GER,Dortmund,Bundesliga,2019,31.0,1988.0,0.7,2,1,1,1,0,1,1,100.0,0,0,0,0,1,3,2,0,DF,30-34,Defender,Germany,Europe
2274,Jonathan Schmid,FRA,Freiburg,Bundesliga,2019,29.0,1990.0,31.5,42,27,19,19,4,19,37,51.4,18,23,8,15,35,77,84,0,DF,25-29,Defender,France,Europe
2275,Manuel Schmiedebach,GER,Union Berlin,Bundesliga,2019,30.0,1988.0,2.0,4,1,0,3,1,1,7,14.3,6,1,1,0,3,7,3,0,MF,30-34,Midfielder,Germany,Europe
2276,Benno Schmitz,GER,Köln,Bundesliga,2019,24.0,1994.0,12.9,28,17,13,11,4,16,36,44.4,20,11,1,10,16,44,27,0,DF,20-24,Defender,Germany,Europe
2277,Morgan Schneiderlin,FRA,Everton,Premier League,2019,29.0,1989.0,11.1,31,22,13,16,2,8,24,33.3,16,13,3,10,21,52,20,1,MF,25-29,Midfielder,France,Europe
2278,Lasse Schöne,DEN,Genoa,Serie A,2019,33.0,1986.0,27.0,42,26,16,22,4,15,48,31.3,33,22,6,16,37,79,25,2,MF,30-34,Midfielder,Denmark,Europe
2279,Sebastian Schonlau,GER,Paderborn 07,Bundesliga,2019,24.0,1994.0,23.0,64,43,50,14,0,41,66,62.1,25,36,15,21,40,104,138,1,DF,20-24,Defender,Germany,Europe
2280,Alessandro Schöpf,AUT,Schalke 04,Bundesliga,2019,25.0,1994.0,15.9,29,16,11,10,8,12,33,36.4,21,17,1,16,26,55,8,0,MF,25-29,Midfielder,Austria,Europe
2281,Jerdy Schouten,NED,Bologna,Serie A,2019,22.0,1997.0,12.0,26,16,13,11,2,10,26,38.5,16,19,7,12,26,52,22,0,MF,20-24,Midfielder,Netherlands,Europe
2282,Markus Schubert,GER,Schalke 04,Bundesliga,2019,21.0,1998.0,8.2,0,0,0,0,0,0,1,0.0,1,0,0,0,0,0,9,4,GK,20-24,Goalkeeper,Germany,Europe
2283,Nico Schulz,GER,Dortmund,Bundesliga,2019,26.0,1993.0,6.6,11,7,3,6,2,8,13,61.5,5,14,4,10,9,20,9,0,"DF,MF",25-29,Defender,Germany,Europe
2284,Alexander Schwolow,GER,Freiburg,Bundesliga,2019,27.0,1992.0,23.2,0,0,0,0,0,0,0,,0,2,0,2,1,1,8,3,GK,25-29,Goalkeeper,Germany,Europe
2285,Matteo Scozzarella,ITA,Parma,Serie A,2019,31.0,1988.0,10.2,23,15,8,13,2,14,29,48.3,15,19,14,5,27,50,28,0,MF,30-34,Midfielder,Italy,Europe
2287,Davie Selke,GER,Hertha BSC,Bundesliga,2019,24.0,1995.0,10.7,6,3,2,2,2,4,7,57.1,3,7,1,6,1,7,11,0,FW,20-24,Forward,Germany,Europe
2288,Davie Selke,GER,Werder Bremen,Bundesliga,2019,24.0,1995.0,5.1,2,0,1,1,0,0,2,0.0,2,1,0,1,0,2,2,0,FW,20-24,Forward,Germany,Europe
2289,Matz Sels,BEL,Strasbourg,Ligue 1,2019,27.0,1992.0,27.0,0,0,0,0,0,0,1,0.0,1,0,0,0,1,1,6,0,GK,25-29,Goalkeeper,Belgium,Europe
2290,Ken Sema,SWE,Udinese,Serie A,2019,25.0,1993.0,27.3,59,41,43,15,1,36,68,52.9,32,26,6,20,17,76,41,1,"DF,MF",25-29,Defender,Sweden,Europe
2291,Nélson Semedo,POR,Barcelona,La Liga,2019,25.0,1993.0,23.3,51,30,27,18,6,21,36,58.3,15,18,3,15,22,73,30,0,DF,25-29,Defender,Portugal,Europe
2292,Alessandro Semprini,ITA,Brescia,Serie A,2019,21.0,1998.0,7.0,10,4,7,3,0,7,9,77.8,2,10,3,7,9,19,16,0,DF,20-24,Defender,Italy,Europe
2294,Stefano Sensi,ITA,Inter,Serie A,2019,23.0,1995.0,8.0,18,10,10,7,1,6,22,27.3,16,15,1,14,9,27,4,0,MF,20-24,Midfielder,Italy,Europe
2295,Luigi Sepe,ITA,Parma,Serie A,2019,28.0,1991.0,34.0,1,0,1,0,0,1,2,50.0,1,0,0,0,0,1,6,2,GK,25-29,Goalkeeper,Italy,Europe
2296,Suat Serdar,GER,Schalke 04,Bundesliga,2019,22.0,1997.0,17.8,56,37,16,33,7,18,61,29.5,43,39,7,32,24,80,7,0,MF,20-24,Midfielder,Germany,Europe
2297,Ryan Sessegnon,ENG,Tottenham,Premier League,2019,19.0,2000.0,3.8,6,4,2,4,0,3,6,50.0,3,0,0,0,3,9,12,0,"DF,FW",Under 20,Defender,England,Europe
2299,Yevhen Shakhov,UKR,Lecce,Serie A,2019,28.0,1990.0,12.1,28,16,12,13,3,8,27,29.6,19,11,3,8,14,42,9,1,"MF,FW",25-29,Midfielder,Ukraine,Europe
2300,Xherdan Shaqiri,SUI,Liverpool,Premier League,2019,27.0,1991.0,2.1,1,0,0,1,0,0,1,0.0,1,0,0,0,0,1,0,0,"FW,MF",25-29,Forward,Switzerland,Europe
2301,Billy Sharp,ENG,Sheffield Utd,Premier League,2019,33.0,1986.0,11.7,6,5,2,1,3,1,6,16.7,5,2,0,2,1,7,2,0,FW,30-34,Forward,England,Europe
2302,Luke Shaw,ENG,Manchester Utd,Premier League,2019,24.0,1995.0,19.3,34,18,19,11,4,19,33,57.6,14,26,6,20,24,58,56,1,DF,20-24,Defender,England,Europe
2303,Khiry Shelton,USA,Paderborn 07,Bundesliga,2019,26.0,1993.0,0.4,1,1,1,0,0,0,0,,0,0,0,0,0,1,0,0,FW,25-29,Forward,United States,North America
2304,Jonjo Shelvey,ENG,Newcastle Utd,Premier League,2019,27.0,1992.0,23.5,29,19,17,12,0,11,42,26.2,31,14,5,9,23,52,38,0,MF,25-29,Midfielder,England,Europe
2305,Gen Shoji,JPN,Toulouse,Ligue 1,2019,26.0,1992.0,0.5,2,2,2,0,0,1,1,100.0,0,0,0,0,0,2,2,0,DF,25-29,Defender,Japan,Asia
2306,Djibril Sidibé,FRA,Everton,Premier League,2019,27.0,1992.0,20.3,83,44,48,25,10,43,72,59.7,29,19,3,16,40,123,41,0,"DF,MF",25-29,Defender,France,Europe
2307,Kalidou Sidibé,FRA,Toulouse,Ligue 1,2019,20.0,1999.0,1.0,3,3,0,3,0,2,5,40.0,3,0,0,0,1,4,0,0,MF,20-24,Midfielder,France,Europe
2308,Sidnei,BRA,Betis,La Liga,2019,29.0,1989.0,13.1,23,19,17,6,0,9,14,64.3,5,15,12,3,21,44,57,0,DF,25-29,Defender,Brazil,South America
2309,Kaj Sierhuis,NED,Reims,Ligue 1,2019,21.0,1998.0,0.1,0,0,0,0,0,0,0,,0,0,0,0,0,0,0,0,FW,20-24,Forward,Netherlands,Europe
2310,Gylfi Sigurðsson,ISL,Everton,Premier League,2019,29.0,1989.0,28.4,50,26,15,24,11,19,70,27.1,51,30,4,26,37,87,17,1,MF,25-29,Midfielder,Iceland,Europe
2311,Luca Siligardi,ITA,Parma,Serie A,2019,31.0,1988.0,3.7,6,2,3,2,1,4,8,50.0,4,3,0,3,3,9,5,0,"MF,FW",30-34,Midfielder,Italy,Europe
2312,Adrien Silva,POR,Monaco,Ligue 1,2019,30.0,1989.0,13.6,37,22,14,19,4,10,37,27.0,27,19,6,13,12,49,14,2,MF,30-34,Midfielder,Portugal,Europe
2313,André Silva,POR,Milan,Serie A,2019,23.0,1995.0,0.7,2,1,0,0,2,0,1,0.0,1,0,0,0,0,2,0,0,FW,20-24,Forward,Portugal,Europe
2313,André Silva,POR,Milan,Serie A,2019,23.0,1995.0,0.7,2,1,0,0,2,0,1,0.0,1,0,0,0,0,2,0,0,FW,20-24,Forward,Portugal,Europe
2313,André Silva,POR,Milan,Serie A,2019,23.0,1995.0,0.7,2,1,0,0,2,0,1,0.0,1,0,0,0,0,2,0,0,FW,20-24,Forward,Portugal,Europe
2313,André Silva,POR,Milan,Serie A,2019,23.0,1995.0,0.7,2,1,0,0,2,0,1,0.0,1,0,0,0,0,2,0,0,FW,20-24,Forward,Portugal,Europe
2313,André Silva,POR,Milan,Serie A,2019,23.0,1995.0,0.7,2,1,0,0,2,0,1,0.0,1,0,0,0,0,2,0,0,FW,20-24,Forward,Portugal,Europe
2313,André Silva,POR,Milan,Serie A,2019,23.0,1995.0,0.7,2,1,0,0,2,0,1,0.0,1,0,0,0,0,2,0,0,FW,20-24,Forward,Portugal,Europe
2313,André Silva,POR,Milan,Serie A,2019,23.0,1995.0,0.7,2,1,0,0,2,0,1,0.0,1,0,0,0,0,2,0,0,FW,20-24,Forward,Portugal,Europe
2313,André Silva,POR,Milan,Serie A,2019,23.0,1995.0,0.7,2,1,0,0,2,0,1,0.0,1,0,0,0,0,2,0,0,FW,20-24,Forward,Portugal,Europe
2313,André Silva,POR,Milan,Serie A,2019,23.0,1995.0,0.7,2,1,0,0,2,0,1,0.0,1,0,0,0,0,2,0,0,FW,20-24,Forward,Portugal,Europe
2314,André Silva,POR,Eint Frankfurt,Bundesliga,2019,23.0,1995.0,17.5,7,2,0,5,2,2,14,14.3,12,9,0,9,8,15,4,0,FW,20-24,Forward,Portugal,Europe
2314,André Silva,POR,Eint Frankfurt,Bundesliga,2019,23.0,1995.0,17.5,7,2,0,5,2,2,14,14.3,12,9,0,9,8,15,4,0,FW,20-24,Forward,Portugal,Europe
2314,André Silva,POR,Eint Frankfurt,Bundesliga,2019,23.0,1995.0,17.5,7,2,0,5,2,2,14,14.3,12,9,0,9,8,15,4,0,FW,20-24,Forward,Portugal,Europe
2314,André Silva,POR,Eint Frankfurt,Bundesliga,2019,23.0,1995.0,17.5,7,2,0,5,2,2,14,14.3,12,9,0,9,8,15,4,0,FW,20-24,Forward,Portugal,Europe
2314,André Silva,POR,Eint Frankfurt,Bundesliga,2019,23.0,1995.0,17.5,7,2,0,5,2,2,14,14.3,12,9,0,9,8,15,4,0,FW,20-24,Forward,Portugal,Europe
2314,André Silva,POR,Eint Frankfurt,Bundesliga,2019,23.0,1995.0,17.5,7,2,0,5,2,2,14,14.3,12,9,0,9,8,15,4,0,FW,20-24,Forward,Portugal,Europe
2314,André Silva,POR,Eint Frankfurt,Bundesliga,2019,23.0,1995.0,17.5,7,2,0,5,2,2,14,14.3,12,9,0,9,8,15,4,0,FW,20-24,Forward,Portugal,Europe
2314,André Silva,POR,Eint Frankfurt,Bundesliga,2019,23.0,1995.0,17.5,7,2,0,5,2,2,14,14.3,12,9,0,9,8,15,4,0,FW,20-24,Forward,Portugal,Europe
2314,André Silva,POR,Eint Frankfurt,Bundesliga,2019,23.0,1995.0,17.5,7,2,0,5,2,2,14,14.3,12,9,0,9,8,15,4,0,FW,20-24,Forward,Portugal,Europe
2315,Bernardo Silva,POR,Manchester City,Premier League,2019,24.0,1994.0,22.6,36,18,8,21,7,13,44,29.5,31,25,1,24,24,60,13,0,"FW,MF",20-24,Forward,Portugal,Europe
2317,Gabriel Silva,BRA,Saint-Étienne,Ligue 1,2019,28.0,1991.0,2.6,4,1,1,2,1,2,3,66.7,1,2,0,2,4,8,8,0,DF,25-29,Defender,Brazil,South America
2317,Gabriel Silva,BRA,Saint-Étienne,Ligue 1,2019,28.0,1991.0,2.6,4,1,1,2,1,2,3,66.7,1,2,0,2,4,8,8,0,DF,25-29,Defender,Brazil,South America
2317,Gabriel Silva,BRA,Saint-Étienne,Ligue 1,2019,28.0,1991.0,2.6,4,1,1,2,1,2,3,66.7,1,2,0,2,4,8,8,0,DF,25-29,Defender,Brazil,South America
2317,Gabriel Silva,BRA,Saint-Étienne,Ligue 1,2019,28.0,1991.0,2.6,4,1,1,2,1,2,3,66.7,1,2,0,2,4,8,8,0,DF,25-29,Defender,Brazil,South America
2318,Jonathan Silva,ARG,Leganés,La Liga,2019,25.0,1994.0,30.9,60,34,32,22,6,27,52,51.9,25,12,4,8,34,94,46,0,DF,25-29,Defender,Argentina,South America
2318,Jonathan Silva,ARG,Leganés,La Liga,2019,25.0,1994.0,30.9,60,34,32,22,6,27,52,51.9,25,12,4,8,34,94,46,0,DF,25-29,Defender,Argentina,South America
2318,Jonathan Silva,ARG,Leganés,La Liga,2019,25.0,1994.0,30.9,60,34,32,22,6,27,52,51.9,25,12,4,8,34,94,46,0,DF,25-29,Defender,Argentina,South America
2318,Jonathan Silva,ARG,Leganés,La Liga,2019,25.0,1994.0,30.9,60,34,32,22,6,27,52,51.9,25,12,4,8,34,94,46,0,DF,25-29,Defender,Argentina,South America
2319,Matheus Pereira da Silva,BRA,Dijon,Ligue 1,2019,21.0,1998.0,5.2,10,6,1,6,3,4,10,40.0,6,11,0,11,6,16,5,0,"MF,FW",20-24,Midfielder,Brazil,South America
2320,Rui Silva,POR,Granada,La Liga,2019,25.0,1994.0,35.0,2,1,2,0,0,2,2,100.0,0,0,0,0,2,4,22,3,GK,25-29,Goalkeeper,Portugal,Europe
2320,Rui Silva,POR,Granada,La Liga,2019,25.0,1994.0,35.0,2,1,2,0,0,2,2,100.0,0,0,0,0,2,4,22,3,GK,25-29,Goalkeeper,Portugal,Europe
2320,Rui Silva,POR,Granada,La Liga,2019,25.0,1994.0,35.0,2,1,2,0,0,2,2,100.0,0,0,0,0,2,4,22,3,GK,25-29,Goalkeeper,Portugal,Europe
2320,Rui Silva,POR,Granada,La Liga,2019,25.0,1994.0,35.0,2,1,2,0,0,2,2,100.0,0,0,0,0,2,4,22,3,GK,25-29,Goalkeeper,Portugal,Europe
2321,Thiago Silva,BRA,Paris S-G,Ligue 1,2019,34.0,1984.0,17.5,28,16,15,13,0,13,16,81.3,3,18,15,3,26,54,54,0,DF,30-34,Defender,Brazil,South America
2321,Thiago Silva,BRA,Paris S-G,Ligue 1,2019,34.0,1984.0,17.5,28,16,15,13,0,13,16,81.3,3,18,15,3,26,54,54,0,DF,30-34,Defender,Brazil,South America
2321,Thiago Silva,BRA,Paris S-G,Ligue 1,2019,34.0,1984.0,17.5,28,16,15,13,0,13,16,81.3,3,18,15,3,26,54,54,0,DF,30-34,Defender,Brazil,South America
2321,Thiago Silva,BRA,Paris S-G,Ligue 1,2019,34.0,1984.0,17.5,28,16,15,13,0,13,16,81.3,3,18,15,3,26,54,54,0,DF,30-34,Defender,Brazil,South America
2322,Marco Silvestri,ITA,Hellas Verona,Serie A,2019,28.0,1991.0,35.0,1,0,1,0,0,1,2,50.0,1,0,0,0,4,5,11,1,GK,25-29,Goalkeeper,Italy,Europe
2323,Mohamed Simakan,FRA,Strasbourg,Ligue 1,2019,19.0,2000.0,16.7,54,32,35,16,3,22,34,64.7,12,14,3,11,31,85,25,0,DF,Under 20,Defender,France,Europe
2324,Giovanni Simeone,ARG,Cagliari,Serie A,2019,24.0,1995.0,32.5,24,13,9,10,5,5,32,15.6,27,24,7,17,11,35,16,1,FW,20-24,Forward,Argentina,South America
2325,Moses Simon,NGA,Nantes,Ligue 1,2019,24.0,1995.0,24.2,15,7,5,4,6,6,21,28.6,15,6,0,6,8,23,6,0,"FW,MF",20-24,Forward,Nigeria,Africa
2327,Jack Simpson,ENG,Bournemouth,Premier League,2019,22.0,1996.0,2.7,5,2,4,1,0,2,8,25.0,6,1,0,1,2,7,12,1,DF,20-24,Defender,England,Europe
2328,Sarpreet Singh,NZL,Bayern Munich,Bundesliga,2019,20.0,1999.0,0.8,1,0,0,1,0,0,1,0.0,1,0,0,0,0,1,0,0,"FW,MF",20-24,Forward,New Zealand,Oceania
2329,Wilfried Singo,CIV,Torino,Serie A,2019,18.0,2000.0,1.5,1,0,0,1,0,0,0,,0,0,0,0,1,2,2,0,DF,Under 20,Defender,Ivory Coast,Africa
2330,Daley Sinkgraven,NED,Leverkusen,Bundesliga,2019,24.0,1995.0,10.1,20,16,11,6,3,8,24,33.3,16,12,3,9,10,30,16,0,"DF,MF",20-24,Defender,Netherlands,Europe
2331,Dimitris Siovas,GRE,Leganés,La Liga,2019,30.0,1988.0,21.3,42,31,24,15,3,19,28,67.9,9,14,1,13,46,88,69,0,DF,30-34,Defender,Greece,Europe
2332,Salvatore Sirigu,ITA,Torino,Serie A,2019,32.0,1987.0,36.0,0,0,0,0,0,0,0,,0,0,0,0,2,2,12,0,GK,30-34,Goalkeeper,Italy,Europe
2333,Ibrahima Sissoko,MLI,Strasbourg,Ligue 1,2019,21.0,1997.0,17.8,46,27,21,21,4,16,48,33.3,32,14,5,9,20,66,25,0,MF,20-24,Midfielder,Mali,Africa
2334,Moussa Sissoko,FRA,Tottenham,Premier League,2019,29.0,1989.0,27.2,39,25,25,12,2,20,48,41.7,28,19,4,15,27,66,43,2,MF,25-29,Midfielder,France,Europe
2335,Sambou Sissoko,FRA,Reims,Ligue 1,2019,20.0,1999.0,0.4,0,0,0,0,0,0,0,,0,0,0,0,1,1,2,0,"MF,FW",20-24,Midfielder,France,Europe
2335,Sambou Sissoko,FRA,Reims,Ligue 1,2019,20.0,1999.0,0.4,0,0,0,0,0,0,0,,0,0,0,0,1,1,2,0,"MF,FW",20-24,Midfielder,France,Europe
2335,Sambou Sissoko,FRA,Reims,Ligue 1,2019,20.0,1999.0,0.4,0,0,0,0,0,0,0,,0,0,0,0,1,1,2,0,"MF,FW",20-24,Midfielder,France,Europe
2335,Sambou Sissoko,FRA,Reims,Ligue 1,2019,20.0,1999.0,0.4,0,0,0,0,0,0,0,,0,0,0,0,1,1,2,0,"MF,FW",20-24,Midfielder,France,Europe
2336,Pione Sisto,DEN,Celta Vigo,La Liga,2019,24.0,1995.0,9.9,17,8,5,6,6,4,19,21.1,15,18,0,18,6,23,4,1,"FW,MF",20-24,Forward,Denmark,Europe
2338,Ellyes Skhiri,TUN,Köln,Bundesliga,2019,24.0,1995.0,29.7,74,52,30,37,7,29,77,37.7,48,47,9,38,67,141,33,0,MF,20-24,Midfielder,Tunisia,Africa
2339,Oliver Skipp,ENG,Tottenham,Premier League,2019,18.0,2000.0,0.9,2,2,0,2,0,1,4,25.0,3,3,2,1,0,2,0,0,MF,Under 20,Midfielder,England,Europe
2341,Andreas Skov Olsen,DEN,Bologna,Serie A,2019,19.0,1999.0,8.4,11,8,5,5,1,4,12,33.3,8,10,1,9,8,19,5,0,"FW,MF",Under 20,Forward,Denmark,Europe
2342,Robert Skov,DEN,Hoffenheim,Bundesliga,2019,23.0,1996.0,29.0,41,28,30,9,2,26,50,52.0,24,26,6,20,20,61,40,0,"DF,FW",20-24,Defender,Denmark,Europe
2343,Simon Skrabb,FIN,Brescia,Serie A,2019,24.0,1995.0,2.9,7,6,2,4,1,6,12,50.0,6,4,1,3,0,7,3,0,"FW,MF",20-24,Forward,Finland,Europe
2344,Milan Škriniar,SVK,Inter,Serie A,2019,24.0,1995.0,29.2,39,20,24,14,1,14,33,42.4,19,19,11,8,28,67,85,1,DF,20-24,Defender,Slovakia,Europe
2345,Steven Skrzybski,GER,Düsseldorf,Bundesliga,2019,26.0,1992.0,5.9,4,4,2,1,1,0,16,0.0,16,10,0,10,10,14,4,0,"FW,MF",25-29,Forward,Germany,Europe
2347,Islam Slimani,ALG,Monaco,Ligue 1,2019,31.0,1988.0,14.3,8,4,0,2,6,4,15,26.7,11,5,0,5,1,9,11,1,FW,30-34,Forward,Algeria,Africa
2348,William Smallbone,IRL,Southampton,Premier League,2019,19.0,2000.0,4.4,10,5,2,8,0,5,10,50.0,5,7,1,6,1,11,2,0,MF,Under 20,Midfielder,Republic of Ireland,Europe
2349,Chris Smalling,ENG,Roma,Serie A,2019,29.0,1989.0,28.5,25,16,15,9,1,10,13,76.9,3,44,35,9,56,81,126,2,DF,25-29,Defender,England,Europe
2350,Dennis Smarsch,GER,Hertha BSC,Bundesliga,2019,20.0,1999.0,1.7,0,0,0,0,0,0,0,,0,0,0,0,0,0,1,0,GK,20-24,Goalkeeper,Germany,Europe
2351,Adam Smith,ENG,Bournemouth,Premier League,2019,28.0,1991.0,22.8,47,32,29,16,2,23,50,46.0,27,27,6,21,25,72,64,1,DF,25-29,Defender,England,Europe
2351,Adam Smith,ENG,Bournemouth,Premier League,2019,28.0,1991.0,22.8,47,32,29,16,2,23,50,46.0,27,27,6,21,25,72,64,1,DF,25-29,Defender,England,Europe
2351,Adam Smith,ENG,Bournemouth,Premier League,2019,28.0,1991.0,22.8,47,32,29,16,2,23,50,46.0,27,27,6,21,25,72,64,1,DF,25-29,Defender,England,Europe
2351,Adam Smith,ENG,Bournemouth,Premier League,2019,28.0,1991.0,22.8,47,32,29,16,2,23,50,46.0,27,27,6,21,25,72,64,1,DF,25-29,Defender,England,Europe
2352,Emile Smith Rowe,ENG,Arsenal,Premier League,2019,19.0,2000.0,1.1,1,1,1,0,0,1,3,33.3,2,0,0,0,1,2,2,0,MF,Under 20,Midfielder,England,Europe
2353,Fyodor Smolov,RUS,Celta Vigo,La Liga,2019,29.0,1990.0,8.3,2,1,0,2,0,1,9,11.1,8,6,0,6,7,9,9,0,FW,25-29,Forward,Russia,Europe
2354,Robert Snodgrass,SCO,West Ham,Premier League,2019,31.0,1987.0,16.8,29,16,17,10,2,13,44,29.5,31,12,1,11,4,33,11,0,"MF,FW",30-34,Midfielder,Scotland,Europe
2355,Cédric Soares,POR,Arsenal,Premier League,2019,27.0,1991.0,2.8,8,6,2,6,0,1,3,33.3,2,3,0,3,3,11,4,0,"MF,DF",25-29,Midfielder,Portugal,Europe
2356,Cédric Soares,POR,Southampton,Premier League,2019,27.0,1991.0,14.5,45,26,19,24,2,25,41,61.0,16,18,4,14,19,64,51,0,DF,25-29,Defender,Portugal,Europe
2357,Rafa Soares,POR,Eibar,La Liga,2019,24.0,1995.0,4.8,6,5,5,0,1,5,11,45.5,6,1,0,1,2,8,6,0,DF,20-24,Defender,Portugal,Europe
2358,Lasse Sobiech,GER,Köln,Bundesliga,2019,28.0,1991.0,1.0,1,0,0,0,1,0,0,,0,0,0,0,4,5,6,0,DF,25-29,Defender,Germany,Europe
2359,Marcel Sobottka,GER,Düsseldorf,Bundesliga,2019,25.0,1994.0,7.8,15,10,6,8,1,4,13,30.8,9,9,1,8,9,24,12,0,MF,25-29,Midfielder,Germany,Europe
2361,Dominic Solanke,ENG,Bournemouth,Premier League,2019,21.0,1997.0,18.3,8,4,2,5,1,5,33,15.2,28,9,1,8,8,16,18,1,FW,20-24,Forward,England,Europe
2364,Oumar Solet,FRA,Lyon,Ligue 1,2019,19.0,2000.0,0.1,0,0,0,0,0,0,0,,0,1,1,0,0,0,1,0,DF,Under 20,Defender,France,Europe
2365,Yann Sommer,SUI,Gladbach,Bundesliga,2019,30.0,1988.0,34.0,0,0,0,0,0,0,1,0.0,1,0,0,0,1,1,11,6,GK,30-34,Goalkeeper,Switzerland,Europe
2366,Kévin Soni,CMR,Espanyol,La Liga,2019,21.0,1998.0,0.0,0,0,0,0,0,0,0,,0,0,0,0,0,0,0,0,FW,20-24,Forward,Cameroon,Africa
2370,Roberto Soriano,ITA,Bologna,Serie A,2019,28.0,1991.0,27.4,43,25,15,21,7,10,46,21.7,36,19,0,19,17,60,23,1,MF,25-29,Midfielder,Italy,Europe
2371,Riccardo Sottil,ITA,Fiorentina,Serie A,2019,20.0,1999.0,5.7,6,4,4,2,0,3,10,30.0,7,4,0,4,0,6,0,0,"FW,DF",20-24,Forward,Italy,Europe
2373,Adama Soumaoro,FRA,Genoa,Serie A,2019,27.0,1992.0,7.1,3,2,3,0,0,1,3,33.3,2,12,12,0,11,14,32,0,DF,25-29,Defender,France,Europe
2374,Adama Soumaoro,FRA,Lille,Ligue 1,2019,27.0,1992.0,4.6,1,1,0,1,0,0,0,,0,6,5,1,4,5,17,0,DF,25-29,Defender,France,Europe
2375,Boubakary Soumaré,FRA,Lille,Ligue 1,2019,20.0,1999.0,13.5,19,12,6,13,0,9,19,47.4,10,6,0,6,16,35,9,0,MF,20-24,Midfielder,France,Europe
2376,Bryan Soumaré,FRA,Dijon,Ligue 1,2019,20.0,1999.0,4.3,12,1,6,5,1,6,9,66.7,3,1,0,1,2,14,1,0,"MF,FW",20-24,Midfielder,France,Europe
2377,Arnaud Souquet,FRA,Montpellier,Ligue 1,2019,27.0,1992.0,22.4,62,40,45,13,4,30,67,44.8,37,20,6,14,17,79,44,0,"DF,FW",25-29,Defender,France,Europe
2378,Djibril Sow,SUI,Eint Frankfurt,Bundesliga,2019,22.0,1997.0,19.4,56,33,26,17,13,16,47,34.0,31,15,3,12,30,86,9,0,MF,20-24,Midfielder,Switzerland,Europe
2379,Çağlar Söyüncü,TUR,Leicester City,Premier League,2019,23.0,1996.0,33.7,60,40,41,18,1,27,46,58.7,19,35,19,16,43,103,156,1,DF,20-24,Defender,Turkey,Asia
2380,Nikolas Špalek,SVK,Brescia,Serie A,2019,22.0,1997.0,17.5,24,10,6,11,7,7,31,22.6,24,15,1,14,6,30,10,0,"MF,FW",20-24,Midfielder,Slovakia,Europe
2381,Leonardo Spinazzola,ITA,Roma,Serie A,2019,26.0,1993.0,17.2,24,12,11,8,5,12,21,57.1,9,13,5,8,20,44,41,0,DF,25-29,Defender,Italy,Europe
2382,Marco Sportiello,ITA,Atalanta,Serie A,2019,27.0,1992.0,5.8,0,0,0,0,0,0,0,,0,0,0,0,0,0,3,0,GK,25-29,Goalkeeper,Italy,Europe
2383,Mattia Sprocati,ITA,Parma,Serie A,2019,26.0,1993.0,6.6,4,2,3,1,0,0,1,0.0,1,5,1,4,2,6,2,0,"FW,MF",25-29,Forward,Italy,Europe
2384,Bassem Srarfi,TUN,Nice,Ligue 1,2019,22.0,1997.0,1.5,0,0,0,0,0,0,2,0.0,2,0,0,0,2,2,0,0,"FW,MF",20-24,Forward,Tunisia,Africa
2385,Dennis Srbeny,GER,Norwich City,Premier League,2019,25.0,1994.0,0.5,5,5,3,2,0,1,3,33.3,2,1,0,1,0,5,1,0,"MF,FW",25-29,Midfielder,Germany,Europe
2386,Dennis Srbeny,GER,Paderborn 07,Bundesliga,2019,25.0,1994.0,12.4,11,6,4,4,3,5,18,27.8,13,11,1,10,3,14,9,0,"FW,MF",25-29,Forward,Germany,Europe
2387,Jerry St. Juste,NED,Mainz 05,Bundesliga,2019,22.0,1996.0,23.5,46,25,34,10,2,14,34,41.2,20,35,19,16,52,98,86,1,DF,20-24,Defender,Netherlands,Europe
2388,Jack Stacey,ENG,Bournemouth,Premier League,2019,23.0,1996.0,17.2,21,11,9,11,1,8,22,36.4,14,27,11,16,18,39,64,1,DF,20-24,Defender,England,Europe
2389,Kostas Stafylidis,GRE,Hoffenheim,Bundesliga,2019,25.0,1993.0,4.4,10,3,7,2,1,4,10,40.0,6,10,3,7,2,12,17,0,DF,25-29,Defender,Greece,Europe
2390,Benjamin Stambouli,FRA,Schalke 04,Bundesliga,2019,28.0,1990.0,9.0,31,19,14,15,2,11,21,52.4,10,16,6,10,12,43,28,1,DF,25-29,Defender,France,Europe
2391,Junior Stanislas,ENG,Bournemouth,Premier League,2019,29.0,1989.0,7.9,10,7,2,3,5,3,8,37.5,5,6,0,6,4,14,6,0,"MF,FW",25-29,Midfielder,England,Europe
2392,Niklas Stark,GER,Hertha BSC,Bundesliga,2019,24.0,1995.0,19.2,36,20,24,10,2,9,21,42.9,12,27,12,15,21,57,97,2,DF,20-24,Defender,Germany,Europe
2393,Jed Steer,ENG,Aston Villa,Premier League,2019,26.0,1992.0,0.1,0,0,0,0,0,0,0,,0,0,0,0,0,0,0,0,GK,25-29,Goalkeeper,England,Europe
2394,Renato Steffen,SUI,Wolfsburg,Bundesliga,2019,27.0,1991.0,17.6,25,18,4,14,7,14,39,35.9,25,25,2,23,23,48,10,0,"MF,FW",25-29,Midfielder,Switzerland,Europe
2395,Zack Steffen,USA,Düsseldorf,Bundesliga,2019,24.0,1995.0,17.0,0,0,0,0,0,0,0,,0,0,0,0,0,0,5,4,GK,20-24,Goalkeeper,United States,North America
2396,Dale Stephens,ENG,Brighton,Premier League,2019,30.0,1989.0,28.1,73,44,30,37,6,25,75,33.3,50,31,11,20,58,131,42,2,MF,30-34,Midfielder,England,Europe
2397,Jack Stephens,ENG,Southampton,Premier League,2019,25.0,1994.0,27.2,44,27,30,13,1,24,46,52.2,22,38,22,16,31,75,120,2,DF,25-29,Defender,England,Europe
2399,Raheem Sterling,ENG,Manchester City,Premier League,2019,24.0,1994.0,29.5,27,15,8,10,9,6,28,21.4,22,16,2,14,15,42,4,0,FW,20-24,Forward,England,Europe
2400,Enda Stevens,IRL,Sheffield Utd,Premier League,2019,29.0,1990.0,37.2,81,46,48,26,7,42,96,43.8,54,27,8,19,35,116,71,3,DF,25-29,Defender,Republic of Ireland,Europe
2401,Marco Stiepermann,GER,Norwich City,Premier League,2019,28.0,1991.0,13.1,20,8,8,9,3,5,21,23.8,16,11,3,8,5,25,16,0,MF,25-29,Midfielder,Germany,Europe
2402,Lars Stindl,GER,Gladbach,Bundesliga,2019,30.0,1988.0,15.9,27,16,4,15,8,10,28,35.7,18,18,2,16,10,37,7,0,"MF,FW",30-34,Midfielder,Germany,Europe
2403,Kevin Stöger,AUT,Düsseldorf,Bundesliga,2019,25.0,1993.0,14.1,21,15,10,7,4,6,24,25.0,18,24,2,22,26,47,7,1,MF,25-29,Midfielder,Austria,Europe
2404,Vlatko Stojanovski,MKD,Nîmes,Ligue 1,2019,22.0,1997.0,1.4,3,3,0,3,0,1,1,100.0,0,0,0,0,0,3,1,0,FW,20-24,Forward,North Macedonia,Europe
2405,John Stones,ENG,Manchester City,Premier League,2019,25.0,1994.0,12.5,16,10,8,7,1,3,5,60.0,2,5,3,2,9,25,32,2,DF,25-29,Defender,England,Europe
2406,Thomas Strakosha,ALB,Lazio,Serie A,2019,24.0,1995.0,38.0,0,0,0,0,0,0,1,0.0,1,0,0,0,0,0,7,2,GK,20-24,Goalkeeper,Albania,Europe
2407,Gabriel Strefezza,BRA,SPAL,Serie A,2019,22.0,1997.0,23.4,64,40,28,26,10,22,54,40.7,32,29,3,26,21,85,17,0,"DF,MF",20-24,Defender,Brazil,South America
2408,Tobias Strobl,GER,Gladbach,Bundesliga,2019,29.0,1990.0,6.8,9,6,5,4,0,3,8,37.5,5,8,4,4,11,20,5,0,"MF,DF",25-29,Midfielder,Germany,Europe
2409,Christian Strohdiek,GER,Paderborn 07,Bundesliga,2019,31.0,1988.0,15.1,26,22,21,5,0,20,42,47.6,22,16,10,6,25,51,92,0,DF,30-34,Defender,Germany,Europe
2410,Kevin Strootman,NED,Marseille,Ligue 1,2019,29.0,1990.0,15.7,39,27,13,23,3,20,49,40.8,29,16,1,15,17,56,24,0,MF,25-29,Midfielder,Netherlands,Europe
2411,Jens Stryger Larsen,DEN,Udinese,Serie A,2019,28.0,1991.0,31.0,27,19,15,9,3,17,30,56.7,13,20,5,15,20,47,52,0,DF,25-29,Defender,Denmark,Europe
2412,Stefano Sturaro,ITA,Genoa,Serie A,2019,26.0,1993.0,13.9,38,22,14,19,5,15,39,38.5,24,16,4,12,10,48,26,1,MF,25-29,Midfielder,Italy,Europe
2413,Damián Suárez,URU,Getafe,La Liga,2019,31.0,1988.0,28.8,62,32,32,21,9,38,72,52.8,34,25,2,23,27,89,41,0,DF,30-34,Defender,Uruguay,South America
2415,Luis Suárez,URU,Barcelona,La Liga,2019,32.0,1987.0,22.2,4,0,0,1,3,2,12,16.7,10,6,1,5,1,5,11,0,FW,30-34,Forward,Uruguay,South America
2415,Luis Suárez,URU,Barcelona,La Liga,2019,32.0,1987.0,22.2,4,0,0,1,3,2,12,16.7,10,6,1,5,1,5,11,0,FW,30-34,Forward,Uruguay,South America
2415,Luis Suárez,URU,Barcelona,La Liga,2019,32.0,1987.0,22.2,4,0,0,1,3,2,12,16.7,10,6,1,5,1,5,11,0,FW,30-34,Forward,Uruguay,South America
2415,Luis Suárez,URU,Barcelona,La Liga,2019,32.0,1987.0,22.2,4,0,0,1,3,2,12,16.7,10,6,1,5,1,5,11,0,FW,30-34,Forward,Uruguay,South America
2416,Mathías Suárez,URU,Montpellier,Ligue 1,2019,23.0,1996.0,0.7,2,2,2,0,0,2,3,66.7,1,0,0,0,1,3,3,0,DF,20-24,Defender,Uruguay,South America
2418,Isaac Success,NGA,Watford,Premier League,2019,23.0,1996.0,0.8,0,0,0,0,0,0,0,,0,0,0,0,1,1,0,0,"FW,MF",20-24,Forward,Nigeria,Africa
2420,Niklas Süle,GER,Bayern Munich,Bundesliga,2019,23.0,1995.0,7.1,10,6,8,2,0,4,5,80.0,1,8,6,2,8,18,22,1,DF,20-24,Defender,Germany,Europe
2421,Ki Sung-yueng,KOR,Newcastle Utd,Premier League,2019,30.0,1989.0,1.5,1,1,0,1,0,1,3,33.3,2,1,0,1,3,4,2,0,MF,30-34,Midfielder,South Korea,Asia
2422,Ki Sung-yueng,KOR,Mallorca,La Liga,2019,30.0,1989.0,0.1,0,0,0,0,0,0,1,0.0,1,0,0,0,0,0,0,0,MF,30-34,Midfielder,South Korea,Asia
2423,Stoppila Sunzu,ZAM,Metz,Ligue 1,2019,30.0,1989.0,15.0,16,8,12,4,0,10,15,66.7,5,22,15,7,24,40,63,0,DF,30-34,Defender,Zambia,Africa
2424,Andrew Surman,ENG,Bournemouth,Premier League,2019,32.0,1986.0,2.6,4,2,2,2,0,1,3,33.3,2,1,0,1,1,5,5,1,MF,30-34,Midfielder,England,Europe
2425,Sam Surridge,ENG,Bournemouth,Premier League,2019,21.0,1998.0,0.3,0,0,0,0,0,0,0,,0,1,0,1,1,1,0,0,"FW,MF",20-24,Forward,England,Europe
2428,Bosko Sutalo,CRO,Atalanta,Serie A,2019,19.0,2000.0,3.1,3,2,2,1,0,0,2,0.0,2,4,0,4,6,9,6,1,DF,Under 20,Defender,Croatia,Europe
2429,Markus Suttner,AUT,Düsseldorf,Bundesliga,2019,32.0,1987.0,14.9,21,16,11,9,1,11,24,45.8,13,22,7,15,13,34,33,0,DF,30-34,Defender,Austria,Europe
2430,Mattias Svanberg,SWE,Bologna,Serie A,2019,20.0,1999.0,11.7,13,8,9,4,0,6,31,19.4,25,15,4,11,13,26,10,0,MF,20-24,Midfielder,Sweden,Europe
2431,Issiaga Sylla,GUI,Toulouse,Ligue 1,2019,25.0,1994.0,28.0,73,49,44,21,8,40,69,58.0,29,31,7,24,67,140,90,2,DF,25-29,Defender,Guinea,Africa
2432,Moussa Sylla,MLI,Monaco,Ligue 1,2019,19.0,1999.0,0.1,0,0,0,0,0,0,0,,0,0,0,0,0,0,0,0,FW,Under 20,Forward,Mali,Africa
2433,Eddy Sylvestre,FRA,Nice,Ligue 1,2019,19.0,1999.0,0.4,0,0,0,0,0,0,1,0.0,1,0,0,0,0,0,0,0,MF,Under 20,Midfielder,France,Europe
2434,Ádám Szalai,HUN,Mainz 05,Bundesliga,2019,31.0,1987.0,12.7,8,4,0,6,2,1,11,9.1,10,9,0,9,2,10,14,0,FW,30-34,Forward,Hungary,Europe
2436,Andrea Tabanelli,ITA,Lecce,Serie A,2019,29.0,1990.0,10.7,22,13,10,9,3,8,28,28.6,20,13,2,11,11,33,19,0,MF,25-29,Midfielder,Italy,Europe
2438,Panagiotis Tachtsidis,GRE,Lecce,Serie A,2019,28.0,1991.0,22.3,52,27,26,20,6,20,56,35.7,36,27,11,16,35,87,32,2,MF,25-29,Midfielder,Greece,Europe
2439,Jonathan Tah,GER,Leverkusen,Bundesliga,2019,23.0,1996.0,23.2,36,26,23,11,2,18,29,62.1,11,25,13,12,27,63,98,2,DF,20-24,Defender,Germany,Europe
2440,Flavien Tait,FRA,Rennes,Ligue 1,2019,26.0,1993.0,9.8,20,13,12,6,2,9,28,32.1,19,7,0,7,9,29,5,1,"MF,FW",25-29,Midfielder,France,Europe
2441,Madih Talal,FRA,Amiens,Ligue 1,2019,21.0,1997.0,0.2,0,0,0,0,0,0,1,0.0,1,1,0,1,0,0,2,0,FW,20-24,Forward,France,Europe
2442,Adrien Tameze,CMR,Atalanta,Serie A,2019,25.0,1994.0,2.3,4,3,1,1,2,1,2,50.0,1,3,1,2,3,7,4,1,MF,25-29,Midfielder,Cameroon,Africa
2443,Adrien Tameze,CMR,Nice,Ligue 1,2019,25.0,1994.0,5.8,6,2,2,3,1,4,16,25.0,12,7,2,5,7,13,1,1,MF,25-29,Midfielder,Cameroon,Africa
2444,Japhet Tanganga,ENG,Tottenham,Premier League,2019,20.0,1999.0,5.8,17,9,10,6,1,10,17,58.8,7,7,6,1,11,28,31,2,DF,20-24,Defender,England,Europe
2445,Adil Taoui,FRA,Toulouse,Ligue 1,2019,17.0,2001.0,0.3,2,2,0,2,0,0,2,0.0,2,0,0,0,2,4,0,0,MF,Under 20,Midfielder,France,Europe
2446,Edmond Tapsoba,BFA,Leverkusen,Bundesliga,2019,20.0,1999.0,11.8,24,15,17,5,2,15,25,60.0,10,9,5,4,9,33,44,0,DF,20-24,Defender,Burkina Faso,Africa
2447,Matt Targett,ENG,Aston Villa,Premier League,2019,23.0,1995.0,25.5,52,29,37,11,4,22,53,41.5,31,28,8,20,56,108,82,0,"DF,MF",20-24,Defender,England,Europe
2449,James Tarkowski,ENG,Burnley,Premier League,2019,26.0,1992.0,38.0,66,43,47,19,0,31,54,57.4,23,63,47,16,63,129,204,4,DF,25-29,Defender,England,Europe
2450,Ciprian Tătărușanu,ROU,Lyon,Ligue 1,2019,33.0,1986.0,2.0,0,0,0,0,0,0,0,,0,0,0,0,0,0,0,1,GK,30-34,Goalkeeper,Romania,Europe
2451,Júlio Tavares,CPV,Dijon,Ligue 1,2019,30.0,1988.0,22.2,12,8,1,6,5,4,17,23.5,13,9,2,7,8,20,29,0,FW,30-34,Forward,Cape Verde,Africa
2452,Charlie Taylor,ENG,Burnley,Premier League,2019,25.0,1993.0,21.6,39,24,26,9,4,19,39,48.7,20,29,9,20,29,68,78,1,DF,25-29,Defender,England,Europe
2453,Neil Taylor,WAL,Aston Villa,Premier League,2019,30.0,1989.0,12.1,16,11,12,4,0,11,20,55.0,9,15,5,10,20,36,43,0,DF,30-34,Defender,Wales,Europe
2454,Aurélien Tchouaméni,FRA,Bordeaux,Ligue 1,2019,19.0,2000.0,12.3,30,14,15,13,2,11,27,40.7,16,11,3,8,13,43,19,1,MF,Under 20,Midfielder,France,Europe
2455,Aurélien Tchouaméni,FRA,Monaco,Ligue 1,2019,19.0,2000.0,0.7,0,0,0,0,0,0,2,0.0,2,0,0,0,0,0,2,1,MF,Under 20,Midfielder,France,Europe
2456,Georg Teigl,AUT,Augsburg,Bundesliga,2019,28.0,1991.0,1.2,3,1,1,2,0,2,4,50.0,2,0,0,0,3,6,1,0,"DF,MF",25-29,Defender,Austria,Europe
2458,Bernard Tekpetey,GHA,Düsseldorf,Bundesliga,2019,21.0,1997.0,5.0,4,4,1,2,1,0,2,0.0,2,5,0,5,2,6,0,0,"FW,MF",20-24,Forward,Ghana,Africa
2459,Nathan Tella,NGA,Southampton,Premier League,2019,20.0,1999.0,0.0,0,0,0,0,0,0,0,,0,0,0,0,0,0,0,0,FW,20-24,Forward,Nigeria,Africa
2461,Lino Tempelmann,GER,Freiburg,Bundesliga,2019,20.0,1999.0,0.4,1,0,1,0,0,1,1,100.0,0,1,1,0,0,1,0,0,MF,20-24,Midfielder,Germany,Europe
2463,Hidde ter Avest,NED,Udinese,Serie A,2019,22.0,1997.0,7.6,18,9,13,3,2,14,17,82.4,3,6,1,5,9,27,27,0,DF,20-24,Defender,Netherlands,Europe
2464,Marc-André ter Stegen,GER,Barcelona,La Liga,2019,27.0,1992.0,36.0,2,2,2,0,0,2,3,66.7,1,0,0,0,2,4,17,6,GK,25-29,Goalkeeper,Germany,Europe
2465,Simon Terodde,GER,Köln,Bundesliga,2019,31.0,1988.0,9.0,8,5,4,3,1,3,13,23.1,10,14,3,11,2,10,14,0,FW,30-34,Forward,Germany,Europe
2466,Pietro Terracciano,ITA,Fiorentina,Serie A,2019,29.0,1990.0,6.9,0,0,0,0,0,0,0,,0,0,0,0,0,0,4,0,GK,25-29,Goalkeeper,Italy,Europe
2467,Martin Terrier,FRA,Lyon,Ligue 1,2019,22.0,1997.0,13.3,20,15,7,10,3,3,14,21.4,11,14,1,13,10,30,11,0,"FW,MF",20-24,Forward,France,Europe
2469,Kenny Tete,NED,Lyon,Ligue 1,2019,23.0,1995.0,11.9,33,21,12,16,5,15,23,65.2,8,12,3,9,19,52,34,0,DF,20-24,Defender,Netherlands,Europe
2471,Florian Thauvin,FRA,Marseille,Ligue 1,2019,26.0,1993.0,0.2,1,0,0,1,0,0,1,0.0,1,0,0,0,0,1,0,0,FW,25-29,Forward,France,Europe
2472,Demba Thiam,SEN,SPAL,Serie A,2019,21.0,1998.0,2.0,0,0,0,0,0,0,0,,0,0,0,0,1,1,0,0,GK,20-24,Goalkeeper,Senegal,Africa
2473,Malick Thiaw,GER,Schalke 04,Bundesliga,2019,17.0,2001.0,0.8,2,0,1,1,0,1,2,50.0,1,2,2,0,2,4,4,1,DF,Under 20,Defender,Germany,Europe
2474,Niclas Thiede,GER,Freiburg,Bundesliga,2019,20.0,1999.0,0.8,0,0,0,0,0,0,0,,0,0,0,0,0,0,1,0,GK,20-24,Goalkeeper,Germany,Europe
2475,Jan Thielmann,GER,Köln,Bundesliga,2019,17.0,2002.0,6.2,9,6,2,6,1,5,12,41.7,7,8,0,8,8,17,6,0,"FW,MF",Under 20,Forward,Germany,Europe
2476,Sada Thioub,SEN,Angers,Ligue 1,2019,24.0,1995.0,16.8,20,12,8,9,3,5,18,27.8,13,9,1,8,4,24,5,0,"MF,FW",20-24,Midfielder,Senegal,Africa
2477,Jordan Thomas,ENG,Norwich City,Premier League,2019,18.0,2001.0,0.0,0,0,0,0,0,0,0,,0,0,0,0,0,0,0,0,FW,Under 20,Forward,England,Europe
2478,Luke Thomas,ENG,Leicester City,Premier League,2019,18.0,2001.0,3.0,1,0,0,1,0,0,3,0.0,3,2,0,2,3,4,7,0,"MF,DF",Under 20,Midfielder,England,Europe
2479,Romain Thomas,FRA,Angers,Ligue 1,2019,31.0,1988.0,26.0,24,17,16,7,1,8,18,44.4,10,35,18,17,39,63,118,1,DF,30-34,Defender,France,Europe
2480,Adrien Thomasson,FRA,Strasbourg,Ligue 1,2019,25.0,1993.0,23.0,36,21,11,16,9,15,47,31.9,32,21,1,20,9,45,9,0,"MF,FW",25-29,Midfielder,France,Europe
2481,Erik Thommy,GER,Düsseldorf,Bundesliga,2019,24.0,1994.0,25.1,40,23,16,16,8,15,39,38.5,24,23,2,21,16,56,20,1,"MF,FW",20-24,Midfielder,Germany,Europe
2482,Max Thompson,ENG,Burnley,Premier League,2019,17.0,2002.0,0.0,0,0,0,0,0,0,0,,0,0,0,0,0,0,0,0,FW,Under 20,Forward,England,Europe
2484,Khéphren Thuram,FRA,Nice,Ligue 1,2019,18.0,2001.0,6.6,22,7,14,8,0,6,17,35.3,11,12,2,10,7,29,13,0,MF,Under 20,Midfielder,France,Europe
2485,Marcus Thuram,FRA,Gladbach,Bundesliga,2019,21.0,1997.0,24.5,26,18,7,8,11,11,29,37.9,18,20,1,19,12,38,18,0,FW,20-24,Forward,France,Europe
2486,Youri Tielemans,BEL,Leicester City,Premier League,2019,22.0,1997.0,31.4,52,29,17,30,5,24,74,32.4,50,43,4,39,22,74,18,0,MF,20-24,Midfielder,Belgium,Europe
2487,Kieran Tierney,SCO,Arsenal,Premier League,2019,22.0,1997.0,11.0,20,16,13,6,1,11,15,73.3,4,10,4,6,9,29,37,1,"DF,MF",20-24,Defender,Scotland,Europe
2488,Cheick Timite,CIV,Amiens,Ligue 1,2019,21.0,1997.0,1.3,1,0,0,1,0,0,1,0.0,1,0,0,0,2,3,1,0,"MF,FW",20-24,Midfielder,Ivory Coast,Africa
2490,Marcel Tisserand,COD,Wolfsburg,Bundesliga,2019,26.0,1993.0,13.4,21,10,14,5,2,7,12,58.3,5,13,4,9,32,53,49,2,DF,25-29,Defender,DR Congo,Africa
2491,Jean-Clair Todibo,FRA,Barcelona,La Liga,2019,19.0,1999.0,0.9,1,0,1,0,0,0,1,0.0,1,0,0,0,0,1,6,0,DF,Under 20,Defender,France,Europe
2492,Jean-Clair Todibo,FRA,Schalke 04,Bundesliga,2019,19.0,1999.0,4.1,15,10,10,5,0,8,9,88.9,1,2,0,2,15,30,24,0,DF,Under 20,Defender,France,Europe
2493,Karl Toko Ekambi,CMR,Villarreal,La Liga,2019,26.0,1992.0,11.0,5,3,0,3,2,1,4,25.0,3,2,0,2,3,8,2,0,FW,25-29,Forward,Cameroon,Africa
2494,Karl Toko Ekambi,CMR,Lyon,Ligue 1,2019,26.0,1992.0,6.0,5,2,0,1,4,3,5,60.0,2,2,0,2,5,10,1,0,"FW,MF",25-29,Forward,Cameroon,Africa
2495,Corentin Tolisso,FRA,Bayern Munich,Bundesliga,2019,24.0,1994.0,7.1,9,4,4,3,2,1,9,11.1,8,9,3,6,4,13,2,1,MF,20-24,Midfielder,France,Europe
2496,Jeremy Toljan,GER,Sassuolo,Serie A,2019,24.0,1994.0,24.3,37,21,24,10,3,18,35,51.4,17,23,12,11,18,55,58,1,DF,20-24,Defender,Germany,Europe
2497,Rafael Tolói,ITA,Atalanta,Serie A,2019,28.0,1990.0,29.0,56,29,28,23,5,33,76,43.4,43,31,17,14,45,101,80,0,DF,25-29,Defender,Italy,Europe
2499,Takehiro Tomiyasu,JPN,Bologna,Serie A,2019,20.0,1998.0,28.1,42,24,25,13,4,22,41,53.7,19,34,9,25,49,91,78,1,DF,20-24,Defender,Japan,Asia
2500,James Tomkins,ENG,Crystal Palace,Premier League,2019,30.0,1989.0,17.6,29,17,21,8,0,18,25,72.0,7,17,15,2,21,50,103,0,DF,30-34,Defender,England,Europe
2501,Fikayo Tomori,ENG,Chelsea,Premier League,2019,21.0,1997.0,14.3,29,16,21,8,0,10,15,66.7,5,13,7,6,22,51,48,2,DF,20-24,Defender,England,Europe
2503,Sandro Tonali,ITA,Brescia,Serie A,2019,19.0,2000.0,33.5,39,25,16,20,3,16,55,29.1,39,36,14,22,41,80,42,0,MF,Under 20,Midfielder,Italy,Europe
2504,Lorenzo Tonelli,ITA,Sampdoria,Serie A,2019,29.0,1990.0,7.8,13,9,13,0,0,4,10,40.0,6,10,7,3,4,17,23,0,DF,25-29,Defender,Italy,Europe
2506,Ömer Toprak,TUR,Werder Bremen,Bundesliga,2019,30.0,1989.0,7.9,7,2,4,2,1,3,6,50.0,3,6,4,2,12,19,41,0,DF,30-34,Defender,Turkey,Asia
2507,Ernesto Torregrossa,VEN,Brescia,Serie A,2019,27.0,1992.0,20.5,17,7,5,10,2,6,22,27.3,16,10,2,8,5,22,22,0,FW,25-29,Forward,Venezuela,South America
2508,Lucas Torreira,URU,Arsenal,Premier League,2019,23.0,1996.0,16.8,31,16,11,15,5,16,39,41.0,23,24,8,16,34,65,24,0,MF,20-24,Midfielder,Uruguay,South America
2514,Jordan Torunarigha,GER,Hertha BSC,Bundesliga,2019,21.0,1997.0,16.2,32,19,21,11,0,18,27,66.7,9,33,18,15,31,63,75,0,DF,20-24,Defender,Germany,Europe
2515,Cenk Tosun,TUR,Crystal Palace,Premier League,2019,28.0,1991.0,2.0,2,2,2,0,0,0,2,0.0,2,0,0,0,0,2,1,0,FW,25-29,Forward,Turkey,Asia
2516,Cenk Tosun,TUR,Everton,Premier League,2019,28.0,1991.0,3.2,2,0,0,0,2,0,1,0.0,1,1,0,1,0,2,1,0,FW,25-29,Forward,Turkey,Asia
2517,Abdoulaye Touré,GUI,Nantes,Ligue 1,2019,25.0,1994.0,24.7,32,21,10,21,1,10,30,33.3,20,31,11,20,29,61,18,1,MF,25-29,Midfielder,Guinea,Africa
2517,Abdoulaye Touré,GUI,Nantes,Ligue 1,2019,25.0,1994.0,24.7,32,21,10,21,1,10,30,33.3,20,31,11,20,29,61,18,1,MF,25-29,Midfielder,Guinea,Africa
2517,Abdoulaye Touré,GUI,Nantes,Ligue 1,2019,25.0,1994.0,24.7,32,21,10,21,1,10,30,33.3,20,31,11,20,29,61,18,1,MF,25-29,Midfielder,Guinea,Africa
2517,Abdoulaye Touré,GUI,Nantes,Ligue 1,2019,25.0,1994.0,24.7,32,21,10,21,1,10,30,33.3,20,31,11,20,29,61,18,1,MF,25-29,Midfielder,Guinea,Africa
2518,Almamy Touré,MLI,Eint Frankfurt,Bundesliga,2019,23.0,1996.0,16.6,32,19,18,11,3,11,22,50.0,11,18,7,11,23,55,54,1,DF,20-24,Defender,Mali,Africa
2519,Lucas Tousart,FRA,Lyon,Ligue 1,2019,22.0,1997.0,19.6,58,32,19,34,5,17,56,30.4,39,19,7,12,31,89,27,1,MF,20-24,Midfielder,France,Europe
2520,Andros Townsend,ENG,Crystal Palace,Premier League,2019,28.0,1991.0,14.4,34,21,12,17,5,15,37,40.5,22,18,0,18,15,49,10,1,"FW,MF",25-29,Forward,England,Europe
2521,Aleksandar Trajkovski,MKD,Mallorca,La Liga,2019,26.0,1992.0,3.7,2,0,1,1,0,1,7,14.3,6,2,0,2,3,5,1,0,"MF,FW",25-29,Midfielder,North Macedonia,Europe
2523,Adama Traoré,MLI,Metz,Ligue 1,2019,24.0,1995.0,11.2,3,1,1,2,0,3,12,25.0,9,7,2,5,3,6,5,0,"FW,MF",20-24,Forward,Mali,Africa
2523,Adama Traoré,MLI,Metz,Ligue 1,2019,24.0,1995.0,11.2,3,1,1,2,0,3,12,25.0,9,7,2,5,3,6,5,0,"FW,MF",20-24,Forward,Mali,Africa
2523,Adama Traoré,MLI,Metz,Ligue 1,2019,24.0,1995.0,11.2,3,1,1,2,0,3,12,25.0,9,7,2,5,3,6,5,0,"FW,MF",20-24,Forward,Mali,Africa
2523,Adama Traoré,MLI,Metz,Ligue 1,2019,24.0,1995.0,11.2,3,1,1,2,0,3,12,25.0,9,7,2,5,3,6,5,0,"FW,MF",20-24,Forward,Mali,Africa
2523,Adama Traoré,MLI,Metz,Ligue 1,2019,24.0,1995.0,11.2,3,1,1,2,0,3,12,25.0,9,7,2,5,3,6,5,0,"FW,MF",20-24,Forward,Mali,Africa
2523,Adama Traoré,MLI,Metz,Ligue 1,2019,24.0,1995.0,11.2,3,1,1,2,0,3,12,25.0,9,7,2,5,3,6,5,0,"FW,MF",20-24,Forward,Mali,Africa
2523,Adama Traoré,MLI,Metz,Ligue 1,2019,24.0,1995.0,11.2,3,1,1,2,0,3,12,25.0,9,7,2,5,3,6,5,0,"FW,MF",20-24,Forward,Mali,Africa
2523,Adama Traoré,MLI,Metz,Ligue 1,2019,24.0,1995.0,11.2,3,1,1,2,0,3,12,25.0,9,7,2,5,3,6,5,0,"FW,MF",20-24,Forward,Mali,Africa
2523,Adama Traoré,MLI,Metz,Ligue 1,2019,24.0,1995.0,11.2,3,1,1,2,0,3,12,25.0,9,7,2,5,3,6,5,0,"FW,MF",20-24,Forward,Mali,Africa
2523,Adama Traoré,MLI,Metz,Ligue 1,2019,24.0,1995.0,11.2,3,1,1,2,0,3,12,25.0,9,7,2,5,3,6,5,0,"FW,MF",20-24,Forward,Mali,Africa
2523,Adama Traoré,MLI,Metz,Ligue 1,2019,24.0,1995.0,11.2,3,1,1,2,0,3,12,25.0,9,7,2,5,3,6,5,0,"FW,MF",20-24,Forward,Mali,Africa
2523,Adama Traoré,MLI,Metz,Ligue 1,2019,24.0,1995.0,11.2,3,1,1,2,0,3,12,25.0,9,7,2,5,3,6,5,0,"FW,MF",20-24,Forward,Mali,Africa
2523,Adama Traoré,MLI,Metz,Ligue 1,2019,24.0,1995.0,11.2,3,1,1,2,0,3,12,25.0,9,7,2,5,3,6,5,0,"FW,MF",20-24,Forward,Mali,Africa
2523,Adama Traoré,MLI,Metz,Ligue 1,2019,24.0,1995.0,11.2,3,1,1,2,0,3,12,25.0,9,7,2,5,3,6,5,0,"FW,MF",20-24,Forward,Mali,Africa
2523,Adama Traoré,MLI,Metz,Ligue 1,2019,24.0,1995.0,11.2,3,1,1,2,0,3,12,25.0,9,7,2,5,3,6,5,0,"FW,MF",20-24,Forward,Mali,Africa
2523,Adama Traoré,MLI,Metz,Ligue 1,2019,24.0,1995.0,11.2,3,1,1,2,0,3,12,25.0,9,7,2,5,3,6,5,0,"FW,MF",20-24,Forward,Mali,Africa
2524,Adama Traoré,MLI,Monaco,Ligue 1,2019,24.0,1995.0,0.3,0,0,0,0,0,0,0,,0,0,0,0,1,1,0,0,MF,20-24,Midfielder,Mali,Africa
2524,Adama Traoré,MLI,Monaco,Ligue 1,2019,24.0,1995.0,0.3,0,0,0,0,0,0,0,,0,0,0,0,1,1,0,0,MF,20-24,Midfielder,Mali,Africa
2524,Adama Traoré,MLI,Monaco,Ligue 1,2019,24.0,1995.0,0.3,0,0,0,0,0,0,0,,0,0,0,0,1,1,0,0,MF,20-24,Midfielder,Mali,Africa
2524,Adama Traoré,MLI,Monaco,Ligue 1,2019,24.0,1995.0,0.3,0,0,0,0,0,0,0,,0,0,0,0,1,1,0,0,MF,20-24,Midfielder,Mali,Africa
2524,Adama Traoré,MLI,Monaco,Ligue 1,2019,24.0,1995.0,0.3,0,0,0,0,0,0,0,,0,0,0,0,1,1,0,0,MF,20-24,Midfielder,Mali,Africa
2524,Adama Traoré,MLI,Monaco,Ligue 1,2019,24.0,1995.0,0.3,0,0,0,0,0,0,0,,0,0,0,0,1,1,0,0,MF,20-24,Midfielder,Mali,Africa
2524,Adama Traoré,MLI,Monaco,Ligue 1,2019,24.0,1995.0,0.3,0,0,0,0,0,0,0,,0,0,0,0,1,1,0,0,MF,20-24,Midfielder,Mali,Africa
2524,Adama Traoré,MLI,Monaco,Ligue 1,2019,24.0,1995.0,0.3,0,0,0,0,0,0,0,,0,0,0,0,1,1,0,0,MF,20-24,Midfielder,Mali,Africa
2524,Adama Traoré,MLI,Monaco,Ligue 1,2019,24.0,1995.0,0.3,0,0,0,0,0,0,0,,0,0,0,0,1,1,0,0,MF,20-24,Midfielder,Mali,Africa
2524,Adama Traoré,MLI,Monaco,Ligue 1,2019,24.0,1995.0,0.3,0,0,0,0,0,0,0,,0,0,0,0,1,1,0,0,MF,20-24,Midfielder,Mali,Africa
2524,Adama Traoré,MLI,Monaco,Ligue 1,2019,24.0,1995.0,0.3,0,0,0,0,0,0,0,,0,0,0,0,1,1,0,0,MF,20-24,Midfielder,Mali,Africa
2524,Adama Traoré,MLI,Monaco,Ligue 1,2019,24.0,1995.0,0.3,0,0,0,0,0,0,0,,0,0,0,0,1,1,0,0,MF,20-24,Midfielder,Mali,Africa
2524,Adama Traoré,MLI,Monaco,Ligue 1,2019,24.0,1995.0,0.3,0,0,0,0,0,0,0,,0,0,0,0,1,1,0,0,MF,20-24,Midfielder,Mali,Africa
2524,Adama Traoré,MLI,Monaco,Ligue 1,2019,24.0,1995.0,0.3,0,0,0,0,0,0,0,,0,0,0,0,1,1,0,0,MF,20-24,Midfielder,Mali,Africa
2524,Adama Traoré,MLI,Monaco,Ligue 1,2019,24.0,1995.0,0.3,0,0,0,0,0,0,0,,0,0,0,0,1,1,0,0,MF,20-24,Midfielder,Mali,Africa
2524,Adama Traoré,MLI,Monaco,Ligue 1,2019,24.0,1995.0,0.3,0,0,0,0,0,0,0,,0,0,0,0,1,1,0,0,MF,20-24,Midfielder,Mali,Africa
2525,Bertrand Traoré,BFA,Lyon,Ligue 1,2019,23.0,1995.0,13.9,27,14,8,12,7,8,19,42.1,11,17,2,15,21,48,16,0,"FW,MF",20-24,Forward,Burkina Faso,Africa
2526,Charles Traore,MLI,Nantes,Ligue 1,2019,27.0,1992.0,19.3,48,35,27,19,2,36,61,59.0,25,21,4,17,39,87,64,0,DF,25-29,Defender,Mali,Africa
2527,Hamari Traoré,MLI,Rennes,Ligue 1,2019,27.0,1992.0,26.8,55,26,34,18,3,32,64,50.0,32,22,5,17,48,103,59,1,DF,25-29,Defender,Mali,Africa
2528,Ibrahima Traoré,GUI,Gladbach,Bundesliga,2019,31.0,1988.0,1.7,4,3,1,1,2,1,7,14.3,6,1,0,1,1,5,3,0,"FW,MF",30-34,Forward,Guinea,Africa
2529,Ismaël Traoré,CIV,Angers,Ligue 1,2019,32.0,1986.0,22.8,23,12,14,7,2,10,17,58.8,7,23,13,10,27,50,85,1,DF,30-34,Defender,Ivory Coast,Africa
2530,Kevin Trapp,GER,Eint Frankfurt,Bundesliga,2019,29.0,1990.0,22.0,0,0,0,0,0,0,1,0.0,1,0,0,0,3,3,5,0,GK,25-29,Goalkeeper,Germany,Europe
2531,Miguel Trauco,PER,Saint-Étienne,Ligue 1,2019,26.0,1992.0,16.4,32,20,16,12,4,19,44,43.2,25,8,1,7,23,55,25,0,DF,25-29,Defender,Peru,South America
2532,Mark Travers,IRL,Bournemouth,Premier League,2019,20.0,1999.0,1.0,0,0,0,0,0,0,0,,0,0,0,0,0,0,1,1,GK,20-24,Goalkeeper,Republic of Ireland,Europe
2533,Luca Tremolada,ITA,Brescia,Serie A,2019,27.0,1991.0,0.2,0,0,0,0,0,0,0,,0,0,0,0,0,0,0,0,MF,25-29,Midfielder,Italy,Europe
2534,Trézéguet,EGY,Aston Villa,Premier League,2019,24.0,1994.0,21.7,38,16,18,15,5,9,44,20.5,35,23,2,21,25,63,18,0,"FW,MF",20-24,Forward,Egypt,Africa
2536,Christopher Trimmel,AUT,Union Berlin,Bundesliga,2019,32.0,1987.0,31.8,71,41,35,32,4,32,54,59.3,22,31,10,21,51,122,88,1,"DF,MF",30-34,Defender,Austria,Europe
2537,Alessandro Tripaldelli,ITA,Sassuolo,Serie A,2019,20.0,1999.0,1.5,4,4,1,3,0,1,3,33.3,2,1,0,1,3,7,3,0,DF,20-24,Defender,Italy,Europe
2538,Kieran Trippier,ENG,Atlético Madrid,La Liga,2019,28.0,1990.0,22.0,52,34,24,21,7,34,53,64.2,19,33,7,26,24,76,46,0,DF,25-29,Defender,England,Europe
2539,William Troost-Ekong,NGA,Udinese,Serie A,2019,25.0,1993.0,28.6,37,19,25,12,0,10,18,55.6,8,41,29,12,31,68,135,2,DF,25-29,Defender,Nigeria,Africa
2540,Leandro Trossard,BEL,Brighton,Premier League,2019,24.0,1994.0,22.3,22,17,7,12,3,6,38,15.8,32,16,1,15,9,31,8,0,"FW,MF",20-24,Forward,Belgium,Europe
2541,Tom Trybull,GER,Norwich City,Premier League,2019,26.0,1993.0,12.6,39,25,15,18,6,16,60,26.7,44,20,5,15,16,55,35,0,MF,25-29,Midfielder,Germany,Europe
2542,Axel Tuanzebe,COD,Manchester Utd,Premier League,2019,21.0,1997.0,2.1,2,2,0,2,0,1,2,50.0,1,1,0,1,5,7,5,1,DF,20-24,Defender,DR Congo,Africa
2543,Georgi Tunjov,EST,SPAL,Serie A,2019,18.0,2001.0,3.2,4,4,3,1,0,1,11,9.1,10,3,1,2,1,5,0,0,MF,Under 20,Midfielder,Estonia,Europe
2544,Stefano Turati,ITA,Sassuolo,Serie A,2019,17.0,2001.0,2.0,0,0,0,0,0,0,0,,0,0,0,0,0,0,1,0,GK,Under 20,Goalkeeper,Italy,Europe
2545,Gennaro Tutino,ITA,Hellas Verona,Serie A,2019,22.0,1996.0,2.5,0,0,0,0,0,0,0,,0,0,0,0,2,2,1,0,"FW,MF",20-24,Forward,Italy,Europe
2546,Matthieu Udol,FRA,Metz,Ligue 1,2019,23.0,1996.0,12.2,29,19,19,8,2,13,24,54.2,11,21,4,17,23,52,43,0,DF,20-24,Defender,France,Europe
2547,Hwang Ui-jo,KOR,Bordeaux,Ligue 1,2019,26.0,1992.0,18.1,9,7,2,5,2,4,20,20.0,16,7,0,7,5,14,5,0,"FW,MF",25-29,Forward,South Korea,Asia
2548,Anthony Ujah,NGA,Union Berlin,Bundesliga,2019,28.0,1990.0,10.5,8,6,4,2,2,1,6,16.7,5,0,0,0,3,11,10,0,"FW,MF",25-29,Forward,Nigeria,Africa
2550,Sven Ulreich,GER,Bayern Munich,Bundesliga,2019,30.0,1988.0,1.0,0,0,0,0,0,0,0,,0,0,0,0,0,0,0,0,GK,30-34,Goalkeeper,Germany,Europe
2551,Samuel Umtiti,FRA,Barcelona,La Liga,2019,25.0,1993.0,10.5,11,5,5,5,1,5,8,62.5,3,4,2,2,22,33,32,0,DF,25-29,Defender,France,Europe
2552,Enes Ünal,TUR,Valladolid,La Liga,2019,22.0,1997.0,26.0,20,12,6,11,3,6,28,21.4,22,17,5,12,6,26,13,0,FW,20-24,Forward,Turkey,Asia
2553,Cengiz Ünder,TUR,Roma,Serie A,2019,22.0,1997.0,9.7,10,6,4,4,2,2,9,22.2,7,7,2,5,8,18,7,0,FW,20-24,Forward,Turkey,Asia
2554,Dayot Upamecano,FRA,RB Leipzig,Bundesliga,2019,20.0,1998.0,26.2,52,31,37,15,0,23,43,53.5,20,31,17,14,43,95,88,1,DF,20-24,Defender,France,Europe
2555,Mark Uth,GER,Köln,Bundesliga,2019,27.0,1991.0,12.9,19,12,4,10,5,9,32,28.1,23,15,0,15,7,26,3,0,"MF,FW",25-29,Midfielder,Germany,Europe
2556,Mark Uth,GER,Schalke 04,Bundesliga,2019,27.0,1991.0,3.9,3,2,1,1,1,0,3,0.0,3,4,0,4,1,4,0,0,"FW,MF",25-29,Forward,Germany,Europe
2559,William Vainqueur,FRA,Toulouse,Ligue 1,2019,30.0,1988.0,19.1,68,36,30,32,6,22,60,36.7,38,21,5,16,29,97,23,0,MF,30-34,Midfielder,France,Europe
2560,Mirko Valdifiori,ITA,SPAL,Serie A,2019,33.0,1986.0,15.6,31,15,14,17,0,16,33,48.5,17,8,3,5,4,35,25,0,MF,30-34,Midfielder,Italy,Europe
2561,Pierrick Valdivia,FRA,Nîmes,Ligue 1,2019,31.0,1988.0,0.8,1,1,0,0,1,0,1,0.0,1,0,0,0,0,1,0,0,MF,30-34,Midfielder,France,Europe
2563,Antoine Valerio,FRA,Nîmes,Ligue 1,2019,19.0,1999.0,1.0,1,1,0,1,0,0,2,0.0,2,2,0,2,3,4,1,0,MF,Under 20,Midfielder,France,Europe
2565,Yan Valery,TUN,Southampton,Premier League,2019,20.0,1999.0,8.7,20,7,9,7,4,11,19,57.9,8,9,1,8,13,33,32,2,DF,20-24,Defender,Tunisia,Africa
2566,Martin Valjent,SVK,Mallorca,La Liga,2019,23.0,1995.0,35.4,25,17,14,10,1,13,25,52.0,12,39,27,12,37,62,146,1,DF,20-24,Defender,Slovakia,Europe
2570,Luca Valls,FRA,Nîmes,Ligue 1,2019,20.0,1998.0,0.1,1,0,1,0,0,1,1,100.0,0,1,0,1,0,1,0,0,MF,20-24,Midfielder,France,Europe
2571,Theo Valls,FRA,Nîmes,Ligue 1,2019,23.0,1995.0,18.1,39,16,12,26,1,16,50,32.0,34,17,0,17,13,52,6,0,MF,20-24,Midfielder,France,Europe
2572,Mattia Valoti,ITA,SPAL,Serie A,2019,25.0,1993.0,17.0,48,30,21,25,2,16,43,37.2,27,27,6,21,16,64,18,0,"MF,FW",25-29,Midfielder,Italy,Europe
2573,Federico Valverde,URU,Real Madrid,La Liga,2019,21.0,1998.0,21.2,38,19,9,19,10,12,36,33.3,24,38,4,34,21,59,12,2,MF,20-24,Midfielder,Uruguay,South America
2574,Virgil van Dijk,NED,Liverpool,Premier League,2019,28.0,1991.0,38.0,23,12,18,5,0,6,13,46.2,7,20,15,5,40,63,166,2,DF,25-29,Defender,Netherlands,Europe
2575,Raphaël Varane,FRA,Real Madrid,La Liga,2019,26.0,1993.0,31.4,30,17,15,14,1,12,23,52.2,11,32,16,16,31,61,124,0,DF,25-29,Defender,France,Europe
2576,Jamie Vardy,ENG,Leicester City,Premier League,2019,32.0,1987.0,33.7,15,12,0,9,6,2,4,50.0,2,22,4,18,2,17,22,0,FW,30-34,Forward,England,Europe
2577,Matías Vargas,ARG,Espanyol,La Liga,2019,22.0,1997.0,11.4,13,5,7,3,3,4,23,17.4,19,12,2,10,3,16,5,0,"FW,MF",20-24,Forward,Argentina,South America
2578,Ruben Vargas,SUI,Augsburg,Bundesliga,2019,20.0,1998.0,28.1,32,16,18,7,7,8,36,22.2,28,26,1,25,26,58,35,0,"FW,MF",20-24,Forward,Switzerland,Europe
2579,Thibaut Vargas,FRA,Montpellier,Ligue 1,2019,19.0,2000.0,1.7,3,1,3,0,0,2,5,40.0,3,1,1,0,0,3,3,0,"DF,MF",Under 20,Defender,France,Europe
2580,Sebastian Vasiliadis,GRE,Paderborn 07,Bundesliga,2019,21.0,1997.0,31.2,73,45,34,31,8,28,81,34.6,53,47,6,41,34,107,50,0,MF,20-24,Midfielder,Greece,Europe
2581,Indiana Vassilev,USA,Aston Villa,Premier League,2019,18.0,2001.0,0.6,0,0,0,0,0,0,0,,0,0,0,0,0,0,0,0,"FW,MF",Under 20,Forward,United States,North America
2582,Denis Vavro,SVK,Lazio,Serie A,2019,23.0,1996.0,3.6,3,3,2,1,0,1,3,33.3,2,8,6,2,5,8,10,0,DF,20-24,Defender,Slovakia,Europe
2583,Franco Vázquez,ARG,Sevilla,La Liga,2019,30.0,1989.0,12.2,25,17,9,14,2,6,36,16.7,30,13,0,13,10,35,10,0,"MF,FW",30-34,Midfielder,Argentina,South America
2586,Matías Vecino,URU,Inter,Serie A,2019,27.0,1991.0,14.2,31,20,14,11,6,9,36,25.0,27,20,3,17,15,46,26,0,MF,25-29,Midfielder,Uruguay,South America
2589,Miguel Veloso,POR,Hellas Verona,Serie A,2019,33.0,1986.0,31.2,52,29,20,28,4,18,60,30.0,42,36,12,24,32,84,46,1,MF,30-34,Midfielder,Portugal,Europe
2591,Lorenzo Venuti,ITA,Fiorentina,Serie A,2019,24.0,1995.0,9.5,20,10,12,6,2,13,19,68.4,6,5,1,4,11,31,15,0,"DF,MF",20-24,Defender,Italy,Europe
2592,Brayan Vera,COL,Lecce,Serie A,2019,20.0,1999.0,1.7,4,1,2,1,1,3,7,42.9,4,1,0,1,1,5,4,0,"DF,FW",20-24,Defender,Colombia,South America
2593,Simone Verdi,ITA,Torino,Serie A,2019,27.0,1992.0,23.0,19,10,4,12,3,9,38,23.7,29,14,0,14,7,26,1,0,"MF,FW",25-29,Midfielder,Italy,Europe
2594,Jordan Veretout,FRA,Roma,Serie A,2019,26.0,1993.0,29.2,36,18,13,16,7,14,43,32.6,29,35,5,30,18,54,31,1,MF,25-29,Midfielder,France,Europe
2595,Marco Verratti,ITA,Paris S-G,Ligue 1,2019,26.0,1992.0,16.5,54,32,22,22,10,20,56,35.7,36,23,3,20,19,73,9,0,MF,25-29,Midfielder,Italy,Europe
2596,Valerio Verre,ITA,Hellas Verona,Serie A,2019,25.0,1994.0,19.7,25,15,4,11,10,9,23,39.1,14,5,0,5,13,38,9,0,"MF,FW",25-29,Midfielder,Italy,Europe
2597,Birger Verstraete,BEL,Köln,Bundesliga,2019,25.0,1994.0,7.4,20,11,9,10,1,11,21,52.4,10,8,1,7,4,24,10,1,MF,25-29,Midfielder,Belgium,Europe
2598,Jan Vertonghen,BEL,Tottenham,Premier League,2019,32.0,1987.0,18.3,40,24,25,14,1,20,31,64.5,11,18,10,8,33,73,68,0,DF,30-34,Defender,Belgium,Europe
2600,Jannik Vestergaard,DEN,Southampton,Premier League,2019,26.0,1992.0,16.6,19,12,14,5,0,11,28,39.3,17,15,9,6,26,45,99,2,DF,25-29,Defender,Denmark,Europe
2601,Rúben Vezo,POR,Levante,La Liga,2019,25.0,1994.0,29.0,41,24,28,13,0,19,35,54.3,16,37,29,8,42,83,144,2,DF,25-29,Defender,Portugal,Europe
2602,Francesco Vicari,ITA,SPAL,Serie A,2019,24.0,1994.0,32.2,27,13,20,6,1,12,25,48.0,13,48,37,11,38,65,145,1,DF,20-24,Defender,Italy,Europe
2605,Arturo Vidal,CHI,Barcelona,La Liga,2019,32.0,1987.0,18.6,63,38,22,30,11,24,58,41.4,34,31,7,24,17,80,16,1,MF,30-34,Midfielder,Chile,South America
2606,Clément Vidal,FRA,Montpellier,Ligue 1,2019,19.0,2000.0,1.0,0,0,0,0,0,0,2,0.0,2,1,1,0,0,0,6,0,DF,Under 20,Defender,France,Europe
2608,Ronaldo Vieira,ENG,Sampdoria,Serie A,2019,21.0,1998.0,20.2,33,19,13,17,3,6,28,21.4,22,14,2,12,21,54,31,0,MF,20-24,Midfielder,England,Europe
2609,Mauro Vigorito,ITA,Lecce,Serie A,2019,29.0,1990.0,4.7,0,0,0,0,0,0,0,,0,0,0,0,0,0,3,1,GK,25-29,Goalkeeper,Italy,Europe
2616,Rúben Vinagre,POR,Wolves,Premier League,2019,20.0,1999.0,7.2,23,13,15,6,2,12,15,80.0,3,7,2,5,11,34,22,0,"MF,DF",20-24,Midfielder,Portugal,Europe
2617,Luigi Vitale,ITA,Hellas Verona,Serie A,2019,31.0,1987.0,0.5,1,0,0,1,0,0,0,,0,1,0,1,0,1,0,0,DF,30-34,Defender,Italy,Europe
2619,Mattia Viviani,ITA,Brescia,Serie A,2019,18.0,2000.0,3.8,3,1,0,3,0,1,8,12.5,7,3,3,0,9,12,2,1,MF,Under 20,Midfielder,Italy,Europe
2621,Kevin Vogt,GER,Hoffenheim,Bundesliga,2019,27.0,1991.0,10.7,7,5,4,3,0,3,9,33.3,6,12,6,6,8,15,52,1,DF,25-29,Defender,Germany,Europe
2622,Kevin Vogt,GER,Werder Bremen,Bundesliga,2019,27.0,1991.0,12.3,14,10,8,6,0,8,16,50.0,8,15,12,3,25,39,37,1,"DF,MF",25-29,Defender,Germany,Europe
2623,Jake Vokins,ENG,Southampton,Premier League,2019,19.0,2000.0,1.0,2,2,0,0,2,1,1,100.0,0,0,0,0,0,2,1,0,DF,Under 20,Defender,England,Europe
2624,Kevin Volland,GER,Leverkusen,Bundesliga,2019,27.0,1992.0,22.7,16,6,5,6,5,5,16,31.3,11,14,2,12,5,21,7,0,FW,25-29,Forward,Germany,Europe
2625,Mario Vrančić,BIH,Norwich City,Premier League,2019,30.0,1989.0,7.1,27,16,14,11,2,16,27,59.3,11,9,0,9,10,37,4,2,MF,30-34,Midfielder,Bosnia and Herzegovina,Europe
2626,Stefan de Vrij,NED,Inter,Serie A,2019,27.0,1992.0,31.4,33,18,20,12,1,14,27,51.9,13,34,24,10,52,85,121,1,DF,25-29,Defender,Netherlands,Europe
2627,Giacomo Vrioni,ALB,Juventus,Serie A,2019,20.0,1998.0,0.1,0,0,0,0,0,0,0,,0,0,0,0,0,0,0,0,FW,20-24,Forward,Albania,Europe
2628,Šime Vrsaljko,CRO,Atlético Madrid,La Liga,2019,27.0,1992.0,4.0,6,5,6,0,0,5,6,83.3,1,5,3,2,8,14,11,0,DF,25-29,Defender,Croatia,Europe
2629,Nikola Vukčević,MNE,Levante,La Liga,2019,27.0,1991.0,17.4,41,26,17,17,7,15,40,37.5,25,19,7,12,12,53,16,0,MF,25-29,Midfielder,Montenegro,Europe
2631,Molla Wagué,MLI,Nantes,Ligue 1,2019,28.0,1991.0,7.6,15,12,11,4,0,7,7,100.0,0,10,8,2,15,30,42,0,DF,25-29,Defender,Mali,Africa
2632,Moussa Wagué,SEN,Barcelona,La Liga,2019,20.0,1998.0,1.0,2,1,1,0,1,1,1,100.0,0,0,0,0,1,3,0,0,DF,20-24,Defender,Senegal,Africa
2633,Moussa Wagué,SEN,Nice,Ligue 1,2019,20.0,1998.0,2.2,6,4,3,3,0,2,3,66.7,1,2,1,1,2,8,2,0,"DF,MF",20-24,Defender,Senegal,Africa
2634,Wakaso,GHA,Alavés,La Liga,2019,29.0,1990.0,14.3,54,31,25,24,5,16,33,48.5,17,23,5,18,17,71,17,1,MF,25-29,Midfielder,Ghana,Africa
2635,Walace,BRA,Udinese,Serie A,2019,24.0,1995.0,12.7,28,9,19,6,3,13,42,31.0,29,14,6,8,33,61,19,0,MF,20-24,Midfielder,Brazil,South America
2636,Theo Walcott,ENG,Everton,Premier League,2019,30.0,1989.0,14.3,13,8,6,5,2,3,15,20.0,12,13,0,13,8,21,1,0,"MF,FW",30-34,Midfielder,England,Europe
2637,Luca Waldschmidt,GER,Freiburg,Bundesliga,2019,23.0,1996.0,14.1,10,7,3,5,2,2,18,11.1,16,11,2,9,4,14,4,0,"FW,MF",20-24,Forward,Germany,Europe
2638,Kyle Walker,ENG,Manchester City,Premier League,2019,29.0,1990.0,26.6,28,18,12,15,1,12,29,41.4,17,15,6,9,28,56,42,1,DF,25-29,Defender,England,Europe
2639,Kyle Walker-Peters,ENG,Southampton,Premier League,2019,22.0,1997.0,7.8,13,8,5,6,2,6,16,37.5,10,10,3,7,14,27,21,1,DF,20-24,Defender,England,Europe
2640,Kyle Walker-Peters,ENG,Tottenham,Premier League,2019,22.0,1997.0,2.7,8,5,8,0,0,5,9,55.6,4,4,2,2,3,11,5,1,DF,20-24,Defender,England,Europe
2641,Rémi Walter,FRA,Nice,Ligue 1,2019,24.0,1995.0,0.6,1,1,0,1,0,1,1,100.0,0,0,0,0,0,1,0,0,MF,20-24,Midfielder,France,Europe
2643,Aaron Wan-Bissaka,ENG,Manchester Utd,Premier League,2019,21.0,1997.0,34.1,129,80,71,50,8,64,86,74.4,22,46,13,33,66,195,83,0,DF,20-24,Defender,England,Europe
2644,Victor Wanyama,KEN,Tottenham,Premier League,2019,28.0,1991.0,0.3,0,0,0,0,0,0,0,,0,0,0,0,0,0,0,0,MF,25-29,Midfielder,Kenya,Africa
2645,Joel Ward,ENG,Crystal Palace,Premier League,2019,29.0,1989.0,26.5,69,42,48,16,5,39,56,69.6,17,13,6,7,48,117,93,1,DF,25-29,Defender,England,Europe
2646,James Ward-Prowse,ENG,Southampton,Premier League,2019,24.0,1994.0,38.0,92,48,39,39,14,39,94,41.5,55,48,14,34,60,152,75,1,"MF,DF",20-24,Midfielder,England,Europe
2647,Daniel Wass,DEN,Valencia,La Liga,2019,30.0,1989.0,30.4,44,25,25,13,6,25,57,43.9,32,22,5,17,31,75,91,1,"DF,MF",30-34,Defender,Denmark,Europe
2648,Kelland Watts,ENG,Newcastle Utd,Premier League,2019,19.0,1999.0,0.2,1,0,1,0,0,1,1,100.0,0,0,0,0,0,1,0,0,DF,Under 20,Defender,England,Europe
2649,Timothy Weah,USA,Lille,Ligue 1,2019,19.0,2000.0,0.9,0,0,0,0,0,0,1,0.0,1,0,0,0,0,0,1,0,"MF,FW",Under 20,Midfielder,United States,North America
2650,Adam Webster,ENG,Brighton,Premier League,2019,24.0,1995.0,29.6,30,17,21,8,1,14,32,43.8,18,43,26,17,45,75,110,2,DF,20-24,Defender,England,Europe
2651,Wout Weghorst,NED,Wolfsburg,Bundesliga,2019,26.0,1992.0,30.4,15,8,4,5,6,1,17,5.9,16,17,4,13,2,17,30,0,FW,25-29,Forward,Netherlands,Europe
2652,Julian Weigl,GER,Dortmund,Bundesliga,2019,23.0,1995.0,11.3,16,9,12,3,1,9,16,56.3,7,10,0,10,8,24,21,0,"MF,DF",20-24,Midfielder,Germany,Europe
2653,Mitchell Weiser,GER,Leverkusen,Bundesliga,2019,25.0,1994.0,13.0,41,29,20,17,4,18,30,60.0,12,19,2,17,24,65,22,1,"DF,MF",25-29,Defender,Germany,Europe
2654,Danny Welbeck,ENG,Watford,Premier League,2019,28.0,1990.0,9.1,14,6,6,5,3,3,11,27.3,8,12,1,11,5,19,7,0,"FW,MF",25-29,Forward,England,Europe
2655,Wendell,BRA,Leverkusen,Bundesliga,2019,26.0,1993.0,21.1,64,42,26,26,12,41,66,62.1,25,30,4,26,36,100,36,0,"DF,MF",25-29,Defender,Brazil,South America
2655,Wendell,BRA,Leverkusen,Bundesliga,2019,26.0,1993.0,21.1,64,42,26,26,12,41,66,62.1,25,30,4,26,36,100,36,0,"DF,MF",25-29,Defender,Brazil,South America
2655,Wendell,BRA,Leverkusen,Bundesliga,2019,26.0,1993.0,21.1,64,42,26,26,12,41,66,62.1,25,30,4,26,36,100,36,0,"DF,MF",25-29,Defender,Brazil,South America
2655,Wendell,BRA,Leverkusen,Bundesliga,2019,26.0,1993.0,21.1,64,42,26,26,12,41,66,62.1,25,30,4,26,36,100,36,0,"DF,MF",25-29,Defender,Brazil,South America
2655,Wendell,BRA,Leverkusen,Bundesliga,2019,26.0,1993.0,21.1,64,42,26,26,12,41,66,62.1,25,30,4,26,36,100,36,0,"DF,MF",25-29,Defender,Brazil,South America
2655,Wendell,BRA,Leverkusen,Bundesliga,2019,26.0,1993.0,21.1,64,42,26,26,12,41,66,62.1,25,30,4,26,36,100,36,0,"DF,MF",25-29,Defender,Brazil,South America
2655,Wendell,BRA,Leverkusen,Bundesliga,2019,26.0,1993.0,21.1,64,42,26,26,12,41,66,62.1,25,30,4,26,36,100,36,0,"DF,MF",25-29,Defender,Brazil,South America
2655,Wendell,BRA,Leverkusen,Bundesliga,2019,26.0,1993.0,21.1,64,42,26,26,12,41,66,62.1,25,30,4,26,36,100,36,0,"DF,MF",25-29,Defender,Brazil,South America
2655,Wendell,BRA,Leverkusen,Bundesliga,2019,26.0,1993.0,21.1,64,42,26,26,12,41,66,62.1,25,30,4,26,36,100,36,0,"DF,MF",25-29,Defender,Brazil,South America
2656,Oscar Wendt,SWE,Gladbach,Bundesliga,2019,33.0,1985.0,18.7,26,14,16,8,2,12,31,38.7,19,27,6,21,20,46,45,0,DF,30-34,Defender,Sweden,Europe
2657,Timo Werner,GER,RB Leipzig,Bundesliga,2019,23.0,1996.0,31.1,20,9,6,7,7,3,16,18.8,13,16,0,16,5,25,2,0,FW,20-24,Forward,Germany,Europe
2658,Ashley Westwood,ENG,Burnley,Premier League,2019,29.0,1990.0,35.0,54,33,15,32,7,17,48,35.4,31,23,11,12,32,86,32,3,MF,25-29,Midfielder,England,Europe
2659,Connor Wickham,ENG,Crystal Palace,Premier League,2019,26.0,1993.0,1.1,1,1,1,0,0,0,0,,0,1,0,1,1,2,0,0,"FW,MF",25-29,Forward,England,Europe
2660,Felix Wiedwald,GER,Eint Frankfurt,Bundesliga,2019,29.0,1990.0,3.0,0,0,0,0,0,0,0,,0,0,0,0,0,0,2,1,GK,25-29,Goalkeeper,Germany,Europe
2661,Georginio Wijnaldum,NED,Liverpool,Premier League,2019,28.0,1990.0,32.6,38,20,12,21,5,10,40,25.0,30,18,4,14,17,55,34,3,MF,25-29,Midfielder,Netherlands,Europe
2662,Jetro Willems,NED,Newcastle Utd,Premier League,2019,25.0,1994.0,16.6,37,19,29,6,2,18,39,46.2,21,20,5,15,17,54,42,1,DF,25-29,Defender,Netherlands,Europe
2663,William,BRA,Wolfsburg,Bundesliga,2019,24.0,1995.0,15.2,55,26,34,14,7,27,59,45.8,32,10,3,7,24,79,38,1,DF,20-24,Defender,Brazil,South America
2663,William,BRA,Wolfsburg,Bundesliga,2019,24.0,1995.0,15.2,55,26,34,14,7,27,59,45.8,32,10,3,7,24,79,38,1,DF,20-24,Defender,Brazil,South America
2663,William,BRA,Wolfsburg,Bundesliga,2019,24.0,1995.0,15.2,55,26,34,14,7,27,59,45.8,32,10,3,7,24,79,38,1,DF,20-24,Defender,Brazil,South America
2663,William,BRA,Wolfsburg,Bundesliga,2019,24.0,1995.0,15.2,55,26,34,14,7,27,59,45.8,32,10,3,7,24,79,38,1,DF,20-24,Defender,Brazil,South America
2663,William,BRA,Wolfsburg,Bundesliga,2019,24.0,1995.0,15.2,55,26,34,14,7,27,59,45.8,32,10,3,7,24,79,38,1,DF,20-24,Defender,Brazil,South America
2663,William,BRA,Wolfsburg,Bundesliga,2019,24.0,1995.0,15.2,55,26,34,14,7,27,59,45.8,32,10,3,7,24,79,38,1,DF,20-24,Defender,Brazil,South America
2663,William,BRA,Wolfsburg,Bundesliga,2019,24.0,1995.0,15.2,55,26,34,14,7,27,59,45.8,32,10,3,7,24,79,38,1,DF,20-24,Defender,Brazil,South America
2663,William,BRA,Wolfsburg,Bundesliga,2019,24.0,1995.0,15.2,55,26,34,14,7,27,59,45.8,32,10,3,7,24,79,38,1,DF,20-24,Defender,Brazil,South America
2663,William,BRA,Wolfsburg,Bundesliga,2019,24.0,1995.0,15.2,55,26,34,14,7,27,59,45.8,32,10,3,7,24,79,38,1,DF,20-24,Defender,Brazil,South America
2663,William,BRA,Wolfsburg,Bundesliga,2019,24.0,1995.0,15.2,55,26,34,14,7,27,59,45.8,32,10,3,7,24,79,38,1,DF,20-24,Defender,Brazil,South America
2663,William,BRA,Wolfsburg,Bundesliga,2019,24.0,1995.0,15.2,55,26,34,14,7,27,59,45.8,32,10,3,7,24,79,38,1,DF,20-24,Defender,Brazil,South America
2663,William,BRA,Wolfsburg,Bundesliga,2019,24.0,1995.0,15.2,55,26,34,14,7,27,59,45.8,32,10,3,7,24,79,38,1,DF,20-24,Defender,Brazil,South America
2663,William,BRA,Wolfsburg,Bundesliga,2019,24.0,1995.0,15.2,55,26,34,14,7,27,59,45.8,32,10,3,7,24,79,38,1,DF,20-24,Defender,Brazil,South America
2663,William,BRA,Wolfsburg,Bundesliga,2019,24.0,1995.0,15.2,55,26,34,14,7,27,59,45.8,32,10,3,7,24,79,38,1,DF,20-24,Defender,Brazil,South America
2663,William,BRA,Wolfsburg,Bundesliga,2019,24.0,1995.0,15.2,55,26,34,14,7,27,59,45.8,32,10,3,7,24,79,38,1,DF,20-24,Defender,Brazil,South America
2663,William,BRA,Wolfsburg,Bundesliga,2019,24.0,1995.0,15.2,55,26,34,14,7,27,59,45.8,32,10,3,7,24,79,38,1,DF,20-24,Defender,Brazil,South America
2664,Brandon Williams,ENG,Manchester Utd,Premier League,2019,18.0,2000.0,11.2,21,15,11,6,4,9,29,31.0,20,9,4,5,16,37,27,0,DF,Under 20,Defender,England,Europe
2665,Iñaki Williams,GHA,Athletic Club,La Liga,2019,25.0,1994.0,32.7,15,5,0,7,8,5,18,27.8,13,18,2,16,5,20,29,0,FW,25-29,Forward,Ghana,Africa
2666,Neco Williams,WAL,Liverpool,Premier League,2019,18.0,2001.0,2.6,5,3,1,3,1,4,5,80.0,1,3,1,2,9,14,6,0,DF,Under 20,Defender,Wales,Europe
2667,Willian,BRA,Chelsea,Premier League,2019,30.0,1988.0,28.9,45,27,14,24,7,14,43,32.6,29,15,0,15,20,65,7,0,"FW,MF",30-34,Forward,Brazil,South America
2667,Willian,BRA,Chelsea,Premier League,2019,30.0,1988.0,28.9,45,27,14,24,7,14,43,32.6,29,15,0,15,20,65,7,0,"FW,MF",30-34,Forward,Brazil,South America
2667,Willian,BRA,Chelsea,Premier League,2019,30.0,1988.0,28.9,45,27,14,24,7,14,43,32.6,29,15,0,15,20,65,7,0,"FW,MF",30-34,Forward,Brazil,South America
2667,Willian,BRA,Chelsea,Premier League,2019,30.0,1988.0,28.9,45,27,14,24,7,14,43,32.6,29,15,0,15,20,65,7,0,"FW,MF",30-34,Forward,Brazil,South America
2668,Joe Willock,ENG,Arsenal,Premier League,2019,19.0,1999.0,9.5,25,16,9,12,4,8,21,38.1,13,16,2,14,4,29,11,2,"MF,FW",Under 20,Midfielder,England,Europe
2669,Jack Wilshere,ENG,West Ham,Premier League,2019,27.0,1992.0,2.4,1,0,1,0,0,0,4,0.0,4,3,0,3,1,2,0,0,MF,25-29,Midfielder,England,Europe
2670,Callum Wilson,ENG,Bournemouth,Premier League,2019,27.0,1992.0,32.3,12,9,3,6,3,2,17,11.8,15,16,2,14,4,16,16,0,FW,25-29,Forward,England,Europe
2670,Callum Wilson,ENG,Bournemouth,Premier League,2019,27.0,1992.0,32.3,12,9,3,6,3,2,17,11.8,15,16,2,14,4,16,16,0,FW,25-29,Forward,England,Europe
2670,Callum Wilson,ENG,Bournemouth,Premier League,2019,27.0,1992.0,32.3,12,9,3,6,3,2,17,11.8,15,16,2,14,4,16,16,0,FW,25-29,Forward,England,Europe
2670,Callum Wilson,ENG,Bournemouth,Premier League,2019,27.0,1992.0,32.3,12,9,3,6,3,2,17,11.8,15,16,2,14,4,16,16,0,FW,25-29,Forward,England,Europe
2671,Harry Wilson,WAL,Bournemouth,Premier League,2019,22.0,1997.0,18.3,23,13,8,10,5,11,34,32.4,23,26,2,24,11,34,15,1,"MF,FW",20-24,Midfielder,Wales,Europe
2672,Harry Winks,ENG,Tottenham,Premier League,2019,23.0,1996.0,24.7,40,24,18,20,2,17,54,31.5,37,27,8,19,36,76,32,1,MF,20-24,Midfielder,England,Europe
2673,Florian Wirtz,GER,Leverkusen,Bundesliga,2019,16.0,2003.0,4.1,4,2,0,4,0,2,4,50.0,2,4,0,4,2,6,1,0,FW,Under 20,Forward,Germany,Europe
2674,Axel Witsel,BEL,Dortmund,Bundesliga,2019,30.0,1989.0,24.9,28,20,10,17,1,14,33,42.4,19,26,7,19,31,59,19,1,MF,30-34,Midfielder,Belgium,Europe
2675,Hannes Wolf,AUT,RB Leipzig,Bundesliga,2019,20.0,1999.0,0.6,3,0,0,1,2,1,4,25.0,3,0,0,0,0,3,0,0,"FW,MF",20-24,Forward,Austria,Europe
2676,Marius Wolf,GER,Hertha BSC,Bundesliga,2019,24.0,1995.0,15.7,19,11,9,7,3,10,27,37.0,17,14,1,13,17,36,13,0,"FW,MF",20-24,Forward,Germany,Europe
2677,Nick Woltemade,GER,Werder Bremen,Bundesliga,2019,17.0,2002.0,1.0,2,1,0,2,0,0,1,0.0,1,1,0,1,0,2,2,0,"FW,MF",Under 20,Forward,Germany,Europe
2678,Chris Wood,NZL,Burnley,Premier League,2019,27.0,1991.0,27.1,7,4,2,4,1,5,15,33.3,10,15,2,13,4,11,18,0,FW,25-29,Forward,New Zealand,Oceania
2679,Xeka,POR,Lille,Ligue 1,2019,24.0,1994.0,7.9,18,10,3,13,2,9,29,31.0,20,11,1,10,4,22,7,1,MF,20-24,Midfielder,Portugal,Europe
2680,Granit Xhaka,SUI,Arsenal,Premier League,2019,26.0,1992.0,28.7,45,25,20,19,6,25,55,45.5,30,32,16,16,21,66,59,3,MF,25-29,Midfielder,Switzerland,Europe
2681,Jawad El Yamiq,MAR,Genoa,Serie A,2019,27.0,1992.0,2.2,3,2,3,0,0,1,4,25.0,3,3,2,1,1,4,3,0,DF,25-29,Defender,Morocco,Africa
2682,Andriy Yarmolenko,UKR,West Ham,Premier League,2019,29.0,1989.0,11.0,13,8,5,6,2,5,20,25.0,15,3,1,2,6,19,4,0,"MF,FW",25-29,Midfielder,Ukraine,Europe
2683,Yusuf Yazıcı,TUR,Lille,Ligue 1,2019,22.0,1997.0,9.4,17,8,2,11,4,5,13,38.5,8,6,1,5,5,22,1,1,"MF,FW",20-24,Midfielder,Turkey,Asia
2684,DeAndre Yedlin,USA,Newcastle Utd,Premier League,2019,26.0,1993.0,10.4,18,13,10,6,2,8,16,50.0,8,13,7,6,10,28,20,0,DF,25-29,Defender,United States,North America
2686,Okay Yokuşlu,TUR,Celta Vigo,La Liga,2019,25.0,1994.0,21.9,41,27,18,21,2,20,42,47.6,22,12,5,7,28,69,71,1,MF,25-29,Midfielder,Turkey,Asia
2687,Maya Yoshida,JPN,Southampton,Premier League,2019,30.0,1988.0,6.2,8,5,4,1,3,3,7,42.9,4,6,2,4,4,12,27,1,DF,30-34,Defender,Japan,Asia
2688,Maya Yoshida,JPN,Sampdoria,Serie A,2019,30.0,1988.0,13.2,4,3,2,2,0,2,6,33.3,4,15,12,3,27,31,72,0,DF,30-34,Defender,Japan,Asia
2689,Elie Youan,FRA,Nantes,Ligue 1,2019,20.0,1999.0,1.8,0,0,0,0,0,0,7,0.0,7,2,0,2,0,0,3,0,"FW,MF",20-24,Forward,France,Europe
2690,Amin Younes,GER,Napoli,Serie A,2019,25.0,1993.0,2.0,3,2,1,2,0,2,4,50.0,2,2,0,2,0,3,1,0,"FW,MF",25-29,Forward,Germany,Europe
2691,Ashley Young,ENG,Manchester Utd,Premier League,2019,34.0,1985.0,10.6,14,7,7,4,3,5,17,29.4,12,8,2,6,11,25,29,0,DF,30-34,Defender,England,Europe
2692,Ashley Young,ENG,Inter,Serie A,2019,34.0,1985.0,13.2,11,5,3,5,3,6,19,31.6,13,11,3,8,14,25,24,0,DF,30-34,Defender,England,Europe
2694,Pablo Zabaleta,ARG,West Ham,Premier League,2019,34.0,1985.0,6.6,18,10,12,5,1,6,13,46.2,7,5,3,2,14,32,21,0,DF,30-34,Defender,Argentina,South America
2695,Mattia Zaccagni,ITA,Hellas Verona,Serie A,2019,24.0,1995.0,23.5,20,11,10,5,5,3,15,20.0,12,14,3,11,20,40,21,0,"MF,FW",20-24,Midfielder,Italy,Europe
2696,Dan-Axel Zagadou,FRA,Dortmund,Bundesliga,2019,20.0,1999.0,10.9,16,10,12,4,0,6,8,75.0,2,12,8,4,15,31,38,0,DF,20-24,Defender,France,Europe
2697,Arthur Zagre,FRA,Paris S-G,Ligue 1,2019,17.0,2001.0,0.3,1,0,1,0,0,0,0,,0,1,0,1,1,2,0,0,MF,Under 20,Midfielder,France,Europe
2698,Wilfried Zaha,CIV,Crystal Palace,Premier League,2019,26.0,1992.0,36.4,43,19,18,12,13,12,49,24.5,37,22,2,20,18,61,4,0,"FW,MF",25-29,Forward,Ivory Coast,Africa
2699,Denis Zakaria,SUI,Gladbach,Bundesliga,2019,22.0,1996.0,21.6,49,30,23,23,3,20,39,51.3,19,39,12,27,37,86,31,1,"MF,DF",20-24,Midfielder,Switzerland,Europe
2701,Andre-Frank Zambo Anguissa,CMR,Villarreal,La Liga,2019,23.0,1995.0,28.7,76,49,29,40,7,26,78,33.3,52,42,6,36,44,120,30,0,MF,20-24,Midfielder,Cameroon,Africa
2702,Luca Zanimacchia,ITA,Juventus,Serie A,2019,21.0,1998.0,1.3,5,1,1,2,2,1,2,50.0,1,1,0,1,0,5,0,0,"FW,MF",20-24,Forward,Italy,Europe
2703,Nicolò Zaniolo,ITA,Roma,Serie A,2019,20.0,1999.0,16.7,15,11,4,7,4,3,24,12.5,21,14,0,14,5,20,5,0,"FW,MF",20-24,Forward,Italy,Europe
2704,Cristián Zapata,COL,Genoa,Serie A,2019,32.0,1986.0,19.1,23,17,16,7,0,8,16,50.0,8,29,17,12,24,47,75,0,DF,30-34,Defender,Colombia,South America
2705,Duván Zapata,COL,Atalanta,Serie A,2019,28.0,1991.0,22.5,7,3,1,2,4,1,6,16.7,5,18,7,11,2,9,11,0,FW,25-29,Forward,Colombia,South America
2706,Davide Zappacosta,ITA,Roma,Serie A,2019,27.0,1992.0,5.0,7,3,2,3,2,4,8,50.0,4,3,1,2,6,13,8,1,DF,25-29,Defender,Italy,Europe
2707,Simone Zaza,ITA,Torino,Serie A,2019,28.0,1991.0,18.2,15,10,6,4,5,3,10,30.0,7,11,0,11,9,24,13,1,FW,25-29,Forward,Italy,Europe
2708,Marvin Zeegelaar,NED,Udinese,Serie A,2019,28.0,1990.0,6.6,15,9,8,4,3,6,11,54.5,5,9,2,7,5,20,10,0,DF,25-29,Defender,Netherlands,Europe
2709,Mootaz Zemzemi,TUN,Strasbourg,Ligue 1,2019,19.0,1999.0,0.3,0,0,0,0,0,0,0,,0,0,0,0,1,1,0,0,MF,Under 20,Midfielder,Tunisia,Africa
2711,Robin Zentner,GER,Mainz 05,Bundesliga,2019,24.0,1994.0,21.5,1,1,1,0,0,1,1,100.0,0,0,0,0,0,1,11,0,GK,20-24,Goalkeeper,Germany,Europe
2713,Jean Zimmer,GER,Düsseldorf,Bundesliga,2019,25.0,1993.0,8.0,11,6,5,5,1,5,10,50.0,5,3,1,2,3,14,0,0,"DF,FW",25-29,Defender,Germany,Europe
2714,Christoph Zimmermann,GER,Norwich City,Premier League,2019,26.0,1993.0,15.9,32,21,26,6,0,21,30,70.0,9,22,18,4,19,51,87,2,DF,25-29,Defender,Germany,Europe
2715,Matthias Zimmermann,GER,Düsseldorf,Bundesliga,2019,27.0,1992.0,32.5,62,47,26,27,9,31,64,48.4,33,41,15,26,43,105,59,0,"DF,MF",25-29,Defender,Germany,Europe
2716,Oleksandr Zinchenko,UKR,Manchester City,Premier League,2019,22.0,1996.0,14.2,31,19,16,11,4,17,32,53.1,15,9,0,9,17,48,21,1,DF,20-24,Defender,Ukraine,Europe
2717,Leopold Zingerle,GER,Paderborn 07,Bundesliga,2019,25.0,1994.0,28.0,3,1,3,0,0,2,4,50.0,2,0,0,0,0,3,7,2,GK,25-29,Goalkeeper,Germany,Europe
2718,Joshua Zirkzee,NED,Bayern Munich,Bundesliga,2019,18.0,2001.0,3.3,5,2,0,2,3,2,4,50.0,2,2,0,2,1,6,0,0,FW,Under 20,Forward,Netherlands,Europe
2719,Richairo Živković,CUW,Sheffield Utd,Premier League,2019,22.0,1996.0,1.2,2,2,0,2,0,1,2,50.0,1,1,0,1,0,2,0,0,FW,20-24,Forward,Curaçao,Europe
2721,Kévin Zohi,MLI,Strasbourg,Ligue 1,2019,22.0,1996.0,5.9,8,6,3,3,2,3,6,50.0,3,1,0,1,4,12,2,0,"FW,MF",20-24,Forward,Mali,Africa
2722,Ben Zolinski,GER,Paderborn 07,Bundesliga,2019,27.0,1992.0,13.4,17,9,7,9,1,7,27,25.9,20,12,0,12,8,25,4,0,"FW,MF",25-29,Forward,Germany,Europe
2723,Kurt Zouma,FRA,Chelsea,Premier League,2019,24.0,1994.0,26.0,23,14,17,6,0,9,16,56.3,7,22,14,8,58,81,116,2,DF,20-24,Defender,France,Europe
2725,Steven Zuber,SUI,Hoffenheim,Bundesliga,2019,27.0,1991.0,8.3,11,10,7,2,2,9,19,47.4,10,4,1,3,9,20,12,0,"DF,FW",25-29,Defender,Switzerland,Europe
2727,Ervin Zukanović,BIH,SPAL,Serie A,2019,32.0,1987.0,2.3,1,0,0,0,1,1,1,100.0,0,3,1,2,3,4,15,0,DF,30-34,Defender,Bosnia and Herzegovina,Europe
2728,Bongani Zungu,RSA,Amiens,Ligue 1,2019,26.0,1992.0,11.0,27,11,10,13,4,18,31,58.1,13,8,2,6,16,43,21,0,MF,25-29,Midfielder,South Africa,Africa
2053,Antonio Raillo,ESP,Mallorca,La Liga,2019,27.0,1991.0,30.8,31,21,24,7,0,13,19,68.4,6,31,26,5,22,53,112,1,DF,25-29,Defender,Spain,Europe
2054,Predrag Rajković,SRB,Reims,Ligue 1,2019,23.0,1995.0,27.0,1,1,1,0,0,1,1,100.0,0,0,0,0,1,2,9,0,GK,20-24,Goalkeeper,Serbia,Europe
2058,Sandro Ramírez,ESP,Valladolid,La Liga,2019,24.0,1995.0,14.5,12,10,2,6,4,2,20,10.0,18,11,1,10,7,19,2,0,"FW,MF",20-24,Forward,Spain,Europe
2059,Iván Ramis,ESP,Eibar,La Liga,2019,34.0,1984.0,5.1,3,2,2,1,0,1,4,25.0,3,2,0,2,4,7,23,2,DF,30-34,Defender,Spain,Europe
2061,Sergio Ramos,ESP,Real Madrid,La Liga,2019,33.0,1986.0,33.5,46,31,26,17,3,20,42,47.6,22,22,9,13,49,95,102,4,DF,30-34,Defender,Spain,Europe
2072,Raúl,ESP,Betis,La Liga,2019,18.0,2000.0,0.2,0,0,0,0,0,0,2,0.0,2,0,0,0,0,0,0,0,"FW,MF",Under 20,Forward,Spain,Europe
2075,Arkadiusz Reca,POL,SPAL,Serie A,2019,24.0,1995.0,21.4,38,23,22,10,6,13,39,33.3,26,15,2,13,32,70,48,1,DF,20-24,Defender,Poland,Europe
2076,Recio,ESP,Leganés,La Liga,2019,28.0,1991.0,17.4,30,19,13,12,5,10,40,25.0,30,14,3,11,22,52,9,0,MF,25-29,Midfielder,Spain,Europe
2082,Sergio Reguilón,ESP,Sevilla,La Liga,2019,22.0,1996.0,27.9,57,30,28,25,4,27,64,42.2,37,25,5,20,33,90,53,0,DF,20-24,Defender,Spain,Europe
2084,Manolo Reina,ESP,Mallorca,La Liga,2019,34.0,1985.0,36.0,0,0,0,0,0,0,1,0.0,1,2,0,2,5,5,9,1,GK,30-34,Goalkeeper,Spain,Europe
2085,Pepe Reina,ESP,Aston Villa,Premier League,2019,36.0,1982.0,12.0,0,0,0,0,0,0,2,0.0,2,0,0,0,0,0,9,1,GK,35-39,Goalkeeper,Spain,Europe
2086,Pepe Reina,ESP,Milan,Serie A,2019,36.0,1982.0,1.0,0,0,0,0,0,0,0,,0,0,0,0,0,0,0,1,GK,35-39,Goalkeeper,Spain,Europe
2090,Álex Remiro,ESP,Real Sociedad,La Liga,2019,24.0,1995.0,25.0,0,0,0,0,0,0,1,0.0,1,0,0,0,0,0,25,1,GK,20-24,Goalkeeper,Spain,Europe
2097,Nico Ribaudo,ESP,Espanyol,La Liga,2019,18.0,2001.0,2.0,3,1,1,0,2,2,6,33.3,4,1,0,1,1,4,0,0,"FW,MF",Under 20,Forward,Spain,Europe
2105,Diego Rico,ESP,Bournemouth,Premier League,2019,26.0,1993.0,25.9,61,39,32,24,5,29,59,49.2,30,31,7,24,84,145,91,0,DF,25-29,Defender,Spain,Europe
2106,Sergio Rico,ESP,Paris S-G,Ligue 1,2019,25.0,1993.0,2.0,0,0,0,0,0,0,0,,0,0,0,0,0,0,1,2,GK,25-29,Goalkeeper,Spain,Europe
2110,Luis Rioja,ESP,Alavés,La Liga,2019,25.0,1993.0,18.2,18,12,11,6,1,8,25,32.0,17,21,0,21,16,34,6,0,MF,25-29,Midfielder,Spain,Europe
2112,Rodrigo Riquelme,ESP,Atlético Madrid,La Liga,2019,19.0,2000.0,0.1,0,0,0,0,0,0,0,,0,0,0,0,0,0,0,0,"FW,MF",Under 20,Forward,Spain,Europe
2115,Mihailo Ristić,SRB,Montpellier,Ligue 1,2019,23.0,1995.0,9.0,18,14,7,11,0,9,20,45.0,11,7,2,5,7,25,18,0,"DF,MF",20-24,Defender,Serbia,Europe
2118,Cristian Rivera,ESP,Leganés,La Liga,2019,22.0,1997.0,3.5,6,4,3,2,1,2,4,50.0,2,4,3,1,4,10,7,0,MF,20-24,Midfielder,Spain,Europe
2120,Rober,ESP,Levante,La Liga,2019,24.0,1995.0,2.1,3,1,2,0,1,2,2,100.0,0,0,0,0,3,6,2,0,DF,20-24,Defender,Spain,Europe
2121,Roberto,ESP,West Ham,Premier League,2019,33.0,1986.0,7.6,0,0,0,0,0,0,0,,0,0,0,0,0,0,2,2,GK,30-34,Goalkeeper,Spain,Europe
2121,Roberto,ESP,West Ham,Premier League,2019,33.0,1986.0,7.6,0,0,0,0,0,0,0,,0,0,0,0,0,0,2,2,GK,30-34,Goalkeeper,Spain,Europe
2121,Roberto,ESP,West Ham,Premier League,2019,33.0,1986.0,7.6,0,0,0,0,0,0,0,,0,0,0,0,0,0,2,2,GK,30-34,Goalkeeper,Spain,Europe
2121,Roberto,ESP,West Ham,Premier League,2019,33.0,1986.0,7.6,0,0,0,0,0,0,0,,0,0,0,0,0,0,2,2,GK,30-34,Goalkeeper,Spain,Europe
2122,Roberto,ESP,Alavés,La Liga,2019,33.0,1986.0,8.8,1,1,1,0,0,1,1,100.0,0,0,0,0,0,1,2,0,GK,30-34,Goalkeeper,Spain,Europe
2122,Roberto,ESP,Alavés,La Liga,2019,33.0,1986.0,8.8,1,1,1,0,0,1,1,100.0,0,0,0,0,0,1,2,0,GK,30-34,Goalkeeper,Spain,Europe
2122,Roberto,ESP,Alavés,La Liga,2019,33.0,1986.0,8.8,1,1,1,0,0,1,1,100.0,0,0,0,0,0,1,2,0,GK,30-34,Goalkeeper,Spain,Europe
2122,Roberto,ESP,Alavés,La Liga,2019,33.0,1986.0,8.8,1,1,1,0,0,1,1,100.0,0,0,0,0,0,1,2,0,GK,30-34,Goalkeeper,Spain,Europe
2123,Sergi Roberto,ESP,Barcelona,La Liga,2019,27.0,1992.0,26.0,35,22,16,11,8,15,25,60.0,10,12,3,9,33,68,36,0,"DF,MF",25-29,Defender,Spain,Europe
2128,Joel Robles,ESP,Betis,La Liga,2019,29.0,1990.0,32.1,0,0,0,0,0,0,2,0.0,2,0,0,0,0,0,13,2,GK,25-29,Goalkeeper,Spain,Europe
2129,Marc Roca,ESP,Espanyol,La Liga,2019,22.0,1996.0,33.4,82,52,29,44,9,29,82,35.4,53,28,10,18,31,113,53,2,MF,20-24,Midfielder,Spain,Europe
2130,Rubén Rochina,ESP,Levante,La Liga,2019,28.0,1991.0,20.8,41,26,22,9,10,19,52,36.5,33,16,0,16,12,53,19,1,MF,25-29,Midfielder,Spain,Europe
2132,Rodri,ESP,Manchester City,Premier League,2019,23.0,1996.0,27.6,50,30,17,25,8,23,63,36.5,40,19,5,14,26,76,35,0,MF,20-24,Midfielder,Spain,Europe
2132,Rodri,ESP,Manchester City,Premier League,2019,23.0,1996.0,27.6,50,30,17,25,8,23,63,36.5,40,19,5,14,26,76,35,0,MF,20-24,Midfielder,Spain,Europe
2132,Rodri,ESP,Manchester City,Premier League,2019,23.0,1996.0,27.6,50,30,17,25,8,23,63,36.5,40,19,5,14,26,76,35,0,MF,20-24,Midfielder,Spain,Europe
2132,Rodri,ESP,Manchester City,Premier League,2019,23.0,1996.0,27.6,50,30,17,25,8,23,63,36.5,40,19,5,14,26,76,35,0,MF,20-24,Midfielder,Spain,Europe
2133,Rodrigo,ESP,Valencia,La Liga,2019,28.0,1991.0,20.9,10,6,4,5,1,2,23,8.7,21,9,1,8,9,19,13,0,FW,25-29,Forward,Spain,Europe
2136,Ángel Rodríguez,ESP,Getafe,La Liga,2019,32.0,1987.0,15.6,14,8,2,8,4,2,18,11.1,16,10,1,9,3,17,10,0,FW,30-34,Forward,Spain,Europe
2137,Óscar Rodríguez Arnaiz,ESP,Leganés,La Liga,2019,21.0,1998.0,21.3,23,10,11,7,5,13,41,31.7,28,19,0,19,14,37,13,0,"MF,FW",20-24,Midfielder,Spain,Europe
2138,Dani Rodríguez,ESP,Mallorca,La Liga,2019,31.0,1988.0,33.8,59,32,24,28,7,18,61,29.5,43,35,3,32,38,97,27,1,"MF,FW",30-34,Midfielder,Spain,Europe
2138,Dani Rodríguez,ESP,Mallorca,La Liga,2019,31.0,1988.0,33.8,59,32,24,28,7,18,61,29.5,43,35,3,32,38,97,27,1,"MF,FW",30-34,Midfielder,Spain,Europe
2138,Dani Rodríguez,ESP,Mallorca,La Liga,2019,31.0,1988.0,33.8,59,32,24,28,7,18,61,29.5,43,35,3,32,38,97,27,1,"MF,FW",30-34,Midfielder,Spain,Europe
2138,Dani Rodríguez,ESP,Mallorca,La Liga,2019,31.0,1988.0,33.8,59,32,24,28,7,18,61,29.5,43,35,3,32,38,97,27,1,"MF,FW",30-34,Midfielder,Spain,Europe
2142,Mario Rodriguez,ESP,Granada,La Liga,2019,22.0,1997.0,0.0,0,0,0,0,0,0,0,,0,0,0,0,0,0,0,0,MF,20-24,Midfielder,Spain,Europe
2152,Alaixys Romao,TOG,Reims,Ligue 1,2019,35.0,1984.0,19.8,46,29,31,14,1,17,57,29.8,40,12,3,9,26,72,38,3,MF,35-39,Midfielder,Togo,Africa
2155,Oriol Romeu,ESP,Southampton,Premier League,2019,27.0,1991.0,20.7,55,35,23,30,2,27,75,36.0,48,35,13,22,34,89,32,0,MF,25-29,Midfielder,Spain,Europe
2173,Rubén,ESP,Osasuna,La Liga,2019,35.0,1984.0,17.6,1,1,1,0,0,1,1,100.0,0,0,0,0,0,1,9,1,GK,35-39,Goalkeeper,Spain,Europe
2174,Waldo Rubio,ESP,Valladolid,La Liga,2019,23.0,1995.0,9.8,13,8,10,3,0,5,31,16.1,26,12,0,12,7,20,7,0,"MF,FW",20-24,Midfielder,Spain,Europe
2181,Aitor Ruibal,ESP,Leganés,La Liga,2019,23.0,1996.0,13.6,27,17,14,11,2,16,39,41.0,23,18,1,17,8,35,11,0,"DF,MF",20-24,Defender,Spain,Europe
2182,Fabián Ruiz Peña,ESP,Napoli,Serie A,2019,23.0,1996.0,29.8,43,26,19,18,6,24,65,36.9,41,32,4,28,32,75,18,2,MF,20-24,Midfielder,Spain,Europe
2187,Julian Ryerson,NOR,Union Berlin,Bundesliga,2019,21.0,1997.0,4.1,7,5,2,1,4,3,6,50.0,3,5,3,2,5,12,9,0,"DF,MF",20-24,Defender,Norway,Europe
2197,Jorge Sáenz,ESP,Celta Vigo,La Liga,2019,22.0,1996.0,4.1,6,1,4,2,0,3,5,60.0,2,5,2,3,10,16,15,0,DF,20-24,Defender,Spain,Europe
2202,Borja Sainz,ESP,Alavés,La Liga,2019,18.0,2001.0,6.4,16,9,4,9,3,8,26,30.8,18,14,0,14,3,19,0,0,"MF,FW",Under 20,Midfielder,Spain,Europe
2209,Bartosz Salamon,POL,SPAL,Serie A,2019,28.0,1991.0,3.8,2,1,2,0,0,1,2,50.0,1,4,4,0,6,8,14,0,DF,25-29,Defender,Poland,Europe
2216,Lazar Samardzic,SRB,Hertha BSC,Bundesliga,2019,17.0,2002.0,0.4,4,4,2,2,0,1,4,25.0,3,2,1,1,0,4,0,0,"MF,FW",Under 20,Midfielder,Serbia,Europe
2222,Fede San Emeterio,ESP,Valladolid,La Liga,2019,22.0,1997.0,19.5,26,13,18,6,2,7,29,24.1,22,20,8,12,28,54,13,1,MF,20-24,Midfielder,Spain,Europe
2223,Mikel San José,ESP,Athletic Club,La Liga,2019,30.0,1989.0,4.0,9,4,2,4,3,2,10,20.0,8,3,1,2,9,18,12,0,MF,30-34,Midfielder,Spain,Europe
2225,Oihan Sancet,ESP,Athletic Club,La Liga,2019,19.0,2000.0,8.2,11,7,5,4,2,4,11,36.4,7,6,0,6,2,13,2,0,"MF,FW",Under 20,Midfielder,Spain,Europe
2231,Germán Sánchez,ESP,Granada,La Liga,2019,32.0,1986.0,25.5,16,10,12,4,0,6,16,37.5,10,29,23,6,33,49,115,2,DF,30-34,Defender,Spain,Europe
2232,Javi Sánchez,ESP,Valladolid,La Liga,2019,22.0,1997.0,5.5,5,4,3,2,0,1,3,33.3,2,4,2,2,4,9,24,0,DF,20-24,Defender,Spain,Europe
2233,Manu Sánchez,ESP,Atlético Madrid,La Liga,2019,18.0,2000.0,3.6,13,7,2,7,4,8,15,53.3,7,3,0,3,7,20,1,0,DF,Under 20,Defender,Spain,Europe
2234,Víctor Sánchez,ESP,Espanyol,La Liga,2019,31.0,1987.0,18.8,66,36,36,23,7,30,71,42.3,41,31,8,23,27,93,23,1,MF,30-34,Midfielder,Spain,Europe
2239,Luca Sangalli,ESP,Real Sociedad,La Liga,2019,24.0,1995.0,4.1,1,0,0,1,0,1,8,12.5,7,3,0,3,1,2,0,0,MF,20-24,Midfielder,Spain,Europe
2241,Oier Sanjurjo,ESP,Osasuna,La Liga,2019,33.0,1986.0,25.8,65,34,21,34,10,28,64,43.8,36,33,8,25,35,100,39,1,MF,30-34,Midfielder,Spain,Europe
2251,Ivan Šaponjić,SRB,Atlético Madrid,La Liga,2019,21.0,1997.0,0.1,0,0,0,0,0,0,0,,0,0,0,0,0,0,0,0,"DF,FW",20-24,Defender,Serbia,Europe
2252,Pablo Sarabia,ESP,Paris S-G,Ligue 1,2019,27.0,1992.0,12.9,12,7,3,6,3,4,25,16.0,21,19,1,18,10,22,5,0,"FW,MF",25-29,Forward,Spain,Europe
2259,Joan Sastre Vanrell,ESP,Mallorca,La Liga,2019,22.0,1997.0,15.1,30,17,26,3,1,17,39,43.6,22,8,2,6,23,53,27,1,DF,20-24,Defender,Spain,Europe
2265,Patrik Schick,CZE,RB Leipzig,Bundesliga,2019,23.0,1996.0,14.4,7,3,1,3,3,2,9,22.2,7,8,2,6,2,9,17,0,FW,20-24,Forward,Czech Republic,Europe
2286,Aleksandar Sedlar,SRB,Mallorca,La Liga,2019,27.0,1991.0,9.0,13,6,10,2,1,7,11,63.6,4,17,11,6,16,29,31,0,DF,25-29,Defender,Serbia,Europe
2293,Josep Señé,ESP,Mallorca,La Liga,2019,27.0,1991.0,1.7,2,1,2,0,0,2,5,40.0,3,2,1,1,0,2,2,0,MF,25-29,Midfielder,Spain,Europe
2298,Salva Sevilla,ESP,Mallorca,La Liga,2019,35.0,1984.0,28.5,27,21,11,16,0,9,30,30.0,21,17,5,12,29,56,17,1,MF,35-39,Midfielder,Spain,Europe
2316,David Silva,ESP,Manchester City,Premier League,2019,33.0,1986.0,20.3,26,14,3,15,8,10,28,35.7,18,18,3,15,13,39,5,0,MF,30-34,Midfielder,Spain,Europe
2316,David Silva,ESP,Manchester City,Premier League,2019,33.0,1986.0,20.3,26,14,3,15,8,10,28,35.7,18,18,3,15,13,39,5,0,MF,30-34,Midfielder,Spain,Europe
2316,David Silva,ESP,Manchester City,Premier League,2019,33.0,1986.0,20.3,26,14,3,15,8,10,28,35.7,18,18,3,15,13,39,5,0,MF,30-34,Midfielder,Spain,Europe
2316,David Silva,ESP,Manchester City,Premier League,2019,33.0,1986.0,20.3,26,14,3,15,8,10,28,35.7,18,18,3,15,13,39,5,0,MF,30-34,Midfielder,Spain,Europe
2326,Unai Simón,ESP,Athletic Club,La Liga,2019,22.0,1997.0,33.2,0,0,0,0,0,0,1,0.0,1,1,0,1,1,1,10,1,GK,20-24,Goalkeeper,Spain,Europe
2337,Antonio Sivera,ESP,Alavés,La Liga,2019,22.0,1996.0,3.0,0,0,0,0,0,0,0,,0,0,0,0,0,0,2,0,GK,20-24,Goalkeeper,Spain,Europe
2340,Łukasz Skorupski,POL,Bologna,Serie A,2019,28.0,1991.0,37.0,1,0,1,0,0,0,1,0.0,1,0,0,0,2,3,15,5,GK,25-29,Goalkeeper,Poland,Europe
2346,Petar Škuletić,SRB,Montpellier,Ligue 1,2019,29.0,1990.0,1.2,6,4,2,2,2,2,4,50.0,2,0,0,0,0,6,1,0,"FW,MF",25-29,Forward,Serbia,Europe
2360,Rubén Sobrino,ESP,Valencia,La Liga,2019,27.0,1992.0,1.9,7,5,3,2,2,2,3,66.7,1,1,0,1,0,7,1,0,"FW,MF",25-29,Forward,Spain,Europe
2362,Roberto Soldado,ESP,Granada,La Liga,2019,34.0,1985.0,26.1,16,9,2,7,7,7,24,29.2,17,16,4,12,4,20,16,0,FW,30-34,Forward,Spain,Europe
2363,Carlos Soler,ESP,Valencia,La Liga,2019,22.0,1997.0,23.0,21,10,10,10,1,9,39,23.1,30,16,6,10,9,30,14,0,MF,20-24,Midfielder,Spain,Europe
2367,David Soria,ESP,Getafe,La Liga,2019,26.0,1993.0,38.0,2,1,2,0,0,2,4,50.0,2,0,0,0,3,5,17,5,GK,25-29,Goalkeeper,Spain,Europe
2368,Bruno Soriano,ESP,Villarreal,La Liga,2019,35.0,1984.0,2.9,4,0,1,2,1,1,1,100.0,0,4,0,4,1,5,7,0,"MF,FW",35-39,Midfielder,Spain,Europe
2369,Juan Soriano,ESP,Leganés,La Liga,2019,21.0,1997.0,11.0,0,0,0,0,0,0,0,,0,0,0,0,0,0,1,1,GK,20-24,Goalkeeper,Spain,Europe
2372,Tomáš Souček,CZE,West Ham,Premier League,2019,24.0,1995.0,11.6,29,15,13,15,1,10,23,43.5,13,7,1,6,22,51,35,0,MF,20-24,Midfielder,Czech Republic,Europe
2398,Mariusz Stępiński,POL,Hellas Verona,Serie A,2019,24.0,1995.0,7.8,5,3,2,1,2,1,2,50.0,1,3,1,2,1,6,7,0,"FW,MF",20-24,Forward,Poland,Europe
2414,Denis Suárez,ESP,Celta Vigo,La Liga,2019,25.0,1994.0,18.1,22,15,14,7,1,10,37,27.0,27,9,1,8,14,36,12,1,"MF,FW",25-29,Midfielder,Spain,Europe
2417,Neven Subotić,SRB,Union Berlin,Bundesliga,2019,30.0,1988.0,21.8,30,18,12,16,2,8,32,25.0,24,21,8,13,34,64,89,0,DF,30-34,Defender,Serbia,Europe
2419,Marek Suchý,CZE,Augsburg,Bundesliga,2019,31.0,1988.0,4.4,7,5,7,0,0,4,6,66.7,2,4,1,3,6,13,15,0,DF,30-34,Defender,Czech Republic,Europe
2426,Suso,ESP,Milan,Serie A,2019,25.0,1993.0,15.1,7,3,2,3,2,2,10,20.0,8,5,0,5,8,15,3,0,"FW,MF",25-29,Forward,Spain,Europe
2427,Suso,ESP,Sevilla,La Liga,2019,25.0,1993.0,8.7,9,4,4,4,1,7,16,43.8,9,6,0,6,2,11,0,0,"FW,MF",25-29,Forward,Spain,Europe
2435,Wojciech Szczęsny,POL,Juventus,Serie A,2019,29.0,1990.0,28.8,0,0,0,0,0,0,0,,0,0,0,0,1,1,10,1,GK,25-29,Goalkeeper,Poland,Europe
2437,Tachi,ESP,Alavés,La Liga,2019,21.0,1997.0,2.6,2,1,2,0,0,1,4,25.0,3,5,4,1,4,6,12,0,DF,20-24,Defender,Spain,Europe
2448,Rodrigo Tarín,ESP,Leganés,La Liga,2019,23.0,1996.0,10.6,10,7,8,2,0,9,14,64.3,5,7,3,4,9,19,51,0,DF,20-24,Defender,Spain,Europe
2457,Álvaro Tejero,ESP,Eibar,La Liga,2019,23.0,1996.0,16.1,30,18,17,10,3,14,23,60.9,9,17,4,13,28,58,38,0,DF,20-24,Defender,Spain,Europe
2460,Cristian Tello,ESP,Betis,La Liga,2019,27.0,1991.0,8.7,8,5,2,2,4,4,8,50.0,4,5,0,5,4,12,0,0,"MF,FW",25-29,Midfielder,Spain,Europe
2462,Łukasz Teodorczyk,POL,Udinese,Serie A,2019,28.0,1991.0,2.5,7,5,1,5,1,3,7,42.9,4,2,0,2,0,7,1,0,FW,25-29,Forward,Poland,Europe
2468,Aleksa Terzić,SRB,Fiorentina,Serie A,2019,19.0,1999.0,0.1,0,0,0,0,0,0,0,,0,0,0,0,0,0,0,0,MF,Under 20,Midfielder,Serbia,Europe
2470,Alexander Tettey,NOR,Norwich City,Premier League,2019,33.0,1986.0,26.0,23,18,7,16,0,11,39,28.2,28,20,9,11,43,66,72,1,"MF,DF",30-34,Midfielder,Norway,Europe
2483,Morten Thorsby,NOR,Sampdoria,Serie A,2019,23.0,1996.0,20.7,53,34,17,23,13,27,52,51.9,25,24,6,18,17,70,34,0,"MF,DF",20-24,Midfielder,Norway,Europe
2489,David Timor,ESP,Getafe,La Liga,2019,29.0,1989.0,10.5,9,6,4,5,0,5,16,31.3,11,8,3,5,18,27,23,0,"MF,DF",25-29,Midfielder,Spain,Europe
2498,Raúl de Tomás,ESP,Espanyol,La Liga,2019,24.0,1994.0,11.9,9,7,3,4,2,4,13,30.8,9,8,1,7,10,19,4,0,FW,20-24,Forward,Spain,Europe
2502,Nenad Tomović,SRB,SPAL,Serie A,2019,31.0,1987.0,19.5,26,19,18,6,2,10,21,47.6,11,32,23,9,30,56,65,1,DF,30-34,Defender,Serbia,Europe
2505,Toño,ESP,Levante,La Liga,2019,29.0,1989.0,17.7,26,19,18,7,1,15,28,53.6,13,11,3,8,13,39,34,1,DF,25-29,Defender,Spain,Europe
2505,Toño,ESP,Levante,La Liga,2019,29.0,1989.0,17.7,26,19,18,7,1,15,28,53.6,13,11,3,8,13,39,34,1,DF,25-29,Defender,Spain,Europe
2505,Toño,ESP,Levante,La Liga,2019,29.0,1989.0,17.7,26,19,18,7,1,15,28,53.6,13,11,3,8,13,39,34,1,DF,25-29,Defender,Spain,Europe
2505,Toño,ESP,Levante,La Liga,2019,29.0,1989.0,17.7,26,19,18,7,1,15,28,53.6,13,11,3,8,13,39,34,1,DF,25-29,Defender,Spain,Europe
2509,Ferrán Torres,ESP,Valencia,La Liga,2019,19.0,2000.0,25.0,23,15,6,16,1,8,30,26.7,22,20,3,17,14,37,12,0,"MF,FW",Under 20,Midfielder,Spain,Europe
2510,Óliver Torres,ESP,Sevilla,La Liga,2019,24.0,1994.0,17.7,45,27,12,26,7,23,60,38.3,37,23,1,22,13,58,9,1,"MF,FW",20-24,Midfielder,Spain,Europe
2511,Pau Torres,ESP,Villarreal,La Liga,2019,22.0,1997.0,33.0,34,21,24,10,0,16,24,66.7,8,39,23,16,27,61,153,1,DF,20-24,Defender,Spain,Europe
2512,Roberto Torres,ESP,Osasuna,La Liga,2019,30.0,1989.0,30.2,33,16,12,18,3,21,49,42.9,28,41,2,39,31,64,37,0,"MF,FW",30-34,Midfielder,Spain,Europe
2513,Lucas Torró,ESP,Eint Frankfurt,Bundesliga,2019,25.0,1994.0,3.7,12,7,6,6,0,8,16,50.0,8,2,1,1,8,20,3,0,MF,25-29,Midfielder,Spain,Europe
2522,Adama Traoré,ESP,Wolves,Premier League,2019,23.0,1996.0,28.9,33,21,6,14,13,8,23,34.8,15,19,3,16,13,46,14,2,"FW,DF",20-24,Forward,Spain,Europe
2522,Adama Traoré,ESP,Wolves,Premier League,2019,23.0,1996.0,28.9,33,21,6,14,13,8,23,34.8,15,19,3,16,13,46,14,2,"FW,DF",20-24,Forward,Spain,Europe
2522,Adama Traoré,ESP,Wolves,Premier League,2019,23.0,1996.0,28.9,33,21,6,14,13,8,23,34.8,15,19,3,16,13,46,14,2,"FW,DF",20-24,Forward,Spain,Europe
2522,Adama Traoré,ESP,Wolves,Premier League,2019,23.0,1996.0,28.9,33,21,6,14,13,8,23,34.8,15,19,3,16,13,46,14,2,"FW,DF",20-24,Forward,Spain,Europe
2522,Adama Traoré,ESP,Wolves,Premier League,2019,23.0,1996.0,28.9,33,21,6,14,13,8,23,34.8,15,19,3,16,13,46,14,2,"FW,DF",20-24,Forward,Spain,Europe
2522,Adama Traoré,ESP,Wolves,Premier League,2019,23.0,1996.0,28.9,33,21,6,14,13,8,23,34.8,15,19,3,16,13,46,14,2,"FW,DF",20-24,Forward,Spain,Europe
2522,Adama Traoré,ESP,Wolves,Premier League,2019,23.0,1996.0,28.9,33,21,6,14,13,8,23,34.8,15,19,3,16,13,46,14,2,"FW,DF",20-24,Forward,Spain,Europe
2522,Adama Traoré,ESP,Wolves,Premier League,2019,23.0,1996.0,28.9,33,21,6,14,13,8,23,34.8,15,19,3,16,13,46,14,2,"FW,DF",20-24,Forward,Spain,Europe
2522,Adama Traoré,ESP,Wolves,Premier League,2019,23.0,1996.0,28.9,33,21,6,14,13,8,23,34.8,15,19,3,16,13,46,14,2,"FW,DF",20-24,Forward,Spain,Europe
2522,Adama Traoré,ESP,Wolves,Premier League,2019,23.0,1996.0,28.9,33,21,6,14,13,8,23,34.8,15,19,3,16,13,46,14,2,"FW,DF",20-24,Forward,Spain,Europe
2522,Adama Traoré,ESP,Wolves,Premier League,2019,23.0,1996.0,28.9,33,21,6,14,13,8,23,34.8,15,19,3,16,13,46,14,2,"FW,DF",20-24,Forward,Spain,Europe
2522,Adama Traoré,ESP,Wolves,Premier League,2019,23.0,1996.0,28.9,33,21,6,14,13,8,23,34.8,15,19,3,16,13,46,14,2,"FW,DF",20-24,Forward,Spain,Europe
2522,Adama Traoré,ESP,Wolves,Premier League,2019,23.0,1996.0,28.9,33,21,6,14,13,8,23,34.8,15,19,3,16,13,46,14,2,"FW,DF",20-24,Forward,Spain,Europe
2522,Adama Traoré,ESP,Wolves,Premier League,2019,23.0,1996.0,28.9,33,21,6,14,13,8,23,34.8,15,19,3,16,13,46,14,2,"FW,DF",20-24,Forward,Spain,Europe
2522,Adama Traoré,ESP,Wolves,Premier League,2019,23.0,1996.0,28.9,33,21,6,14,13,8,23,34.8,15,19,3,16,13,46,14,2,"FW,DF",20-24,Forward,Spain,Europe
2522,Adama Traoré,ESP,Wolves,Premier League,2019,23.0,1996.0,28.9,33,21,6,14,13,8,23,34.8,15,19,3,16,13,46,14,2,"FW,DF",20-24,Forward,Spain,Europe
2535,Manu Trigueros,ESP,Villarreal,La Liga,2019,27.0,1991.0,17.2,34,21,10,17,7,12,45,26.7,33,23,12,11,4,38,21,0,MF,25-29,Midfielder,Spain,Europe
2557,Tomáš Vaclík,CZE,Sevilla,La Liga,2019,30.0,1989.0,32.5,0,0,0,0,0,0,1,0.0,1,0,0,0,0,0,7,0,GK,30-34,Goalkeeper,Czech Republic,Europe
2558,Álvaro Vadillo,ESP,Granada,La Liga,2019,24.0,1994.0,13.5,16,11,6,8,2,9,16,56.3,7,12,0,12,7,23,2,0,"FW,MF",20-24,Forward,Spain,Europe
2562,Germán Valera,ESP,Atlético Madrid,La Liga,2019,17.0,2002.0,0.0,0,0,0,0,0,0,0,,0,1,0,1,0,0,0,0,FW,Under 20,Forward,Spain,Europe
2564,Borja Valero,ESP,Inter,Serie A,2019,34.0,1985.0,10.3,18,7,9,3,6,6,24,25.0,18,12,3,9,8,26,9,0,MF,30-34,Midfielder,Spain,Europe
2567,Jesús Vallejo,ESP,Wolves,Premier League,2019,22.0,1997.0,1.8,1,1,1,0,0,1,2,50.0,1,4,3,1,2,3,8,1,DF,20-24,Defender,Spain,Europe
2568,Jesús Vallejo,ESP,Granada,La Liga,2019,22.0,1997.0,7.0,6,5,4,2,0,3,4,75.0,1,7,4,3,5,11,28,0,DF,20-24,Defender,Spain,Europe
2569,Manu Vallejo,ESP,Valencia,La Liga,2019,22.0,1997.0,4.6,7,3,0,3,4,5,9,55.6,4,4,0,4,2,9,2,0,"MF,FW",20-24,Midfielder,Spain,Europe
2584,Kevin Vázquez,ESP,Celta Vigo,La Liga,2019,26.0,1993.0,14.7,26,15,16,6,4,15,28,53.6,13,18,1,17,26,52,28,0,DF,25-29,Defender,Spain,Europe
2585,Lucas Vázquez,ESP,Real Madrid,La Liga,2019,28.0,1991.0,9.4,23,17,10,13,0,11,26,42.3,15,10,0,10,10,33,8,1,"MF,FW",25-29,Midfielder,Spain,Europe
2587,Koke Vegas,ESP,Levante,La Liga,2019,23.0,1995.0,2.0,0,0,0,0,0,0,1,0.0,1,0,0,0,0,0,3,0,GK,20-24,Goalkeeper,Spain,Europe
2588,Miloš Veljković,SRB,Werder Bremen,Bundesliga,2019,23.0,1995.0,22.8,55,33,36,18,1,33,53,62.3,20,25,11,14,26,81,92,1,DF,20-24,Defender,Serbia,Europe
2590,Unai Vencedor Paris,ESP,Athletic Club,La Liga,2019,18.0,2000.0,0.8,0,0,0,0,0,0,0,,0,0,0,0,0,0,0,0,MF,Under 20,Midfielder,Spain,Europe
2599,Mikel Vesga,ESP,Athletic Club,La Liga,2019,26.0,1993.0,14.1,25,17,7,12,6,9,45,20.0,36,18,7,11,31,56,24,1,MF,25-29,Midfielder,Spain,Europe
2603,Fede Vico,ESP,Granada,La Liga,2019,25.0,1994.0,9.7,5,1,2,3,0,2,11,18.2,9,12,1,11,5,10,2,0,"MF,FW",25-29,Midfielder,Spain,Europe
2604,Aleix Vidal,ESP,Alavés,La Liga,2019,29.0,1989.0,24.1,21,14,8,11,2,8,37,21.6,29,14,1,13,23,44,18,0,MF,25-29,Midfielder,Spain,Europe
2607,Nacho Vidal,ESP,Osasuna,La Liga,2019,24.0,1995.0,25.9,45,29,26,13,6,21,38,55.3,17,24,6,18,44,89,70,1,DF,20-24,Defender,Spain,Europe
2610,Dídac Vilà,ESP,Espanyol,La Liga,2019,30.0,1989.0,27.7,73,42,44,23,6,25,61,41.0,36,31,5,26,40,113,63,0,DF,30-34,Defender,Spain,Europe
2611,Toni Villa,ESP,Valladolid,La Liga,2019,24.0,1995.0,15.0,31,16,13,14,4,13,50,26.0,37,16,1,15,8,39,11,0,MF,20-24,Midfielder,Spain,Europe
2612,Asier Villalibre,ESP,Athletic Club,La Liga,2019,21.0,1997.0,5.9,0,0,0,0,0,0,3,0.0,3,3,0,3,1,1,4,0,FW,20-24,Forward,Spain,Europe
2613,Gonzalo Villar,ESP,Roma,Serie A,2019,21.0,1998.0,3.3,5,3,4,0,1,2,4,50.0,2,2,0,2,2,7,3,0,MF,20-24,Midfielder,Spain,Europe
2614,Iván Villar,ESP,Celta Vigo,La Liga,2019,22.0,1997.0,3.1,0,0,0,0,0,0,0,,0,0,0,0,0,0,5,0,GK,20-24,Goalkeeper,Spain,Europe
2615,Juan Villar,ESP,Osasuna,La Liga,2019,31.0,1988.0,2.7,1,0,0,1,0,0,2,0.0,2,4,1,3,1,2,0,0,FW,30-34,Forward,Spain,Europe
2618,Vitolo,ESP,Atlético Madrid,La Liga,2019,29.0,1989.0,13.6,15,12,7,7,1,5,17,29.4,12,9,0,9,10,25,9,0,"FW,MF",25-29,Forward,Spain,Europe
2618,Vitolo,ESP,Atlético Madrid,La Liga,2019,29.0,1989.0,13.6,15,12,7,7,1,5,17,29.4,12,9,0,9,10,25,9,0,"FW,MF",25-29,Forward,Spain,Europe
2618,Vitolo,ESP,Atlético Madrid,La Liga,2019,29.0,1989.0,13.6,15,12,7,7,1,5,17,29.4,12,9,0,9,10,25,9,0,"FW,MF",25-29,Forward,Spain,Europe
2618,Vitolo,ESP,Atlético Madrid,La Liga,2019,29.0,1989.0,13.6,15,12,7,7,1,5,17,29.4,12,9,0,9,10,25,9,0,"FW,MF",25-29,Forward,Spain,Europe
2620,Dušan Vlahović,SRB,Fiorentina,Serie A,2019,19.0,2000.0,16.7,6,2,1,4,1,4,13,30.8,9,5,2,3,7,13,6,0,FW,Under 20,Forward,Serbia,Europe
2630,Matěj Vydra,CZE,Burnley,Premier League,2019,27.0,1992.0,9.1,4,3,0,3,1,3,6,50.0,3,7,3,4,1,5,6,0,FW,25-29,Forward,Czech Republic,Europe
2642,Sebastian Walukiewicz,POL,Cagliari,Serie A,2019,19.0,2000.0,12.9,25,11,17,8,0,14,22,63.6,8,21,14,7,14,39,41,0,DF,Under 20,Defender,Poland,Europe
2685,Yoel,ESP,Eibar,La Liga,2019,30.0,1988.0,3.0,0,0,0,0,0,0,0,,0,0,0,0,1,1,1,0,GK,30-34,Goalkeeper,Spain,Europe
2693,Zaydou Youssouf,COM,Saint-Étienne,Ligue 1,2019,20.0,1999.0,12.0,40,22,12,26,2,15,35,42.9,20,7,1,6,16,56,13,0,MF,20-24,Midfielder,Comoros,Africa
2700,Joseba Zaldúa,ESP,Real Sociedad,La Liga,2019,27.0,1992.0,28.3,62,43,39,18,5,31,59,52.5,28,31,7,24,37,99,71,0,DF,25-29,Defender,Spain,Europe
2712,Piotr Zieliński,POL,Napoli,Serie A,2019,25.0,1994.0,32.5,26,16,10,11,5,12,30,40.0,18,28,5,23,21,47,15,0,MF,25-29,Midfielder,Poland,Europe
2720,Jaromír Zmrhal,CZE,Brescia,Serie A,2019,25.0,1993.0,12.5,10,4,2,5,3,5,18,27.8,13,8,1,7,4,14,11,0,MF,25-29,Midfielder,Czech Republic,Europe
2724,Igor Zubeldia,ESP,Real Sociedad,La Liga,2019,22.0,1997.0,29.3,42,21,18,19,5,17,35,48.6,18,38,21,17,26,68,82,2,"MF,DF",20-24,Midfielder,Spain,Europe
2726,Martín Zubimendi,ESP,Real Sociedad,La Liga,2019,20.0,1999.0,5.8,16,12,9,7,0,6,12,50.0,6,7,0,7,9,25,2,0,MF,20-24,Midfielder,Spain,Europe
2729,Szymon Żurkowski,POL,Fiorentina,Serie A,2019,21.0,1997.0,0.1,1,0,0,0,1,0,2,0.0,2,0,0,0,0,1,1,0,MF,20-24,Midfielder,Poland,Europe
2730,David Zurutuza,ESP,Real Sociedad,La Liga,2019,33.0,1986.0,1.7,4,3,0,3,1,1,2,50.0,1,1,0,1,4,8,3,0,MF,30-34,Midfielder,Spain,Europe
2731,Martin Ødegaard,NOR,Real Sociedad,La Liga,2019,20.0,1998.0,28.1,27,19,5,14,8,7,34,20.6,27,13,0,13,17,44,5,0,MF,20-24,Midfielder,Norway,Europe
2732,Filip Đuričić,SRB,Sassuolo,Serie A,2019,27.0,1992.0,18.1,23,14,2,10,11,3,19,15.8,16,20,3,17,8,31,14,0,"MF,FW",25-29,Midfielder,Serbia,Europe
1,Brenden Aaronson,USA,Leeds United,Premier League,2022,21.0,2000.0,26.4,45,18,16,22,7,15,46,32.6,31,43,3,40,5,50,6,1,"MF,FW",20-24,Midfielder,United States,North America
2,Paxten Aaronson,USA,Eint Frankfurt,Bundesliga,2022,18.0,2003.0,1.9,6,5,2,2,2,2,3,66.7,1,2,1,1,0,6,2,0,"MF,DF",Under 20,Midfielder,United States,North America
3,James Abankwah,IRL,Udinese,Serie A,2022,18.0,2004.0,0.7,1,1,0,1,0,0,0,,0,4,2,2,0,1,5,0,DF,Under 20,Defender,Republic of Ireland,Europe
4,George Abbott,ENG,Tottenham,Premier League,2022,16.0,2005.0,0.0,0,0,0,0,0,0,0,,0,0,0,0,1,1,0,0,MF,Under 20,Midfielder,England,Europe
5,Yunis Abdelhamid,MAR,Reims,Ligue 1,2022,34.0,1987.0,37.0,82,50,47,33,2,39,52,75.0,13,65,27,38,64,146,116,1,DF,30-34,Defender,Morocco,Africa
6,Himad Abdelli,ALG,Angers,Ligue 1,2022,22.0,1999.0,23.7,64,38,22,32,10,31,67,46.3,36,30,1,29,28,92,15,0,"MF,FW",20-24,Midfielder,Algeria,Africa
7,Salis Abdul Samed,GHA,Lens,Ligue 1,2022,22.0,2000.0,32.2,46,26,18,23,5,29,52,55.8,23,38,9,29,36,82,26,0,MF,20-24,Midfielder,Ghana,Africa
8,Laurent Abergel,FRA,Lorient,Ligue 1,2022,29.0,1993.0,26.0,92,52,59,30,3,39,92,42.4,53,47,8,39,34,126,39,0,MF,25-29,Midfielder,France,Europe
9,Oliver Abildgaard,DEN,Hellas Verona,Serie A,2022,26.0,1996.0,6.6,10,6,6,3,1,7,16,43.8,9,7,1,6,5,15,17,0,MF,25-29,Midfielder,Denmark,Europe
10,Matthis Abline,FRA,Auxerre,Ligue 1,2022,19.0,2003.0,9.0,4,2,0,3,1,0,5,0.0,5,6,1,5,1,5,1,0,"FW,MF",Under 20,Forward,France,Europe
11,Matthis Abline,FRA,Rennes,Ligue 1,2022,19.0,2003.0,1.2,1,1,0,0,1,1,1,100.0,0,1,0,1,2,3,1,0,"FW,MF",Under 20,Forward,France,Europe
12,Abner,BRA,Betis,La Liga,2022,22.0,2000.0,6.7,12,9,9,2,1,7,16,43.8,9,8,2,6,8,20,24,0,DF,20-24,Defender,Brazil,South America
13,Zakaria Aboukhlal,MAR,Toulouse,Ligue 1,2022,22.0,2000.0,27.5,33,23,13,9,11,14,45,31.1,31,18,1,17,22,55,23,0,"FW,MF",20-24,Forward,Morocco,Africa
14,Tammy Abraham,ENG,Roma,Serie A,2022,24.0,1997.0,24.3,17,10,4,8,5,3,16,18.8,13,10,4,6,3,20,14,0,FW,20-24,Forward,England,Europe
15,Christian Acella,ITA,Cremonese,Serie A,2022,20.0,2002.0,0.2,1,0,1,0,0,0,2,0.0,2,0,0,0,0,1,0,0,MF,20-24,Midfielder,Italy,Europe
16,Francesco Acerbi,ITA,Inter,Serie A,2022,34.0,1988.0,26.9,33,19,22,7,4,20,27,74.1,7,25,18,7,41,74,85,2,DF,30-34,Defender,Italy,Europe
18,Mohamed Achi,FRA,Nantes,Ligue 1,2022,20.0,2002.0,0.4,1,1,1,0,0,1,1,100.0,0,0,0,0,0,1,0,0,FW,20-24,Forward,France,Europe
19,Marcos Acuña,ARG,Sevilla,La Liga,2022,30.0,1991.0,21.2,57,36,34,17,6,30,42,71.4,12,16,5,11,23,80,36,0,DF,30-34,Defender,Argentina,South America
20,Che Adams,SCO,Southampton,Premier League,2022,26.0,1996.0,22.1,17,13,7,8,2,7,12,58.3,5,13,4,9,4,21,22,0,FW,25-29,Forward,Scotland,Europe
21,Tyler Adams,USA,Leeds United,Premier League,2022,23.0,1999.0,24.0,89,46,44,35,10,50,77,64.9,27,48,8,40,35,124,29,0,MF,20-24,Midfielder,United States,North America
22,Sargis Adamyan,ARM,Köln,Bundesliga,2022,29.0,1993.0,7.2,14,7,5,3,6,7,17,41.2,10,12,0,12,4,18,5,0,"FW,MF",25-29,Forward,Armenia,Asia
23,Tosin Adarabioyo,ENG,Fulham,Premier League,2022,24.0,1997.0,23.2,30,13,22,6,2,16,23,69.6,7,20,15,5,26,56,140,1,DF,20-24,Defender,England,Europe
24,Martin Adeline,FRA,Reims,Ligue 1,2022,18.0,2003.0,1.2,3,3,2,1,0,3,4,75.0,1,3,1,2,3,6,3,0,"MF,FW",Under 20,Midfielder,France,Europe
25,Karim Adeyemi,GER,Dortmund,Bundesliga,2022,20.0,2002.0,15.4,16,11,6,6,4,8,30,26.7,22,18,1,17,7,23,3,0,"FW,MF",20-24,Forward,Germany,Europe
26,Amine Adli,MAR,Leverkusen,Bundesliga,2022,22.0,2000.0,15.9,18,10,4,6,8,5,17,29.4,12,28,2,26,6,24,7,0,"FW,MF",20-24,Forward,Morocco,Africa
27,Yacine Adli,FRA,Milan,Serie A,2022,22.0,2000.0,1.6,6,3,2,4,0,2,2,100.0,0,2,0,2,1,7,1,0,"MF,FW",20-24,Midfielder,France,Europe
28,Michel Aebischer,SUI,Bologna,Serie A,2022,25.0,1997.0,17.1,12,6,3,6,3,2,18,11.1,16,14,2,12,7,19,9,0,"FW,MF",25-29,Forward,Switzerland,Europe
29,Felix Afena-Gyan,GHA,Cremonese,Serie A,2022,19.0,2003.0,9.1,7,3,4,1,2,2,10,20.0,8,5,1,4,1,8,6,0,"FW,MF",Under 20,Forward,Ghana,Africa
30,Emmanuel Agbadou,CIV,Reims,Ligue 1,2022,25.0,1997.0,26.5,71,49,53,16,2,42,65,64.6,23,30,14,16,32,103,107,3,DF,25-29,Defender,Ivory Coast,Africa
32,Lucien Agoume,FRA,Troyes,Ligue 1,2022,20.0,2002.0,12.2,42,25,18,15,9,17,33,51.5,16,14,5,9,27,69,24,0,MF,20-24,Midfielder,France,Europe
33,Felix Agu,GER,Werder Bremen,Bundesliga,2022,22.0,1999.0,0.5,1,0,0,1,0,0,0,,0,1,1,0,0,1,0,0,"DF,FW",20-24,Defender,Germany,Europe
35,Kevin Agudelo,COL,Spezia,Serie A,2022,23.0,1998.0,23.7,71,38,22,30,19,25,59,42.4,34,39,5,34,10,81,6,0,"MF,FW",20-24,Midfielder,Colombia,South America
36,Nayef Aguerd,MAR,West Ham,Premier League,2022,26.0,1996.0,17.7,27,18,18,8,1,13,20,65.0,7,26,24,2,18,45,79,2,DF,25-29,Defender,Morocco,Africa
37,Ruben Aguilar,FRA,Monaco,Ligue 1,2022,29.0,1993.0,13.0,19,9,7,7,5,8,22,36.4,14,13,1,12,18,37,28,1,DF,25-29,Defender,France,Europe
38,Naouirou Ahamada,FRA,Crystal Palace,Premier League,2022,20.0,2002.0,1.0,3,2,3,0,0,1,3,33.3,2,2,0,2,0,3,0,0,"MF,FW",20-24,Midfielder,France,Europe
39,Naouirou Ahamada,FRA,Stuttgart,Bundesliga,2022,20.0,2002.0,15.5,17,11,7,7,3,8,20,40.0,12,16,5,11,8,25,7,0,MF,20-24,Midfielder,France,Europe
40,Amar Ahmed,SWE,Troyes,Ligue 1,2022,18.0,2004.0,0.2,1,1,0,1,0,0,1,0.0,1,0,0,0,1,2,0,0,FW,Under 20,Forward,Sweden,Europe
41,Jean-Eudes Aholou,CIV,Strasbourg,Ligue 1,2022,28.0,1994.0,14.4,34,20,10,20,4,12,31,38.7,19,25,0,25,24,58,15,0,MF,25-29,Midfielder,Ivory Coast,Africa
42,Joseph Aidoo,GHA,Celta Vigo,La Liga,2022,26.0,1995.0,34.7,51,36,33,17,1,16,28,57.1,12,26,14,12,31,82,150,0,DF,25-29,Defender,Ghana,Africa
43,Ola Aina,NGA,Torino,Serie A,2022,25.0,1996.0,9.7,17,13,5,8,4,9,15,60.0,6,12,2,10,11,28,26,0,DF,25-29,Defender,Nigeria,Africa
44,Rayan Aït-Nouri,ALG,Wolves,Premier League,2022,21.0,2001.0,12.0,33,20,25,7,1,9,16,56.3,7,3,0,3,9,42,28,0,DF,20-24,Defender,Algeria,Africa
45,Emanuel Aiwum,AUT,Cremonese,Serie A,2022,21.0,2000.0,18.4,55,34,36,17,2,33,47,70.2,14,28,16,12,25,80,52,3,DF,20-24,Defender,Austria,Europe
47,Ludovic Ajorque,FRA,Strasbourg,Ligue 1,2022,28.0,1994.0,8.6,5,4,1,4,0,3,9,33.3,6,3,1,2,2,7,7,0,FW,25-29,Forward,France,Europe
48,Ludovic Ajorque,FRA,Mainz 05,Bundesliga,2022,28.0,1994.0,13.5,6,5,1,4,1,1,9,11.1,8,8,2,6,1,7,8,0,"FW,MF",25-29,Forward,France,Europe
49,Manuel Akanji,SUI,Manchester City,Premier League,2022,27.0,1995.0,25.4,36,25,15,18,3,23,36,63.9,13,27,9,18,16,52,33,1,DF,25-29,Defender,Switzerland,Europe
50,Nathan Aké,NED,Manchester City,Premier League,2022,27.0,1995.0,20.8,26,12,15,9,2,11,15,73.3,4,20,10,10,20,46,48,0,DF,25-29,Defender,Netherlands,Europe
52,Babatunde Akinsola,NGA,Valladolid,La Liga,2022,19.0,2003.0,0.1,1,1,0,0,1,0,0,,0,0,0,0,0,1,0,0,FW,Under 20,Forward,Nigeria,Africa
53,Maghnes Akliouche,FRA,Monaco,Ligue 1,2022,20.0,2002.0,4.5,7,4,4,3,0,2,8,25.0,6,2,0,2,3,10,2,0,"MF,FW",20-24,Midfielder,France,Europe
54,Paul Akouokou,CIV,Betis,La Liga,2022,24.0,1997.0,5.0,16,9,13,3,0,13,20,65.0,7,2,2,0,12,28,17,1,"MF,DF",20-24,Midfielder,Ivory Coast,Africa
55,Jean-Daniel Akpa-Akpro,CIV,Empoli,Serie A,2022,29.0,1992.0,15.1,53,37,25,19,9,23,42,54.8,19,35,4,31,13,66,27,0,"MF,FW",25-29,Midfielder,Ivory Coast,Africa
56,Kevin Akpoguma,NGA,Hoffenheim,Bundesliga,2022,27.0,1995.0,21.7,75,44,45,27,3,32,45,71.1,13,45,16,29,24,99,70,1,DF,25-29,Defender,Nigeria,Africa
57,David Alaba,AUT,Real Madrid,La Liga,2022,30.0,1992.0,20.4,15,11,8,4,3,9,15,60.0,6,18,9,9,14,29,37,1,DF,30-34,Defender,Austria,Europe
59,Tomás Alarcón,CHI,Cádiz,La Liga,2022,23.0,1999.0,2.5,3,2,0,2,1,1,2,50.0,1,1,0,1,2,5,2,0,MF,20-24,Midfielder,Chile,South America
60,Lucas Alario,ARG,Eint Frankfurt,Bundesliga,2022,29.0,1992.0,3.7,3,2,1,0,2,0,1,0.0,1,0,0,0,2,5,13,0,"FW,MF",25-29,Forward,Argentina,South America
64,Marc Albrighton,ENG,Leicester City,Premier League,2022,32.0,1989.0,2.6,4,1,0,2,2,1,8,12.5,7,6,2,4,1,5,5,0,"FW,MF",30-34,Forward,England,Europe
66,Carlos Alcaraz,ARG,Southampton,Premier League,2022,19.0,2002.0,11.4,10,5,2,7,1,6,22,27.3,16,14,5,9,1,11,11,0,"MF,FW",Under 20,Midfielder,Argentina,South America
68,Omar Alderete,PAR,Getafe,La Liga,2022,25.0,1996.0,22.7,35,20,21,14,0,28,40,70.0,12,23,16,7,26,61,85,0,DF,25-29,Defender,Paraguay,South America
70,Doğan Alemdar,TUR,Rennes,Ligue 1,2022,19.0,2002.0,4.5,0,0,0,0,0,0,0,,0,0,0,0,0,0,1,1,GK,Under 20,Goalkeeper,Turkey,Asia
72,Trent Alexander-Arnold,ENG,Liverpool,Premier League,2022,23.0,1998.0,32.5,57,40,32,16,9,42,80,52.5,38,25,7,18,43,100,41,2,DF,20-24,Defender,England,Europe
75,Mohamed Ali Cho,FRA,Real Sociedad,La Liga,2022,18.0,2004.0,6.5,13,10,6,5,2,4,10,40.0,6,9,0,9,2,15,2,0,"FW,MF",Under 20,Forward,France,Europe
76,Faride Alidou,GER,Eint Frankfurt,Bundesliga,2022,21.0,2001.0,2.0,8,5,3,4,1,3,9,33.3,6,3,0,3,1,9,3,0,"DF,MF",20-24,Defender,Germany,Europe
77,Alisson,BRA,Liverpool,Premier League,2022,29.0,1992.0,37.0,0,0,0,0,0,0,3,0.0,3,3,0,3,0,0,20,0,GK,25-29,Goalkeeper,Brazil,South America
77,Alisson,BRA,Liverpool,Premier League,2022,29.0,1992.0,37.0,0,0,0,0,0,0,3,0.0,3,3,0,3,0,0,20,0,GK,25-29,Goalkeeper,Brazil,South America
77,Alisson,BRA,Liverpool,Premier League,2022,29.0,1992.0,37.0,0,0,0,0,0,0,3,0.0,3,3,0,3,0,0,20,0,GK,25-29,Goalkeeper,Brazil,South America
77,Alisson,BRA,Liverpool,Premier League,2022,29.0,1992.0,37.0,0,0,0,0,0,0,3,0.0,3,3,0,3,0,0,20,0,GK,25-29,Goalkeeper,Brazil,South America
78,Jim Allevinah,GAB,Clermont Foot,Ligue 1,2022,27.0,1995.0,24.9,39,24,24,11,4,19,62,30.6,43,24,2,22,24,63,26,1,"DF,FW",25-29,Defender,Gabon,Africa
79,Dele Alli,ENG,Everton,Premier League,2022,26.0,1996.0,0.4,0,0,0,0,0,0,0,,0,0,0,0,0,0,0,0,MF,25-29,Midfielder,England,Europe
80,Domingos André Ribeiro Almeida,POR,Valencia,La Liga,2022,22.0,2000.0,28.2,66,42,23,32,11,26,57,45.6,31,26,0,26,20,86,16,1,MF,20-24,Midfielder,Portugal,Europe
81,Miguel Almirón,PAR,Newcastle Utd,Premier League,2022,28.0,1994.0,27.7,46,30,16,19,11,18,42,42.9,24,25,2,23,10,56,17,0,FW,25-29,Forward,Paraguay,South America
84,Éder Álvarez Balanta,COL,Schalke 04,Bundesliga,2022,29.0,1993.0,2.6,5,4,2,3,0,2,6,33.3,4,0,0,0,3,8,4,0,"MF,FW",25-29,Midfielder,Colombia,South America
86,Gastón Álvarez,URU,Getafe,La Liga,2022,22.0,2000.0,16.7,38,30,24,9,5,23,42,54.8,19,15,5,10,15,53,35,0,DF,20-24,Defender,Uruguay,South America
87,Julián Álvarez,ARG,Manchester City,Premier League,2022,22.0,2000.0,16.3,26,16,3,13,10,9,30,30.0,21,13,0,13,2,28,6,0,"FW,MF",20-24,Forward,Argentina,South America
88,Agustín Álvarez Martínez,URU,Sassuolo,Serie A,2022,21.0,2001.0,4.1,6,3,0,5,1,1,4,25.0,3,5,1,4,3,9,3,0,"FW,MF",20-24,Forward,Uruguay,South America
90,Ibrahim Amadou,FRA,Angers,Ligue 1,2022,29.0,1993.0,4.7,10,7,6,3,1,7,11,63.6,4,7,3,4,10,20,20,0,"DF,MF",25-29,Defender,France,Europe
91,Selim Amallah,MAR,Valladolid,La Liga,2022,25.0,1996.0,3.0,15,9,7,8,0,5,8,62.5,3,2,0,2,5,20,2,0,"MF,FW",25-29,Midfielder,Morocco,Africa
92,Daniel Amartey,GHA,Leicester City,Premier League,2022,27.0,1994.0,17.9,19,8,13,5,1,12,14,85.7,2,24,17,7,8,27,71,0,DF,25-29,Defender,Ghana,Africa
93,Amath,SEN,Mallorca,La Liga,2022,26.0,1996.0,13.6,29,19,14,8,7,14,22,63.6,8,13,1,12,5,34,5,0,"MF,FW",25-29,Midfielder,Senegal,Africa
94,Jordan Amavi,FRA,Getafe,La Liga,2022,28.0,1994.0,2.2,3,2,3,0,0,1,3,33.3,2,3,0,3,4,7,7,0,DF,25-29,Defender,France,Europe
96,Kelvin Amian,FRA,Spezia,Serie A,2022,24.0,1998.0,26.4,54,32,33,12,9,24,31,77.4,7,34,12,22,22,76,87,1,DF,20-24,Defender,France,Europe
97,Bruno Amione,ARG,Hellas Verona,Serie A,2022,20.0,2002.0,0.6,1,1,1,0,0,1,2,50.0,1,1,0,1,0,1,4,0,DF,20-24,Defender,Argentina,South America
98,Bruno Amione,ARG,Sampdoria,Serie A,2022,20.0,2002.0,23.2,50,33,36,14,0,19,43,44.2,24,26,11,15,25,75,62,1,DF,20-24,Defender,Argentina,South America
99,Nadiem Amiri,GER,Leverkusen,Bundesliga,2022,25.0,1996.0,10.9,15,6,5,8,2,9,20,45.0,11,12,1,11,6,21,10,2,"MF,FW",25-29,Midfielder,Germany,Europe
100,Samuel Amo-Ameyaw,ENG,Southampton,Premier League,2022,16.0,2006.0,0.0,0,0,0,0,0,0,1,0.0,1,0,0,0,0,0,0,0,MF,Under 20,Midfielder,England,Europe
101,Ethan Ampadu,WAL,Spezia,Serie A,2022,21.0,2000.0,29.3,66,37,33,28,5,17,41,41.5,24,48,23,25,36,102,98,0,"DF,MF",20-24,Defender,Wales,Europe
102,Sofyan Amrabat,MAR,Fiorentina,Serie A,2022,25.0,1996.0,22.2,39,24,15,17,7,16,29,55.2,13,23,5,18,21,60,18,2,MF,25-29,Midfielder,Morocco,Africa
103,Ayoub Amraoui,MAR,Nice,Ligue 1,2022,18.0,2004.0,3.3,6,5,3,3,0,2,5,40.0,3,1,0,1,4,10,4,0,"DF,FW",Under 20,Defender,Morocco,Africa
104,Joachim Andersen,DEN,Crystal Palace,Premier League,2022,26.0,1996.0,30.9,42,22,30,12,0,16,32,50.0,16,28,13,15,24,66,188,1,DF,25-29,Defender,Denmark,Europe
105,Elliot Anderson,ENG,Newcastle Utd,Premier League,2022,19.0,2002.0,4.6,11,5,5,3,3,6,12,50.0,6,11,2,9,6,17,2,0,"MF,FW",Under 20,Midfielder,England,Europe
106,Felipe Anderson,BRA,Lazio,Serie A,2022,29.0,1993.0,32.9,80,50,31,41,8,31,88,35.2,57,58,6,52,31,111,27,0,FW,25-29,Forward,Brazil,South America
107,Benjamin André,FRA,Lille,Ligue 1,2022,31.0,1990.0,32.4,128,74,51,60,17,65,121,53.7,56,50,8,42,47,175,60,0,MF,30-34,Midfielder,France,Europe
108,Marcos André,BRA,Valencia,La Liga,2022,25.0,1996.0,5.0,4,1,1,1,2,1,2,50.0,1,4,1,3,0,4,0,0,"FW,MF",25-29,Forward,Brazil,South America
108,Marcos André,BRA,Valencia,La Liga,2022,25.0,1996.0,5.0,4,1,1,1,2,1,2,50.0,1,4,1,3,0,4,0,0,"FW,MF",25-29,Forward,Brazil,South America
108,Marcos André,BRA,Valencia,La Liga,2022,25.0,1996.0,5.0,4,1,1,1,2,1,2,50.0,1,4,1,3,0,4,0,0,"FW,MF",25-29,Forward,Brazil,South America
108,Marcos André,BRA,Valencia,La Liga,2022,25.0,1996.0,5.0,4,1,1,1,2,1,2,50.0,1,4,1,3,0,4,0,0,"FW,MF",25-29,Forward,Brazil,South America
110,Robert Andrich,GER,Leverkusen,Bundesliga,2022,27.0,1994.0,26.7,61,38,30,27,4,26,45,57.8,19,27,9,18,42,103,55,2,MF,25-29,Midfielder,Germany,Europe
112,Fabrizio Angileri,ARG,Getafe,La Liga,2022,28.0,1994.0,6.5,12,9,8,3,1,10,17,58.8,7,8,3,5,7,19,10,0,DF,25-29,Defender,Argentina,South America
113,Jaidon Anthony,ENG,Bournemouth,Premier League,2022,22.0,1999.0,14.0,30,17,15,9,6,8,24,33.3,16,30,3,27,10,40,19,0,"MF,FW",20-24,Midfielder,England,Europe
114,Janis Antiste,FRA,Sassuolo,Serie A,2022,19.0,2002.0,0.6,1,0,1,0,0,1,1,100.0,0,0,0,0,0,1,0,0,FW,Under 20,Forward,France,Europe
115,Waldemar Anton,GER,Stuttgart,Bundesliga,2022,26.0,1996.0,32.6,49,27,27,19,3,27,51,52.9,24,44,16,28,38,87,123,2,DF,25-29,Defender,Germany,Europe
118,Marcos Antônio,BRA,Lazio,Serie A,2022,22.0,2000.0,6.6,9,6,4,5,0,9,20,45.0,11,7,2,5,11,20,18,0,MF,20-24,Midfielder,Brazil,South America
119,Michail Antonio,JAM,West Ham,Premier League,2022,32.0,1990.0,20.3,14,7,1,8,5,3,12,25.0,9,13,5,8,5,19,9,0,FW,30-34,Forward,Jamaica,North America
120,Antony,BRA,Manchester Utd,Premier League,2022,22.0,2000.0,20.0,22,9,9,9,4,8,28,28.6,20,18,0,18,11,33,6,0,FW,20-24,Forward,Brazil,South America
120,Antony,BRA,Manchester Utd,Premier League,2022,22.0,2000.0,20.0,22,9,9,9,4,8,28,28.6,20,18,0,18,11,33,6,0,FW,20-24,Forward,Brazil,South America
120,Antony,BRA,Manchester Utd,Premier League,2022,22.0,2000.0,20.0,22,9,9,9,4,8,28,28.6,20,18,0,18,11,33,6,0,FW,20-24,Forward,Brazil,South America
120,Antony,BRA,Manchester Utd,Premier League,2022,22.0,2000.0,20.0,22,9,9,9,4,8,28,28.6,20,18,0,18,11,33,6,0,FW,20-24,Forward,Brazil,South America
121,Valentin Antov,BUL,Monza,Serie A,2022,21.0,2000.0,3.4,6,5,3,3,0,1,5,20.0,4,5,4,1,4,10,14,1,DF,20-24,Defender,Bulgaria,Europe
122,Christopher Antwi-Adjei,GHA,Bochum,Bundesliga,2022,28.0,1994.0,22.0,23,15,7,8,8,10,29,34.5,19,17,0,17,5,28,16,0,"FW,MF",25-29,Forward,Ghana,Africa
123,Anuar,MAR,Valladolid,La Liga,2022,27.0,1995.0,2.3,4,4,0,1,3,0,0,,0,5,2,3,3,7,3,0,"MF,FW",25-29,Midfielder,Morocco,Africa
124,Houssem Aouar,ALG,Lyon,Ligue 1,2022,24.0,1998.0,5.8,12,5,5,5,2,3,9,33.3,6,12,2,10,8,20,3,0,MF,20-24,Midfielder,Algeria,Africa
125,Adil Aouchiche,FRA,Lorient,Ligue 1,2022,20.0,2002.0,2.8,5,2,3,1,1,1,9,11.1,8,1,0,1,4,9,1,0,MF,20-24,Midfielder,France,Europe
126,Dennis Appiah,FRA,Nantes,Ligue 1,2022,30.0,1992.0,8.8,21,11,14,7,0,10,27,37.0,17,13,5,8,10,31,16,0,"DF,MF",30-34,Defender,France,Europe
127,Stredair Appuah,FRA,Nantes,Ligue 1,2022,18.0,2004.0,0.7,2,1,0,2,0,0,0,,0,2,0,2,1,3,0,0,"DF,MF",Under 20,Defender,France,Europe
128,Mauro Arambarri,URU,Getafe,La Liga,2022,26.0,1995.0,11.0,14,6,9,4,1,3,17,17.6,14,17,5,12,14,28,19,0,MF,25-29,Midfielder,Uruguay,South America
129,Charles Aránguiz,CHI,Leverkusen,Bundesliga,2022,33.0,1989.0,5.5,17,7,7,10,0,12,20,60.0,8,4,0,4,7,24,4,0,MF,30-34,Midfielder,Chile,South America
130,Ronald Araújo,URU,Barcelona,La Liga,2022,23.0,1999.0,20.0,26,18,12,13,1,6,9,66.7,3,15,7,8,12,38,41,1,DF,20-24,Defender,Uruguay,South America
131,Cameron Archer,ENG,Aston Villa,Premier League,2022,21.0,2001.0,0.5,0,0,0,0,0,0,0,,0,0,0,0,0,0,0,0,"FW,MF",20-24,Forward,England,Europe
132,Taïryk Arconte,FRA,Brest,Ligue 1,2022,18.0,2003.0,1.4,1,1,0,0,1,0,3,0.0,3,1,0,1,0,1,2,0,FW,Under 20,Forward,France,Europe
133,Alphonse Areola,FRA,West Ham,Premier League,2022,29.0,1993.0,3.4,0,0,0,0,0,0,0,,0,0,0,0,0,0,0,0,GK,25-29,Goalkeeper,France,Europe
135,Joe Aribo,NGA,Southampton,Premier League,2022,26.0,1996.0,13.6,31,20,15,12,4,11,20,55.0,9,14,1,13,10,41,11,0,"MF,FW",25-29,Midfielder,Nigeria,Africa
136,Adam Armstrong,ENG,Southampton,Premier League,2022,25.0,1997.0,14.8,14,9,6,5,3,3,10,30.0,7,15,3,12,5,19,6,0,"FW,MF",25-29,Forward,England,Europe
137,Stuart Armstrong,SCO,Southampton,Premier League,2022,30.0,1992.0,15.6,32,21,15,13,4,14,39,35.9,25,18,0,18,10,42,9,2,"MF,FW",30-34,Midfielder,Scotland,Europe
138,Marko Arnautović,AUT,Bologna,Serie A,2022,33.0,1989.0,17.0,9,6,2,5,2,1,6,16.7,5,11,1,10,2,11,10,0,FW,30-34,Forward,Austria,Europe
139,Maximilian Arnold,GER,Wolfsburg,Bundesliga,2022,28.0,1994.0,30.7,62,31,25,28,9,28,54,51.9,26,34,11,23,26,88,65,2,MF,25-29,Midfielder,Germany,Europe
140,Mohamed El Arouch,FRA,Lyon,Ligue 1,2022,18.0,2004.0,0.0,1,1,1,0,0,0,0,,0,0,0,0,0,1,0,0,MF,Under 20,Midfielder,France,Europe
144,Tolgay Arslan,GER,Udinese,Serie A,2022,31.0,1990.0,13.5,29,18,13,15,1,14,39,35.9,25,19,0,19,12,41,9,1,MF,30-34,Midfielder,Germany,Europe
146,Santiago Arzamendia,PAR,Cádiz,La Liga,2022,24.0,1998.0,5.4,9,8,7,1,1,6,21,28.6,15,11,1,10,2,11,15,1,"DF,MF",20-24,Defender,Paraguay,South America
147,Takuma Asano,JPN,Bochum,Bundesliga,2022,27.0,1994.0,19.0,14,9,4,4,6,7,16,43.8,9,17,1,16,8,22,8,0,"FW,MF",25-29,Forward,Japan,Asia
148,Santiago Ascacíbar,ARG,Cremonese,Serie A,2022,25.0,1997.0,8.1,29,14,17,10,2,14,35,40.0,21,14,2,12,13,42,11,0,MF,25-29,Midfielder,Argentina,South America
153,Kristjan Asllani,ALB,Inter,Serie A,2022,20.0,2002.0,6.6,11,5,1,8,2,7,10,70.0,3,3,1,2,6,17,4,0,MF,20-24,Midfielder,Albania,Europe
156,Youcef Atal,ALG,Nice,Ligue 1,2022,26.0,1996.0,8.7,38,22,18,15,5,23,32,71.9,9,9,0,9,14,52,13,0,"DF,MF",25-29,Defender,Algeria,Africa
157,Valentin Atangana Edoa,FRA,Reims,Ligue 1,2022,16.0,2005.0,1.9,8,3,4,2,2,3,6,50.0,3,2,1,1,0,8,1,0,MF,Under 20,Midfielder,France,Europe
158,Pierre-Emerick Aubameyang,GAB,Chelsea,Premier League,2022,33.0,1989.0,6.2,1,0,1,0,0,0,1,0.0,1,2,0,2,2,3,4,2,FW,30-34,Forward,Gabon,Africa
159,Pierre-Emerick Aubameyang,GAB,Barcelona,La Liga,2022,33.0,1989.0,0.1,0,0,0,0,0,0,0,,0,0,0,0,0,0,0,0,FW,30-34,Forward,Gabon,Africa
160,Emil Audero,ITA,Sampdoria,Serie A,2022,25.0,1997.0,25.0,0,0,0,0,0,0,2,0.0,2,0,0,0,0,0,7,1,GK,25-29,Goalkeeper,Italy,Europe
161,Tommaso Augello,ITA,Sampdoria,Serie A,2022,27.0,1994.0,34.0,17,14,13,2,2,9,20,45.0,11,23,7,16,17,34,61,1,DF,25-29,Defender,Italy,Europe
162,Ludwig Augustinsson,SWE,Aston Villa,Premier League,2022,28.0,1994.0,0.9,1,1,1,0,0,0,0,,0,0,0,0,0,1,1,0,DF,25-29,Defender,Sweden,Europe
163,Ludwig Augustinsson,SWE,Mallorca,La Liga,2022,28.0,1994.0,1.5,2,1,2,0,0,1,3,33.3,2,1,0,1,1,3,3,0,DF,25-29,Defender,Sweden,Europe
164,Carlos Augusto,BRA,Monza,Serie A,2022,23.0,1999.0,34.3,73,38,42,23,8,33,54,61.1,21,24,6,18,24,97,85,1,DF,20-24,Defender,Brazil,South America
165,Serge Aurier,CIV,Nott'ham Forest,Premier League,2022,29.0,1992.0,21.6,64,41,41,18,5,23,33,69.7,10,34,11,23,29,93,75,0,DF,25-29,Defender,Ivory Coast,Africa
166,Mathias Autret,FRA,Auxerre,Ligue 1,2022,31.0,1991.0,14.3,22,10,10,10,2,7,16,43.8,9,14,2,12,12,34,13,0,"MF,FW",30-34,Midfielder,France,Europe
167,Ezequiel Ávila,ARG,Osasuna,La Liga,2022,28.0,1994.0,19.0,8,5,2,4,2,6,23,26.1,17,12,1,11,8,16,16,0,"FW,MF",25-29,Forward,Argentina,South America
169,Taiwo Awoniyi,NGA,Nott'ham Forest,Premier League,2022,24.0,1997.0,15.6,17,10,2,10,5,6,12,50.0,6,18,4,14,4,21,20,0,FW,20-24,Forward,Nigeria,Africa
170,Yasin Ayari,SWE,Brighton,Premier League,2022,18.0,2003.0,0.7,2,2,1,1,0,0,4,0.0,4,1,0,1,0,2,0,0,MF,Under 20,Midfielder,Sweden,Europe
171,Mehmet Aydin,GER,Schalke 04,Bundesliga,2022,20.0,2002.0,6.3,25,18,14,9,2,11,24,45.8,13,11,0,11,10,35,15,0,"DF,FW",20-24,Defender,Germany,Europe
172,André Ayew,GHA,Nott'ham Forest,Premier League,2022,32.0,1989.0,3.5,5,3,0,4,1,2,4,50.0,2,6,1,5,0,5,7,0,"FW,MF",30-34,Forward,Ghana,Africa
173,Jordan Ayew,GHA,Crystal Palace,Premier League,2022,30.0,1991.0,30.2,66,41,23,20,23,21,53,39.6,32,35,4,31,15,81,31,0,"FW,MF",30-34,Forward,Ghana,Africa
174,Kaan Ayhan,TUR,Sassuolo,Serie A,2022,27.0,1994.0,6.1,10,4,6,4,0,7,7,100.0,0,5,4,1,5,15,26,1,DF,25-29,Defender,Turkey,Asia
175,Luke Ayling,ENG,Leeds United,Premier League,2022,30.0,1991.0,22.8,66,37,42,15,9,42,85,49.4,43,34,11,23,26,92,52,2,DF,30-34,Defender,England,Europe
176,Ayman Azhil,MAR,Leverkusen,Bundesliga,2022,21.0,2001.0,0.0,0,0,0,0,0,0,0,,0,0,0,0,0,0,0,0,MF,20-24,Midfielder,Morocco,Africa
177,Sardar Azmoun,IRN,Leverkusen,Bundesliga,2022,27.0,1995.0,10.3,6,3,1,4,1,1,7,14.3,6,4,0,4,2,8,14,0,"FW,MF",25-29,Forward,Iran,Asia
179,Sanoussy Ba,GER,RB Leipzig,Bundesliga,2022,18.0,2004.0,0.0,0,0,0,0,0,0,0,,0,0,0,0,0,0,0,0,DF,Under 20,Defender,Germany,Europe
180,Iddrisu Baba,GHA,Mallorca,La Liga,2022,26.0,1996.0,18.9,31,17,15,16,0,15,32,46.9,17,18,8,10,11,42,39,0,"MF,DF",25-29,Midfielder,Ghana,Africa
182,Loïc Bade,FRA,Sevilla,La Liga,2022,22.0,2000.0,16.1,27,20,23,3,1,17,30,56.7,13,21,13,8,23,50,77,0,DF,20-24,Defender,France,Europe
183,Loïc Bade,FRA,Rennes,Ligue 1,2022,22.0,2000.0,1.0,1,1,1,0,0,0,0,,0,0,0,0,1,2,3,0,DF,20-24,Defender,France,Europe
185,Benoît Badiashile,FRA,Chelsea,Premier League,2022,21.0,2001.0,10.1,14,8,10,4,0,9,14,64.3,5,5,2,3,16,30,34,1,DF,20-24,Defender,France,Europe
186,Benoît Badiashile,FRA,Monaco,Ligue 1,2022,21.0,2001.0,9.3,10,8,6,4,0,5,10,50.0,5,9,6,3,17,27,40,1,DF,20-24,Defender,France,Europe
188,Jaime Báez,URU,Cremonese,Serie A,2022,27.0,1995.0,1.1,4,2,3,0,1,3,6,50.0,3,0,0,0,0,4,2,1,DF,25-29,Defender,Uruguay,South America
189,Leon Bailey,JAM,Aston Villa,Premier League,2022,24.0,1997.0,21.9,14,6,6,7,1,5,20,25.0,15,13,0,13,6,20,12,0,"FW,MF",20-24,Forward,Jamaica,North America
190,Eric Bailly,CIV,Marseille,Ligue 1,2022,28.0,1994.0,6.0,13,10,6,6,1,7,7,100.0,0,15,12,3,12,25,18,1,DF,25-29,Defender,Ivory Coast,Africa
191,Dénys Bain,FRA,Auxerre,Ligue 1,2022,29.0,1993.0,1.4,4,3,3,1,0,1,2,50.0,1,2,1,1,2,6,4,0,DF,25-29,Defender,France,Europe
192,Brandon Baiye,BEL,Clermont Foot,Ligue 1,2022,21.0,2000.0,0.6,3,2,2,1,0,2,3,66.7,1,1,0,1,1,4,3,0,MF,20-24,Midfielder,Belgium,Europe
194,Nedim Bajrami,ALB,Empoli,Serie A,2022,23.0,1999.0,10.4,8,4,3,3,2,4,6,66.7,2,5,0,5,7,15,4,0,"MF,FW",20-24,Midfielder,Albania,Europe
195,Nedim Bajrami,ALB,Sassuolo,Serie A,2022,23.0,1999.0,9.1,12,7,6,2,4,5,11,45.5,6,9,1,8,7,19,6,0,"FW,MF",20-24,Forward,Albania,Europe
196,Cédric Bakambu,COD,Marseille,Ligue 1,2022,31.0,1991.0,0.7,2,1,2,0,0,2,2,100.0,0,0,0,0,0,2,0,0,MF,30-34,Midfielder,DR Congo,Africa
197,Tiemoué Bakayoko,FRA,Milan,Serie A,2022,27.0,1994.0,0.5,5,5,4,1,0,3,3,100.0,0,0,0,0,0,5,0,1,MF,25-29,Midfielder,France,Europe
198,Mitchel Bakker,NED,Leverkusen,Bundesliga,2022,22.0,2000.0,18.4,16,8,9,7,0,6,15,40.0,9,20,2,18,15,31,20,2,"DF,MF",20-24,Defender,Netherlands,Europe
199,Ridle Baku,GER,Wolfsburg,Bundesliga,2022,24.0,1998.0,28.7,50,26,29,17,4,32,58,55.2,26,44,6,38,21,71,59,0,"DF,FW",20-24,Defender,Germany,Europe
200,Tommaso Baldanzi,ITA,Empoli,Serie A,2022,19.0,2003.0,19.7,25,12,9,13,3,7,32,21.9,25,21,1,20,2,27,5,0,MF,Under 20,Midfielder,Italy,Europe
202,Thierno Balde,FRA,Troyes,Ligue 1,2022,20.0,2002.0,23.9,27,14,19,4,4,18,30,60.0,12,15,3,12,23,50,39,0,"DF,MF",20-24,Defender,France,Europe
203,Carlos Baleba,CMR,Lille,Ligue 1,2022,18.0,2004.0,5.3,13,11,2,9,2,9,14,64.3,5,13,3,10,1,14,3,2,MF,Under 20,Midfielder,Cameroon,Africa
205,Leonardo Balerdi,ARG,Marseille,Ligue 1,2022,23.0,1999.0,29.3,57,37,43,12,2,32,45,71.1,13,48,29,19,63,120,91,1,DF,20-24,Defender,Argentina,South America
206,Dominic Ballard,ENG,Southampton,Premier League,2022,17.0,2005.0,0.3,0,0,0,0,0,0,0,,0,0,0,0,1,1,0,0,"FW,MF",Under 20,Forward,England,Europe
207,Iván Balliu,ALB,Rayo Vallecano,La Liga,2022,30.0,1992.0,35.9,52,29,26,20,6,18,30,60.0,12,26,3,23,25,77,72,1,DF,30-34,Defender,Albania,Europe
208,Fodé Ballo-Touré,SEN,Milan,Serie A,2022,25.0,1997.0,5.8,14,9,7,6,1,7,10,70.0,3,11,3,8,2,16,3,0,DF,25-29,Defender,Senegal,Africa
209,Folarin Balogun,USA,Reims,Ligue 1,2022,21.0,2001.0,33.3,9,5,1,5,3,2,20,10.0,18,20,1,19,3,12,15,0,FW,20-24,Forward,United States,North America
210,Abdoulaye Bamba,CIV,Angers,Ligue 1,2022,32.0,1990.0,15.2,22,12,15,5,2,16,19,84.2,3,7,3,4,18,40,38,0,DF,30-34,Defender,Ivory Coast,Africa
211,Jonathan Bamba,CIV,Lille,Ligue 1,2022,26.0,1996.0,30.9,37,17,12,14,11,14,45,31.1,31,36,1,35,22,59,14,0,FW,25-29,Forward,Ivory Coast,Africa
212,Patrick Bamford,ENG,Leeds United,Premier League,2022,28.0,1993.0,16.8,9,6,0,6,3,4,20,20.0,16,12,5,7,5,14,13,0,FW,25-29,Forward,England,Europe
213,Lameck Banda,ZAM,Lecce,Serie A,2022,21.0,2001.0,18.2,30,20,13,14,3,15,41,36.6,26,24,2,22,8,38,5,0,"FW,MF",20-24,Forward,Zambia,Africa
214,Filippo Bandinelli,ITA,Empoli,Serie A,2022,27.0,1995.0,25.1,55,34,19,26,10,17,45,37.8,28,20,7,13,18,73,40,0,MF,25-29,Midfielder,Italy,Europe
215,Léo Baptistão,BRA,Almería,La Liga,2022,29.0,1992.0,19.2,32,20,13,16,3,13,33,39.4,20,17,2,15,19,51,12,0,"FW,MF",25-29,Forward,Brazil,South America
216,Shandon Baptiste,GRN,Brentford,Premier League,2022,24.0,1998.0,6.9,15,9,6,6,3,7,17,41.2,10,10,2,8,7,22,10,0,MF,20-24,Midfielder,Grenada,North America
219,Andrea Barberis,ITA,Monza,Serie A,2022,28.0,1993.0,3.8,7,2,4,3,0,5,11,45.5,6,0,0,0,8,15,1,0,MF,25-29,Midfielder,Italy,Europe
220,Tommaso Barbieri,ITA,Juventus,Serie A,2022,19.0,2002.0,1.2,3,3,3,0,0,3,8,37.5,5,3,0,3,0,3,2,0,DF,Under 20,Defender,Italy,Europe
221,Bradley Barcola,FRA,Lyon,Ligue 1,2022,19.0,2002.0,16.0,25,16,8,10,7,8,39,20.5,31,29,0,29,19,44,10,0,"FW,MF",Under 20,Forward,France,Europe
222,Melvin Bard,FRA,Nice,Ligue 1,2022,21.0,2000.0,27.3,96,60,61,29,6,59,89,66.3,30,35,4,31,64,160,40,1,DF,20-24,Defender,France,Europe
223,Francesco Bardi,ITA,Bologna,Serie A,2022,30.0,1992.0,1.0,0,0,0,0,0,0,0,,0,0,0,0,0,0,0,0,GK,30-34,Goalkeeper,Italy,Europe
224,Keidi Bare,ALB,Espanyol,La Liga,2022,24.0,1997.0,5.6,15,8,7,5,3,7,13,53.8,6,8,2,6,11,26,8,0,MF,20-24,Midfielder,Albania,Europe
225,Nicolò Barella,ITA,Inter,Serie A,2022,25.0,1997.0,29.0,49,25,17,26,6,28,53,52.8,25,29,5,24,12,61,12,0,MF,25-29,Midfielder,Italy,Europe
227,Ross Barkley,ENG,Nice,Ligue 1,2022,28.0,1993.0,10.7,16,9,7,4,5,7,13,53.8,6,7,2,5,8,24,6,0,"MF,FW",25-29,Midfielder,England,Europe
228,Aymen Barkok,MAR,Mainz 05,Bundesliga,2022,24.0,1998.0,6.5,18,8,10,5,3,5,10,50.0,5,7,0,7,3,21,9,0,MF,20-24,Midfielder,Morocco,Africa
229,Harvey Barnes,ENG,Leicester City,Premier League,2022,24.0,1997.0,30.1,26,14,8,14,4,14,42,33.3,28,32,1,31,8,34,12,0,"FW,MF",20-24,Forward,England,Europe
230,Leandro Barreiro Martins,LUX,Mainz 05,Bundesliga,2022,22.0,2000.0,23.8,60,38,19,28,13,22,49,44.9,27,38,13,25,41,101,39,1,MF,20-24,Midfielder,Luxembourg,Europe
231,Enzo Barrenechea,ARG,Juventus,Serie A,2022,21.0,2001.0,1.8,8,3,3,4,1,3,5,60.0,2,3,0,3,2,10,3,0,MF,20-24,Midfielder,Argentina,South America
233,Mickaël Barreto,FRA,Ajaccio,Ligue 1,2022,31.0,1991.0,14.7,32,20,12,17,3,8,45,17.8,37,17,0,17,18,50,11,0,MF,30-34,Midfielder,France,Europe
235,Musa Barrow,GAM,Bologna,Serie A,2022,23.0,1998.0,21.8,21,4,10,6,5,8,14,57.1,6,25,1,24,1,22,7,0,"FW,MF",20-24,Forward,Gambia,Africa
236,Federico Baschirotto,ITA,Lecce,Serie A,2022,25.0,1996.0,37.0,40,30,35,5,0,22,36,61.1,14,45,29,16,36,76,192,0,DF,25-29,Defender,Italy,Europe
237,Toma Bašić,CRO,Lazio,Serie A,2022,25.0,1996.0,5.7,6,4,4,1,1,3,8,37.5,5,9,0,9,7,13,8,0,MF,25-29,Midfielder,Croatia,Europe
238,Alberto Basso,ITA,Cremonese,Serie A,2022,18.0,2004.0,0.2,0,0,0,0,0,0,0,,0,0,0,0,0,0,0,0,MF,Under 20,Midfielder,Italy,Europe
239,Gil Bastião Dias,POR,Stuttgart,Bundesliga,2022,25.0,1996.0,4.4,8,6,3,4,1,3,12,25.0,9,7,0,7,2,10,3,0,FW,25-29,Forward,Portugal,Europe
240,Alessandro Bastoni,ITA,Inter,Serie A,2022,23.0,1999.0,24.0,41,20,20,14,7,11,27,40.7,16,27,13,14,24,65,45,0,DF,20-24,Defender,Italy,Europe
241,Simone Bastoni,ITA,Spezia,Serie A,2022,25.0,1996.0,13.2,47,24,23,19,5,15,33,45.5,18,20,5,15,8,55,14,0,"MF,DF",25-29,Midfielder,Italy,Europe
242,Rodrigo Battaglia,ARG,Mallorca,La Liga,2022,31.0,1991.0,7.6,12,5,7,5,0,6,14,42.9,8,16,7,9,5,17,18,0,MF,30-34,Midfielder,Argentina,South America
243,Maximilian Bauer,GER,Augsburg,Bundesliga,2022,22.0,2000.0,20.5,31,17,18,12,1,17,34,50.0,17,25,9,16,23,54,79,1,DF,20-24,Defender,Germany,Europe
244,Oliver Baumann,GER,Hoffenheim,Bundesliga,2022,32.0,1990.0,34.0,0,0,0,0,0,0,0,,0,0,0,0,0,0,15,1,GK,30-34,Goalkeeper,Germany,Europe
245,Timo Baumgartl,GER,Union Berlin,Bundesliga,2022,26.0,1996.0,6.2,11,6,5,4,2,5,18,27.8,13,12,4,8,2,13,14,0,DF,25-29,Defender,Germany,Europe
246,Julian Baumgartlinger,AUT,Augsburg,Bundesliga,2022,34.0,1988.0,6.2,15,4,5,6,4,6,19,31.6,13,4,2,2,4,19,15,0,MF,30-34,Midfielder,Austria,Europe
247,Christoph Baumgartner,AUT,Hoffenheim,Bundesliga,2022,22.0,1999.0,28.5,36,19,12,17,7,9,52,17.3,43,57,5,52,15,51,19,1,"MF,FW",20-24,Midfielder,Austria,Europe
248,Cyrille Bayala,BFA,Ajaccio,Ligue 1,2022,26.0,1996.0,22.3,53,37,16,20,17,23,48,47.9,25,20,3,17,25,78,21,0,MF,25-29,Midfielder,Burkina Faso,Africa
249,Brian Bayeye,COD,Torino,Serie A,2022,22.0,2000.0,0.7,3,0,3,0,0,1,1,100.0,0,1,1,0,1,4,2,0,DF,20-24,Defender,DR Congo,Africa
250,Noah Joel Sarenren Bazee,NGA,Augsburg,Bundesliga,2022,25.0,1996.0,0.2,0,0,0,0,0,0,1,0.0,1,1,0,1,0,0,0,0,"MF,FW",25-29,Midfielder,Nigeria,Africa
251,Gavin Bazunu,IRL,Southampton,Premier League,2022,20.0,2002.0,32.0,1,0,1,0,0,1,1,100.0,0,0,0,0,1,2,24,2,GK,20-24,Goalkeeper,Republic of Ireland,Europe
252,Bebé,CPV,Rayo Vallecano,La Liga,2022,32.0,1990.0,0.7,0,0,0,0,0,0,2,0.0,2,1,0,1,0,0,0,0,FW,30-34,Forward,Cape Verde,Africa
254,Rodrigo Becão,BRA,Udinese,Serie A,2022,26.0,1996.0,27.6,70,36,50,17,3,40,53,75.5,13,44,24,20,26,96,68,2,DF,25-29,Defender,Brazil,South America
255,Mads Bech Sørensen,DEN,Brentford,Premier League,2022,23.0,1999.0,0.2,0,0,0,0,0,0,0,,0,0,0,0,1,1,1,0,"DF,MF",20-24,Defender,Denmark,Europe
256,Julius Beck,DEN,Spezia,Serie A,2022,17.0,2005.0,0.1,2,1,1,1,0,0,0,,0,0,0,0,0,2,0,0,MF,Under 20,Midfielder,Denmark,Europe
257,Sheraldo Becker,SUR,Union Berlin,Bundesliga,2022,27.0,1995.0,28.4,15,5,1,7,7,2,11,18.2,9,13,1,12,3,18,7,1,FW,25-29,Forward,Suriname,South America
260,Donny van de Beek,NED,Manchester Utd,Premier League,2022,25.0,1997.0,1.9,0,0,0,0,0,0,1,0.0,1,2,1,1,1,1,1,0,MF,25-29,Midfielder,Netherlands,Europe
261,Asmir Begović,BIH,Everton,Premier League,2022,35.0,1987.0,1.0,0,0,0,0,0,0,0,,0,0,0,0,0,0,1,0,GK,35-39,Goalkeeper,Bosnia and Herzegovina,Europe
262,Yanis Begraoui,MAR,Toulouse,Ligue 1,2022,21.0,2001.0,0.7,2,0,1,0,1,1,2,50.0,1,0,0,0,1,3,0,0,"FW,MF",20-24,Forward,Morocco,Africa
263,Kevin Behrens,GER,Union Berlin,Bundesliga,2022,31.0,1991.0,17.1,11,7,4,4,3,4,18,22.2,14,18,3,15,5,16,25,0,FW,30-34,Forward,Germany,Europe
264,Alexis Beka Beka,FRA,Nice,Ligue 1,2022,21.0,2001.0,6.1,16,5,6,9,1,4,15,26.7,11,9,1,8,12,28,6,0,"MF,DF",20-24,Midfielder,France,Europe
265,Jérémie Bela,ANG,Clermont Foot,Ligue 1,2022,29.0,1993.0,8.3,6,4,2,1,3,3,4,75.0,1,10,1,9,9,15,8,0,"DF,MF",25-29,Defender,Angola,Africa
266,Reda Belahyane,MAR,Nice,Ligue 1,2022,18.0,2004.0,2.0,8,6,5,3,0,3,5,60.0,2,5,1,4,2,10,0,0,MF,Under 20,Midfielder,Morocco,Africa
267,Youcef Belaïli,ALG,Ajaccio,Ligue 1,2022,30.0,1992.0,12.8,18,10,3,9,6,8,20,40.0,12,10,1,9,5,23,4,0,"MF,FW",30-34,Midfielder,Algeria,Africa
268,Youcef Belaïli,ALG,Brest,Ligue 1,2022,30.0,1992.0,4.0,5,2,3,2,0,2,7,28.6,5,2,0,2,1,6,1,0,"FW,MF",30-34,Forward,Algeria,Africa
269,Haris Belkebla,ALG,Brest,Ligue 1,2022,28.0,1994.0,29.5,80,48,35,40,5,44,85,51.8,41,32,6,26,52,132,21,3,MF,25-29,Midfielder,Algeria,Africa
270,Stefan Bell,GER,Mainz 05,Bundesliga,2022,30.0,1991.0,26.6,43,28,32,10,1,22,44,50.0,22,42,15,27,44,87,133,0,DF,30-34,Defender,Germany,Europe
271,Armel Bella Kotchap,GER,Southampton,Premier League,2022,20.0,2001.0,20.9,37,17,28,9,0,15,20,75.0,5,29,12,17,44,81,110,0,DF,20-24,Defender,Germany,Europe
272,Raoul Bellanova,ITA,Inter,Serie A,2022,22.0,2000.0,5.5,14,6,11,2,1,9,14,64.3,5,6,1,5,4,18,14,0,DF,20-24,Defender,Italy,Europe
273,Karim Bellarabi,GER,Leverkusen,Bundesliga,2022,32.0,1990.0,0.9,2,0,1,1,0,2,3,66.7,1,0,0,0,0,2,0,0,"FW,MF",30-34,Forward,Germany,Europe
274,Jean-Ricner Bellegarde,FRA,Strasbourg,Ligue 1,2022,24.0,1998.0,26.9,47,25,15,21,11,11,25,44.0,14,26,3,23,26,73,22,0,"MF,FW",20-24,Midfielder,France,Europe
276,Jude Bellingham,ENG,Dortmund,Bundesliga,2022,19.0,2003.0,29.9,76,42,28,34,14,34,51,66.7,17,51,4,47,35,111,30,0,MF,Under 20,Midfielder,England,Europe
277,Jeanuël Belocian,FRA,Rennes,Ligue 1,2022,17.0,2005.0,5.6,10,7,3,5,2,5,9,55.6,4,6,3,3,6,16,11,0,DF,Under 20,Defender,France,Europe
278,Andrea Belotti,ITA,Roma,Serie A,2022,28.0,1993.0,12.7,12,5,3,5,4,5,11,45.5,6,11,1,10,3,15,5,0,FW,25-29,Forward,Italy,Europe
280,Eliesse Ben Seghir,MAR,Monaco,Ligue 1,2022,17.0,2005.0,11.7,18,10,4,12,2,4,12,33.3,8,18,1,17,4,22,1,0,"FW,MF",Under 20,Forward,Morocco,Africa
281,Salim Ben Seghir,FRA,Marseille,Ligue 1,2022,19.0,2003.0,0.0,0,0,0,0,0,0,0,,0,1,0,1,0,0,0,0,MF,Under 20,Midfielder,France,Europe
282,Wissam Ben Yedder,FRA,Monaco,Ligue 1,2022,31.0,1990.0,23.5,16,9,2,5,9,4,13,30.8,9,15,0,15,4,20,0,0,FW,30-34,Forward,France,Europe
283,Marco Benassi,ITA,Fiorentina,Serie A,2022,27.0,1994.0,1.0,3,3,2,0,1,3,4,75.0,1,0,0,0,1,4,1,0,DF,25-29,Defender,Italy,Europe
284,Marco Benassi,ITA,Cremonese,Serie A,2022,27.0,1994.0,11.1,26,15,9,11,6,15,24,62.5,9,13,1,12,12,38,19,0,MF,25-29,Midfielder,Italy,Europe
286,Ismaël Bennacer,ALG,Milan,Serie A,2022,24.0,1997.0,22.3,59,33,26,31,2,30,51,58.8,21,25,7,18,26,85,16,1,MF,20-24,Midfielder,Algeria,Africa
287,Saïd Benrahma,ALG,West Ham,Premier League,2022,26.0,1995.0,23.0,25,15,11,7,7,11,27,40.7,16,23,1,22,9,34,13,0,"FW,MF",25-29,Forward,Algeria,Africa
288,Ramy Bensebaini,ALG,Gladbach,Bundesliga,2022,27.0,1995.0,27.6,34,21,21,10,3,26,39,66.7,13,44,14,30,36,70,98,1,DF,25-29,Defender,Algeria,Africa
289,Nabil Bentaleb,ALG,Angers,Ligue 1,2022,27.0,1994.0,27.7,74,40,31,35,8,36,61,59.0,25,33,11,22,44,118,29,3,MF,25-29,Midfielder,Algeria,Africa
290,Rodrigo Bentancur,URU,Tottenham,Premier League,2022,25.0,1997.0,16.7,45,28,15,21,9,16,28,57.1,12,28,15,13,20,65,22,0,MF,25-29,Midfielder,Uruguay,South America
291,Daniel Bentley,ENG,Wolves,Premier League,2022,29.0,1993.0,2.0,1,1,1,0,0,1,1,100.0,0,0,0,0,0,1,0,1,GK,25-29,Goalkeeper,England,Europe
292,Karim Benzema,FRA,Real Madrid,La Liga,2022,34.0,1987.0,22.6,9,5,2,4,3,2,11,18.2,9,11,0,11,2,11,5,0,FW,30-34,Forward,France,Europe
293,Domenico Berardi,ITA,Sassuolo,Serie A,2022,27.0,1994.0,20.7,23,14,8,10,5,9,40,22.5,31,13,0,13,19,42,18,0,FW,25-29,Forward,Italy,Europe
299,Mitchell van Bergen,NED,Reims,Ligue 1,2022,22.0,1999.0,10.1,18,8,6,7,5,8,20,40.0,12,8,2,6,6,24,11,0,"FW,DF",20-24,Forward,Netherlands,Europe
300,Mergim Berisha,GER,Augsburg,Bundesliga,2022,24.0,1998.0,18.7,11,6,4,3,4,4,14,28.6,10,16,1,15,0,11,19,0,FW,20-24,Forward,Germany,Europe
301,Quentin Bernard,FRA,Auxerre,Ligue 1,2022,33.0,1989.0,7.0,9,7,4,2,3,7,15,46.7,8,9,1,8,15,24,17,0,DF,30-34,Defender,France,Europe
302,Paul Bernardoni,FRA,Angers,Ligue 1,2022,25.0,1997.0,27.0,2,0,2,0,0,2,3,66.7,1,1,0,1,1,3,12,1,GK,25-29,Goalkeeper,France,Europe
304,Victor Bernth Kristiansen,DEN,Leicester City,Premier League,2022,19.0,2002.0,9.9,38,23,18,16,4,22,30,73.3,8,16,4,12,3,41,26,1,DF,Under 20,Defender,Denmark,Europe
305,Jason Berthomier,FRA,Clermont Foot,Ligue 1,2022,32.0,1990.0,0.3,0,0,0,0,0,0,0,,0,0,0,0,0,0,0,0,MF,30-34,Midfielder,France,Europe
306,Marco Bertini,ITA,Lazio,Serie A,2022,19.0,2002.0,0.0,0,0,0,0,0,0,0,,0,0,0,0,0,0,0,0,MF,Under 20,Midfielder,Italy,Europe
307,Beto,GNB,Udinese,Serie A,2022,24.0,1998.0,23.7,16,9,0,9,7,4,17,23.5,13,18,3,15,6,22,30,0,FW,20-24,Forward,Guinea-Bissau,Africa
307,Beto,GNB,Udinese,Serie A,2022,24.0,1998.0,23.7,16,9,0,9,7,4,17,23.5,13,18,3,15,6,22,30,0,FW,20-24,Forward,Guinea-Bissau,Africa
307,Beto,GNB,Udinese,Serie A,2022,24.0,1998.0,23.7,16,9,0,9,7,4,17,23.5,13,18,3,15,6,22,30,0,FW,20-24,Forward,Guinea-Bissau,Africa
307,Beto,GNB,Udinese,Serie A,2022,24.0,1998.0,23.7,16,9,0,9,7,4,17,23.5,13,18,3,15,6,22,30,0,FW,20-24,Forward,Guinea-Bissau,Africa
308,Owen Bevan,WAL,Bournemouth,Premier League,2022,18.0,2003.0,0.1,0,0,0,0,0,0,0,,0,0,0,0,0,0,0,0,DF,Under 20,Defender,Wales,Europe
309,Matteo Bianchetti,ITA,Cremonese,Serie A,2022,29.0,1993.0,23.7,32,19,21,9,2,20,32,62.5,12,31,17,14,20,52,111,0,DF,25-29,Defender,Italy,Europe
310,Alessandro Bianco,ITA,Fiorentina,Serie A,2022,19.0,2002.0,1.7,5,2,2,3,0,2,3,66.7,1,1,0,1,0,5,0,0,MF,Under 20,Midfielder,Italy,Europe
311,Giulian Biancone,FRA,Nott'ham Forest,Premier League,2022,22.0,2000.0,0.2,2,1,2,0,0,1,1,100.0,0,0,0,0,1,3,0,0,DF,20-24,Defender,France,Europe
312,Ermin Bičakčić,BIH,Hoffenheim,Bundesliga,2022,32.0,1990.0,2.9,8,4,6,1,1,2,6,33.3,4,4,3,1,5,13,14,0,DF,30-34,Defender,Bosnia and Herzegovina,Europe
315,El Bilal Touré,MLI,Almería,La Liga,2022,20.0,2001.0,14.0,4,3,2,1,1,0,3,0.0,3,6,1,5,1,5,23,0,FW,20-24,Forward,Mali,Africa
316,El Bilal Touré,MLI,Reims,Ligue 1,2022,20.0,2001.0,1.0,0,0,0,0,0,0,0,,0,2,0,2,0,0,1,0,FW,20-24,Forward,Mali,Africa
317,Philip Billing,DEN,Bournemouth,Premier League,2022,26.0,1996.0,30.7,63,36,21,33,9,11,42,26.2,31,48,8,40,31,94,58,1,"MF,FW",25-29,Midfielder,Denmark,Europe
318,Jean-Claude Billong,CMR,Clermont Foot,Ligue 1,2022,28.0,1993.0,0.3,0,0,0,0,0,0,0,,0,1,1,0,1,1,0,0,MF,25-29,Midfielder,Cameroon,Africa
319,Cristiano Biraghi,ITA,Fiorentina,Serie A,2022,29.0,1992.0,28.3,65,38,29,29,7,32,65,49.2,33,32,7,25,14,79,42,1,DF,25-29,Defender,Italy,Europe
320,Samuele Birindelli,ITA,Monza,Serie A,2022,23.0,1999.0,15.6,35,19,21,10,4,18,29,62.1,11,28,8,20,16,51,30,0,DF,20-24,Defender,Italy,Europe
322,Tom Bischof,GER,Hoffenheim,Bundesliga,2022,17.0,2005.0,3.5,15,10,8,3,4,7,10,70.0,3,5,1,4,1,16,1,0,"MF,FW",Under 20,Midfielder,Germany,Europe
323,Yves Bissouma,MLI,Tottenham,Premier League,2022,25.0,1996.0,11.2,16,13,6,6,4,2,7,28.6,5,15,6,9,12,28,10,0,MF,25-29,Midfielder,Mali,Africa
324,Kristijan Bistrović,CRO,Lecce,Serie A,2022,24.0,1998.0,5.1,3,1,3,0,0,0,5,0.0,5,3,0,3,0,3,4,0,MF,20-24,Midfielder,Croatia,Europe
325,Leonardo Bittencourt,GER,Werder Bremen,Bundesliga,2022,28.0,1993.0,18.1,53,28,20,25,8,25,62,40.3,37,13,0,13,10,63,15,0,"MF,DF",25-29,Midfielder,Germany,Europe
326,Marco Bizot,NED,Brest,Ligue 1,2022,31.0,1991.0,37.0,0,0,0,0,0,0,1,0.0,1,1,0,1,0,0,24,4,GK,30-34,Goalkeeper,Netherlands,Europe
328,Lautaro Blanco,ARG,Elche,La Liga,2022,23.0,1999.0,9.7,16,9,10,4,2,9,26,34.6,17,8,1,7,2,18,10,1,"DF,MF",20-24,Defender,Argentina,South America
330,Ludovic Blas,FRA,Nantes,Ligue 1,2022,24.0,1997.0,31.3,47,30,17,19,11,17,49,34.7,32,26,1,25,19,66,8,0,"MF,FW",20-24,Midfielder,France,Europe
331,Janis Blaswich,GER,RB Leipzig,Bundesliga,2022,31.0,1991.0,26.0,0,0,0,0,0,0,0,,0,0,0,0,0,0,10,0,GK,30-34,Goalkeeper,Germany,Europe
333,Joaquín Blázquez,ARG,Brest,Ligue 1,2022,21.0,2001.0,1.0,0,0,0,0,0,0,0,,0,0,0,0,0,0,2,0,GK,20-24,Goalkeeper,Argentina,South America
334,Alexis Blin,FRA,Lecce,Serie A,2022,25.0,1996.0,26.4,69,39,27,33,9,38,73,52.1,35,55,15,40,34,103,74,0,MF,25-29,Midfielder,France,Europe
335,Daley Blind,NED,Bayern Munich,Bundesliga,2022,32.0,1990.0,1.5,2,0,2,0,0,0,1,0.0,1,4,2,2,2,4,6,0,"DF,MF",30-34,Defender,Netherlands,Europe
336,Myron Boadu,NED,Monaco,Ligue 1,2022,21.0,2001.0,3.3,3,3,0,2,1,1,7,14.3,6,1,0,1,0,3,1,0,FW,20-24,Forward,Netherlands,Europe
337,Jérôme Boateng,GER,Lyon,Ligue 1,2022,33.0,1988.0,4.8,3,0,2,1,0,2,6,33.3,4,8,5,3,6,9,16,0,DF,30-34,Defender,Germany,Europe
338,Kevin-Prince Boateng,GHA,Hertha BSC,Bundesliga,2022,35.0,1987.0,5.2,8,6,4,2,2,3,9,33.3,6,11,3,8,3,11,5,0,MF,35-39,Midfielder,Ghana,Africa
339,Antonin Bobichon,FRA,Angers,Ligue 1,2022,26.0,1995.0,0.2,0,0,0,0,0,0,0,,0,1,0,1,0,0,0,0,MF,25-29,Midfielder,France,Europe
340,Jean-Paul Boëtius,NED,Hertha BSC,Bundesliga,2022,28.0,1994.0,11.7,30,16,19,9,2,8,25,32.0,17,25,5,20,14,44,10,0,MF,25-29,Midfielder,Netherlands,Europe
341,Jeremie Boga,CIV,Atalanta,Serie A,2022,25.0,1997.0,8.7,9,5,3,2,4,2,5,40.0,3,6,0,6,1,10,1,0,"MF,FW",25-29,Midfielder,Ivory Coast,Africa
343,Quentin Boisgard,FRA,Lorient,Ligue 1,2022,25.0,1997.0,2.0,6,2,1,4,1,3,4,75.0,1,3,1,2,4,10,2,0,MF,25-29,Midfielder,France,Europe
344,Willy Boly,CIV,Nott'ham Forest,Premier League,2022,31.0,1991.0,7.6,13,6,8,3,2,8,13,61.5,5,13,4,9,12,25,45,0,DF,30-34,Defender,Ivory Coast,Africa
345,Giacomo Bonaventura,ITA,Fiorentina,Serie A,2022,32.0,1989.0,21.2,35,23,14,15,6,24,37,64.9,13,14,0,14,16,51,5,1,MF,30-34,Midfielder,Italy,Europe
346,Federico Bonazzoli,ITA,Salernitana,Serie A,2022,25.0,1997.0,12.4,5,3,0,3,2,0,9,0.0,9,9,1,8,3,8,0,0,"FW,MF",25-29,Forward,Italy,Europe
347,Warren Bondo,FRA,Monza,Serie A,2022,18.0,2003.0,0.7,1,0,1,0,0,0,0,,0,1,0,1,0,1,0,0,MF,Under 20,Midfielder,France,Europe
348,Theo Bongonda,COD,Cádiz,La Liga,2022,26.0,1995.0,21.5,28,20,11,14,3,17,40,42.5,23,21,2,19,6,34,14,0,"MF,FW",25-29,Midfielder,DR Congo,Africa
349,Kevin Bonifazi,ITA,Bologna,Serie A,2022,26.0,1996.0,10.0,13,8,7,6,0,6,12,50.0,6,11,8,3,12,25,39,0,DF,25-29,Defender,Italy,Europe
350,Leonardo Bonucci,ITA,Juventus,Serie A,2022,35.0,1987.0,9.8,5,4,1,4,0,2,4,50.0,2,12,8,4,13,18,29,0,DF,35-39,Defender,Italy,Europe
351,Neto Borges,BRA,Clermont Foot,Ligue 1,2022,25.0,1996.0,31.5,75,45,45,20,10,46,75,61.3,29,45,11,34,41,116,62,1,DF,25-29,Defender,Brazil,South America
352,Yvandro Borges Sanches,LUX,Gladbach,Bundesliga,2022,18.0,2004.0,0.3,2,2,0,2,0,2,2,100.0,0,0,0,0,0,2,0,0,"FW,MF",Under 20,Forward,Luxembourg,Europe
353,Sebastiaan Bornauw,BEL,Wolfsburg,Bundesliga,2022,23.0,1999.0,21.4,29,17,17,10,2,16,22,72.7,6,27,12,15,31,60,83,1,DF,20-24,Defender,Belgium,Europe
354,Rafael Borré,COL,Eint Frankfurt,Bundesliga,2022,26.0,1995.0,12.0,25,15,4,13,8,4,17,23.5,13,10,2,8,2,27,9,0,"MF,FW",25-29,Midfielder,Colombia,South America
356,Sven Botman,NED,Newcastle Utd,Premier League,2022,22.0,2000.0,34.7,38,24,31,7,0,22,28,78.6,6,44,24,20,34,72,126,2,DF,20-24,Defender,Netherlands,Europe
357,Kenji-Van Boto,MAD,Auxerre,Ligue 1,2022,26.0,1996.0,2.0,3,2,2,0,1,2,4,50.0,2,0,0,0,1,4,3,0,DF,25-29,Defender,Madagascar,Africa
358,Kouamé Botué,BFA,Ajaccio,Ligue 1,2022,19.0,2002.0,2.5,4,2,2,1,1,0,2,0.0,2,1,0,1,0,4,1,0,"FW,MF",Under 20,Forward,Burkina Faso,Africa
359,Badredine Bouanani,ALG,Nice,Ligue 1,2022,17.0,2004.0,9.6,13,9,2,7,4,7,14,50.0,7,4,0,4,1,14,2,0,"FW,MF",Under 20,Forward,Algeria,Africa
360,Hicham Boudaoui,ALG,Nice,Ligue 1,2022,22.0,1999.0,20.8,67,32,31,30,6,35,53,66.0,18,34,5,29,36,103,16,0,MF,20-24,Midfielder,Algeria,Africa
361,Franci Bouebari,FRA,Strasbourg,Ligue 1,2022,18.0,2003.0,0.8,3,0,1,2,0,3,5,60.0,2,0,0,0,2,5,2,0,DF,Under 20,Defender,France,Europe
362,Sofiane Boufal,MAR,Angers,Ligue 1,2022,28.0,1993.0,9.3,14,9,7,4,3,3,14,21.4,11,6,0,6,5,19,1,0,"FW,MF",25-29,Forward,Morocco,Africa
363,Yassine Bounou,MAR,Sevilla,La Liga,2022,31.0,1991.0,23.9,2,1,2,0,0,1,4,25.0,3,0,0,0,2,4,11,1,GK,30-34,Goalkeeper,Morocco,Africa
365,Mehdi Bourabia,MAR,Spezia,Serie A,2022,30.0,1991.0,30.8,41,20,13,22,6,19,41,46.3,22,39,12,27,32,73,57,0,MF,30-34,Midfielder,Morocco,Africa
366,Benjamin Bourigeaud,FRA,Rennes,Ligue 1,2022,28.0,1994.0,34.1,45,29,16,23,6,21,65,32.3,44,38,3,35,31,76,32,0,"MF,FW",25-29,Midfielder,France,Europe
367,Edoardo Bove,ITA,Roma,Serie A,2022,20.0,2002.0,11.0,35,18,12,15,8,16,39,41.0,23,15,1,14,10,45,11,0,MF,20-24,Midfielder,Italy,Europe
368,Jarrod Bowen,ENG,West Ham,Premier League,2022,25.0,1996.0,35.9,39,16,14,11,14,16,58,27.6,42,47,9,38,36,75,25,0,"FW,MF",25-29,Forward,England,Europe
369,Lucas Boyé,ARG,Elche,La Liga,2022,26.0,1996.0,27.4,36,16,12,16,8,17,35,48.6,18,33,5,28,15,51,46,0,FW,25-29,Forward,Argentina,South America
370,Jayden Braaf,NED,Hellas Verona,Serie A,2022,19.0,2002.0,3.2,5,3,2,3,0,0,0,,0,1,0,1,2,7,1,0,"MF,FW",Under 20,Midfielder,Netherlands,Europe
371,Domagoj Bradarić,CRO,Salernitana,Serie A,2022,22.0,1999.0,25.0,26,19,14,8,4,7,16,43.8,9,20,5,15,21,47,44,0,DF,20-24,Defender,Croatia,Europe
372,Bilal Brahimi,ALG,Nice,Ligue 1,2022,22.0,2000.0,8.9,8,5,2,5,1,1,7,14.3,6,4,0,4,4,12,0,0,"FW,MF",20-24,Forward,Algeria,Africa
373,Martin Braithwaite,DEN,Espanyol,La Liga,2022,31.0,1991.0,27.3,12,2,2,4,6,5,14,35.7,9,10,0,10,5,17,11,0,"FW,MF",30-34,Forward,Denmark,Europe
374,Julian Brandt,GER,Dortmund,Bundesliga,2022,26.0,1996.0,26.6,29,20,6,14,9,12,43,27.9,31,23,0,23,15,44,9,1,"MF,FW",25-29,Midfielder,Germany,Europe
376,Lilian Brassier,FRA,Brest,Ligue 1,2022,22.0,1999.0,34.4,42,30,31,8,3,23,32,71.9,9,42,19,23,53,95,132,1,DF,20-24,Defender,France,Europe
377,Claudio Bravo,CHI,Betis,La Liga,2022,39.0,1983.0,12.0,0,0,0,0,0,0,0,,0,0,0,0,2,2,1,1,GK,35-39,Goalkeeper,Chile,South America
378,Fabian Bredlow,GER,Stuttgart,Bundesliga,2022,27.0,1995.0,15.0,1,1,1,0,0,1,1,100.0,0,0,0,0,0,1,4,2,GK,25-29,Goalkeeper,Germany,Europe
379,James Bree,ENG,Southampton,Premier League,2022,24.0,1997.0,4.1,5,3,4,1,0,3,4,75.0,1,3,1,2,6,11,11,0,DF,20-24,Defender,England,Europe
380,Josip Brekalo,CRO,Fiorentina,Serie A,2022,24.0,1998.0,2.5,2,1,0,1,1,1,4,25.0,3,1,0,1,1,3,1,0,"FW,MF",20-24,Forward,Croatia,Europe
381,Josip Brekalo,CRO,Wolfsburg,Bundesliga,2022,24.0,1998.0,3.0,2,1,2,0,0,0,4,0.0,4,0,0,0,2,4,2,0,"MF,FW",20-24,Midfielder,Croatia,Europe
382,Gleison Bremer,BRA,Juventus,Serie A,2022,25.0,1997.0,29.3,29,20,23,5,1,19,26,73.1,7,44,22,22,42,71,120,2,DF,25-29,Defender,Brazil,South America
383,Armando Broja,ALB,Chelsea,Premier League,2022,20.0,2001.0,3.3,4,1,0,3,1,1,1,100.0,0,10,1,9,1,5,1,0,FW,20-24,Forward,Albania,Europe
384,Dylan Bronn,TUN,Salernitana,Serie A,2022,27.0,1995.0,18.7,34,18,17,16,1,20,30,66.7,10,32,20,12,20,54,58,1,DF,25-29,Defender,Tunisia,Africa
385,David Brooks,WAL,Bournemouth,Premier League,2022,25.0,1997.0,1.9,1,0,1,0,0,0,1,0.0,1,2,0,2,2,3,5,0,"FW,MF",25-29,Forward,Wales,Europe
386,John Brooks,USA,Hoffenheim,Bundesliga,2022,29.0,1993.0,15.0,18,12,10,8,0,13,18,72.2,5,17,12,5,10,28,105,0,DF,25-29,Defender,United States,North America
387,Moritz Broschinski,GER,Bochum,Bundesliga,2022,21.0,2000.0,2.4,0,0,0,0,0,0,5,0.0,5,1,0,1,0,0,6,0,"FW,MF",20-24,Forward,Germany,Europe
388,Marcelo Brozović,CRO,Inter,Serie A,2022,29.0,1992.0,19.7,37,22,13,22,2,11,37,29.7,26,23,7,16,22,59,28,0,MF,25-29,Midfielder,Croatia,Europe
389,Cédric Brunner,SUI,Schalke 04,Bundesliga,2022,28.0,1994.0,25.7,39,27,26,11,2,30,45,66.7,15,24,7,17,43,82,79,0,DF,25-29,Defender,Switzerland,Europe
390,Lewis Brunt,ENG,Leicester City,Premier League,2022,21.0,2000.0,0.3,0,0,0,0,0,0,0,,0,0,0,0,0,0,2,0,DF,20-24,Defender,England,Europe
391,Jacob Bruun Larsen,DEN,Hoffenheim,Bundesliga,2022,23.0,1998.0,3.6,4,3,0,1,3,3,4,75.0,1,3,1,2,1,5,0,0,FW,20-24,Forward,Denmark,Europe
392,Andreas Bruus,DEN,Troyes,Ligue 1,2022,23.0,1999.0,18.1,12,6,9,3,0,8,20,40.0,12,13,2,11,17,29,24,0,"DF,FW",20-24,Defender,Denmark,Europe
393,Joe Bryan,ENG,Nice,Ligue 1,2022,28.0,1993.0,2.0,5,4,3,2,0,4,4,100.0,0,2,0,2,1,6,1,0,"MF,DF",25-29,Midfielder,England,Europe
394,Lee Buchanan,ENG,Werder Bremen,Bundesliga,2022,21.0,2001.0,5.2,14,10,2,11,1,6,12,50.0,6,5,0,5,12,26,21,0,"DF,FW",20-24,Defender,England,Europe
395,Ante Budimir,CRO,Osasuna,La Liga,2022,31.0,1991.0,20.0,19,9,0,12,7,2,10,20.0,8,10,0,10,5,24,19,0,FW,30-34,Forward,Croatia,Europe
396,Emi Buendía,ARG,Aston Villa,Premier League,2022,25.0,1996.0,26.8,52,23,20,20,12,21,74,28.4,53,20,2,18,20,72,17,0,"MF,FW",25-29,Midfielder,Argentina,South America
399,Santiago Bueno,URU,Girona,La Liga,2022,23.0,1998.0,33.4,63,38,43,19,1,24,36,66.7,12,34,22,12,31,94,105,2,DF,20-24,Defender,Uruguay,South America
401,Marius Bülter,GER,Schalke 04,Bundesliga,2022,29.0,1993.0,28.9,22,11,8,7,7,12,32,37.5,20,34,1,33,10,32,20,0,"FW,MF",25-29,Forward,Germany,Europe
402,Cristian Buonaiuto,ITA,Cremonese,Serie A,2022,29.0,1992.0,10.9,25,16,8,11,6,12,26,46.2,14,11,0,11,14,39,7,0,"MF,FW",25-29,Midfielder,Italy,Europe
403,Facundo Buonanotte,ARG,Brighton,Premier League,2022,17.0,2004.0,6.3,2,1,1,1,0,1,22,4.5,21,5,2,3,4,6,3,0,"FW,MF",Under 20,Forward,Argentina,South America
404,Alessandro Buongiorno,ITA,Torino,Serie A,2022,23.0,1999.0,30.2,38,25,22,16,0,16,31,51.6,15,38,19,19,60,98,105,2,DF,20-24,Defender,Italy,Europe
405,Delano Burgzorg,SUR,Mainz 05,Bundesliga,2022,23.0,1998.0,2.7,3,3,1,1,1,2,3,66.7,1,2,0,2,0,3,2,0,"FW,MF",20-24,Forward,Suriname,South America
406,Jonathan Burkardt,GER,Mainz 05,Bundesliga,2022,22.0,2000.0,5.9,3,1,0,1,2,1,4,25.0,3,6,1,5,1,4,1,0,"MF,FW",20-24,Midfielder,Germany,Europe
407,Oliver Burke,SCO,Werder Bremen,Bundesliga,2022,25.0,1997.0,3.0,1,0,0,0,1,0,0,,0,2,0,2,0,1,0,0,"FW,MF",25-29,Forward,Scotland,Europe
408,Dan Burn,ENG,Newcastle Utd,Premier League,2022,30.0,1992.0,34.6,60,38,29,23,8,34,67,50.7,33,42,16,26,32,92,120,2,DF,30-34,Defender,England,Europe
409,Maxime Busi,BEL,Reims,Ligue 1,2022,22.0,1999.0,11.6,21,16,9,11,1,13,29,44.8,16,14,6,8,14,35,24,0,DF,20-24,Defender,Belgium,Europe
411,Aurélio Buta,POR,Eint Frankfurt,Bundesliga,2022,25.0,1997.0,14.6,33,19,15,13,5,15,27,55.6,12,18,1,17,9,42,34,0,DF,25-29,Defender,Portugal,Europe
412,Leonardo Buta,POR,Udinese,Serie A,2022,20.0,2002.0,0.2,1,1,0,1,0,0,0,,0,0,0,0,0,1,0,0,DF,20-24,Defender,Portugal,Europe
414,Rémy Cabella,FRA,Lille,Ligue 1,2022,32.0,1990.0,28.1,64,37,21,28,15,29,64,45.3,35,41,5,36,17,81,7,1,"MF,FW",30-34,Midfielder,France,Europe
415,Jimmy Cabot,FRA,Lens,Ligue 1,2022,28.0,1994.0,5.7,20,12,10,8,2,12,26,46.2,14,5,0,5,4,24,12,0,"DF,MF",25-29,Defender,France,Europe
416,Arthur Cabral,BRA,Fiorentina,Serie A,2022,24.0,1998.0,15.9,9,2,1,4,4,4,8,50.0,4,10,1,9,1,10,12,0,FW,20-24,Forward,Brazil,South America
417,Leandro Cabrera,URU,Espanyol,La Liga,2022,31.0,1991.0,29.7,46,24,34,12,0,28,43,65.1,15,37,23,14,43,89,114,2,DF,30-34,Defender,Uruguay,South America
418,Liberato Cacace,NZL,Empoli,Serie A,2022,21.0,2000.0,6.5,25,10,12,8,5,9,15,60.0,6,15,7,8,4,29,16,0,DF,20-24,Defender,New Zealand,Oceania
419,Anthony Caci,FRA,Mainz 05,Bundesliga,2022,25.0,1997.0,22.6,58,33,32,20,6,28,42,66.7,14,28,4,24,54,112,40,0,DF,25-29,Defender,France,Europe
420,Cafú,POR,Nott'ham Forest,Premier League,2022,29.0,1993.0,0.1,0,0,0,0,0,0,0,,0,0,0,0,0,0,1,0,MF,25-29,Midfielder,Portugal,Europe
421,Moisés Caicedo,ECU,Brighton,Premier League,2022,20.0,2001.0,34.9,100,50,41,47,12,40,68,58.8,28,43,7,36,56,156,31,3,MF,20-24,Midfielder,Ecuador,South America
422,Tom Cairney,SCO,Fulham,Premier League,2022,31.0,1991.0,11.0,17,6,4,8,5,7,10,70.0,3,18,3,15,5,22,3,0,MF,30-34,Midfielder,Scotland,Europe
423,Jens Cajuste,SWE,Reims,Ligue 1,2022,22.0,1999.0,17.0,46,25,25,14,7,25,48,52.1,23,30,6,24,18,64,22,0,MF,20-24,Midfielder,Sweden,Europe
425,Davide Calabria,ITA,Milan,Serie A,2022,25.0,1996.0,18.8,71,44,31,32,8,38,61,62.3,23,22,7,15,25,96,34,0,DF,25-29,Defender,Italy,Europe
426,Mattia Caldara,ITA,Spezia,Serie A,2022,28.0,1994.0,13.9,23,14,10,11,2,9,20,45.0,11,23,16,7,17,40,88,2,DF,25-29,Defender,Italy,Europe
427,Luca Caldirola,ITA,Monza,Serie A,2022,31.0,1991.0,26.1,26,14,19,4,3,13,26,50.0,13,32,18,14,25,51,66,1,DF,30-34,Defender,Italy,Europe
429,Duje Ćaleta-Car,CRO,Southampton,Premier League,2022,25.0,1996.0,10.5,14,10,9,4,1,6,9,66.7,3,15,11,4,15,29,65,1,DF,25-29,Defender,Croatia,Europe
430,Duje Ćaleta-Car,CRO,Marseille,Ligue 1,2022,25.0,1996.0,0.1,0,0,0,0,0,0,0,,0,0,0,0,0,0,1,0,DF,25-29,Defender,Croatia,Europe
431,Hakan Çalhanoğlu,TUR,Inter,Serie A,2022,28.0,1994.0,26.3,48,27,17,26,5,16,43,37.2,27,30,5,25,25,73,13,1,MF,25-29,Midfielder,Turkey,Asia
432,Kerim Calhanoglu,GER,Schalke 04,Bundesliga,2022,19.0,2002.0,0.7,2,1,2,0,0,2,2,100.0,0,1,0,1,0,2,3,0,DF,Under 20,Defender,Germany,Europe
433,Daniel Caligiuri,ITA,Augsburg,Bundesliga,2022,34.0,1988.0,3.2,8,5,5,3,0,4,5,80.0,1,3,2,1,3,11,2,0,"DF,MF",30-34,Defender,Italy,Europe
434,Alexander Callens,PER,Girona,La Liga,2022,30.0,1992.0,1.3,3,3,2,1,0,3,4,75.0,1,3,1,2,1,4,9,0,DF,30-34,Defender,Peru,South America
435,Dominic Calvert-Lewin,ENG,Everton,Premier League,2022,25.0,1997.0,12.9,4,2,1,0,3,1,5,20.0,4,5,1,4,3,7,18,0,FW,25-29,Forward,England,Europe
436,Mahdi Camara,FRA,Brest,Ligue 1,2022,24.0,1998.0,20.2,63,36,18,38,7,25,43,58.1,18,35,4,31,40,103,16,0,MF,20-24,Midfielder,France,Europe
437,Mohamed Camara,GUI,Roma,Serie A,2022,25.0,1997.0,7.7,13,10,3,7,3,5,15,33.3,10,5,1,4,10,23,8,0,MF,25-29,Midfielder,Guinea,Africa
437,Mohamed Camara,GUI,Roma,Serie A,2022,25.0,1997.0,7.7,13,10,3,7,3,5,15,33.3,10,5,1,4,10,23,8,0,MF,25-29,Midfielder,Guinea,Africa
437,Mohamed Camara,GUI,Roma,Serie A,2022,25.0,1997.0,7.7,13,10,3,7,3,5,15,33.3,10,5,1,4,10,23,8,0,MF,25-29,Midfielder,Guinea,Africa
437,Mohamed Camara,GUI,Roma,Serie A,2022,25.0,1997.0,7.7,13,10,3,7,3,5,15,33.3,10,5,1,4,10,23,8,0,MF,25-29,Midfielder,Guinea,Africa
438,Mohamed Camara,MLI,Monaco,Ligue 1,2022,22.0,2000.0,24.4,83,45,38,39,6,48,92,52.2,44,45,6,39,27,110,14,1,MF,20-24,Midfielder,Mali,Africa
438,Mohamed Camara,MLI,Monaco,Ligue 1,2022,22.0,2000.0,24.4,83,45,38,39,6,48,92,52.2,44,45,6,39,27,110,14,1,MF,20-24,Midfielder,Mali,Africa
438,Mohamed Camara,MLI,Monaco,Ligue 1,2022,22.0,2000.0,24.4,83,45,38,39,6,48,92,52.2,44,45,6,39,27,110,14,1,MF,20-24,Midfielder,Mali,Africa
438,Mohamed Camara,MLI,Monaco,Ligue 1,2022,22.0,2000.0,24.4,83,45,38,39,6,48,92,52.2,44,45,6,39,27,110,14,1,MF,20-24,Midfielder,Mali,Africa
439,Ousmane Camara,GUI,Auxerre,Ligue 1,2022,20.0,2001.0,0.3,1,1,0,0,1,0,0,,0,0,0,0,0,1,0,0,"FW,MF",20-24,Forward,Guinea,Africa
439,Ousmane Camara,GUI,Auxerre,Ligue 1,2022,20.0,2001.0,0.3,1,1,0,0,1,0,0,,0,0,0,0,0,1,0,0,"FW,MF",20-24,Forward,Guinea,Africa
439,Ousmane Camara,GUI,Auxerre,Ligue 1,2022,20.0,2001.0,0.3,1,1,0,0,1,0,0,,0,0,0,0,0,1,0,0,"FW,MF",20-24,Forward,Guinea,Africa
439,Ousmane Camara,GUI,Auxerre,Ligue 1,2022,20.0,2001.0,0.3,1,1,0,0,1,0,0,,0,0,0,0,0,1,0,0,"FW,MF",20-24,Forward,Guinea,Africa
440,Ousmane Camara,FRA,Angers,Ligue 1,2022,19.0,2003.0,5.8,10,6,5,5,0,5,12,41.7,7,4,2,2,11,21,15,0,DF,Under 20,Defender,France,Europe
440,Ousmane Camara,FRA,Angers,Ligue 1,2022,19.0,2003.0,5.8,10,6,5,5,0,5,12,41.7,7,4,2,2,11,21,15,0,DF,Under 20,Defender,France,Europe
440,Ousmane Camara,FRA,Angers,Ligue 1,2022,19.0,2003.0,5.8,10,6,5,5,0,5,12,41.7,7,4,2,2,11,21,15,0,DF,Under 20,Defender,France,Europe
440,Ousmane Camara,FRA,Angers,Ligue 1,2022,19.0,2003.0,5.8,10,6,5,5,0,5,12,41.7,7,4,2,2,11,21,15,0,DF,Under 20,Defender,France,Europe
441,Eduardo Camavinga,FRA,Real Madrid,La Liga,2022,19.0,2002.0,22.3,68,48,32,21,15,24,64,37.5,40,24,5,19,17,85,25,0,"MF,DF",Under 20,Midfielder,France,Europe
442,Nicolò Cambiaghi,ITA,Empoli,Serie A,2022,21.0,2000.0,14.3,30,22,11,12,7,8,27,29.6,19,19,1,18,9,39,8,0,"FW,MF",20-24,Forward,Italy,Europe
443,Andrea Cambiaso,ITA,Bologna,Serie A,2022,22.0,2000.0,24.1,57,34,34,20,3,28,65,43.1,37,26,2,24,26,83,33,1,DF,20-24,Defender,Italy,Europe
444,Axel Camblan,FRA,Brest,Ligue 1,2022,18.0,2003.0,0.8,2,2,1,1,0,0,1,0.0,1,0,0,0,0,2,0,0,"FW,MF",Under 20,Forward,France,Europe
446,Chem Campbell,WAL,Wolves,Premier League,2022,19.0,2002.0,0.8,2,1,1,1,0,0,1,0.0,1,2,0,2,1,3,0,0,"FW,MF",Under 20,Forward,Wales,Europe
447,Emre Can,GER,Dortmund,Bundesliga,2022,28.0,1994.0,21.1,57,28,25,27,5,22,43,51.2,21,16,6,10,25,82,39,1,MF,25-29,Midfielder,Germany,Europe
449,Matteo Cancellieri,ITA,Lazio,Serie A,2022,20.0,2002.0,2.8,10,4,5,3,2,5,9,55.6,4,4,0,4,1,11,2,0,FW,20-24,Forward,Italy,Europe
450,João Cancelo,POR,Manchester City,Premier League,2022,28.0,1994.0,14.2,29,21,16,9,4,17,24,70.8,7,7,1,6,19,48,9,1,DF,25-29,Defender,Portugal,Europe
451,João Cancelo,POR,Bayern Munich,Bundesliga,2022,28.0,1994.0,11.2,23,14,9,10,4,10,23,43.5,13,14,2,12,15,38,22,0,"DF,FW",25-29,Defender,Portugal,Europe
452,Antonio Candreva,ITA,Salernitana,Serie A,2022,35.0,1987.0,30.3,17,7,13,2,2,11,38,28.9,27,7,3,4,17,34,32,0,"MF,DF",35-39,Midfielder,Italy,Europe
453,Thomas Cannon,IRL,Everton,Premier League,2022,19.0,2002.0,0.3,0,0,0,0,0,0,0,,0,0,0,0,0,0,0,0,FW,Under 20,Forward,Republic of Ireland,Europe
456,Pierrick Capelle,FRA,Angers,Ligue 1,2022,35.0,1987.0,15.9,36,21,17,15,4,22,55,40.0,33,24,3,21,15,51,24,0,"MF,DF",35-39,Midfielder,France,Europe
457,Étienne Capoue,FRA,Villarreal,La Liga,2022,34.0,1988.0,21.7,21,12,6,13,2,10,18,55.6,8,12,5,7,19,40,20,1,MF,30-34,Midfielder,France,Europe
458,Gianluca Caprari,ITA,Monza,Serie A,2022,29.0,1993.0,27.1,16,6,3,11,2,8,26,30.8,18,22,1,21,8,24,3,0,"MF,FW",25-29,Midfielder,Italy,Europe
459,Francesco Caputo,ITA,Sampdoria,Serie A,2022,34.0,1987.0,12.2,3,1,0,0,3,0,3,0.0,3,0,0,0,1,4,3,0,FW,30-34,Forward,Italy,Europe
460,Francesco Caputo,ITA,Empoli,Serie A,2022,34.0,1987.0,19.0,2,2,0,1,1,0,1,0.0,1,7,2,5,2,4,8,0,FW,30-34,Forward,Italy,Europe
461,Maxence Caqueret,FRA,Lyon,Ligue 1,2022,22.0,2000.0,30.7,87,54,27,38,22,43,109,39.4,66,45,3,42,39,126,27,0,MF,20-24,Midfielder,France,Europe
462,Andrea Carboni,ITA,Monza,Serie A,2022,21.0,2001.0,1.9,3,2,2,0,1,2,5,40.0,3,3,2,1,3,6,2,1,DF,20-24,Defender,Italy,Europe
463,Franco Carboni,ITA,Monza,Serie A,2022,19.0,2003.0,0.7,1,1,1,0,0,0,2,0.0,2,3,0,3,1,2,0,0,"DF,FW",Under 20,Defender,Italy,Europe
464,Valentin Carboni,ARG,Inter,Serie A,2022,17.0,2005.0,0.3,1,1,0,1,0,1,3,33.3,2,1,0,1,0,1,0,0,"MF,DF",Under 20,Midfielder,Argentina,South America
466,Irvin Cardona,FRA,Brest,Ligue 1,2022,24.0,1997.0,2.6,2,0,1,1,0,0,3,0.0,3,3,0,3,2,4,2,0,"FW,MF",20-24,Forward,France,Europe
467,Irvin Cardona,FRA,Augsburg,Bundesliga,2022,24.0,1997.0,3.5,1,1,1,0,0,1,5,20.0,4,3,0,3,4,5,8,0,"MF,FW",20-24,Midfielder,France,Europe
468,Igor Carioca,BRA,Lorient,Ligue 1,2022,25.0,1996.0,5.1,18,11,12,2,4,12,21,57.1,9,7,0,7,5,23,17,0,DF,25-29,Defender,Brazil,South America
469,Diego Carlos,BRA,Aston Villa,Premier League,2022,29.0,1993.0,2.3,1,0,0,1,0,0,1,0.0,1,2,2,0,1,2,2,0,DF,25-29,Defender,Brazil,South America
475,Marco Carnesecchi,ITA,Cremonese,Serie A,2022,22.0,2000.0,27.0,1,1,1,0,0,1,2,50.0,1,0,0,0,0,1,11,2,GK,20-24,Goalkeeper,Italy,Europe
476,Yannick Carrasco,BEL,Atlético Madrid,La Liga,2022,28.0,1993.0,25.7,35,14,21,10,4,23,54,42.6,31,23,1,22,12,47,19,0,"DF,MF",25-29,Defender,Belgium,Europe
478,Fabio Carvalho,POR,Liverpool,Premier League,2022,19.0,2002.0,3.9,8,8,3,3,2,3,6,50.0,3,6,0,6,6,14,0,0,"MF,FW",Under 20,Midfielder,Portugal,Europe
479,Matis Carvalho,POR,Montpellier,Ligue 1,2022,23.0,1999.0,1.5,0,0,0,0,0,0,0,,0,0,0,0,1,1,0,0,GK,20-24,Goalkeeper,Portugal,Europe
480,William Carvalho,POR,Betis,La Liga,2022,30.0,1992.0,27.1,43,27,18,23,2,17,44,38.6,27,27,6,21,16,59,22,0,MF,30-34,Midfielder,Portugal,Europe
481,Nicolò Casale,ITA,Lazio,Serie A,2022,24.0,1998.0,27.1,42,20,28,14,0,22,34,64.7,12,25,17,8,17,59,73,1,DF,20-24,Defender,Italy,Europe
482,Casemiro,BRA,Manchester Utd,Premier League,2022,30.0,1992.0,23.6,88,46,43,35,10,47,92,51.1,45,49,11,38,34,122,64,0,MF,30-34,Midfielder,Brazil,South America
483,Casemiro,BRA,Real Madrid,La Liga,2022,30.0,1992.0,0.1,0,0,0,0,0,0,0,,0,0,0,0,0,0,1,0,MF,30-34,Midfielder,Brazil,South America
485,Tommaso Cassandro,ITA,Lecce,Serie A,2022,22.0,2000.0,0.1,1,1,0,1,0,0,0,,0,1,1,0,0,1,0,0,DF,20-24,Defender,Italy,Europe
486,Timothy Castagne,BEL,Leicester City,Premier League,2022,26.0,1995.0,36.2,87,44,53,27,7,41,84,48.8,43,50,13,37,43,130,110,0,DF,25-29,Defender,Belgium,Europe
487,Michele Castagnetti,ITA,Cremonese,Serie A,2022,32.0,1989.0,15.7,46,21,20,24,2,18,54,33.3,36,14,4,10,15,61,22,0,MF,30-34,Midfielder,Italy,Europe
488,Koen Casteels,BEL,Wolfsburg,Bundesliga,2022,30.0,1992.0,34.0,0,0,0,0,0,0,0,,0,0,0,0,1,1,10,1,GK,30-34,Goalkeeper,Belgium,Europe
489,Valentín Castellanos,ARG,Girona,La Liga,2022,23.0,1998.0,28.9,12,5,2,7,3,0,18,0.0,18,22,2,20,6,18,26,0,FW,20-24,Forward,Argentina,South America
490,Jean-Charles Castelletto,CMR,Nantes,Ligue 1,2022,27.0,1995.0,28.5,43,26,29,12,2,22,36,61.1,14,35,22,13,58,101,90,0,DF,25-29,Defender,Cameroon,Africa
493,Gaetano Castrovilli,ITA,Fiorentina,Serie A,2022,25.0,1997.0,8.0,10,8,1,7,2,2,9,22.2,7,5,1,4,8,18,5,0,MF,25-29,Midfielder,Italy,Europe
494,Danilo Cataldi,ITA,Lazio,Serie A,2022,27.0,1994.0,21.3,25,16,7,15,3,14,40,35.0,26,23,9,14,24,49,33,0,MF,25-29,Midfielder,Italy,Europe
496,Yoann Cathline,FRA,Lorient,Ligue 1,2022,20.0,2002.0,12.1,19,12,7,6,6,5,12,41.7,7,10,1,9,8,27,16,1,"FW,MF",20-24,Forward,France,Europe
497,Maximiliano Caufriez,BEL,Clermont Foot,Ligue 1,2022,25.0,1997.0,24.7,40,24,31,8,1,20,28,71.4,8,33,18,15,34,74,70,0,DF,25-29,Defender,Belgium,Europe
498,Edinson Cavani,URU,Valencia,La Liga,2022,35.0,1987.0,16.1,7,4,3,3,1,3,15,20.0,12,10,3,7,2,9,11,0,FW,35-39,Forward,Uruguay,South America
500,Pietro Ceccaroni,ITA,Lecce,Serie A,2022,26.0,1995.0,0.5,0,0,0,0,0,0,0,,0,1,1,0,3,3,2,0,DF,25-29,Defender,Italy,Europe
501,Federico Ceccherini,ITA,Hellas Verona,Serie A,2022,30.0,1992.0,15.7,25,19,15,9,1,13,23,56.5,10,17,10,7,19,44,55,0,DF,30-34,Defender,Italy,Europe
502,Assan Ceesay,GAM,Lecce,Serie A,2022,28.0,1994.0,20.1,23,18,7,8,8,9,17,52.9,8,15,2,13,3,26,24,0,FW,25-29,Forward,Gambia,Africa
504,Zeki Çelik,TUR,Roma,Serie A,2022,25.0,1997.0,16.7,42,21,19,21,2,24,41,58.5,17,33,6,27,14,56,36,2,DF,25-29,Defender,Turkey,Asia
506,Fabien Centonze,FRA,Nantes,Ligue 1,2022,26.0,1996.0,18.8,58,37,30,22,6,30,42,71.4,12,24,7,17,44,102,55,1,DF,25-29,Defender,France,Europe
507,Michele Cerofolini,ITA,Fiorentina,Serie A,2022,23.0,1999.0,5.0,0,0,0,0,0,0,0,,0,0,0,0,1,1,2,0,GK,20-24,Goalkeeper,Italy,Europe
508,Franco Cervi,ARG,Celta Vigo,La Liga,2022,28.0,1994.0,21.0,76,46,29,36,11,33,66,50.0,33,33,1,32,36,112,16,0,"MF,DF",25-29,Midfielder,Argentina,South America
509,Julian Chabot,GER,Köln,Bundesliga,2022,24.0,1998.0,20.0,36,23,19,14,3,20,35,57.1,15,30,18,12,41,77,105,0,DF,20-24,Defender,Germany,Europe
510,Florian Chabrolle,FRA,Ajaccio,Ligue 1,2022,24.0,1998.0,3.7,6,4,1,5,0,2,4,50.0,2,3,0,3,7,13,2,0,MF,20-24,Midfielder,France,Europe
511,El Chadaille Bitshiabu,FRA,Paris S-G,Ligue 1,2022,17.0,2005.0,6.5,10,7,7,2,1,3,12,25.0,9,9,7,2,9,19,13,3,DF,Under 20,Defender,France,Europe
512,Fares Chaïbi,ALG,Toulouse,Ligue 1,2022,19.0,2002.0,26.0,31,18,8,15,8,17,50,34.0,33,38,5,33,19,50,36,1,"FW,MF",Under 20,Forward,Algeria,Africa
513,Nathaniel Chalobah,ENG,Fulham,Premier League,2022,27.0,1994.0,0.1,1,1,1,0,0,1,1,100.0,0,0,0,0,0,1,2,0,MF,25-29,Midfielder,England,Europe
514,Trevoh Chalobah,ENG,Chelsea,Premier League,2022,23.0,1999.0,17.9,31,20,22,6,3,24,35,68.6,11,17,7,10,24,55,56,1,DF,20-24,Defender,England,Europe
515,Muhammed Cham,AUT,Clermont Foot,Ligue 1,2022,21.0,2000.0,21.9,30,15,15,4,11,13,35,37.1,22,13,0,13,7,37,5,0,MF,20-24,Midfielder,Austria,Europe
516,Calum Chambers,ENG,Aston Villa,Premier League,2022,27.0,1995.0,3.9,9,6,7,2,0,6,8,75.0,2,5,4,1,7,16,10,1,"DF,MF",25-29,Defender,England,Europe
517,Timothy Chandler,USA,Eint Frankfurt,Bundesliga,2022,32.0,1990.0,1.0,2,2,2,0,0,2,2,100.0,0,1,0,1,0,2,3,0,DF,30-34,Defender,United States,North America
518,Gaëtan Charbonnier,FRA,Auxerre,Ligue 1,2022,33.0,1988.0,2.8,2,1,0,2,0,0,4,0.0,4,2,0,2,0,2,5,0,"FW,MF",30-34,Forward,France,Europe
519,Brendan Chardonnet,FRA,Brest,Ligue 1,2022,27.0,1994.0,27.7,45,27,27,18,0,20,38,52.6,18,40,19,21,63,108,86,1,DF,25-29,Defender,France,Europe
521,Xavier Chavalerin,FRA,Troyes,Ligue 1,2022,31.0,1991.0,27.0,82,50,39,30,13,27,71,38.0,44,31,8,23,41,123,24,0,MF,30-34,Midfielder,France,Europe
523,Ivane Chegra,FRA,Ajaccio,Ligue 1,2022,18.0,2004.0,2.1,8,3,6,1,1,4,11,36.4,7,0,0,0,1,9,0,0,"MF,FW",Under 20,Midfielder,France,Europe
524,Pape Cheikh Diop,SEN,Elche,La Liga,2022,24.0,1997.0,0.4,0,0,0,0,0,0,1,0.0,1,0,0,0,0,0,0,0,MF,20-24,Midfielder,Senegal,Africa
525,Rayan Cherki,FRA,Lyon,Ligue 1,2022,18.0,2003.0,20.8,14,8,2,5,7,8,23,34.8,15,6,0,6,5,19,1,0,"MF,FW",Under 20,Midfielder,France,Europe
526,Ilyes Cheti,ALG,Angers,Ligue 1,2022,27.0,1995.0,2.3,6,4,4,0,2,5,8,62.5,3,5,1,4,4,10,7,0,DF,25-29,Defender,Algeria,Africa
527,Lucas Chevalier,FRA,Lille,Ligue 1,2022,20.0,2001.0,32.0,2,1,2,0,0,2,2,100.0,0,1,0,1,2,4,7,2,GK,20-24,Goalkeeper,France,Europe
528,Fabio Chiarodia,ITA,Werder Bremen,Bundesliga,2022,17.0,2005.0,0.7,0,0,0,0,0,0,0,,0,1,0,1,2,2,4,0,DF,Under 20,Defender,Italy,Europe
529,Federico Chiesa,ITA,Juventus,Serie A,2022,24.0,1997.0,9.5,22,11,6,6,10,5,14,35.7,9,13,1,12,0,22,1,0,"DF,MF",20-24,Defender,Italy,Europe
530,Ben Chilwell,ENG,Chelsea,Premier League,2022,25.0,1996.0,15.6,21,17,12,8,1,13,25,52.0,12,21,2,19,18,39,26,0,"DF,MF",25-29,Defender,England,Europe
531,Vlad Chiricheș,ROU,Cremonese,Serie A,2022,32.0,1989.0,10.9,35,20,27,7,1,16,24,66.7,8,36,23,13,22,57,44,0,DF,30-34,Defender,Romania,Europe
533,Joris Chotard,FRA,Montpellier,Ligue 1,2022,20.0,2001.0,27.3,64,34,37,23,4,40,78,51.3,38,40,11,29,40,104,42,1,MF,20-24,Midfielder,France,Europe
534,Andreas Christensen,DEN,Barcelona,La Liga,2022,26.0,1996.0,19.6,20,15,9,11,0,10,16,62.5,6,14,12,2,21,41,47,0,DF,25-29,Defender,Denmark,Europe
535,Oliver Christensen,DEN,Hertha BSC,Bundesliga,2022,23.0,1999.0,33.0,1,0,1,0,0,0,2,0.0,2,0,0,0,0,1,22,2,GK,20-24,Goalkeeper,Denmark,Europe
536,Ryan Christie,SCO,Bournemouth,Premier League,2022,27.0,1995.0,20.4,34,22,10,23,1,14,50,28.0,36,16,4,12,26,60,20,0,"MF,FW",25-29,Midfielder,Scotland,Europe
537,Carney Chukwuemeka,ENG,Chelsea,Premier League,2022,18.0,2003.0,3.9,13,7,7,6,0,3,5,60.0,2,7,0,7,6,19,1,0,"MF,FW",Under 20,Midfielder,England,Europe
538,Samuel Chukwueze,NGA,Villarreal,La Liga,2022,23.0,1999.0,26.0,14,7,7,2,5,7,23,30.4,16,13,0,13,12,26,16,0,"FW,MF",20-24,Forward,Nigeria,Africa
540,Darko Churlinov,MKD,Stuttgart,Bundesliga,2022,22.0,2000.0,0.3,3,2,2,1,0,2,3,66.7,1,1,0,1,0,3,0,0,FW,20-24,Forward,North Macedonia,Europe
542,Tolga Ciğerci,TUR,Hertha BSC,Bundesliga,2022,30.0,1992.0,7.5,16,13,6,9,1,10,16,62.5,6,6,2,4,8,24,5,0,MF,30-34,Midfielder,Turkey,Asia
543,Yanis Cimignani,FRA,Ajaccio,Ligue 1,2022,20.0,2002.0,3.1,11,5,3,7,1,4,5,80.0,1,5,1,4,2,13,2,0,"MF,DF",20-24,Midfielder,France,Europe
544,Daniel Ciofani,ITA,Cremonese,Serie A,2022,37.0,1985.0,11.8,6,3,1,2,3,4,7,57.1,3,7,1,6,2,8,10,0,FW,35-39,Forward,Italy,Europe
546,Pathé Ciss,SEN,Rayo Vallecano,La Liga,2022,28.0,1994.0,14.2,39,29,11,23,5,15,34,44.1,19,23,10,13,22,61,34,0,"MF,DF",25-29,Midfielder,Senegal,Africa
547,Souleymane Cissé,FRA,Clermont Foot,Ligue 1,2022,19.0,2002.0,0.4,1,1,1,0,0,1,1,100.0,0,1,1,0,1,2,2,0,DF,Under 20,Defender,France,Europe
548,Patrick Ciurria,ITA,Monza,Serie A,2022,27.0,1995.0,30.6,31,18,20,10,1,17,33,51.5,16,24,2,22,7,38,32,0,"DF,MF",25-29,Defender,Italy,Europe
549,Bobby Clark,ENG,Liverpool,Premier League,2022,17.0,2005.0,0.1,0,0,0,0,0,0,0,,0,2,0,2,0,0,0,0,MF,Under 20,Midfielder,England,Europe
550,Alexis Claude-Maurice,FRA,Nice,Ligue 1,2022,24.0,1998.0,0.7,3,2,2,1,0,3,3,100.0,0,0,0,0,2,5,1,0,FW,20-24,Forward,France,Europe
551,Alexis Claude-Maurice,FRA,Lens,Ligue 1,2022,24.0,1998.0,6.7,14,9,5,8,1,6,16,37.5,10,6,0,6,2,16,1,0,"MF,FW",20-24,Midfielder,France,Europe
552,Jonathan Clauss,FRA,Marseille,Ligue 1,2022,29.0,1992.0,28.8,46,28,21,16,9,23,52,44.2,29,29,4,25,31,77,40,2,DF,25-29,Defender,France,Europe
554,Nathaniel Clyne,ENG,Crystal Palace,Premier League,2022,31.0,1991.0,18.2,27,16,13,9,5,14,23,60.9,9,22,4,18,19,46,34,0,DF,30-34,Defender,England,Europe
555,Conor Coady,ENG,Everton,Premier League,2022,29.0,1993.0,23.3,14,9,8,6,0,7,15,46.7,8,21,17,4,14,28,88,3,DF,25-29,Defender,England,Europe
556,Nicolò Cocetta,ITA,Udinese,Serie A,2022,18.0,2003.0,0.4,0,0,0,0,0,0,1,0.0,1,1,1,0,1,1,1,0,DF,Under 20,Defender,Italy,Europe
557,Marcus Coco,FRA,Nantes,Ligue 1,2022,26.0,1996.0,7.1,24,15,11,9,4,11,23,47.8,12,13,3,10,14,38,7,0,"FW,MF",25-29,Forward,France,Europe
558,Alexandre Coeff,FRA,Auxerre,Ligue 1,2022,30.0,1992.0,6.5,10,5,6,4,0,4,9,44.4,5,9,4,5,8,18,35,1,DF,30-34,Defender,France,Europe
559,Jack Colback,ENG,Nott'ham Forest,Premier League,2022,32.0,1989.0,5.5,18,13,12,6,0,5,8,62.5,3,3,0,3,3,21,9,0,MF,30-34,Midfielder,England,Europe
560,Séamus Coleman,IRL,Everton,Premier League,2022,33.0,1988.0,18.4,35,26,21,10,4,19,29,65.5,10,14,7,7,22,57,58,2,DF,30-34,Defender,Republic of Ireland,Europe
561,David Čolina,CRO,Augsburg,Bundesliga,2022,22.0,2000.0,1.8,4,1,1,1,2,2,2,100.0,0,8,0,8,4,8,3,0,"DF,FW",20-24,Defender,Croatia,Europe
564,Omar Colley,GAM,Sampdoria,Serie A,2022,29.0,1992.0,15.4,17,10,10,7,0,9,12,75.0,3,9,5,4,22,39,69,1,DF,25-29,Defender,Gambia,Africa
565,Nathan Collins,IRL,Wolves,Premier League,2022,21.0,2001.0,20.2,27,15,19,8,0,15,24,62.5,9,35,28,7,21,48,84,0,DF,20-24,Defender,Republic of Ireland,Europe
566,Lorenzo Colombo,ITA,Lecce,Serie A,2022,20.0,2002.0,16.8,17,9,1,9,7,6,14,42.9,8,22,0,22,2,19,7,0,FW,20-24,Forward,Italy,Europe
567,Andrea Colpani,ITA,Monza,Serie A,2022,23.0,1999.0,10.5,14,9,6,5,3,8,12,66.7,4,14,2,12,3,17,6,0,MF,20-24,Midfielder,Italy,Europe
568,Levi Colwill,ENG,Brighton,Premier League,2022,19.0,2003.0,13.6,8,7,4,4,0,4,9,44.4,5,5,3,2,15,23,37,1,DF,Under 20,Defender,England,Europe
569,Kingsley Coman,FRA,Bayern Munich,Bundesliga,2022,26.0,1996.0,15.7,11,8,3,5,3,7,17,41.2,10,19,1,18,2,13,7,0,"FW,MF",25-29,Forward,France,Europe
570,Eray Cömert,SUI,Valencia,La Liga,2022,24.0,1998.0,18.6,35,23,24,10,1,17,33,51.5,16,23,8,15,29,64,76,1,DF,20-24,Defender,Switzerland,Europe
572,Andrea Consigli,ITA,Sassuolo,Serie A,2022,35.0,1987.0,35.0,1,0,1,0,0,0,1,0.0,1,0,0,0,0,1,13,3,GK,35-39,Goalkeeper,Italy,Europe
573,Abdu Conté,POR,Troyes,Ligue 1,2022,24.0,1998.0,14.6,25,17,14,8,3,12,22,54.5,10,13,6,7,6,31,25,0,DF,20-24,Defender,Portugal,Europe
574,Andrea Conti,ITA,Sampdoria,Serie A,2022,28.0,1994.0,0.3,0,0,0,0,0,0,0,,0,0,0,0,0,0,0,0,DF,25-29,Defender,Italy,Europe
575,Lewis Cook,ENG,Bournemouth,Premier League,2022,25.0,1997.0,19.1,37,22,10,22,5,18,44,40.9,26,29,10,19,23,60,31,0,MF,25-29,Midfielder,England,Europe
576,Steve Cook,ENG,Nott'ham Forest,Premier League,2022,31.0,1991.0,10.6,8,4,4,4,0,5,7,71.4,2,16,11,5,12,20,51,0,DF,30-34,Defender,England,Europe
577,Liam Cooper,SCO,Leeds United,Premier League,2022,30.0,1991.0,15.8,38,23,27,9,2,23,36,63.9,13,16,8,8,34,72,57,3,DF,30-34,Defender,Scotland,Europe
579,Diego Coppola,ITA,Hellas Verona,Serie A,2022,18.0,2003.0,13.1,25,17,15,10,0,11,24,45.8,13,20,6,14,14,39,38,0,DF,Under 20,Defender,Italy,Europe
580,Francis Coquelin,FRA,Villarreal,La Liga,2022,31.0,1991.0,8.3,18,13,7,9,2,7,7,100.0,0,8,2,6,9,27,7,0,MF,30-34,Midfielder,France,Europe
581,Sébastien Corchia,FRA,Nantes,Ligue 1,2022,31.0,1990.0,8.7,16,6,10,2,4,11,22,50.0,11,9,3,6,14,30,21,0,DF,30-34,Defender,France,Europe
582,Alex Cordaz,ITA,Inter,Serie A,2022,39.0,1983.0,0.3,0,0,0,0,0,0,0,,0,0,0,0,0,0,0,0,GK,35-39,Goalkeeper,Italy,Europe
583,Maxwel Cornet,CIV,West Ham,Premier League,2022,25.0,1996.0,2.7,7,3,5,0,2,4,6,66.7,2,6,0,6,2,9,3,0,FW,25-29,Forward,Ivory Coast,Africa
584,Jesús Corona,MEX,Sevilla,La Liga,2022,29.0,1993.0,1.2,1,0,1,0,0,0,1,0.0,1,0,0,0,1,2,1,0,FW,25-29,Forward,Mexico,North America
585,Ángel Correa,ARG,Atlético Madrid,La Liga,2022,27.0,1995.0,16.2,12,6,6,3,3,5,16,31.3,11,17,0,17,10,22,6,1,"FW,MF",25-29,Forward,Argentina,South America
586,Joaquín Correa,ARG,Inter,Serie A,2022,27.0,1994.0,10.6,12,7,3,6,3,4,15,26.7,11,4,1,3,3,15,0,0,FW,25-29,Forward,Argentina,South America
587,Thierry Correia,POR,Valencia,La Liga,2022,23.0,1999.0,22.3,71,52,46,22,3,31,54,57.4,23,25,2,23,24,95,54,2,DF,20-24,Defender,Portugal,Europe
588,Alessandro Cortinovis,ITA,Hellas Verona,Serie A,2022,21.0,2001.0,0.1,1,0,1,0,0,0,0,,0,1,0,1,0,1,0,0,MF,20-24,Midfielder,Italy,Europe
589,Danny da Costa,GER,Mainz 05,Bundesliga,2022,29.0,1993.0,13.7,20,16,7,8,5,12,20,60.0,8,22,3,19,9,29,26,0,DF,25-29,Defender,Germany,Europe
590,David Costa,POR,Lens,Ligue 1,2022,21.0,2001.0,15.6,13,7,1,10,2,7,19,36.8,12,19,1,18,11,24,6,0,"MF,FW",20-24,Midfielder,Portugal,Europe
593,Logan Costa,CPV,Toulouse,Ligue 1,2022,21.0,2001.0,4.6,9,4,7,1,1,6,9,66.7,3,6,3,3,4,13,12,0,DF,20-24,Defender,Cape Verde,Africa
594,Nuno da Costa,CPV,Auxerre,Ligue 1,2022,31.0,1991.0,22.3,45,23,14,23,8,11,46,23.9,35,21,1,20,20,65,15,0,"FW,MF",30-34,Forward,Cape Verde,Africa
595,Samu Costa,POR,Almería,La Liga,2022,21.0,2000.0,22.1,61,31,35,20,6,29,61,47.5,32,29,7,22,37,98,64,4,MF,20-24,Midfielder,Portugal,Europe
596,Benoît Costil,FRA,Auxerre,Ligue 1,2022,35.0,1987.0,19.0,2,0,2,0,0,2,4,50.0,2,0,0,0,0,2,5,0,GK,35-39,Goalkeeper,France,Europe
598,Lassana Coulibaly,MLI,Salernitana,Serie A,2022,26.0,1996.0,32.1,84,50,42,35,7,30,73,41.1,43,35,7,28,25,109,33,2,MF,25-29,Midfielder,Mali,Africa
599,Soumaïla Coulibaly,FRA,Dortmund,Bundesliga,2022,18.0,2003.0,0.5,0,0,0,0,0,0,0,,0,0,0,0,0,0,0,1,DF,Under 20,Defender,France,Europe
600,Tanguy Coulibaly,FRA,Stuttgart,Bundesliga,2022,21.0,2001.0,3.6,12,9,9,1,2,5,12,41.7,7,10,0,10,3,15,0,0,"FW,DF",20-24,Forward,France,Europe
601,Thibaut Courtois,BEL,Real Madrid,La Liga,2022,30.0,1992.0,31.0,1,0,1,0,0,1,1,100.0,0,0,0,0,3,4,7,1,GK,30-34,Goalkeeper,Belgium,Europe
602,Mathieu Coutadeur,FRA,Ajaccio,Ligue 1,2022,36.0,1986.0,21.6,23,13,13,10,0,8,28,28.6,20,19,3,16,19,42,21,0,MF,35-39,Midfielder,France,Europe
603,Philippe Coutinho,BRA,Aston Villa,Premier League,2022,30.0,1992.0,8.8,19,14,8,8,3,9,15,60.0,6,11,1,10,4,23,2,0,"MF,FW",30-34,Midfielder,Brazil,South America
604,Yan Couto,BRA,Girona,La Liga,2022,20.0,2002.0,12.9,25,18,11,11,3,12,20,60.0,8,7,2,5,5,30,10,0,"DF,MF",20-24,Defender,Brazil,South America
605,Conor Coventry,IRL,West Ham,Premier League,2022,22.0,2000.0,0.0,0,0,0,0,0,0,0,,0,0,0,0,0,0,0,0,"MF,FW",20-24,Midfielder,Republic of Ireland,Europe
606,Nicolas Cozza,FRA,Montpellier,Ligue 1,2022,23.0,1999.0,14.2,38,21,27,9,2,26,38,68.4,12,11,5,6,21,59,35,1,DF,20-24,Defender,France,Europe
607,Nicolas Cozza,FRA,Wolfsburg,Bundesliga,2022,23.0,1999.0,1.1,3,3,1,2,0,2,3,66.7,1,3,1,2,0,3,0,0,DF,20-24,Defender,France,Europe
608,Alessio Cragno,ITA,Monza,Serie A,2022,28.0,1994.0,1.0,0,0,0,0,0,0,1,0.0,1,0,0,0,0,0,0,0,GK,25-29,Goalkeeper,Italy,Europe
609,Matthew Craig,SCO,Tottenham,Premier League,2022,19.0,2003.0,0.2,4,1,2,2,0,0,0,,0,0,0,0,0,4,0,0,MF,Under 20,Midfielder,Scotland,Europe
610,Aaron Cresswell,ENG,West Ham,Premier League,2022,32.0,1989.0,24.8,21,11,12,7,2,12,31,38.7,19,21,11,10,27,48,56,0,DF,30-34,Defender,England,Europe
611,Bryan Cristante,ITA,Roma,Serie A,2022,27.0,1995.0,32.6,113,62,55,49,9,55,90,61.1,35,39,10,29,18,131,53,0,"MF,DF",25-29,Midfielder,Italy,Europe
615,Juan Cuadrado,COL,Juventus,Serie A,2022,34.0,1988.0,23.1,50,34,34,13,3,27,65,41.5,38,15,2,13,24,74,32,0,"DF,FW",30-34,Defender,Colombia,South America
618,Braian Cufré,ARG,Mallorca,La Liga,2022,25.0,1996.0,2.4,5,2,2,1,2,2,5,40.0,3,2,1,1,2,7,1,0,DF,25-29,Defender,Argentina,South America
619,Mickaël Cuisance,FRA,Sampdoria,Serie A,2022,22.0,1999.0,6.9,13,10,7,5,1,5,23,21.7,18,10,0,10,5,18,4,0,MF,20-24,Midfielder,France,Europe
620,Matheus Cunha,BRA,Wolves,Premier League,2022,23.0,1999.0,10.7,7,4,0,5,2,2,10,20.0,8,15,3,12,9,16,11,0,FW,20-24,Forward,Brazil,South America
621,Matheus Cunha,BRA,Atlético Madrid,La Liga,2022,23.0,1999.0,4.2,4,1,1,3,0,0,3,0.0,3,4,1,3,2,6,3,0,"FW,MF",20-24,Forward,Brazil,South America
623,Marco D'Alessandro,ITA,Monza,Serie A,2022,31.0,1991.0,3.2,4,4,3,1,0,2,5,40.0,3,2,0,2,1,5,3,0,"DF,FW",30-34,Defender,Italy,Europe
624,Danilo D'Ambrosio,ITA,Inter,Serie A,2022,33.0,1988.0,8.1,25,17,17,7,1,15,27,55.6,12,12,4,8,10,35,17,0,DF,30-34,Defender,Italy,Europe
625,Luca D'Andrea,ITA,Sassuolo,Serie A,2022,17.0,2004.0,3.5,4,0,2,1,1,1,4,25.0,3,2,0,2,1,5,1,0,FW,Under 20,Forward,Italy,Europe
626,Damien Da Silva,FRA,Lyon,Ligue 1,2022,34.0,1988.0,3.8,8,7,5,3,0,3,3,100.0,0,4,3,1,5,13,12,0,DF,30-34,Defender,France,Europe
627,Moanes Dabbur,ISR,Hoffenheim,Bundesliga,2022,30.0,1992.0,10.4,11,8,4,5,2,3,9,33.3,6,8,0,8,5,16,0,0,FW,30-34,Forward,Israel,Asia
628,Andréa Dacourt,FRA,Nice,Ligue 1,2022,17.0,2005.0,0.0,0,0,0,0,0,0,0,,0,0,0,0,0,0,0,0,MF,Under 20,Midfielder,France,Europe
629,Colin Dagba,FRA,Strasbourg,Ligue 1,2022,23.0,1998.0,10.6,32,20,17,10,5,19,26,73.1,7,18,2,16,17,49,19,0,"DF,MF",20-24,Defender,France,Europe
630,Finn Dahmen,GER,Mainz 05,Bundesliga,2022,24.0,1998.0,8.0,0,0,0,0,0,0,0,,0,0,0,0,0,0,3,0,GK,20-24,Goalkeeper,Germany,Europe
631,Mahmoud Dahoud,GER,Dortmund,Bundesliga,2022,26.0,1996.0,3.7,11,9,3,4,4,7,7,100.0,0,6,2,4,7,18,3,0,MF,25-29,Midfielder,Germany,Europe
632,Patson Daka,ZAM,Leicester City,Premier League,2022,23.0,1998.0,13.2,14,8,6,8,0,3,13,23.1,10,14,2,12,7,21,7,0,FW,20-24,Forward,Zambia,Africa
633,Thijs Dallinga,NED,Toulouse,Ligue 1,2022,21.0,2000.0,26.1,8,6,2,2,4,1,13,7.7,12,17,3,14,3,11,20,0,FW,20-24,Forward,Netherlands,Europe
634,Diogo Dalot,POR,Manchester Utd,Premier League,2022,23.0,1999.0,23.9,54,41,40,13,1,33,45,73.3,12,25,7,18,37,91,55,2,DF,20-24,Defender,Portugal,Europe
635,Muhammed Damar,GER,Hoffenheim,Bundesliga,2022,18.0,2004.0,1.8,6,3,1,2,3,1,2,50.0,1,3,0,3,0,6,0,0,MF,Under 20,Midfielder,Germany,Europe
636,Mikkel Damsgaard,DEN,Brentford,Premier League,2022,22.0,2000.0,11.0,31,21,13,13,5,15,42,35.7,27,20,2,18,10,41,14,0,"MF,FW",20-24,Midfielder,Denmark,Europe
637,Flavius Daniliuc,AUT,Salernitana,Serie A,2022,21.0,2001.0,24.4,57,29,37,17,3,26,47,55.3,21,30,13,17,29,86,76,0,DF,20-24,Defender,Austria,Europe
638,Flavius Daniliuc,AUT,Nice,Ligue 1,2022,21.0,2001.0,1.0,2,0,2,0,0,1,1,100.0,0,4,1,3,0,2,1,0,DF,20-24,Defender,Austria,Europe
639,Danilo,BRA,Nott'ham Forest,Premier League,2022,21.0,2001.0,10.8,18,7,7,9,2,6,25,24.0,19,26,6,20,9,27,19,0,MF,20-24,Midfielder,Brazil,South America
639,Danilo,BRA,Nott'ham Forest,Premier League,2022,21.0,2001.0,10.8,18,7,7,9,2,6,25,24.0,19,26,6,20,9,27,19,0,MF,20-24,Midfielder,Brazil,South America
639,Danilo,BRA,Nott'ham Forest,Premier League,2022,21.0,2001.0,10.8,18,7,7,9,2,6,25,24.0,19,26,6,20,9,27,19,0,MF,20-24,Midfielder,Brazil,South America
639,Danilo,BRA,Nott'ham Forest,Premier League,2022,21.0,2001.0,10.8,18,7,7,9,2,6,25,24.0,19,26,6,20,9,27,19,0,MF,20-24,Midfielder,Brazil,South America
639,Danilo,BRA,Nott'ham Forest,Premier League,2022,21.0,2001.0,10.8,18,7,7,9,2,6,25,24.0,19,26,6,20,9,27,19,0,MF,20-24,Midfielder,Brazil,South America
639,Danilo,BRA,Nott'ham Forest,Premier League,2022,21.0,2001.0,10.8,18,7,7,9,2,6,25,24.0,19,26,6,20,9,27,19,0,MF,20-24,Midfielder,Brazil,South America
639,Danilo,BRA,Nott'ham Forest,Premier League,2022,21.0,2001.0,10.8,18,7,7,9,2,6,25,24.0,19,26,6,20,9,27,19,0,MF,20-24,Midfielder,Brazil,South America
639,Danilo,BRA,Nott'ham Forest,Premier League,2022,21.0,2001.0,10.8,18,7,7,9,2,6,25,24.0,19,26,6,20,9,27,19,0,MF,20-24,Midfielder,Brazil,South America
639,Danilo,BRA,Nott'ham Forest,Premier League,2022,21.0,2001.0,10.8,18,7,7,9,2,6,25,24.0,19,26,6,20,9,27,19,0,MF,20-24,Midfielder,Brazil,South America
639,Danilo,BRA,Nott'ham Forest,Premier League,2022,21.0,2001.0,10.8,18,7,7,9,2,6,25,24.0,19,26,6,20,9,27,19,0,MF,20-24,Midfielder,Brazil,South America
639,Danilo,BRA,Nott'ham Forest,Premier League,2022,21.0,2001.0,10.8,18,7,7,9,2,6,25,24.0,19,26,6,20,9,27,19,0,MF,20-24,Midfielder,Brazil,South America
639,Danilo,BRA,Nott'ham Forest,Premier League,2022,21.0,2001.0,10.8,18,7,7,9,2,6,25,24.0,19,26,6,20,9,27,19,0,MF,20-24,Midfielder,Brazil,South America
639,Danilo,BRA,Nott'ham Forest,Premier League,2022,21.0,2001.0,10.8,18,7,7,9,2,6,25,24.0,19,26,6,20,9,27,19,0,MF,20-24,Midfielder,Brazil,South America
639,Danilo,BRA,Nott'ham Forest,Premier League,2022,21.0,2001.0,10.8,18,7,7,9,2,6,25,24.0,19,26,6,20,9,27,19,0,MF,20-24,Midfielder,Brazil,South America
639,Danilo,BRA,Nott'ham Forest,Premier League,2022,21.0,2001.0,10.8,18,7,7,9,2,6,25,24.0,19,26,6,20,9,27,19,0,MF,20-24,Midfielder,Brazil,South America
639,Danilo,BRA,Nott'ham Forest,Premier League,2022,21.0,2001.0,10.8,18,7,7,9,2,6,25,24.0,19,26,6,20,9,27,19,0,MF,20-24,Midfielder,Brazil,South America
639,Danilo,BRA,Nott'ham Forest,Premier League,2022,21.0,2001.0,10.8,18,7,7,9,2,6,25,24.0,19,26,6,20,9,27,19,0,MF,20-24,Midfielder,Brazil,South America
639,Danilo,BRA,Nott'ham Forest,Premier League,2022,21.0,2001.0,10.8,18,7,7,9,2,6,25,24.0,19,26,6,20,9,27,19,0,MF,20-24,Midfielder,Brazil,South America
639,Danilo,BRA,Nott'ham Forest,Premier League,2022,21.0,2001.0,10.8,18,7,7,9,2,6,25,24.0,19,26,6,20,9,27,19,0,MF,20-24,Midfielder,Brazil,South America
639,Danilo,BRA,Nott'ham Forest,Premier League,2022,21.0,2001.0,10.8,18,7,7,9,2,6,25,24.0,19,26,6,20,9,27,19,0,MF,20-24,Midfielder,Brazil,South America
639,Danilo,BRA,Nott'ham Forest,Premier League,2022,21.0,2001.0,10.8,18,7,7,9,2,6,25,24.0,19,26,6,20,9,27,19,0,MF,20-24,Midfielder,Brazil,South America
639,Danilo,BRA,Nott'ham Forest,Premier League,2022,21.0,2001.0,10.8,18,7,7,9,2,6,25,24.0,19,26,6,20,9,27,19,0,MF,20-24,Midfielder,Brazil,South America
639,Danilo,BRA,Nott'ham Forest,Premier League,2022,21.0,2001.0,10.8,18,7,7,9,2,6,25,24.0,19,26,6,20,9,27,19,0,MF,20-24,Midfielder,Brazil,South America
639,Danilo,BRA,Nott'ham Forest,Premier League,2022,21.0,2001.0,10.8,18,7,7,9,2,6,25,24.0,19,26,6,20,9,27,19,0,MF,20-24,Midfielder,Brazil,South America
639,Danilo,BRA,Nott'ham Forest,Premier League,2022,21.0,2001.0,10.8,18,7,7,9,2,6,25,24.0,19,26,6,20,9,27,19,0,MF,20-24,Midfielder,Brazil,South America
639,Danilo,BRA,Nott'ham Forest,Premier League,2022,21.0,2001.0,10.8,18,7,7,9,2,6,25,24.0,19,26,6,20,9,27,19,0,MF,20-24,Midfielder,Brazil,South America
639,Danilo,BRA,Nott'ham Forest,Premier League,2022,21.0,2001.0,10.8,18,7,7,9,2,6,25,24.0,19,26,6,20,9,27,19,0,MF,20-24,Midfielder,Brazil,South America
639,Danilo,BRA,Nott'ham Forest,Premier League,2022,21.0,2001.0,10.8,18,7,7,9,2,6,25,24.0,19,26,6,20,9,27,19,0,MF,20-24,Midfielder,Brazil,South America
639,Danilo,BRA,Nott'ham Forest,Premier League,2022,21.0,2001.0,10.8,18,7,7,9,2,6,25,24.0,19,26,6,20,9,27,19,0,MF,20-24,Midfielder,Brazil,South America
639,Danilo,BRA,Nott'ham Forest,Premier League,2022,21.0,2001.0,10.8,18,7,7,9,2,6,25,24.0,19,26,6,20,9,27,19,0,MF,20-24,Midfielder,Brazil,South America
639,Danilo,BRA,Nott'ham Forest,Premier League,2022,21.0,2001.0,10.8,18,7,7,9,2,6,25,24.0,19,26,6,20,9,27,19,0,MF,20-24,Midfielder,Brazil,South America
639,Danilo,BRA,Nott'ham Forest,Premier League,2022,21.0,2001.0,10.8,18,7,7,9,2,6,25,24.0,19,26,6,20,9,27,19,0,MF,20-24,Midfielder,Brazil,South America
639,Danilo,BRA,Nott'ham Forest,Premier League,2022,21.0,2001.0,10.8,18,7,7,9,2,6,25,24.0,19,26,6,20,9,27,19,0,MF,20-24,Midfielder,Brazil,South America
639,Danilo,BRA,Nott'ham Forest,Premier League,2022,21.0,2001.0,10.8,18,7,7,9,2,6,25,24.0,19,26,6,20,9,27,19,0,MF,20-24,Midfielder,Brazil,South America
639,Danilo,BRA,Nott'ham Forest,Premier League,2022,21.0,2001.0,10.8,18,7,7,9,2,6,25,24.0,19,26,6,20,9,27,19,0,MF,20-24,Midfielder,Brazil,South America
639,Danilo,BRA,Nott'ham Forest,Premier League,2022,21.0,2001.0,10.8,18,7,7,9,2,6,25,24.0,19,26,6,20,9,27,19,0,MF,20-24,Midfielder,Brazil,South America
639,Danilo,BRA,Nott'ham Forest,Premier League,2022,21.0,2001.0,10.8,18,7,7,9,2,6,25,24.0,19,26,6,20,9,27,19,0,MF,20-24,Midfielder,Brazil,South America
639,Danilo,BRA,Nott'ham Forest,Premier League,2022,21.0,2001.0,10.8,18,7,7,9,2,6,25,24.0,19,26,6,20,9,27,19,0,MF,20-24,Midfielder,Brazil,South America
639,Danilo,BRA,Nott'ham Forest,Premier League,2022,21.0,2001.0,10.8,18,7,7,9,2,6,25,24.0,19,26,6,20,9,27,19,0,MF,20-24,Midfielder,Brazil,South America
639,Danilo,BRA,Nott'ham Forest,Premier League,2022,21.0,2001.0,10.8,18,7,7,9,2,6,25,24.0,19,26,6,20,9,27,19,0,MF,20-24,Midfielder,Brazil,South America
639,Danilo,BRA,Nott'ham Forest,Premier League,2022,21.0,2001.0,10.8,18,7,7,9,2,6,25,24.0,19,26,6,20,9,27,19,0,MF,20-24,Midfielder,Brazil,South America
639,Danilo,BRA,Nott'ham Forest,Premier League,2022,21.0,2001.0,10.8,18,7,7,9,2,6,25,24.0,19,26,6,20,9,27,19,0,MF,20-24,Midfielder,Brazil,South America
639,Danilo,BRA,Nott'ham Forest,Premier League,2022,21.0,2001.0,10.8,18,7,7,9,2,6,25,24.0,19,26,6,20,9,27,19,0,MF,20-24,Midfielder,Brazil,South America
639,Danilo,BRA,Nott'ham Forest,Premier League,2022,21.0,2001.0,10.8,18,7,7,9,2,6,25,24.0,19,26,6,20,9,27,19,0,MF,20-24,Midfielder,Brazil,South America
639,Danilo,BRA,Nott'ham Forest,Premier League,2022,21.0,2001.0,10.8,18,7,7,9,2,6,25,24.0,19,26,6,20,9,27,19,0,MF,20-24,Midfielder,Brazil,South America
639,Danilo,BRA,Nott'ham Forest,Premier League,2022,21.0,2001.0,10.8,18,7,7,9,2,6,25,24.0,19,26,6,20,9,27,19,0,MF,20-24,Midfielder,Brazil,South America
639,Danilo,BRA,Nott'ham Forest,Premier League,2022,21.0,2001.0,10.8,18,7,7,9,2,6,25,24.0,19,26,6,20,9,27,19,0,MF,20-24,Midfielder,Brazil,South America
639,Danilo,BRA,Nott'ham Forest,Premier League,2022,21.0,2001.0,10.8,18,7,7,9,2,6,25,24.0,19,26,6,20,9,27,19,0,MF,20-24,Midfielder,Brazil,South America
639,Danilo,BRA,Nott'ham Forest,Premier League,2022,21.0,2001.0,10.8,18,7,7,9,2,6,25,24.0,19,26,6,20,9,27,19,0,MF,20-24,Midfielder,Brazil,South America
640,Danilo,BRA,Juventus,Serie A,2022,31.0,1991.0,35.4,92,62,61,23,8,52,73,71.2,21,39,20,19,47,139,114,1,DF,30-34,Defender,Brazil,South America
640,Danilo,BRA,Juventus,Serie A,2022,31.0,1991.0,35.4,92,62,61,23,8,52,73,71.2,21,39,20,19,47,139,114,1,DF,30-34,Defender,Brazil,South America
640,Danilo,BRA,Juventus,Serie A,2022,31.0,1991.0,35.4,92,62,61,23,8,52,73,71.2,21,39,20,19,47,139,114,1,DF,30-34,Defender,Brazil,South America
640,Danilo,BRA,Juventus,Serie A,2022,31.0,1991.0,35.4,92,62,61,23,8,52,73,71.2,21,39,20,19,47,139,114,1,DF,30-34,Defender,Brazil,South America
640,Danilo,BRA,Juventus,Serie A,2022,31.0,1991.0,35.4,92,62,61,23,8,52,73,71.2,21,39,20,19,47,139,114,1,DF,30-34,Defender,Brazil,South America
640,Danilo,BRA,Juventus,Serie A,2022,31.0,1991.0,35.4,92,62,61,23,8,52,73,71.2,21,39,20,19,47,139,114,1,DF,30-34,Defender,Brazil,South America
640,Danilo,BRA,Juventus,Serie A,2022,31.0,1991.0,35.4,92,62,61,23,8,52,73,71.2,21,39,20,19,47,139,114,1,DF,30-34,Defender,Brazil,South America
640,Danilo,BRA,Juventus,Serie A,2022,31.0,1991.0,35.4,92,62,61,23,8,52,73,71.2,21,39,20,19,47,139,114,1,DF,30-34,Defender,Brazil,South America
640,Danilo,BRA,Juventus,Serie A,2022,31.0,1991.0,35.4,92,62,61,23,8,52,73,71.2,21,39,20,19,47,139,114,1,DF,30-34,Defender,Brazil,South America
640,Danilo,BRA,Juventus,Serie A,2022,31.0,1991.0,35.4,92,62,61,23,8,52,73,71.2,21,39,20,19,47,139,114,1,DF,30-34,Defender,Brazil,South America
640,Danilo,BRA,Juventus,Serie A,2022,31.0,1991.0,35.4,92,62,61,23,8,52,73,71.2,21,39,20,19,47,139,114,1,DF,30-34,Defender,Brazil,South America
640,Danilo,BRA,Juventus,Serie A,2022,31.0,1991.0,35.4,92,62,61,23,8,52,73,71.2,21,39,20,19,47,139,114,1,DF,30-34,Defender,Brazil,South America
640,Danilo,BRA,Juventus,Serie A,2022,31.0,1991.0,35.4,92,62,61,23,8,52,73,71.2,21,39,20,19,47,139,114,1,DF,30-34,Defender,Brazil,South America
640,Danilo,BRA,Juventus,Serie A,2022,31.0,1991.0,35.4,92,62,61,23,8,52,73,71.2,21,39,20,19,47,139,114,1,DF,30-34,Defender,Brazil,South America
640,Danilo,BRA,Juventus,Serie A,2022,31.0,1991.0,35.4,92,62,61,23,8,52,73,71.2,21,39,20,19,47,139,114,1,DF,30-34,Defender,Brazil,South America
640,Danilo,BRA,Juventus,Serie A,2022,31.0,1991.0,35.4,92,62,61,23,8,52,73,71.2,21,39,20,19,47,139,114,1,DF,30-34,Defender,Brazil,South America
640,Danilo,BRA,Juventus,Serie A,2022,31.0,1991.0,35.4,92,62,61,23,8,52,73,71.2,21,39,20,19,47,139,114,1,DF,30-34,Defender,Brazil,South America
640,Danilo,BRA,Juventus,Serie A,2022,31.0,1991.0,35.4,92,62,61,23,8,52,73,71.2,21,39,20,19,47,139,114,1,DF,30-34,Defender,Brazil,South America
640,Danilo,BRA,Juventus,Serie A,2022,31.0,1991.0,35.4,92,62,61,23,8,52,73,71.2,21,39,20,19,47,139,114,1,DF,30-34,Defender,Brazil,South America
640,Danilo,BRA,Juventus,Serie A,2022,31.0,1991.0,35.4,92,62,61,23,8,52,73,71.2,21,39,20,19,47,139,114,1,DF,30-34,Defender,Brazil,South America
640,Danilo,BRA,Juventus,Serie A,2022,31.0,1991.0,35.4,92,62,61,23,8,52,73,71.2,21,39,20,19,47,139,114,1,DF,30-34,Defender,Brazil,South America
640,Danilo,BRA,Juventus,Serie A,2022,31.0,1991.0,35.4,92,62,61,23,8,52,73,71.2,21,39,20,19,47,139,114,1,DF,30-34,Defender,Brazil,South America
640,Danilo,BRA,Juventus,Serie A,2022,31.0,1991.0,35.4,92,62,61,23,8,52,73,71.2,21,39,20,19,47,139,114,1,DF,30-34,Defender,Brazil,South America
640,Danilo,BRA,Juventus,Serie A,2022,31.0,1991.0,35.4,92,62,61,23,8,52,73,71.2,21,39,20,19,47,139,114,1,DF,30-34,Defender,Brazil,South America
640,Danilo,BRA,Juventus,Serie A,2022,31.0,1991.0,35.4,92,62,61,23,8,52,73,71.2,21,39,20,19,47,139,114,1,DF,30-34,Defender,Brazil,South America
640,Danilo,BRA,Juventus,Serie A,2022,31.0,1991.0,35.4,92,62,61,23,8,52,73,71.2,21,39,20,19,47,139,114,1,DF,30-34,Defender,Brazil,South America
640,Danilo,BRA,Juventus,Serie A,2022,31.0,1991.0,35.4,92,62,61,23,8,52,73,71.2,21,39,20,19,47,139,114,1,DF,30-34,Defender,Brazil,South America
640,Danilo,BRA,Juventus,Serie A,2022,31.0,1991.0,35.4,92,62,61,23,8,52,73,71.2,21,39,20,19,47,139,114,1,DF,30-34,Defender,Brazil,South America
640,Danilo,BRA,Juventus,Serie A,2022,31.0,1991.0,35.4,92,62,61,23,8,52,73,71.2,21,39,20,19,47,139,114,1,DF,30-34,Defender,Brazil,South America
640,Danilo,BRA,Juventus,Serie A,2022,31.0,1991.0,35.4,92,62,61,23,8,52,73,71.2,21,39,20,19,47,139,114,1,DF,30-34,Defender,Brazil,South America
640,Danilo,BRA,Juventus,Serie A,2022,31.0,1991.0,35.4,92,62,61,23,8,52,73,71.2,21,39,20,19,47,139,114,1,DF,30-34,Defender,Brazil,South America
640,Danilo,BRA,Juventus,Serie A,2022,31.0,1991.0,35.4,92,62,61,23,8,52,73,71.2,21,39,20,19,47,139,114,1,DF,30-34,Defender,Brazil,South America
640,Danilo,BRA,Juventus,Serie A,2022,31.0,1991.0,35.4,92,62,61,23,8,52,73,71.2,21,39,20,19,47,139,114,1,DF,30-34,Defender,Brazil,South America
640,Danilo,BRA,Juventus,Serie A,2022,31.0,1991.0,35.4,92,62,61,23,8,52,73,71.2,21,39,20,19,47,139,114,1,DF,30-34,Defender,Brazil,South America
640,Danilo,BRA,Juventus,Serie A,2022,31.0,1991.0,35.4,92,62,61,23,8,52,73,71.2,21,39,20,19,47,139,114,1,DF,30-34,Defender,Brazil,South America
640,Danilo,BRA,Juventus,Serie A,2022,31.0,1991.0,35.4,92,62,61,23,8,52,73,71.2,21,39,20,19,47,139,114,1,DF,30-34,Defender,Brazil,South America
640,Danilo,BRA,Juventus,Serie A,2022,31.0,1991.0,35.4,92,62,61,23,8,52,73,71.2,21,39,20,19,47,139,114,1,DF,30-34,Defender,Brazil,South America
640,Danilo,BRA,Juventus,Serie A,2022,31.0,1991.0,35.4,92,62,61,23,8,52,73,71.2,21,39,20,19,47,139,114,1,DF,30-34,Defender,Brazil,South America
640,Danilo,BRA,Juventus,Serie A,2022,31.0,1991.0,35.4,92,62,61,23,8,52,73,71.2,21,39,20,19,47,139,114,1,DF,30-34,Defender,Brazil,South America
640,Danilo,BRA,Juventus,Serie A,2022,31.0,1991.0,35.4,92,62,61,23,8,52,73,71.2,21,39,20,19,47,139,114,1,DF,30-34,Defender,Brazil,South America
640,Danilo,BRA,Juventus,Serie A,2022,31.0,1991.0,35.4,92,62,61,23,8,52,73,71.2,21,39,20,19,47,139,114,1,DF,30-34,Defender,Brazil,South America
640,Danilo,BRA,Juventus,Serie A,2022,31.0,1991.0,35.4,92,62,61,23,8,52,73,71.2,21,39,20,19,47,139,114,1,DF,30-34,Defender,Brazil,South America
640,Danilo,BRA,Juventus,Serie A,2022,31.0,1991.0,35.4,92,62,61,23,8,52,73,71.2,21,39,20,19,47,139,114,1,DF,30-34,Defender,Brazil,South America
640,Danilo,BRA,Juventus,Serie A,2022,31.0,1991.0,35.4,92,62,61,23,8,52,73,71.2,21,39,20,19,47,139,114,1,DF,30-34,Defender,Brazil,South America
640,Danilo,BRA,Juventus,Serie A,2022,31.0,1991.0,35.4,92,62,61,23,8,52,73,71.2,21,39,20,19,47,139,114,1,DF,30-34,Defender,Brazil,South America
640,Danilo,BRA,Juventus,Serie A,2022,31.0,1991.0,35.4,92,62,61,23,8,52,73,71.2,21,39,20,19,47,139,114,1,DF,30-34,Defender,Brazil,South America
640,Danilo,BRA,Juventus,Serie A,2022,31.0,1991.0,35.4,92,62,61,23,8,52,73,71.2,21,39,20,19,47,139,114,1,DF,30-34,Defender,Brazil,South America
640,Danilo,BRA,Juventus,Serie A,2022,31.0,1991.0,35.4,92,62,61,23,8,52,73,71.2,21,39,20,19,47,139,114,1,DF,30-34,Defender,Brazil,South America
640,Danilo,BRA,Juventus,Serie A,2022,31.0,1991.0,35.4,92,62,61,23,8,52,73,71.2,21,39,20,19,47,139,114,1,DF,30-34,Defender,Brazil,South America
641,Arnaut Danjuma,NED,Tottenham,Premier League,2022,25.0,1997.0,1.9,2,0,1,1,0,0,0,,0,1,0,1,0,2,0,0,"FW,MF",25-29,Forward,Netherlands,Europe
642,Arnaut Danjuma,NED,Villarreal,La Liga,2022,25.0,1997.0,5.3,3,3,1,0,2,1,2,50.0,1,0,0,0,0,3,1,1,FW,25-29,Forward,Netherlands,Europe
643,Kévin Danois,FRA,Auxerre,Ligue 1,2022,18.0,2004.0,0.0,1,1,0,1,0,0,0,,0,0,0,0,1,2,0,0,MF,Under 20,Midfielder,France,Europe
644,Kevin Danso,AUT,Lens,Ligue 1,2022,23.0,1998.0,35.9,37,19,25,11,1,19,30,63.3,11,48,34,14,33,70,124,0,DF,20-24,Defender,Austria,Europe
645,Dante,BRA,Nice,Ligue 1,2022,38.0,1983.0,36.7,70,40,45,21,4,36,59,61.0,23,52,31,21,47,117,125,2,DF,35-39,Defender,Brazil,South America
646,Márton Dárdai,HUN,Hertha BSC,Bundesliga,2022,20.0,2002.0,10.5,17,8,9,8,0,9,18,50.0,9,14,9,5,11,28,45,1,"DF,MF",20-24,Defender,Hungary,Europe
648,Achraf Dari,MAR,Brest,Ligue 1,2022,23.0,1999.0,14.6,21,14,15,5,1,14,20,70.0,6,16,10,6,19,40,65,2,DF,20-24,Defender,Morocco,Africa
650,Matteo Darmian,ITA,Inter,Serie A,2022,32.0,1989.0,22.5,56,30,29,15,12,31,47,66.0,16,33,5,28,21,77,36,0,DF,30-34,Defender,Italy,Europe
651,Josh Dasilva,ENG,Brentford,Premier League,2022,23.0,1998.0,15.4,18,9,6,6,6,6,15,40.0,9,22,6,16,5,23,7,1,MF,20-24,Midfielder,England,Europe
652,David Datro Fofana,CIV,Chelsea,Premier League,2022,19.0,2002.0,0.8,3,1,1,1,1,1,1,100.0,0,1,0,1,0,3,0,0,FW,Under 20,Forward,Ivory Coast,Africa
653,Juan David Cabal,COL,Hellas Verona,Serie A,2022,21.0,2001.0,4.9,10,6,7,3,0,7,12,58.3,5,8,5,3,13,23,12,0,DF,20-24,Defender,Colombia,South America
654,Jonathan David,CAN,Lille,Ligue 1,2022,22.0,2000.0,35.2,24,17,6,11,7,10,27,37.0,17,20,2,18,8,32,13,0,FW,20-24,Forward,Canada,North America
655,Alphonso Davies,CAN,Bayern Munich,Bundesliga,2022,21.0,2000.0,22.7,45,28,25,13,7,18,39,46.2,21,28,4,24,24,69,24,4,DF,20-24,Defender,Canada,North America
656,Ben Davies,WAL,Tottenham,Premier League,2022,29.0,1993.0,25.4,28,11,13,13,2,14,26,53.8,12,17,8,9,18,46,72,0,DF,25-29,Defender,Wales,Europe
656,Ben Davies,WAL,Tottenham,Premier League,2022,29.0,1993.0,25.4,28,11,13,13,2,14,26,53.8,12,17,8,9,18,46,72,0,DF,25-29,Defender,Wales,Europe
656,Ben Davies,WAL,Tottenham,Premier League,2022,29.0,1993.0,25.4,28,11,13,13,2,14,26,53.8,12,17,8,9,18,46,72,0,DF,25-29,Defender,Wales,Europe
656,Ben Davies,WAL,Tottenham,Premier League,2022,29.0,1993.0,25.4,28,11,13,13,2,14,26,53.8,12,17,8,9,18,46,72,0,DF,25-29,Defender,Wales,Europe
657,Tom Davies,ENG,Everton,Premier League,2022,24.0,1998.0,6.0,15,9,5,9,1,7,14,50.0,7,10,1,9,4,19,7,1,MF,20-24,Midfielder,England,Europe
657,Tom Davies,ENG,Everton,Premier League,2022,24.0,1998.0,6.0,15,9,5,9,1,7,14,50.0,7,10,1,9,4,19,7,1,MF,20-24,Midfielder,England,Europe
657,Tom Davies,ENG,Everton,Premier League,2022,24.0,1998.0,6.0,15,9,5,9,1,7,14,50.0,7,10,1,9,4,19,7,1,MF,20-24,Midfielder,England,Europe
657,Tom Davies,ENG,Everton,Premier League,2022,24.0,1998.0,6.0,15,9,5,9,1,7,14,50.0,7,10,1,9,4,19,7,1,MF,20-24,Midfielder,England,Europe
659,Craig Dawson,ENG,West Ham,Premier League,2022,32.0,1990.0,8.0,11,7,9,2,0,5,7,71.4,2,9,6,3,6,17,26,0,DF,30-34,Defender,England,Europe
660,Craig Dawson,ENG,Wolves,Premier League,2022,32.0,1990.0,15.7,9,6,6,3,0,4,7,57.1,3,31,23,8,12,21,74,2,DF,30-34,Defender,England,Europe
661,Kevin De Bruyne,BEL,Manchester City,Premier League,2022,31.0,1991.0,26.9,28,12,3,12,13,14,39,35.9,25,27,2,25,9,37,10,0,MF,30-34,Midfielder,Belgium,Europe
662,Charles De Ketelaere,BEL,Milan,Serie A,2022,21.0,2001.0,12.4,26,12,7,14,5,13,30,43.3,17,14,2,12,4,30,9,0,"MF,FW",20-24,Midfielder,Belgium,Europe
663,Manuel De Luca,ITA,Sampdoria,Serie A,2022,24.0,1998.0,0.5,0,0,0,0,0,0,0,,0,0,0,0,0,0,0,0,"FW,MF",20-24,Forward,Italy,Europe
664,Tommaso De Nipoti,ITA,Atalanta,Serie A,2022,19.0,2003.0,0.0,1,0,0,1,0,0,0,,0,0,0,0,0,1,0,0,MF,Under 20,Midfielder,Italy,Europe
665,Rodrigo De Paul,ARG,Atlético Madrid,La Liga,2022,28.0,1994.0,21.4,35,21,11,18,6,18,35,51.4,17,20,3,17,8,43,7,0,MF,25-29,Midfielder,Argentina,South America
666,Mattia De Sciglio,ITA,Juventus,Serie A,2022,29.0,1992.0,11.6,14,7,8,3,3,9,14,64.3,5,9,3,6,4,18,20,0,DF,25-29,Defender,Italy,Europe
667,Lorenzo De Silvestri,ITA,Bologna,Serie A,2022,34.0,1988.0,7.5,3,2,2,0,1,3,7,42.9,4,6,5,1,3,6,20,0,DF,30-34,Defender,Italy,Europe
668,Thibault De Smet,BEL,Reims,Ligue 1,2022,24.0,1998.0,19.5,24,17,10,14,0,11,37,29.7,26,28,5,23,20,44,40,1,DF,20-24,Defender,Belgium,Europe
669,Koni De Winter,BEL,Empoli,Serie A,2022,20.0,2002.0,11.4,14,9,11,3,0,5,13,38.5,8,14,12,2,6,20,65,0,DF,20-24,Defender,Belgium,Europe
671,Duccio Degl'Innocenti,ITA,Empoli,Serie A,2022,19.0,2003.0,0.0,0,0,0,0,0,0,0,,0,0,0,0,1,1,0,0,MF,Under 20,Midfielder,Italy,Europe
672,Brecht Dejaegere,BEL,Toulouse,Ligue 1,2022,31.0,1991.0,20.1,40,23,10,20,10,15,51,29.4,36,25,5,20,14,54,11,0,MF,30-34,Midfielder,Belgium,Europe
673,Romain Del Castillo,FRA,Brest,Ligue 1,2022,26.0,1996.0,15.8,39,24,13,17,9,16,36,44.4,20,14,1,13,11,50,5,0,"MF,FW",25-29,Midfielder,France,Europe
675,Thomas Delaine,FRA,Strasbourg,Ligue 1,2022,30.0,1992.0,11.9,28,14,16,6,6,13,26,50.0,13,8,3,5,16,44,9,0,"DF,MF",30-34,Defender,France,Europe
676,Thomas Delaney,DEN,Sevilla,La Liga,2022,30.0,1991.0,3.4,4,2,0,4,0,3,5,60.0,2,3,2,1,4,8,3,0,MF,30-34,Midfielder,Denmark,Europe
677,Thomas Delaney,DEN,Hoffenheim,Bundesliga,2022,30.0,1991.0,3.3,6,3,3,2,1,3,8,37.5,5,5,0,5,1,7,4,0,MF,30-34,Midfielder,Denmark,Europe
678,Sacha Delaye,FRA,Montpellier,Ligue 1,2022,20.0,2002.0,0.2,1,0,0,0,1,1,1,100.0,0,0,0,0,0,1,0,0,"FW,MF",20-24,Forward,France,Europe
680,Andy Delort,ALG,Nice,Ligue 1,2022,30.0,1991.0,8.7,2,0,1,1,0,1,2,50.0,1,0,0,0,1,3,7,0,FW,30-34,Forward,Algeria,Africa
681,Andy Delort,ALG,Nantes,Ligue 1,2022,30.0,1991.0,5.2,5,4,1,2,2,2,6,33.3,4,3,0,3,0,5,2,0,FW,30-34,Forward,Algeria,Africa
682,Karamoko Dembélé,ENG,Brest,Ligue 1,2022,19.0,2003.0,2.0,2,0,1,1,0,2,2,100.0,0,1,0,1,1,3,0,0,"FW,MF",Under 20,Forward,England,Europe
683,Moussa Dembélé,FRA,Lyon,Ligue 1,2022,26.0,1996.0,9.7,8,4,3,3,2,4,7,57.1,3,5,0,5,2,10,6,0,"FW,MF",25-29,Forward,France,Europe
684,Ousmane Dembélé,FRA,Barcelona,La Liga,2022,25.0,1997.0,15.7,19,12,4,8,7,4,15,26.7,11,10,1,9,0,19,2,0,FW,25-29,Forward,France,Europe
685,Siriki Dembélé,CIV,Bournemouth,Premier League,2022,25.0,1996.0,1.2,3,1,2,1,0,0,1,0.0,1,1,0,1,1,4,1,0,"FW,MF",25-29,Forward,Ivory Coast,Africa
686,Siriki Dembélé,CIV,Auxerre,Ligue 1,2022,25.0,1996.0,4.1,10,6,4,3,3,4,12,33.3,8,2,0,2,1,11,2,0,"MF,FW",25-29,Midfielder,Ivory Coast,Africa
687,Merih Demiral,TUR,Atalanta,Serie A,2022,24.0,1998.0,17.1,41,29,30,11,0,26,36,72.2,10,24,7,17,24,65,57,1,DF,20-24,Defender,Turkey,Asia
688,Kerem Demirbay,GER,Leverkusen,Bundesliga,2022,29.0,1993.0,17.2,36,18,16,17,3,18,34,52.9,16,26,6,20,16,52,11,0,MF,25-29,Midfielder,Germany,Europe
689,Ermedin Demirović,BIH,Augsburg,Bundesliga,2022,24.0,1998.0,26.3,31,14,9,12,10,9,22,40.9,13,31,4,27,14,45,37,0,"FW,MF",20-24,Forward,Bosnia and Herzegovina,Europe
690,Diego Demme,GER,Napoli,Serie A,2022,30.0,1991.0,1.6,1,0,1,0,0,0,4,0.0,4,2,0,2,0,1,1,0,MF,30-34,Midfielder,Germany,Europe
691,Sepp van den Berg,NED,Schalke 04,Bundesliga,2022,20.0,2001.0,7.7,5,4,2,2,1,1,4,25.0,3,8,5,3,13,18,33,2,DF,20-24,Defender,Netherlands,Europe
692,Branco van den Boomen,NED,Toulouse,Ligue 1,2022,27.0,1995.0,32.1,71,36,26,32,13,36,89,40.4,53,27,4,23,10,81,27,2,MF,25-29,Midfielder,Netherlands,Europe
693,Leander Dendoncker,BEL,Aston Villa,Premier League,2022,27.0,1995.0,7.7,19,9,11,6,2,11,22,50.0,11,19,4,15,10,29,12,0,MF,25-29,Midfielder,Belgium,Europe
694,Leander Dendoncker,BEL,Wolves,Premier League,2022,27.0,1995.0,2.4,4,2,0,3,1,2,3,66.7,1,2,0,2,9,13,4,0,MF,25-29,Midfielder,Belgium,Europe
695,Emmanuel Dennis,NGA,Nott'ham Forest,Premier League,2022,24.0,1997.0,8.0,17,11,5,5,7,8,18,44.4,10,13,1,12,2,19,6,0,"FW,MF",20-24,Forward,Nigeria,Africa
696,Fabio Depaoli,ITA,Hellas Verona,Serie A,2022,25.0,1997.0,24.1,48,28,25,16,7,25,44,56.8,19,32,6,26,18,66,33,3,DF,25-29,Defender,Italy,Europe
697,Fabio Depaoli,ITA,Sampdoria,Serie A,2022,25.0,1997.0,1.5,5,3,2,3,0,3,4,75.0,1,1,0,1,1,6,4,0,"DF,MF",25-29,Defender,Italy,Europe
698,Kastriot Dermaku,ALB,Lecce,Serie A,2022,30.0,1992.0,0.4,0,0,0,0,0,0,0,,0,0,0,0,0,0,0,0,DF,30-34,Defender,Albania,Europe
699,Halil Dervişoğlu,TUR,Brentford,Premier League,2022,22.0,1999.0,0.1,0,0,0,0,0,0,1,0.0,1,0,0,0,0,0,0,0,MF,20-24,Midfielder,Turkey,Asia
700,Rémy Descamps,FRA,Nantes,Ligue 1,2022,26.0,1996.0,1.0,0,0,0,0,0,0,0,,0,0,0,0,0,0,0,0,GK,25-29,Goalkeeper,France,Europe
701,Mikkel Desler,DEN,Toulouse,Ligue 1,2022,27.0,1995.0,25.1,71,38,36,27,8,43,67,64.2,24,35,6,29,36,107,48,2,DF,25-29,Defender,Denmark,Europe
702,Cyriel Dessers,NGA,Cremonese,Serie A,2022,27.0,1994.0,17.6,11,4,4,4,3,2,6,33.3,4,14,2,12,3,14,5,0,FW,25-29,Forward,Nigeria,Africa
703,Sergiño Dest,USA,Milan,Serie A,2022,21.0,2000.0,3.7,12,6,3,5,4,3,4,75.0,1,1,0,1,4,16,2,0,DF,20-24,Defender,United States,North America
704,Mattia Destro,ITA,Empoli,Serie A,2022,31.0,1991.0,6.4,1,1,0,1,0,0,0,,0,2,0,2,1,2,5,0,"FW,MF",30-34,Forward,Italy,Europe
706,Kiernan Dewsbury-Hall,ENG,Leicester City,Premier League,2022,23.0,1998.0,25.6,53,29,14,34,5,19,47,40.4,28,55,13,42,28,81,21,0,MF,20-24,Midfielder,England,Europe
707,Samuel Di Carmine,ITA,Cremonese,Serie A,2022,33.0,1988.0,0.3,0,0,0,0,0,0,0,,0,0,0,0,0,0,0,0,"FW,MF",30-34,Forward,Italy,Europe
708,Federico Di Francesco,ITA,Lecce,Serie A,2022,28.0,1994.0,22.6,28,16,7,11,10,9,19,47.4,10,16,0,16,8,36,14,0,"FW,MF",25-29,Forward,Italy,Europe
709,Michele Di Gregorio,ITA,Monza,Serie A,2022,25.0,1997.0,37.0,0,0,0,0,0,0,3,0.0,3,1,0,1,4,4,18,3,GK,25-29,Goalkeeper,Italy,Europe
710,Giovanni Di Lorenzo,ITA,Napoli,Serie A,2022,28.0,1993.0,36.2,60,29,33,19,8,25,49,51.0,24,30,9,21,30,90,60,0,DF,25-29,Defender,Italy,Europe
711,Ángel Di María,ARG,Juventus,Serie A,2022,34.0,1988.0,15.1,10,5,3,5,2,3,19,15.8,16,15,0,15,7,17,0,0,"FW,MF",30-34,Forward,Argentina,South America
712,Boulaye Dia,SEN,Salernitana,Serie A,2022,25.0,1996.0,28.0,12,5,3,6,3,2,7,28.6,5,10,0,10,7,19,27,1,"FW,MF",25-29,Forward,Senegal,Africa
713,Moussa Diaby,FRA,Leverkusen,Bundesliga,2022,23.0,1999.0,30.0,14,8,4,8,2,7,14,50.0,7,8,0,8,5,19,3,0,"FW,MF",20-24,Forward,France,Europe
714,Mouctar Diakhaby,GUI,Valencia,La Liga,2022,25.0,1996.0,27.2,30,16,19,11,0,13,20,65.0,7,30,17,13,20,50,111,2,DF,25-29,Defender,Guinea,Africa
715,Mamadou Diakhon,FRA,Reims,Ligue 1,2022,16.0,2005.0,0.2,2,0,2,0,0,0,1,0.0,1,1,0,1,1,3,0,0,FW,Under 20,Forward,France,Europe
716,Bafodé Diakité,FRA,Lille,Ligue 1,2022,21.0,2001.0,29.5,54,35,23,24,7,32,57,56.1,25,37,8,29,17,71,58,0,DF,20-24,Defender,France,Europe
717,Ibrahim Diakité,GUI,Reims,Ligue 1,2022,18.0,2003.0,1.5,3,3,3,0,0,2,3,66.7,1,0,0,0,5,8,6,0,DF,Under 20,Defender,Guinea,Africa
718,Abdou Diallo,SEN,RB Leipzig,Bundesliga,2022,26.0,1996.0,5.3,6,5,5,1,0,1,3,33.3,2,8,5,3,8,14,22,0,"DF,MF",25-29,Defender,Senegal,Africa
719,Baila Diallo,FRA,Clermont Foot,Ligue 1,2022,21.0,2001.0,1.0,1,0,1,0,0,0,0,,0,1,1,0,0,1,1,0,"DF,MF",20-24,Defender,France,Europe
720,Habib Diallo,SEN,Strasbourg,Ligue 1,2022,27.0,1995.0,32.0,18,10,8,7,3,6,16,37.5,10,19,4,15,12,30,26,0,FW,25-29,Forward,Senegal,Africa
721,Ibrahima Diallo,FRA,Southampton,Premier League,2022,23.0,1999.0,9.1,25,15,14,10,1,8,14,57.1,6,11,1,10,6,31,11,0,MF,20-24,Midfielder,France,Europe
721,Ibrahima Diallo,FRA,Southampton,Premier League,2022,23.0,1999.0,9.1,25,15,14,10,1,8,14,57.1,6,11,1,10,6,31,11,0,MF,20-24,Midfielder,France,Europe
721,Ibrahima Diallo,FRA,Southampton,Premier League,2022,23.0,1999.0,9.1,25,15,14,10,1,8,14,57.1,6,11,1,10,6,31,11,0,MF,20-24,Midfielder,France,Europe
721,Ibrahima Diallo,FRA,Southampton,Premier League,2022,23.0,1999.0,9.1,25,15,14,10,1,8,14,57.1,6,11,1,10,6,31,11,0,MF,20-24,Midfielder,France,Europe
721,Ibrahima Diallo,FRA,Southampton,Premier League,2022,23.0,1999.0,9.1,25,15,14,10,1,8,14,57.1,6,11,1,10,6,31,11,0,MF,20-24,Midfielder,France,Europe
721,Ibrahima Diallo,FRA,Southampton,Premier League,2022,23.0,1999.0,9.1,25,15,14,10,1,8,14,57.1,6,11,1,10,6,31,11,0,MF,20-24,Midfielder,France,Europe
721,Ibrahima Diallo,FRA,Southampton,Premier League,2022,23.0,1999.0,9.1,25,15,14,10,1,8,14,57.1,6,11,1,10,6,31,11,0,MF,20-24,Midfielder,France,Europe
721,Ibrahima Diallo,FRA,Southampton,Premier League,2022,23.0,1999.0,9.1,25,15,14,10,1,8,14,57.1,6,11,1,10,6,31,11,0,MF,20-24,Midfielder,France,Europe
721,Ibrahima Diallo,FRA,Southampton,Premier League,2022,23.0,1999.0,9.1,25,15,14,10,1,8,14,57.1,6,11,1,10,6,31,11,0,MF,20-24,Midfielder,France,Europe
722,Ismael Diallo,CIV,Ajaccio,Ligue 1,2022,25.0,1997.0,24.2,46,33,35,9,2,35,63,55.6,28,26,12,14,30,76,46,1,DF,25-29,Defender,Ivory Coast,Africa
723,Habib Diarra,SEN,Strasbourg,Ligue 1,2022,18.0,2004.0,18.1,24,16,10,11,3,15,29,51.7,14,17,1,16,11,35,13,0,"MF,FW",Under 20,Midfielder,Senegal,Africa
724,Mamady Diarra,MLI,Cádiz,La Liga,2022,22.0,2000.0,0.7,2,1,2,0,0,1,2,50.0,1,2,0,2,0,2,0,0,"MF,DF",20-24,Midfielder,Mali,Africa
725,Moussa Diarra,MLI,Toulouse,Ligue 1,2022,21.0,2000.0,13.6,20,9,9,9,2,9,15,60.0,6,25,10,15,19,39,27,1,DF,20-24,Defender,Mali,Africa
726,Stéphane Diarra,FRA,Lorient,Ligue 1,2022,23.0,1998.0,11.8,25,17,14,9,2,11,29,37.9,18,13,1,12,22,47,9,0,"FW,MF",20-24,Forward,France,Europe
727,Youba Diarra,MLI,Cádiz,La Liga,2022,24.0,1998.0,1.1,3,0,2,1,0,1,5,20.0,4,7,1,6,2,5,3,0,MF,20-24,Midfielder,Mali,Africa
728,Rúben Dias,POR,Manchester City,Premier League,2022,25.0,1997.0,22.2,21,13,10,10,1,11,18,61.1,7,21,13,8,18,39,56,1,DF,25-29,Defender,Portugal,Europe
729,Krépin Diatta,SEN,Monaco,Ligue 1,2022,23.0,1999.0,23.0,30,21,4,17,9,13,32,40.6,19,29,1,28,17,47,12,0,"MF,FW",20-24,Midfielder,Senegal,Africa
730,Mory Diaw,SEN,Clermont Foot,Ligue 1,2022,29.0,1993.0,37.0,0,0,0,0,0,0,4,0.0,4,0,0,0,2,2,13,5,GK,25-29,Goalkeeper,Senegal,Africa
731,Brahim Díaz,MAR,Milan,Serie A,2022,22.0,1999.0,21.4,32,15,5,22,5,5,15,33.3,10,11,0,11,7,39,6,0,"MF,FW",20-24,Midfielder,Morocco,Africa
732,Luis Díaz,COL,Liverpool,Premier League,2022,25.0,1997.0,11.1,17,11,4,8,5,8,15,53.3,7,8,0,8,6,23,2,0,FW,25-29,Forward,Colombia,South America
733,Justin Diehl,GER,Köln,Bundesliga,2022,17.0,2004.0,0.2,0,0,0,0,0,0,0,,0,0,0,0,0,0,0,0,"MF,FW",Under 20,Midfielder,Germany,Europe
734,Bamba Dieng,SEN,Marseille,Ligue 1,2022,22.0,2000.0,2.2,4,4,2,1,1,3,4,75.0,1,5,1,4,0,4,0,0,"FW,MF",20-24,Forward,Senegal,Africa
735,Bamba Dieng,SEN,Lorient,Ligue 1,2022,22.0,2000.0,8.3,19,10,5,12,2,3,11,27.3,8,6,0,6,2,21,6,0,FW,20-24,Forward,Senegal,Africa
736,Eric Dier,ENG,Tottenham,Premier League,2022,28.0,1994.0,31.3,30,19,16,12,2,9,19,47.4,10,41,24,17,35,65,112,2,DF,25-29,Defender,England,Europe
737,Florian Dietz,GER,Köln,Bundesliga,2022,23.0,1998.0,4.4,2,1,0,2,0,1,4,25.0,3,4,1,3,0,2,2,0,FW,20-24,Forward,Germany,Europe
738,Lucas Digne,FRA,Aston Villa,Premier League,2022,29.0,1993.0,16.7,30,12,20,9,1,20,33,60.6,13,18,5,13,18,48,45,0,DF,25-29,Defender,France,Europe
739,Federico Dimarco,ITA,Inter,Serie A,2022,24.0,1997.0,23.0,31,25,6,18,7,9,19,47.4,10,15,4,11,18,49,20,0,DF,20-24,Defender,Italy,Europe
740,Stole Dimitrievski,MKD,Rayo Vallecano,La Liga,2022,28.0,1993.0,36.9,1,0,1,0,0,1,2,50.0,1,2,0,2,1,2,17,3,GK,25-29,Goalkeeper,North Macedonia,Europe
741,Junior Dina Ebimbe,FRA,Eint Frankfurt,Bundesliga,2022,21.0,2000.0,11.8,30,19,16,14,0,16,33,48.5,17,18,5,13,11,41,20,0,"DF,MF",20-24,Defender,France,Europe
742,Tristan Dingomé,CMR,Troyes,Ligue 1,2022,31.0,1991.0,1.1,1,1,0,1,0,0,2,0.0,2,0,0,0,0,1,0,0,MF,30-34,Midfielder,Cameroon,Africa
743,Eren Dinkçi,GER,Werder Bremen,Bundesliga,2022,20.0,2001.0,2.6,5,5,2,1,2,2,6,33.3,4,2,0,2,0,5,2,0,"FW,MF",20-24,Forward,Germany,Europe
744,Sinaly Diomande,CIV,Lyon,Ligue 1,2022,21.0,2001.0,21.7,42,24,26,15,1,31,49,63.3,18,26,13,13,49,91,75,1,DF,20-24,Defender,Ivory Coast,Africa
745,Lois Diony,FRA,Angers,Ligue 1,2022,29.0,1992.0,5.6,1,0,0,1,0,1,3,33.3,2,2,0,2,0,1,1,0,FW,25-29,Forward,France,Europe
746,Edan Diop,FRA,Monaco,Ligue 1,2022,17.0,2004.0,2.5,13,8,3,3,7,7,15,46.7,8,7,1,6,4,17,1,0,"DF,FW",Under 20,Defender,France,Europe
747,Issa Diop,FRA,Fulham,Premier League,2022,25.0,1997.0,22.4,28,19,18,9,1,17,32,53.1,15,24,17,7,35,63,86,0,DF,25-29,Defender,France,Europe
748,Sofiane Diop,FRA,Nice,Ligue 1,2022,22.0,2000.0,13.6,23,11,12,6,5,7,20,35.0,13,14,2,12,16,39,5,0,"MF,FW",20-24,Midfielder,France,Europe
749,Sofiane Diop,FRA,Monaco,Ligue 1,2022,22.0,2000.0,0.7,0,0,0,0,0,0,0,,0,0,0,0,1,1,0,0,MF,20-24,Midfielder,France,Europe
750,Yehvann Diouf,FRA,Reims,Ligue 1,2022,22.0,1999.0,31.0,2,0,2,0,0,1,3,33.3,2,0,0,0,1,3,13,5,GK,20-24,Goalkeeper,France,Europe
751,Axel Disasi,FRA,Monaco,Ligue 1,2022,24.0,1998.0,37.0,30,20,13,13,4,13,27,48.1,14,51,31,20,56,86,112,2,DF,20-24,Defender,France,Europe
752,Tiago Djaló,POR,Lille,Ligue 1,2022,22.0,2000.0,22.4,31,21,23,7,1,13,20,65.0,7,17,11,6,23,54,60,1,DF,20-24,Defender,Portugal,Europe
754,Moussa Djenepo,MLI,Southampton,Premier League,2022,24.0,1998.0,7.9,19,11,13,5,1,11,27,40.7,16,19,2,17,11,30,7,0,"DF,FW",20-24,Defender,Mali,Africa
755,Koffi Djidji,CIV,Torino,Serie A,2022,29.0,1992.0,26.9,50,25,32,17,1,18,32,56.3,14,29,14,15,34,84,72,0,DF,25-29,Defender,Ivory Coast,Africa
756,Alexander Djiku,GHA,Strasbourg,Ligue 1,2022,27.0,1994.0,29.7,53,36,37,16,0,26,46,56.5,20,45,19,26,66,119,151,3,DF,25-29,Defender,Ghana,Africa
757,Berat Djimsiti,ALB,Atalanta,Serie A,2022,29.0,1993.0,20.0,34,19,21,13,0,17,25,68.0,8,17,7,10,36,70,74,1,DF,25-29,Defender,Albania,Europe
758,Moussa Djitte,SEN,Ajaccio,Ligue 1,2022,22.0,1999.0,1.5,1,0,0,0,1,1,2,50.0,1,0,0,0,0,1,1,0,FW,20-24,Forward,Senegal,Africa
759,Ouparine Djoco,GNB,Clermont Foot,Ligue 1,2022,24.0,1998.0,1.0,0,0,0,0,0,0,0,,0,0,0,0,0,0,1,0,GK,20-24,Goalkeeper,Guinea-Bissau,Africa
761,Alan Do Marcolino,GAB,Rennes,Ligue 1,2022,20.0,2002.0,0.2,0,0,0,0,0,0,0,,0,0,0,0,0,0,1,0,FW,20-24,Forward,Gabon,Africa
762,Ben Doak,SCO,Liverpool,Premier League,2022,16.0,2005.0,0.3,3,2,1,2,0,1,1,100.0,0,1,0,1,0,3,0,0,FW,Under 20,Forward,Scotland,Europe
763,Ritsu Doan,JPN,Freiburg,Bundesliga,2022,24.0,1998.0,26.9,61,29,19,29,13,25,55,45.5,30,40,1,39,14,75,12,0,"MF,FW",20-24,Midfielder,Japan,Asia
764,Dodô,BRA,Fiorentina,Serie A,2022,23.0,1998.0,25.9,40,22,20,14,6,22,46,47.8,24,26,2,24,25,65,37,0,DF,20-24,Defender,Brazil,South America
764,Dodô,BRA,Fiorentina,Serie A,2022,23.0,1998.0,25.9,40,22,20,14,6,22,46,47.8,24,26,2,24,25,65,37,0,DF,20-24,Defender,Brazil,South America
764,Dodô,BRA,Fiorentina,Serie A,2022,23.0,1998.0,25.9,40,22,20,14,6,22,46,47.8,24,26,2,24,25,65,37,0,DF,20-24,Defender,Brazil,South America
764,Dodô,BRA,Fiorentina,Serie A,2022,23.0,1998.0,25.9,40,22,20,14,6,22,46,47.8,24,26,2,24,25,65,37,0,DF,20-24,Defender,Brazil,South America
764,Dodô,BRA,Fiorentina,Serie A,2022,23.0,1998.0,25.9,40,22,20,14,6,22,46,47.8,24,26,2,24,25,65,37,0,DF,20-24,Defender,Brazil,South America
764,Dodô,BRA,Fiorentina,Serie A,2022,23.0,1998.0,25.9,40,22,20,14,6,22,46,47.8,24,26,2,24,25,65,37,0,DF,20-24,Defender,Brazil,South America
764,Dodô,BRA,Fiorentina,Serie A,2022,23.0,1998.0,25.9,40,22,20,14,6,22,46,47.8,24,26,2,24,25,65,37,0,DF,20-24,Defender,Brazil,South America
764,Dodô,BRA,Fiorentina,Serie A,2022,23.0,1998.0,25.9,40,22,20,14,6,22,46,47.8,24,26,2,24,25,65,37,0,DF,20-24,Defender,Brazil,South America
764,Dodô,BRA,Fiorentina,Serie A,2022,23.0,1998.0,25.9,40,22,20,14,6,22,46,47.8,24,26,2,24,25,65,37,0,DF,20-24,Defender,Brazil,South America
765,Danilho Doekhi,NED,Union Berlin,Bundesliga,2022,24.0,1998.0,24.6,38,23,21,17,0,14,26,53.8,12,27,12,15,29,67,93,0,DF,20-24,Defender,Netherlands,Europe
766,Matt Doherty,IRL,Tottenham,Premier League,2022,30.0,1992.0,7.4,16,10,12,3,1,8,10,80.0,2,11,6,5,8,24,14,1,"DF,MF",30-34,Defender,Republic of Ireland,Europe
767,Matt Doherty,IRL,Atlético Madrid,La Liga,2022,30.0,1992.0,0.2,0,0,0,0,0,0,0,,0,2,0,2,0,0,0,0,DF,30-34,Defender,Republic of Ireland,Europe
768,Josh Doig,SCO,Hellas Verona,Serie A,2022,20.0,2002.0,15.0,19,8,6,7,6,6,16,37.5,10,25,6,19,11,30,13,1,DF,20-24,Defender,Scotland,Europe
769,Jeremy Doku,BEL,Rennes,Ligue 1,2022,20.0,2002.0,14.3,25,16,6,13,6,12,24,50.0,12,10,0,10,5,30,2,0,"MF,FW",20-24,Midfielder,Belgium,Europe
770,Kasper Dolberg,DEN,Sevilla,La Liga,2022,24.0,1997.0,2.2,1,0,0,1,0,1,3,33.3,2,0,0,0,0,1,5,0,FW,20-24,Forward,Denmark,Europe
771,Kasper Dolberg,DEN,Hoffenheim,Bundesliga,2022,24.0,1997.0,4.5,7,5,1,4,2,4,6,66.7,2,6,2,4,0,7,5,0,"FW,MF",20-24,Forward,Denmark,Europe
773,Nicolás Domínguez,ARG,Bologna,Serie A,2022,24.0,1998.0,25.6,79,49,34,33,12,39,76,51.3,37,29,3,26,21,100,29,1,MF,20-24,Midfielder,Argentina,South America
775,Giulio Donati,ITA,Monza,Serie A,2022,32.0,1990.0,4.7,4,1,1,1,2,3,6,50.0,3,3,1,2,4,8,11,0,DF,30-34,Defender,Italy,Europe
776,Kyliane Dong,FRA,Troyes,Ligue 1,2022,17.0,2004.0,2.4,3,1,0,2,1,1,2,50.0,1,1,0,1,1,4,0,0,"MF,FW",Under 20,Midfielder,France,Europe
777,Jordan Dongmo,CMR,Troyes,Ligue 1,2022,21.0,2001.0,0.2,1,0,0,1,0,1,1,100.0,0,0,0,0,0,1,0,0,MF,20-24,Midfielder,Cameroon,Africa
778,Gianluigi Donnarumma,ITA,Paris S-G,Ligue 1,2022,23.0,1999.0,37.9,1,0,1,0,0,1,2,50.0,1,0,0,0,0,1,12,4,GK,20-24,Goalkeeper,Italy,Europe
779,Niklas Dorsch,GER,Augsburg,Bundesliga,2022,24.0,1998.0,5.4,21,12,8,11,2,9,16,56.3,7,9,3,6,6,27,9,0,MF,20-24,Midfielder,Germany,Europe
780,Jodel Dossou,BEN,Clermont Foot,Ligue 1,2022,30.0,1992.0,2.9,7,4,3,2,2,4,4,100.0,0,2,1,1,1,8,0,0,"MF,DF",30-34,Midfielder,Benin,Africa
781,Lohann Doucet,FRA,Nantes,Ligue 1,2022,19.0,2002.0,1.0,3,0,2,0,1,3,4,75.0,1,2,0,2,2,5,4,0,"MF,FW",Under 20,Midfielder,France,Europe
782,Abdoulaye Doucouré,MLI,Everton,Premier League,2022,29.0,1993.0,17.0,31,20,9,15,7,12,37,32.4,25,26,3,23,13,44,11,0,MF,25-29,Midfielder,Mali,Africa
783,Cheick Doucouré,MLI,Crystal Palace,Premier League,2022,22.0,2000.0,30.8,77,46,40,33,4,29,52,55.8,23,47,13,34,56,133,48,0,MF,20-24,Midfielder,Mali,Africa
784,Siriné Doucouré,MLI,Lorient,Ligue 1,2022,20.0,2002.0,1.5,2,2,2,0,0,1,2,50.0,1,0,0,0,1,3,0,0,"FW,MF",20-24,Forward,Mali,Africa
785,Désiré Doué,FRA,Rennes,Ligue 1,2022,17.0,2005.0,12.4,37,18,10,23,4,13,32,40.6,19,17,1,16,13,50,3,0,"MF,FW",Under 20,Midfielder,France,Europe
786,Guela Doué,CIV,Rennes,Ligue 1,2022,19.0,2002.0,0.1,0,0,0,0,0,0,0,,0,0,0,0,0,0,0,0,"FW,MF",Under 20,Forward,Ivory Coast,Africa
787,Ismaël Doukouré,FRA,Strasbourg,Ligue 1,2022,19.0,2003.0,25.5,48,24,23,21,4,20,34,58.8,14,26,8,18,27,75,54,0,"DF,MF",Under 20,Defender,France,Europe
788,Kamory Doumbia,MLI,Reims,Ligue 1,2022,19.0,2003.0,12.8,31,16,9,14,8,12,37,32.4,25,17,1,16,13,44,3,0,MF,Under 20,Midfielder,Mali,Africa
789,Souleyman Doumbia,CIV,Angers,Ligue 1,2022,25.0,1996.0,19.9,45,31,31,13,1,17,31,54.8,14,20,3,17,27,72,27,1,"DF,FW",25-29,Defender,Ivory Coast,Africa
790,Flynn Downes,ENG,West Ham,Premier League,2022,23.0,1999.0,8.5,16,9,4,10,2,6,12,50.0,6,15,2,13,7,23,6,0,MF,20-24,Midfielder,England,Europe
791,Kami Doyle,ENG,Southampton,Premier League,2022,16.0,2005.0,0.1,0,0,0,0,0,0,0,,0,0,0,0,0,0,0,0,MF,Under 20,Midfielder,England,Europe
793,Cody Drameh,ENG,Leeds United,Premier League,2022,20.0,2001.0,0.8,5,4,0,4,1,2,3,66.7,1,0,0,0,1,6,1,0,DF,20-24,Defender,England,Europe
794,Dion Drena Beljo,CRO,Augsburg,Bundesliga,2022,20.0,2002.0,12.5,7,6,3,2,2,2,13,15.4,11,15,2,13,1,8,14,0,FW,20-24,Forward,Croatia,Europe
795,Dominick Drexler,GER,Schalke 04,Bundesliga,2022,32.0,1990.0,15.2,25,17,12,10,3,9,22,40.9,13,18,2,16,8,33,12,0,"MF,FW",30-34,Midfielder,Germany,Europe
796,Domingos Duarte,POR,Getafe,La Liga,2022,27.0,1995.0,29.5,26,18,21,5,0,19,26,73.1,7,29,23,6,39,65,145,0,DF,25-29,Defender,Portugal,Europe
797,Martin Dúbravka,SVK,Newcastle Utd,Premier League,2022,33.0,1989.0,1.7,0,0,0,0,0,0,1,0.0,1,0,0,0,0,0,1,0,GK,30-34,Goalkeeper,Slovakia,Europe
798,Marvin Ducksch,GER,Werder Bremen,Bundesliga,2022,28.0,1994.0,31.7,8,3,2,4,2,3,16,18.8,13,13,2,11,9,17,41,1,FW,25-29,Forward,Germany,Europe
799,Ondrej Duda,SVK,Hellas Verona,Serie A,2022,27.0,1994.0,11.8,22,14,7,12,3,9,16,56.3,7,11,0,11,13,35,8,0,MF,25-29,Midfielder,Slovakia,Europe
800,Ondrej Duda,SVK,Köln,Bundesliga,2022,27.0,1994.0,7.7,9,8,2,5,2,4,11,36.4,7,7,1,6,2,11,3,0,MF,25-29,Midfielder,Slovakia,Europe
801,Shane Duffy,IRL,Fulham,Premier League,2022,30.0,1992.0,0.2,0,0,0,0,0,0,0,,0,0,0,0,0,0,0,1,"DF,FW",30-34,Defender,Republic of Ireland,Europe
802,Rémy Dugimont,FRA,Auxerre,Ligue 1,2022,36.0,1986.0,1.3,2,1,0,1,1,1,2,50.0,1,3,0,3,0,2,5,0,"FW,MF",35-39,Forward,France,Europe
803,Denzel Dumfries,NED,Inter,Serie A,2022,26.0,1996.0,24.6,35,18,17,13,5,22,34,64.7,12,33,9,24,12,47,26,0,DF,25-29,Defender,Netherlands,Europe
804,Alfred Duncan,GHA,Fiorentina,Serie A,2022,29.0,1993.0,12.3,18,10,0,17,1,10,21,47.6,11,9,0,9,8,26,6,0,MF,25-29,Midfielder,Ghana,Africa
805,Lewis Dunk,ENG,Brighton,Premier League,2022,30.0,1991.0,36.0,30,19,19,9,2,18,41,43.9,23,37,27,10,34,64,81,1,DF,30-34,Defender,England,Europe
806,Maxime Dupé,FRA,Toulouse,Ligue 1,2022,29.0,1993.0,38.0,0,0,0,0,0,0,0,,0,0,0,0,0,0,9,3,GK,25-29,Goalkeeper,France,Europe
807,Jhon Durán,COL,Aston Villa,Premier League,2022,18.0,2003.0,1.5,2,2,0,1,1,1,4,25.0,3,0,0,0,2,4,2,0,"FW,MF",Under 20,Forward,Colombia,South America
809,Julien Duranville,BEL,Dortmund,Bundesliga,2022,16.0,2006.0,0.3,1,1,0,1,0,1,1,100.0,0,0,0,0,0,1,0,0,MF,Under 20,Midfielder,Belgium,Europe
811,Jean-Kevin Duverne,HAI,Brest,Ligue 1,2022,25.0,1997.0,27.9,72,38,44,24,4,42,73,57.5,31,33,5,28,28,100,65,1,DF,25-29,Defender,Haiti,North America
812,Paulo Dybala,ARG,Roma,Serie A,2022,28.0,1993.0,19.3,14,4,1,8,5,8,26,30.8,18,12,1,11,8,22,4,0,"MF,FW",25-29,Midfielder,Argentina,South America
813,Edin Džeko,BIH,Inter,Serie A,2022,36.0,1986.0,19.2,3,2,0,3,0,0,4,0.0,4,15,1,14,3,6,25,0,FW,35-39,Forward,Bosnia and Herzegovina,Europe
814,Malcolm Ebiowei,ENG,Crystal Palace,Premier League,2022,18.0,2003.0,0.4,1,1,1,0,0,0,1,0.0,1,2,0,2,0,1,0,0,"MF,FW",Under 20,Midfielder,England,Europe
815,Festy Ebosele,IRL,Udinese,Serie A,2022,19.0,2002.0,4.6,15,10,8,7,0,4,10,40.0,6,5,0,5,2,17,5,0,DF,Under 20,Defender,Republic of Ireland,Europe
816,Enzo Ebosse,CMR,Udinese,Serie A,2022,23.0,1999.0,10.3,15,9,11,4,0,9,13,69.2,4,27,6,21,11,26,29,0,DF,20-24,Defender,Cameroon,Africa
817,Tyronne Ebuehi,NGA,Empoli,Serie A,2022,26.0,1995.0,21.4,22,14,11,7,4,9,13,69.2,4,23,12,11,12,34,79,1,DF,25-29,Defender,Nigeria,Africa
818,Ederson,BRA,Manchester City,Premier League,2022,28.0,1993.0,35.0,3,1,3,0,0,1,2,50.0,1,0,0,0,1,4,10,2,GK,25-29,Goalkeeper,Brazil,South America
818,Ederson,BRA,Manchester City,Premier League,2022,28.0,1993.0,35.0,3,1,3,0,0,1,2,50.0,1,0,0,0,1,4,10,2,GK,25-29,Goalkeeper,Brazil,South America
818,Ederson,BRA,Manchester City,Premier League,2022,28.0,1993.0,35.0,3,1,3,0,0,1,2,50.0,1,0,0,0,1,4,10,2,GK,25-29,Goalkeeper,Brazil,South America
818,Ederson,BRA,Manchester City,Premier League,2022,28.0,1993.0,35.0,3,1,3,0,0,1,2,50.0,1,0,0,0,1,4,10,2,GK,25-29,Goalkeeper,Brazil,South America
819,Éderson,BRA,Atalanta,Serie A,2022,23.0,1999.0,24.6,67,34,18,42,7,29,66,43.9,37,56,7,49,36,103,31,0,MF,20-24,Midfielder,Brazil,South America
820,Odsonne Édouard,FRA,Crystal Palace,Premier League,2022,24.0,1998.0,20.0,25,13,7,12,6,7,13,53.8,6,17,5,12,3,28,22,0,FW,20-24,Forward,France,Europe
821,Samuel Edozie,ENG,Southampton,Premier League,2022,19.0,2003.0,6.3,17,10,6,10,1,3,8,37.5,5,7,0,7,6,23,6,0,"FW,MF",Under 20,Forward,England,Europe
822,Maximilian Eggestein,GER,Freiburg,Bundesliga,2022,25.0,1996.0,27.2,51,29,21,24,6,17,35,48.6,18,37,8,29,36,87,27,0,MF,25-29,Midfielder,Germany,Europe
823,Lilian Egloff,GER,Stuttgart,Bundesliga,2022,19.0,2002.0,2.7,12,10,4,5,3,4,6,66.7,2,2,0,2,1,13,1,0,"MF,FW",Under 20,Midfielder,Germany,Europe
825,Kingsley Ehizibue,NED,Udinese,Serie A,2022,27.0,1995.0,17.1,47,31,28,13,6,29,45,64.4,16,21,3,18,10,57,42,1,DF,25-29,Defender,Netherlands,Europe
826,Kingsley Ehizibue,NED,Köln,Bundesliga,2022,27.0,1995.0,0.7,0,0,0,0,0,0,0,,0,1,0,1,2,2,1,0,DF,25-29,Defender,Netherlands,Europe
827,Julian Eitschberger,GER,Hertha BSC,Bundesliga,2022,18.0,2004.0,0.0,0,0,0,0,0,0,0,,0,0,0,0,0,0,0,0,FW,Under 20,Forward,Germany,Europe
828,Chidera Ejuke,NGA,Hertha BSC,Bundesliga,2022,24.0,1998.0,9.9,5,4,1,4,0,1,5,20.0,4,4,0,4,4,9,1,0,"FW,MF",20-24,Forward,Nigeria,Africa
829,Albin Ekdal,SWE,Spezia,Serie A,2022,33.0,1989.0,19.3,37,20,14,20,3,19,45,42.2,26,24,2,22,26,63,36,0,MF,30-34,Midfielder,Sweden,Europe
830,Hugo Ekitike,FRA,Paris S-G,Ligue 1,2022,20.0,2002.0,12.8,12,4,1,10,1,4,12,33.3,8,12,0,12,9,21,3,0,FW,20-24,Forward,France,Europe
831,Emmanuel Ekong,SWE,Empoli,Serie A,2022,20.0,2002.0,0.2,0,0,0,0,0,0,0,,0,0,0,0,0,0,0,0,"FW,MF",20-24,Forward,Sweden,Europe
832,Anthony Elanga,SWE,Manchester Utd,Premier League,2022,20.0,2002.0,4.7,3,0,0,2,1,1,2,50.0,1,4,0,4,2,5,4,0,FW,20-24,Forward,Sweden,Europe
834,Mikael Ellertsson,ISL,Spezia,Serie A,2022,20.0,2002.0,1.9,4,2,1,3,0,0,3,0.0,3,2,1,1,2,6,0,0,"MF,DF",20-24,Midfielder,Iceland,Europe
835,Harvey Elliott,ENG,Liverpool,Premier League,2022,19.0,2003.0,17.9,27,18,6,12,9,9,37,24.3,28,26,1,25,15,42,8,0,"MF,FW",Under 20,Midfielder,England,Europe
836,Elif Elmas,MKD,Napoli,Serie A,2022,22.0,1999.0,18.1,24,13,8,12,4,11,23,47.8,12,18,2,16,11,35,5,0,"FW,MF",20-24,Forward,North Macedonia,Europe
837,Mohamed Elneny,EGY,Arsenal,Premier League,2022,30.0,1992.0,1.3,1,1,1,0,0,1,1,100.0,0,0,0,0,0,1,0,0,MF,30-34,Midfielder,Egypt,Africa
839,Nico Elvedi,SUI,Gladbach,Bundesliga,2022,25.0,1996.0,31.4,46,24,32,12,2,27,41,65.9,14,31,16,15,35,81,149,3,DF,25-29,Defender,Switzerland,Europe
840,Rodrigo Ely,BRA,Almería,La Liga,2022,28.0,1993.0,35.1,30,21,26,4,0,18,25,72.0,7,46,33,13,31,61,203,1,DF,25-29,Defender,Brazil,South America
844,Breel Embolo,SUI,Monaco,Ligue 1,2022,25.0,1997.0,20.7,15,9,2,7,6,5,10,50.0,5,14,3,11,5,20,12,0,FW,25-29,Forward,Switzerland,Europe
845,Emerson,BRA,Tottenham,Premier League,2022,23.0,1999.0,19.3,54,33,38,12,4,27,40,67.5,13,17,3,14,18,72,75,0,DF,20-24,Defender,Brazil,South America
846,Youssef En-Nesyri,MAR,Sevilla,La Liga,2022,25.0,1997.0,18.5,16,8,3,7,6,4,14,28.6,10,6,2,4,4,20,16,0,FW,25-29,Forward,Morocco,Africa
847,Julio Enciso,PAR,Brighton,Premier League,2022,18.0,2004.0,9.0,13,4,3,6,4,8,13,61.5,5,9,0,9,4,17,2,0,"FW,MF",Under 20,Forward,Paraguay,South America
848,Wataru Endo,JPN,Stuttgart,Bundesliga,2022,29.0,1993.0,32.5,70,37,30,31,9,38,85,44.7,47,44,6,38,26,96,63,0,MF,25-29,Midfielder,Japan,Asia
849,Arne Engels,BEL,Augsburg,Bundesliga,2022,18.0,2003.0,16.0,20,9,9,10,1,8,19,42.1,11,17,5,12,15,35,12,1,MF,Under 20,Midfielder,Belgium,Europe
850,Christian Eriksen,DEN,Manchester Utd,Premier League,2022,30.0,1992.0,22.8,22,18,10,7,5,10,33,30.3,23,23,9,14,11,33,20,1,MF,30-34,Midfielder,Denmark,Europe
851,Martin Erlic,CRO,Sassuolo,Serie A,2022,24.0,1998.0,25.9,27,16,18,8,1,10,23,43.5,13,36,23,13,31,58,120,1,DF,20-24,Defender,Croatia,Europe
852,Tjark Ernst,GER,Hertha BSC,Bundesliga,2022,19.0,2003.0,1.0,0,0,0,0,0,0,0,,0,0,0,0,0,0,1,0,GK,Under 20,Goalkeeper,Germany,Europe
853,Gonzalo Escalante,ARG,Cremonese,Serie A,2022,29.0,1993.0,6.2,16,8,8,8,0,10,13,76.9,3,7,1,6,10,26,4,0,MF,25-29,Midfielder,Argentina,South America
854,Gonzalo Escalante,ARG,Cádiz,La Liga,2022,29.0,1993.0,12.5,36,24,15,20,1,15,29,51.7,14,18,4,14,17,53,26,1,MF,25-29,Midfielder,Argentina,South America
856,Alfonso Espino,URU,Cádiz,La Liga,2022,30.0,1992.0,34.7,87,56,55,20,12,48,96,50.0,48,52,11,41,48,135,99,3,DF,30-34,Defender,Uruguay,South America
857,Bernardo Espinosa,COL,Girona,La Liga,2022,33.0,1989.0,13.6,6,2,2,4,0,3,9,33.3,6,17,10,7,12,18,70,2,DF,30-34,Defender,Colombia,South America
858,Salvatore Esposito,ITA,Spezia,Serie A,2022,21.0,2000.0,10.8,15,12,8,5,2,5,21,23.8,16,9,1,8,11,26,18,0,MF,20-24,Midfielder,Italy,Europe
859,Maxime Estève,FRA,Montpellier,Ligue 1,2022,20.0,2002.0,18.3,24,13,17,5,2,12,17,70.6,5,28,17,11,34,58,90,0,DF,20-24,Defender,France,Europe
860,Pervis Estupiñán,ECU,Brighton,Premier League,2022,24.0,1998.0,29.7,61,31,36,19,6,35,60,58.3,25,30,8,22,37,98,37,1,DF,20-24,Defender,Ecuador,South America
863,Eberechi Eze,ENG,Crystal Palace,Premier League,2022,24.0,1998.0,29.3,42,24,17,18,7,18,38,47.4,20,22,0,22,13,55,10,0,"MF,FW",20-24,Midfielder,England,Europe
864,Kimberly Ezekwem,GER,Freiburg,Bundesliga,2022,21.0,2001.0,0.1,0,0,0,0,0,0,0,,0,1,0,1,0,0,0,0,DF,20-24,Defender,Germany,Europe
865,Nicolás Ezequiel Fernández,ARG,Elche,La Liga,2022,22.0,2000.0,5.7,23,12,10,7,6,9,17,52.9,8,7,0,7,5,28,2,1,"MF,DF",20-24,Midfielder,Argentina,South America
866,Abde Ezzalzouli,MAR,Osasuna,La Liga,2022,20.0,2001.0,16.7,29,19,13,12,4,13,23,56.5,10,20,0,20,4,33,6,0,"FW,MF",20-24,Forward,Morocco,Africa
868,Fabinho,BRA,Liverpool,Premier League,2022,28.0,1993.0,29.7,65,38,18,40,7,24,62,38.7,38,38,11,27,37,102,40,0,MF,25-29,Midfielder,Brazil,South America
868,Fabinho,BRA,Liverpool,Premier League,2022,28.0,1993.0,29.7,65,38,18,40,7,24,62,38.7,38,38,11,27,37,102,40,0,MF,25-29,Midfielder,Brazil,South America
868,Fabinho,BRA,Liverpool,Premier League,2022,28.0,1993.0,29.7,65,38,18,40,7,24,62,38.7,38,38,11,27,37,102,40,0,MF,25-29,Midfielder,Brazil,South America
868,Fabinho,BRA,Liverpool,Premier League,2022,28.0,1993.0,29.7,65,38,18,40,7,24,62,38.7,38,38,11,27,37,102,40,0,MF,25-29,Midfielder,Brazil,South America
868,Fabinho,BRA,Liverpool,Premier League,2022,28.0,1993.0,29.7,65,38,18,40,7,24,62,38.7,38,38,11,27,37,102,40,0,MF,25-29,Midfielder,Brazil,South America
868,Fabinho,BRA,Liverpool,Premier League,2022,28.0,1993.0,29.7,65,38,18,40,7,24,62,38.7,38,38,11,27,37,102,40,0,MF,25-29,Midfielder,Brazil,South America
868,Fabinho,BRA,Liverpool,Premier League,2022,28.0,1993.0,29.7,65,38,18,40,7,24,62,38.7,38,38,11,27,37,102,40,0,MF,25-29,Midfielder,Brazil,South America
868,Fabinho,BRA,Liverpool,Premier League,2022,28.0,1993.0,29.7,65,38,18,40,7,24,62,38.7,38,38,11,27,37,102,40,0,MF,25-29,Midfielder,Brazil,South America
868,Fabinho,BRA,Liverpool,Premier League,2022,28.0,1993.0,29.7,65,38,18,40,7,24,62,38.7,38,38,11,27,37,102,40,0,MF,25-29,Midfielder,Brazil,South America
868,Fabinho,BRA,Liverpool,Premier League,2022,28.0,1993.0,29.7,65,38,18,40,7,24,62,38.7,38,38,11,27,37,102,40,0,MF,25-29,Midfielder,Brazil,South America
868,Fabinho,BRA,Liverpool,Premier League,2022,28.0,1993.0,29.7,65,38,18,40,7,24,62,38.7,38,38,11,27,37,102,40,0,MF,25-29,Midfielder,Brazil,South America
868,Fabinho,BRA,Liverpool,Premier League,2022,28.0,1993.0,29.7,65,38,18,40,7,24,62,38.7,38,38,11,27,37,102,40,0,MF,25-29,Midfielder,Brazil,South America
868,Fabinho,BRA,Liverpool,Premier League,2022,28.0,1993.0,29.7,65,38,18,40,7,24,62,38.7,38,38,11,27,37,102,40,0,MF,25-29,Midfielder,Brazil,South America
868,Fabinho,BRA,Liverpool,Premier League,2022,28.0,1993.0,29.7,65,38,18,40,7,24,62,38.7,38,38,11,27,37,102,40,0,MF,25-29,Midfielder,Brazil,South America
868,Fabinho,BRA,Liverpool,Premier League,2022,28.0,1993.0,29.7,65,38,18,40,7,24,62,38.7,38,38,11,27,37,102,40,0,MF,25-29,Midfielder,Brazil,South America
868,Fabinho,BRA,Liverpool,Premier League,2022,28.0,1993.0,29.7,65,38,18,40,7,24,62,38.7,38,38,11,27,37,102,40,0,MF,25-29,Midfielder,Brazil,South America
868,Fabinho,BRA,Liverpool,Premier League,2022,28.0,1993.0,29.7,65,38,18,40,7,24,62,38.7,38,38,11,27,37,102,40,0,MF,25-29,Midfielder,Brazil,South America
868,Fabinho,BRA,Liverpool,Premier League,2022,28.0,1993.0,29.7,65,38,18,40,7,24,62,38.7,38,38,11,27,37,102,40,0,MF,25-29,Midfielder,Brazil,South America
868,Fabinho,BRA,Liverpool,Premier League,2022,28.0,1993.0,29.7,65,38,18,40,7,24,62,38.7,38,38,11,27,37,102,40,0,MF,25-29,Midfielder,Brazil,South America
868,Fabinho,BRA,Liverpool,Premier League,2022,28.0,1993.0,29.7,65,38,18,40,7,24,62,38.7,38,38,11,27,37,102,40,0,MF,25-29,Midfielder,Brazil,South America
868,Fabinho,BRA,Liverpool,Premier League,2022,28.0,1993.0,29.7,65,38,18,40,7,24,62,38.7,38,38,11,27,37,102,40,0,MF,25-29,Midfielder,Brazil,South America
868,Fabinho,BRA,Liverpool,Premier League,2022,28.0,1993.0,29.7,65,38,18,40,7,24,62,38.7,38,38,11,27,37,102,40,0,MF,25-29,Midfielder,Brazil,South America
868,Fabinho,BRA,Liverpool,Premier League,2022,28.0,1993.0,29.7,65,38,18,40,7,24,62,38.7,38,38,11,27,37,102,40,0,MF,25-29,Midfielder,Brazil,South America
868,Fabinho,BRA,Liverpool,Premier League,2022,28.0,1993.0,29.7,65,38,18,40,7,24,62,38.7,38,38,11,27,37,102,40,0,MF,25-29,Midfielder,Brazil,South America
868,Fabinho,BRA,Liverpool,Premier League,2022,28.0,1993.0,29.7,65,38,18,40,7,24,62,38.7,38,38,11,27,37,102,40,0,MF,25-29,Midfielder,Brazil,South America
869,Fábio,BRA,Nantes,Ligue 1,2022,32.0,1990.0,2.5,4,2,1,2,1,4,6,66.7,2,2,0,2,3,7,11,0,"DF,MF",30-34,Defender,Brazil,South America
870,Noah Fadiga,SEN,Brest,Ligue 1,2022,22.0,1999.0,14.5,30,21,18,9,3,14,26,53.8,12,17,7,10,26,56,18,0,DF,20-24,Defender,Senegal,Africa
871,Wout Faes,BEL,Leicester City,Premier League,2022,24.0,1998.0,31.0,56,33,28,26,2,28,44,63.6,16,53,37,16,41,97,113,2,DF,20-24,Defender,Belgium,Europe
872,Wout Faes,BEL,Reims,Ligue 1,2022,24.0,1998.0,3.0,1,1,1,0,0,1,2,50.0,1,6,3,3,7,8,19,0,DF,20-24,Defender,Belgium,Europe
873,Nicolò Fagioli,ITA,Juventus,Serie A,2022,21.0,2001.0,16.9,29,19,12,15,2,8,27,29.6,19,16,2,14,8,37,7,1,MF,20-24,Midfielder,Italy,Europe
874,Ralf Fährmann,GER,Schalke 04,Bundesliga,2022,33.0,1988.0,11.4,1,0,1,0,0,1,1,100.0,0,0,0,0,0,1,10,2,GK,30-34,Goalkeeper,Germany,Europe
875,Romain Faivre,FRA,Lorient,Ligue 1,2022,24.0,1998.0,13.8,13,8,5,4,4,5,25,20.0,20,11,0,11,1,14,4,0,"MF,FW",20-24,Midfielder,France,Europe
876,Romain Faivre,FRA,Lyon,Ligue 1,2022,24.0,1998.0,3.3,6,3,2,2,2,1,3,33.3,2,3,0,3,0,6,0,0,MF,20-24,Midfielder,France,Europe
877,Radamel Falcao,COL,Rayo Vallecano,La Liga,2022,36.0,1986.0,6.8,4,4,1,3,0,1,8,12.5,7,5,1,4,2,6,10,0,"FW,MF",35-39,Forward,Colombia,South America
878,Wladimiro Falcone,ITA,Lecce,Serie A,2022,27.0,1995.0,38.0,2,0,2,0,0,2,2,100.0,0,0,0,0,2,4,21,3,GK,25-29,Goalkeeper,Italy,Europe
880,Fallou Fall,SEN,Reims,Ligue 1,2022,18.0,2004.0,0.4,0,0,0,0,0,0,1,0.0,1,3,3,0,0,0,4,0,DF,Under 20,Defender,Senegal,Africa
881,Mamadou Fall,SEN,Villarreal,La Liga,2022,19.0,2002.0,0.3,0,0,0,0,0,0,0,,0,1,0,1,0,0,1,0,DF,Under 20,Defender,Senegal,Africa
881,Mamadou Fall,SEN,Villarreal,La Liga,2022,19.0,2002.0,0.3,0,0,0,0,0,0,0,,0,1,0,1,0,0,1,0,DF,Under 20,Defender,Senegal,Africa
881,Mamadou Fall,SEN,Villarreal,La Liga,2022,19.0,2002.0,0.3,0,0,0,0,0,0,0,,0,1,0,1,0,0,1,0,DF,Under 20,Defender,Senegal,Africa
881,Mamadou Fall,SEN,Villarreal,La Liga,2022,19.0,2002.0,0.3,0,0,0,0,0,0,0,,0,1,0,1,0,0,1,0,DF,Under 20,Defender,Senegal,Africa
882,Davide Faraoni,ITA,Hellas Verona,Serie A,2022,30.0,1991.0,16.5,34,24,19,13,2,16,41,39.0,25,30,11,19,15,49,37,0,DF,30-34,Defender,Italy,Europe
884,Khalil Fayad,FRA,Montpellier,Ligue 1,2022,18.0,2004.0,8.0,30,14,12,16,2,12,21,57.1,9,8,1,7,9,39,4,0,MF,Under 20,Midfielder,France,Europe
885,Cheikh Faye,SEN,Montpellier,Ligue 1,2022,23.0,1999.0,0.4,0,0,0,0,0,0,0,,0,0,0,0,1,1,0,0,FW,20-24,Forward,Senegal,Africa
886,Federico Fazio,ARG,Salernitana,Serie A,2022,35.0,1987.0,11.9,15,12,8,7,0,4,11,36.4,7,9,4,5,28,43,61,0,DF,35-39,Defender,Argentina,South America
887,Jacopo Fazzini,ITA,Empoli,Serie A,2022,19.0,2003.0,9.2,31,17,20,8,3,18,34,52.9,16,15,3,12,7,38,19,0,MF,Under 20,Midfielder,Italy,Europe
888,Zouhair Feddal,MAR,Valladolid,La Liga,2022,33.0,1989.0,4.2,4,2,1,3,0,3,4,75.0,1,9,9,0,5,9,27,0,DF,30-34,Defender,Morocco,Africa
889,Nabil Fekir,FRA,Betis,La Liga,2022,29.0,1993.0,10.7,11,5,3,3,5,2,9,22.2,7,6,2,4,1,12,0,0,MF,25-29,Midfielder,France,Europe
890,Felipe,BRA,Nott'ham Forest,Premier League,2022,33.0,1989.0,15.8,42,23,29,13,0,24,41,58.5,17,34,13,21,36,78,90,0,DF,30-34,Defender,Brazil,South America
890,Felipe,BRA,Nott'ham Forest,Premier League,2022,33.0,1989.0,15.8,42,23,29,13,0,24,41,58.5,17,34,13,21,36,78,90,0,DF,30-34,Defender,Brazil,South America
890,Felipe,BRA,Nott'ham Forest,Premier League,2022,33.0,1989.0,15.8,42,23,29,13,0,24,41,58.5,17,34,13,21,36,78,90,0,DF,30-34,Defender,Brazil,South America
890,Felipe,BRA,Nott'ham Forest,Premier League,2022,33.0,1989.0,15.8,42,23,29,13,0,24,41,58.5,17,34,13,21,36,78,90,0,DF,30-34,Defender,Brazil,South America
891,Felipe,BRA,Atlético Madrid,La Liga,2022,33.0,1989.0,2.2,3,2,1,2,0,2,4,50.0,2,2,2,0,0,3,7,0,DF,30-34,Defender,Brazil,South America
891,Felipe,BRA,Atlético Madrid,La Liga,2022,33.0,1989.0,2.2,3,2,1,2,0,2,4,50.0,2,2,2,0,0,3,7,0,DF,30-34,Defender,Brazil,South America
891,Felipe,BRA,Atlético Madrid,La Liga,2022,33.0,1989.0,2.2,3,2,1,2,0,2,4,50.0,2,2,2,0,0,3,7,0,DF,30-34,Defender,Brazil,South America
891,Felipe,BRA,Atlético Madrid,La Liga,2022,33.0,1989.0,2.2,3,2,1,2,0,2,4,50.0,2,2,2,0,0,3,7,0,DF,30-34,Defender,Brazil,South America
892,Luiz Felipe,ITA,Betis,La Liga,2022,25.0,1997.0,19.6,34,23,23,11,0,18,34,52.9,16,43,24,19,28,62,106,0,DF,25-29,Defender,Italy,Europe
892,Luiz Felipe,ITA,Betis,La Liga,2022,25.0,1997.0,19.6,34,23,23,11,0,18,34,52.9,16,43,24,19,28,62,106,0,DF,25-29,Defender,Italy,Europe
892,Luiz Felipe,ITA,Betis,La Liga,2022,25.0,1997.0,19.6,34,23,23,11,0,18,34,52.9,16,43,24,19,28,62,106,0,DF,25-29,Defender,Italy,Europe
892,Luiz Felipe,ITA,Betis,La Liga,2022,25.0,1997.0,19.6,34,23,23,11,0,18,34,52.9,16,43,24,19,28,62,106,0,DF,25-29,Defender,Italy,Europe
893,João Félix,POR,Chelsea,Premier League,2022,22.0,1999.0,10.5,14,7,5,6,3,4,12,33.3,8,3,0,3,1,15,1,1,"FW,MF",20-24,Forward,Portugal,Europe
894,João Félix,POR,Atlético Madrid,La Liga,2022,22.0,1999.0,7.2,10,7,2,3,5,1,6,16.7,5,1,0,1,3,13,2,0,"FW,MF",20-24,Forward,Portugal,Europe
895,Ohis Felix Uduokhai,GER,Augsburg,Bundesliga,2022,24.0,1997.0,16.1,30,20,14,13,3,15,29,51.7,14,27,14,13,29,59,61,1,DF,20-24,Defender,Germany,Europe
897,Evan Ferguson,IRL,Brighton,Premier League,2022,17.0,2004.0,10.6,6,3,1,3,2,1,7,14.3,6,11,1,10,2,8,6,0,FW,Under 20,Forward,Republic of Ireland,Europe
898,Lewis Ferguson,SCO,Bologna,Serie A,2022,22.0,1999.0,25.7,44,25,16,20,8,20,40,50.0,20,22,7,15,19,63,25,0,"MF,FW",20-24,Midfielder,Scotland,Europe
899,Bruno Fernandes,POR,Manchester Utd,Premier League,2022,27.0,1994.0,36.8,68,42,24,25,19,30,71,42.3,41,37,5,32,25,93,40,1,"MF,FW",25-29,Midfielder,Portugal,Europe
900,Edimilson Fernandes,SUI,Mainz 05,Bundesliga,2022,26.0,1996.0,27.1,35,25,26,5,4,18,34,52.9,16,37,16,21,54,89,87,2,DF,25-29,Defender,Switzerland,Europe
905,Enzo Fernández,ARG,Chelsea,Premier League,2022,21.0,2001.0,17.2,45,27,25,17,3,21,56,37.5,35,32,2,30,16,61,12,1,MF,20-24,Midfielder,Argentina,South America
906,Federico Fernández,ARG,Elche,La Liga,2022,33.0,1989.0,1.0,1,1,1,0,0,1,1,100.0,0,0,0,0,2,3,12,0,DF,30-34,Defender,Argentina,South America
910,Fernando,BRA,Sevilla,La Liga,2022,35.0,1987.0,17.5,34,23,14,17,3,18,30,60.0,12,21,10,11,24,58,29,0,"MF,DF",35-39,Midfielder,Brazil,South America
910,Fernando,BRA,Sevilla,La Liga,2022,35.0,1987.0,17.5,34,23,14,17,3,18,30,60.0,12,21,10,11,24,58,29,0,"MF,DF",35-39,Midfielder,Brazil,South America
910,Fernando,BRA,Sevilla,La Liga,2022,35.0,1987.0,17.5,34,23,14,17,3,18,30,60.0,12,21,10,11,24,58,29,0,"MF,DF",35-39,Midfielder,Brazil,South America
910,Fernando,BRA,Sevilla,La Liga,2022,35.0,1987.0,17.5,34,23,14,17,3,18,30,60.0,12,21,10,11,24,58,29,0,"MF,DF",35-39,Midfielder,Brazil,South America
910,Fernando,BRA,Sevilla,La Liga,2022,35.0,1987.0,17.5,34,23,14,17,3,18,30,60.0,12,21,10,11,24,58,29,0,"MF,DF",35-39,Midfielder,Brazil,South America
910,Fernando,BRA,Sevilla,La Liga,2022,35.0,1987.0,17.5,34,23,14,17,3,18,30,60.0,12,21,10,11,24,58,29,0,"MF,DF",35-39,Midfielder,Brazil,South America
910,Fernando,BRA,Sevilla,La Liga,2022,35.0,1987.0,17.5,34,23,14,17,3,18,30,60.0,12,21,10,11,24,58,29,0,"MF,DF",35-39,Midfielder,Brazil,South America
910,Fernando,BRA,Sevilla,La Liga,2022,35.0,1987.0,17.5,34,23,14,17,3,18,30,60.0,12,21,10,11,24,58,29,0,"MF,DF",35-39,Midfielder,Brazil,South America
910,Fernando,BRA,Sevilla,La Liga,2022,35.0,1987.0,17.5,34,23,14,17,3,18,30,60.0,12,21,10,11,24,58,29,0,"MF,DF",35-39,Midfielder,Brazil,South America
910,Fernando,BRA,Sevilla,La Liga,2022,35.0,1987.0,17.5,34,23,14,17,3,18,30,60.0,12,21,10,11,24,58,29,0,"MF,DF",35-39,Midfielder,Brazil,South America
910,Fernando,BRA,Sevilla,La Liga,2022,35.0,1987.0,17.5,34,23,14,17,3,18,30,60.0,12,21,10,11,24,58,29,0,"MF,DF",35-39,Midfielder,Brazil,South America
910,Fernando,BRA,Sevilla,La Liga,2022,35.0,1987.0,17.5,34,23,14,17,3,18,30,60.0,12,21,10,11,24,58,29,0,"MF,DF",35-39,Midfielder,Brazil,South America
910,Fernando,BRA,Sevilla,La Liga,2022,35.0,1987.0,17.5,34,23,14,17,3,18,30,60.0,12,21,10,11,24,58,29,0,"MF,DF",35-39,Midfielder,Brazil,South America
910,Fernando,BRA,Sevilla,La Liga,2022,35.0,1987.0,17.5,34,23,14,17,3,18,30,60.0,12,21,10,11,24,58,29,0,"MF,DF",35-39,Midfielder,Brazil,South America
910,Fernando,BRA,Sevilla,La Liga,2022,35.0,1987.0,17.5,34,23,14,17,3,18,30,60.0,12,21,10,11,24,58,29,0,"MF,DF",35-39,Midfielder,Brazil,South America
910,Fernando,BRA,Sevilla,La Liga,2022,35.0,1987.0,17.5,34,23,14,17,3,18,30,60.0,12,21,10,11,24,58,29,0,"MF,DF",35-39,Midfielder,Brazil,South America
911,Alex Ferrari,ITA,Sampdoria,Serie A,2022,28.0,1994.0,9.6,9,5,7,2,0,4,8,50.0,4,21,10,11,19,28,25,0,DF,25-29,Defender,Italy,Europe
912,Alex Ferrari,ITA,Cremonese,Serie A,2022,28.0,1994.0,11.2,40,23,32,7,1,28,42,66.7,14,19,4,15,25,65,45,1,DF,25-29,Defender,Italy,Europe
914,Jordan Ferri,FRA,Montpellier,Ligue 1,2022,30.0,1992.0,30.4,55,35,32,19,4,30,89,33.7,59,22,6,16,26,81,21,0,MF,30-34,Midfielder,France,Europe
917,Vincenzo Fiorillo,ITA,Salernitana,Serie A,2022,32.0,1990.0,1.0,0,0,0,0,0,0,0,,0,0,0,0,0,0,0,0,GK,30-34,Goalkeeper,Italy,Europe
918,Roberto Firmino,BRA,Liverpool,Premier League,2022,30.0,1991.0,13.5,17,12,2,12,3,4,22,18.2,18,16,1,15,7,24,2,0,"FW,MF",30-34,Forward,Brazil,South America
919,Junior Firpo,DOM,Leeds United,Premier League,2022,25.0,1996.0,15.2,47,25,27,15,5,24,46,52.2,22,23,7,16,24,71,40,0,DF,25-29,Defender,Dominican Republic,North America
920,Kilian Fischer,GER,Wolfsburg,Bundesliga,2022,21.0,2000.0,5.6,9,6,3,4,2,6,11,54.5,5,6,0,6,5,14,18,0,"DF,FW",20-24,Defender,Germany,Europe
921,Mark Flekken,NED,Freiburg,Bundesliga,2022,29.0,1993.0,34.0,0,0,0,0,0,0,1,0.0,1,1,0,1,0,0,9,5,GK,25-29,Goalkeeper,Netherlands,Europe
922,Florian Flick,GER,Schalke 04,Bundesliga,2022,22.0,2000.0,5.7,12,3,7,5,0,4,14,28.6,10,9,3,6,4,16,18,0,MF,20-24,Midfielder,Germany,Europe
923,Alexis Flips,FRA,Reims,Ligue 1,2022,22.0,2000.0,22.0,51,30,18,17,16,27,64,42.2,37,35,5,30,24,75,12,0,"FW,MF",20-24,Forward,France,Europe
924,Alessandro Florenzi,ITA,Milan,Serie A,2022,31.0,1991.0,2.3,6,4,3,2,1,4,7,57.1,3,1,0,1,4,10,2,0,DF,30-34,Defender,Italy,Europe
925,Phil Foden,ENG,Manchester City,Premier League,2022,22.0,2000.0,20.5,16,10,9,5,2,8,19,42.1,11,25,2,23,5,21,12,0,FW,20-24,Forward,England,Europe
926,Seko Fofana,CIV,Lens,Ligue 1,2022,27.0,1995.0,34.1,28,13,8,18,2,15,39,38.5,24,17,4,13,19,47,14,0,MF,25-29,Midfielder,Ivory Coast,Africa
927,Wesley Fofana,FRA,Leicester City,Premier League,2022,21.0,2000.0,2.0,4,2,1,2,1,1,3,33.3,2,1,1,0,9,13,5,0,DF,20-24,Defender,France,Europe
928,Wesley Fofana,FRA,Chelsea,Premier League,2022,21.0,2000.0,13.1,30,18,19,7,4,13,26,50.0,13,17,10,7,20,50,33,2,DF,20-24,Defender,France,Europe
929,Yahia Fofana,CIV,Angers,Ligue 1,2022,21.0,2000.0,11.0,0,0,0,0,0,0,0,,0,0,0,0,1,1,4,1,GK,20-24,Goalkeeper,Ivory Coast,Africa
930,Youssouf Fofana,FRA,Monaco,Ligue 1,2022,23.0,1999.0,34.3,81,41,31,42,8,38,74,51.4,36,50,6,44,56,137,32,1,MF,20-24,Midfielder,France,Europe
931,Thomas Foket,BEL,Reims,Ligue 1,2022,27.0,1994.0,22.0,35,22,18,11,6,17,46,37.0,29,21,7,14,33,68,29,2,DF,25-29,Defender,Belgium,Europe
932,José Fonte,POR,Lille,Ligue 1,2022,38.0,1983.0,28.8,23,17,18,4,1,10,21,47.6,11,27,14,13,25,48,112,2,DF,35-39,Defender,Portugal,Europe
934,Emil Forsberg,SWE,RB Leipzig,Bundesliga,2022,30.0,1991.0,16.5,16,11,1,8,7,6,20,30.0,14,25,2,23,3,19,7,0,"MF,FW",30-34,Midfielder,Sweden,Europe
935,Adam Forshaw,ENG,Leeds United,Premier League,2022,30.0,1991.0,5.3,12,9,5,7,0,7,17,41.2,10,9,1,8,4,16,2,0,MF,30-34,Midfielder,England,Europe
936,Fraser Forster,ENG,Tottenham,Premier League,2022,34.0,1988.0,13.5,1,0,1,0,0,0,0,,0,1,0,1,0,1,3,1,GK,30-34,Goalkeeper,England,Europe
937,Philipp Förster,GER,Bochum,Bundesliga,2022,27.0,1995.0,14.5,31,19,11,15,5,12,40,30.0,28,22,0,22,6,37,6,0,MF,25-29,Midfielder,Germany,Europe
938,Steven Fortes,CPV,Lens,Ligue 1,2022,30.0,1992.0,0.1,0,0,0,0,0,0,0,,0,0,0,0,0,0,0,0,DF,30-34,Defender,Cape Verde,Africa
939,Timothy Fosu-Mensah,NED,Leverkusen,Bundesliga,2022,24.0,1998.0,2.1,7,5,3,3,1,4,4,100.0,0,2,0,2,0,7,1,0,DF,20-24,Defender,Netherlands,Europe
940,Dimitri Foulquier,FRA,Valencia,La Liga,2022,29.0,1993.0,19.3,31,19,17,8,6,20,28,71.4,8,19,3,16,14,45,40,0,DF,25-29,Defender,France,Europe
941,Juan Foyth,ARG,Villarreal,La Liga,2022,24.0,1998.0,21.8,73,48,49,22,2,41,57,71.9,16,32,11,21,20,93,68,0,DF,20-24,Defender,Argentina,South America
942,Raphael Framberger,GER,Augsburg,Bundesliga,2022,26.0,1995.0,2.0,10,6,6,4,0,3,5,60.0,2,2,1,1,2,12,5,0,"DF,FW",25-29,Defender,Germany,Europe
943,Tyrese Francois,AUS,Fulham,Premier League,2022,22.0,2000.0,0.0,0,0,0,0,0,0,1,0.0,1,0,0,0,0,0,1,0,FW,20-24,Forward,Australia,Oceania
944,Bartol Franjić,CRO,Wolfsburg,Bundesliga,2022,22.0,2000.0,2.5,4,2,2,2,0,0,2,0.0,2,4,1,3,5,9,4,0,MF,20-24,Midfielder,Croatia,Europe
946,Ryan Fraser,SCO,Newcastle Utd,Premier League,2022,28.0,1994.0,3.5,2,2,0,0,2,2,5,40.0,3,3,1,2,0,2,3,0,FW,25-29,Forward,Scotland,Europe
947,Davide Frattesi,ITA,Sassuolo,Serie A,2022,22.0,1999.0,31.9,63,36,24,29,10,25,44,56.8,19,27,6,21,16,79,42,0,MF,20-24,Midfielder,Italy,Europe
948,Oscar Fraulo,DEN,Gladbach,Bundesliga,2022,18.0,2003.0,0.1,0,0,0,0,0,0,0,,0,0,0,0,0,0,0,0,"FW,MF",Under 20,Forward,Denmark,Europe
949,Fred,BRA,Manchester Utd,Premier League,2022,29.0,1993.0,13.9,47,30,24,20,3,15,38,39.5,23,38,2,36,19,66,19,0,MF,25-29,Midfielder,Brazil,South America
950,Ryan Fredericks,ENG,Bournemouth,Premier League,2022,29.0,1992.0,5.9,3,2,2,0,1,1,4,25.0,3,7,2,5,1,4,27,0,DF,25-29,Defender,England,Europe
952,Remo Freuler,SUI,Nott'ham Forest,Premier League,2022,30.0,1992.0,24.0,43,23,23,15,5,19,43,44.2,24,36,9,27,29,72,45,0,MF,30-34,Midfielder,Switzerland,Europe
953,Michael Frey,SUI,Schalke 04,Bundesliga,2022,28.0,1994.0,9.6,13,5,2,8,3,4,13,30.8,9,6,0,6,2,15,1,0,FW,25-29,Forward,Switzerland,Europe
954,Marco Friedl,AUT,Werder Bremen,Bundesliga,2022,24.0,1998.0,28.8,62,46,40,22,0,41,68,60.3,27,46,17,29,58,120,127,1,DF,20-24,Defender,Austria,Europe
955,Marvin Friedrich,GER,Gladbach,Bundesliga,2022,26.0,1995.0,13.9,17,11,13,3,1,10,13,76.9,3,14,6,8,11,28,52,0,DF,25-29,Defender,Germany,Europe
956,Jeremie Frimpong,NED,Leverkusen,Bundesliga,2022,21.0,2000.0,30.1,53,27,22,26,5,23,44,52.3,21,24,3,21,16,69,40,0,"DF,MF",20-24,Defender,Netherlands,Europe
957,Chris Führich,GER,Stuttgart,Bundesliga,2022,24.0,1998.0,20.9,36,14,15,14,7,24,44,54.5,20,29,2,27,7,43,13,0,"FW,MF",20-24,Forward,Germany,Europe
958,Angelo Fulgini,FRA,Lens,Ligue 1,2022,25.0,1996.0,9.5,14,7,2,4,8,5,14,35.7,9,11,0,11,8,22,2,0,"MF,FW",25-29,Midfielder,France,Europe
959,Angelo Fulgini,FRA,Mainz 05,Bundesliga,2022,25.0,1996.0,5.8,6,5,2,3,1,5,12,41.7,7,5,0,5,5,11,7,0,MF,25-29,Midfielder,France,Europe
960,Niclas Füllkrug,GER,Werder Bremen,Bundesliga,2022,29.0,1993.0,27.5,9,4,0,6,3,3,13,23.1,10,13,4,9,1,10,24,0,FW,25-29,Forward,Germany,Europe
961,Matteo Gabbia,ITA,Milan,Serie A,2022,22.0,1999.0,6.8,17,10,12,5,0,6,8,75.0,2,8,3,5,5,22,29,0,DF,20-24,Defender,Italy,Europe
962,Manolo Gabbiadini,ITA,Sampdoria,Serie A,2022,30.0,1991.0,26.2,23,15,8,9,6,9,23,39.1,14,16,2,14,6,29,25,0,"FW,MF",30-34,Forward,Italy,Europe
963,Gianluca Gaetano,ITA,Napoli,Serie A,2022,22.0,2000.0,0.8,5,3,1,3,1,0,0,,0,1,0,1,1,6,0,0,MF,20-24,Midfielder,Italy,Europe
964,Roberto Gagliardini,ITA,Inter,Serie A,2022,28.0,1994.0,8.7,16,6,9,6,1,10,21,47.6,11,14,5,9,4,20,15,0,MF,25-29,Midfielder,Italy,Europe
965,Adolfo Gaich,ARG,Hellas Verona,Serie A,2022,23.0,1999.0,8.1,5,3,0,3,2,1,6,16.7,5,7,2,5,3,8,7,1,FW,20-24,Forward,Argentina,South America
966,Cody Gakpo,NED,Liverpool,Premier League,2022,23.0,1999.0,16.2,26,15,4,13,9,13,38,34.2,25,13,1,12,4,30,2,0,"FW,MF",20-24,Forward,Netherlands,Europe
969,Pablo Galdames Millán,CHI,Cremonese,Serie A,2022,25.0,1996.0,8.2,14,10,8,3,3,5,33,15.2,28,13,2,11,10,24,13,0,MF,25-29,Midfielder,Chile,South America
970,Conor Gallagher,ENG,Chelsea,Premier League,2022,22.0,2000.0,18.0,46,33,17,19,10,10,37,27.0,27,41,10,31,23,69,18,1,MF,20-24,Midfielder,England,Europe
971,Antonino Gallo,ITA,Lecce,Serie A,2022,22.0,2000.0,27.6,56,36,35,12,9,38,57,66.7,19,37,6,31,13,69,71,0,DF,20-24,Defender,Italy,Europe
972,Gauthier Gallon,FRA,Troyes,Ligue 1,2022,29.0,1993.0,29.6,2,2,2,0,0,2,4,50.0,2,0,0,0,2,4,17,0,GK,25-29,Goalkeeper,France,Europe
973,Cristian Gamboa,CRC,Bochum,Bundesliga,2022,32.0,1989.0,16.4,42,24,27,14,1,21,31,67.7,10,20,7,13,16,58,34,1,DF,30-34,Defender,Costa Rica,North America
974,Kévin Gameiro,FRA,Strasbourg,Ligue 1,2022,35.0,1987.0,23.3,20,10,6,10,4,8,28,28.6,20,10,1,9,9,29,0,0,FW,35-39,Forward,France,Europe
975,Idrissa Gana Gueye,SEN,Everton,Premier League,2022,32.0,1989.0,28.6,97,57,49,35,13,31,62,50.0,31,50,12,38,56,153,34,3,MF,30-34,Midfielder,Senegal,Africa
976,Ignatius Ganago,CMR,Nantes,Ligue 1,2022,23.0,1999.0,16.9,9,7,2,3,4,4,7,57.1,3,13,1,12,2,11,12,0,"FW,MF",20-24,Forward,Cameroon,Africa
977,Ignatius Ganago,CMR,Lens,Ligue 1,2022,23.0,1999.0,0.7,0,0,0,0,0,0,0,,0,0,0,0,0,0,1,0,FW,20-24,Forward,Cameroon,Africa
978,Silvère Ganvoula M'Boussy,CGO,Bochum,Bundesliga,2022,26.0,1996.0,2.7,2,2,0,1,1,0,0,,0,0,0,0,0,2,3,0,"FW,MF",25-29,Forward,Congo,Africa
991,Alejandro Garnacho,ARG,Manchester Utd,Premier League,2022,18.0,2004.0,6.3,5,2,2,0,3,1,11,9.1,10,5,0,5,5,10,3,0,"FW,MF",Under 20,Forward,Argentina,South America
992,James Garner,ENG,Everton,Premier League,2022,21.0,2001.0,8.9,16,13,4,8,4,9,19,47.4,10,9,1,8,12,28,13,0,"MF,DF",20-24,Midfielder,England,Europe
995,Sékou Gassama,SEN,Valladolid,La Liga,2022,27.0,1995.0,0.4,0,0,0,0,0,0,0,,0,0,0,0,0,0,0,0,FW,25-29,Forward,Senegal,Africa
996,Johan Gastien,FRA,Clermont Foot,Ligue 1,2022,34.0,1988.0,28.9,62,34,30,23,9,38,111,34.2,73,37,7,30,36,98,25,1,MF,30-34,Midfielder,France,Europe
997,Federico Gatti,ITA,Juventus,Serie A,2022,24.0,1998.0,16.1,15,11,9,4,2,9,15,60.0,6,20,14,6,21,36,54,2,DF,20-24,Defender,Italy,Europe
999,Paulo Gazzaniga,ARG,Girona,La Liga,2022,30.0,1992.0,28.0,0,0,0,0,0,0,1,0.0,1,0,0,0,1,1,9,5,GK,30-34,Goalkeeper,Argentina,South America
1001,Dario Gebuhr,GER,Eint Frankfurt,Bundesliga,2022,19.0,2003.0,0.2,0,0,0,0,0,0,1,0.0,1,0,0,0,0,0,0,0,DF,Under 20,Defender,Germany,Europe
1002,Dennis Geiger,GER,Hoffenheim,Bundesliga,2022,24.0,1998.0,21.7,45,25,15,28,2,22,35,62.9,13,27,3,24,24,69,18,2,MF,20-24,Midfielder,Germany,Europe
1003,Joe Gelhardt,ENG,Leeds United,Premier League,2022,20.0,2002.0,2.4,6,2,1,3,2,3,5,60.0,2,5,0,5,0,6,4,0,FW,20-24,Forward,England,Europe
1004,Valentin Gendrey,FRA,Lecce,Serie A,2022,22.0,2000.0,34.5,88,57,54,25,9,40,71,56.3,31,45,4,41,37,125,89,0,DF,20-24,Defender,France,Europe
1005,Denis Genreau,AUS,Toulouse,Ligue 1,2022,23.0,1999.0,7.3,35,13,16,12,7,13,31,41.9,18,16,1,15,8,43,9,0,MF,20-24,Midfielder,Australia,Oceania
1006,Yannick Gerhardt,GER,Wolfsburg,Bundesliga,2022,28.0,1994.0,20.7,29,15,10,11,8,12,30,40.0,18,26,5,21,7,36,24,0,MF,25-29,Midfielder,Germany,Europe
1007,Valère Germain,FRA,Montpellier,Ligue 1,2022,32.0,1990.0,7.6,13,11,3,5,5,4,12,33.3,8,8,0,8,6,19,12,0,"FW,MF",30-34,Forward,France,Europe
1008,Gerson,BRA,Marseille,Ligue 1,2022,25.0,1997.0,4.6,6,4,1,4,1,3,5,60.0,2,5,0,5,2,8,4,0,MF,25-29,Midfielder,Brazil,South America
1010,Paolo Ghiglione,ITA,Cremonese,Serie A,2022,25.0,1997.0,7.9,16,11,10,3,3,10,23,43.5,13,9,4,5,4,20,12,0,DF,25-29,Defender,Italy,Europe
1011,Saman Ghoddos,IRN,Brentford,Premier League,2022,28.0,1993.0,1.5,2,1,0,1,1,1,3,33.3,2,5,1,4,4,6,2,0,"MF,FW",25-29,Midfielder,Iran,Asia
1012,Faouzi Ghoulam,ALG,Angers,Ligue 1,2022,31.0,1991.0,5.3,3,3,1,1,1,3,5,60.0,2,4,2,2,4,7,12,1,DF,30-34,Defender,Algeria,Africa
1013,Morgan Gibbs-White,ENG,Wolves,Premier League,2022,22.0,2000.0,2.0,3,1,3,0,0,2,4,50.0,2,2,0,2,1,4,3,0,"FW,MF",20-24,Forward,England,Europe
1014,Morgan Gibbs-White,ENG,Nott'ham Forest,Premier League,2022,22.0,2000.0,33.0,26,14,7,7,12,11,33,33.3,22,23,4,19,14,40,15,0,"MF,FW",20-24,Midfielder,England,Europe
1015,Niko Gießelmann,GER,Union Berlin,Bundesliga,2022,30.0,1991.0,14.5,21,11,9,9,3,13,31,41.9,18,17,5,12,9,30,28,0,DF,30-34,Defender,Germany,Europe
1016,Samuel Gigot,FRA,Marseille,Ligue 1,2022,28.0,1993.0,20.9,46,24,22,21,3,12,15,80.0,3,24,7,17,45,91,85,1,DF,25-29,Defender,France,Europe
1023,Billy Gilmour,SCO,Brighton,Premier League,2022,21.0,2001.0,5.6,5,2,2,2,1,2,8,25.0,6,5,2,3,6,11,5,0,MF,20-24,Midfielder,Scotland,Europe
1025,Gvidas Gineitis,LTU,Torino,Serie A,2022,18.0,2004.0,1.5,3,1,0,2,1,1,2,50.0,1,0,0,0,0,3,1,0,MF,Under 20,Midfielder,Lithuania,Europe
1026,Matthias Ginter,GER,Freiburg,Bundesliga,2022,28.0,1994.0,34.0,43,20,29,12,2,26,40,65.0,14,40,24,16,35,78,153,3,DF,25-29,Defender,Germany,Europe
1027,Andrei Girotto,BRA,Nantes,Ligue 1,2022,30.0,1992.0,35.0,122,73,71,45,6,74,132,56.1,58,55,24,31,73,195,176,1,"DF,MF",30-34,Defender,Brazil,South America
1028,Olivier Giroud,FRA,Milan,Serie A,2022,35.0,1986.0,23.8,8,5,2,4,2,2,10,20.0,8,11,3,8,3,11,23,0,FW,35-39,Forward,France,Europe
1029,Jamie Gittens,ENG,Dortmund,Bundesliga,2022,17.0,2004.0,5.9,8,4,2,5,1,2,7,28.6,5,1,0,1,1,9,2,0,"FW,MF",Under 20,Forward,England,Europe
1030,Serge Gnabry,GER,Bayern Munich,Bundesliga,2022,27.0,1995.0,21.6,35,23,11,14,10,17,43,39.5,26,24,1,23,11,46,5,1,"FW,MF",25-29,Forward,Germany,Europe
1031,Wilfried Gnonto,ITA,Leeds United,Premier League,2022,18.0,2003.0,15.0,27,17,7,15,5,10,30,33.3,20,24,1,23,5,32,7,0,"FW,MF",Under 20,Forward,Italy,Europe
1032,Ben Godfrey,ENG,Everton,Premier League,2022,24.0,1998.0,8.9,20,11,13,5,2,11,29,37.9,18,12,6,6,8,28,33,1,DF,20-24,Defender,England,Europe
1033,Pierluigi Gollini,ITA,Fiorentina,Serie A,2022,27.0,1995.0,3.0,1,0,1,0,0,1,1,100.0,0,0,0,0,0,1,2,0,GK,25-29,Goalkeeper,Italy,Europe
1034,Pierluigi Gollini,ITA,Napoli,Serie A,2022,27.0,1995.0,4.0,0,0,0,0,0,0,0,,0,0,0,0,0,0,1,0,GK,25-29,Goalkeeper,Italy,Europe
1035,Aleksandr Golovin,RUS,Monaco,Ligue 1,2022,26.0,1996.0,27.4,62,36,19,32,11,28,72,38.9,44,28,1,27,37,99,10,0,"MF,FW",25-29,Midfielder,Russia,Europe
1036,André Gomes,POR,Lille,Ligue 1,2022,29.0,1993.0,18.1,37,19,12,17,8,19,52,36.5,33,20,5,15,9,46,16,1,MF,25-29,Midfielder,Portugal,Europe
1036,André Gomes,POR,Lille,Ligue 1,2022,29.0,1993.0,18.1,37,19,12,17,8,19,52,36.5,33,20,5,15,9,46,16,1,MF,25-29,Midfielder,Portugal,Europe
1036,André Gomes,POR,Lille,Ligue 1,2022,29.0,1993.0,18.1,37,19,12,17,8,19,52,36.5,33,20,5,15,9,46,16,1,MF,25-29,Midfielder,Portugal,Europe
1036,André Gomes,POR,Lille,Ligue 1,2022,29.0,1993.0,18.1,37,19,12,17,8,19,52,36.5,33,20,5,15,9,46,16,1,MF,25-29,Midfielder,Portugal,Europe
1037,Angel Gomes,ENG,Lille,Ligue 1,2022,21.0,2000.0,31.3,41,19,12,21,8,18,49,36.7,31,22,2,20,13,54,11,1,MF,20-24,Midfielder,England,Europe
1038,João Gomes,BRA,Wolves,Premier League,2022,21.0,2001.0,7.3,29,13,14,14,1,13,23,56.5,10,12,3,9,4,33,11,0,MF,20-24,Midfielder,Brazil,South America
1038,João Gomes,BRA,Wolves,Premier League,2022,21.0,2001.0,7.3,29,13,14,14,1,13,23,56.5,10,12,3,9,4,33,11,0,MF,20-24,Midfielder,Brazil,South America
1038,João Gomes,BRA,Wolves,Premier League,2022,21.0,2001.0,7.3,29,13,14,14,1,13,23,56.5,10,12,3,9,4,33,11,0,MF,20-24,Midfielder,Brazil,South America
1038,João Gomes,BRA,Wolves,Premier League,2022,21.0,2001.0,7.3,29,13,14,14,1,13,23,56.5,10,12,3,9,4,33,11,0,MF,20-24,Midfielder,Brazil,South America
1039,Toti Gomes,POR,Wolves,Premier League,2022,23.0,1999.0,10.9,15,9,11,4,0,9,13,69.2,4,16,8,8,11,26,51,0,DF,20-24,Defender,Portugal,Europe
1041,Joe Gomez,ENG,Liverpool,Premier League,2022,25.0,1997.0,16.3,28,21,15,11,2,11,19,57.9,8,17,11,6,24,52,51,2,DF,25-29,Defender,England,Europe
1042,Maxi Gómez,URU,Valencia,La Liga,2022,25.0,1996.0,1.2,0,0,0,0,0,0,0,,0,0,0,0,0,0,2,0,FW,25-29,Forward,Uruguay,South America
1044,Papu Gómez,ARG,Sevilla,La Liga,2022,34.0,1988.0,11.8,6,4,3,3,0,2,10,20.0,8,8,1,7,4,10,5,0,"FW,MF",30-34,Forward,Argentina,South America
1048,Maxime Gonalons,FRA,Clermont Foot,Ligue 1,2022,33.0,1989.0,16.1,52,32,25,21,6,25,53,47.2,28,21,1,20,20,72,7,1,MF,30-34,Midfielder,France,Europe
1051,Giovanni González,URU,Mallorca,La Liga,2022,27.0,1994.0,10.3,16,8,11,2,3,9,22,40.9,13,8,2,6,7,23,22,0,DF,25-29,Defender,Uruguay,South America
1053,Nicolás González,ARG,Fiorentina,Serie A,2022,24.0,1998.0,15.0,17,10,3,10,4,5,16,31.3,11,14,0,14,4,21,6,0,"FW,MF",20-24,Forward,Argentina,South America
1055,Oumar Gonzalez,CMR,Ajaccio,Ligue 1,2022,24.0,1998.0,28.6,51,28,34,13,4,23,37,62.2,14,32,11,21,52,103,82,0,DF,20-24,Defender,Cameroon,Africa
1058,Anthony Gordon,ENG,Newcastle Utd,Premier League,2022,21.0,2001.0,5.4,14,12,5,7,2,9,20,45.0,11,9,1,8,2,16,1,1,"FW,MF",20-24,Forward,England,Europe
1059,Anthony Gordon,ENG,Everton,Premier League,2022,21.0,2001.0,12.2,34,22,17,10,7,8,24,33.3,16,19,0,19,4,38,11,0,FW,20-24,Forward,England,Europe
1060,Leon Goretzka,GER,Bayern Munich,Bundesliga,2022,27.0,1995.0,19.2,43,24,21,16,6,27,48,56.3,21,40,3,37,30,73,32,0,MF,25-29,Midfielder,Germany,Europe
1062,Robin Gosens,GER,Inter,Serie A,2022,28.0,1994.0,13.2,34,18,15,10,9,15,25,60.0,10,16,2,14,23,57,15,0,DF,25-29,Defender,Germany,Europe
1063,Mario Götze,GER,Eint Frankfurt,Bundesliga,2022,30.0,1992.0,30.4,42,25,13,22,7,14,47,29.8,33,25,0,25,13,55,12,0,MF,30-34,Midfielder,Germany,Europe
1064,Amine Gouiri,ALG,Nice,Ligue 1,2022,22.0,2000.0,2.5,1,1,1,0,0,0,1,0.0,1,1,0,1,0,1,3,0,"FW,MF",20-24,Forward,Algeria,Africa
1065,Amine Gouiri,ALG,Rennes,Ligue 1,2022,22.0,2000.0,28.0,42,25,14,16,12,14,33,42.4,19,21,0,21,12,54,10,0,"FW,MF",20-24,Forward,Algeria,Africa
1066,Jeffrey Gouweleeuw,NED,Augsburg,Bundesliga,2022,31.0,1991.0,31.1,42,27,19,17,6,24,49,49.0,25,41,23,18,50,92,141,2,DF,30-34,Defender,Netherlands,Europe
1067,Jonathan Gradit,FRA,Lens,Ligue 1,2022,29.0,1992.0,31.4,62,40,30,25,7,31,53,58.5,22,40,26,14,38,100,83,0,DF,25-29,Defender,France,Europe
1069,Alberto Grassi,ITA,Empoli,Serie A,2022,27.0,1995.0,13.3,26,21,13,13,0,15,24,62.5,9,23,12,11,27,53,45,0,MF,25-29,Midfielder,Italy,Europe
1070,Ryan Gravenberch,NED,Bayern Munich,Bundesliga,2022,20.0,2002.0,6.4,17,8,4,10,3,7,13,53.8,6,9,1,8,9,26,10,0,MF,20-24,Midfielder,Netherlands,Europe
1073,Demarai Gray,JAM,Everton,Premier League,2022,26.0,1996.0,27.9,33,24,9,14,10,17,31,54.8,14,23,3,20,13,46,18,0,"FW,MF",25-29,Forward,Jamaica,North America
1074,Adrian Grbić,AUT,Lorient,Ligue 1,2022,25.0,1996.0,0.3,0,0,0,0,0,0,1,0.0,1,3,0,3,0,0,0,0,"MF,FW",25-29,Midfielder,Austria,Europe
1075,Ivo Grbić,CRO,Atlético Madrid,La Liga,2022,26.0,1996.0,10.2,0,0,0,0,0,0,0,,0,0,0,0,0,0,9,1,GK,25-29,Goalkeeper,Croatia,Europe
1076,Jack Grealish,ENG,Manchester City,Premier League,2022,26.0,1995.0,22.8,25,16,10,12,3,13,23,56.5,10,17,3,14,7,32,9,0,FW,25-29,Forward,England,Europe
1077,Sam Greenwood,ENG,Leeds United,Premier League,2022,20.0,2002.0,4.7,15,7,7,8,0,8,21,38.1,13,10,2,8,1,16,1,0,"MF,FW",20-24,Midfielder,England,Europe
1078,Michael Gregoritsch,AUT,Freiburg,Bundesliga,2022,28.0,1994.0,23.9,19,12,6,9,4,3,21,14.3,18,23,4,19,5,24,10,0,FW,25-29,Forward,Austria,Europe
1079,Dominik Greif,SVK,Mallorca,La Liga,2022,25.0,1997.0,1.0,0,0,0,0,0,0,0,,0,0,0,0,0,0,0,0,GK,25-29,Goalkeeper,Slovakia,Europe
1080,Leo Greiml,AUT,Schalke 04,Bundesliga,2022,21.0,2001.0,4.0,10,5,4,5,1,5,12,41.7,7,7,3,4,3,13,16,0,DF,20-24,Defender,Austria,Europe
1081,Clément Grenier,FRA,Mallorca,La Liga,2022,31.0,1991.0,8.0,20,8,6,12,2,10,20,50.0,10,9,1,8,6,26,7,0,MF,30-34,Midfielder,France,Europe
1082,Antoine Griezmann,FRA,Atlético Madrid,La Liga,2022,31.0,1991.0,31.8,49,34,15,23,11,20,66,30.3,46,34,3,31,24,73,31,0,"FW,MF",30-34,Forward,France,Europe
1083,Vincenzo Grifo,ITA,Freiburg,Bundesliga,2022,29.0,1993.0,26.8,29,16,6,15,8,13,31,41.9,18,18,1,17,19,48,19,0,"MF,FW",25-29,Midfielder,Italy,Europe
1084,Lennart Grill,GER,Union Berlin,Bundesliga,2022,23.0,1999.0,5.0,0,0,0,0,0,0,1,0.0,1,0,0,0,0,0,1,1,GK,20-24,Goalkeeper,Germany,Europe
1085,Christian Groß,GER,Werder Bremen,Bundesliga,2022,33.0,1989.0,21.0,56,25,20,34,2,29,60,48.3,31,20,5,15,23,79,38,1,MF,30-34,Midfielder,Germany,Europe
1086,Pascal Groß,GER,Brighton,Premier League,2022,31.0,1991.0,36.0,59,38,23,27,9,25,55,45.5,30,32,10,22,13,72,21,1,"MF,DF",30-34,Midfielder,Germany,Europe
1087,Brajan Gruda,GER,Mainz 05,Bundesliga,2022,18.0,2004.0,0.0,0,0,0,0,0,0,0,,0,0,0,0,0,0,0,0,MF,Under 20,Midfielder,Germany,Europe
1088,Ilia Gruev,BUL,Werder Bremen,Bundesliga,2022,22.0,2000.0,17.6,44,27,16,25,3,18,31,58.1,13,23,6,17,22,66,21,1,MF,20-24,Midfielder,Bulgaria,Europe
1089,Carlos Gruezo,ECU,Augsburg,Bundesliga,2022,27.0,1995.0,10.7,21,12,12,9,0,9,16,56.3,7,13,4,9,10,31,15,0,MF,25-29,Midfielder,Ecuador,South America
1091,Andrés Guardado,MEX,Betis,La Liga,2022,35.0,1986.0,15.3,41,25,17,20,4,18,43,41.9,25,14,5,9,23,64,29,0,MF,35-39,Midfielder,Mexico,North America
1095,Gabriel Gudmundsson,SWE,Lille,Ligue 1,2022,23.0,1999.0,9.3,19,11,7,10,2,12,22,54.5,10,11,2,9,10,29,20,0,"DF,FW",20-24,Defender,Sweden,Europe
1096,Gonçalo Guedes,POR,Wolves,Premier League,2022,25.0,1996.0,7.9,8,6,4,3,1,5,8,62.5,3,4,0,4,1,9,2,0,"FW,MF",25-29,Forward,Portugal,Europe
1097,Axel Gueguin,FRA,Montpellier,Ligue 1,2022,17.0,2005.0,0.3,0,0,0,0,0,0,0,,0,1,0,1,0,0,0,0,"FW,MF",Under 20,Forward,France,Europe
1098,Marc Guéhi,ENG,Crystal Palace,Premier League,2022,22.0,2000.0,37.0,52,27,39,11,2,26,42,61.9,16,45,24,21,45,97,134,3,DF,20-24,Defender,England,Europe
1099,Mattéo Guendouzi,FRA,Marseille,Ligue 1,2022,23.0,1999.0,23.4,39,18,9,21,9,14,38,36.8,24,12,5,7,21,60,18,0,MF,20-24,Midfielder,France,Europe
1101,Raphaël Guerreiro,POR,Dortmund,Bundesliga,2022,28.0,1993.0,25.4,36,20,13,15,8,21,34,61.8,13,21,2,19,36,72,23,0,"DF,MF",25-29,Defender,Portugal,Europe
1102,Axel Guessand,FRA,Udinese,Serie A,2022,17.0,2004.0,0.9,2,1,2,0,0,1,2,50.0,1,1,0,1,2,4,3,0,DF,Under 20,Defender,France,Europe
1103,Evann Guessand,CIV,Nantes,Ligue 1,2022,21.0,2001.0,14.0,24,16,8,13,3,6,12,50.0,6,17,1,16,9,33,6,0,"FW,MF",20-24,Forward,Ivory Coast,Africa
1105,Pape Gueye,SEN,Sevilla,La Liga,2022,23.0,1999.0,13.0,37,22,13,21,3,16,33,48.5,17,21,5,16,22,59,10,0,MF,20-24,Midfielder,Senegal,Africa
1106,Pape Gueye,SEN,Marseille,Ligue 1,2022,23.0,1999.0,5.5,18,7,10,7,1,7,15,46.7,8,9,2,7,9,27,2,0,"MF,DF",20-24,Midfielder,Senegal,Africa
1107,Josuha Guilavogui,FRA,Wolfsburg,Bundesliga,2022,31.0,1990.0,13.1,18,11,7,10,1,6,17,35.3,11,19,13,6,23,41,52,0,"DF,MF",30-34,Defender,France,Europe
1108,Frederic Guilbert,FRA,Strasbourg,Ligue 1,2022,27.0,1994.0,16.2,47,29,18,23,6,25,43,58.1,18,24,3,21,43,90,33,1,DF,25-29,Defender,France,Europe
1110,Bruno Guimarães,BRA,Newcastle Utd,Premier League,2022,24.0,1997.0,30.3,78,40,27,46,5,38,65,58.5,27,28,4,24,36,114,22,1,MF,20-24,Midfielder,Brazil,South America
1111,Serhou Guirassy,GUI,Rennes,Ligue 1,2022,26.0,1996.0,0.3,0,0,0,0,0,0,0,,0,0,0,0,0,0,0,0,MF,25-29,Midfielder,Guinea,Africa
1112,Serhou Guirassy,GUI,Stuttgart,Bundesliga,2022,26.0,1996.0,18.3,4,1,2,2,0,1,2,50.0,1,7,2,5,0,4,14,0,FW,25-29,Forward,Guinea,Africa
1113,Rafik Guitane,FRA,Reims,Ligue 1,2022,23.0,1999.0,0.0,0,0,0,0,0,0,0,,0,0,0,0,0,0,1,0,FW,20-24,Forward,France,Europe
1114,Péter Gulácsi,HUN,RB Leipzig,Bundesliga,2022,32.0,1990.0,6.0,0,0,0,0,0,0,0,,0,0,0,0,0,0,2,0,GK,30-34,Goalkeeper,Hungary,Europe
1115,Manuel Gulde,GER,Freiburg,Bundesliga,2022,31.0,1991.0,7.1,14,8,10,4,0,2,4,50.0,2,5,1,4,19,33,25,0,DF,30-34,Defender,Germany,Europe
1118,İlkay Gündoğan,GER,Manchester City,Premier League,2022,31.0,1990.0,26.1,30,18,7,13,10,12,34,35.3,22,18,3,15,20,50,13,0,MF,30-34,Midfielder,Germany,Europe
1119,Christian Günter,GER,Freiburg,Bundesliga,2022,29.0,1993.0,30.5,29,21,18,9,2,13,43,30.2,30,22,4,18,16,45,41,0,"DF,MF",25-29,Defender,Germany,Europe
1120,Koray Günter,GER,Hellas Verona,Serie A,2022,27.0,1994.0,11.1,10,6,1,8,1,4,7,57.1,3,24,15,9,30,40,46,0,DF,25-29,Defender,Germany,Europe
1121,Koray Günter,GER,Sampdoria,Serie A,2022,27.0,1994.0,8.6,10,8,6,4,0,6,9,66.7,3,10,5,5,11,21,46,0,DF,25-29,Defender,Germany,Europe
1123,Malo Gusto,FRA,Lyon,Ligue 1,2022,19.0,2003.0,17.7,42,26,23,11,8,21,43,48.8,22,22,5,17,28,70,23,1,DF,Under 20,Defender,France,Europe
1126,Joško Gvardiol,CRO,RB Leipzig,Bundesliga,2022,20.0,2002.0,24.1,23,17,15,8,0,9,22,40.9,13,34,17,17,34,57,76,1,DF,20-24,Defender,Croatia,Europe
1127,Darko Gyabi,ENG,Leeds United,Premier League,2022,18.0,2004.0,0.1,2,2,1,1,0,0,0,,0,2,0,2,0,2,0,0,FW,Under 20,Forward,England,Europe
1128,Emmanuel Gyasi,GHA,Spezia,Serie A,2022,28.0,1994.0,31.2,24,15,11,10,3,9,36,25.0,27,24,6,18,8,32,26,0,"FW,DF",25-29,Forward,Ghana,Africa
1129,Norbert Gyömbér,SVK,Salernitana,Serie A,2022,30.0,1992.0,19.3,32,23,25,6,1,16,24,66.7,8,33,22,11,35,67,92,0,DF,30-34,Defender,Slovakia,Europe
1130,Christian Gytkjær,DEN,Monza,Serie A,2022,32.0,1990.0,6.2,6,2,1,4,1,2,5,40.0,3,6,1,5,0,6,2,0,"FW,MF",30-34,Forward,Denmark,Europe
1132,Nicolas Haas,SUI,Empoli,Serie A,2022,26.0,1996.0,12.8,27,13,16,6,5,12,24,50.0,12,16,4,12,8,35,27,0,MF,25-29,Midfielder,Switzerland,Europe
1133,Janik Haberer,GER,Union Berlin,Bundesliga,2022,28.0,1994.0,24.3,29,17,8,18,3,17,48,35.4,31,35,2,33,14,43,25,0,MF,25-29,Midfielder,Germany,Europe
1134,Alexander Hack,GER,Mainz 05,Bundesliga,2022,28.0,1993.0,12.6,30,18,21,9,0,19,33,57.6,14,18,5,13,24,54,45,1,DF,25-29,Defender,Germany,Europe
1135,Munir El Haddadi,MAR,Getafe,La Liga,2022,26.0,1995.0,12.8,12,7,3,7,2,2,10,20.0,8,23,2,21,9,21,7,0,"MF,FW",25-29,Midfielder,Morocco,Africa
1136,Jaouen Hadjam,ALG,Nantes,Ligue 1,2022,19.0,2003.0,8.9,27,21,13,9,5,16,25,64.0,9,10,3,7,12,39,12,0,DF,Under 20,Defender,Algeria,Africa
1137,Dennis Hadzikadunic,BIH,Mallorca,La Liga,2022,24.0,1998.0,6.8,9,6,4,5,0,4,4,100.0,0,5,4,1,3,12,27,0,DF,20-24,Defender,Bosnia and Herzegovina,Europe
1138,André Hahn,GER,Augsburg,Bundesliga,2022,31.0,1990.0,4.3,9,5,4,4,1,8,12,66.7,4,9,2,7,4,13,14,0,"FW,MF",30-34,Forward,Germany,Europe
1139,Amadou Haidara,MLI,RB Leipzig,Bundesliga,2022,24.0,1998.0,15.9,25,11,15,10,0,13,34,38.2,21,26,6,20,26,51,20,0,MF,20-24,Midfielder,Mali,Africa
1140,Massadio Haïdara,MLI,Lens,Ligue 1,2022,29.0,1992.0,18.6,24,16,9,9,6,12,24,50.0,12,26,9,17,36,60,39,1,"DF,MF",25-29,Defender,Mali,Africa
1141,Achraf Hakimi,MAR,Paris S-G,Ligue 1,2022,23.0,1998.0,22.8,54,34,19,20,15,31,59,52.5,28,34,2,32,16,70,19,0,"DF,MF",20-24,Defender,Morocco,Africa
1142,Lewis Hall,ENG,Chelsea,Premier League,2022,17.0,2004.0,7.3,23,12,19,4,0,15,22,68.2,7,8,0,8,11,34,11,1,DF,Under 20,Defender,England,Europe
1143,Sébastien Haller,CIV,Dortmund,Bundesliga,2022,28.0,1994.0,13.6,5,4,2,1,2,0,4,0.0,4,8,0,8,1,6,10,0,FW,25-29,Forward,Ivory Coast,Africa
1144,Marcel Halstenberg,GER,RB Leipzig,Bundesliga,2022,30.0,1991.0,17.3,40,21,20,15,5,23,41,56.1,18,22,1,21,21,61,29,0,DF,30-34,Defender,Germany,Europe
1145,Mathis Hamdi,FRA,Troyes,Ligue 1,2022,18.0,2003.0,0.8,0,0,0,0,0,0,1,0.0,1,0,0,0,1,1,1,0,DF,Under 20,Defender,France,Europe
1146,Ben Hamed Touré,CIV,Ajaccio,Ligue 1,2022,18.0,2003.0,2.3,4,4,2,2,0,1,5,20.0,4,2,0,2,1,5,4,0,FW,Under 20,Forward,Ivory Coast,Africa
1147,Romain Hamouma,FRA,Ajaccio,Ligue 1,2022,35.0,1987.0,12.0,8,3,3,3,2,3,6,50.0,3,8,0,8,2,10,2,0,"FW,MF",35-39,Forward,France,Europe
1148,Saïd Hamulic,BIH,Toulouse,Ligue 1,2022,21.0,2000.0,1.2,0,0,0,0,0,0,0,,0,0,0,0,0,0,0,0,FW,20-24,Forward,Bosnia and Herzegovina,Europe
1151,Genki Haraguchi,JPN,Stuttgart,Bundesliga,2022,31.0,1991.0,8.3,16,7,7,7,2,4,16,25.0,12,13,2,11,8,24,6,0,MF,30-34,Midfielder,Japan,Asia
1152,Genki Haraguchi,JPN,Union Berlin,Bundesliga,2022,31.0,1991.0,5.5,12,8,1,10,1,3,9,33.3,6,7,1,6,3,15,9,0,MF,30-34,Midfielder,Japan,Asia
1153,Amine Harit,MAR,Marseille,Ligue 1,2022,25.0,1997.0,5.7,6,4,0,3,3,3,8,37.5,5,4,1,3,4,10,6,0,"MF,FW",25-29,Midfielder,Morocco,Africa
1154,Luke Harris,WAL,Fulham,Premier League,2022,17.0,2005.0,0.1,0,0,0,0,0,0,0,,0,0,0,0,0,0,0,0,"MF,FW",Under 20,Midfielder,Wales,Europe
1155,Jack Harrison,ENG,Leeds United,Premier League,2022,25.0,1996.0,30.1,41,17,5,15,21,12,52,23.1,40,47,2,45,22,63,25,0,"FW,MF",25-29,Forward,England,Europe
1156,Abdou Harroui,NED,Sassuolo,Serie A,2022,24.0,1998.0,7.2,17,6,6,7,4,2,7,28.6,5,6,1,5,2,19,10,0,MF,20-24,Midfielder,Netherlands,Europe
1157,Makoto Hasebe,JPN,Eint Frankfurt,Bundesliga,2022,38.0,1984.0,14.5,18,12,16,2,0,7,22,31.8,15,22,9,13,17,35,45,0,DF,35-39,Defender,Japan,Asia
1158,Haissem Hassan,FRA,Villarreal,La Liga,2022,20.0,2002.0,0.6,0,0,0,0,0,0,2,0.0,2,0,0,0,1,1,0,0,"FW,MF",20-24,Forward,France,Europe
1159,Hans Hateboer,NED,Atalanta,Serie A,2022,28.0,1994.0,15.5,21,13,11,8,2,11,27,40.7,16,23,4,19,12,33,25,0,DF,25-29,Defender,Netherlands,Europe
1160,Kai Havertz,GER,Chelsea,Premier League,2022,23.0,1999.0,28.5,34,16,4,20,10,10,30,33.3,20,28,0,28,7,41,41,0,"FW,MF",20-24,Forward,Germany,Europe
1161,Eden Hazard,BEL,Real Madrid,La Liga,2022,31.0,1991.0,2.2,0,0,0,0,0,0,2,0.0,2,1,0,1,1,1,0,0,FW,30-34,Forward,Belgium,Europe
1162,Thorgan Hazard,BEL,Dortmund,Bundesliga,2022,29.0,1993.0,5.2,17,6,5,11,1,12,17,70.6,5,6,0,6,5,22,5,0,"FW,DF",25-29,Forward,Belgium,Europe
1163,Rhys Healey,WAL,Toulouse,Ligue 1,2022,27.0,1994.0,0.7,0,0,0,0,0,0,0,,0,0,0,0,0,0,0,0,FW,25-29,Forward,Wales,Europe
1164,Jan Paul van Hecke,NED,Brighton,Premier League,2022,22.0,2000.0,3.3,8,6,3,4,1,5,5,100.0,0,8,5,3,6,14,9,0,DF,20-24,Defender,Netherlands,Europe
1165,Jonas Hector,GER,Köln,Bundesliga,2022,32.0,1990.0,31.4,112,66,59,43,10,66,113,58.4,47,61,9,52,39,151,74,1,DF,30-34,Defender,Germany,Europe
1166,Hwang Hee-chan,KOR,Wolves,Premier League,2022,26.0,1996.0,12.6,20,9,7,8,5,6,20,30.0,14,18,2,16,5,25,5,0,"FW,MF",25-29,Forward,South Korea,Asia
1167,Gauthier Hein,FRA,Auxerre,Ligue 1,2022,25.0,1996.0,20.8,27,20,13,11,3,18,48,37.5,30,10,0,10,6,33,10,0,"MF,FW",25-29,Midfielder,France,Europe
1168,Dominique Heintz,GER,Bochum,Bundesliga,2022,28.0,1993.0,8.8,13,9,5,7,1,6,17,35.3,11,11,7,4,12,25,34,0,DF,25-29,Defender,Germany,Europe
1169,Dean Henderson,ENG,Nott'ham Forest,Premier League,2022,25.0,1997.0,18.0,0,0,0,0,0,0,0,,0,0,0,0,0,0,12,1,GK,25-29,Goalkeeper,England,Europe
1170,Jordan Henderson,ENG,Liverpool,Premier League,2022,32.0,1990.0,23.0,32,23,10,18,4,15,36,41.7,21,21,3,18,21,53,16,1,MF,30-34,Midfielder,England,Europe
1171,Liam Henderson,SCO,Empoli,Serie A,2022,26.0,1996.0,11.2,13,10,6,5,2,4,21,19.0,17,10,2,8,10,23,10,0,MF,25-29,Midfielder,Scotland,Europe
1172,Jack Hendry,SCO,Cremonese,Serie A,2022,27.0,1995.0,2.4,0,0,0,0,0,0,1,0.0,1,2,1,1,1,1,7,0,DF,25-29,Defender,Scotland,Europe
1173,Wayne Hennessey,WAL,Nott'ham Forest,Premier League,2022,35.0,1987.0,3.0,1,0,1,0,0,1,1,100.0,0,0,0,0,0,1,2,0,GK,35-39,Goalkeeper,Wales,Europe
1174,Benjamin Henrichs,GER,RB Leipzig,Bundesliga,2022,25.0,1997.0,24.3,73,46,41,29,3,43,66,65.2,23,48,4,44,35,108,46,0,"DF,MF",25-29,Defender,Germany,Europe
1175,Henrique,BRA,Lyon,Ligue 1,2022,28.0,1994.0,4.0,9,4,3,2,4,6,13,46.2,7,3,1,2,5,14,8,0,"DF,FW",25-29,Defender,Brazil,South America
1175,Henrique,BRA,Lyon,Ligue 1,2022,28.0,1994.0,4.0,9,4,3,2,4,6,13,46.2,7,3,1,2,5,14,8,0,"DF,FW",25-29,Defender,Brazil,South America
1175,Henrique,BRA,Lyon,Ligue 1,2022,28.0,1994.0,4.0,9,4,3,2,4,6,13,46.2,7,3,1,2,5,14,8,0,"DF,FW",25-29,Defender,Brazil,South America
1175,Henrique,BRA,Lyon,Ligue 1,2022,28.0,1994.0,4.0,9,4,3,2,4,6,13,46.2,7,3,1,2,5,14,8,0,"DF,FW",25-29,Defender,Brazil,South America
1175,Henrique,BRA,Lyon,Ligue 1,2022,28.0,1994.0,4.0,9,4,3,2,4,6,13,46.2,7,3,1,2,5,14,8,0,"DF,FW",25-29,Defender,Brazil,South America
1175,Henrique,BRA,Lyon,Ligue 1,2022,28.0,1994.0,4.0,9,4,3,2,4,6,13,46.2,7,3,1,2,5,14,8,0,"DF,FW",25-29,Defender,Brazil,South America
1175,Henrique,BRA,Lyon,Ligue 1,2022,28.0,1994.0,4.0,9,4,3,2,4,6,13,46.2,7,3,1,2,5,14,8,0,"DF,FW",25-29,Defender,Brazil,South America
1175,Henrique,BRA,Lyon,Ligue 1,2022,28.0,1994.0,4.0,9,4,3,2,4,6,13,46.2,7,3,1,2,5,14,8,0,"DF,FW",25-29,Defender,Brazil,South America
1175,Henrique,BRA,Lyon,Ligue 1,2022,28.0,1994.0,4.0,9,4,3,2,4,6,13,46.2,7,3,1,2,5,14,8,0,"DF,FW",25-29,Defender,Brazil,South America
1175,Henrique,BRA,Lyon,Ligue 1,2022,28.0,1994.0,4.0,9,4,3,2,4,6,13,46.2,7,3,1,2,5,14,8,0,"DF,FW",25-29,Defender,Brazil,South America
1175,Henrique,BRA,Lyon,Ligue 1,2022,28.0,1994.0,4.0,9,4,3,2,4,6,13,46.2,7,3,1,2,5,14,8,0,"DF,FW",25-29,Defender,Brazil,South America
1175,Henrique,BRA,Lyon,Ligue 1,2022,28.0,1994.0,4.0,9,4,3,2,4,6,13,46.2,7,3,1,2,5,14,8,0,"DF,FW",25-29,Defender,Brazil,South America
1175,Henrique,BRA,Lyon,Ligue 1,2022,28.0,1994.0,4.0,9,4,3,2,4,6,13,46.2,7,3,1,2,5,14,8,0,"DF,FW",25-29,Defender,Brazil,South America
1175,Henrique,BRA,Lyon,Ligue 1,2022,28.0,1994.0,4.0,9,4,3,2,4,6,13,46.2,7,3,1,2,5,14,8,0,"DF,FW",25-29,Defender,Brazil,South America
1175,Henrique,BRA,Lyon,Ligue 1,2022,28.0,1994.0,4.0,9,4,3,2,4,6,13,46.2,7,3,1,2,5,14,8,0,"DF,FW",25-29,Defender,Brazil,South America
1175,Henrique,BRA,Lyon,Ligue 1,2022,28.0,1994.0,4.0,9,4,3,2,4,6,13,46.2,7,3,1,2,5,14,8,0,"DF,FW",25-29,Defender,Brazil,South America
1176,Luiz Henrique,BRA,Betis,La Liga,2022,21.0,2001.0,20.1,48,34,27,15,6,20,44,45.5,24,22,0,22,14,62,17,0,FW,20-24,Forward,Brazil,South America
1176,Luiz Henrique,BRA,Betis,La Liga,2022,21.0,2001.0,20.1,48,34,27,15,6,20,44,45.5,24,22,0,22,14,62,17,0,FW,20-24,Forward,Brazil,South America
1176,Luiz Henrique,BRA,Betis,La Liga,2022,21.0,2001.0,20.1,48,34,27,15,6,20,44,45.5,24,22,0,22,14,62,17,0,FW,20-24,Forward,Brazil,South America
1176,Luiz Henrique,BRA,Betis,La Liga,2022,21.0,2001.0,20.1,48,34,27,15,6,20,44,45.5,24,22,0,22,14,62,17,0,FW,20-24,Forward,Brazil,South America
1177,Matheus Henrique,BRA,Sassuolo,Serie A,2022,24.0,1997.0,21.6,26,12,9,11,6,12,24,50.0,12,15,4,11,12,38,10,0,MF,20-24,Midfielder,Brazil,South America
1178,Rico Henry,ENG,Brentford,Premier League,2022,25.0,1997.0,36.0,57,31,20,28,9,22,41,53.7,19,29,8,21,30,87,84,1,DF,25-29,Defender,England,Europe
1179,Thomas Henry,FRA,Hellas Verona,Serie A,2022,27.0,1994.0,11.4,5,3,1,1,3,1,5,20.0,4,6,2,4,0,5,14,0,FW,25-29,Forward,France,Europe
1184,Lucas Hernández,FRA,Bayern Munich,Bundesliga,2022,26.0,1996.0,5.3,6,4,3,3,0,5,6,83.3,1,2,1,1,5,11,7,0,DF,25-29,Defender,France,Europe
1187,Theo Hernández,FRA,Milan,Serie A,2022,24.0,1997.0,30.8,43,24,27,15,1,22,38,57.9,16,34,7,27,21,64,35,1,DF,20-24,Defender,France,Europe
1191,Yangel Herrera,VEN,Girona,La Liga,2022,24.0,1998.0,10.7,26,9,9,14,3,6,15,40.0,9,14,1,13,4,30,12,0,"MF,FW",20-24,Midfielder,Venezuela,South America
1192,Patrick Herrmann,GER,Gladbach,Bundesliga,2022,31.0,1991.0,1.8,6,2,4,1,1,2,4,50.0,2,2,0,2,2,8,1,0,"FW,MF",30-34,Forward,Germany,Europe
1193,Son Heung-min,KOR,Tottenham,Premier League,2022,30.0,1992.0,32.1,24,12,7,8,9,9,30,30.0,21,23,2,21,13,37,6,0,"MF,FW",30-34,Midfielder,South Korea,Asia
1194,Aaron Hickey,SCO,Brentford,Premier League,2022,20.0,2002.0,21.3,38,26,27,11,0,18,32,56.3,14,18,7,11,17,55,32,1,DF,20-24,Defender,Scotland,Europe
1195,Isak Hien,SWE,Hellas Verona,Serie A,2022,23.0,1999.0,29.0,73,36,54,19,0,38,61,62.3,23,40,17,23,31,104,92,1,DF,20-24,Defender,Sweden,Europe
1196,Omar El Hilali,MAR,Espanyol,La Liga,2022,18.0,2003.0,1.0,3,2,3,0,0,1,2,50.0,1,1,0,1,1,4,6,0,"DF,MF",Under 20,Defender,Morocco,Africa
1197,Piero Hincapié,ECU,Leverkusen,Bundesliga,2022,20.0,2002.0,27.3,51,34,28,20,3,25,38,65.8,13,41,20,21,31,82,83,1,"DF,MF",20-24,Defender,Ecuador,South America
1198,Jack Hinshelwood,ENG,Brighton,Premier League,2022,17.0,2005.0,0.0,1,0,1,0,0,0,0,,0,0,0,0,0,1,0,0,FW,Under 20,Forward,England,Europe
1199,Morten Hjulmand,DEN,Lecce,Serie A,2022,23.0,1999.0,32.9,90,52,49,40,1,37,67,55.2,30,43,11,32,72,162,54,0,MF,20-24,Midfielder,Denmark,Europe
1201,Joseph Hodge,IRL,Wolves,Premier League,2022,19.0,2002.0,1.9,5,2,1,3,1,3,4,75.0,1,5,0,5,0,5,2,1,MF,Under 20,Midfielder,Republic of Ireland,Europe
1202,Nicolas Höfler,GER,Freiburg,Bundesliga,2022,32.0,1990.0,31.3,66,35,28,35,3,27,61,44.3,34,40,13,27,58,124,49,0,MF,30-34,Midfielder,Germany,Europe
1203,Jonas Hofmann,GER,Gladbach,Bundesliga,2022,30.0,1992.0,29.8,31,16,17,8,6,15,52,28.8,37,36,2,34,16,47,21,0,"FW,MF",30-34,Forward,Germany,Europe
1203,Jonas Hofmann,GER,Gladbach,Bundesliga,2022,30.0,1992.0,29.8,31,16,17,8,6,15,52,28.8,37,36,2,34,16,47,21,0,"FW,MF",30-34,Forward,Germany,Europe
1203,Jonas Hofmann,GER,Gladbach,Bundesliga,2022,30.0,1992.0,29.8,31,16,17,8,6,15,52,28.8,37,36,2,34,16,47,21,0,"FW,MF",30-34,Forward,Germany,Europe
1203,Jonas Hofmann,GER,Gladbach,Bundesliga,2022,30.0,1992.0,29.8,31,16,17,8,6,15,52,28.8,37,36,2,34,16,47,21,0,"FW,MF",30-34,Forward,Germany,Europe
1204,Philipp Hofmann,GER,Bochum,Bundesliga,2022,29.0,1993.0,29.2,18,11,0,13,5,5,12,41.7,7,20,8,12,6,24,48,0,FW,25-29,Forward,Germany,Europe
1205,Rob Holding,ENG,Arsenal,Premier League,2022,26.0,1995.0,6.3,8,5,4,4,0,3,6,50.0,3,6,5,1,3,11,27,1,DF,25-29,Defender,England,Europe
1206,Lucas Höler,GER,Freiburg,Bundesliga,2022,28.0,1994.0,16.7,19,14,5,7,7,6,22,27.3,16,22,5,17,10,29,17,0,"FW,MF",25-29,Forward,Germany,Europe
1207,Mason Holgate,ENG,Everton,Premier League,2022,25.0,1996.0,5.6,11,7,8,3,0,3,11,27.3,8,7,3,4,7,18,28,0,DF,25-29,Defender,England,Europe
1208,Emil Holm,SWE,Spezia,Serie A,2022,22.0,2000.0,15.5,26,15,13,8,5,16,31,51.6,15,21,6,15,9,35,41,0,DF,20-24,Defender,Sweden,Europe
1210,Gerrit Holtmann,PHI,Bochum,Bundesliga,2022,27.0,1995.0,10.5,14,7,6,7,1,12,21,57.1,9,15,1,14,2,16,4,0,"FW,MF",25-29,Forward,Philippines,Asia
1211,Martin Hongla,CMR,Hellas Verona,Serie A,2022,24.0,1998.0,5.8,8,5,4,4,0,5,5,100.0,0,7,1,6,6,14,9,0,MF,20-24,Midfielder,Cameroon,Africa
1212,Martin Hongla,CMR,Valladolid,La Liga,2022,24.0,1998.0,14.5,18,13,13,5,0,11,21,52.4,10,15,12,3,8,26,46,1,"DF,MF",20-24,Defender,Cameroon,Africa
1213,Franck Honorat,FRA,Brest,Ligue 1,2022,25.0,1996.0,28.2,41,29,20,8,13,19,34,55.9,15,22,2,20,21,62,18,0,"FW,MF",25-29,Forward,France,Europe
1214,Jannes Horn,GER,Bochum,Bundesliga,2022,25.0,1997.0,0.7,2,1,1,1,0,1,1,100.0,0,1,0,1,3,5,2,0,"DF,FW",25-29,Defender,Germany,Europe
1215,Cédric Hountondji,BEN,Angers,Ligue 1,2022,28.0,1994.0,34.4,50,36,31,17,2,19,29,65.5,10,44,22,22,59,109,132,1,DF,25-29,Defender,Benin,Africa
1216,Ilyes Housni,FRA,Paris S-G,Ligue 1,2022,17.0,2005.0,0.1,1,1,1,0,0,1,1,100.0,0,0,0,0,0,1,0,0,FW,Under 20,Forward,France,Europe
1217,Lukáš Hrádecký,FIN,Leverkusen,Bundesliga,2022,32.0,1989.0,33.0,0,0,0,0,0,0,0,,0,0,0,0,0,0,3,3,GK,30-34,Goalkeeper,Finland,Europe
1218,Petko Hristov,BUL,Spezia,Serie A,2022,23.0,1999.0,4.1,6,4,2,4,0,5,8,62.5,3,4,2,2,4,10,12,0,DF,20-24,Defender,Bulgaria,Europe
1219,Ajdin Hrustic,AUS,Hellas Verona,Serie A,2022,26.0,1996.0,2.5,2,1,1,1,0,1,2,50.0,1,2,0,2,0,2,2,1,MF,25-29,Midfielder,Australia,Oceania
1220,Timo Hübers,GER,Köln,Bundesliga,2022,26.0,1996.0,28.4,43,28,35,8,0,24,52,46.2,28,27,13,14,58,101,153,0,DF,25-29,Defender,Germany,Europe
1221,Callum Hudson-Odoi,ENG,Leverkusen,Bundesliga,2022,21.0,2000.0,6.7,5,3,4,0,1,1,1,100.0,0,0,0,0,2,7,4,0,"FW,MF",20-24,Forward,England,Europe
1222,Will Hughes,ENG,Crystal Palace,Premier League,2022,27.0,1995.0,9.4,29,16,11,16,2,11,20,55.0,9,16,7,9,16,45,9,0,MF,25-29,Midfielder,England,Europe
1223,Mats Hummels,GER,Dortmund,Bundesliga,2022,33.0,1988.0,22.4,62,34,38,22,2,32,55,58.2,23,30,16,14,33,95,100,1,DF,30-34,Defender,Germany,Europe
1224,Adrien Hunou,FRA,Angers,Ligue 1,2022,28.0,1994.0,24.8,39,20,17,16,6,16,45,35.6,29,35,0,35,7,46,7,0,"MF,FW",25-29,Midfielder,France,Europe
1225,Denis Huseinbasic,BIH,Köln,Bundesliga,2022,21.0,2001.0,8.8,23,9,8,11,4,10,25,40.0,15,16,2,14,4,27,5,0,"MF,FW",20-24,Midfielder,Bosnia and Herzegovina,Europe
1226,Omari Hutchinson,ENG,Chelsea,Premier League,2022,18.0,2003.0,0.3,0,0,0,0,0,0,0,,0,0,0,0,1,1,0,0,FW,Under 20,Forward,England,Europe
1227,Elseid Hysaj,ALB,Lazio,Serie A,2022,28.0,1994.0,22.2,39,23,24,11,4,23,41,56.1,18,31,7,24,20,59,42,0,DF,25-29,Defender,Albania,Europe
1228,Pierre Højbjerg,DEN,Tottenham,Premier League,2022,26.0,1995.0,34.8,56,30,28,22,6,26,67,38.8,41,46,17,29,49,105,64,1,MF,25-29,Midfielder,Denmark,Europe
1229,Rasmus Højlund,DEN,Atalanta,Serie A,2022,19.0,2003.0,20.4,4,3,0,2,2,1,6,16.7,5,9,1,8,1,5,5,0,FW,Under 20,Forward,Denmark,Europe
1230,Iago,BRA,Augsburg,Bundesliga,2022,25.0,1997.0,17.8,34,16,20,10,4,11,29,37.9,18,18,5,13,17,51,53,0,"DF,MF",25-29,Defender,Brazil,South America
1232,Roger Ibanez,BRA,Roma,Serie A,2022,23.0,1998.0,31.1,67,33,38,26,3,32,48,66.7,16,30,11,19,66,133,95,2,DF,20-24,Defender,Brazil,South America
1233,Arijon Ibrahimović,GER,Bayern Munich,Bundesliga,2022,16.0,2005.0,0.2,1,1,1,0,0,0,0,,0,0,0,0,0,1,0,0,MF,Under 20,Midfielder,Germany,Europe
1234,Zlatan Ibrahimović,SWE,Milan,Serie A,2022,40.0,1981.0,1.6,0,0,0,0,0,0,0,,0,1,1,0,0,0,2,0,FW,Over 40,Forward,Sweden,Europe
1235,Mounaim El Idrissy,FRA,Ajaccio,Ligue 1,2022,23.0,1999.0,27.7,32,19,5,20,7,10,36,27.8,26,22,0,22,13,45,20,0,FW,20-24,Forward,France,Europe
1236,Antonio Iervolino,ITA,Salernitana,Serie A,2022,19.0,2003.0,0.1,0,0,0,0,0,0,1,0.0,1,0,0,0,0,0,0,0,MF,Under 20,Midfielder,Italy,Europe
1239,Igor,BRA,Fiorentina,Serie A,2022,24.0,1998.0,22.9,43,29,21,18,4,20,27,74.1,7,33,14,19,25,68,56,2,DF,20-24,Defender,Brazil,South America
1239,Igor,BRA,Fiorentina,Serie A,2022,24.0,1998.0,22.9,43,29,21,18,4,20,27,74.1,7,33,14,19,25,68,56,2,DF,20-24,Defender,Brazil,South America
1239,Igor,BRA,Fiorentina,Serie A,2022,24.0,1998.0,22.9,43,29,21,18,4,20,27,74.1,7,33,14,19,25,68,56,2,DF,20-24,Defender,Brazil,South America
1239,Igor,BRA,Fiorentina,Serie A,2022,24.0,1998.0,22.9,43,29,21,18,4,20,27,74.1,7,33,14,19,25,68,56,2,DF,20-24,Defender,Brazil,South America
1240,Kelechi Iheanacho,NGA,Leicester City,Premier League,2022,25.0,1996.0,12.5,7,2,0,3,4,3,10,30.0,7,9,1,8,0,7,8,0,"FW,MF",25-29,Forward,Nigeria,Africa
1241,Jonathan Ikone,FRA,Fiorentina,Serie A,2022,24.0,1998.0,22.3,16,8,5,6,5,5,14,35.7,9,18,1,17,4,20,3,0,FW,20-24,Forward,France,Europe
1244,Rareş Ilie,ROU,Nice,Ligue 1,2022,19.0,2003.0,1.6,3,3,0,1,2,2,4,50.0,2,2,0,2,1,4,1,0,"MF,FW",Under 20,Midfielder,Romania,Europe
1245,Samuel Iling-Junior,ENG,Juventus,Serie A,2022,18.0,2003.0,3.5,7,2,3,1,3,4,9,44.4,5,5,1,4,2,9,6,0,"DF,FW",Under 20,Defender,England,Europe
1246,Emirhan İlkhan,TUR,Torino,Serie A,2022,18.0,2004.0,1.0,1,1,0,1,0,1,1,100.0,0,3,1,2,2,3,2,0,MF,Under 20,Midfielder,Turkey,Asia
1247,Emirhan İlkhan,TUR,Sampdoria,Serie A,2022,18.0,2004.0,1.3,6,3,2,2,2,2,3,66.7,1,5,1,4,0,6,3,0,MF,Under 20,Midfielder,Turkey,Asia
1249,Ciro Immobile,ITA,Lazio,Serie A,2022,32.0,1990.0,24.7,11,5,4,4,3,6,9,66.7,3,10,2,8,1,12,14,0,FW,30-34,Forward,Italy,Europe
1250,Danny Ings,ENG,West Ham,Premier League,2022,30.0,1992.0,8.6,9,8,0,4,5,5,14,35.7,9,8,2,6,3,12,5,0,FW,30-34,Forward,England,Europe
1251,Danny Ings,ENG,Aston Villa,Premier League,2022,30.0,1992.0,9.2,10,5,1,6,3,1,6,16.7,5,12,1,11,1,11,11,0,FW,30-34,Forward,England,Europe
1252,Marcus Ingvartsen,DEN,Mainz 05,Bundesliga,2022,26.0,1996.0,14.6,4,1,0,2,2,1,10,10.0,9,9,1,8,4,8,10,0,"FW,MF",25-29,Forward,Denmark,Europe
1253,Bonke Innocent,NGA,Lorient,Ligue 1,2022,26.0,1996.0,13.1,28,17,13,14,1,11,36,30.6,25,22,5,17,26,54,31,0,MF,25-29,Midfielder,Nigeria,Africa
1254,Alexander Isak,SWE,Newcastle Utd,Premier League,2022,22.0,1999.0,16.9,18,8,4,7,7,10,28,35.7,18,21,2,19,4,22,8,0,FW,20-24,Forward,Sweden,Europe
1255,Alexander Isak,SWE,Real Sociedad,La Liga,2022,22.0,1999.0,1.7,1,1,0,0,1,0,0,,0,0,0,0,0,1,2,0,FW,20-24,Forward,Sweden,Europe
1257,Ismaily,BRA,Lille,Ligue 1,2022,32.0,1990.0,19.8,41,18,16,16,9,17,32,53.1,15,25,5,20,21,62,39,0,DF,30-34,Defender,Brazil,South America
1258,Ardian Ismajli,ALB,Empoli,Serie A,2022,25.0,1996.0,23.3,40,32,25,15,0,18,24,75.0,6,47,31,16,27,67,120,0,DF,25-29,Defender,Albania,Europe
1259,Ko Itakura,JPN,Gladbach,Bundesliga,2022,25.0,1997.0,22.0,29,17,18,7,4,16,30,53.3,14,41,25,16,27,56,95,0,DF,25-29,Defender,Japan,Asia
1260,Hiroki Ito,JPN,Stuttgart,Bundesliga,2022,23.0,1999.0,28.5,40,29,24,14,2,18,35,51.4,17,38,17,21,40,80,94,0,DF,20-24,Defender,Japan,Asia
1261,Junya Ito,JPN,Reims,Ligue 1,2022,29.0,1993.0,32.4,40,20,14,15,11,13,53,24.5,40,29,1,28,8,48,4,1,FW,25-29,Forward,Japan,Asia
1263,Andreas Ivan,ROU,Schalke 04,Bundesliga,2022,27.0,1995.0,0.5,0,0,0,0,0,0,1,0.0,1,0,0,0,0,0,1,0,MF,25-29,Midfielder,Romania,Europe
1265,Daniel Iversen,DEN,Leicester City,Premier League,2022,25.0,1997.0,12.0,0,0,0,0,0,0,0,,0,0,0,0,0,0,6,1,GK,25-29,Goalkeeper,Denmark,Europe
1266,Alex Iwobi,NGA,Everton,Premier League,2022,26.0,1996.0,37.5,69,37,37,28,4,33,65,50.8,32,41,2,39,25,94,29,0,"MF,FW",25-29,Midfielder,Nigeria,Africa
1267,Armando Izzo,ITA,Monza,Serie A,2022,30.0,1992.0,27.4,73,50,44,27,2,29,45,64.4,16,29,17,12,50,123,87,1,DF,30-34,Defender,Italy,Europe
1268,Nicolas Jackson,SEN,Villarreal,La Liga,2022,21.0,2001.0,17.8,14,11,2,10,2,2,8,25.0,6,18,2,16,2,16,4,0,FW,20-24,Forward,Senegal,Africa
1269,Lee Jae-sung,KOR,Mainz 05,Bundesliga,2022,29.0,1992.0,21.0,38,17,9,21,8,16,36,44.4,20,29,5,24,17,55,21,0,MF,25-29,Midfielder,South Korea,Asia
1270,Paul Jaeckel,GER,Union Berlin,Bundesliga,2022,24.0,1998.0,13.3,24,18,11,11,2,17,35,48.6,18,11,5,6,19,43,44,1,DF,20-24,Defender,Germany,Europe
1271,Mato Jajalo,BIH,Udinese,Serie A,2022,34.0,1988.0,0.7,0,0,0,0,0,0,1,0.0,1,0,0,0,0,0,2,0,MF,30-34,Midfielder,Bosnia and Herzegovina,Europe
1272,Kristijan Jakić,CRO,Eint Frankfurt,Bundesliga,2022,25.0,1997.0,16.2,33,21,19,12,2,22,41,53.7,19,32,10,22,14,47,49,1,"DF,MF",25-29,Defender,Croatia,Europe
1273,Ismail Jakobs,SEN,Monaco,Ligue 1,2022,22.0,1999.0,12.4,11,5,7,3,1,5,12,41.7,7,9,1,8,9,20,18,0,"DF,FW",20-24,Defender,Senegal,Africa
1274,Marin Jakoliš,CRO,Angers,Ligue 1,2022,25.0,1996.0,0.3,1,1,0,0,1,0,0,,0,0,0,0,0,1,0,0,FW,25-29,Forward,Croatia,Europe
1275,Daniel James,WAL,Leeds United,Premier League,2022,24.0,1997.0,2.2,6,2,1,3,2,3,6,50.0,3,4,0,4,2,8,2,0,FW,20-24,Forward,Wales,Europe
1276,Daniel James,WAL,Fulham,Premier League,2022,24.0,1997.0,6.9,10,6,4,5,1,4,9,44.4,5,5,1,4,1,11,5,0,FW,20-24,Forward,Wales,Europe
1277,Reece James,ENG,Chelsea,Premier League,2022,22.0,1999.0,13.8,31,20,10,18,3,15,19,78.9,4,17,2,15,12,43,23,0,"DF,MF",20-24,Defender,England,Europe
1277,Reece James,ENG,Chelsea,Premier League,2022,22.0,1999.0,13.8,31,20,10,18,3,15,19,78.9,4,17,2,15,12,43,23,0,"DF,MF",20-24,Defender,England,Europe
1277,Reece James,ENG,Chelsea,Premier League,2022,22.0,1999.0,13.8,31,20,10,18,3,15,19,78.9,4,17,2,15,12,43,23,0,"DF,MF",20-24,Defender,England,Europe
1277,Reece James,ENG,Chelsea,Premier League,2022,22.0,1999.0,13.8,31,20,10,18,3,15,19,78.9,4,17,2,15,12,43,23,0,"DF,MF",20-24,Defender,England,Europe
1278,Vitaly Janelt,GER,Brentford,Premier League,2022,24.0,1998.0,24.5,54,27,20,24,10,21,49,42.9,28,29,9,20,29,83,26,0,"MF,DF",20-24,Midfielder,Germany,Europe
1279,Saidy Janko,GAM,Bochum,Bundesliga,2022,26.0,1995.0,12.6,23,15,13,8,2,12,20,60.0,8,24,10,14,11,34,33,1,DF,25-29,Defender,Gambia,Africa
1280,Pontus Jansson,SWE,Brentford,Premier League,2022,31.0,1991.0,8.0,5,3,4,1,0,3,5,60.0,2,13,9,4,9,14,38,0,DF,30-34,Defender,Sweden,Europe
1281,Tony Jantschke,GER,Gladbach,Bundesliga,2022,32.0,1990.0,1.1,2,1,1,1,0,1,1,100.0,0,5,3,2,0,2,5,0,"DF,MF",30-34,Defender,Germany,Europe
1282,Adnan Januzaj,BEL,Sevilla,La Liga,2022,27.0,1995.0,0.5,0,0,0,0,0,0,1,0.0,1,0,0,0,1,1,0,0,FW,25-29,Forward,Belgium,Europe
1283,Léo Jardim,BRA,Lille,Ligue 1,2022,27.0,1995.0,6.0,0,0,0,0,0,0,1,0.0,1,0,0,0,0,0,0,1,GK,25-29,Goalkeeper,Brazil,South America
1284,Luis Javier Suárez,COL,Almería,La Liga,2022,24.0,1997.0,16.6,17,11,5,6,6,6,26,23.1,20,13,3,10,3,20,10,0,FW,20-24,Forward,Colombia,South America
1285,Luis Javier Suárez,COL,Marseille,Ligue 1,2022,24.0,1997.0,3.3,4,1,1,2,1,1,4,25.0,3,1,0,1,3,7,6,0,FW,20-24,Forward,Colombia,South America
1286,Dany Jean,HAI,Strasbourg,Ligue 1,2022,19.0,2002.0,0.1,0,0,0,0,0,0,1,0.0,1,1,0,1,0,0,0,0,"DF,MF",Under 20,Defender,Haiti,North America
1287,Julian Jeanvier,GUI,Auxerre,Ligue 1,2022,30.0,1992.0,19.6,32,17,24,8,0,13,22,59.1,9,24,17,7,27,59,96,1,DF,30-34,Defender,Guinea,Africa
1288,Jeffinho,BRA,Lyon,Ligue 1,2022,22.0,1999.0,5.0,17,4,4,9,4,6,15,40.0,9,6,0,6,1,18,0,0,FW,20-24,Forward,Brazil,South America
1289,Fredrik Jensen,FIN,Augsburg,Bundesliga,2022,24.0,1997.0,10.3,15,10,8,3,4,5,10,50.0,5,12,5,7,4,19,12,0,"FW,MF",20-24,Forward,Finland,Europe
1290,Mathias Jensen,DEN,Brentford,Premier League,2022,26.0,1996.0,31.1,71,36,29,30,12,34,97,35.1,63,54,5,49,32,103,24,1,MF,25-29,Midfielder,Denmark,Europe
1291,Moritz Jenz,GER,Schalke 04,Bundesliga,2022,23.0,1999.0,10.5,14,11,8,5,1,5,8,62.5,3,16,10,6,8,22,53,1,DF,20-24,Defender,Germany,Europe
1293,Gabriel Jesus,BRA,Arsenal,Premier League,2022,25.0,1997.0,22.9,33,25,16,8,9,15,31,48.4,16,27,3,24,11,44,15,1,FW,25-29,Forward,Brazil,South America
1294,Juan Jesus,BRA,Napoli,Serie A,2022,31.0,1991.0,10.4,16,11,9,6,1,9,12,75.0,3,18,11,7,10,26,29,0,DF,30-34,Defender,Brazil,South America
1295,Raúl Jiménez,MEX,Wolves,Premier League,2022,31.0,1991.0,9.4,9,6,3,5,1,3,6,50.0,3,9,0,9,0,9,8,0,FW,30-34,Forward,Mexico,North America
1297,Joelinton,BRA,Newcastle Utd,Premier League,2022,25.0,1996.0,29.6,70,49,36,26,8,26,62,41.9,36,52,7,45,48,118,39,0,"MF,FW",25-29,Midfielder,Brazil,South America
1298,Þórir Jóhann Helgason,ISL,Lecce,Serie A,2022,21.0,2000.0,2.5,2,2,1,0,1,2,3,66.7,1,3,1,2,3,5,3,0,MF,20-24,Midfielder,Iceland,Europe
1299,Ben Johnson,ENG,West Ham,Premier League,2022,22.0,2000.0,9.6,20,14,12,4,4,12,18,66.7,6,12,4,8,9,29,28,1,DF,20-24,Defender,England,Europe
1300,Brennan Johnson,WAL,Nott'ham Forest,Premier League,2022,21.0,2001.0,32.6,34,20,18,8,8,8,29,27.6,21,30,1,29,5,39,7,1,"FW,MF",20-24,Forward,Wales,Europe
1301,Sam Johnstone,ENG,Crystal Palace,Premier League,2022,29.0,1993.0,9.0,0,0,0,0,0,0,0,,0,0,0,0,0,0,5,0,GK,25-29,Goalkeeper,England,Europe
1302,Paul Joly,FRA,Auxerre,Ligue 1,2022,22.0,2000.0,9.6,33,21,21,10,2,19,35,54.3,16,13,2,11,24,57,29,2,DF,20-24,Defender,France,Europe
1303,Curtis Jones,ENG,Liverpool,Premier League,2022,21.0,2001.0,11.5,34,17,8,12,14,18,31,58.1,13,12,2,10,3,37,9,0,MF,20-24,Midfielder,England,Europe
1304,Frenkie de Jong,NED,Barcelona,La Liga,2022,25.0,1997.0,28.2,46,26,16,21,9,17,41,41.5,24,11,1,10,35,81,22,1,MF,25-29,Midfielder,Netherlands,Europe
1306,Jorginho,ITA,Arsenal,Premier League,2022,30.0,1991.0,9.5,18,13,6,10,2,5,24,20.8,19,7,2,5,9,27,8,0,MF,30-34,Midfielder,Italy,Europe
1306,Jorginho,ITA,Arsenal,Premier League,2022,30.0,1991.0,9.5,18,13,6,10,2,5,24,20.8,19,7,2,5,9,27,8,0,MF,30-34,Midfielder,Italy,Europe
1306,Jorginho,ITA,Arsenal,Premier League,2022,30.0,1991.0,9.5,18,13,6,10,2,5,24,20.8,19,7,2,5,9,27,8,0,MF,30-34,Midfielder,Italy,Europe
1306,Jorginho,ITA,Arsenal,Premier League,2022,30.0,1991.0,9.5,18,13,6,10,2,5,24,20.8,19,7,2,5,9,27,8,0,MF,30-34,Midfielder,Italy,Europe
1306,Jorginho,ITA,Arsenal,Premier League,2022,30.0,1991.0,9.5,18,13,6,10,2,5,24,20.8,19,7,2,5,9,27,8,0,MF,30-34,Midfielder,Italy,Europe
1306,Jorginho,ITA,Arsenal,Premier League,2022,30.0,1991.0,9.5,18,13,6,10,2,5,24,20.8,19,7,2,5,9,27,8,0,MF,30-34,Midfielder,Italy,Europe
1306,Jorginho,ITA,Arsenal,Premier League,2022,30.0,1991.0,9.5,18,13,6,10,2,5,24,20.8,19,7,2,5,9,27,8,0,MF,30-34,Midfielder,Italy,Europe
1306,Jorginho,ITA,Arsenal,Premier League,2022,30.0,1991.0,9.5,18,13,6,10,2,5,24,20.8,19,7,2,5,9,27,8,0,MF,30-34,Midfielder,Italy,Europe
1306,Jorginho,ITA,Arsenal,Premier League,2022,30.0,1991.0,9.5,18,13,6,10,2,5,24,20.8,19,7,2,5,9,27,8,0,MF,30-34,Midfielder,Italy,Europe
1306,Jorginho,ITA,Arsenal,Premier League,2022,30.0,1991.0,9.5,18,13,6,10,2,5,24,20.8,19,7,2,5,9,27,8,0,MF,30-34,Midfielder,Italy,Europe
1306,Jorginho,ITA,Arsenal,Premier League,2022,30.0,1991.0,9.5,18,13,6,10,2,5,24,20.8,19,7,2,5,9,27,8,0,MF,30-34,Midfielder,Italy,Europe
1306,Jorginho,ITA,Arsenal,Premier League,2022,30.0,1991.0,9.5,18,13,6,10,2,5,24,20.8,19,7,2,5,9,27,8,0,MF,30-34,Midfielder,Italy,Europe
1306,Jorginho,ITA,Arsenal,Premier League,2022,30.0,1991.0,9.5,18,13,6,10,2,5,24,20.8,19,7,2,5,9,27,8,0,MF,30-34,Midfielder,Italy,Europe
1306,Jorginho,ITA,Arsenal,Premier League,2022,30.0,1991.0,9.5,18,13,6,10,2,5,24,20.8,19,7,2,5,9,27,8,0,MF,30-34,Midfielder,Italy,Europe
1306,Jorginho,ITA,Arsenal,Premier League,2022,30.0,1991.0,9.5,18,13,6,10,2,5,24,20.8,19,7,2,5,9,27,8,0,MF,30-34,Midfielder,Italy,Europe
1306,Jorginho,ITA,Arsenal,Premier League,2022,30.0,1991.0,9.5,18,13,6,10,2,5,24,20.8,19,7,2,5,9,27,8,0,MF,30-34,Midfielder,Italy,Europe
1307,Jorginho,ITA,Chelsea,Premier League,2022,30.0,1991.0,14.2,42,23,22,14,6,22,46,47.8,24,18,3,15,21,63,7,0,MF,30-34,Midfielder,Italy,Europe
1307,Jorginho,ITA,Chelsea,Premier League,2022,30.0,1991.0,14.2,42,23,22,14,6,22,46,47.8,24,18,3,15,21,63,7,0,MF,30-34,Midfielder,Italy,Europe
1307,Jorginho,ITA,Chelsea,Premier League,2022,30.0,1991.0,14.2,42,23,22,14,6,22,46,47.8,24,18,3,15,21,63,7,0,MF,30-34,Midfielder,Italy,Europe
1307,Jorginho,ITA,Chelsea,Premier League,2022,30.0,1991.0,14.2,42,23,22,14,6,22,46,47.8,24,18,3,15,21,63,7,0,MF,30-34,Midfielder,Italy,Europe
1307,Jorginho,ITA,Chelsea,Premier League,2022,30.0,1991.0,14.2,42,23,22,14,6,22,46,47.8,24,18,3,15,21,63,7,0,MF,30-34,Midfielder,Italy,Europe
1307,Jorginho,ITA,Chelsea,Premier League,2022,30.0,1991.0,14.2,42,23,22,14,6,22,46,47.8,24,18,3,15,21,63,7,0,MF,30-34,Midfielder,Italy,Europe
1307,Jorginho,ITA,Chelsea,Premier League,2022,30.0,1991.0,14.2,42,23,22,14,6,22,46,47.8,24,18,3,15,21,63,7,0,MF,30-34,Midfielder,Italy,Europe
1307,Jorginho,ITA,Chelsea,Premier League,2022,30.0,1991.0,14.2,42,23,22,14,6,22,46,47.8,24,18,3,15,21,63,7,0,MF,30-34,Midfielder,Italy,Europe
1307,Jorginho,ITA,Chelsea,Premier League,2022,30.0,1991.0,14.2,42,23,22,14,6,22,46,47.8,24,18,3,15,21,63,7,0,MF,30-34,Midfielder,Italy,Europe
1307,Jorginho,ITA,Chelsea,Premier League,2022,30.0,1991.0,14.2,42,23,22,14,6,22,46,47.8,24,18,3,15,21,63,7,0,MF,30-34,Midfielder,Italy,Europe
1307,Jorginho,ITA,Chelsea,Premier League,2022,30.0,1991.0,14.2,42,23,22,14,6,22,46,47.8,24,18,3,15,21,63,7,0,MF,30-34,Midfielder,Italy,Europe
1307,Jorginho,ITA,Chelsea,Premier League,2022,30.0,1991.0,14.2,42,23,22,14,6,22,46,47.8,24,18,3,15,21,63,7,0,MF,30-34,Midfielder,Italy,Europe
1307,Jorginho,ITA,Chelsea,Premier League,2022,30.0,1991.0,14.2,42,23,22,14,6,22,46,47.8,24,18,3,15,21,63,7,0,MF,30-34,Midfielder,Italy,Europe
1307,Jorginho,ITA,Chelsea,Premier League,2022,30.0,1991.0,14.2,42,23,22,14,6,22,46,47.8,24,18,3,15,21,63,7,0,MF,30-34,Midfielder,Italy,Europe
1307,Jorginho,ITA,Chelsea,Premier League,2022,30.0,1991.0,14.2,42,23,22,14,6,22,46,47.8,24,18,3,15,21,63,7,0,MF,30-34,Midfielder,Italy,Europe
1307,Jorginho,ITA,Chelsea,Premier League,2022,30.0,1991.0,14.2,42,23,22,14,6,22,46,47.8,24,18,3,15,21,63,7,0,MF,30-34,Midfielder,Italy,Europe
1309,Willian José,BRA,Betis,La Liga,2022,30.0,1991.0,8.1,9,6,6,3,0,4,9,44.4,5,4,0,4,1,10,15,0,FW,30-34,Forward,Brazil,South America
1312,Diogo Jota,POR,Liverpool,Premier League,2022,25.0,1996.0,12.6,23,15,8,8,7,12,37,32.4,25,5,0,5,3,26,11,0,FW,25-29,Forward,Portugal,Europe
1313,Stevan Jovetić,MNE,Hertha BSC,Bundesliga,2022,32.0,1989.0,9.9,3,2,2,1,0,1,11,9.1,10,2,1,1,2,5,10,0,"FW,MF",30-34,Forward,Montenegro,Europe
1317,Jubal,BRA,Auxerre,Ligue 1,2022,28.0,1993.0,35.7,41,26,29,11,1,19,38,50.0,19,57,34,23,53,94,193,0,DF,25-29,Defender,Brazil,South America
1318,Christopher Jullien,FRA,Montpellier,Ligue 1,2022,29.0,1993.0,29.9,46,28,29,14,3,28,51,54.9,23,35,18,17,43,89,114,1,DF,25-29,Defender,France,Europe
1319,Anthony Jung,GER,Werder Bremen,Bundesliga,2022,30.0,1991.0,29.1,46,27,19,20,7,31,58,53.4,27,30,6,24,22,68,63,0,"DF,FW",30-34,Defender,Germany,Europe
1320,Eli Junior Kroupi,FRA,Lorient,Ligue 1,2022,16.0,2006.0,0.1,0,0,0,0,0,0,1,0.0,1,0,0,0,1,1,0,0,"FW,MF",Under 20,Forward,France,Europe
1321,Lago Junior,CIV,Mallorca,La Liga,2022,31.0,1990.0,0.6,1,0,0,1,0,1,1,100.0,0,0,0,0,0,1,0,0,"FW,MF",30-34,Forward,Ivory Coast,Africa
1322,Hamed Junior Traorè,CIV,Bournemouth,Premier League,2022,22.0,2000.0,4.7,17,11,5,9,3,6,18,33.3,12,9,0,9,2,19,1,0,"FW,MF",20-24,Forward,Ivory Coast,Africa
1323,Hamed Junior Traorè,CIV,Sassuolo,Serie A,2022,22.0,2000.0,6.6,11,6,4,6,1,4,11,36.4,7,4,0,4,2,13,0,1,"MF,FW",20-24,Midfielder,Ivory Coast,Africa
1324,Vinicius Júnior,BRA,Real Madrid,La Liga,2022,22.0,2000.0,31.4,30,21,10,12,8,14,39,35.9,25,24,1,23,6,36,1,0,FW,20-24,Forward,Brazil,South America
1325,Josip Juranović,CRO,Union Berlin,Bundesliga,2022,26.0,1995.0,10.4,9,7,5,2,2,7,18,38.9,11,9,3,6,6,15,22,1,DF,25-29,Defender,Croatia,Europe
1326,James Justin,ENG,Leicester City,Premier League,2022,24.0,1998.0,13.9,20,18,7,12,1,9,18,50.0,9,24,6,18,15,35,47,0,DF,20-24,Defender,England,Europe
1327,Filip Jørgensen,DEN,Villarreal,La Liga,2022,20.0,2002.0,2.0,0,0,0,0,0,0,1,0.0,1,0,0,0,0,0,0,0,GK,20-24,Goalkeeper,Denmark,Europe
1328,Mathias Jørgensen,DEN,Brentford,Premier League,2022,32.0,1990.0,12.3,17,8,9,8,0,9,21,42.9,12,19,12,7,16,33,39,1,DF,30-34,Defender,Denmark,Europe
1329,Ozan Kabak,TUR,Hoffenheim,Bundesliga,2022,22.0,2000.0,26.5,51,34,27,21,3,17,30,56.7,13,35,23,12,45,96,83,0,DF,20-24,Defender,Turkey,Asia
1330,Issa Kaboré,BFA,Marseille,Ligue 1,2022,21.0,2001.0,11.4,33,19,10,18,5,21,32,65.6,11,11,1,10,12,45,21,1,DF,20-24,Defender,Burkina Faso,Africa
1331,Abdoul Kader Bamba,FRA,Nantes,Ligue 1,2022,28.0,1994.0,0.9,0,0,0,0,0,0,2,0.0,2,3,1,2,0,0,1,0,"FW,MF",25-29,Forward,France,Europe
1333,Tino Kadewere,ZIM,Mallorca,La Liga,2022,26.0,1996.0,6.0,6,3,3,3,0,4,9,44.4,5,6,2,4,2,8,1,0,"FW,MF",25-29,Forward,Zimbabwe,Africa
1334,Kaiky,BRA,Almería,La Liga,2022,18.0,2004.0,6.5,5,5,5,0,0,3,7,42.9,4,18,10,8,11,16,28,0,DF,Under 20,Defender,Brazil,South America
1335,Florian Kainz,AUT,Köln,Bundesliga,2022,29.0,1992.0,26.0,21,10,7,12,2,8,26,30.8,18,27,6,21,32,53,30,1,"MF,FW",25-29,Midfielder,Austria,Europe
1336,Gaël Kakuta,COD,Lens,Ligue 1,2022,31.0,1991.0,0.2,0,0,0,0,0,0,0,,0,0,0,0,0,0,1,0,FW,30-34,Forward,DR Congo,Africa
1337,Sasa Kalajdzic,AUT,Wolves,Premier League,2022,25.0,1997.0,0.5,0,0,0,0,0,0,0,,0,0,0,0,1,1,0,0,FW,25-29,Forward,Austria,Europe
1338,Sasa Kalajdzic,AUT,Stuttgart,Bundesliga,2022,25.0,1997.0,2.6,3,2,0,1,2,1,3,33.3,2,1,0,1,0,3,0,0,FW,25-29,Forward,Austria,Europe
1339,Arnaud Kalimuendo,FRA,Rennes,Ligue 1,2022,20.0,2002.0,20.5,15,8,3,6,6,5,20,25.0,15,15,2,13,2,17,9,0,FW,20-24,Forward,France,Europe
1340,Yayah Kallon,SLE,Hellas Verona,Serie A,2022,21.0,2001.0,9.6,14,10,5,4,5,7,12,58.3,5,10,0,10,8,22,5,0,"MF,FW",20-24,Midfielder,Sierra Leone,Africa
1341,Gedeon Kalulu,COD,Lorient,Ligue 1,2022,24.0,1997.0,27.1,64,34,43,14,7,30,48,62.5,18,32,3,29,28,92,79,2,DF,20-24,Defender,DR Congo,Africa
1342,Pierre Kalulu,FRA,Milan,Serie A,2022,22.0,2000.0,28.3,57,39,33,21,3,28,42,66.7,14,41,17,24,41,98,56,1,DF,20-24,Defender,France,Europe
1343,Justin-Noël Kalumba,FRA,Angers,Ligue 1,2022,17.0,2004.0,6.1,9,5,5,2,2,5,16,31.3,11,4,1,3,4,13,5,0,DF,Under 20,Defender,France,Europe
1344,Daichi Kamada,JPN,Eint Frankfurt,Bundesliga,2022,25.0,1996.0,25.2,51,31,10,37,4,31,57,54.4,26,31,2,29,16,67,17,1,MF,25-29,Midfielder,Japan,Asia
1346,Bingourou Kamara,SEN,Montpellier,Ligue 1,2022,25.0,1996.0,4.5,0,0,0,0,0,0,0,,0,0,0,0,0,0,2,0,GK,25-29,Goalkeeper,Senegal,Africa
1347,Boubacar Kamara,FRA,Aston Villa,Premier League,2022,22.0,1999.0,19.7,58,25,25,23,10,27,56,48.2,29,38,12,26,19,77,24,3,MF,20-24,Midfielder,France,Europe
1351,Nordine Kandil,FRA,Strasbourg,Ligue 1,2022,20.0,2001.0,1.1,3,2,1,2,0,0,3,0.0,3,2,0,2,1,4,1,0,"MF,FW",20-24,Midfielder,France,Europe
1352,Harry Kane,ENG,Tottenham,Premier League,2022,29.0,1993.0,37.8,15,12,1,6,8,7,21,33.3,14,27,7,20,2,17,18,0,FW,25-29,Forward,England,Europe
1353,Lee Kang-in,KOR,Mallorca,La Liga,2022,21.0,2001.0,31.4,42,24,10,22,10,18,61,29.5,43,25,2,23,11,53,7,0,"MF,FW",20-24,Midfielder,South Korea,Asia
1354,Wilfried Kanga,CIV,Hertha BSC,Bundesliga,2022,24.0,1998.0,15.7,5,4,2,1,2,2,4,50.0,2,14,3,11,2,7,13,0,FW,20-24,Forward,Ivory Coast,Africa
1355,N'Golo Kanté,FRA,Chelsea,Premier League,2022,31.0,1991.0,5.8,16,10,4,10,2,4,8,50.0,4,11,0,11,6,22,2,0,MF,30-34,Midfielder,France,Europe
1356,Kenan Karaman,TUR,Schalke 04,Bundesliga,2022,28.0,1994.0,10.8,11,8,3,5,3,3,12,25.0,9,9,1,8,3,14,9,0,FW,25-29,Forward,Turkey,Asia
1357,Yann Karamoh,FRA,Torino,Serie A,2022,24.0,1998.0,8.0,5,2,3,2,0,1,5,20.0,4,5,0,5,0,5,2,1,"MF,FW",20-24,Midfielder,France,Europe
1359,Ayman Kari,FRA,Lorient,Ligue 1,2022,17.0,2004.0,1.1,0,0,0,0,0,0,0,,0,4,0,4,3,3,0,0,"MF,DF",Under 20,Midfielder,France,Europe
1361,Rick Karsdorp,NED,Roma,Serie A,2022,27.0,1995.0,7.9,21,13,11,7,3,13,22,59.1,9,0,0,0,7,28,15,1,DF,25-29,Defender,Netherlands,Europe
1362,Denso Kasius,NED,Bologna,Serie A,2022,19.0,2002.0,3.8,12,6,7,4,1,8,10,80.0,2,6,3,3,3,15,6,0,DF,Under 20,Defender,Netherlands,Europe
1363,Thomas Kastanaras,GRE,Stuttgart,Bundesliga,2022,19.0,2003.0,0.8,0,0,0,0,0,0,0,,0,1,0,1,0,0,0,0,"FW,DF",Under 20,Forward,Greece,Europe
1364,Grigoris Kastanos,CYP,Salernitana,Serie A,2022,24.0,1998.0,14.3,39,23,18,19,2,16,40,40.0,24,20,6,14,8,47,8,0,"MF,DF",20-24,Midfielder,Cyprus,Asia
1365,Silas Katompa,COD,Stuttgart,Bundesliga,2022,23.0,1998.0,22.1,25,17,5,14,6,6,20,30.0,14,17,2,15,8,33,1,0,"FW,MF",20-24,Forward,DR Congo,Africa
1366,Moise Kean,ITA,Juventus,Serie A,2022,22.0,2000.0,11.1,8,6,2,5,1,3,7,42.9,4,4,0,4,5,13,2,0,FW,20-24,Forward,Italy,Europe
1367,Michael Keane,ENG,Everton,Premier League,2022,29.0,1993.0,10.9,7,4,5,2,0,5,8,62.5,3,12,7,5,14,21,55,1,DF,25-29,Defender,England,Europe
1368,Neeskens Kebano,COD,Fulham,Premier League,2022,30.0,1992.0,8.5,17,9,8,6,3,9,18,50.0,9,14,0,14,1,18,8,0,FW,30-34,Forward,DR Congo,Africa
1369,Kévin Keben Biakolo,CMR,Toulouse,Ligue 1,2022,18.0,2004.0,4.0,3,2,2,0,1,0,4,0.0,4,1,0,1,5,8,9,0,DF,Under 20,Defender,Cameroon,Africa
1370,Thilo Kehrer,GER,West Ham,Premier League,2022,25.0,1996.0,24.8,43,24,25,14,4,21,45,46.7,24,16,6,10,34,77,76,1,DF,25-29,Defender,Germany,Europe
1371,Check Keita,FRA,Reims,Ligue 1,2022,19.0,2003.0,7.6,12,9,9,3,0,4,9,44.4,5,6,5,1,5,17,24,1,DF,Under 20,Defender,France,Europe
1372,Naby Keïta,GUI,Liverpool,Premier League,2022,27.0,1995.0,3.3,5,4,2,3,0,1,4,25.0,3,1,0,1,2,7,3,0,MF,25-29,Midfielder,Guinea,Africa
1373,Yannik Keitel,GER,Freiburg,Bundesliga,2022,22.0,2000.0,7.6,11,7,4,6,1,3,5,60.0,2,6,3,3,13,24,8,0,MF,20-24,Midfielder,Germany,Europe
1374,Caoimhín Kelleher,IRL,Liverpool,Premier League,2022,23.0,1998.0,1.0,0,0,0,0,0,0,0,,0,0,0,0,0,0,0,0,GK,20-24,Goalkeeper,Republic of Ireland,Europe
1375,Lloyd Kelly,ENG,Bournemouth,Premier League,2022,23.0,1998.0,22.7,33,18,23,9,1,13,19,68.4,6,26,15,11,26,59,101,1,DF,20-24,Defender,England,Europe
1376,Marc-Oliver Kempf,GER,Hertha BSC,Bundesliga,2022,27.0,1995.0,30.1,44,27,29,14,1,16,22,72.7,6,42,32,10,51,95,143,0,DF,25-29,Defender,Germany,Europe
1377,Kenedy,BRA,Valladolid,La Liga,2022,26.0,1996.0,3.1,6,2,3,3,0,2,4,50.0,2,2,0,2,1,7,0,0,"FW,DF",25-29,Forward,Brazil,South America
1378,Jonjoe Kenny,ENG,Hertha BSC,Bundesliga,2022,25.0,1997.0,24.9,46,34,27,16,3,24,42,57.1,18,38,9,29,46,92,74,0,DF,25-29,Defender,England,Europe
1379,Franck Kessié,CIV,Barcelona,La Liga,2022,25.0,1996.0,11.0,15,9,6,6,3,8,18,44.4,10,10,2,8,12,27,11,2,MF,25-29,Midfielder,Ivory Coast,Africa
1380,Saîf-Eddine Khaoui,TUN,Clermont Foot,Ligue 1,2022,27.0,1995.0,22.5,47,28,14,25,8,15,47,31.9,32,17,2,15,33,80,8,0,MF,25-29,Midfielder,Tunisia,Africa
1381,Wahbi Khazri,TUN,Montpellier,Ligue 1,2022,31.0,1991.0,18.2,26,13,13,7,6,6,25,24.0,19,17,1,16,9,35,20,0,"FW,MF",30-34,Forward,Tunisia,Africa
1382,Rani Khedira,GER,Union Berlin,Bundesliga,2022,28.0,1994.0,32.0,60,33,21,32,7,25,50,50.0,25,33,10,23,40,100,33,0,MF,25-29,Midfielder,Germany,Europe
1383,Anthony Khelifa,ALG,Ajaccio,Ligue 1,2022,16.0,2005.0,0.1,0,0,0,0,0,0,0,,0,0,0,0,0,0,0,0,DF,Under 20,Defender,Algeria,Africa
1385,Luca Kilian,GER,Köln,Bundesliga,2022,22.0,1999.0,12.5,22,16,14,7,1,12,21,57.1,9,16,8,8,11,33,48,0,DF,20-24,Defender,Germany,Europe
1386,Max Kilman,ENG,Wolves,Premier League,2022,25.0,1997.0,36.7,36,20,26,9,1,16,30,53.3,14,70,42,28,19,55,164,1,DF,25-29,Defender,England,Europe
1387,Joshua Kimmich,GER,Bayern Munich,Bundesliga,2022,27.0,1995.0,31.2,78,49,24,46,8,38,72,52.8,34,36,7,29,41,119,39,2,MF,25-29,Midfielder,Germany,Europe
1388,Presnel Kimpembe,FRA,Paris S-G,Ligue 1,2022,26.0,1995.0,8.1,17,8,9,6,2,9,13,69.2,4,12,7,5,13,30,9,1,DF,25-29,Defender,France,Europe
1391,Simon Kjær,DEN,Milan,Serie A,2022,33.0,1989.0,11.2,15,8,9,6,0,7,11,63.6,4,14,11,3,9,24,35,1,DF,30-34,Defender,Denmark,Europe
1392,Pascal Klemens,GER,Hertha BSC,Bundesliga,2022,17.0,2005.0,1.0,0,0,0,0,0,0,1,0.0,1,1,0,1,1,1,3,0,DF,Under 20,Defender,Germany,Europe
1394,Lukas Klostermann,GER,RB Leipzig,Bundesliga,2022,26.0,1996.0,10.1,16,8,7,9,0,8,15,53.3,7,6,3,3,13,29,31,0,DF,25-29,Defender,Germany,Europe
1395,Justin Kluivert,NED,Valencia,La Liga,2022,23.0,1999.0,16.1,17,14,7,4,6,6,12,50.0,6,4,0,4,7,24,4,0,"FW,MF",20-24,Forward,Netherlands,Europe
1396,Ansgar Knauff,GER,Eint Frankfurt,Bundesliga,2022,20.0,2002.0,14.3,36,25,22,11,3,15,34,44.1,19,19,1,18,15,51,26,0,DF,20-24,Defender,Germany,Europe
1397,Robin Knoche,GER,Union Berlin,Bundesliga,2022,30.0,1992.0,31.9,45,29,29,12,4,24,47,51.1,23,35,18,17,38,83,140,0,DF,30-34,Defender,Germany,Europe
1398,Gregor Kobel,SUI,Dortmund,Bundesliga,2022,24.0,1997.0,27.0,0,0,0,0,0,0,1,0.0,1,1,0,1,0,0,7,2,GK,20-24,Goalkeeper,Switzerland,Europe
1399,Robin Koch,GER,Leeds United,Premier League,2022,26.0,1996.0,35.3,53,30,32,16,5,24,56,42.9,32,44,21,23,43,96,152,1,DF,25-29,Defender,Germany,Europe
1400,Samuel Koeberlé,FRA,Reims,Ligue 1,2022,17.0,2004.0,0.0,0,0,0,0,0,0,0,,0,0,0,0,0,0,0,0,MF,Under 20,Midfielder,France,Europe
1401,Rudy Kohon,FRA,Troyes,Ligue 1,2022,18.0,2004.0,0.7,4,3,4,0,0,2,2,100.0,0,1,0,1,1,5,2,0,DF,Under 20,Defender,France,Europe
1402,Dominik Kohr,GER,Mainz 05,Bundesliga,2022,28.0,1994.0,25.5,59,33,23,31,5,29,61,47.5,32,46,9,37,34,93,26,1,MF,25-29,Midfielder,Germany,Europe
1404,Sead Kolašinac,BIH,Marseille,Ligue 1,2022,29.0,1993.0,24.6,52,36,24,22,6,24,37,64.9,13,19,2,17,43,95,35,1,DF,25-29,Defender,Bosnia and Herzegovina,Europe
1405,Luca Koleosho,ITA,Espanyol,La Liga,2022,17.0,2004.0,0.7,2,2,0,0,2,1,2,50.0,1,1,0,1,0,2,0,0,"FW,DF",Under 20,Forward,Italy,Europe
1406,Randal Kolo Muani,FRA,Eint Frankfurt,Bundesliga,2022,23.0,1998.0,29.2,14,10,3,3,8,1,9,11.1,8,19,2,17,3,17,13,0,FW,20-24,Forward,France,Europe
1407,Timothée Kolodziejczak,FRA,Schalke 04,Bundesliga,2022,30.0,1991.0,0.3,0,0,0,0,0,0,1,0.0,1,0,0,0,1,1,1,0,DF,30-34,Defender,France,Europe
1408,Cheick Konaté,MLI,Clermont Foot,Ligue 1,2022,18.0,2004.0,6.4,19,12,10,7,2,13,22,59.1,9,7,1,6,13,32,8,1,DF,Under 20,Defender,Mali,Africa
1409,Ibrahima Konaté,FRA,Liverpool,Premier League,2022,23.0,1999.0,17.2,38,26,25,13,0,16,27,59.3,11,12,5,7,26,64,61,4,DF,20-24,Defender,France,Europe
1410,Geoffrey Kondogbia,CTA,Atlético Madrid,La Liga,2022,29.0,1993.0,11.2,40,23,19,20,1,17,25,68.0,8,9,1,8,26,66,12,1,MF,25-29,Midfielder,Central African Republic,Africa
1411,Ibrahima Koné,MLI,Lorient,Ligue 1,2022,23.0,1999.0,17.5,24,13,3,13,8,5,11,45.5,6,13,0,13,4,28,18,0,FW,20-24,Forward,Mali,Africa
1412,Manu Koné,FRA,Gladbach,Bundesliga,2022,21.0,2001.0,29.0,74,39,37,33,4,24,47,51.1,23,44,12,32,32,106,21,0,MF,20-24,Midfielder,France,Europe
1413,Youssouf Koné,MLI,Ajaccio,Ligue 1,2022,27.0,1995.0,10.2,28,19,24,4,0,18,25,72.0,7,9,2,7,12,40,32,1,DF,25-29,Defender,Mali,Africa
1414,Ezri Konsa,ENG,Aston Villa,Premier League,2022,24.0,1997.0,36.9,42,20,25,15,2,18,26,69.2,8,41,23,18,26,68,120,3,DF,20-24,Defender,England,Europe
1415,Teun Koopmeiners,NED,Atalanta,Serie A,2022,24.0,1998.0,31.8,46,26,15,24,7,28,55,50.9,27,41,5,36,19,65,36,2,MF,20-24,Midfielder,Netherlands,Europe
1416,Odilon Kossounou,CIV,Leverkusen,Bundesliga,2022,21.0,2001.0,16.9,21,14,12,7,2,8,16,50.0,8,26,11,15,24,45,58,1,DF,20-24,Defender,Ivory Coast,Africa
1419,Christian Kouamé,CIV,Fiorentina,Serie A,2022,24.0,1997.0,20.7,27,18,8,10,9,7,14,50.0,7,15,3,12,12,39,8,0,FW,20-24,Forward,Ivory Coast,Africa
1420,Rominigue Kouamé,MLI,Troyes,Ligue 1,2022,25.0,1996.0,29.6,44,27,28,14,2,17,41,41.5,24,32,11,21,49,93,46,1,MF,25-29,Midfielder,Mali,Africa
1422,Kalidou Koulibaly,SEN,Chelsea,Premier League,2022,31.0,1991.0,20.0,45,31,34,8,3,26,40,65.0,14,30,13,17,29,74,77,0,DF,30-34,Defender,Senegal,Africa
1423,Jules Koundé,FRA,Barcelona,La Liga,2022,23.0,1998.0,27.0,37,23,18,13,6,21,31,67.7,10,24,9,15,19,56,61,3,DF,20-24,Defender,France,Europe
1424,Boubakar Kouyaté,MLI,Montpellier,Ligue 1,2022,25.0,1997.0,14.0,31,18,18,11,2,19,35,54.3,16,24,14,10,34,65,73,1,DF,25-29,Defender,Mali,Africa
1425,Cheikhou Kouyaté,SEN,Nott'ham Forest,Premier League,2022,32.0,1989.0,9.8,29,21,18,8,3,9,13,69.2,4,14,2,12,10,39,24,0,MF,30-34,Midfielder,Senegal,Africa
1426,Mateo Kovačić,CRO,Chelsea,Premier League,2022,28.0,1994.0,19.0,36,24,16,14,6,14,36,38.9,22,10,1,9,19,55,16,0,MF,25-29,Midfielder,Croatia,Europe
1427,Viktor Kovalenko,UKR,Spezia,Serie A,2022,26.0,1996.0,6.1,9,5,1,6,2,5,8,62.5,3,11,2,9,4,13,7,0,MF,25-29,Midfielder,Ukraine,Europe
1428,Soichiro Kozuki,JPN,Schalke 04,Bundesliga,2022,21.0,2000.0,4.2,6,4,3,3,0,4,6,66.7,2,5,0,5,3,9,3,0,"FW,MF",20-24,Forward,Japan,Asia
1429,Emil Krafth,SWE,Newcastle Utd,Premier League,2022,27.0,1994.0,0.0,0,0,0,0,0,0,0,,0,0,0,0,0,0,0,0,DF,25-29,Defender,Sweden,Europe
1431,Andrej Kramarić,CRO,Hoffenheim,Bundesliga,2022,31.0,1991.0,26.5,5,2,2,1,2,1,11,9.1,10,14,2,12,6,11,13,0,"MF,FW",30-34,Midfielder,Croatia,Europe
1432,Christoph Kramer,GER,Gladbach,Bundesliga,2022,31.0,1991.0,24.7,44,33,24,15,5,22,55,40.0,33,34,2,32,17,61,40,0,MF,30-34,Midfielder,Germany,Europe
1433,Tom Krauß,GER,Schalke 04,Bundesliga,2022,21.0,2001.0,27.9,112,68,39,62,11,51,100,51.0,49,39,6,33,36,148,35,0,MF,20-24,Midfielder,Germany,Europe
1434,Rasmus Kristensen,DEN,Leeds United,Premier League,2022,25.0,1997.0,21.8,62,35,35,21,6,42,76,55.3,34,32,14,18,35,97,61,0,DF,25-29,Defender,Denmark,Europe
1436,Raimonds Krollis,LVA,Spezia,Serie A,2022,20.0,2001.0,0.4,1,1,0,0,1,0,1,0.0,1,0,0,0,0,1,0,0,"FW,DF",20-24,Forward,Latvia,Europe
1437,Toni Kroos,GER,Real Madrid,La Liga,2022,32.0,1990.0,23.9,51,32,16,33,2,23,69,33.3,46,23,4,19,24,75,11,0,MF,30-34,Midfielder,Germany,Europe
1438,Rade Krunić,BIH,Milan,Serie A,2022,28.0,1993.0,18.4,40,28,18,18,4,16,50,32.0,34,31,11,20,16,56,21,0,MF,25-29,Midfielder,Bosnia and Herzegovina,Europe
1439,Max Kruse,GER,Wolfsburg,Bundesliga,2022,34.0,1988.0,3.0,1,1,0,1,0,0,1,0.0,1,2,1,1,0,1,1,0,"MF,FW",30-34,Midfielder,Germany,Europe
1440,Lukas Kübler,GER,Freiburg,Bundesliga,2022,29.0,1992.0,18.2,37,25,24,9,4,18,30,60.0,12,25,11,14,29,66,50,0,DF,25-29,Defender,Germany,Europe
1441,Takefusa Kubo,JPN,Real Sociedad,La Liga,2022,21.0,2001.0,27.1,44,26,18,16,10,16,38,42.1,22,29,1,28,9,53,4,0,"FW,MF",20-24,Forward,Japan,Asia
1442,Dejan Kulusevski,SWE,Tottenham,Premier League,2022,22.0,2000.0,23.0,38,15,23,7,8,16,44,36.4,28,19,0,19,13,51,7,0,"MF,FW",20-24,Midfielder,Sweden,Europe
1443,Sael Kumbedi,FRA,Lyon,Ligue 1,2022,17.0,2005.0,14.7,47,27,27,13,7,20,38,52.6,18,23,7,16,10,57,16,0,DF,Under 20,Defender,France,Europe
1444,Marash Kumbulla,ALB,Roma,Serie A,2022,22.0,2000.0,2.9,4,4,2,2,0,2,3,66.7,1,2,1,1,4,8,6,0,DF,20-24,Defender,Albania,Europe
1445,Pierre Kunde,CMR,Bochum,Bundesliga,2022,27.0,1995.0,4.2,12,6,3,8,1,6,14,42.9,8,7,1,6,7,19,9,0,"MF,FW",25-29,Midfielder,Cameroon,Africa
1446,Alou Kuol,AUS,Stuttgart,Bundesliga,2022,21.0,2000.0,0.1,0,0,0,0,0,0,0,,0,0,0,0,0,0,0,0,FW,20-24,Forward,Australia,Oceania
1447,Layvin Kurzawa,FRA,Fulham,Premier League,2022,29.0,1992.0,1.5,3,2,1,1,1,3,3,100.0,0,1,1,0,2,5,4,0,DF,25-29,Defender,France,Europe
1448,Khvicha Kvaratskhelia,GEO,Napoli,Serie A,2022,21.0,2001.0,28.0,43,23,12,8,23,17,43,39.5,26,20,0,20,5,48,6,1,FW,20-24,Forward,Georgia,Asia
1449,Grejohn Kyei,FRA,Clermont Foot,Ligue 1,2022,26.0,1995.0,24.8,16,7,2,9,5,4,13,30.8,9,14,3,11,6,22,22,0,FW,25-29,Forward,France,Europe
1450,Daniel Kyereh,GHA,Freiburg,Bundesliga,2022,26.0,1996.0,6.2,6,4,2,4,0,3,6,50.0,3,4,0,4,2,8,6,0,"MF,FW",25-29,Midfielder,Ghana,Africa
1451,Giorgos Kyriakopoulos,GRE,Bologna,Serie A,2022,26.0,1996.0,7.8,13,6,4,5,4,10,23,43.5,13,14,2,12,4,17,10,0,"DF,FW",25-29,Defender,Greece,Europe
1452,Giorgos Kyriakopoulos,GRE,Sassuolo,Serie A,2022,26.0,1996.0,8.5,21,8,7,9,5,10,14,71.4,4,7,1,6,11,32,12,1,"FW,DF",25-29,Forward,Greece,Europe
1454,Luca de la Torre,USA,Celta Vigo,La Liga,2022,24.0,1998.0,16.5,28,19,11,14,3,12,32,37.5,20,22,1,21,9,37,6,0,MF,20-24,Midfielder,United States,North America
1456,Gaëtan Laborde,FRA,Nice,Ligue 1,2022,28.0,1994.0,27.8,45,25,13,17,15,18,40,45.0,22,27,2,25,9,54,13,0,FW,25-29,Forward,France,Europe
1457,Gaëtan Laborde,FRA,Rennes,Ligue 1,2022,28.0,1994.0,2.8,1,1,1,0,0,0,1,0.0,1,1,0,1,0,1,1,0,FW,25-29,Forward,France,Europe
1458,Alexandre Lacazette,FRA,Lyon,Ligue 1,2022,31.0,1991.0,32.5,43,23,7,17,19,10,29,34.5,19,23,3,20,15,58,4,0,FW,30-34,Forward,France,Europe
1459,Qazim Laçi,ALB,Ajaccio,Ligue 1,2022,26.0,1996.0,2.4,6,3,2,3,1,4,9,44.4,5,5,0,5,2,8,3,0,MF,25-29,Midfielder,Albania,Europe
1460,Maxence Lacroix,FRA,Wolfsburg,Bundesliga,2022,22.0,2000.0,18.1,22,13,15,7,0,8,16,50.0,8,22,11,11,26,48,85,0,DF,20-24,Defender,France,Europe
1461,Alban Lafont,FRA,Nantes,Ligue 1,2022,23.0,1999.0,37.0,0,0,0,0,0,0,1,0.0,1,0,0,0,0,0,20,4,GK,20-24,Goalkeeper,France,Europe
1462,Aïssa Laïdouni,TUN,Union Berlin,Bundesliga,2022,25.0,1996.0,9.7,14,7,6,8,0,5,17,29.4,12,22,4,18,9,23,3,0,MF,25-29,Midfielder,Tunisia,Africa
1463,Konrad Laimer,AUT,RB Leipzig,Bundesliga,2022,25.0,1997.0,16.3,60,31,23,30,7,30,54,55.6,24,31,4,27,18,78,8,0,MF,25-29,Midfielder,Austria,Europe
1464,Stefan Lainer,AUT,Gladbach,Bundesliga,2022,29.0,1992.0,9.1,16,8,10,5,1,10,23,43.5,13,8,1,7,14,30,34,1,DF,25-29,Defender,Austria,Europe
1465,Kenny Lala,MAD,Brest,Ligue 1,2022,30.0,1991.0,15.7,36,19,19,15,2,22,38,57.9,16,15,5,10,21,57,28,0,DF,30-34,Defender,Madagascar,Africa
1466,Adam Lallana,ENG,Brighton,Premier League,2022,34.0,1988.0,8.0,9,4,6,2,1,0,7,0.0,7,6,0,6,2,11,1,0,"MF,FW",30-34,Midfielder,England,Europe
1467,Vassilis Lambropoulos,GRE,Bochum,Bundesliga,2022,32.0,1990.0,7.0,10,8,7,3,0,6,9,66.7,3,5,3,2,13,23,41,0,DF,30-34,Defender,Greece,Europe
1468,Érik Lamela,ARG,Sevilla,La Liga,2022,30.0,1992.0,20.5,46,27,14,16,16,12,34,35.3,22,26,2,24,7,53,3,0,"FW,MF",30-34,Forward,Argentina,South America
1469,Mohamed Lamine Bayo,GUI,Lille,Ligue 1,2022,24.0,1998.0,7.2,3,3,0,2,1,0,12,0.0,12,3,1,2,0,3,1,0,"FW,MF",20-24,Forward,Guinea,Africa
1470,Sam Lammers,NED,Sampdoria,Serie A,2022,25.0,1997.0,12.2,12,5,2,7,3,6,15,40.0,9,10,3,7,6,18,11,0,FW,25-29,Forward,Netherlands,Europe
1471,Sam Lammers,NED,Empoli,Serie A,2022,25.0,1997.0,9.8,20,10,5,9,6,7,11,63.6,4,4,1,3,3,23,8,0,FW,25-29,Forward,Netherlands,Europe
1472,Tariq Lamptey,GHA,Brighton,Premier League,2022,21.0,2000.0,5.0,11,6,6,4,1,5,7,71.4,2,7,3,4,7,18,2,0,DF,20-24,Defender,Ghana,Africa
1473,Manuel Lanzini,ARG,West Ham,Premier League,2022,29.0,1993.0,2.8,2,2,1,1,0,2,6,33.3,4,2,0,2,2,4,0,0,"MF,FW",25-29,Midfielder,Argentina,South America
1475,Julien Laporte,FRA,Lorient,Ligue 1,2022,28.0,1993.0,18.4,22,16,18,3,1,16,22,72.7,6,33,27,6,18,40,108,2,DF,25-29,Defender,France,Europe
1476,Cyle Larin,CAN,Valladolid,La Liga,2022,27.0,1995.0,16.3,9,3,2,4,3,3,7,42.9,4,6,3,3,0,9,15,0,FW,25-29,Forward,Canada,North America
1478,Yasser Larouci,ALG,Troyes,Ligue 1,2022,21.0,2001.0,20.0,23,13,13,8,2,15,24,62.5,9,15,1,14,26,49,46,0,"DF,MF",20-24,Defender,Algeria,Africa
1479,Jordan Larsson,SWE,Schalke 04,Bundesliga,2022,25.0,1997.0,5.1,8,5,1,7,0,2,9,22.2,7,9,0,9,4,12,3,0,"FW,MF",25-29,Forward,Sweden,Europe
1480,Kevin Lasagna,ITA,Hellas Verona,Serie A,2022,29.0,1992.0,17.5,12,6,7,3,2,6,14,42.9,8,17,1,16,5,17,13,0,"FW,MF",25-29,Forward,Italy,Europe
1481,Jamaal Lascelles,ENG,Newcastle Utd,Premier League,2022,28.0,1993.0,2.4,1,0,1,0,0,1,1,100.0,0,3,2,1,0,1,17,0,DF,25-29,Defender,England,Europe
1484,Danny Latza,GER,Schalke 04,Bundesliga,2022,32.0,1989.0,9.5,17,13,8,8,1,5,17,29.4,12,16,1,15,5,22,15,0,MF,30-34,Midfielder,Germany,Europe
1485,Armand Lauriente,FRA,Sassuolo,Serie A,2022,23.0,1998.0,24.2,21,15,5,7,9,8,21,38.1,13,20,0,20,12,33,8,0,FW,20-24,Forward,France,Europe
1486,Armand Lauriente,FRA,Lorient,Ligue 1,2022,23.0,1998.0,3.0,8,7,3,4,1,3,7,42.9,4,5,1,4,4,12,1,0,FW,20-24,Forward,France,Europe
1487,Roméo Lavia,BEL,Southampton,Premier League,2022,18.0,2004.0,24.7,60,35,27,29,4,21,53,39.6,32,47,11,36,33,93,23,1,MF,Under 20,Midfielder,Belgium,Europe
1488,Lázaro,BRA,Almería,La Liga,2022,20.0,2002.0,8.0,4,3,3,0,1,3,15,20.0,12,16,1,15,2,6,1,0,"FW,MF",20-24,Forward,Brazil,South America
1489,Valentino Lazaro,AUT,Torino,Serie A,2022,26.0,1996.0,15.3,10,5,6,0,4,6,14,42.9,8,16,3,13,3,13,29,0,DF,25-29,Defender,Austria,Europe
1492,Manuel Lazzari,ITA,Lazio,Serie A,2022,28.0,1993.0,20.9,33,21,13,14,6,21,36,58.3,15,20,6,14,18,51,36,1,DF,25-29,Defender,Italy,Europe
1493,Théo Le Bris,FRA,Lorient,Ligue 1,2022,19.0,2002.0,16.1,31,19,17,11,3,15,33,45.5,18,21,2,19,18,49,31,0,"MF,DF",Under 20,Midfielder,France,Europe
1494,Julien Le Cardinal,FRA,Lens,Ligue 1,2022,24.0,1997.0,1.8,6,4,5,0,1,4,6,66.7,2,3,0,3,2,8,5,0,DF,20-24,Defender,France,Europe
1495,Jérémy Le Douaron,FRA,Brest,Ligue 1,2022,24.0,1998.0,23.0,15,9,5,9,1,3,27,11.1,24,29,2,27,11,26,30,0,"MF,FW",20-24,Midfielder,France,Europe
1496,Enzo Le Fée,FRA,Lorient,Ligue 1,2022,22.0,2000.0,33.6,108,64,52,40,16,43,113,38.1,70,50,5,45,34,142,38,1,MF,20-24,Midfielder,France,Europe
1497,Vincent Le Goff,FRA,Lorient,Ligue 1,2022,32.0,1989.0,37.0,75,32,56,16,3,45,62,72.6,17,29,9,20,41,116,105,1,DF,30-34,Defender,France,Europe
1498,Maxime Le Marchand,FRA,Strasbourg,Ligue 1,2022,32.0,1989.0,22.4,39,24,23,14,2,19,31,61.3,12,22,14,8,37,76,74,0,DF,30-34,Defender,France,Europe
1500,Rafael Leão,POR,Milan,Serie A,2022,23.0,1999.0,26.9,8,7,2,3,3,6,14,42.9,8,9,2,7,15,23,8,0,"FW,MF",20-24,Forward,Portugal,Europe
1501,Paolo Lebas,FRA,Ajaccio,Ligue 1,2022,19.0,2003.0,0.6,0,0,0,0,0,0,0,,0,0,0,0,0,0,0,0,MF,Under 20,Midfielder,France,Europe
1502,Jean-Louis Leca,FRA,Lens,Ligue 1,2022,36.0,1985.0,1.0,0,0,0,0,0,0,0,,0,0,0,0,0,0,0,1,GK,35-39,Goalkeeper,France,Europe
1503,Benjamin Lecomte,FRA,Espanyol,La Liga,2022,31.0,1991.0,10.0,0,0,0,0,0,0,0,,0,0,0,0,0,0,3,2,GK,30-34,Goalkeeper,France,Europe
1504,Benjamin Lecomte,FRA,Montpellier,Ligue 1,2022,31.0,1991.0,19.0,0,0,0,0,0,0,2,0.0,2,0,0,0,0,0,6,0,GK,30-34,Goalkeeper,France,Europe
1505,Jeremías Ledesma,ARG,Cádiz,La Liga,2022,29.0,1993.0,34.0,3,2,3,0,0,3,7,42.9,4,1,0,1,2,5,23,3,GK,25-29,Goalkeeper,Argentina,South America
1506,Pierre Lees-Melou,FRA,Brest,Ligue 1,2022,29.0,1993.0,30.7,97,55,55,37,5,57,123,46.3,66,48,13,35,52,149,46,1,MF,25-29,Midfielder,France,Europe
1507,Diogo Leite,POR,Union Berlin,Bundesliga,2022,23.0,1999.0,25.0,35,20,21,14,0,21,34,61.8,13,23,14,9,26,61,99,1,DF,20-24,Defender,Portugal,Europe
1508,Maxim Leitsch,GER,Mainz 05,Bundesliga,2022,24.0,1998.0,7.4,9,7,6,3,0,4,5,80.0,1,7,4,3,18,27,26,1,DF,20-24,Defender,Germany,Europe
1509,Florian Lejeune,FRA,Rayo Vallecano,La Liga,2022,31.0,1991.0,28.5,28,17,19,8,1,17,25,68.0,8,24,16,8,15,43,123,0,DF,30-34,Defender,France,Europe
1511,Thomas Lemar,FRA,Atlético Madrid,La Liga,2022,26.0,1995.0,13.9,30,18,10,13,7,10,28,35.7,18,12,3,9,7,37,12,0,MF,25-29,Midfielder,France,Europe
1512,Félix Lemaréchal,FRA,Brest,Ligue 1,2022,18.0,2003.0,3.2,5,5,2,1,2,0,3,0.0,3,6,0,6,1,6,2,0,MF,Under 20,Midfielder,France,Europe
1513,Dexter Lembikisa,JAM,Wolves,Premier League,2022,18.0,2003.0,0.3,0,0,0,0,0,0,0,,0,0,0,0,0,0,0,0,DF,Under 20,Defender,Jamaica,North America
1514,Mario Lemina,GAB,Wolves,Premier League,2022,28.0,1993.0,14.4,38,24,22,13,3,20,38,52.6,18,26,8,18,14,52,24,1,MF,25-29,Midfielder,Gabon,Africa
1515,Mario Lemina,GAB,Nice,Ligue 1,2022,28.0,1993.0,9.3,32,21,11,14,7,12,18,66.7,6,13,5,8,11,43,20,0,"MF,DF",25-29,Midfielder,Gabon,Africa
1516,Tim Lemperle,GER,Köln,Bundesliga,2022,20.0,2002.0,1.5,6,4,3,1,2,3,5,60.0,2,5,0,5,1,7,4,0,"FW,MF",20-24,Forward,Germany,Europe
1517,Clément Lenglet,FRA,Tottenham,Premier League,2022,27.0,1995.0,22.4,38,23,18,15,5,16,34,47.1,18,26,11,15,18,56,68,2,DF,25-29,Defender,France,Europe
1518,Bernd Leno,GER,Fulham,Premier League,2022,30.0,1992.0,36.0,0,0,0,0,0,0,3,0.0,3,0,0,0,0,0,18,1,GK,30-34,Goalkeeper,Germany,Europe
1519,Christopher Lenz,GER,Eint Frankfurt,Bundesliga,2022,27.0,1994.0,14.3,29,21,17,7,5,16,37,43.2,21,16,3,13,21,50,34,0,DF,25-29,Defender,Germany,Europe
1522,Johann Lepenant,FRA,Lyon,Ligue 1,2022,19.0,2002.0,21.5,58,34,24,27,7,32,86,37.2,54,29,5,24,28,86,17,3,MF,Under 20,Midfielder,France,Europe
1523,Mehdi Léris,ALG,Sampdoria,Serie A,2022,24.0,1998.0,27.3,63,46,30,24,9,23,55,41.8,32,38,6,32,27,90,34,0,"MF,DF",20-24,Midfielder,Algeria,Africa
1524,Jefferson Lerma,COL,Bournemouth,Premier League,2022,27.0,1994.0,36.1,50,30,23,23,4,20,45,44.4,25,32,15,17,47,97,91,2,MF,25-29,Midfielder,Colombia,South America
1525,Benjamin Leroy,FRA,Ajaccio,Ligue 1,2022,33.0,1989.0,31.1,0,0,0,0,0,0,2,0.0,2,0,0,0,1,1,16,2,GK,30-34,Goalkeeper,France,Europe
1526,Léo Leroy,FRA,Montpellier,Ligue 1,2022,22.0,2000.0,13.2,53,38,24,26,3,31,57,54.4,26,25,2,23,14,67,8,0,MF,20-24,Midfielder,France,Europe
1527,Alexandre Letellier,FRA,Paris S-G,Ligue 1,2022,31.0,1990.0,0.1,0,0,0,0,0,0,0,,0,0,0,0,0,0,0,0,GK,30-34,Goalkeeper,France,Europe
1528,Ruan Levine,BRA,Ajaccio,Ligue 1,2022,23.0,1999.0,0.3,2,2,1,1,0,0,0,,0,1,0,1,2,4,0,0,"MF,FW",20-24,Midfielder,Brazil,South America
1530,Jamie Leweling,GER,Union Berlin,Bundesliga,2022,21.0,2001.0,2.9,5,3,2,2,1,3,5,60.0,2,3,0,3,1,6,0,0,"FW,MF",20-24,Forward,Germany,Europe
1532,Rico Lewis,ENG,Manchester City,Premier League,2022,17.0,2004.0,10.0,16,9,9,5,2,6,11,54.5,5,8,4,4,6,22,13,1,"DF,MF",Under 20,Defender,England,Europe
1533,Keane Lewis-Potter,ENG,Brentford,Premier League,2022,21.0,2001.0,3.6,1,0,0,1,0,0,0,,0,5,1,4,0,1,2,0,"FW,MF",20-24,Forward,England,Europe
1534,Dimitri Liénard,FRA,Strasbourg,Ligue 1,2022,34.0,1988.0,17.1,46,29,20,18,8,34,57,59.6,23,28,4,24,16,62,24,0,"DF,MF",30-34,Defender,France,Europe
1535,Philipp Lienhart,AUT,Freiburg,Bundesliga,2022,26.0,1996.0,27.8,29,18,19,10,0,13,27,48.1,14,29,15,14,35,64,97,0,DF,25-29,Defender,Austria,Europe
1536,Matthijs de Ligt,NED,Bayern Munich,Bundesliga,2022,22.0,1999.0,26.7,32,23,15,16,1,15,24,62.5,9,31,20,11,23,55,85,0,DF,20-24,Defender,Netherlands,Europe
1537,Dimitris Limnios,GRE,Köln,Bundesliga,2022,24.0,1998.0,0.4,0,0,0,0,0,0,0,,0,0,0,0,1,1,0,0,FW,20-24,Forward,Greece,Europe
1538,Victor Lindelöf,SWE,Manchester Utd,Premier League,2022,28.0,1994.0,15.2,22,17,10,9,3,9,17,52.9,8,18,9,9,21,43,63,1,DF,25-29,Defender,Sweden,Europe
1539,Jesper Lindstrøm,DEN,Eint Frankfurt,Bundesliga,2022,22.0,2000.0,18.7,26,11,15,7,4,7,22,31.8,15,25,3,22,9,35,9,0,"MF,FW",20-24,Midfielder,Denmark,Europe
1541,Jesse Lingard,ENG,Nott'ham Forest,Premier League,2022,29.0,1992.0,10.3,4,4,2,2,0,1,7,14.3,6,11,0,11,5,9,4,0,"FW,MF",25-29,Forward,England,Europe
1542,Samuel Lino,BRA,Valencia,La Liga,2022,22.0,1999.0,32.1,66,43,17,37,12,26,72,36.1,46,34,0,34,18,84,16,0,"FW,MF",20-24,Forward,Brazil,South America
1546,Valentino Livramento,ENG,Southampton,Premier League,2022,19.0,2002.0,0.3,2,1,2,0,0,0,0,,0,0,0,0,2,4,3,0,"DF,FW",Under 20,Defender,England,Europe
1547,Dejan Ljubicic,AUT,Köln,Bundesliga,2022,24.0,1997.0,19.0,25,14,7,14,4,13,40,32.5,27,20,1,19,8,33,8,1,"MF,FW",20-24,Midfielder,Austria,Europe
1552,Hugo Lloris,FRA,Tottenham,Premier League,2022,35.0,1986.0,24.5,1,1,1,0,0,1,3,33.3,2,0,0,0,1,2,13,5,GK,35-39,Goalkeeper,France,Europe
1553,Giovani Lo Celso,ARG,Villarreal,La Liga,2022,26.0,1996.0,12.5,32,28,7,15,10,12,21,57.1,9,14,2,12,6,38,5,0,"MF,FW",25-29,Midfielder,Argentina,South America
1554,Stanislav Lobotka,SVK,Napoli,Serie A,2022,27.0,1994.0,34.5,83,44,35,35,13,43,73,58.9,30,29,7,22,23,106,16,0,MF,25-29,Midfielder,Slovakia,Europe
1555,Manuel Locatelli,ITA,Juventus,Serie A,2022,24.0,1998.0,27.2,59,33,26,23,10,30,53,56.6,23,50,22,28,27,86,59,0,MF,20-24,Midfielder,Italy,Europe
1556,Luka Lochoshvili,GEO,Cremonese,Serie A,2022,24.0,1998.0,20.4,45,19,30,11,4,22,31,71.0,9,31,10,21,22,67,89,0,DF,20-24,Defender,Georgia,Asia
1557,Bradley Locko,FRA,Reims,Ligue 1,2022,20.0,2002.0,11.8,31,16,21,4,6,15,27,55.6,12,17,4,13,20,51,21,0,DF,20-24,Defender,France,Europe
1558,Bradley Locko,FRA,Brest,Ligue 1,2022,20.0,2002.0,3.0,4,3,2,1,1,2,3,66.7,1,4,0,4,2,6,13,0,DF,20-24,Defender,France,Europe
1559,Renan Lodi,BRA,Nott'ham Forest,Premier League,2022,24.0,1998.0,24.6,52,39,38,8,6,33,66,50.0,33,25,6,19,33,85,74,0,DF,20-24,Defender,Brazil,South America
1560,Ruben Loftus-Cheek,ENG,Chelsea,Premier League,2022,26.0,1996.0,17.1,25,14,8,14,3,12,22,54.5,10,15,2,13,12,37,23,0,"MF,DF",25-29,Midfielder,England,Europe
1561,Sean Longstaff,ENG,Newcastle Utd,Premier League,2022,24.0,1997.0,28.0,42,21,16,20,6,20,52,38.5,32,35,8,27,16,58,23,0,MF,20-24,Midfielder,England,Europe
1562,Ademola Lookman,NGA,Atalanta,Serie A,2022,24.0,1997.0,19.2,13,5,2,6,5,3,15,20.0,12,18,0,18,4,17,1,0,"FW,MF",20-24,Forward,Nigeria,Africa
1563,Anthony Lopes,POR,Lyon,Ligue 1,2022,31.0,1990.0,31.3,1,0,1,0,0,1,4,25.0,3,0,0,0,3,4,10,0,GK,30-34,Goalkeeper,Portugal,Europe
1564,Rony Lopes,POR,Troyes,Ligue 1,2022,26.0,1995.0,26.1,24,12,6,15,3,7,31,22.6,24,14,2,12,9,33,10,0,"MF,FW",25-29,Midfielder,Portugal,Europe
1568,Maxime Lopez,FRA,Sassuolo,Serie A,2022,24.0,1997.0,25.5,42,18,26,12,4,16,56,28.6,40,24,6,18,22,64,21,0,MF,20-24,Midfielder,France,Europe
1571,Dion Lopy,SEN,Reims,Ligue 1,2022,20.0,2002.0,15.3,45,24,22,16,7,23,62,37.1,39,27,3,24,22,67,18,0,MF,20-24,Midfielder,Senegal,Africa
1572,Anthony Losilla,FRA,Bochum,Bundesliga,2022,36.0,1986.0,30.2,76,49,32,34,10,38,77,49.4,39,39,12,27,37,113,67,0,MF,35-39,Midfielder,France,Europe
1573,Jordan Lotomba,SUI,Nice,Ligue 1,2022,23.0,1998.0,27.3,65,38,33,24,8,31,48,64.6,17,38,11,27,32,97,53,0,DF,20-24,Defender,Switzerland,Europe
1574,Matteo Lovato,ITA,Salernitana,Serie A,2022,22.0,2000.0,9.0,17,14,14,3,0,10,25,40.0,15,8,5,3,13,30,33,2,DF,20-24,Defender,Italy,Europe
1575,Dejan Lovren,CRO,Lyon,Ligue 1,2022,33.0,1989.0,16.2,25,19,20,5,0,20,29,69.0,9,20,10,10,26,51,70,1,DF,30-34,Defender,Croatia,Europe
1577,Jamal Lowe,JAM,Bournemouth,Premier League,2022,28.0,1994.0,0.1,0,0,0,0,0,0,0,,0,0,0,0,0,0,0,0,"MF,FW",25-29,Midfielder,Jamaica,North America
1579,Hirving Lozano,MEX,Napoli,Serie A,2022,27.0,1995.0,17.8,24,13,10,6,8,9,21,42.9,12,31,0,31,15,39,6,0,FW,25-29,Forward,Mexico,North America
1581,Jean Lucas,BRA,Monaco,Ligue 1,2022,24.0,1998.0,3.2,9,5,3,5,1,6,12,50.0,6,2,1,1,4,13,2,0,MF,20-24,Midfielder,Brazil,South America
1582,Jhon Lucumí,COL,Bologna,Serie A,2022,24.0,1998.0,32.2,53,37,39,13,1,24,43,55.8,19,43,26,17,35,88,100,1,DF,20-24,Defender,Colombia,South America
1585,José Luis Palomino,ARG,Atalanta,Serie A,2022,32.0,1990.0,8.4,23,14,16,7,0,11,19,57.9,8,11,4,7,28,51,20,0,DF,30-34,Defender,Argentina,South America
1586,Douglas Luiz,BRA,Aston Villa,Premier League,2022,24.0,1998.0,32.5,72,42,31,32,9,29,63,46.0,34,36,7,29,40,112,27,2,MF,20-24,Midfielder,Brazil,South America
1587,Romelu Lukaku,BEL,Inter,Serie A,2022,29.0,1993.0,18.4,3,1,1,0,2,2,5,40.0,3,3,1,2,0,3,16,0,FW,25-29,Forward,Belgium,Europe
1588,Castello Lukeba,FRA,Lyon,Ligue 1,2022,19.0,2002.0,33.2,39,23,27,8,4,21,31,67.7,10,42,24,18,75,114,105,1,DF,Under 20,Defender,France,Europe
1589,Dodi Lukebakio,BEL,Hertha BSC,Bundesliga,2022,24.0,1997.0,26.6,18,11,7,8,3,6,27,22.2,21,23,5,18,13,31,17,0,"FW,MF",20-24,Forward,Belgium,Europe
1592,Andriy Lunin,UKR,Real Madrid,La Liga,2022,23.0,1999.0,7.0,0,0,0,0,0,0,0,,0,0,0,0,0,0,1,0,GK,20-24,Goalkeeper,Ukraine,Europe
1593,Andrey Lunyov,RUS,Leverkusen,Bundesliga,2022,30.0,1991.0,1.0,0,0,0,0,0,0,0,,0,0,0,0,0,0,0,0,GK,30-34,Goalkeeper,Russia,Europe
1594,Sebastiano Luperto,ITA,Empoli,Serie A,2022,25.0,1996.0,34.8,33,18,24,8,1,9,20,45.0,11,54,42,12,43,76,163,1,DF,25-29,Defender,Italy,Europe
1595,Lyanco,BRA,Southampton,Premier League,2022,25.0,1997.0,13.1,24,16,15,9,0,12,18,66.7,6,30,25,5,20,44,65,2,DF,25-29,Defender,Brazil,South America
1596,Charalambos Lykogiannis,GRE,Bologna,Serie A,2022,28.0,1993.0,12.3,16,8,5,6,5,5,13,38.5,8,9,4,5,15,31,30,0,DF,25-29,Defender,Greece,Europe
1598,Awer Mabil,AUS,Cádiz,La Liga,2022,26.0,1995.0,1.8,2,0,0,1,1,1,3,33.3,2,1,1,0,0,2,1,0,"MF,FW",25-29,Midfielder,Australia,Oceania
1599,Alexis Mac Allister,ARG,Brighton,Premier League,2022,23.0,1998.0,32.1,70,39,22,40,8,34,71,47.9,37,26,2,24,22,92,10,1,MF,20-24,Midfielder,Argentina,South America
1600,Deiver Machado,COL,Lens,Ligue 1,2022,28.0,1993.0,24.3,45,26,18,20,7,21,34,61.8,13,21,4,17,21,66,27,0,"DF,MF",25-29,Defender,Colombia,South America
1601,Darwin Machís,VEN,Valladolid,La Liga,2022,29.0,1993.0,6.7,3,2,0,2,1,1,8,12.5,7,5,0,5,3,6,4,0,FW,25-29,Forward,Venezuela,South America
1602,James Maddison,ENG,Leicester City,Premier League,2022,25.0,1996.0,27.6,51,26,25,19,7,19,50,38.0,31,19,1,18,13,64,6,1,"MF,FW",25-29,Midfielder,England,Europe
1603,Noni Madueke,ENG,Chelsea,Premier League,2022,20.0,2002.0,7.1,12,8,5,4,3,6,13,46.2,7,13,2,11,4,16,7,0,FW,20-24,Forward,England,Europe
1605,Gabriel Magalhães,BRA,Arsenal,Premier League,2022,24.0,1997.0,37.9,48,30,29,15,4,18,27,66.7,9,49,26,23,32,80,125,3,DF,20-24,Defender,Brazil,South America
1606,Lisandro Magallán,ARG,Elche,La Liga,2022,28.0,1993.0,10.0,19,11,11,5,3,10,12,83.3,2,14,5,9,13,32,30,1,DF,25-29,Defender,Argentina,South America
1607,Soungoutou Magassa,FRA,Monaco,Ligue 1,2022,18.0,2003.0,0.9,4,1,2,2,0,2,4,50.0,2,3,0,3,1,5,1,0,MF,Under 20,Midfielder,France,Europe
1608,Giulio Maggiore,ITA,Salernitana,Serie A,2022,24.0,1998.0,9.9,20,8,11,6,3,10,21,47.6,11,19,4,15,8,28,10,0,MF,20-24,Midfielder,Italy,Europe
1609,Giangiacomo Magnani,ITA,Hellas Verona,Serie A,2022,26.0,1995.0,17.0,33,22,20,11,2,19,25,76.0,6,20,15,5,21,54,76,0,DF,25-29,Defender,Italy,Europe
1610,Hugo Magnetti,FRA,Brest,Ligue 1,2022,24.0,1998.0,18.8,43,27,18,23,2,23,63,36.5,40,21,1,20,25,68,12,0,MF,20-24,Midfielder,France,Europe
1611,Yohann Magnin,FRA,Clermont Foot,Ligue 1,2022,25.0,1997.0,26.7,89,54,37,45,7,54,106,50.9,52,50,12,38,25,114,46,0,MF,25-29,Midfielder,France,Europe
1612,Harry Maguire,ENG,Manchester Utd,Premier League,2022,29.0,1993.0,8.5,8,6,6,1,1,4,5,80.0,1,18,11,7,13,21,41,0,DF,25-29,Defender,England,Europe
1614,Riyad Mahrez,ALG,Manchester City,Premier League,2022,31.0,1991.0,21.3,30,14,8,13,9,13,39,33.3,26,27,1,26,9,39,5,0,"FW,MF",30-34,Forward,Algeria,Africa
1615,Arne Maier,GER,Augsburg,Bundesliga,2022,23.0,1999.0,21.8,31,22,17,11,3,10,18,55.6,8,21,0,21,15,46,22,0,MF,20-24,Midfielder,Germany,Europe
1616,Mike Maignan,FRA,Milan,Serie A,2022,27.0,1995.0,22.0,1,0,1,0,0,1,1,100.0,0,0,0,0,1,2,10,1,GK,25-29,Goalkeeper,France,Europe
1617,Linton Maina,GER,Köln,Bundesliga,2022,23.0,1999.0,24.9,18,12,5,11,2,7,30,23.3,23,19,0,19,5,23,9,0,"FW,MF",20-24,Forward,Germany,Europe
1618,Kobbie Mainoo,ENG,Manchester Utd,Premier League,2022,17.0,2005.0,0.1,0,0,0,0,0,0,0,,0,1,1,0,0,0,0,0,MF,Under 20,Midfielder,England,Europe
1619,Ainsley Maitland-Niles,ENG,Southampton,Premier League,2022,24.0,1997.0,15.6,45,24,23,18,4,28,44,63.6,16,28,7,21,22,67,45,1,"DF,MF",20-24,Defender,England,Europe
1621,Lovro Majer,CRO,Rennes,Ligue 1,2022,24.0,1998.0,18.5,34,23,16,13,5,8,29,27.6,21,21,1,20,21,55,5,1,"MF,FW",20-24,Midfielder,Croatia,Europe
1622,Jean-Victor Makengo,FRA,Udinese,Serie A,2022,24.0,1998.0,8.9,16,13,7,7,2,5,9,55.6,4,8,2,6,9,25,3,0,MF,20-24,Midfielder,France,Europe
1623,Jean-Victor Makengo,FRA,Lorient,Ligue 1,2022,24.0,1998.0,11.8,16,8,5,10,1,6,20,30.0,14,8,5,3,10,26,13,1,MF,20-24,Midfielder,France,Europe
1624,Béni Makouana,CGO,Montpellier,Ligue 1,2022,19.0,2002.0,2.2,1,0,0,1,0,0,2,0.0,2,3,1,2,0,1,1,0,"FW,MF",Under 20,Forward,Congo,Africa
1626,Tyrell Malacia,NED,Manchester Utd,Premier League,2022,22.0,1999.0,15.5,46,33,33,12,1,14,25,56.0,11,13,3,10,25,71,49,0,DF,20-24,Defender,Netherlands,Europe
1627,Lorenzo Malagrida,ITA,Sampdoria,Serie A,2022,18.0,2003.0,1.2,1,0,0,0,1,1,3,33.3,2,1,0,1,0,1,1,0,"MF,DF",Under 20,Midfielder,Italy,Europe
1628,Daniel Maldini,ITA,Spezia,Serie A,2022,20.0,2001.0,7.0,12,5,3,4,5,4,11,36.4,7,9,0,9,1,13,8,0,"FW,MF",20-24,Forward,Italy,Europe
1629,Youssef Maleh,MAR,Fiorentina,Serie A,2022,23.0,1998.0,3.3,3,1,0,3,0,0,4,0.0,4,5,0,5,1,4,3,0,MF,20-24,Midfielder,Morocco,Africa
1630,Youssef Maleh,MAR,Lecce,Serie A,2022,23.0,1998.0,7.5,17,8,3,7,7,6,14,42.9,8,20,1,19,5,22,10,0,MF,20-24,Midfielder,Morocco,Africa
1631,Donyell Malen,NED,Dortmund,Bundesliga,2022,23.0,1999.0,19.0,13,5,3,4,6,5,12,41.7,7,14,1,13,4,17,11,0,FW,20-24,Forward,Netherlands,Europe
1632,Ruslan Malinovskyi,UKR,Atalanta,Serie A,2022,29.0,1993.0,6.1,14,8,5,6,3,6,17,35.3,11,8,1,7,5,19,2,0,"MF,FW",25-29,Midfielder,Ukraine,Europe
1633,Ruslan Malinovskyi,UKR,Marseille,Ligue 1,2022,29.0,1993.0,13.6,21,11,3,12,6,10,26,38.5,16,13,1,12,3,24,9,0,"MF,FW",25-29,Midfielder,Ukraine,Europe
1636,Giorgi Mamardashvili,GEO,Valencia,La Liga,2022,21.0,2000.0,38.0,0,0,0,0,0,0,0,,0,0,0,0,1,1,11,4,GK,20-24,Goalkeeper,Georgia,Asia
1637,Hianga Mananga Mbock,FRA,Brest,Ligue 1,2022,22.0,1999.0,0.2,0,0,0,0,0,0,1,0.0,1,0,0,0,0,0,0,0,MF,20-24,Midfielder,France,Europe
1638,Gianluca Mancini,ITA,Roma,Serie A,2022,26.0,1996.0,31.8,37,19,27,9,1,18,34,52.9,16,38,17,21,46,83,67,0,DF,25-29,Defender,Italy,Europe
1639,Steve Mandanda,FRA,Rennes,Ligue 1,2022,37.0,1985.0,33.5,0,0,0,0,0,0,2,0.0,2,0,0,0,0,0,9,3,GK,35-39,Goalkeeper,France,Europe
1640,Reinildo Mandava,MOZ,Atlético Madrid,La Liga,2022,28.0,1994.0,20.6,66,43,46,19,1,38,49,77.6,11,27,12,15,30,96,59,0,DF,25-29,Defender,Mozambique,Africa
1641,Aïssa Mandi,ALG,Villarreal,La Liga,2022,30.0,1991.0,16.2,18,10,14,3,1,6,12,50.0,6,19,14,5,21,39,58,0,DF,30-34,Defender,Algeria,Africa
1642,Rolando Mandragora,ITA,Fiorentina,Serie A,2022,25.0,1997.0,21.7,42,24,12,22,8,23,52,44.2,29,25,3,22,16,58,21,0,MF,25-29,Midfielder,Italy,Europe
1643,Sadio Mané,SEN,Bayern Munich,Bundesliga,2022,30.0,1992.0,15.8,11,5,3,3,5,1,9,11.1,8,15,2,13,0,11,4,0,"FW,MF",30-34,Forward,Senegal,Africa
1644,Orel Mangala,BEL,Nott'ham Forest,Premier League,2022,24.0,1998.0,17.2,28,20,16,10,2,12,29,41.4,17,21,7,14,23,51,15,0,MF,20-24,Midfielder,Belgium,Europe
1645,Thomas Mangani,FRA,Ajaccio,Ligue 1,2022,35.0,1987.0,14.8,32,17,14,15,3,18,47,38.3,29,22,3,19,24,56,22,1,MF,35-39,Midfielder,France,Europe
1646,Vito Mannone,ITA,Lorient,Ligue 1,2022,34.0,1988.0,17.9,0,0,0,0,0,0,0,,0,0,0,0,0,0,4,3,GK,30-34,Goalkeeper,Italy,Europe
1650,Faitout Maouassa,FRA,Montpellier,Ligue 1,2022,24.0,1998.0,21.4,52,32,26,20,6,18,41,43.9,23,31,3,28,20,72,23,0,"FW,DF",20-24,Forward,France,Europe
1651,Sekou Mara,FRA,Southampton,Premier League,2022,20.0,2002.0,6.2,14,10,5,8,1,3,9,33.3,6,11,0,11,1,15,5,0,"FW,MF",20-24,Forward,France,Europe
1652,Marcão,BRA,Sevilla,La Liga,2022,26.0,1996.0,4.2,2,2,1,1,0,1,1,100.0,0,3,3,0,6,8,14,0,DF,25-29,Defender,Brazil,South America
1652,Marcão,BRA,Sevilla,La Liga,2022,26.0,1996.0,4.2,2,2,1,1,0,1,1,100.0,0,3,3,0,6,8,14,0,DF,25-29,Defender,Brazil,South America
1652,Marcão,BRA,Sevilla,La Liga,2022,26.0,1996.0,4.2,2,2,1,1,0,1,1,100.0,0,3,3,0,6,8,14,0,DF,25-29,Defender,Brazil,South America
1652,Marcão,BRA,Sevilla,La Liga,2022,26.0,1996.0,4.2,2,2,1,1,0,1,1,100.0,0,3,3,0,6,8,14,0,DF,25-29,Defender,Brazil,South America
1652,Marcão,BRA,Sevilla,La Liga,2022,26.0,1996.0,4.2,2,2,1,1,0,1,1,100.0,0,3,3,0,6,8,14,0,DF,25-29,Defender,Brazil,South America
1652,Marcão,BRA,Sevilla,La Liga,2022,26.0,1996.0,4.2,2,2,1,1,0,1,1,100.0,0,3,3,0,6,8,14,0,DF,25-29,Defender,Brazil,South America
1652,Marcão,BRA,Sevilla,La Liga,2022,26.0,1996.0,4.2,2,2,1,1,0,1,1,100.0,0,3,3,0,6,8,14,0,DF,25-29,Defender,Brazil,South America
1652,Marcão,BRA,Sevilla,La Liga,2022,26.0,1996.0,4.2,2,2,1,1,0,1,1,100.0,0,3,3,0,6,8,14,0,DF,25-29,Defender,Brazil,South America
1652,Marcão,BRA,Sevilla,La Liga,2022,26.0,1996.0,4.2,2,2,1,1,0,1,1,100.0,0,3,3,0,6,8,14,0,DF,25-29,Defender,Brazil,South America
1652,Marcão,BRA,Sevilla,La Liga,2022,26.0,1996.0,4.2,2,2,1,1,0,1,1,100.0,0,3,3,0,6,8,14,0,DF,25-29,Defender,Brazil,South America
1652,Marcão,BRA,Sevilla,La Liga,2022,26.0,1996.0,4.2,2,2,1,1,0,1,1,100.0,0,3,3,0,6,8,14,0,DF,25-29,Defender,Brazil,South America
1652,Marcão,BRA,Sevilla,La Liga,2022,26.0,1996.0,4.2,2,2,1,1,0,1,1,100.0,0,3,3,0,6,8,14,0,DF,25-29,Defender,Brazil,South America
1652,Marcão,BRA,Sevilla,La Liga,2022,26.0,1996.0,4.2,2,2,1,1,0,1,1,100.0,0,3,3,0,6,8,14,0,DF,25-29,Defender,Brazil,South America
1652,Marcão,BRA,Sevilla,La Liga,2022,26.0,1996.0,4.2,2,2,1,1,0,1,1,100.0,0,3,3,0,6,8,14,0,DF,25-29,Defender,Brazil,South America
1652,Marcão,BRA,Sevilla,La Liga,2022,26.0,1996.0,4.2,2,2,1,1,0,1,1,100.0,0,3,3,0,6,8,14,0,DF,25-29,Defender,Brazil,South America
1652,Marcão,BRA,Sevilla,La Liga,2022,26.0,1996.0,4.2,2,2,1,1,0,1,1,100.0,0,3,3,0,6,8,14,0,DF,25-29,Defender,Brazil,South America
1652,Marcão,BRA,Sevilla,La Liga,2022,26.0,1996.0,4.2,2,2,1,1,0,1,1,100.0,0,3,3,0,6,8,14,0,DF,25-29,Defender,Brazil,South America
1652,Marcão,BRA,Sevilla,La Liga,2022,26.0,1996.0,4.2,2,2,1,1,0,1,1,100.0,0,3,3,0,6,8,14,0,DF,25-29,Defender,Brazil,South America
1652,Marcão,BRA,Sevilla,La Liga,2022,26.0,1996.0,4.2,2,2,1,1,0,1,1,100.0,0,3,3,0,6,8,14,0,DF,25-29,Defender,Brazil,South America
1652,Marcão,BRA,Sevilla,La Liga,2022,26.0,1996.0,4.2,2,2,1,1,0,1,1,100.0,0,3,3,0,6,8,14,0,DF,25-29,Defender,Brazil,South America
1652,Marcão,BRA,Sevilla,La Liga,2022,26.0,1996.0,4.2,2,2,1,1,0,1,1,100.0,0,3,3,0,6,8,14,0,DF,25-29,Defender,Brazil,South America
1652,Marcão,BRA,Sevilla,La Liga,2022,26.0,1996.0,4.2,2,2,1,1,0,1,1,100.0,0,3,3,0,6,8,14,0,DF,25-29,Defender,Brazil,South America
1652,Marcão,BRA,Sevilla,La Liga,2022,26.0,1996.0,4.2,2,2,1,1,0,1,1,100.0,0,3,3,0,6,8,14,0,DF,25-29,Defender,Brazil,South America
1652,Marcão,BRA,Sevilla,La Liga,2022,26.0,1996.0,4.2,2,2,1,1,0,1,1,100.0,0,3,3,0,6,8,14,0,DF,25-29,Defender,Brazil,South America
1652,Marcão,BRA,Sevilla,La Liga,2022,26.0,1996.0,4.2,2,2,1,1,0,1,1,100.0,0,3,3,0,6,8,14,0,DF,25-29,Defender,Brazil,South America
1653,Solly March,ENG,Brighton,Premier League,2022,28.0,1994.0,30.2,53,31,16,17,20,8,28,28.6,20,34,3,31,24,77,32,0,"FW,DF",25-29,Forward,England,Europe
1654,Agustín Marchesín,ARG,Celta Vigo,La Liga,2022,34.0,1988.0,19.0,0,0,0,0,0,0,1,0.0,1,0,0,0,0,0,7,0,GK,30-34,Goalkeeper,Argentina,South America
1655,Federico Marchetti,ITA,Spezia,Serie A,2022,39.0,1983.0,0.7,0,0,0,0,0,0,0,,0,0,0,0,0,0,0,0,GK,35-39,Goalkeeper,Italy,Europe
1656,Vincent Marchetti,FRA,Ajaccio,Ligue 1,2022,25.0,1997.0,27.2,55,26,29,19,7,25,68,36.8,43,23,3,20,19,74,31,0,MF,25-29,Midfielder,France,Europe
1657,Riccardo Marchizza,ITA,Sassuolo,Serie A,2022,24.0,1998.0,3.1,2,2,1,1,0,2,4,50.0,2,2,0,2,2,4,8,0,DF,20-24,Defender,Italy,Europe
1658,Gian Marco Ferrari,ITA,Sassuolo,Serie A,2022,30.0,1992.0,24.7,23,16,11,10,2,10,17,58.8,7,29,20,9,23,46,81,4,DF,30-34,Defender,Italy,Europe
1659,Emiliano Marcondes,DEN,Bournemouth,Premier League,2022,27.0,1995.0,0.1,0,0,0,0,0,0,0,,0,0,0,0,0,0,1,0,MF,25-29,Midfielder,Denmark,Europe
1664,José María Giménez,URU,Atlético Madrid,La Liga,2022,27.0,1995.0,26.9,43,25,28,14,1,24,35,68.6,11,37,17,20,24,67,138,1,DF,25-29,Defender,Uruguay,South America
1665,Mariano,DOM,Real Madrid,La Liga,2022,28.0,1993.0,1.7,1,0,0,1,0,0,0,,0,1,0,1,0,1,0,0,FW,25-29,Forward,Dominican Republic,North America
1667,Răzvan Marin,ROU,Empoli,Serie A,2022,26.0,1996.0,28.2,44,22,22,21,1,19,40,47.5,21,29,11,18,14,58,33,0,MF,25-29,Midfielder,Romania,Europe
1669,Guillermo Maripán,CHI,Monaco,Ligue 1,2022,28.0,1994.0,24.0,46,26,26,20,0,17,33,51.5,16,39,27,12,38,84,87,0,DF,25-29,Defender,Chile,South America
1670,Marlon,BRA,Monza,Serie A,2022,26.0,1995.0,17.7,35,21,20,14,1,15,29,51.7,14,13,4,9,18,53,50,0,DF,25-29,Defender,Brazil,South America
1670,Marlon,BRA,Monza,Serie A,2022,26.0,1995.0,17.7,35,21,20,14,1,15,29,51.7,14,13,4,9,18,53,50,0,DF,25-29,Defender,Brazil,South America
1670,Marlon,BRA,Monza,Serie A,2022,26.0,1995.0,17.7,35,21,20,14,1,15,29,51.7,14,13,4,9,18,53,50,0,DF,25-29,Defender,Brazil,South America
1670,Marlon,BRA,Monza,Serie A,2022,26.0,1995.0,17.7,35,21,20,14,1,15,29,51.7,14,13,4,9,18,53,50,0,DF,25-29,Defender,Brazil,South America
1670,Marlon,BRA,Monza,Serie A,2022,26.0,1995.0,17.7,35,21,20,14,1,15,29,51.7,14,13,4,9,18,53,50,0,DF,25-29,Defender,Brazil,South America
1670,Marlon,BRA,Monza,Serie A,2022,26.0,1995.0,17.7,35,21,20,14,1,15,29,51.7,14,13,4,9,18,53,50,0,DF,25-29,Defender,Brazil,South America
1670,Marlon,BRA,Monza,Serie A,2022,26.0,1995.0,17.7,35,21,20,14,1,15,29,51.7,14,13,4,9,18,53,50,0,DF,25-29,Defender,Brazil,South America
1670,Marlon,BRA,Monza,Serie A,2022,26.0,1995.0,17.7,35,21,20,14,1,15,29,51.7,14,13,4,9,18,53,50,0,DF,25-29,Defender,Brazil,South America
1670,Marlon,BRA,Monza,Serie A,2022,26.0,1995.0,17.7,35,21,20,14,1,15,29,51.7,14,13,4,9,18,53,50,0,DF,25-29,Defender,Brazil,South America
1671,Omar Marmoush,EGY,Wolfsburg,Bundesliga,2022,23.0,1999.0,16.4,16,10,8,2,6,4,16,25.0,12,21,1,20,7,23,4,0,FW,20-24,Forward,Egypt,Africa
1672,Marquinhos,BRA,Arsenal,Premier League,2022,19.0,2003.0,0.0,0,0,0,0,0,0,0,,0,0,0,0,0,0,0,0,MF,Under 20,Midfielder,Brazil,South America
1672,Marquinhos,BRA,Arsenal,Premier League,2022,19.0,2003.0,0.0,0,0,0,0,0,0,0,,0,0,0,0,0,0,0,0,MF,Under 20,Midfielder,Brazil,South America
1672,Marquinhos,BRA,Arsenal,Premier League,2022,19.0,2003.0,0.0,0,0,0,0,0,0,0,,0,0,0,0,0,0,0,0,MF,Under 20,Midfielder,Brazil,South America
1672,Marquinhos,BRA,Arsenal,Premier League,2022,19.0,2003.0,0.0,0,0,0,0,0,0,0,,0,0,0,0,0,0,0,0,MF,Under 20,Midfielder,Brazil,South America
1672,Marquinhos,BRA,Arsenal,Premier League,2022,19.0,2003.0,0.0,0,0,0,0,0,0,0,,0,0,0,0,0,0,0,0,MF,Under 20,Midfielder,Brazil,South America
1672,Marquinhos,BRA,Arsenal,Premier League,2022,19.0,2003.0,0.0,0,0,0,0,0,0,0,,0,0,0,0,0,0,0,0,MF,Under 20,Midfielder,Brazil,South America
1672,Marquinhos,BRA,Arsenal,Premier League,2022,19.0,2003.0,0.0,0,0,0,0,0,0,0,,0,0,0,0,0,0,0,0,MF,Under 20,Midfielder,Brazil,South America
1672,Marquinhos,BRA,Arsenal,Premier League,2022,19.0,2003.0,0.0,0,0,0,0,0,0,0,,0,0,0,0,0,0,0,0,MF,Under 20,Midfielder,Brazil,South America
1672,Marquinhos,BRA,Arsenal,Premier League,2022,19.0,2003.0,0.0,0,0,0,0,0,0,0,,0,0,0,0,0,0,0,0,MF,Under 20,Midfielder,Brazil,South America
1673,Marquinhos,BRA,Paris S-G,Ligue 1,2022,28.0,1994.0,30.2,33,25,18,12,3,18,26,69.2,8,43,27,16,23,56,83,2,DF,25-29,Defender,Brazil,South America
1673,Marquinhos,BRA,Paris S-G,Ligue 1,2022,28.0,1994.0,30.2,33,25,18,12,3,18,26,69.2,8,43,27,16,23,56,83,2,DF,25-29,Defender,Brazil,South America
1673,Marquinhos,BRA,Paris S-G,Ligue 1,2022,28.0,1994.0,30.2,33,25,18,12,3,18,26,69.2,8,43,27,16,23,56,83,2,DF,25-29,Defender,Brazil,South America
1673,Marquinhos,BRA,Paris S-G,Ligue 1,2022,28.0,1994.0,30.2,33,25,18,12,3,18,26,69.2,8,43,27,16,23,56,83,2,DF,25-29,Defender,Brazil,South America
1673,Marquinhos,BRA,Paris S-G,Ligue 1,2022,28.0,1994.0,30.2,33,25,18,12,3,18,26,69.2,8,43,27,16,23,56,83,2,DF,25-29,Defender,Brazil,South America
1673,Marquinhos,BRA,Paris S-G,Ligue 1,2022,28.0,1994.0,30.2,33,25,18,12,3,18,26,69.2,8,43,27,16,23,56,83,2,DF,25-29,Defender,Brazil,South America
1673,Marquinhos,BRA,Paris S-G,Ligue 1,2022,28.0,1994.0,30.2,33,25,18,12,3,18,26,69.2,8,43,27,16,23,56,83,2,DF,25-29,Defender,Brazil,South America
1673,Marquinhos,BRA,Paris S-G,Ligue 1,2022,28.0,1994.0,30.2,33,25,18,12,3,18,26,69.2,8,43,27,16,23,56,83,2,DF,25-29,Defender,Brazil,South America
1673,Marquinhos,BRA,Paris S-G,Ligue 1,2022,28.0,1994.0,30.2,33,25,18,12,3,18,26,69.2,8,43,27,16,23,56,83,2,DF,25-29,Defender,Brazil,South America
1674,Luca Marrone,ITA,Monza,Serie A,2022,32.0,1990.0,1.5,0,0,0,0,0,0,2,0.0,2,2,2,0,0,0,4,1,DF,30-34,Defender,Italy,Europe
1675,Eric Martel,GER,Köln,Bundesliga,2022,20.0,2002.0,22.4,66,41,29,30,7,30,60,50.0,30,29,9,20,33,99,49,0,MF,20-24,Midfielder,Germany,Europe
1678,Anthony Martial,FRA,Manchester Utd,Premier League,2022,26.0,1995.0,10.9,5,3,0,2,3,1,4,25.0,3,11,2,9,1,6,4,0,FW,25-29,Forward,France,Europe
1684,Jonas Martin,FRA,Lille,Ligue 1,2022,32.0,1990.0,3.1,9,7,4,5,0,5,14,35.7,9,3,1,2,7,16,3,0,MF,30-34,Midfielder,France,Europe
1685,Gabriel Martinelli,BRA,Arsenal,Premier League,2022,21.0,2001.0,31.0,31,18,13,12,6,9,22,40.9,13,24,1,23,9,40,14,0,FW,20-24,Forward,Brazil,South America
1687,Emiliano Martínez,ARG,Aston Villa,Premier League,2022,29.0,1992.0,34.9,0,0,0,0,0,0,2,0.0,2,0,0,0,1,1,23,1,GK,25-29,Goalkeeper,Argentina,South America
1687,Emiliano Martínez,ARG,Aston Villa,Premier League,2022,29.0,1992.0,34.9,0,0,0,0,0,0,2,0.0,2,0,0,0,1,1,23,1,GK,25-29,Goalkeeper,Argentina,South America
1687,Emiliano Martínez,ARG,Aston Villa,Premier League,2022,29.0,1992.0,34.9,0,0,0,0,0,0,2,0.0,2,0,0,0,1,1,23,1,GK,25-29,Goalkeeper,Argentina,South America
1687,Emiliano Martínez,ARG,Aston Villa,Premier League,2022,29.0,1992.0,34.9,0,0,0,0,0,0,2,0.0,2,0,0,0,1,1,23,1,GK,25-29,Goalkeeper,Argentina,South America
1689,Lautaro Martínez,ARG,Inter,Serie A,2022,24.0,1997.0,28.6,25,14,3,15,7,7,23,30.4,16,31,1,30,13,38,16,1,FW,20-24,Forward,Argentina,South America
1690,Lisandro Martínez,ARG,Manchester Utd,Premier League,2022,24.0,1998.0,23.5,54,28,33,18,3,30,43,69.8,13,51,27,24,33,87,103,0,DF,20-24,Defender,Argentina,South America
1691,Lucas Martínez Quarta,ARG,Fiorentina,Serie A,2022,26.0,1996.0,24.1,80,48,44,32,4,42,61,68.9,19,41,19,22,48,128,78,1,DF,25-29,Defender,Argentina,South America
1693,Gelson Martins,POR,Monaco,Ligue 1,2022,27.0,1995.0,3.8,15,8,6,4,5,4,13,30.8,9,4,1,3,3,18,2,0,"MF,FW",25-29,Midfielder,Portugal,Europe
1694,Adam Marušić,MNE,Lazio,Serie A,2022,29.0,1992.0,30.7,41,30,23,14,4,25,39,64.1,14,20,6,14,38,79,63,1,DF,25-29,Defender,Montenegro,Europe
1695,Omar Mascarell,EQG,Elche,La Liga,2022,29.0,1993.0,27.2,53,26,32,19,2,31,64,48.4,33,51,19,32,45,98,54,1,"MF,DF",25-29,Midfielder,Equatorial Guinea,Africa
1696,Adam Masina,MAR,Udinese,Serie A,2022,28.0,1994.0,8.8,10,7,7,3,0,6,15,40.0,9,11,4,7,10,20,28,1,DF,25-29,Defender,Morocco,Africa
1699,Han-Noah Massengo,FRA,Auxerre,Ligue 1,2022,21.0,2001.0,12.4,27,15,10,15,2,7,16,43.8,9,12,3,9,14,41,7,0,MF,20-24,Midfielder,France,Europe
1700,Yanis Massolin,FRA,Clermont Foot,Ligue 1,2022,19.0,2002.0,0.7,2,1,1,0,1,0,1,0.0,1,1,0,1,2,4,0,0,MF,Under 20,Midfielder,France,Europe
1702,Pape Matar Sarr,SEN,Tottenham,Premier League,2022,19.0,2002.0,2.4,7,6,4,2,1,4,8,50.0,4,3,2,1,6,13,6,0,"MF,FW",Under 20,Midfielder,Senegal,Africa
1703,Eliot Matazo,BEL,Monaco,Ligue 1,2022,20.0,2002.0,13.1,26,12,11,13,2,11,26,42.3,15,18,4,14,15,41,11,1,MF,20-24,Midfielder,Belgium,Europe
1704,Jean-Philippe Mateta,FRA,Crystal Palace,Premier League,2022,25.0,1997.0,8.6,7,1,2,4,1,1,3,33.3,2,3,1,2,3,10,18,0,FW,25-29,Forward,France,Europe
1706,Joël Matip,CMR,Liverpool,Premier League,2022,30.0,1991.0,12.1,14,8,12,2,0,11,23,47.8,12,8,3,5,21,35,45,3,DF,30-34,Defender,Cameroon,Africa
1707,Henning Matriciani,GER,Schalke 04,Bundesliga,2022,22.0,2000.0,20.7,43,23,28,12,3,26,60,43.3,34,28,11,17,23,66,57,1,DF,20-24,Defender,Germany,Europe
1708,Chrislain Matsima,FRA,Lorient,Ligue 1,2022,20.0,2002.0,2.5,0,0,0,0,0,0,0,,0,3,3,0,2,2,7,0,"DF,MF",20-24,Defender,France,Europe
1709,Chrislain Matsima,FRA,Monaco,Ligue 1,2022,20.0,2002.0,5.0,11,6,7,2,2,4,7,57.1,3,5,5,0,9,20,16,0,DF,20-24,Defender,France,Europe
1710,Jean Mattéo Bahoya,FRA,Angers,Ligue 1,2022,17.0,2005.0,3.0,7,3,1,3,3,4,7,57.1,3,4,0,4,0,7,0,0,"FW,MF",Under 20,Forward,France,Europe
1711,Azor Matusiwa,NED,Reims,Ligue 1,2022,24.0,1998.0,27.6,66,41,30,29,7,36,61,59.0,25,37,11,26,46,112,52,0,MF,20-24,Midfielder,Netherlands,Europe
1712,Neal Maupay,FRA,Everton,Premier League,2022,25.0,1996.0,12.4,11,5,3,4,4,2,4,50.0,2,8,0,8,5,16,0,0,FW,25-29,Forward,France,Europe
1713,Aïman Maurer,MAR,Clermont Foot,Ligue 1,2022,17.0,2004.0,5.6,2,1,1,1,0,1,10,10.0,9,1,0,1,3,5,5,0,MF,Under 20,Midfielder,Morocco,Africa
1714,Stephy Mavididi,ENG,Montpellier,Ligue 1,2022,24.0,1998.0,14.3,24,19,12,8,4,13,27,48.1,14,21,1,20,4,28,10,0,FW,20-24,Forward,England,Europe
1715,Konstantinos Mavropanos,GRE,Stuttgart,Bundesliga,2022,24.0,1997.0,25.4,50,27,32,15,3,28,38,73.7,10,39,18,21,63,113,99,0,DF,20-24,Defender,Greece,Europe
1716,Christian Mawissa,FRA,Toulouse,Ligue 1,2022,17.0,2005.0,1.1,2,0,1,1,0,1,3,33.3,2,0,0,0,3,5,1,0,DF,Under 20,Defender,France,Europe
1717,Philipp Max,GER,Eint Frankfurt,Bundesliga,2022,28.0,1993.0,7.7,12,9,4,7,1,5,16,31.3,11,10,2,8,3,15,11,0,DF,25-29,Defender,Germany,Europe
1718,Eric Maxim Choupo-Moting,CMR,Bayern Munich,Bundesliga,2022,33.0,1989.0,12.4,10,7,2,6,2,1,2,50.0,1,8,0,8,0,10,5,0,FW,30-34,Forward,Cameroon,Africa
1719,Luís Maximiano,POR,Lazio,Serie A,2022,23.0,1999.0,0.1,0,0,0,0,0,0,0,,0,0,0,0,0,0,0,0,GK,20-24,Goalkeeper,Portugal,Europe
1720,Keke Maximilian Topp,GER,Schalke 04,Bundesliga,2022,18.0,2004.0,0.2,0,0,0,0,0,0,0,,0,0,0,0,1,1,0,0,FW,Under 20,Forward,Germany,Europe
1721,Fernand Mayembo,CGO,Ajaccio,Ligue 1,2022,26.0,1996.0,7.9,8,5,6,2,0,4,9,44.4,5,2,0,2,11,19,36,0,DF,25-29,Defender,Congo,Africa
1723,Ibrahim Maza,ALG,Hertha BSC,Bundesliga,2022,16.0,2005.0,0.8,1,1,1,0,0,0,1,0.0,1,2,0,2,0,1,1,0,"MF,FW",Under 20,Midfielder,Algeria,Africa
1724,Derek Mazou-Sacko,FRA,Troyes,Ligue 1,2022,17.0,2004.0,0.2,0,0,0,0,0,0,1,0.0,1,1,0,1,1,1,1,0,MF,Under 20,Midfielder,France,Europe
1725,Noussair Mazraoui,MAR,Bayern Munich,Bundesliga,2022,24.0,1997.0,11.9,29,21,9,9,11,15,24,62.5,9,13,2,11,10,39,25,0,DF,20-24,Defender,Morocco,Africa
1726,Pasquale Mazzocchi,ITA,Salernitana,Serie A,2022,27.0,1995.0,21.8,32,18,21,5,6,17,37,45.9,20,10,2,8,10,42,37,2,DF,25-29,Defender,Italy,Europe
1727,Kevin Mbabu,SUI,Fulham,Premier League,2022,27.0,1995.0,1.6,3,2,2,1,0,1,3,33.3,2,2,0,2,3,6,3,0,"DF,FW",25-29,Defender,Switzerland,Europe
1728,Noah Mbamba,BEL,Leverkusen,Bundesliga,2022,17.0,2005.0,0.0,0,0,0,0,0,0,0,,0,0,0,0,0,0,0,0,MF,Under 20,Midfielder,Belgium,Europe
1729,Kylian Mbappé,FRA,Paris S-G,Ligue 1,2022,23.0,1998.0,31.3,10,4,0,5,5,5,16,31.3,11,5,0,5,5,15,6,0,FW,20-24,Forward,France,Europe
1730,Mamadou Mbaye,SEN,Cádiz,La Liga,2022,24.0,1998.0,8.4,10,7,7,3,0,6,8,75.0,2,10,8,2,7,17,50,1,DF,20-24,Defender,Senegal,Africa
1731,Chancel Mbemba,COD,Marseille,Ligue 1,2022,27.0,1994.0,31.7,43,26,24,17,2,22,31,71.0,9,25,12,13,42,85,89,0,DF,25-29,Defender,DR Congo,Africa
1732,Bryan Mbeumo,CMR,Brentford,Premier League,2022,22.0,1999.0,32.3,26,18,5,13,8,8,42,19.0,34,24,1,23,13,39,21,0,FW,20-24,Forward,Cameroon,Africa
1733,Jason Mbock,FRA,Angers,Ligue 1,2022,22.0,1999.0,0.3,0,0,0,0,0,0,0,,0,0,0,0,0,0,0,0,"MF,FW",20-24,Midfielder,France,Europe
1734,Jean-Manuel Mbom,GER,Werder Bremen,Bundesliga,2022,22.0,2000.0,0.1,0,0,0,0,0,0,1,0.0,1,0,0,0,0,0,0,0,MF,20-24,Midfielder,Germany,Europe
1735,Nathanael Mbuku,COD,Reims,Ligue 1,2022,20.0,2002.0,0.7,2,1,2,0,0,2,2,100.0,0,0,0,0,0,2,0,0,"FW,MF",20-24,Forward,DR Congo,Africa
1736,Nathanael Mbuku,COD,Augsburg,Bundesliga,2022,20.0,2002.0,0.4,1,0,0,1,0,0,0,,0,0,0,0,0,1,0,0,"MF,FW",20-24,Midfielder,DR Congo,Africa
1737,James McArthur,SCO,Crystal Palace,Premier League,2022,34.0,1987.0,0.6,1,1,1,0,0,1,1,100.0,0,2,1,1,1,2,2,0,MF,30-34,Midfielder,Scotland,Europe
1738,Alex McCarthy,ENG,Southampton,Premier League,2022,32.0,1989.0,6.0,0,0,0,0,0,0,1,0.0,1,0,0,0,1,1,3,1,GK,30-34,Goalkeeper,England,Europe
1739,John McGinn,SCO,Aston Villa,Premier League,2022,27.0,1994.0,29.9,66,36,27,29,10,34,71,47.9,37,43,4,39,24,90,19,0,"MF,FW",25-29,Midfielder,Scotland,Europe
1740,Scott McKenna,SCO,Nott'ham Forest,Premier League,2022,25.0,1996.0,17.5,12,7,7,3,2,6,10,60.0,4,20,14,6,12,24,85,1,DF,25-29,Defender,Scotland,Europe
1741,Weston McKennie,USA,Leeds United,Premier League,2022,23.0,1998.0,16.0,30,13,5,18,7,10,29,34.5,19,22,3,19,22,52,26,0,MF,20-24,Midfielder,United States,North America
1742,Weston McKennie,USA,Juventus,Serie A,2022,23.0,1998.0,11.7,14,5,3,9,2,5,8,62.5,3,15,4,11,11,25,15,1,"MF,DF",20-24,Midfielder,United States,North America
1743,Dwight McNeil,ENG,Everton,Premier League,2022,22.0,1999.0,27.8,64,41,35,14,15,27,65,41.5,38,46,7,39,31,95,41,0,"FW,MF",20-24,Forward,England,Europe
1744,Scott McTominay,SCO,Manchester Utd,Premier League,2022,25.0,1996.0,12.9,32,19,16,10,6,13,22,59.1,9,15,6,9,14,46,45,1,MF,25-29,Midfielder,Scotland,Europe
1745,Gary Medel,CHI,Bologna,Serie A,2022,34.0,1987.0,16.4,25,15,16,7,2,9,16,56.3,7,17,10,7,28,53,34,0,"MF,DF",30-34,Midfielder,Chile,South America
1746,Facundo Medina,ARG,Lens,Ligue 1,2022,23.0,1999.0,30.9,31,20,16,15,0,13,35,37.1,22,25,9,16,26,57,62,1,DF,20-24,Defender,Argentina,South America
1748,Ben Mee,ENG,Brentford,Premier League,2022,32.0,1989.0,36.3,45,24,28,13,4,20,37,54.1,17,54,42,12,48,93,122,2,DF,30-34,Defender,England,Europe
1749,Bamo Meïté,CIV,Lorient,Ligue 1,2022,20.0,2001.0,16.7,18,8,13,4,1,7,16,43.8,9,33,23,10,16,34,70,0,DF,20-24,Defender,Ivory Coast,Africa
1750,Soualiho Meïté,FRA,Cremonese,Serie A,2022,28.0,1994.0,26.3,47,31,25,15,7,22,46,47.8,24,27,6,21,27,74,36,0,MF,25-29,Midfielder,France,Europe
1751,Farid El Melali,ALG,Angers,Ligue 1,2022,25.0,1997.0,9.0,21,12,7,12,2,11,22,50.0,11,16,0,16,8,29,7,0,"DF,FW",25-29,Defender,Algeria,Africa
1754,Memphis,NED,Atlético Madrid,La Liga,2022,28.0,1994.0,3.0,1,0,0,0,1,0,1,0.0,1,0,0,0,0,1,0,0,FW,25-29,Forward,Netherlands,Europe
1755,Memphis,NED,Barcelona,La Liga,2022,28.0,1994.0,1.3,1,1,1,0,0,0,1,0.0,1,0,0,0,0,1,0,0,FW,25-29,Forward,Netherlands,Europe
1756,Houboulang Mendes,GNB,Almería,La Liga,2022,24.0,1998.0,9.8,19,11,16,3,0,11,27,40.7,16,12,2,10,7,26,23,1,DF,20-24,Defender,Guinea-Bissau,Africa
1757,Nuno Mendes,POR,Paris S-G,Ligue 1,2022,20.0,2002.0,17.2,45,30,29,12,4,30,41,73.2,11,19,3,16,17,62,18,0,DF,20-24,Defender,Portugal,Europe
1758,Pedro Mendes,POR,Montpellier,Ligue 1,2022,31.0,1990.0,0.1,0,0,0,0,0,0,0,,0,0,0,0,0,0,0,1,DF,30-34,Defender,Portugal,Europe
1758,Pedro Mendes,POR,Montpellier,Ligue 1,2022,31.0,1990.0,0.1,0,0,0,0,0,0,0,,0,0,0,0,0,0,0,1,DF,30-34,Defender,Portugal,Europe
1758,Pedro Mendes,POR,Montpellier,Ligue 1,2022,31.0,1990.0,0.1,0,0,0,0,0,0,0,,0,0,0,0,0,0,0,1,DF,30-34,Defender,Portugal,Europe
1758,Pedro Mendes,POR,Montpellier,Ligue 1,2022,31.0,1990.0,0.1,0,0,0,0,0,0,0,,0,0,0,0,0,0,0,1,DF,30-34,Defender,Portugal,Europe
1758,Pedro Mendes,POR,Montpellier,Ligue 1,2022,31.0,1990.0,0.1,0,0,0,0,0,0,0,,0,0,0,0,0,0,0,1,DF,30-34,Defender,Portugal,Europe
1758,Pedro Mendes,POR,Montpellier,Ligue 1,2022,31.0,1990.0,0.1,0,0,0,0,0,0,0,,0,0,0,0,0,0,0,1,DF,30-34,Defender,Portugal,Europe
1758,Pedro Mendes,POR,Montpellier,Ligue 1,2022,31.0,1990.0,0.1,0,0,0,0,0,0,0,,0,0,0,0,0,0,0,1,DF,30-34,Defender,Portugal,Europe
1758,Pedro Mendes,POR,Montpellier,Ligue 1,2022,31.0,1990.0,0.1,0,0,0,0,0,0,0,,0,0,0,0,0,0,0,1,DF,30-34,Defender,Portugal,Europe
1758,Pedro Mendes,POR,Montpellier,Ligue 1,2022,31.0,1990.0,0.1,0,0,0,0,0,0,0,,0,0,0,0,0,0,0,1,DF,30-34,Defender,Portugal,Europe
1759,Thiago Mendes,BRA,Lyon,Ligue 1,2022,30.0,1992.0,22.9,48,27,24,21,3,30,40,75.0,10,28,8,20,47,95,51,4,"MF,DF",30-34,Midfielder,Brazil,South America
1762,Antoine Mendy,FRA,Nice,Ligue 1,2022,18.0,2004.0,5.8,22,13,16,5,1,9,15,60.0,6,6,1,5,2,24,16,0,DF,Under 20,Defender,France,Europe
1763,Arial Mendy,SEN,Clermont Foot,Ligue 1,2022,27.0,1994.0,2.5,4,2,3,0,1,2,2,100.0,0,2,0,2,4,8,4,0,DF,25-29,Defender,Senegal,Africa
1764,Batista Mendy,FRA,Angers,Ligue 1,2022,22.0,2000.0,31.8,70,30,34,28,8,37,53,69.8,16,38,6,32,21,91,29,2,"MF,DF",20-24,Midfielder,France,Europe
1765,Edouard Mendy,SEN,Chelsea,Premier League,2022,30.0,1992.0,9.5,0,0,0,0,0,0,0,,0,0,0,0,0,0,3,3,GK,30-34,Goalkeeper,Senegal,Africa
1766,Ferland Mendy,FRA,Real Madrid,La Liga,2022,27.0,1995.0,15.0,21,12,14,6,1,12,20,60.0,8,7,2,5,14,35,16,0,DF,25-29,Defender,France,Europe
1767,Nampalys Mendy,SEN,Leicester City,Premier League,2022,30.0,1992.0,8.4,13,9,7,6,0,8,15,53.3,7,20,4,16,13,26,2,0,MF,30-34,Midfielder,Senegal,Africa
1768,Gideon Mensah,GHA,Auxerre,Ligue 1,2022,24.0,1998.0,25.1,80,44,43,32,5,44,77,57.1,33,33,10,23,38,118,41,0,DF,20-24,Defender,Ghana,Africa
1769,Chris Mepham,WAL,Bournemouth,Premier League,2022,24.0,1997.0,24.4,45,22,37,8,0,19,30,63.3,11,40,27,13,30,75,152,0,DF,20-24,Defender,Wales,Europe
1771,Alex Meret,ITA,Napoli,Serie A,2022,25.0,1997.0,34.0,0,0,0,0,0,0,0,,0,0,0,0,0,0,6,1,GK,25-29,Goalkeeper,Italy,Europe
1773,Quentin Merlin,FRA,Nantes,Ligue 1,2022,20.0,2002.0,19.9,31,19,19,8,4,18,38,47.4,20,27,4,23,24,55,30,0,DF,20-24,Defender,France,Europe
1774,Yıldırım Mert Çetin,TUR,Lecce,Serie A,2022,25.0,1997.0,0.2,1,0,1,0,0,0,0,,0,0,0,0,1,2,1,0,DF,25-29,Defender,Turkey,Asia
1776,Illan Meslier,FRA,Leeds United,Premier League,2022,22.0,2000.0,34.0,2,1,2,0,0,2,4,50.0,2,0,0,0,1,3,30,3,GK,20-24,Goalkeeper,France,Europe
1777,Lionel Messi,ARG,Paris S-G,Ligue 1,2022,35.0,1987.0,31.5,26,18,1,13,12,11,27,40.7,16,11,0,11,2,28,0,0,"FW,MF",35-39,Forward,Argentina,South America
1778,Junior Messias,BRA,Milan,Serie A,2022,31.0,1991.0,16.6,24,18,9,9,6,5,19,26.3,14,20,4,16,7,31,28,0,"FW,DF",30-34,Forward,Brazil,South America
1779,Amine Messoussa,FRA,Lille,Ligue 1,2022,17.0,2004.0,0.0,0,0,0,0,0,0,0,,0,0,0,0,0,0,0,0,FW,Under 20,Forward,France,Europe
1780,Thomas Meunier,BEL,Dortmund,Bundesliga,2022,30.0,1991.0,6.5,16,7,8,5,3,10,17,58.8,7,7,2,5,9,25,16,0,DF,30-34,Defender,Belgium,Europe
1781,Alexander Meyer,GER,Dortmund,Bundesliga,2022,31.0,1991.0,7.0,0,0,0,0,0,0,1,0.0,1,0,0,0,0,0,1,0,GK,30-34,Goalkeeper,Germany,Europe
1782,Sven Michel,GER,Union Berlin,Bundesliga,2022,32.0,1990.0,5.5,9,5,1,5,3,4,8,50.0,4,5,1,4,0,9,4,0,"FW,MF",30-34,Forward,Germany,Europe
1783,Alex Mighten,ENG,Nott'ham Forest,Premier League,2022,20.0,2002.0,0.1,0,0,0,0,0,0,1,0.0,1,0,0,0,0,0,0,0,FW,20-24,Forward,England,Europe
1784,Tommaso Milanese,ITA,Cremonese,Serie A,2022,20.0,2002.0,0.3,0,0,0,0,0,0,0,,0,1,1,0,0,0,0,0,MF,20-24,Midfielder,Italy,Europe
1786,Lewis Miley,ENG,Newcastle Utd,Premier League,2022,16.0,2006.0,0.2,0,0,0,0,0,0,0,,0,1,0,1,0,0,0,0,MF,Under 20,Midfielder,England,Europe
1791,Éder Militão,BRA,Real Madrid,La Liga,2022,24.0,1998.0,30.0,46,32,25,18,3,26,33,78.8,7,67,39,28,42,88,104,2,DF,20-24,Defender,Brazil,South America
1795,Enzo Millot,FRA,Stuttgart,Bundesliga,2022,20.0,2002.0,9.9,23,16,9,10,4,12,19,63.2,7,20,3,17,12,35,7,0,MF,20-24,Midfielder,France,Europe
1796,James Milner,ENG,Liverpool,Premier League,2022,36.0,1986.0,10.1,26,16,11,11,4,15,34,44.1,19,14,2,12,12,38,15,0,"MF,DF",35-39,Midfielder,England,Europe
1798,Kim Min-jae,KOR,Napoli,Serie A,2022,25.0,1996.0,33.9,55,30,32,22,1,25,29,86.2,4,36,26,10,41,96,123,1,DF,25-29,Defender,South Korea,Asia
1799,Yerry Mina,COL,Everton,Premier League,2022,27.0,1994.0,6.6,15,8,9,6,0,9,11,81.8,2,7,4,3,6,21,28,0,DF,25-29,Defender,Colombia,South America
1800,Takumi Minamino,JPN,Monaco,Ligue 1,2022,27.0,1995.0,8.0,15,8,5,7,3,7,35,20.0,28,14,0,14,6,21,4,0,"MF,FW",25-29,Midfielder,Japan,Asia
1801,Tyrone Mings,ENG,Aston Villa,Premier League,2022,29.0,1993.0,35.0,15,7,10,5,0,9,20,45.0,11,40,21,19,54,69,163,2,DF,25-29,Defender,England,Europe
1804,Aleksei Miranchuk,RUS,Torino,Serie A,2022,26.0,1995.0,23.2,11,5,3,4,4,3,11,27.3,8,11,0,11,2,13,5,0,MF,25-29,Midfielder,Russia,Europe
1806,Antonio Mirante,ITA,Milan,Serie A,2022,39.0,1983.0,0.0,0,0,0,0,0,0,0,,0,0,0,0,0,0,0,0,GK,35-39,Goalkeeper,Italy,Europe
1807,Fabio Miretti,ITA,Juventus,Serie A,2022,18.0,2003.0,13.7,24,11,15,6,3,12,29,41.4,17,20,1,19,4,28,11,0,"MF,FW",Under 20,Midfielder,Italy,Europe
1808,Filippo Missori,ITA,Roma,Serie A,2022,18.0,2004.0,2.0,4,3,3,0,1,3,6,50.0,3,0,0,0,3,7,5,0,DF,Under 20,Defender,Italy,Europe
1809,Tyrick Mitchell,ENG,Crystal Palace,Premier League,2022,22.0,1999.0,32.1,71,49,43,23,5,30,53,56.6,23,48,11,37,42,113,78,0,DF,20-24,Defender,England,Europe
1810,Kaoru Mitoma,JPN,Brighton,Premier League,2022,25.0,1997.0,25.8,44,27,15,16,13,20,41,48.8,21,25,0,25,17,61,10,0,"FW,MF",25-29,Forward,Japan,Asia
1813,Maximilian Mittelstädt,GER,Hertha BSC,Bundesliga,2022,25.0,1997.0,9.4,39,20,31,6,2,17,39,43.6,22,13,2,11,26,65,27,0,"DF,MF",25-29,Defender,Germany,Europe
1814,Henrikh Mkhitaryan,ARM,Inter,Serie A,2022,33.0,1989.0,22.1,41,26,13,22,6,14,41,34.1,27,27,4,23,21,62,18,0,MF,30-34,Midfielder,Armenia,Asia
1815,Anthony Modeste,FRA,Dortmund,Bundesliga,2022,34.0,1988.0,9.0,4,4,2,0,2,2,5,40.0,3,7,0,7,2,6,22,0,FW,30-34,Forward,France,Europe
1816,Luka Modrić,CRO,Real Madrid,La Liga,2022,36.0,1985.0,19.4,19,9,6,6,7,10,25,40.0,15,15,5,10,10,29,7,0,MF,35-39,Midfielder,Croatia,Europe
1817,Terem Moffi,NGA,Nice,Ligue 1,2022,23.0,1999.0,14.8,12,6,0,6,6,2,12,16.7,10,3,0,3,2,14,5,0,FW,20-24,Forward,Nigeria,Africa
1818,Terem Moffi,NGA,Lorient,Ligue 1,2022,23.0,1999.0,15.4,8,5,1,4,3,3,5,60.0,2,11,3,8,3,11,10,0,FW,20-24,Forward,Nigeria,Africa
1819,Mostafa Mohamed,EGY,Nantes,Ligue 1,2022,24.0,1997.0,21.5,18,13,5,7,6,9,20,45.0,11,23,1,22,10,28,33,0,FW,20-24,Forward,Egypt,Africa
1820,Tobias Mohr,GER,Schalke 04,Bundesliga,2022,26.0,1995.0,9.3,8,5,3,5,0,2,7,28.6,5,14,5,9,8,16,19,0,"DF,MF",25-29,Defender,Germany,Europe
1821,Johan Mojica,COL,Villarreal,La Liga,2022,29.0,1992.0,7.1,13,9,9,3,1,5,9,55.6,4,8,3,5,4,17,14,1,DF,25-29,Defender,Colombia,South America
1822,Johan Mojica,COL,Elche,La Liga,2022,29.0,1992.0,3.0,6,3,5,1,0,2,3,66.7,1,3,2,1,4,10,5,0,"DF,MF",25-29,Defender,Colombia,South America
1823,Clinton Mola,ENG,Stuttgart,Bundesliga,2022,21.0,2001.0,0.2,3,1,2,1,0,1,1,100.0,0,1,1,0,1,4,2,0,DF,20-24,Defender,England,Europe
1824,Nahuel Molina,ARG,Atlético Madrid,La Liga,2022,24.0,1998.0,31.9,69,43,38,18,13,39,91,42.9,52,38,7,31,18,87,63,1,DF,20-24,Defender,Argentina,South America
1825,Salvatore Molina,ITA,Monza,Serie A,2022,30.0,1992.0,2.5,6,5,2,4,0,4,5,80.0,1,4,2,2,1,7,2,0,DF,30-34,Defender,Italy,Europe
1826,Florent Mollet,FRA,Nantes,Ligue 1,2022,30.0,1991.0,12.1,14,6,5,4,5,7,24,29.2,17,12,1,11,10,24,11,0,MF,30-34,Midfielder,France,Europe
1827,Florent Mollet,FRA,Schalke 04,Bundesliga,2022,30.0,1991.0,4.6,4,1,0,4,0,2,7,28.6,5,7,1,6,1,5,1,0,MF,30-34,Midfielder,France,Europe
1830,César Montes,MEX,Espanyol,La Liga,2022,25.0,1997.0,17.7,17,9,10,7,0,10,18,55.6,8,19,12,7,14,31,101,0,DF,25-29,Defender,Mexico,North America
1831,Daniele Montevago,ITA,Sampdoria,Serie A,2022,19.0,2003.0,2.6,1,0,0,0,1,0,1,0.0,1,2,1,1,0,1,1,0,FW,Under 20,Forward,Italy,Europe
1832,Gonzalo Montiel,ARG,Sevilla,La Liga,2022,25.0,1997.0,16.9,26,15,12,14,0,15,29,51.7,14,25,7,18,19,45,38,0,DF,25-29,Defender,Argentina,South America
1833,Lorenzo Montipò,ITA,Hellas Verona,Serie A,2022,26.0,1996.0,37.0,1,0,1,0,0,0,3,0.0,3,1,0,1,0,1,26,3,GK,25-29,Goalkeeper,Italy,Europe
1835,Kieffer Moore,WAL,Bournemouth,Premier League,2022,29.0,1992.0,14.2,14,11,2,9,3,5,16,31.3,11,12,5,7,1,15,26,0,FW,25-29,Forward,Wales,Europe
1836,Andrew Moran,IRL,Brighton,Premier League,2022,18.0,2003.0,0.1,0,0,0,0,0,0,0,,0,1,0,1,0,0,0,0,FW,Under 20,Forward,Republic of Ireland,Europe
1844,Marlos Moreno,COL,Troyes,Ligue 1,2022,25.0,1996.0,0.1,2,2,2,0,0,2,3,66.7,1,1,1,0,0,2,0,0,"MF,DF",25-29,Midfielder,Colombia,South America
1846,Ilaix Moriba,GUI,Valencia,La Liga,2022,19.0,2003.0,11.2,35,16,14,17,4,14,24,58.3,10,11,1,10,4,39,12,0,MF,Under 20,Midfielder,Guinea,Africa
1849,Nikola Moro,CRO,Bologna,Serie A,2022,24.0,1998.0,13.6,32,21,11,15,6,14,36,38.9,22,15,2,13,8,40,18,0,MF,20-24,Midfielder,Croatia,Europe
1852,Dany Mota,POR,Monza,Serie A,2022,24.0,1998.0,21.2,8,7,1,3,4,2,10,20.0,8,5,1,4,6,14,25,0,"FW,MF",20-24,Forward,Portugal,Europe
1853,Lebo Mothiba,RSA,Strasbourg,Ligue 1,2022,26.0,1996.0,4.8,1,0,1,0,0,0,1,0.0,1,6,1,5,0,1,4,0,"FW,MF",25-29,Forward,South Africa,Africa
1854,Youssoufa Moukoko,GER,Dortmund,Bundesliga,2022,17.0,2004.0,12.7,13,7,3,6,4,3,6,50.0,3,9,0,9,2,15,1,0,FW,Under 20,Forward,Germany,Europe
1855,Steve Mounié,BEN,Brest,Ligue 1,2022,27.0,1994.0,18.4,13,5,1,7,5,5,14,35.7,9,18,7,11,3,16,20,0,FW,25-29,Forward,Benin,Africa
1856,Mason Mount,ENG,Chelsea,Premier League,2022,23.0,1999.0,18.3,33,19,6,16,11,14,27,51.9,13,24,6,18,8,41,9,0,"MF,FW",20-24,Midfielder,England,Europe
1857,Lucas Moura,BRA,Tottenham,Premier League,2022,29.0,1992.0,1.7,8,5,1,3,4,1,4,25.0,3,0,0,0,2,10,1,1,"MF,DF",25-29,Midfielder,Brazil,South America
1858,Bevic Moussiti-Oko,CGO,Ajaccio,Ligue 1,2022,27.0,1995.0,7.8,3,1,1,1,1,1,2,50.0,1,5,3,2,2,5,8,0,FW,25-29,Forward,Congo,Africa
1859,João Moutinho,POR,Wolves,Premier League,2022,35.0,1986.0,19.8,51,30,24,21,6,19,46,41.3,27,22,6,16,18,69,20,0,MF,35-39,Midfielder,Portugal,Europe
1859,João Moutinho,POR,Wolves,Premier League,2022,35.0,1986.0,19.8,51,30,24,21,6,19,46,41.3,27,22,6,16,18,69,20,0,MF,35-39,Midfielder,Portugal,Europe
1859,João Moutinho,POR,Wolves,Premier League,2022,35.0,1986.0,19.8,51,30,24,21,6,19,46,41.3,27,22,6,16,18,69,20,0,MF,35-39,Midfielder,Portugal,Europe
1859,João Moutinho,POR,Wolves,Premier League,2022,35.0,1986.0,19.8,51,30,24,21,6,19,46,41.3,27,22,6,16,18,69,20,0,MF,35-39,Midfielder,Portugal,Europe
1860,João Moutinho,POR,Spezia,Serie A,2022,24.0,1998.0,0.6,7,1,5,1,1,3,4,75.0,1,1,1,0,0,7,0,0,"DF,FW",20-24,Defender,Portugal,Europe
1860,João Moutinho,POR,Spezia,Serie A,2022,24.0,1998.0,0.6,7,1,5,1,1,3,4,75.0,1,1,1,0,0,7,0,0,"DF,FW",20-24,Defender,Portugal,Europe
1860,João Moutinho,POR,Spezia,Serie A,2022,24.0,1998.0,0.6,7,1,5,1,1,3,4,75.0,1,1,1,0,0,7,0,0,"DF,FW",20-24,Defender,Portugal,Europe
1860,João Moutinho,POR,Spezia,Serie A,2022,24.0,1998.0,0.6,7,1,5,1,1,3,4,75.0,1,1,1,0,0,7,0,0,"DF,FW",20-24,Defender,Portugal,Europe
1861,Samuel Moutoussamy,COD,Nantes,Ligue 1,2022,25.0,1996.0,26.7,64,34,27,28,9,26,76,34.2,50,23,2,21,24,88,15,0,MF,25-29,Midfielder,DR Congo,Africa
1862,Divin Mubama,ENG,West Ham,Premier League,2022,17.0,2004.0,0.4,1,1,1,0,0,0,0,,0,0,0,0,0,1,0,0,FW,Under 20,Forward,England,Europe
1863,Mykhailo Mudryk,UKR,Chelsea,Premier League,2022,21.0,2001.0,7.3,11,9,2,4,5,4,13,30.8,9,7,1,6,0,11,3,0,"FW,MF",20-24,Forward,Ukraine,Europe
1864,François Mughe,CMR,Marseille,Ligue 1,2022,18.0,2004.0,0.1,0,0,0,0,0,0,0,,0,0,0,0,0,0,0,0,MF,Under 20,Midfielder,Cameroon,Africa
1865,Nordi Mukiele,FRA,Paris S-G,Ligue 1,2022,24.0,1997.0,12.6,31,23,16,6,9,19,29,65.5,10,22,9,13,14,45,16,0,DF,20-24,Defender,France,Europe
1866,Mert Müldür,TUR,Sassuolo,Serie A,2022,23.0,1999.0,0.1,0,0,0,0,0,0,0,,0,0,0,0,0,0,0,0,"FW,DF",20-24,Forward,Turkey,Asia
1867,Florian Müller,GER,Stuttgart,Bundesliga,2022,24.0,1997.0,19.0,0,0,0,0,0,0,0,,0,0,0,0,0,0,7,4,GK,20-24,Goalkeeper,Germany,Europe
1868,Thomas Müller,GER,Bayern Munich,Bundesliga,2022,32.0,1989.0,18.5,21,12,5,9,7,6,16,37.5,10,19,3,16,4,25,16,0,"FW,MF",30-34,Forward,Germany,Europe
1869,Abdul Mumin,GHA,Rayo Vallecano,La Liga,2022,24.0,1998.0,10.2,11,9,5,6,0,3,7,42.9,4,13,5,8,9,20,36,2,DF,20-24,Defender,Ghana,Africa
1870,Marshall Munetsi,ZIM,Reims,Ligue 1,2022,26.0,1996.0,30.0,58,27,13,31,14,20,48,41.7,28,37,11,26,26,84,41,1,MF,25-29,Midfielder,Zimbabwe,Africa
1875,Luis Muriel,COL,Atalanta,Serie A,2022,31.0,1991.0,11.9,9,6,2,3,4,5,16,31.3,11,9,0,9,2,11,2,0,"FW,MF",30-34,Forward,Colombia,South America
1876,Jeison Murillo,COL,Sampdoria,Serie A,2022,30.0,1992.0,11.7,22,11,16,6,0,17,26,65.4,9,22,14,8,8,30,39,0,DF,30-34,Defender,Colombia,South America
1878,Jacob Murphy,ENG,Newcastle Utd,Premier League,2022,27.0,1995.0,13.9,15,7,3,8,4,8,20,40.0,12,17,0,17,7,22,3,0,FW,25-29,Forward,England,Europe
1879,Nicola Murru,ITA,Sampdoria,Serie A,2022,27.0,1994.0,8.7,24,14,15,8,1,7,13,53.8,6,17,7,10,10,34,21,0,DF,25-29,Defender,Italy,Europe
1880,Yunus Musah,USA,Valencia,La Liga,2022,19.0,2002.0,23.4,48,35,17,23,8,20,30,66.7,10,20,1,19,11,59,16,2,MF,Under 20,Midfielder,United States,North America
1881,Jamal Musiala,GER,Bayern Munich,Bundesliga,2022,19.0,2003.0,24.4,34,23,9,16,9,13,35,37.1,22,30,3,27,19,53,3,0,"MF,FW",Under 20,Midfielder,Germany,Europe
1882,Juan Musso,ARG,Atalanta,Serie A,2022,28.0,1994.0,23.1,1,1,1,0,0,1,1,100.0,0,0,0,0,0,1,11,1,GK,25-29,Goalkeeper,Argentina,South America
1883,Marlon Mustapha,AUT,Mainz 05,Bundesliga,2022,21.0,2001.0,0.8,2,2,0,2,0,0,0,,0,4,0,4,0,2,0,0,"FW,MF",20-24,Forward,Austria,Europe
1884,Yvon Mvogo,SUI,Lorient,Ligue 1,2022,28.0,1994.0,20.1,0,0,0,0,0,0,0,,0,0,0,0,2,2,6,3,GK,25-29,Goalkeeper,Switzerland,Europe
1885,Enock Mwepu,ZAM,Brighton,Premier League,2022,24.0,1998.0,2.4,10,5,1,6,3,3,4,75.0,1,3,1,2,1,11,1,0,"FW,MF",20-24,Forward,Zambia,Africa
1886,Francisco Mwepu,ZAM,Cádiz,La Liga,2022,22.0,2000.0,0.2,1,0,0,1,0,0,0,,0,0,0,0,0,1,0,0,FW,20-24,Forward,Zambia,Africa
1887,Vitaliy Mykolenko,UKR,Everton,Premier League,2022,23.0,1999.0,29.5,58,34,36,19,3,28,51,54.9,23,50,16,34,46,104,99,0,DF,20-24,Defender,Ukraine,Europe
1888,Joakim Mæhle,DEN,Atalanta,Serie A,2022,25.0,1997.0,24.5,32,18,12,7,13,22,39,56.4,17,29,6,23,24,56,26,0,"DF,MF",25-29,Defender,Denmark,Europe
1889,Obite N'Dicka,CIV,Eint Frankfurt,Bundesliga,2022,22.0,1999.0,29.9,25,18,10,11,4,18,32,56.3,14,47,19,28,31,56,150,0,DF,20-24,Defender,Ivory Coast,Africa
1890,Nathan N'Goumou,FRA,Toulouse,Ligue 1,2022,22.0,2000.0,1.0,3,2,2,1,0,1,1,100.0,0,2,0,2,2,5,0,0,FW,20-24,Forward,France,Europe
1891,Nathan N'Goumou,FRA,Gladbach,Bundesliga,2022,22.0,2000.0,7.7,11,5,5,5,1,7,13,53.8,6,9,0,9,1,12,4,0,FW,20-24,Forward,France,Europe
1892,Stanley N'Soki,FRA,Hoffenheim,Bundesliga,2022,23.0,1999.0,14.3,22,13,14,7,1,12,22,54.5,10,22,5,17,24,46,34,0,DF,20-24,Defender,France,Europe
1893,Herculano Nabian,POR,Empoli,Serie A,2022,18.0,2004.0,0.0,0,0,0,0,0,0,0,,0,0,0,0,0,0,0,0,MF,Under 20,Midfielder,Portugal,Europe
1895,Nikolas Nartey,DEN,Stuttgart,Bundesliga,2022,22.0,2000.0,5.3,11,6,7,3,1,5,9,55.6,4,9,0,9,4,15,12,0,"DF,MF",20-24,Defender,Denmark,Europe
1896,Juanjo Narváez,COL,Valladolid,La Liga,2022,27.0,1995.0,1.6,1,1,1,0,0,1,1,100.0,0,2,0,2,0,1,0,0,"MF,FW",25-29,Midfielder,Colombia,South America
1900,Keylor Navas,CRC,Nott'ham Forest,Premier League,2022,35.0,1986.0,17.0,0,0,0,0,0,0,0,,0,0,0,0,1,1,11,2,GK,35-39,Goalkeeper,Costa Rica,North America
1901,Michel Ndary Adopo,FRA,Torino,Serie A,2022,22.0,2000.0,2.9,7,2,4,2,1,1,3,33.3,2,2,2,0,1,8,4,0,"MF,DF",20-24,Midfielder,France,Europe
1903,Papa Ndiaga Yade,MTN,Troyes,Ligue 1,2022,22.0,2000.0,6.3,10,6,6,2,2,7,22,31.8,15,10,2,8,8,18,10,0,"DF,MF",20-24,Defender,Mauritania,Africa
1904,Wilfred Ndidi,NGA,Leicester City,Premier League,2022,25.0,1996.0,18.7,61,42,34,24,3,17,43,39.5,26,32,14,18,38,99,48,3,MF,25-29,Midfielder,Nigeria,Africa
1905,Tanguy Ndombele,FRA,Napoli,Serie A,2022,25.0,1996.0,9.0,14,8,4,8,2,4,7,57.1,3,10,1,9,7,21,7,1,MF,25-29,Midfielder,France,Europe
1907,Reiss Nelson,ENG,Arsenal,Premier League,2022,22.0,1999.0,2.4,4,1,2,1,1,2,4,50.0,2,3,0,3,0,4,4,0,FW,20-24,Forward,England,Europe
1908,Ilija Nestorovski,MKD,Udinese,Serie A,2022,32.0,1990.0,7.1,7,3,2,1,4,5,11,45.5,6,6,1,5,2,9,10,0,"FW,MF",30-34,Forward,North Macedonia,Europe
1909,Neto,BRA,Bournemouth,Premier League,2022,33.0,1989.0,26.5,3,1,3,0,0,3,3,100.0,0,0,0,0,0,3,10,3,GK,30-34,Goalkeeper,Brazil,South America
1909,Neto,BRA,Bournemouth,Premier League,2022,33.0,1989.0,26.5,3,1,3,0,0,3,3,100.0,0,0,0,0,0,3,10,3,GK,30-34,Goalkeeper,Brazil,South America
1909,Neto,BRA,Bournemouth,Premier League,2022,33.0,1989.0,26.5,3,1,3,0,0,3,3,100.0,0,0,0,0,0,3,10,3,GK,30-34,Goalkeeper,Brazil,South America
1909,Neto,BRA,Bournemouth,Premier League,2022,33.0,1989.0,26.5,3,1,3,0,0,3,3,100.0,0,0,0,0,0,3,10,3,GK,30-34,Goalkeeper,Brazil,South America
1909,Neto,BRA,Bournemouth,Premier League,2022,33.0,1989.0,26.5,3,1,3,0,0,3,3,100.0,0,0,0,0,0,3,10,3,GK,30-34,Goalkeeper,Brazil,South America
1909,Neto,BRA,Bournemouth,Premier League,2022,33.0,1989.0,26.5,3,1,3,0,0,3,3,100.0,0,0,0,0,0,3,10,3,GK,30-34,Goalkeeper,Brazil,South America
1909,Neto,BRA,Bournemouth,Premier League,2022,33.0,1989.0,26.5,3,1,3,0,0,3,3,100.0,0,0,0,0,0,3,10,3,GK,30-34,Goalkeeper,Brazil,South America
1909,Neto,BRA,Bournemouth,Premier League,2022,33.0,1989.0,26.5,3,1,3,0,0,3,3,100.0,0,0,0,0,0,3,10,3,GK,30-34,Goalkeeper,Brazil,South America
1909,Neto,BRA,Bournemouth,Premier League,2022,33.0,1989.0,26.5,3,1,3,0,0,3,3,100.0,0,0,0,0,0,3,10,3,GK,30-34,Goalkeeper,Brazil,South America
1910,Pedro Neto,POR,Wolves,Premier League,2022,22.0,2000.0,10.7,11,6,4,2,5,7,17,41.2,10,5,1,4,4,15,4,0,"FW,MF",20-24,Forward,Portugal,Europe
1911,Luca Netz,GER,Gladbach,Bundesliga,2022,19.0,2003.0,7.8,25,13,19,3,3,19,32,59.4,13,5,1,4,6,31,27,0,DF,Under 20,Defender,Germany,Europe
1912,Manuel Neuer,GER,Bayern Munich,Bundesliga,2022,36.0,1986.0,12.0,0,0,0,0,0,0,0,,0,0,0,0,0,0,4,1,GK,35-39,Goalkeeper,Germany,Europe
1913,Florian Neuhaus,GER,Gladbach,Bundesliga,2022,25.0,1997.0,15.6,19,9,9,5,5,8,27,29.6,19,20,3,17,12,31,5,0,MF,25-29,Midfielder,Germany,Europe
1914,Rúben Neves,POR,Wolves,Premier League,2022,25.0,1997.0,33.5,79,43,31,33,15,32,76,42.1,44,59,22,37,50,129,85,1,MF,25-29,Midfielder,Portugal,Europe
1915,Neymar,BRA,Paris S-G,Ligue 1,2022,30.0,1992.0,17.2,22,14,6,9,7,9,19,47.4,10,7,1,6,4,26,1,1,"MF,FW",30-34,Midfielder,Brazil,South America
1916,Jessic Ngankam,GER,Hertha BSC,Bundesliga,2022,22.0,2000.0,9.2,14,9,7,4,3,6,14,42.9,8,6,1,5,1,15,4,0,"FW,MF",20-24,Forward,Germany,Europe
1917,Cyril Ngonge,BEL,Hellas Verona,Serie A,2022,22.0,2000.0,8.3,7,3,2,2,3,3,11,27.3,8,7,0,7,6,13,4,0,"MF,FW",20-24,Midfielder,Belgium,Europe
1918,Moussa Niakhate,SEN,Nott'ham Forest,Premier League,2022,26.0,1996.0,12.9,18,9,15,3,0,11,22,50.0,11,18,8,10,19,37,60,0,DF,25-29,Defender,Senegal,Africa
1919,Ibrahima Niane,SEN,Angers,Ligue 1,2022,23.0,1999.0,12.6,6,2,1,4,1,1,6,16.7,5,8,2,6,1,7,9,0,FW,20-24,Forward,Senegal,Africa
1920,M'Baye Niang,SEN,Auxerre,Ligue 1,2022,27.0,1994.0,16.5,13,7,1,8,4,3,13,23.1,10,22,1,21,1,14,20,0,FW,25-29,Forward,Senegal,Africa
1921,Tanguy Nianzou,FRA,Sevilla,La Liga,2022,20.0,2002.0,15.2,20,15,10,9,1,8,11,72.7,3,8,5,3,16,36,44,3,DF,20-24,Defender,France,Europe
1922,Rasmus Nicolaisen,DEN,Toulouse,Ligue 1,2022,25.0,1997.0,33.3,48,21,34,14,0,29,46,63.0,17,58,45,13,50,98,152,0,DF,25-29,Defender,Denmark,Europe
1923,Hans Nicolussi Caviglia,ITA,Salernitana,Serie A,2022,22.0,2000.0,6.5,15,6,5,8,2,9,15,60.0,6,9,0,9,7,22,7,1,MF,20-24,Midfielder,Italy,Europe
1924,Florian Niederlechner,GER,Augsburg,Bundesliga,2022,31.0,1990.0,10.1,10,5,5,4,1,4,7,57.1,3,16,2,14,1,11,9,0,"FW,MF",30-34,Forward,Germany,Europe
1925,Florian Niederlechner,GER,Hertha BSC,Bundesliga,2022,31.0,1990.0,8.7,9,7,2,4,3,2,8,25.0,6,7,0,7,3,12,10,0,FW,30-34,Forward,Germany,Europe
1927,Dimitris Nikolaou,GRE,Spezia,Serie A,2022,23.0,1998.0,32.9,45,32,31,10,4,25,37,67.6,12,41,26,15,27,72,82,0,DF,20-24,Defender,Greece,Europe
1929,Justin Njinmah,GER,Dortmund,Bundesliga,2022,21.0,2000.0,0.2,0,0,0,0,0,0,0,,0,0,0,0,0,0,0,0,FW,20-24,Forward,Germany,Europe
1930,Eddie Nketiah,ENG,Arsenal,Premier League,2022,23.0,1999.0,12.1,13,9,6,2,5,2,10,20.0,8,7,1,6,1,14,7,0,FW,20-24,Forward,England,Europe
1931,Christopher Nkunku,FRA,RB Leipzig,Bundesliga,2022,24.0,1997.0,21.1,6,4,2,1,3,1,6,16.7,5,8,3,5,8,14,11,0,"FW,MF",20-24,Forward,France,Europe
1932,Felix Nmecha,GER,Wolfsburg,Bundesliga,2022,21.0,2000.0,20.4,41,24,11,23,7,16,34,47.1,18,26,10,16,25,66,31,0,MF,20-24,Midfielder,Germany,Europe
1933,Lukas Nmecha,GER,Wolfsburg,Bundesliga,2022,23.0,1998.0,10.0,5,3,0,2,3,3,3,100.0,0,5,1,4,3,8,4,0,FW,20-24,Forward,Germany,Europe
1934,Arnaud Nordin,FRA,Montpellier,Ligue 1,2022,24.0,1998.0,26.7,26,14,10,12,4,12,28,42.9,16,19,1,18,14,40,7,0,FW,20-24,Forward,France,Europe
1935,Riad Nouri,FRA,Ajaccio,Ligue 1,2022,37.0,1985.0,18.8,21,12,7,10,4,12,29,41.4,17,8,1,7,15,36,11,0,"MF,FW",35-39,Midfielder,France,Europe
1937,Samuel Ntanda,BEL,Sampdoria,Serie A,2022,17.0,2005.0,0.0,0,0,0,0,0,0,0,,0,0,0,0,0,0,0,0,MF,Under 20,Midfielder,Belgium,Europe
1938,Randy Nteka,ANG,Elche,La Liga,2022,24.0,1997.0,8.1,15,10,7,6,2,2,11,18.2,9,15,3,12,4,19,9,0,"FW,MF",20-24,Forward,Angola,Africa
1939,Randy Nteka,ANG,Rayo Vallecano,La Liga,2022,24.0,1997.0,1.3,4,2,2,2,0,1,1,100.0,0,2,0,2,2,6,3,0,"FW,MF",20-24,Forward,Angola,Africa
1940,Alexander Nübel,GER,Monaco,Ligue 1,2022,25.0,1996.0,38.0,0,0,0,0,0,0,1,0.0,1,0,0,0,1,1,10,3,GK,25-29,Goalkeeper,Germany,Europe
1941,Matheus Nunes,POR,Wolves,Premier League,2022,23.0,1998.0,27.4,67,43,36,22,9,28,61,45.9,33,35,4,31,16,83,35,2,MF,20-24,Midfielder,Portugal,Europe
1942,Darwin Núñez,URU,Liverpool,Premier League,2022,23.0,1999.0,18.8,11,5,2,4,5,4,17,23.5,13,10,0,10,3,14,13,0,FW,20-24,Forward,Uruguay,South America
1944,Bram Nuytinck,NED,Udinese,Serie A,2022,32.0,1990.0,4.3,7,4,3,4,0,4,8,50.0,4,6,6,0,5,12,22,0,DF,30-34,Defender,Netherlands,Europe
1945,Bram Nuytinck,NED,Sampdoria,Serie A,2022,32.0,1990.0,16.6,54,38,33,21,0,23,34,67.6,11,36,21,15,23,77,84,0,DF,30-34,Defender,Netherlands,Europe
1946,Ethan Nwaneri,ENG,Arsenal,Premier League,2022,15.0,2007.0,0.0,0,0,0,0,0,0,0,,0,1,0,1,0,0,0,0,FW,Under 20,Forward,England,Europe
1947,Gerzino Nyamsi,FRA,Strasbourg,Ligue 1,2022,25.0,1997.0,17.5,28,20,14,12,2,10,12,83.3,2,19,11,8,10,38,63,1,DF,25-29,Defender,France,Europe
1949,M'Bala Nzola,ANG,Spezia,Serie A,2022,25.0,1996.0,29.5,12,5,0,6,6,3,9,33.3,6,20,6,14,7,19,21,0,FW,25-29,Forward,Angola,Africa
1950,Christian Nørgaard,DEN,Brentford,Premier League,2022,28.0,1994.0,19.6,52,30,21,29,2,18,48,37.5,30,32,9,23,34,86,41,2,MF,25-29,Midfielder,Denmark,Europe
1951,Lewis O'Brien,ENG,Nott'ham Forest,Premier League,2022,23.0,1998.0,6.5,16,9,4,11,1,6,12,50.0,6,13,2,11,5,21,9,0,MF,20-24,Midfielder,England,Europe
1952,Pedro Obiang,EQG,Sassuolo,Serie A,2022,30.0,1992.0,9.7,26,17,12,12,2,10,18,55.6,8,12,2,10,8,34,15,0,MF,30-34,Midfielder,Equatorial Guinea,Africa
1954,Brian Ocampo,URU,Cádiz,La Liga,2022,23.0,1999.0,12.4,18,15,12,5,1,8,21,38.1,13,13,0,13,3,21,3,0,"MF,FW",20-24,Midfielder,Uruguay,South America
1955,Lucas Ocampos,ARG,Sevilla,La Liga,2022,28.0,1994.0,12.9,22,14,9,9,4,8,31,25.8,23,17,2,15,8,30,5,0,"FW,MF",25-29,Forward,Argentina,South America
1956,Guillermo Ochoa,MEX,Salernitana,Serie A,2022,37.0,1985.0,20.0,0,0,0,0,0,0,2,0.0,2,0,0,0,0,0,9,1,GK,35-39,Goalkeeper,Mexico,North America
1957,Wilson Odobert,FRA,Troyes,Ligue 1,2022,17.0,2004.0,19.6,20,14,10,7,3,9,25,36.0,16,11,0,11,15,35,5,0,"MF,FW",Under 20,Midfielder,France,Europe
1959,Tim Oermann,GER,Bochum,Bundesliga,2022,18.0,2003.0,2.2,2,1,2,0,0,1,1,100.0,0,3,2,1,1,3,8,1,DF,Under 20,Defender,Germany,Europe
1960,Odeluga Offiah,ENG,Brighton,Premier League,2022,19.0,2002.0,0.3,1,1,1,0,0,0,2,0.0,2,0,0,0,0,1,1,0,DF,Under 20,Defender,England,Europe
1961,Angelo Ogbonna,ITA,West Ham,Premier League,2022,34.0,1988.0,13.7,11,4,7,4,0,5,10,50.0,5,11,7,4,17,28,74,1,DF,30-34,Defender,Italy,Europe
1962,Florent Ogier,FRA,Clermont Foot,Ligue 1,2022,33.0,1989.0,18.9,33,16,20,12,1,22,39,56.4,17,22,13,9,18,51,64,1,DF,30-34,Defender,France,Europe
1963,Marios Oikonomou,GRE,Sampdoria,Serie A,2022,29.0,1992.0,2.4,3,2,3,0,0,1,3,33.3,2,5,4,1,4,7,13,0,DF,25-29,Defender,Greece,Europe
1964,David Okereke,NGA,Cremonese,Serie A,2022,24.0,1997.0,25.2,12,8,4,5,3,3,16,18.8,13,23,3,20,10,22,12,0,"FW,MF",20-24,Forward,Nigeria,Africa
1965,Caleb Okoli,ITA,Atalanta,Serie A,2022,21.0,2001.0,10.7,21,17,14,6,1,10,25,40.0,15,10,5,5,30,51,44,3,DF,20-24,Defender,Italy,Europe
1967,Lucas Olaza,URU,Valladolid,La Liga,2022,28.0,1994.0,16.6,24,14,12,10,2,17,26,65.4,9,20,8,12,14,38,34,0,DF,25-29,Defender,Uruguay,South America
1968,Finn Ole Becker,GER,Hoffenheim,Bundesliga,2022,22.0,2000.0,5.7,10,2,4,6,0,4,7,57.1,3,4,0,4,5,15,8,0,MF,20-24,Midfielder,Germany,Europe
1969,Mathias Olesen,LUX,Köln,Bundesliga,2022,21.0,2001.0,5.3,10,5,4,4,2,5,8,62.5,3,6,1,5,2,12,3,0,MF,20-24,Midfielder,Luxembourg,Europe
1970,Michael Olise,FRA,Crystal Palace,Premier League,2022,20.0,2001.0,30.5,58,34,28,26,4,25,60,41.7,35,46,1,45,26,84,17,0,"FW,MF",20-24,Forward,France,Europe
1972,Lucas Oliveira Rosa,BRA,Valladolid,La Liga,2022,22.0,2000.0,10.3,39,18,23,10,6,12,20,60.0,8,12,2,10,15,54,24,0,DF,20-24,Defender,Brazil,South America
1973,Mathías Olivera,URU,Napoli,Serie A,2022,24.0,1997.0,18.3,39,23,16,16,7,22,43,51.2,21,28,2,26,22,61,26,0,DF,20-24,Defender,Uruguay,South America
1975,Jan Olschowsky,GER,Gladbach,Bundesliga,2022,20.0,2001.0,4.0,0,0,0,0,0,0,1,0.0,1,1,0,1,0,0,1,0,GK,20-24,Goalkeeper,Germany,Europe
1976,Robin Olsen,SWE,Aston Villa,Premier League,2022,32.0,1990.0,3.1,0,0,0,0,0,0,2,0.0,2,0,0,0,0,0,1,0,GK,30-34,Goalkeeper,Sweden,Europe
1978,Jonas Omlin,SUI,Montpellier,Ligue 1,2022,28.0,1994.0,13.0,1,0,1,0,0,0,0,,0,0,0,0,0,1,8,1,GK,25-29,Goalkeeper,Switzerland,Europe
1979,Jonas Omlin,SUI,Gladbach,Bundesliga,2022,28.0,1994.0,14.3,1,1,1,0,0,1,3,33.3,2,1,0,1,0,1,9,1,GK,25-29,Goalkeeper,Switzerland,Europe
1980,Ado Onaiwu,JPN,Toulouse,Ligue 1,2022,26.0,1995.0,12.0,11,6,4,4,3,5,13,38.5,8,5,1,4,2,13,5,0,FW,25-29,Forward,Japan,Asia
1981,Amadou Onana,BEL,Everton,Premier League,2022,20.0,2001.0,27.6,72,43,24,42,6,30,42,71.4,12,25,6,19,37,109,39,0,MF,20-24,Midfielder,Belgium,Europe
1982,André Onana,CMR,Inter,Serie A,2022,26.0,1996.0,24.0,0,0,0,0,0,0,1,0.0,1,0,0,0,0,0,5,0,GK,25-29,Goalkeeper,Cameroon,Africa
1983,Jean Onana,CMR,Lens,Ligue 1,2022,22.0,2000.0,9.0,28,17,8,17,3,10,22,45.5,12,15,5,10,18,46,20,0,"MF,DF",20-24,Midfielder,Cameroon,Africa
1984,Karim Onisiwo,AUT,Mainz 05,Bundesliga,2022,30.0,1992.0,28.2,19,12,3,10,6,4,21,19.0,17,19,0,19,2,21,7,0,"FW,MF",30-34,Forward,Austria,Europe
1985,Josh Onomah,ENG,Fulham,Premier League,2022,25.0,1997.0,0.2,1,0,1,0,0,0,0,,0,1,0,1,0,1,0,0,MF,25-29,Midfielder,England,Europe
1986,Paul Onuachu,NGA,Southampton,Premier League,2022,28.0,1994.0,4.5,3,2,1,1,1,1,3,33.3,2,4,1,3,0,3,4,0,FW,25-29,Forward,Nigeria,Africa
1987,Frank Onyeka,NGA,Brentford,Premier League,2022,24.0,1998.0,9.4,19,14,11,7,1,10,24,41.7,14,16,3,13,10,29,16,0,MF,20-24,Midfielder,Nigeria,Africa
1988,Loïs Openda,BEL,Lens,Ligue 1,2022,22.0,2000.0,28.0,11,9,2,6,3,2,13,15.4,11,9,0,9,2,13,6,0,FW,20-24,Forward,Belgium,Europe
1989,Willi Orban,HUN,RB Leipzig,Bundesliga,2022,29.0,1992.0,32.8,51,30,33,18,0,26,43,60.5,17,42,24,18,39,90,129,1,DF,25-29,Defender,Hungary,Europe
1990,Ivan Ordets,UKR,Bochum,Bundesliga,2022,30.0,1992.0,27.2,31,19,21,9,1,16,28,57.1,12,34,17,17,57,88,139,0,DF,30-34,Defender,Ukraine,Europe
1991,Divock Origi,BEL,Milan,Serie A,2022,27.0,1995.0,11.4,10,5,4,3,3,5,10,50.0,5,6,2,4,0,10,13,0,FW,25-29,Forward,Belgium,Europe
1993,Mislav Oršić,CRO,Southampton,Premier League,2022,29.0,1992.0,0.1,1,1,1,0,0,0,0,,0,0,0,0,0,1,0,0,MF,25-29,Midfielder,Croatia,Europe
1994,Riccardo Orsolini,ITA,Bologna,Serie A,2022,25.0,1997.0,23.6,30,19,15,10,5,17,41,41.5,24,29,3,26,8,38,18,0,FW,25-29,Forward,Italy,Europe
1995,Stefan Ortega,GER,Manchester City,Premier League,2022,29.0,1992.0,3.0,0,0,0,0,0,0,0,,0,0,0,0,0,0,0,0,GK,25-29,Goalkeeper,Germany,Europe
1997,Jordi Osei-Tutu,ENG,Bochum,Bundesliga,2022,23.0,1998.0,8.3,23,18,13,5,5,12,23,52.2,11,12,5,7,10,33,8,0,"DF,FW",20-24,Defender,England,Europe
1998,Victor Osimhen,NGA,Napoli,Serie A,2022,23.0,1998.0,28.5,10,6,1,2,7,0,7,0.0,7,6,1,5,6,16,29,0,FW,20-24,Forward,Nigeria,Africa
1999,Patrick Osterhage,GER,Bochum,Bundesliga,2022,22.0,2000.0,11.4,20,17,8,10,2,11,16,68.8,5,17,6,11,12,32,25,0,MF,20-24,Midfielder,Germany,Europe
2000,Paulo Otávio,BRA,Wolfsburg,Bundesliga,2022,27.0,1994.0,22.7,72,46,46,17,9,44,66,66.7,22,42,6,36,30,102,70,1,DF,25-29,Defender,Brazil,South America
2001,Dango Ouattara,BFA,Bournemouth,Premier League,2022,20.0,2002.0,13.8,28,15,20,6,2,13,32,40.6,19,20,3,17,13,41,29,1,"MF,FW",20-24,Midfielder,Burkina Faso,Africa
2002,Dango Ouattara,BFA,Lorient,Ligue 1,2022,20.0,2002.0,17.2,41,26,20,11,10,15,28,53.6,13,24,6,18,19,60,21,0,"FW,MF",20-24,Forward,Burkina Faso,Africa
2003,Remi Oudin,FRA,Lecce,Serie A,2022,25.0,1996.0,14.7,25,13,9,12,4,10,23,43.5,13,16,2,14,29,54,23,0,"FW,MF",25-29,Forward,France,Europe
2004,Zinédine Ould Khaled,FRA,Angers,Ligue 1,2022,22.0,2000.0,0.6,1,1,0,1,0,0,1,0.0,1,0,0,0,2,3,0,0,"MF,FW",20-24,Midfielder,France,Europe
2005,Azzedine Ounahi,MAR,Marseille,Ligue 1,2022,22.0,2000.0,1.3,2,1,1,1,0,0,2,0.0,2,1,0,1,0,2,0,0,"MF,FW",20-24,Midfielder,Morocco,Africa
2006,Azzedine Ounahi,MAR,Angers,Ligue 1,2022,22.0,2000.0,12.5,19,8,5,13,1,10,20,50.0,10,8,0,8,15,34,4,1,"MF,FW",20-24,Midfielder,Morocco,Africa
2007,Adam Ounas,ALG,Napoli,Serie A,2022,25.0,1996.0,0.2,0,0,0,0,0,0,0,,0,0,0,0,1,1,0,0,FW,25-29,Forward,Algeria,Africa
2008,Adam Ounas,ALG,Lille,Ligue 1,2022,25.0,1996.0,11.8,20,11,4,10,6,8,13,61.5,5,16,0,16,7,27,5,0,"FW,MF",25-29,Forward,Algeria,Africa
2009,Thomas Ouwejan,NED,Schalke 04,Bundesliga,2022,25.0,1996.0,10.0,20,8,13,5,2,6,10,60.0,4,17,4,13,13,33,27,0,DF,25-29,Defender,Netherlands,Europe
2010,Reece Oxford,ENG,Augsburg,Bundesliga,2022,23.0,1998.0,1.0,1,1,1,0,0,0,0,,0,4,3,1,1,2,5,0,DF,20-24,Defender,England,Europe
2011,Alex Oxlade-Chamberlain,ENG,Liverpool,Premier League,2022,28.0,1993.0,3.7,5,4,1,2,2,1,5,20.0,4,5,2,3,1,6,4,0,"FW,MF",25-29,Forward,England,Europe
2013,Salih Özcan,TUR,Dortmund,Bundesliga,2022,24.0,1998.0,17.5,31,18,10,16,5,16,39,41.0,23,24,2,22,28,59,19,1,MF,20-24,Midfielder,Turkey,Asia
2014,Cenk Özkacar,TUR,Valencia,La Liga,2022,21.0,2000.0,15.2,27,20,17,10,0,14,19,73.7,5,14,2,12,12,39,47,4,DF,20-24,Defender,Turkey,Asia
2015,David Ozoh,ENG,Crystal Palace,Premier League,2022,17.0,2005.0,0.0,0,0,0,0,0,0,0,,0,0,0,0,0,0,0,0,FW,Under 20,Forward,England,Europe
2016,Levin Öztunalı,GER,Union Berlin,Bundesliga,2022,26.0,1996.0,0.1,0,0,0,0,0,0,1,0.0,1,0,0,0,0,0,0,0,MF,25-29,Midfielder,Germany,Europe
2020,Gonçalo Paciência,POR,Celta Vigo,La Liga,2022,27.0,1994.0,7.4,8,5,0,5,3,2,7,28.6,5,9,1,8,0,8,4,0,"FW,MF",25-29,Forward,Portugal,Europe
2021,Simone Pafundi,ITA,Udinese,Serie A,2022,16.0,2006.0,0.9,8,5,1,5,2,2,4,50.0,2,0,0,0,1,9,0,0,"MF,FW",Under 20,Midfielder,Italy,Europe
2022,Exequiel Palacios,ARG,Leverkusen,Bundesliga,2022,23.0,1998.0,18.4,59,36,20,33,6,29,48,60.4,19,29,2,27,33,92,28,0,MF,20-24,Midfielder,Argentina,South America
2023,Helibelton Palacios,COL,Elche,La Liga,2022,29.0,1993.0,21.3,38,20,21,15,2,19,26,73.1,7,26,12,14,20,58,55,0,DF,25-29,Defender,Colombia,South America
2024,Ante Palaversa,CRO,Troyes,Ligue 1,2022,22.0,2000.0,0.3,1,1,1,0,0,0,0,,0,0,0,0,1,2,0,0,MF,20-24,Midfielder,Croatia,Europe
2026,João Palhinha,POR,Fulham,Premier League,2022,27.0,1995.0,34.5,148,83,59,65,24,71,135,52.6,64,48,5,43,46,194,61,2,MF,25-29,Midfielder,Portugal,Europe
2027,Nicolas Pallois,FRA,Nantes,Ligue 1,2022,34.0,1987.0,24.6,69,44,51,16,2,42,70,60.0,28,35,18,17,30,99,131,2,DF,30-34,Defender,France,Europe
2028,Cole Palmer,ENG,Manchester City,Premier League,2022,20.0,2002.0,4.1,5,1,0,3,2,3,5,60.0,2,2,1,1,1,6,2,0,"MF,FW",20-24,Midfielder,England,Europe
2029,Erik Palmer-Brown,USA,Troyes,Ligue 1,2022,25.0,1997.0,35.5,42,27,31,10,1,18,33,54.5,15,56,29,27,26,68,166,1,DF,25-29,Defender,United States,North America
2030,Emerson Palmieri,ITA,West Ham,Premier League,2022,27.0,1994.0,14.7,26,14,9,15,2,12,24,50.0,12,17,4,13,15,41,36,0,DF,25-29,Defender,Italy,Europe
2032,Flavio Paoletti,ITA,Sampdoria,Serie A,2022,19.0,2003.0,3.2,2,2,0,2,0,1,5,20.0,4,1,0,1,5,7,9,0,MF,Under 20,Midfielder,Italy,Europe
2033,Antonios Papadopoulos,GER,Dortmund,Bundesliga,2022,22.0,1999.0,0.1,0,0,0,0,0,0,0,,0,0,0,0,1,1,0,0,DF,20-24,Defender,Germany,Europe
2034,Lucas Paquetá,BRA,West Ham,Premier League,2022,24.0,1997.0,23.9,71,53,23,36,12,27,68,39.7,41,41,4,37,16,87,31,0,MF,20-24,Midfielder,Brazil,South America
2035,Lucas Paquetá,BRA,Lyon,Ligue 1,2022,24.0,1997.0,1.8,5,4,0,5,0,1,3,33.3,2,2,0,2,1,6,3,0,MF,20-24,Midfielder,Brazil,South America
2037,Kevin Paredes,USA,Wolfsburg,Bundesliga,2022,19.0,2003.0,5.9,13,9,6,3,4,9,12,75.0,3,7,0,7,6,19,8,0,"FW,MF",Under 20,Forward,United States,North America
2038,Leandro Paredes,ARG,Juventus,Serie A,2022,28.0,1994.0,10.9,19,13,7,11,1,10,22,45.5,12,8,0,8,17,36,22,0,MF,25-29,Midfielder,Argentina,South America
2039,Leandro Paredes,ARG,Paris S-G,Ligue 1,2022,28.0,1994.0,0.6,1,1,1,0,0,1,1,100.0,0,2,1,1,1,2,0,0,MF,25-29,Midfielder,Argentina,South America
2041,Fabiano Parisi,ITA,Empoli,Serie A,2022,21.0,2000.0,31.4,65,35,37,21,7,30,72,41.7,42,51,16,35,41,106,91,0,DF,20-24,Defender,Italy,Europe
2044,Thomas Partey,GHA,Arsenal,Premier League,2022,29.0,1993.0,27.6,70,40,20,35,15,25,52,48.1,27,26,5,21,28,98,41,1,MF,25-29,Midfielder,Ghana,Africa
2045,Marco Pašalić,CRO,Dortmund,Bundesliga,2022,21.0,2000.0,0.1,0,0,0,0,0,0,0,,0,0,0,0,0,0,0,0,MF,20-24,Midfielder,Croatia,Europe
2046,Mario Pašalić,CRO,Atalanta,Serie A,2022,27.0,1995.0,19.7,22,10,6,14,2,6,23,26.1,17,22,4,18,21,43,13,0,"MF,FW",25-29,Midfielder,Croatia,Europe
2048,Felix Passlack,GER,Dortmund,Bundesliga,2022,24.0,1998.0,0.7,4,3,0,4,0,1,1,100.0,0,1,1,0,0,4,1,0,DF,20-24,Defender,Germany,Europe
17,Álvaro Aceves,ESP,Valladolid,La Liga,2022,19.0,2003.0,0.1,0,0,0,0,0,0,0,,0,0,0,0,0,0,0,0,GK,Under 20,Goalkeeper,Spain,Europe
31,Julen Agirrezabala,ESP,Athletic Club,La Liga,2022,21.0,2000.0,7.5,0,0,0,0,0,0,0,,0,0,0,0,0,0,2,0,GK,20-24,Goalkeeper,Spain,Europe
34,Álvaro Aguado,ESP,Valladolid,La Liga,2022,26.0,1996.0,21.0,27,15,13,11,3,15,25,60.0,10,16,4,12,13,40,15,0,MF,25-29,Midfielder,Spain,Europe
46,Kristoffer Ajer,NOR,Brentford,Premier League,2022,24.0,1998.0,8.5,11,8,5,4,2,9,16,56.3,7,6,5,1,7,18,22,0,DF,20-24,Defender,Norway,Europe
51,Sergio Akieme,ESP,Almería,La Liga,2022,24.0,1997.0,25.5,27,16,19,6,2,12,22,54.5,10,22,6,16,14,41,41,0,DF,20-24,Defender,Spain,Europe
58,Ángel Alarcón,ESP,Barcelona,La Liga,2022,18.0,2004.0,0.3,0,0,0,0,0,0,2,0.0,2,0,0,0,0,0,0,0,"FW,MF",Under 20,Forward,Spain,Europe
61,Jordi Alba,ESP,Barcelona,La Liga,2022,33.0,1989.0,15.8,25,18,13,11,1,12,28,42.9,16,12,5,7,11,36,23,0,DF,30-34,Defender,Spain,Europe
62,Luis Alberto,ESP,Lazio,Serie A,2022,29.0,1992.0,27.1,49,29,18,20,11,23,72,31.9,49,35,6,29,9,58,4,0,MF,25-29,Midfielder,Spain,Europe
63,Raúl Albiol,ESP,Villarreal,La Liga,2022,36.0,1985.0,23.5,25,17,17,6,2,14,18,77.8,4,17,13,4,14,39,111,0,DF,35-39,Defender,Spain,Europe
65,Thiago Alcántara,ESP,Liverpool,Premier League,2022,31.0,1991.0,13.9,43,24,20,21,2,14,23,60.9,9,15,3,12,21,64,13,2,MF,30-34,Midfielder,Spain,Europe
67,Rubén Alcaraz,ESP,Cádiz,La Liga,2022,31.0,1991.0,22.7,43,31,24,18,1,19,54,35.2,35,23,8,15,19,62,37,0,MF,30-34,Midfielder,Spain,Europe
69,Iván Alejo,ESP,Cádiz,La Liga,2022,27.0,1995.0,14.6,32,21,19,9,4,17,37,45.9,20,18,3,15,5,37,12,1,"MF,FW",25-29,Midfielder,Spain,Europe
71,Carles Aleñá,ESP,Getafe,La Liga,2022,24.0,1998.0,23.5,18,10,7,5,6,5,34,14.7,29,19,1,18,4,22,18,0,"MF,FW",20-24,Midfielder,Spain,Europe
73,Alejandro Alfaro,ESP,Elche,La Liga,2022,20.0,2002.0,0.2,0,0,0,0,0,0,0,,0,0,0,0,0,0,0,0,MF,20-24,Midfielder,Spain,Europe
73,Alejandro Alfaro,ESP,Elche,La Liga,2022,20.0,2002.0,0.2,0,0,0,0,0,0,0,,0,0,0,0,0,0,0,0,MF,20-24,Midfielder,Spain,Europe
73,Alejandro Alfaro,ESP,Elche,La Liga,2022,20.0,2002.0,0.2,0,0,0,0,0,0,0,,0,0,0,0,0,0,0,0,MF,20-24,Midfielder,Spain,Europe
73,Alejandro Alfaro,ESP,Elche,La Liga,2022,20.0,2002.0,0.2,0,0,0,0,0,0,0,,0,0,0,0,0,0,0,0,MF,20-24,Midfielder,Spain,Europe
74,Ángel Algobia,ESP,Getafe,La Liga,2022,23.0,1999.0,12.6,27,13,14,13,0,22,48,45.8,26,15,5,10,3,30,11,0,MF,20-24,Midfielder,Spain,Europe
82,Marcos Alonso,ESP,Barcelona,La Liga,2022,31.0,1990.0,13.0,15,10,10,5,0,9,12,75.0,3,14,10,4,11,26,32,0,DF,30-34,Defender,Spain,Europe
85,Carlos Álvarez,ESP,Sevilla,La Liga,2022,18.0,2003.0,0.1,1,1,0,1,0,0,0,,0,0,0,0,0,1,0,0,MF,Under 20,Midfielder,Spain,Europe
89,Yeray Álvarez,ESP,Athletic Club,La Liga,2022,27.0,1995.0,25.9,34,23,26,7,1,24,31,77.4,7,23,13,10,48,82,101,0,DF,25-29,Defender,Spain,Europe
95,Lukáš Ambros,CZE,Wolfsburg,Bundesliga,2022,18.0,2004.0,0.2,1,0,1,0,0,1,4,25.0,3,1,0,1,0,1,2,1,MF,Under 20,Midfielder,Czech Republic,Europe
109,Komnen Andrić,SRB,Clermont Foot,Ligue 1,2022,27.0,1995.0,16.1,13,5,2,7,4,2,15,13.3,13,8,1,7,8,21,13,0,FW,25-29,Forward,Serbia,Europe
111,Angeliño,ESP,Hoffenheim,Bundesliga,2022,25.0,1997.0,29.1,40,24,19,18,3,23,37,62.2,14,32,6,26,25,65,67,0,DF,25-29,Defender,Spain,Europe
116,Josep Antoni Gayá,ESP,Mallorca,La Liga,2022,22.0,2000.0,1.1,0,0,0,0,0,0,0,,0,4,2,2,1,1,6,0,"DF,MF",20-24,Defender,Spain,Europe
117,José Antonio,ESP,Cádiz,La Liga,2022,18.0,2004.0,0.5,2,1,0,0,2,0,0,,0,0,0,0,0,2,0,0,"MF,DF",Under 20,Midfielder,Spain,Europe
134,Adu Ares,ESP,Athletic Club,La Liga,2022,20.0,2001.0,0.9,4,2,2,1,1,4,4,100.0,0,1,0,1,2,6,1,0,"FW,MF",20-24,Forward,Spain,Europe
141,Sergio Arribas,ESP,Real Madrid,La Liga,2022,20.0,2001.0,0.2,0,0,0,0,0,0,0,,0,1,0,1,0,0,0,0,"MF,FW",20-24,Midfielder,Spain,Europe
141,Sergio Arribas,ESP,Real Madrid,La Liga,2022,20.0,2001.0,0.2,0,0,0,0,0,0,0,,0,1,0,1,0,0,0,0,"MF,FW",20-24,Midfielder,Spain,Europe
141,Sergio Arribas,ESP,Real Madrid,La Liga,2022,20.0,2001.0,0.2,0,0,0,0,0,0,0,,0,1,0,1,0,0,0,0,"MF,FW",20-24,Midfielder,Spain,Europe
141,Sergio Arribas,ESP,Real Madrid,La Liga,2022,20.0,2001.0,0.2,0,0,0,0,0,0,0,,0,1,0,1,0,0,0,0,"MF,FW",20-24,Midfielder,Spain,Europe
142,Kepa Arrizabalaga,ESP,Chelsea,Premier League,2022,27.0,1994.0,28.5,2,2,2,0,0,2,3,66.7,1,0,0,0,1,3,16,2,GK,25-29,Goalkeeper,Spain,Europe
143,Roberto Arroyo,ESP,Valladolid,La Liga,2022,18.0,2003.0,0.2,1,1,0,1,0,1,1,100.0,0,0,0,0,0,1,0,0,MF,Under 20,Midfielder,Spain,Europe
145,Ricard Artero,ESP,Girona,La Liga,2022,19.0,2003.0,1.5,3,3,2,1,0,1,1,100.0,0,2,0,2,1,4,3,0,"MF,FW",Under 20,Midfielder,Spain,Europe
149,Sergio Asenjo,ESP,Valladolid,La Liga,2022,33.0,1989.0,10.0,0,0,0,0,0,0,0,,0,0,0,0,0,0,10,2,GK,30-34,Goalkeeper,Spain,Europe
150,Marco Asensio,ESP,Real Madrid,La Liga,2022,26.0,1996.0,16.0,16,10,8,6,2,8,19,42.1,11,8,3,5,5,21,4,0,"FW,MF",25-29,Forward,Spain,Europe
151,Kristoffer Askildsen,NOR,Lecce,Serie A,2022,21.0,2001.0,8.1,7,3,2,3,2,4,10,40.0,6,15,4,11,11,18,6,0,MF,20-24,Midfielder,Norway,Europe
154,Iago Aspas,ESP,Celta Vigo,La Liga,2022,34.0,1987.0,31.9,8,4,0,4,4,3,22,13.6,19,10,1,9,7,15,23,0,FW,30-34,Forward,Spain,Europe
155,Lorenz Assignon,TOG,Rennes,Ligue 1,2022,22.0,2000.0,2.9,6,2,4,2,0,2,4,50.0,2,6,0,6,2,8,9,0,DF,20-24,Defender,Togo,Africa
178,César Azpilicueta,ESP,Chelsea,Premier League,2022,32.0,1989.0,17.0,43,25,23,15,5,22,37,59.5,15,26,5,21,19,62,54,1,DF,30-34,Defender,Spain,Europe
181,Srđan Babić,SRB,Almería,La Liga,2022,26.0,1996.0,33.3,28,18,20,8,0,15,32,46.9,17,34,22,12,29,57,124,1,DF,25-29,Defender,Serbia,Europe
184,Édgar Badía,ESP,Elche,La Liga,2022,30.0,1992.0,36.0,1,0,1,0,0,1,2,50.0,1,0,0,0,0,1,19,3,GK,30-34,Goalkeeper,Spain,Europe
187,Alex Baena,ESP,Villarreal,La Liga,2022,21.0,2001.0,21.6,30,17,9,15,6,15,45,33.3,30,15,3,12,7,37,16,0,"MF,FW",20-24,Midfielder,Spain,Europe
193,Stefan Bajcetic,ESP,Liverpool,Premier League,2022,17.0,2004.0,5.8,9,6,5,3,1,8,27,29.6,19,7,0,7,9,18,4,0,MF,Under 20,Midfielder,Spain,Europe
201,Alejandro Balde,ESP,Barcelona,La Liga,2022,18.0,2003.0,27.5,42,30,22,16,4,24,41,58.5,17,25,3,22,12,54,17,1,DF,Under 20,Defender,Spain,Europe
204,Mikel Balenziaga,ESP,Athletic Club,La Liga,2022,34.0,1988.0,1.3,4,4,1,2,1,4,4,100.0,0,0,0,0,1,5,2,0,DF,30-34,Defender,Spain,Europe
217,Antonín Barák,CZE,Hellas Verona,Serie A,2022,27.0,1994.0,0.3,0,0,0,0,0,0,0,,0,0,0,0,0,0,0,0,MF,25-29,Midfielder,Czech Republic,Europe
218,Antonín Barák,CZE,Fiorentina,Serie A,2022,27.0,1994.0,20.0,21,9,5,7,9,6,16,37.5,10,16,2,14,3,24,13,0,MF,25-29,Midfielder,Czech Republic,Europe
226,Kike Barja,ESP,Osasuna,La Liga,2022,25.0,1997.0,14.6,15,9,6,5,4,8,24,33.3,16,7,0,7,4,19,3,0,"FW,MF",25-29,Forward,Spain,Europe
232,Ander Barrenetxea,ESP,Real Sociedad,La Liga,2022,20.0,2001.0,9.8,21,15,15,6,0,12,28,42.9,16,15,1,14,5,26,7,0,"FW,DF",20-24,Forward,Spain,Europe
234,Pablo Barrios,ESP,Atlético Madrid,La Liga,2022,19.0,2003.0,8.0,19,10,3,10,6,8,15,53.3,7,12,2,10,9,28,6,1,MF,Under 20,Midfielder,Spain,Europe
253,Ihlas Bebou,TOG,Hoffenheim,Bundesliga,2022,28.0,1994.0,15.7,19,16,8,7,4,11,17,64.7,6,9,2,7,7,26,15,0,"FW,DF",25-29,Forward,Togo,Africa
258,Jan Bednarek,POL,Southampton,Premier League,2022,26.0,1996.0,18.6,27,21,20,7,0,12,16,75.0,4,38,27,11,49,76,87,0,DF,25-29,Defender,Poland,Europe
259,Jan Bednarek,POL,Aston Villa,Premier League,2022,26.0,1996.0,1.1,3,3,0,3,0,1,1,100.0,0,3,1,2,2,5,5,0,DF,25-29,Defender,Poland,Europe
275,Héctor Bellerín,ESP,Barcelona,La Liga,2022,27.0,1995.0,1.6,2,0,0,2,0,2,3,66.7,1,2,0,2,3,5,2,0,DF,25-29,Defender,Spain,Europe
279,Fran Beltrán,ESP,Celta Vigo,La Liga,2022,23.0,1999.0,31.7,34,22,15,14,5,14,55,25.5,41,29,5,24,53,87,35,2,MF,20-24,Midfielder,Spain,Europe
285,Iker Benito,ESP,Osasuna,La Liga,2022,19.0,2002.0,2.0,4,3,0,3,1,2,4,50.0,2,0,0,0,2,6,4,0,"FW,MF",Under 20,Forward,Spain,Europe
294,Yuri Berchiche,ESP,Athletic Club,La Liga,2022,32.0,1990.0,26.7,56,32,28,20,8,35,59,59.3,24,37,12,25,40,96,59,1,DF,30-34,Defender,Spain,Europe
295,Álex Berenguer,ESP,Athletic Club,La Liga,2022,27.0,1995.0,25.5,58,37,17,25,16,23,60,38.3,37,37,4,33,10,68,6,0,FW,25-29,Forward,Spain,Europe
296,Bartosz Bereszyński,POL,Sampdoria,Serie A,2022,30.0,1992.0,13.3,28,18,15,11,2,17,26,65.4,9,18,4,14,21,49,25,0,DF,30-34,Defender,Poland,Europe
297,Bartosz Bereszyński,POL,Napoli,Serie A,2022,30.0,1992.0,1.8,3,2,1,1,1,2,2,100.0,0,4,0,4,3,6,3,0,DF,30-34,Defender,Poland,Europe
298,Patrick Berg,NOR,Lens,Ligue 1,2022,24.0,1997.0,0.3,0,0,0,0,0,0,1,0.0,1,0,0,0,1,1,0,0,"MF,FW",20-24,Midfielder,Norway,Europe
303,Juan Bernat,ESP,Paris S-G,Ligue 1,2022,29.0,1993.0,18.3,32,16,18,9,5,21,39,53.8,18,11,2,9,9,41,22,1,"DF,MF",25-29,Defender,Spain,Europe
313,Pedro Bigas,ESP,Elche,La Liga,2022,31.0,1990.0,22.4,37,20,30,7,0,18,29,62.1,11,25,14,11,33,70,95,0,DF,30-34,Defender,Spain,Europe
314,Jaka Bijol,SVN,Udinese,Serie A,2022,23.0,1999.0,30.3,39,23,32,7,0,16,27,59.3,11,41,25,16,29,68,165,0,DF,20-24,Defender,Slovenia,Europe
321,Veljko Birmančević,SRB,Toulouse,Ligue 1,2022,24.0,1998.0,4.9,13,7,5,4,4,7,21,33.3,14,12,2,10,7,20,1,0,"FW,MF",20-24,Forward,Serbia,Europe
327,Antonio Blanco,ESP,Cádiz,La Liga,2022,22.0,2000.0,1.8,6,4,5,1,0,4,6,66.7,2,5,0,5,1,7,3,0,MF,20-24,Midfielder,Spain,Europe
329,Rubén Blanco,ESP,Marseille,Ligue 1,2022,27.0,1995.0,5.5,0,0,0,0,0,0,0,,0,0,0,0,0,0,1,0,GK,25-29,Goalkeeper,Spain,Europe
332,Miha Blažič,SVN,Angers,Ligue 1,2022,29.0,1993.0,22.0,8,6,8,0,0,7,15,46.7,8,25,19,6,22,30,80,1,DF,25-29,Defender,Slovenia,Europe
342,Emil Bohinen,NOR,Salernitana,Serie A,2022,23.0,1999.0,9.2,25,13,15,8,2,12,23,52.2,11,25,7,18,17,42,21,0,MF,20-24,Midfielder,Norway,Europe
355,Erik Botheim,NOR,Salernitana,Serie A,2022,22.0,2000.0,9.6,11,7,3,4,4,6,13,46.2,7,3,0,3,0,11,4,0,"MF,FW",20-24,Midfielder,Norway,Europe
364,Ismaël Boura,COM,Lens,Ligue 1,2022,21.0,2000.0,1.0,6,4,4,2,0,5,6,83.3,1,2,1,1,2,8,3,0,"DF,FW",20-24,Defender,Comoros,Africa
375,Darko Brašanac,SRB,Osasuna,La Liga,2022,30.0,1992.0,11.6,29,20,12,10,7,12,23,52.2,11,14,2,12,12,41,9,0,MF,30-34,Midfielder,Serbia,Europe
397,Hugo Bueno,ESP,Wolves,Premier League,2022,19.0,2002.0,14.6,33,16,23,6,4,17,33,51.5,16,14,1,13,10,43,36,0,DF,Under 20,Defender,Spain,Europe
398,Manu Bueno,ESP,Sevilla,La Liga,2022,18.0,2004.0,1.7,7,4,3,3,1,5,8,62.5,3,0,0,0,0,7,2,0,MF,Under 20,Midfielder,Spain,Europe
400,Adam Buksa,POL,Lens,Ligue 1,2022,26.0,1996.0,1.1,1,0,0,0,1,0,3,0.0,3,0,0,0,0,1,0,0,"FW,MF",25-29,Forward,Poland,Europe
410,Sergio Busquets,ESP,Barcelona,La Liga,2022,34.0,1988.0,26.0,58,26,24,26,8,29,51,56.9,22,32,6,26,27,85,36,2,MF,30-34,Midfielder,Spain,Europe
413,Marcin Bułka,POL,Nice,Ligue 1,2022,22.0,1999.0,2.0,0,0,0,0,0,0,1,0.0,1,0,0,0,1,1,0,0,GK,20-24,Goalkeeper,Poland,Europe
424,Cala,ESP,Cádiz,La Liga,2022,32.0,1989.0,1.5,2,1,1,1,0,1,2,50.0,1,2,1,1,1,3,12,0,DF,30-34,Defender,Spain,Europe
428,Fernando Calero,ESP,Espanyol,La Liga,2022,26.0,1995.0,17.9,46,29,27,15,4,21,34,61.8,13,31,13,18,13,59,52,0,"DF,MF",25-29,Defender,Spain,Europe
445,Sergio Camello,ESP,Rayo Vallecano,La Liga,2022,21.0,2001.0,26.7,16,10,3,9,4,5,17,29.4,12,9,1,8,2,18,26,0,FW,20-24,Forward,Spain,Europe
448,Sergio Canales,ESP,Betis,La Liga,2022,31.0,1991.0,26.7,25,14,10,8,7,14,33,42.4,19,18,0,18,14,39,8,0,"FW,MF",30-34,Forward,Spain,Europe
454,Sergi Canós,ESP,Brentford,Premier League,2022,25.0,1997.0,0.9,0,0,0,0,0,0,2,0.0,2,3,1,2,0,0,1,0,"FW,DF",25-29,Forward,Spain,Europe
455,Ander Capa,ESP,Athletic Club,La Liga,2022,30.0,1992.0,1.2,1,1,1,0,0,1,5,20.0,4,5,0,5,0,1,2,0,DF,30-34,Defender,Spain,Europe
465,Isaac Carcelen,ESP,Cádiz,La Liga,2022,29.0,1993.0,24.4,69,51,41,22,6,41,63,65.1,22,35,11,24,19,88,80,1,DF,25-29,Defender,Spain,Europe
470,Juan Carlos,ESP,Girona,La Liga,2022,34.0,1988.0,10.0,0,0,0,0,0,0,0,,0,0,0,0,1,1,7,1,GK,30-34,Goalkeeper,Spain,Europe
470,Juan Carlos,ESP,Girona,La Liga,2022,34.0,1988.0,10.0,0,0,0,0,0,0,0,,0,0,0,0,1,1,7,1,GK,30-34,Goalkeeper,Spain,Europe
470,Juan Carlos,ESP,Girona,La Liga,2022,34.0,1988.0,10.0,0,0,0,0,0,0,0,,0,0,0,0,1,1,7,1,GK,30-34,Goalkeeper,Spain,Europe
470,Juan Carlos,ESP,Girona,La Liga,2022,34.0,1988.0,10.0,0,0,0,0,0,0,0,,0,0,0,0,1,1,7,1,GK,30-34,Goalkeeper,Spain,Europe
471,José Carlos Lazo,ESP,Almería,La Liga,2022,26.0,1996.0,0.2,0,0,0,0,0,0,0,,0,0,0,0,0,0,0,0,"MF,FW",25-29,Midfielder,Spain,Europe
472,José Carlos Lazo,ESP,Espanyol,La Liga,2022,26.0,1996.0,1.8,5,3,2,2,1,3,3,100.0,0,2,0,2,3,8,5,0,"MF,FW",25-29,Midfielder,Spain,Europe
473,Carmona,ESP,Elche,La Liga,2022,20.0,2002.0,6.5,16,9,7,6,3,6,16,37.5,10,14,2,12,8,24,9,0,"MF,DF",20-24,Midfielder,Spain,Europe
474,Carmona,ESP,Sevilla,La Liga,2022,20.0,2002.0,5.9,13,11,5,3,5,9,16,56.3,7,10,6,4,7,20,17,1,DF,20-24,Defender,Spain,Europe
477,Dani Carvajal,ESP,Real Madrid,La Liga,2022,30.0,1992.0,19.8,32,18,15,12,5,18,35,51.4,17,24,6,18,15,47,49,0,DF,30-34,Defender,Spain,Europe
484,Matty Cash,POL,Aston Villa,Premier League,2022,24.0,1997.0,20.2,55,32,36,15,4,26,37,70.3,11,20,5,15,26,81,43,0,DF,20-24,Defender,Poland,Europe
491,Samu Castillejo,ESP,Valencia,La Liga,2022,27.0,1995.0,15.1,21,12,8,9,4,8,40,20.0,32,21,2,19,9,30,2,0,"FW,MF",25-29,Forward,Spain,Europe
492,Jonny Castro,ESP,Wolves,Premier League,2022,28.0,1994.0,14.0,33,15,22,10,1,17,38,44.7,21,26,5,21,14,47,28,2,DF,25-29,Defender,Spain,Europe
495,Catena,ESP,Rayo Vallecano,La Liga,2022,27.0,1994.0,34.5,29,14,23,4,2,13,27,48.1,14,32,25,7,28,57,159,1,DF,25-29,Defender,Spain,Europe
499,Dani Ceballos,ESP,Real Madrid,La Liga,2022,25.0,1996.0,17.4,43,29,13,15,15,25,64,39.1,39,23,2,21,25,68,6,1,MF,25-29,Midfielder,Spain,Europe
503,Emil Ceide,NOR,Sassuolo,Serie A,2022,20.0,2001.0,5.7,5,2,5,0,0,3,5,60.0,2,3,1,2,1,6,0,0,FW,20-24,Forward,Norway,Europe
505,Álex Centelles,ESP,Almería,La Liga,2022,24.0,1997.0,12.5,22,14,16,3,3,16,22,72.7,6,13,2,11,11,33,40,0,DF,20-24,Defender,Spain,Europe
520,Shea Charles,NIR,Manchester City,Premier League,2022,18.0,2003.0,0.3,4,0,4,0,0,1,1,100.0,0,0,0,0,1,5,2,0,DF,Under 20,Defender,Northern Ireland,Europe
522,Pep Chavarría,ESP,Rayo Vallecano,La Liga,2022,24.0,1998.0,4.1,6,4,2,1,3,1,5,20.0,4,8,0,8,2,8,8,0,"FW,MF",20-24,Forward,Spain,Europe
532,Pedro Chirivella,ESP,Nantes,Ligue 1,2022,25.0,1997.0,22.5,33,22,12,15,6,17,44,38.6,27,24,1,23,20,53,7,0,MF,25-29,Midfielder,Spain,Europe
539,Chumi,ESP,Almería,La Liga,2022,23.0,1999.0,16.5,29,16,18,9,2,14,23,60.9,9,20,7,13,15,44,53,0,DF,20-24,Defender,Spain,Europe
541,Víctor Chust,ESP,Cádiz,La Liga,2022,22.0,2000.0,10.7,9,6,7,2,0,4,7,57.1,3,8,3,5,10,19,53,0,DF,20-24,Defender,Spain,Europe
545,Tio Cipot,SVN,Spezia,Serie A,2022,19.0,2003.0,1.5,12,7,6,3,3,6,8,75.0,2,0,0,0,0,12,2,0,"FW,MF",Under 20,Forward,Slovenia,Europe
553,Carlos Clerc,ESP,Elche,La Liga,2022,30.0,1992.0,29.3,75,51,55,16,4,31,50,62.0,19,29,7,22,28,103,94,1,"DF,MF",30-34,Defender,Spain,Europe
562,Álex Collado,ESP,Elche,La Liga,2022,23.0,1999.0,8.0,26,14,13,11,2,8,13,61.5,5,12,1,11,2,28,4,0,MF,20-24,Midfielder,Spain,Europe
563,Diego Collado,ESP,Villarreal,La Liga,2022,21.0,2001.0,0.1,0,0,0,0,0,0,0,,0,0,0,0,0,0,0,0,FW,20-24,Forward,Spain,Europe
571,Santi Comesaña,ESP,Rayo Vallecano,La Liga,2022,25.0,1996.0,27.2,71,44,24,41,6,38,82,46.3,44,39,3,36,32,103,17,0,MF,25-29,Midfielder,Spain,Europe
578,Copete,ESP,Mallorca,La Liga,2022,22.0,1999.0,24.5,53,28,35,16,2,26,36,72.2,10,38,17,21,44,97,111,2,DF,20-24,Defender,Spain,Europe
591,Diego Costa,ESP,Wolves,Premier League,2022,33.0,1988.0,13.8,3,1,3,0,0,2,9,22.2,7,6,1,5,2,5,17,0,FW,30-34,Forward,Spain,Europe
591,Diego Costa,ESP,Wolves,Premier League,2022,33.0,1988.0,13.8,3,1,3,0,0,2,9,22.2,7,6,1,5,2,5,17,0,FW,30-34,Forward,Spain,Europe
591,Diego Costa,ESP,Wolves,Premier League,2022,33.0,1988.0,13.8,3,1,3,0,0,2,9,22.2,7,6,1,5,2,5,17,0,FW,30-34,Forward,Spain,Europe
591,Diego Costa,ESP,Wolves,Premier League,2022,33.0,1988.0,13.8,3,1,3,0,0,2,9,22.2,7,6,1,5,2,5,17,0,FW,30-34,Forward,Spain,Europe
592,Jaume Costa,ESP,Mallorca,La Liga,2022,34.0,1988.0,28.9,50,34,26,17,7,29,51,56.9,22,13,5,8,22,72,44,1,DF,30-34,Defender,Spain,Europe
597,Vladimír Coufal,CZE,West Ham,Premier League,2022,29.0,1992.0,23.7,58,31,37,15,6,36,51,70.6,15,24,6,18,38,96,70,0,DF,25-29,Defender,Czech Republic,Europe
612,Domen Črnigoj,SVN,Salernitana,Serie A,2022,26.0,1995.0,3.3,8,3,0,7,1,1,2,50.0,1,9,1,8,9,17,6,0,MF,25-29,Midfielder,Slovenia,Europe
613,Juan Cruz Armada,ESP,Osasuna,La Liga,2022,30.0,1992.0,22.9,24,14,17,4,3,13,23,56.5,10,21,8,13,13,37,58,0,DF,30-34,Defender,Spain,Europe
614,Juan Cruz,ESP,Betis,La Liga,2022,22.0,2000.0,2.0,1,0,0,1,0,1,3,33.3,2,1,0,1,0,1,0,0,FW,20-24,Forward,Spain,Europe
614,Juan Cruz,ESP,Betis,La Liga,2022,22.0,2000.0,2.0,1,0,0,1,0,1,3,33.3,2,1,0,1,0,1,0,0,FW,20-24,Forward,Spain,Europe
614,Juan Cruz,ESP,Betis,La Liga,2022,22.0,2000.0,2.0,1,0,0,1,0,1,3,33.3,2,1,0,1,0,1,0,0,FW,20-24,Forward,Spain,Europe
614,Juan Cruz,ESP,Betis,La Liga,2022,22.0,2000.0,2.0,1,0,0,1,0,1,3,33.3,2,1,0,1,0,1,0,0,FW,20-24,Forward,Spain,Europe
616,Marc Cucurella,ESP,Chelsea,Premier League,2022,24.0,1998.0,18.6,66,33,40,15,11,30,60,50.0,30,28,8,20,16,82,48,1,DF,20-24,Defender,Spain,Europe
617,Jorge Cuenca,ESP,Villarreal,La Liga,2022,22.0,1999.0,5.6,9,7,7,2,0,4,7,57.1,3,10,8,2,6,15,44,0,DF,20-24,Defender,Spain,Europe
622,Curro,ESP,Almería,La Liga,2022,26.0,1996.0,0.5,2,0,1,1,0,1,2,50.0,1,0,0,0,0,2,0,0,MF,25-29,Midfielder,Spain,Europe
647,Sergi Darder,ESP,Espanyol,La Liga,2022,28.0,1993.0,36.9,69,38,12,43,14,29,73,39.7,44,34,2,32,24,93,23,0,MF,25-29,Midfielder,Spain,Europe
649,Vladimír Darida,CZE,Hertha BSC,Bundesliga,2022,31.0,1990.0,0.3,1,1,0,1,0,0,0,,0,1,0,1,0,1,0,0,MF,30-34,Midfielder,Czech Republic,Europe
658,Paweł Dawidowicz,POL,Hellas Verona,Serie A,2022,27.0,1995.0,18.1,48,31,28,17,3,22,31,71.0,9,14,9,5,23,71,71,0,DF,25-29,Defender,Poland,Europe
674,Alberto Del Moral,ESP,Villarreal,La Liga,2022,22.0,2000.0,0.1,0,0,0,0,0,0,0,,0,0,0,0,0,0,0,0,MF,20-24,Midfielder,Spain,Europe
679,Fran Delgado,ESP,Betis,La Liga,2022,21.0,2001.0,0.1,0,0,0,0,0,0,0,,0,0,0,0,0,0,0,0,DF,20-24,Defender,Spain,Europe
705,Gerard Deulofeu,ESP,Udinese,Serie A,2022,28.0,1994.0,13.5,8,5,5,1,2,5,15,33.3,10,8,1,7,2,10,1,0,FW,25-29,Forward,Spain,Europe
753,Djené,TOG,Getafe,La Liga,2022,30.0,1991.0,31.6,41,28,23,17,1,22,38,57.9,16,25,10,15,42,83,81,1,DF,30-34,Defender,Togo,Africa
760,Marko Dmitrović,SRB,Sevilla,La Liga,2022,30.0,1992.0,14.1,0,0,0,0,0,0,0,,0,0,0,0,0,0,6,0,GK,30-34,Goalkeeper,Serbia,Europe
772,Carlos Dominguez,ESP,Celta Vigo,La Liga,2022,21.0,2001.0,1.2,1,1,0,1,0,1,2,50.0,1,1,1,0,0,1,7,0,DF,20-24,Defender,Spain,Europe
774,John Donald,ESP,Elche,La Liga,2022,21.0,2000.0,12.1,20,11,9,9,2,7,14,50.0,7,14,7,7,14,34,23,1,"MF,DF",20-24,Midfielder,Spain,Europe
792,Bartłomiej Drągowski,POL,Spezia,Serie A,2022,24.0,1997.0,32.7,1,0,1,0,0,1,5,20.0,4,0,0,0,1,2,15,3,GK,20-24,Goalkeeper,Poland,Europe
808,Pablo Durán,ESP,Celta Vigo,La Liga,2022,21.0,2001.0,0.4,0,0,0,0,0,0,0,,0,2,1,1,1,1,2,0,"MF,DF",20-24,Midfielder,Spain,Europe
810,Hugo Duro,ESP,Valencia,La Liga,2022,22.0,1999.0,15.4,15,12,2,6,7,7,17,41.2,10,11,1,10,2,17,7,1,FW,20-24,Forward,Spain,Europe
824,Íñigo Eguaras,ESP,Almería,La Liga,2022,30.0,1992.0,10.7,11,8,4,6,1,5,18,27.8,13,9,3,6,6,17,15,0,MF,30-34,Midfielder,Spain,Europe
833,Alberth Elis,HON,Brest,Ligue 1,2022,26.0,1996.0,2.9,4,3,1,2,1,1,7,14.3,6,1,0,1,1,5,2,0,"MF,FW",25-29,Midfielder,Honduras,North America
838,Aritz Elustondo,ESP,Real Sociedad,La Liga,2022,28.0,1994.0,16.1,26,17,15,10,1,14,26,53.8,12,15,6,9,20,46,43,1,DF,25-29,Defender,Spain,Europe
841,Mohamed Elyounoussi,NOR,Southampton,Premier League,2022,27.0,1994.0,24.1,46,28,22,20,4,19,44,43.2,25,40,3,37,27,73,37,0,"MF,FW",25-29,Midfielder,Norway,Europe
842,Adri Embarba,ESP,Almería,La Liga,2022,30.0,1992.0,16.4,50,27,21,26,3,22,46,47.8,24,23,0,23,9,59,9,0,"FW,MF",30-34,Forward,Spain,Europe
843,Adri Embarba,ESP,Espanyol,La Liga,2022,30.0,1992.0,0.4,1,0,0,1,0,1,1,100.0,0,1,0,1,0,1,0,0,FW,30-34,Forward,Spain,Europe
855,Sergio Escudero,ESP,Valladolid,La Liga,2022,32.0,1989.0,16.0,33,19,21,8,4,15,35,42.9,20,26,6,20,26,59,46,0,DF,30-34,Defender,Spain,Europe
861,Jonny Evans,NIR,Leicester City,Premier League,2022,34.0,1988.0,11.7,13,5,12,1,0,7,11,63.6,4,15,11,4,18,31,51,0,DF,30-34,Defender,Northern Ireland,Europe
862,Edu Expósito,ESP,Espanyol,La Liga,2022,25.0,1996.0,12.9,34,20,16,15,3,13,23,56.5,10,7,0,7,12,46,20,0,MF,25-29,Midfielder,Spain,Europe
867,Łukasz Fabiański,POL,West Ham,Premier League,2022,37.0,1985.0,34.6,2,0,2,0,0,1,2,50.0,1,1,0,1,0,2,10,1,GK,35-39,Goalkeeper,Poland,Europe
879,Fali,ESP,Cádiz,La Liga,2022,28.0,1993.0,19.0,27,19,19,8,0,18,29,62.1,11,24,15,9,13,40,70,1,"DF,MF",25-29,Defender,Spain,Europe
883,Ansu Fati,ESP,Barcelona,La Liga,2022,19.0,2002.0,15.5,16,9,8,4,4,5,18,27.8,13,19,0,19,5,21,6,0,FW,Under 20,Forward,Spain,Europe
896,Kiko Femenía,ESP,Villarreal,La Liga,2022,31.0,1991.0,12.6,18,9,14,3,1,13,18,72.2,5,15,6,9,20,38,22,0,DF,30-34,Defender,Spain,Europe
901,Aitor Fernández,ESP,Osasuna,La Liga,2022,31.0,1991.0,21.0,1,1,1,0,0,0,1,0.0,1,0,0,0,2,3,17,0,GK,30-34,Goalkeeper,Spain,Europe
901,Aitor Fernández,ESP,Osasuna,La Liga,2022,31.0,1991.0,21.0,1,1,1,0,0,0,1,0.0,1,0,0,0,2,3,17,0,GK,30-34,Goalkeeper,Spain,Europe
901,Aitor Fernández,ESP,Osasuna,La Liga,2022,31.0,1991.0,21.0,1,1,1,0,0,0,1,0.0,1,0,0,0,2,3,17,0,GK,30-34,Goalkeeper,Spain,Europe
901,Aitor Fernández,ESP,Osasuna,La Liga,2022,31.0,1991.0,21.0,1,1,1,0,0,0,1,0.0,1,0,0,0,2,3,17,0,GK,30-34,Goalkeeper,Spain,Europe
902,Álex Fernández,ESP,Cádiz,La Liga,2022,29.0,1992.0,17.5,13,7,6,4,3,4,14,28.6,10,14,1,13,8,21,19,0,"MF,FW",25-29,Midfielder,Spain,Europe
903,Álvaro Fernández,ESP,Espanyol,La Liga,2022,24.0,1998.0,11.0,0,0,0,0,0,0,0,,0,0,0,0,0,0,7,2,GK,20-24,Goalkeeper,Spain,Europe
903,Álvaro Fernández,ESP,Espanyol,La Liga,2022,24.0,1998.0,11.0,0,0,0,0,0,0,0,,0,0,0,0,0,0,7,2,GK,20-24,Goalkeeper,Spain,Europe
903,Álvaro Fernández,ESP,Espanyol,La Liga,2022,24.0,1998.0,11.0,0,0,0,0,0,0,0,,0,0,0,0,0,0,7,2,GK,20-24,Goalkeeper,Spain,Europe
903,Álvaro Fernández,ESP,Espanyol,La Liga,2022,24.0,1998.0,11.0,0,0,0,0,0,0,0,,0,0,0,0,0,0,7,2,GK,20-24,Goalkeeper,Spain,Europe
904,Carlos Fernández,ESP,Real Sociedad,La Liga,2022,26.0,1996.0,7.0,6,4,1,3,2,1,15,6.7,14,1,0,1,1,7,4,0,FW,25-29,Forward,Spain,Europe
907,Joaquín Fernández,ESP,Valladolid,La Liga,2022,26.0,1996.0,24.0,35,28,20,11,4,19,30,63.3,11,31,22,9,27,62,98,1,DF,25-29,Defender,Spain,Europe
907,Joaquín Fernández,ESP,Valladolid,La Liga,2022,26.0,1996.0,24.0,35,28,20,11,4,19,30,63.3,11,31,22,9,27,62,98,1,DF,25-29,Defender,Spain,Europe
907,Joaquín Fernández,ESP,Valladolid,La Liga,2022,26.0,1996.0,24.0,35,28,20,11,4,19,30,63.3,11,31,22,9,27,62,98,1,DF,25-29,Defender,Spain,Europe
907,Joaquín Fernández,ESP,Valladolid,La Liga,2022,26.0,1996.0,24.0,35,28,20,11,4,19,30,63.3,11,31,22,9,27,62,98,1,DF,25-29,Defender,Spain,Europe
908,Valery Fernández,ESP,Girona,La Liga,2022,22.0,1999.0,10.7,12,6,4,6,2,5,9,55.6,4,8,1,7,10,22,9,1,"MF,DF",20-24,Midfielder,Spain,Europe
909,Fernando,ESP,Almería,La Liga,2022,32.0,1990.0,36.5,0,0,0,0,0,0,2,0.0,2,2,0,2,1,1,20,3,GK,30-34,Goalkeeper,Spain,Europe
909,Fernando,ESP,Almería,La Liga,2022,32.0,1990.0,36.5,0,0,0,0,0,0,2,0.0,2,2,0,2,1,1,20,3,GK,30-34,Goalkeeper,Spain,Europe
909,Fernando,ESP,Almería,La Liga,2022,32.0,1990.0,36.5,0,0,0,0,0,0,2,0.0,2,2,0,2,1,1,20,3,GK,30-34,Goalkeeper,Spain,Europe
909,Fernando,ESP,Almería,La Liga,2022,32.0,1990.0,36.5,0,0,0,0,0,0,2,0.0,2,2,0,2,1,1,20,3,GK,30-34,Goalkeeper,Spain,Europe
909,Fernando,ESP,Almería,La Liga,2022,32.0,1990.0,36.5,0,0,0,0,0,0,2,0.0,2,2,0,2,1,1,20,3,GK,30-34,Goalkeeper,Spain,Europe
909,Fernando,ESP,Almería,La Liga,2022,32.0,1990.0,36.5,0,0,0,0,0,0,2,0.0,2,2,0,2,1,1,20,3,GK,30-34,Goalkeeper,Spain,Europe
909,Fernando,ESP,Almería,La Liga,2022,32.0,1990.0,36.5,0,0,0,0,0,0,2,0.0,2,2,0,2,1,1,20,3,GK,30-34,Goalkeeper,Spain,Europe
909,Fernando,ESP,Almería,La Liga,2022,32.0,1990.0,36.5,0,0,0,0,0,0,2,0.0,2,2,0,2,1,1,20,3,GK,30-34,Goalkeeper,Spain,Europe
909,Fernando,ESP,Almería,La Liga,2022,32.0,1990.0,36.5,0,0,0,0,0,0,2,0.0,2,2,0,2,1,1,20,3,GK,30-34,Goalkeeper,Spain,Europe
909,Fernando,ESP,Almería,La Liga,2022,32.0,1990.0,36.5,0,0,0,0,0,0,2,0.0,2,2,0,2,1,1,20,3,GK,30-34,Goalkeeper,Spain,Europe
909,Fernando,ESP,Almería,La Liga,2022,32.0,1990.0,36.5,0,0,0,0,0,0,2,0.0,2,2,0,2,1,1,20,3,GK,30-34,Goalkeeper,Spain,Europe
909,Fernando,ESP,Almería,La Liga,2022,32.0,1990.0,36.5,0,0,0,0,0,0,2,0.0,2,2,0,2,1,1,20,3,GK,30-34,Goalkeeper,Spain,Europe
909,Fernando,ESP,Almería,La Liga,2022,32.0,1990.0,36.5,0,0,0,0,0,0,2,0.0,2,2,0,2,1,1,20,3,GK,30-34,Goalkeeper,Spain,Europe
909,Fernando,ESP,Almería,La Liga,2022,32.0,1990.0,36.5,0,0,0,0,0,0,2,0.0,2,2,0,2,1,1,20,3,GK,30-34,Goalkeeper,Spain,Europe
909,Fernando,ESP,Almería,La Liga,2022,32.0,1990.0,36.5,0,0,0,0,0,0,2,0.0,2,2,0,2,1,1,20,3,GK,30-34,Goalkeeper,Spain,Europe
909,Fernando,ESP,Almería,La Liga,2022,32.0,1990.0,36.5,0,0,0,0,0,0,2,0.0,2,2,0,2,1,1,20,3,GK,30-34,Goalkeeper,Spain,Europe
913,Salvador Ferrer,ESP,Spezia,Serie A,2022,24.0,1998.0,1.5,4,2,2,2,0,1,3,33.3,2,3,1,2,1,5,4,0,DF,20-24,Defender,Spain,Europe
915,Fidel,ESP,Elche,La Liga,2022,32.0,1989.0,19.0,15,10,8,5,2,4,38,10.5,34,9,0,9,5,20,8,0,"MF,FW",30-34,Midfielder,Spain,Europe
916,Karol Fila,POL,Strasbourg,Ligue 1,2022,24.0,1998.0,0.5,0,0,0,0,0,0,0,,0,0,0,0,1,1,1,0,DF,20-24,Defender,Poland,Europe
933,Pablo Fornals,ESP,West Ham,Premier League,2022,26.0,1996.0,16.7,30,15,9,12,9,13,34,38.2,21,16,2,14,14,44,9,0,"FW,MF",25-29,Forward,Spain,Europe
945,Przemysław Frankowski,POL,Lens,Ligue 1,2022,27.0,1995.0,31.5,77,51,37,31,9,39,80,48.8,41,38,6,32,41,118,42,2,"DF,MF",25-29,Defender,Poland,Europe
951,Iván Fresneda,ESP,Valladolid,La Liga,2022,17.0,2004.0,19.4,48,34,31,13,4,29,47,61.7,18,32,8,24,15,63,60,0,DF,Under 20,Defender,Spain,Europe
967,Javi Galán,ESP,Celta Vigo,La Liga,2022,27.0,1994.0,35.1,104,72,60,40,4,48,98,49.0,50,54,5,49,41,145,63,1,DF,25-29,Defender,Spain,Europe
968,Iñigo Ruiz de Galarreta,ESP,Mallorca,La Liga,2022,28.0,1993.0,27.2,54,38,27,23,4,20,52,38.5,32,26,9,17,30,84,19,0,MF,25-29,Midfielder,Spain,Europe
979,Aleix García,ESP,Girona,La Liga,2022,25.0,1997.0,26.0,37,20,9,18,10,15,33,45.5,18,24,8,16,31,68,35,1,MF,25-29,Midfielder,Spain,Europe
980,Álvaro García,ESP,Rayo Vallecano,La Liga,2022,29.0,1992.0,31.9,49,28,21,13,15,11,33,33.3,22,41,4,37,34,83,24,1,"FW,MF",25-29,Forward,Spain,Europe
980,Álvaro García,ESP,Rayo Vallecano,La Liga,2022,29.0,1992.0,31.9,49,28,21,13,15,11,33,33.3,22,41,4,37,34,83,24,1,"FW,MF",25-29,Forward,Spain,Europe
980,Álvaro García,ESP,Rayo Vallecano,La Liga,2022,29.0,1992.0,31.9,49,28,21,13,15,11,33,33.3,22,41,4,37,34,83,24,1,"FW,MF",25-29,Forward,Spain,Europe
980,Álvaro García,ESP,Rayo Vallecano,La Liga,2022,29.0,1992.0,31.9,49,28,21,13,15,11,33,33.3,22,41,4,37,34,83,24,1,"FW,MF",25-29,Forward,Spain,Europe
980,Álvaro García,ESP,Rayo Vallecano,La Liga,2022,29.0,1992.0,31.9,49,28,21,13,15,11,33,33.3,22,41,4,37,34,83,24,1,"FW,MF",25-29,Forward,Spain,Europe
980,Álvaro García,ESP,Rayo Vallecano,La Liga,2022,29.0,1992.0,31.9,49,28,21,13,15,11,33,33.3,22,41,4,37,34,83,24,1,"FW,MF",25-29,Forward,Spain,Europe
980,Álvaro García,ESP,Rayo Vallecano,La Liga,2022,29.0,1992.0,31.9,49,28,21,13,15,11,33,33.3,22,41,4,37,34,83,24,1,"FW,MF",25-29,Forward,Spain,Europe
980,Álvaro García,ESP,Rayo Vallecano,La Liga,2022,29.0,1992.0,31.9,49,28,21,13,15,11,33,33.3,22,41,4,37,34,83,24,1,"FW,MF",25-29,Forward,Spain,Europe
980,Álvaro García,ESP,Rayo Vallecano,La Liga,2022,29.0,1992.0,31.9,49,28,21,13,15,11,33,33.3,22,41,4,37,34,83,24,1,"FW,MF",25-29,Forward,Spain,Europe
980,Álvaro García,ESP,Rayo Vallecano,La Liga,2022,29.0,1992.0,31.9,49,28,21,13,15,11,33,33.3,22,41,4,37,34,83,24,1,"FW,MF",25-29,Forward,Spain,Europe
980,Álvaro García,ESP,Rayo Vallecano,La Liga,2022,29.0,1992.0,31.9,49,28,21,13,15,11,33,33.3,22,41,4,37,34,83,24,1,"FW,MF",25-29,Forward,Spain,Europe
980,Álvaro García,ESP,Rayo Vallecano,La Liga,2022,29.0,1992.0,31.9,49,28,21,13,15,11,33,33.3,22,41,4,37,34,83,24,1,"FW,MF",25-29,Forward,Spain,Europe
980,Álvaro García,ESP,Rayo Vallecano,La Liga,2022,29.0,1992.0,31.9,49,28,21,13,15,11,33,33.3,22,41,4,37,34,83,24,1,"FW,MF",25-29,Forward,Spain,Europe
980,Álvaro García,ESP,Rayo Vallecano,La Liga,2022,29.0,1992.0,31.9,49,28,21,13,15,11,33,33.3,22,41,4,37,34,83,24,1,"FW,MF",25-29,Forward,Spain,Europe
980,Álvaro García,ESP,Rayo Vallecano,La Liga,2022,29.0,1992.0,31.9,49,28,21,13,15,11,33,33.3,22,41,4,37,34,83,24,1,"FW,MF",25-29,Forward,Spain,Europe
980,Álvaro García,ESP,Rayo Vallecano,La Liga,2022,29.0,1992.0,31.9,49,28,21,13,15,11,33,33.3,22,41,4,37,34,83,24,1,"FW,MF",25-29,Forward,Spain,Europe
981,Borja García,ESP,Girona,La Liga,2022,31.0,1990.0,7.5,10,4,7,2,1,2,9,22.2,7,3,1,2,5,15,6,1,"MF,FW",30-34,Midfielder,Spain,Europe
982,Carlos García,ESP,Cádiz,La Liga,2022,22.0,2000.0,0.3,0,0,0,0,0,0,0,,0,0,0,0,0,0,2,0,DF,20-24,Defender,Spain,Europe
982,Carlos García,ESP,Cádiz,La Liga,2022,22.0,2000.0,0.3,0,0,0,0,0,0,0,,0,0,0,0,0,0,2,0,DF,20-24,Defender,Spain,Europe
982,Carlos García,ESP,Cádiz,La Liga,2022,22.0,2000.0,0.3,0,0,0,0,0,0,0,,0,0,0,0,0,0,2,0,DF,20-24,Defender,Spain,Europe
982,Carlos García,ESP,Cádiz,La Liga,2022,22.0,2000.0,0.3,0,0,0,0,0,0,0,,0,0,0,0,0,0,2,0,DF,20-24,Defender,Spain,Europe
982,Carlos García,ESP,Cádiz,La Liga,2022,22.0,2000.0,0.3,0,0,0,0,0,0,0,,0,0,0,0,0,0,2,0,DF,20-24,Defender,Spain,Europe
982,Carlos García,ESP,Cádiz,La Liga,2022,22.0,2000.0,0.3,0,0,0,0,0,0,0,,0,0,0,0,0,0,2,0,DF,20-24,Defender,Spain,Europe
982,Carlos García,ESP,Cádiz,La Liga,2022,22.0,2000.0,0.3,0,0,0,0,0,0,0,,0,0,0,0,0,0,2,0,DF,20-24,Defender,Spain,Europe
982,Carlos García,ESP,Cádiz,La Liga,2022,22.0,2000.0,0.3,0,0,0,0,0,0,0,,0,0,0,0,0,0,2,0,DF,20-24,Defender,Spain,Europe
982,Carlos García,ESP,Cádiz,La Liga,2022,22.0,2000.0,0.3,0,0,0,0,0,0,0,,0,0,0,0,0,0,2,0,DF,20-24,Defender,Spain,Europe
983,Dani García,ESP,Athletic Club,La Liga,2022,32.0,1990.0,16.5,46,27,17,25,4,29,47,61.7,18,21,6,15,19,65,21,1,MF,30-34,Midfielder,Spain,Europe
984,David García,ESP,Osasuna,La Liga,2022,28.0,1994.0,29.8,34,20,22,12,0,19,22,86.4,3,28,13,15,45,79,151,0,DF,25-29,Defender,Spain,Europe
984,David García,ESP,Osasuna,La Liga,2022,28.0,1994.0,29.8,34,20,22,12,0,19,22,86.4,3,28,13,15,45,79,151,0,DF,25-29,Defender,Spain,Europe
984,David García,ESP,Osasuna,La Liga,2022,28.0,1994.0,29.8,34,20,22,12,0,19,22,86.4,3,28,13,15,45,79,151,0,DF,25-29,Defender,Spain,Europe
984,David García,ESP,Osasuna,La Liga,2022,28.0,1994.0,29.8,34,20,22,12,0,19,22,86.4,3,28,13,15,45,79,151,0,DF,25-29,Defender,Spain,Europe
985,Eric García,ESP,Barcelona,La Liga,2022,21.0,2001.0,15.7,24,16,16,5,3,9,20,45.0,11,23,10,13,19,43,36,1,"DF,MF",20-24,Defender,Spain,Europe
986,Fran Garcia,ESP,Rayo Vallecano,La Liga,2022,22.0,1999.0,37.9,84,54,53,23,8,55,96,57.3,41,49,8,41,44,128,66,0,DF,20-24,Defender,Spain,Europe
987,Joan García,ESP,Espanyol,La Liga,2022,21.0,2001.0,1.0,0,0,0,0,0,0,0,,0,0,0,0,0,0,0,0,GK,20-24,Goalkeeper,Spain,Europe
988,Raúl García,ESP,Athletic Club,La Liga,2022,36.0,1986.0,10.7,12,8,3,4,5,5,15,33.3,10,13,1,12,6,18,9,0,"FW,MF",35-39,Forward,Spain,Europe
988,Raúl García,ESP,Athletic Club,La Liga,2022,36.0,1986.0,10.7,12,8,3,4,5,5,15,33.3,10,13,1,12,6,18,9,0,"FW,MF",35-39,Forward,Spain,Europe
988,Raúl García,ESP,Athletic Club,La Liga,2022,36.0,1986.0,10.7,12,8,3,4,5,5,15,33.3,10,13,1,12,6,18,9,0,"FW,MF",35-39,Forward,Spain,Europe
988,Raúl García,ESP,Athletic Club,La Liga,2022,36.0,1986.0,10.7,12,8,3,4,5,5,15,33.3,10,13,1,12,6,18,9,0,"FW,MF",35-39,Forward,Spain,Europe
989,Rubén García,ESP,Osasuna,La Liga,2022,29.0,1993.0,12.9,20,11,12,4,4,7,24,29.2,17,14,1,13,12,32,13,0,"FW,MF",25-29,Forward,Spain,Europe
989,Rubén García,ESP,Osasuna,La Liga,2022,29.0,1993.0,12.9,20,11,12,4,4,7,24,29.2,17,14,1,13,12,32,13,0,"FW,MF",25-29,Forward,Spain,Europe
989,Rubén García,ESP,Osasuna,La Liga,2022,29.0,1993.0,12.9,20,11,12,4,4,7,24,29.2,17,14,1,13,12,32,13,0,"FW,MF",25-29,Forward,Spain,Europe
989,Rubén García,ESP,Osasuna,La Liga,2022,29.0,1993.0,12.9,20,11,12,4,4,7,24,29.2,17,14,1,13,12,32,13,0,"FW,MF",25-29,Forward,Spain,Europe
990,Unai García,ESP,Osasuna,La Liga,2022,30.0,1992.0,19.0,23,13,13,8,2,12,17,70.6,5,23,14,9,19,42,60,2,DF,30-34,Defender,Spain,Europe
993,Felix Garreta,ESP,Betis,La Liga,2022,18.0,2004.0,1.0,1,0,0,1,0,0,0,,0,1,1,0,1,2,4,0,DF,Under 20,Defender,Spain,Europe
994,Aleix Garrido,ESP,Barcelona,La Liga,2022,18.0,2004.0,0.1,2,1,1,0,1,1,1,100.0,0,1,0,1,0,2,0,0,FW,Under 20,Forward,Spain,Europe
998,Gavi,ESP,Barcelona,La Liga,2022,17.0,2004.0,28.1,47,31,7,30,10,21,55,38.2,34,32,5,27,18,65,22,0,"MF,FW",Under 20,Midfielder,Spain,Europe
1000,David de Gea,ESP,Manchester Utd,Premier League,2022,31.0,1990.0,38.0,0,0,0,0,0,0,1,0.0,1,0,0,0,1,1,15,3,GK,30-34,Goalkeeper,Spain,Europe
1009,Ismaël Gharbi,ESP,Paris S-G,Ligue 1,2022,18.0,2004.0,0.6,0,0,0,0,0,0,2,0.0,2,2,0,2,3,3,0,0,"MF,FW",Under 20,Midfielder,Spain,Europe
1017,Rafał Gikiewicz,POL,Augsburg,Bundesliga,2022,34.0,1987.0,23.0,2,2,2,0,0,2,3,66.7,1,0,0,0,0,2,15,5,GK,30-34,Goalkeeper,Poland,Europe
1018,Bryan Gil,ESP,Tottenham,Premier League,2022,21.0,2001.0,1.6,3,1,3,0,0,0,3,0.0,3,3,0,3,1,4,1,0,"MF,FW",20-24,Midfielder,Spain,Europe
1019,Bryan Gil,ESP,Sevilla,La Liga,2022,21.0,2001.0,10.2,22,11,11,7,4,10,23,43.5,13,10,0,10,8,30,10,0,"FW,DF",20-24,Forward,Spain,Europe
1020,David Gil,ESP,Cádiz,La Liga,2022,28.0,1994.0,4.0,0,0,0,0,0,0,0,,0,0,0,0,0,0,3,0,GK,25-29,Goalkeeper,Spain,Europe
1021,Óscar Gil,ESP,Espanyol,La Liga,2022,25.0,1997.0,28.4,63,37,38,16,9,32,61,52.5,29,51,18,33,31,94,55,1,DF,25-29,Defender,Spain,Europe
1021,Óscar Gil,ESP,Espanyol,La Liga,2022,25.0,1997.0,28.4,63,37,38,16,9,32,61,52.5,29,51,18,33,31,94,55,1,DF,25-29,Defender,Spain,Europe
1021,Óscar Gil,ESP,Espanyol,La Liga,2022,25.0,1997.0,28.4,63,37,38,16,9,32,61,52.5,29,51,18,33,31,94,55,1,DF,25-29,Defender,Spain,Europe
1021,Óscar Gil,ESP,Espanyol,La Liga,2022,25.0,1997.0,28.4,63,37,38,16,9,32,61,52.5,29,51,18,33,31,94,55,1,DF,25-29,Defender,Spain,Europe
1022,Mario Gila,ESP,Lazio,Serie A,2022,21.0,2000.0,1.0,3,1,3,0,0,0,1,0.0,1,0,0,0,3,6,3,0,DF,20-24,Defender,Spain,Europe
1024,Álvaro Giménez,ESP,Cádiz,La Liga,2022,31.0,1991.0,0.2,0,0,0,0,0,0,1,0.0,1,0,0,0,0,0,0,0,FW,30-34,Forward,Spain,Europe
1040,Dani Gómez,ESP,Espanyol,La Liga,2022,24.0,1998.0,1.0,2,1,1,1,0,1,2,50.0,1,0,0,0,1,3,0,0,"MF,FW",20-24,Midfielder,Spain,Europe
1043,Moi Gómez,ESP,Osasuna,La Liga,2022,28.0,1994.0,27.3,26,17,9,14,3,15,32,46.9,17,15,3,12,10,36,5,1,"MF,FW",25-29,Midfielder,Spain,Europe
1045,Sergi Gómez,ESP,Espanyol,La Liga,2022,30.0,1992.0,26.0,29,16,20,9,0,18,22,81.8,4,33,19,14,27,56,125,1,DF,30-34,Defender,Spain,Europe
1046,Sergio Gómez,ESP,Manchester City,Premier League,2022,21.0,2000.0,3.9,9,4,6,1,2,5,8,62.5,3,5,3,2,2,11,9,1,"DF,MF",20-24,Defender,Spain,Europe
1047,Antonio Gomis,ESP,Atlético Madrid,La Liga,2022,19.0,2003.0,0.1,0,0,0,0,0,0,0,,0,0,0,0,0,0,0,0,GK,Under 20,Goalkeeper,Spain,Europe
1049,Diego González,ESP,Elche,La Liga,2022,27.0,1995.0,10.6,12,7,9,3,0,7,11,63.6,4,14,12,2,7,19,50,1,DF,25-29,Defender,Spain,Europe
1049,Diego González,ESP,Elche,La Liga,2022,27.0,1995.0,10.6,12,7,9,3,0,7,11,63.6,4,14,12,2,7,19,50,1,DF,25-29,Defender,Spain,Europe
1049,Diego González,ESP,Elche,La Liga,2022,27.0,1995.0,10.6,12,7,9,3,0,7,11,63.6,4,14,12,2,7,19,50,1,DF,25-29,Defender,Spain,Europe
1049,Diego González,ESP,Elche,La Liga,2022,27.0,1995.0,10.6,12,7,9,3,0,7,11,63.6,4,14,12,2,7,19,50,1,DF,25-29,Defender,Spain,Europe
1050,Édgar González,ESP,Betis,La Liga,2022,25.0,1997.0,19.7,28,19,18,7,3,14,27,51.9,13,12,9,3,21,49,120,0,DF,25-29,Defender,Spain,Europe
1052,Joan Gonzàlez,ESP,Lecce,Serie A,2022,20.0,2002.0,24.4,48,28,20,18,10,17,51,33.3,34,37,8,29,16,64,28,0,MF,20-24,Midfielder,Spain,Europe
1054,Nicolás González,ESP,Valencia,La Liga,2022,20.0,2002.0,15.6,27,15,11,13,3,9,25,36.0,16,21,7,14,19,46,16,0,MF,20-24,Midfielder,Spain,Europe
1056,Roberto González,ESP,Betis,La Liga,2022,21.0,2001.0,0.6,0,0,0,0,0,0,1,0.0,1,0,0,0,1,1,0,0,"FW,MF",20-24,Forward,Spain,Europe
1057,Jacek Góralski,POL,Bochum,Bundesliga,2022,29.0,1992.0,1.6,6,3,3,3,0,4,6,66.7,2,4,0,4,3,9,5,0,MF,25-29,Midfielder,Poland,Europe
1061,Andoni Gorosabel,ESP,Real Sociedad,La Liga,2022,25.0,1996.0,19.0,41,25,23,9,9,26,43,60.5,17,21,2,19,17,58,23,0,DF,25-29,Defender,Spain,Europe
1068,José Gragera,ESP,Espanyol,La Liga,2022,21.0,2000.0,5.1,19,9,11,6,2,6,11,54.5,5,10,4,6,7,26,18,0,"MF,DF",20-24,Midfielder,Spain,Europe
1090,Vicente Guaita,ESP,Crystal Palace,Premier League,2022,35.0,1987.0,27.0,0,0,0,0,0,0,0,,0,0,0,0,0,0,9,1,GK,35-39,Goalkeeper,Spain,Europe
1092,Sergi Guardiola,ESP,Valladolid,La Liga,2022,31.0,1991.0,5.6,12,7,6,5,1,2,4,50.0,2,6,0,6,2,14,7,0,FW,30-34,Forward,Spain,Europe
1093,Sergi Guardiola,ESP,Cádiz,La Liga,2022,31.0,1991.0,12.9,9,7,0,6,3,3,12,25.0,9,5,0,5,3,12,7,0,FW,30-34,Forward,Spain,Europe
1094,Nemanja Gudelj,SRB,Sevilla,La Liga,2022,30.0,1991.0,30.9,43,33,22,18,3,20,33,60.6,13,39,29,10,34,77,102,1,"DF,MF",30-34,Defender,Serbia,Europe
1100,Javier Guerra,ESP,Valencia,La Liga,2022,19.0,2003.0,6.7,16,13,7,4,5,9,20,45.0,11,8,1,7,11,27,9,0,MF,Under 20,Midfielder,Spain,Europe
1104,Ander Guevara,ESP,Real Sociedad,La Liga,2022,25.0,1997.0,2.5,5,2,2,2,1,1,4,25.0,3,6,1,5,2,7,3,0,MF,25-29,Midfielder,Spain,Europe
1109,Hugo Guillamón,ESP,Valencia,La Liga,2022,22.0,2000.0,18.1,20,12,10,8,2,8,24,33.3,16,14,2,12,19,39,30,2,MF,20-24,Midfielder,Spain,Europe
1116,Gerard Gumbau,ESP,Elche,La Liga,2022,27.0,1994.0,30.4,44,25,17,23,4,18,51,35.3,33,32,8,24,28,72,40,0,MF,25-29,Midfielder,Spain,Europe
1117,Robert Gumny,POL,Augsburg,Bundesliga,2022,24.0,1998.0,22.4,34,24,13,15,6,11,27,40.7,16,21,7,14,26,60,62,1,DF,20-24,Defender,Poland,Europe
1122,Gorka Guruzeta,ESP,Athletic Club,La Liga,2022,25.0,1996.0,15.8,24,20,6,12,6,11,24,45.8,13,23,2,21,4,28,8,0,FW,25-29,Forward,Spain,Europe
1124,Raúl Guti,ESP,Elche,La Liga,2022,25.0,1996.0,12.4,18,12,8,9,1,8,18,44.4,10,10,3,7,8,26,6,0,MF,25-29,Midfielder,Spain,Europe
1125,Miguel Gutiérrez,ESP,Girona,La Liga,2022,21.0,2001.0,26.6,41,23,23,13,5,23,37,62.2,14,23,5,18,18,59,42,1,DF,20-24,Defender,Spain,Europe
1131,Erling Haaland,NOR,Manchester City,Premier League,2022,22.0,2000.0,30.8,3,2,0,2,1,1,5,20.0,4,12,4,8,3,6,14,0,FW,20-24,Forward,Norway,Europe
1149,Andreas Hanche-Olsen,NOR,Mainz 05,Bundesliga,2022,25.0,1997.0,16.6,35,23,24,7,4,22,39,56.4,17,16,8,8,33,68,77,2,DF,25-29,Defender,Norway,Europe
1150,Samir Handanović,SVN,Inter,Serie A,2022,38.0,1984.0,13.7,0,0,0,0,0,0,0,,0,0,0,0,0,0,5,0,GK,35-39,Goalkeeper,Slovenia,Europe
1181,Mario Hermoso,ESP,Atlético Madrid,La Liga,2022,27.0,1995.0,23.4,22,15,14,6,2,9,30,30.0,21,19,9,10,19,41,85,1,DF,25-29,Defender,Spain,Europe
1182,Javi Hernández,ESP,Girona,La Liga,2022,24.0,1998.0,12.4,21,12,12,7,2,13,21,61.9,8,10,5,5,7,28,38,0,DF,20-24,Defender,Spain,Europe
1183,Aridane Hernández,ESP,Osasuna,La Liga,2022,33.0,1989.0,19.9,21,15,17,4,0,12,25,48.0,13,34,21,13,28,49,96,1,DF,30-34,Defender,Spain,Europe
1185,Luis Hernández,ESP,Cádiz,La Liga,2022,33.0,1989.0,35.0,33,21,25,7,1,22,36,61.1,14,31,24,7,31,64,145,0,DF,30-34,Defender,Spain,Europe
1186,Mario Hernández,ESP,Rayo Vallecano,La Liga,2022,23.0,1999.0,1.1,3,2,2,1,0,3,7,42.9,4,2,0,2,2,5,0,0,DF,20-24,Defender,Spain,Europe
1188,Jorge Herrando,ESP,Osasuna,La Liga,2022,21.0,2001.0,0.3,0,0,0,0,0,0,0,,0,1,0,1,0,0,3,0,DF,20-24,Defender,Spain,Europe
1189,Ander Herrera,ESP,Athletic Club,La Liga,2022,32.0,1989.0,7.7,18,10,8,7,3,6,18,33.3,12,12,3,9,11,29,12,0,MF,30-34,Midfielder,Spain,Europe
1190,Sergio Herrera,ESP,Osasuna,La Liga,2022,29.0,1993.0,17.0,2,0,2,0,0,2,2,100.0,0,1,0,1,1,3,6,2,GK,25-29,Goalkeeper,Spain,Europe
1200,Adam Hložek,CZE,Leverkusen,Bundesliga,2022,20.0,2002.0,14.3,9,4,4,3,2,3,9,33.3,6,9,2,7,6,15,9,0,"FW,MF",20-24,Forward,Czech Republic,Europe
1209,Noah Holm,NOR,Reims,Ligue 1,2022,21.0,2001.0,2.2,6,4,2,2,2,2,5,40.0,3,0,0,0,0,6,5,0,"FW,MF",20-24,Forward,Norway,Europe
1231,Pablo Ibáñez,ESP,Osasuna,La Liga,2022,23.0,1998.0,11.8,29,13,7,17,5,12,35,34.3,23,19,2,17,8,37,24,0,MF,20-24,Midfielder,Spain,Europe
1237,Iglesias,ESP,Getafe,La Liga,2022,24.0,1998.0,23.8,61,35,40,18,3,33,65,50.8,32,40,5,35,21,82,91,1,"DF,MF",20-24,Defender,Spain,Europe
1238,Borja Iglesias,ESP,Betis,La Liga,2022,29.0,1993.0,26.3,8,4,3,3,2,2,13,15.4,11,9,1,8,1,9,17,0,FW,25-29,Forward,Spain,Europe
1242,Ivan Ilić,SRB,Hellas Verona,Serie A,2022,21.0,2001.0,9.5,16,10,9,7,0,6,11,54.5,5,10,1,9,8,24,14,0,MF,20-24,Midfielder,Serbia,Europe
1243,Ivan Ilić,SRB,Torino,Serie A,2022,21.0,2001.0,13.1,18,7,6,11,1,10,20,50.0,10,12,3,9,5,23,10,0,MF,20-24,Midfielder,Serbia,Europe
1248,Asier Illarramendi,ESP,Real Sociedad,La Liga,2022,32.0,1990.0,12.0,36,18,10,22,4,16,44,36.4,28,27,8,19,18,54,20,0,MF,30-34,Midfielder,Spain,Europe
1256,Isco,ESP,Sevilla,La Liga,2022,30.0,1992.0,8.9,15,9,6,5,4,8,14,57.1,6,3,0,3,10,25,3,0,"MF,FW",30-34,Midfielder,Spain,Europe
1262,Diego Iturralde,ESP,Sevilla,La Liga,2022,19.0,2003.0,0.5,1,0,1,0,0,0,2,0.0,2,0,0,0,0,1,1,0,DF,Under 20,Defender,Spain,Europe
1264,Mihailo Ivanović,SRB,Sampdoria,Serie A,2022,17.0,2004.0,0.0,0,0,0,0,0,0,0,,0,0,0,0,0,0,0,0,FW,Under 20,Forward,Serbia,Europe
1292,Jesé,ESP,Sampdoria,Serie A,2022,29.0,1993.0,2.3,2,0,0,2,0,0,1,0.0,1,3,1,2,1,3,2,0,FW,25-29,Forward,Spain,Europe
1296,Joaquín,ESP,Betis,La Liga,2022,41.0,1981.0,5.5,3,3,2,1,0,1,3,33.3,2,7,2,5,4,7,5,0,"MF,FW",Over 40,Midfielder,Spain,Europe
1305,Joan Jordán,ESP,Sevilla,La Liga,2022,28.0,1994.0,17.7,32,17,13,17,2,16,38,42.1,22,14,7,7,16,48,14,2,MF,25-29,Midfielder,Spain,Europe
1308,Josan,ESP,Elche,La Liga,2022,32.0,1989.0,12.0,25,20,20,5,0,14,27,51.9,13,8,0,8,7,32,15,1,"DF,MF",30-34,Defender,Spain,Europe
1310,Joselu,ESP,Espanyol,La Liga,2022,32.0,1990.0,33.2,13,11,3,4,6,4,17,23.5,13,25,4,21,8,21,43,0,FW,30-34,Forward,Spain,Europe
1311,Mateo Joseph,ESP,Leeds United,Premier League,2022,18.0,2003.0,0.3,0,0,0,0,0,0,0,,0,1,0,1,0,0,1,0,"FW,MF",Under 20,Forward,Spain,Europe
1314,Luka Jović,SRB,Fiorentina,Serie A,2022,24.0,1997.0,17.0,6,3,1,4,1,2,8,25.0,6,7,2,5,2,8,10,0,"FW,MF",20-24,Forward,Serbia,Europe
1315,Juanmi,ESP,Betis,La Liga,2022,29.0,1993.0,10.3,14,10,4,7,3,7,31,22.6,24,10,0,10,4,18,4,0,FW,25-29,Forward,Spain,Europe
1316,Juanpe,ESP,Girona,La Liga,2022,31.0,1991.0,15.8,19,11,10,9,0,11,17,64.7,6,12,9,3,10,29,60,1,DF,30-34,Defender,Spain,Europe
1332,Pavel Kadeřábek,CZE,Hoffenheim,Bundesliga,2022,30.0,1992.0,18.5,26,20,10,9,7,15,23,65.2,8,12,2,10,14,40,37,1,DF,30-34,Defender,Czech Republic,Europe
1345,Waren Kamanzi,NOR,Toulouse,Ligue 1,2022,21.0,2000.0,7.4,16,9,9,5,2,13,19,68.4,6,8,2,6,8,24,9,0,DF,20-24,Defender,Norway,Europe
1348,Jakub Kamiński,POL,Wolfsburg,Bundesliga,2022,20.0,2002.0,22.9,36,25,15,13,8,20,40,50.0,20,37,2,35,8,44,15,0,"FW,DF",20-24,Forward,Poland,Europe
1349,Marcin Kamiński,POL,Schalke 04,Bundesliga,2022,30.0,1992.0,7.0,6,4,4,0,2,2,4,50.0,2,8,7,1,9,15,28,0,DF,30-34,Defender,Poland,Europe
1350,Kevin Kampl,SVN,RB Leipzig,Bundesliga,2022,31.0,1990.0,15.2,21,11,6,14,1,6,27,22.2,21,26,9,17,22,43,11,0,MF,30-34,Midfielder,Slovenia,Europe
1360,Jon Karrikaburu,ESP,Real Sociedad,La Liga,2022,19.0,2002.0,1.0,1,0,0,1,0,0,0,,0,2,0,2,0,1,0,0,FW,Under 20,Forward,Spain,Europe
1384,Kiké,ESP,Osasuna,La Liga,2022,32.0,1989.0,11.3,6,3,0,4,2,2,5,40.0,3,6,1,5,1,7,13,0,FW,30-34,Forward,Spain,Europe
1389,Jakub Kiwior,POL,Arsenal,Premier League,2022,22.0,2000.0,4.7,7,5,6,1,0,5,8,62.5,3,5,3,2,6,13,10,0,DF,20-24,Defender,Poland,Europe
1390,Jakub Kiwior,POL,Spezia,Serie A,2022,22.0,2000.0,16.0,22,17,15,7,0,6,24,25.0,18,26,18,8,24,46,71,1,DF,20-24,Defender,Poland,Europe
1393,Mateusz Klich,POL,Leeds United,Premier League,2022,32.0,1990.0,3.1,12,8,3,4,5,7,13,53.8,6,4,0,4,0,12,1,0,"MF,FW",30-34,Midfielder,Poland,Europe
1403,Koke,ESP,Atlético Madrid,La Liga,2022,30.0,1992.0,28.3,55,38,23,25,7,28,72,38.9,44,35,13,22,20,75,19,0,MF,30-34,Midfielder,Spain,Europe
1417,Filip Kostić,SRB,Juventus,Serie A,2022,29.0,1992.0,28.5,41,26,17,20,4,21,47,44.7,26,30,4,26,16,57,32,0,"DF,FW",25-29,Defender,Serbia,Europe
1418,Filip Kostić,SRB,Eint Frankfurt,Bundesliga,2022,29.0,1992.0,0.8,2,0,1,1,0,0,0,,0,0,0,0,1,3,0,0,"DF,MF",25-29,Defender,Serbia,Europe
1421,Tomáš Koubek,CZE,Augsburg,Bundesliga,2022,29.0,1992.0,11.0,0,0,0,0,0,0,0,,0,0,0,0,0,0,7,0,GK,25-29,Goalkeeper,Czech Republic,Europe
1430,Alex Král,CZE,Schalke 04,Bundesliga,2022,24.0,1998.0,26.2,34,24,10,22,2,17,37,45.9,20,31,6,25,17,51,53,0,MF,20-24,Midfielder,Czech Republic,Europe
1435,Julian Kristoffersen,NOR,Salernitana,Serie A,2022,25.0,1997.0,0.2,0,0,0,0,0,0,0,,0,1,0,1,0,0,0,0,FW,25-29,Forward,Norway,Europe
1453,César de la Hoz,ESP,Almería,La Liga,2022,30.0,1992.0,18.6,37,20,17,18,2,19,37,51.4,18,26,6,20,13,50,37,0,MF,30-34,Midfielder,Spain,Europe
1474,Aymeric Laporte,ESP,Manchester City,Premier League,2022,28.0,1994.0,11.0,11,8,6,4,1,7,11,63.6,4,10,4,6,3,14,30,1,DF,25-29,Defender,Spain,Europe
1477,Juan Larios,ESP,Southampton,Premier League,2022,18.0,2004.0,1.7,7,6,6,1,0,5,5,100.0,0,2,0,2,3,10,4,0,DF,Under 20,Defender,Spain,Europe
1482,Juanmi Latasa,ESP,Getafe,La Liga,2022,21.0,2001.0,5.0,5,4,2,0,3,1,1,100.0,0,3,1,2,1,6,8,0,FW,20-24,Forward,Spain,Europe
1483,Toni Lato,ESP,Valencia,La Liga,2022,24.0,1997.0,10.2,23,11,9,12,2,9,21,42.9,12,10,1,9,6,29,14,0,"DF,MF",20-24,Defender,Spain,Europe
1490,Marko Lazetić,SRB,Milan,Serie A,2022,18.0,2004.0,0.1,0,0,0,0,0,0,0,,0,0,0,0,0,0,0,0,FW,Under 20,Forward,Serbia,Europe
1491,Darko Lazović,SRB,Hellas Verona,Serie A,2022,31.0,1990.0,24.9,24,13,9,12,3,13,29,44.8,16,14,3,11,16,40,19,0,"MF,DF",30-34,Midfielder,Serbia,Europe
1499,Robin Le Normand,ESP,Real Sociedad,La Liga,2022,25.0,1996.0,31.1,36,23,25,9,2,14,27,51.9,13,22,14,8,33,69,93,0,DF,25-29,Defender,Spain,Europe
1510,Iñigo Lekue,ESP,Athletic Club,La Liga,2022,29.0,1993.0,14.7,24,17,20,4,0,12,19,63.2,7,16,2,14,13,37,31,1,DF,25-29,Defender,Spain,Europe
1521,Sergio León,ESP,Valladolid,La Liga,2022,33.0,1989.0,14.8,6,4,0,4,2,3,6,50.0,3,6,0,6,0,6,4,0,FW,30-34,Forward,Spain,Europe
1529,Robert Lewandowski,POL,Barcelona,La Liga,2022,33.0,1988.0,31.6,17,11,2,5,10,7,14,50.0,7,20,0,20,2,19,14,0,FW,30-34,Forward,Poland,Europe
1531,Jamal Lewis,NIR,Newcastle Utd,Premier League,2022,24.0,1998.0,0.1,0,0,0,0,0,0,0,,0,0,0,0,0,0,0,0,"DF,FW",20-24,Defender,Northern Ireland,Europe
1540,Karol Linetty,POL,Torino,Serie A,2022,27.0,1995.0,21.0,32,17,7,22,3,13,25,52.0,12,28,8,20,19,51,25,0,MF,25-29,Midfielder,Poland,Europe
1543,Pol Lirola,ESP,Elche,La Liga,2022,24.0,1997.0,7.0,13,6,9,3,1,8,13,61.5,5,3,2,1,7,20,16,0,DF,20-24,Defender,Spain,Europe
1544,Mateusz Lis,POL,Troyes,Ligue 1,2022,25.0,1997.0,8.3,0,0,0,0,0,0,1,0.0,1,1,0,1,0,0,3,0,GK,25-29,Goalkeeper,Poland,Europe
1545,Marcin Listkowski,POL,Lecce,Serie A,2022,24.0,1998.0,0.9,0,0,0,0,0,0,0,,0,0,0,0,3,3,2,0,"MF,FW",20-24,Midfielder,Poland,Europe
1548,Javier Llabrés,ESP,Mallorca,La Liga,2022,19.0,2002.0,0.2,0,0,0,0,0,0,0,,0,0,0,0,0,0,1,0,FW,Under 20,Forward,Spain,Europe
1549,Diego Llorente,ESP,Leeds United,Premier League,2022,28.0,1993.0,7.2,13,10,8,5,0,4,8,50.0,4,6,2,4,15,28,24,2,DF,25-29,Defender,Spain,Europe
1549,Diego Llorente,ESP,Leeds United,Premier League,2022,28.0,1993.0,7.2,13,10,8,5,0,4,8,50.0,4,6,2,4,15,28,24,2,DF,25-29,Defender,Spain,Europe
1549,Diego Llorente,ESP,Leeds United,Premier League,2022,28.0,1993.0,7.2,13,10,8,5,0,4,8,50.0,4,6,2,4,15,28,24,2,DF,25-29,Defender,Spain,Europe
1549,Diego Llorente,ESP,Leeds United,Premier League,2022,28.0,1993.0,7.2,13,10,8,5,0,4,8,50.0,4,6,2,4,15,28,24,2,DF,25-29,Defender,Spain,Europe
1550,Diego Llorente,ESP,Roma,Serie A,2022,28.0,1993.0,6.4,10,5,6,4,0,5,12,41.7,7,4,2,2,11,21,20,0,DF,25-29,Defender,Spain,Europe
1550,Diego Llorente,ESP,Roma,Serie A,2022,28.0,1993.0,6.4,10,5,6,4,0,5,12,41.7,7,4,2,2,11,21,20,0,DF,25-29,Defender,Spain,Europe
1550,Diego Llorente,ESP,Roma,Serie A,2022,28.0,1993.0,6.4,10,5,6,4,0,5,12,41.7,7,4,2,2,11,21,20,0,DF,25-29,Defender,Spain,Europe
1550,Diego Llorente,ESP,Roma,Serie A,2022,28.0,1993.0,6.4,10,5,6,4,0,5,12,41.7,7,4,2,2,11,21,20,0,DF,25-29,Defender,Spain,Europe
1551,Marcos Llorente,ESP,Atlético Madrid,La Liga,2022,27.0,1995.0,18.9,32,15,16,10,6,17,30,56.7,13,26,2,24,17,49,19,0,"MF,DF",25-29,Midfielder,Spain,Europe
1565,David López,ESP,Girona,La Liga,2022,32.0,1989.0,18.4,31,18,17,13,1,19,27,70.4,8,29,19,10,14,45,64,1,DF,30-34,Defender,Spain,Europe
1565,David López,ESP,Girona,La Liga,2022,32.0,1989.0,18.4,31,18,17,13,1,19,27,70.4,8,29,19,10,14,45,64,1,DF,30-34,Defender,Spain,Europe
1565,David López,ESP,Girona,La Liga,2022,32.0,1989.0,18.4,31,18,17,13,1,19,27,70.4,8,29,19,10,14,45,64,1,DF,30-34,Defender,Spain,Europe
1565,David López,ESP,Girona,La Liga,2022,32.0,1989.0,18.4,31,18,17,13,1,19,27,70.4,8,29,19,10,14,45,64,1,DF,30-34,Defender,Spain,Europe
1566,Diego López,ESP,Rayo Vallecano,La Liga,2022,40.0,1981.0,1.1,0,0,0,0,0,0,0,,0,0,0,0,0,0,0,1,GK,Over 40,Goalkeeper,Spain,Europe
1566,Diego López,ESP,Rayo Vallecano,La Liga,2022,40.0,1981.0,1.1,0,0,0,0,0,0,0,,0,0,0,0,0,0,0,1,GK,Over 40,Goalkeeper,Spain,Europe
1566,Diego López,ESP,Rayo Vallecano,La Liga,2022,40.0,1981.0,1.1,0,0,0,0,0,0,0,,0,0,0,0,0,0,0,1,GK,Over 40,Goalkeeper,Spain,Europe
1566,Diego López,ESP,Rayo Vallecano,La Liga,2022,40.0,1981.0,1.1,0,0,0,0,0,0,0,,0,0,0,0,0,0,0,1,GK,Over 40,Goalkeeper,Spain,Europe
1566,Diego López,ESP,Rayo Vallecano,La Liga,2022,40.0,1981.0,1.1,0,0,0,0,0,0,0,,0,0,0,0,0,0,0,1,GK,Over 40,Goalkeeper,Spain,Europe
1566,Diego López,ESP,Rayo Vallecano,La Liga,2022,40.0,1981.0,1.1,0,0,0,0,0,0,0,,0,0,0,0,0,0,0,1,GK,Over 40,Goalkeeper,Spain,Europe
1566,Diego López,ESP,Rayo Vallecano,La Liga,2022,40.0,1981.0,1.1,0,0,0,0,0,0,0,,0,0,0,0,0,0,0,1,GK,Over 40,Goalkeeper,Spain,Europe
1566,Diego López,ESP,Rayo Vallecano,La Liga,2022,40.0,1981.0,1.1,0,0,0,0,0,0,0,,0,0,0,0,0,0,0,1,GK,Over 40,Goalkeeper,Spain,Europe
1566,Diego López,ESP,Rayo Vallecano,La Liga,2022,40.0,1981.0,1.1,0,0,0,0,0,0,0,,0,0,0,0,0,0,0,1,GK,Over 40,Goalkeeper,Spain,Europe
1567,Diego López,ESP,Valencia,La Liga,2022,20.0,2002.0,5.0,2,2,1,1,0,2,15,13.3,13,9,0,9,3,5,5,0,"FW,MF",20-24,Forward,Spain,Europe
1567,Diego López,ESP,Valencia,La Liga,2022,20.0,2002.0,5.0,2,2,1,1,0,2,15,13.3,13,9,0,9,3,5,5,0,"FW,MF",20-24,Forward,Spain,Europe
1567,Diego López,ESP,Valencia,La Liga,2022,20.0,2002.0,5.0,2,2,1,1,0,2,15,13.3,13,9,0,9,3,5,5,0,"FW,MF",20-24,Forward,Spain,Europe
1567,Diego López,ESP,Valencia,La Liga,2022,20.0,2002.0,5.0,2,2,1,1,0,2,15,13.3,13,9,0,9,3,5,5,0,"FW,MF",20-24,Forward,Spain,Europe
1567,Diego López,ESP,Valencia,La Liga,2022,20.0,2002.0,5.0,2,2,1,1,0,2,15,13.3,13,9,0,9,3,5,5,0,"FW,MF",20-24,Forward,Spain,Europe
1567,Diego López,ESP,Valencia,La Liga,2022,20.0,2002.0,5.0,2,2,1,1,0,2,15,13.3,13,9,0,9,3,5,5,0,"FW,MF",20-24,Forward,Spain,Europe
1567,Diego López,ESP,Valencia,La Liga,2022,20.0,2002.0,5.0,2,2,1,1,0,2,15,13.3,13,9,0,9,3,5,5,0,"FW,MF",20-24,Forward,Spain,Europe
1567,Diego López,ESP,Valencia,La Liga,2022,20.0,2002.0,5.0,2,2,1,1,0,2,15,13.3,13,9,0,9,3,5,5,0,"FW,MF",20-24,Forward,Spain,Europe
1567,Diego López,ESP,Valencia,La Liga,2022,20.0,2002.0,5.0,2,2,1,1,0,2,15,13.3,13,9,0,9,3,5,5,0,"FW,MF",20-24,Forward,Spain,Europe
1569,Pau López,ESP,Marseille,Ligue 1,2022,27.0,1994.0,32.5,0,0,0,0,0,0,1,0.0,1,0,0,0,0,0,5,1,GK,25-29,Goalkeeper,Spain,Europe
1570,Unai López,ESP,Rayo Vallecano,La Liga,2022,26.0,1995.0,13.9,32,20,10,17,5,13,37,35.1,24,12,1,11,15,47,6,1,MF,25-29,Midfielder,Spain,Europe
1576,Sandi Lovrić,SVN,Udinese,Serie A,2022,24.0,1998.0,25.9,40,18,16,16,8,25,43,58.1,18,25,2,23,26,66,21,0,MF,20-24,Midfielder,Slovenia,Europe
1578,Anthony Lozano,HON,Cádiz,La Liga,2022,29.0,1993.0,16.0,6,4,1,4,1,1,7,14.3,6,12,1,11,3,9,17,0,FW,25-29,Forward,Honduras,North America
1580,Pol Lozano,ESP,Espanyol,La Liga,2022,22.0,1999.0,0.2,0,0,0,0,0,0,0,,0,1,0,1,0,0,1,0,MF,20-24,Midfielder,Spain,Europe
1583,José Luis Gayà,ESP,Valencia,La Liga,2022,27.0,1995.0,30.1,80,46,61,16,3,43,74,58.1,31,28,9,19,23,103,48,0,DF,25-29,Defender,Spain,Europe
1584,José Luis Morales,ESP,Villarreal,La Liga,2022,35.0,1987.0,13.5,7,6,1,2,4,5,17,29.4,12,12,1,11,2,9,2,0,"FW,MF",35-39,Forward,Spain,Europe
1590,Saša Lukić,SRB,Fulham,Premier League,2022,25.0,1996.0,4.6,8,3,1,4,3,3,7,42.9,4,6,2,4,5,13,3,0,MF,25-29,Midfielder,Serbia,Europe
1591,Saša Lukić,SRB,Torino,Serie A,2022,25.0,1996.0,13.3,21,14,10,10,1,9,15,60.0,6,17,7,10,13,34,10,0,MF,25-29,Midfielder,Serbia,Europe
1597,Youssouf M'Changama,COM,Auxerre,Ligue 1,2022,31.0,1990.0,12.0,22,11,7,12,3,7,13,53.8,6,6,0,6,15,37,6,1,MF,30-34,Midfielder,Comoros,Africa
1604,Pablo Maffeo,ESP,Mallorca,La Liga,2022,25.0,1997.0,33.1,75,46,54,16,5,45,78,57.7,33,38,11,27,26,101,76,0,DF,25-29,Defender,Spain,Europe
1613,Jon Magunacelaya,ESP,Real Sociedad,La Liga,2022,22.0,2000.0,0.7,1,0,0,0,1,0,2,0.0,2,0,0,0,0,1,1,0,"MF,FW",20-24,Midfielder,Spain,Europe
1620,Jordan Majchrzak,POL,Roma,Serie A,2022,17.0,2004.0,0.2,0,0,0,0,0,0,0,,0,0,0,0,0,0,0,0,FW,Under 20,Forward,Poland,Europe
1625,Nemanja Maksimović,SRB,Getafe,La Liga,2022,27.0,1995.0,22.8,41,30,17,18,6,19,32,59.4,13,36,14,22,34,75,27,0,MF,25-29,Midfielder,Serbia,Europe
1634,Hugo Mallo,ESP,Celta Vigo,La Liga,2022,31.0,1991.0,24.0,53,29,34,14,5,28,42,66.7,14,28,7,21,24,77,73,0,DF,30-34,Defender,Spain,Europe
1647,Javier Manquillo,ESP,Newcastle Utd,Premier League,2022,28.0,1994.0,0.4,3,2,2,1,0,2,2,100.0,0,1,0,1,1,4,1,0,DF,25-29,Defender,Spain,Europe
1648,Myziane Maolida,COM,Reims,Ligue 1,2022,23.0,1999.0,2.6,8,3,2,5,1,5,12,41.7,7,1,0,1,2,10,0,0,"MF,FW",20-24,Midfielder,Comoros,Africa
1649,Myziane Maolida,COM,Hertha BSC,Bundesliga,2022,23.0,1999.0,1.1,1,1,1,0,0,1,2,50.0,1,0,0,0,0,1,1,0,"FW,MF",20-24,Forward,Comoros,Africa
1660,Óscar de Marcos,ESP,Athletic Club,La Liga,2022,33.0,1989.0,31.3,67,33,34,22,11,40,76,52.6,36,42,6,36,29,96,59,0,DF,30-34,Defender,Spain,Europe
1661,Alberto Marí,ESP,Valencia,La Liga,2022,21.0,2001.0,1.0,0,0,0,0,0,0,2,0.0,2,0,0,0,0,0,1,0,"FW,MF",20-24,Forward,Spain,Europe
1662,José Mari,ESP,Cádiz,La Liga,2022,34.0,1987.0,4.4,16,7,12,3,1,10,16,62.5,6,3,1,2,5,21,9,0,MF,30-34,Midfielder,Spain,Europe
1663,Pablo Marí,ESP,Monza,Serie A,2022,28.0,1993.0,27.6,37,19,29,7,1,17,26,65.4,9,22,14,8,31,68,111,3,DF,25-29,Defender,Spain,Europe
1666,Pablo Marín,ESP,Real Sociedad,La Liga,2022,19.0,2003.0,4.0,10,5,5,4,1,2,7,28.6,5,1,0,1,4,14,2,0,"MF,FW",Under 20,Midfielder,Spain,Europe
1668,Diego Mariño,ESP,Almería,La Liga,2022,32.0,1990.0,0.5,0,0,0,0,0,0,0,,0,0,0,0,0,0,0,0,GK,30-34,Goalkeeper,Spain,Europe
1676,Roger Martí,ESP,Elche,La Liga,2022,31.0,1991.0,7.3,5,2,3,2,0,1,5,20.0,4,4,0,4,1,6,7,0,FW,30-34,Forward,Spain,Europe
1677,Roger Martí,ESP,Cádiz,La Liga,2022,31.0,1991.0,7.1,6,4,2,3,1,1,8,12.5,7,7,0,7,2,8,7,0,FW,30-34,Forward,Spain,Europe
1679,Aarón Martín,ESP,Mainz 05,Bundesliga,2022,25.0,1997.0,20.5,42,27,25,11,6,21,40,52.5,19,22,1,21,15,57,31,0,DF,25-29,Defender,Spain,Europe
1680,Ander Martin,ESP,Real Sociedad,La Liga,2022,21.0,2000.0,0.5,2,2,1,1,0,1,4,25.0,3,0,0,0,0,2,1,0,"MF,FW",20-24,Midfielder,Spain,Europe
1681,Andrés Martín,ESP,Rayo Vallecano,La Liga,2022,23.0,1999.0,2.3,4,2,2,1,1,3,5,60.0,2,2,0,2,1,5,2,0,"FW,MF",20-24,Forward,Spain,Europe
1682,Carlos Martín,ESP,Atlético Madrid,La Liga,2022,20.0,2002.0,0.3,2,2,0,2,0,2,3,66.7,1,0,0,0,1,3,0,0,"FW,MF",20-24,Forward,Spain,Europe
1683,Iván Martín,ESP,Girona,La Liga,2022,23.0,1999.0,17.6,9,7,4,4,1,8,23,34.8,15,12,0,12,9,18,12,0,MF,20-24,Midfielder,Spain,Europe
1686,Arnau Martinez,ESP,Girona,La Liga,2022,19.0,2003.0,30.4,69,45,41,19,9,38,85,44.7,47,44,10,34,25,94,54,2,DF,Under 20,Defender,Spain,Europe
1688,Iñigo Martínez,ESP,Athletic Club,La Liga,2022,31.0,1991.0,14.9,18,8,11,7,0,6,9,66.7,3,17,11,6,18,36,55,0,DF,30-34,Defender,Spain,Europe
1692,Roger Martínez,ESP,Espanyol,La Liga,2022,18.0,2004.0,0.1,0,0,0,0,0,0,0,,0,0,0,0,0,0,0,0,DF,Under 20,Defender,Spain,Europe
1692,Roger Martínez,ESP,Espanyol,La Liga,2022,18.0,2004.0,0.1,0,0,0,0,0,0,0,,0,0,0,0,0,0,0,0,DF,Under 20,Defender,Spain,Europe
1692,Roger Martínez,ESP,Espanyol,La Liga,2022,18.0,2004.0,0.1,0,0,0,0,0,0,0,,0,0,0,0,0,0,0,0,DF,Under 20,Defender,Spain,Europe
1692,Roger Martínez,ESP,Espanyol,La Liga,2022,18.0,2004.0,0.1,0,0,0,0,0,0,0,,0,0,0,0,0,0,0,0,DF,Under 20,Defender,Spain,Europe
1697,Jordi Masip,ESP,Valladolid,La Liga,2022,33.0,1989.0,27.9,0,0,0,0,0,0,2,0.0,2,0,0,0,1,1,3,2,GK,30-34,Goalkeeper,Spain,Europe
1698,Erhan Mašović,SRB,Bochum,Bundesliga,2022,23.0,1998.0,24.2,50,31,28,21,1,30,51,58.8,21,30,14,16,27,77,79,0,"DF,MF",20-24,Defender,Serbia,Europe
1701,Jaime Mata,ESP,Getafe,La Liga,2022,33.0,1988.0,4.9,13,10,4,5,4,7,22,31.8,15,7,2,5,3,16,6,0,"FW,MF",30-34,Forward,Spain,Europe
1705,Nemanja Matić,SRB,Roma,Serie A,2022,33.0,1988.0,20.6,47,27,24,19,4,19,33,57.6,14,27,7,20,25,72,21,1,MF,30-34,Midfielder,Serbia,Europe
1722,Borja Mayoral,ESP,Getafe,La Liga,2022,25.0,1997.0,30.7,9,4,7,2,0,5,31,16.1,26,18,0,18,3,12,10,0,FW,25-29,Forward,Spain,Europe
1747,Fernando Medrano,ESP,Celta Vigo,La Liga,2022,22.0,2000.0,0.1,2,1,2,0,0,1,1,100.0,0,0,0,0,1,3,1,0,DF,20-24,Defender,Spain,Europe
1752,Gonzalo Melero,ESP,Almería,La Liga,2022,28.0,1994.0,20.6,32,16,9,18,5,11,39,28.2,28,23,2,21,7,39,19,1,MF,25-29,Midfielder,Spain,Europe
1753,Birger Meling,NOR,Rennes,Ligue 1,2022,27.0,1994.0,13.4,24,15,9,12,3,12,25,48.0,13,18,2,16,23,47,26,0,DF,25-29,Defender,Norway,Europe
1760,Brais Méndez,ESP,Real Sociedad,La Liga,2022,25.0,1997.0,26.7,58,34,18,30,10,24,64,37.5,40,27,3,24,12,70,14,1,MF,25-29,Midfielder,Spain,Europe
1761,Diego Méndez,ESP,Rayo Vallecano,La Liga,2022,18.0,2003.0,0.0,0,0,0,0,0,0,0,,0,0,0,0,1,1,0,0,MF,Under 20,Midfielder,Spain,Europe
1770,Jorge Meré,ESP,Cádiz,La Liga,2022,25.0,1997.0,6.7,11,7,9,2,0,5,8,62.5,3,9,6,3,6,17,32,0,DF,25-29,Defender,Spain,Europe
1772,Mikel Merino,ESP,Real Sociedad,La Liga,2022,26.0,1996.0,27.7,77,49,28,33,16,31,62,50.0,31,38,8,30,20,97,51,1,MF,25-29,Midfielder,Spain,Europe
1775,Roque Mesa,ESP,Valladolid,La Liga,2022,33.0,1989.0,18.0,27,15,16,10,1,12,38,31.6,26,16,4,12,13,40,18,0,MF,30-34,Midfielder,Spain,Europe
1785,Nikola Milenković,SRB,Fiorentina,Serie A,2022,24.0,1997.0,23.7,40,25,20,17,3,18,27,66.7,9,27,14,13,22,62,72,0,DF,20-24,Defender,Serbia,Europe
1787,Arkadiusz Milik,POL,Juventus,Serie A,2022,28.0,1994.0,17.6,12,8,2,8,2,2,8,25.0,6,10,1,9,1,13,14,0,FW,25-29,Forward,Poland,Europe
1788,Arkadiusz Milik,POL,Marseille,Ligue 1,2022,28.0,1994.0,1.4,1,1,0,0,1,0,1,0.0,1,0,0,0,0,1,2,0,FW,25-29,Forward,Poland,Europe
1789,Sergej Milinković-Savić,SRB,Lazio,Serie A,2022,27.0,1995.0,33.6,58,35,22,23,13,24,67,35.8,43,50,12,38,28,86,49,0,MF,25-29,Midfielder,Serbia,Europe
1790,Vanja Milinković-Savić,SRB,Torino,Serie A,2022,25.0,1997.0,38.0,2,1,2,0,0,2,2,100.0,0,0,0,0,1,3,19,1,GK,25-29,Goalkeeper,Serbia,Europe
1792,Luka Milivojević,SRB,Crystal Palace,Premier League,2022,31.0,1991.0,5.7,13,7,7,4,2,7,10,70.0,3,13,4,9,12,25,10,1,MF,30-34,Midfielder,Serbia,Europe
1793,Luis Milla,ESP,Getafe,La Liga,2022,27.0,1994.0,20.6,48,30,21,18,9,19,44,43.2,25,13,1,12,32,80,25,1,MF,25-29,Midfielder,Spain,Europe
1794,Pere Milla,ESP,Elche,La Liga,2022,29.0,1992.0,20.5,31,20,18,8,5,14,41,34.1,27,18,3,15,9,40,19,1,"FW,MF",25-29,Forward,Spain,Europe
1797,Marko Milovanović,SRB,Almería,La Liga,2022,18.0,2003.0,0.2,0,0,0,0,0,0,0,,0,0,0,0,0,0,0,0,FW,Under 20,Forward,Serbia,Europe
1802,Óscar Mingueza,ESP,Celta Vigo,La Liga,2022,23.0,1999.0,14.3,37,21,27,9,1,25,32,78.1,7,10,4,6,12,49,25,0,DF,20-24,Defender,Spain,Europe
1803,Rafa Mir,ESP,Sevilla,La Liga,2022,25.0,1997.0,14.4,8,2,2,4,2,2,5,40.0,3,5,1,4,4,12,11,0,FW,25-29,Forward,Spain,Europe
1805,Juan Miranda,ESP,Betis,La Liga,2022,22.0,2000.0,16.4,23,16,16,6,1,14,29,48.3,15,20,7,13,20,43,63,0,DF,20-24,Defender,Spain,Europe
1811,Aleksandar Mitrović,SRB,Fulham,Premier League,2022,27.0,1994.0,22.3,14,7,8,4,2,5,12,41.7,7,22,5,17,3,17,20,1,FW,25-29,Forward,Serbia,Europe
1812,Stefan Mitrović,SRB,Getafe,La Liga,2022,32.0,1990.0,18.7,14,6,12,2,0,7,11,63.6,4,12,10,2,17,31,90,2,DF,30-34,Defender,Serbia,Europe
1828,Jon Moncayola,ESP,Osasuna,La Liga,2022,24.0,1998.0,27.2,55,39,24,22,9,30,76,39.5,46,37,5,32,17,72,32,2,"MF,DF",20-24,Midfielder,Spain,Europe
1829,Monchu,ESP,Valladolid,La Liga,2022,22.0,1999.0,22.6,50,29,20,21,9,19,46,41.3,27,28,11,17,18,68,22,1,MF,20-24,Midfielder,Spain,Europe
1834,Martín Montoya,ESP,Betis,La Liga,2022,31.0,1991.0,5.0,13,8,9,4,0,10,12,83.3,2,6,1,5,9,22,14,1,DF,30-34,Defender,Spain,Europe
1837,Álvaro Morata,ESP,Atlético Madrid,La Liga,2022,29.0,1992.0,21.1,16,11,4,8,4,3,8,37.5,5,11,3,8,0,16,23,0,FW,25-29,Forward,Spain,Europe
1838,Jon Morcillo,ESP,Athletic Club,La Liga,2022,23.0,1998.0,0.8,1,0,1,0,0,0,1,0.0,1,0,0,0,1,2,0,0,"FW,MF",20-24,Forward,Spain,Europe
1839,Alberto Moreno,ESP,Villarreal,La Liga,2022,30.0,1992.0,14.4,23,12,10,10,3,11,24,45.8,13,12,1,11,23,46,26,0,DF,30-34,Defender,Spain,Europe
1839,Alberto Moreno,ESP,Villarreal,La Liga,2022,30.0,1992.0,14.4,23,12,10,10,3,11,24,45.8,13,12,1,11,23,46,26,0,DF,30-34,Defender,Spain,Europe
1839,Alberto Moreno,ESP,Villarreal,La Liga,2022,30.0,1992.0,14.4,23,12,10,10,3,11,24,45.8,13,12,1,11,23,46,26,0,DF,30-34,Defender,Spain,Europe
1839,Alberto Moreno,ESP,Villarreal,La Liga,2022,30.0,1992.0,14.4,23,12,10,10,3,11,24,45.8,13,12,1,11,23,46,26,0,DF,30-34,Defender,Spain,Europe
1840,Álex Moreno,ESP,Aston Villa,Premier League,2022,29.0,1993.0,14.8,23,14,15,5,3,13,36,36.1,23,18,3,15,7,30,37,2,DF,25-29,Defender,Spain,Europe
1841,Álex Moreno,ESP,Betis,La Liga,2022,29.0,1993.0,15.0,29,22,19,10,0,18,36,50.0,18,17,4,13,17,46,39,0,DF,25-29,Defender,Spain,Europe
1842,Diego Moreno,ESP,Osasuna,La Liga,2022,21.0,2001.0,7.1,4,4,2,2,0,3,8,37.5,5,7,4,3,5,9,21,0,DF,20-24,Defender,Spain,Europe
1842,Diego Moreno,ESP,Osasuna,La Liga,2022,21.0,2001.0,7.1,4,4,2,2,0,3,8,37.5,5,7,4,3,5,9,21,0,DF,20-24,Defender,Spain,Europe
1842,Diego Moreno,ESP,Osasuna,La Liga,2022,21.0,2001.0,7.1,4,4,2,2,0,3,8,37.5,5,7,4,3,5,9,21,0,DF,20-24,Defender,Spain,Europe
1842,Diego Moreno,ESP,Osasuna,La Liga,2022,21.0,2001.0,7.1,4,4,2,2,0,3,8,37.5,5,7,4,3,5,9,21,0,DF,20-24,Defender,Spain,Europe
1842,Diego Moreno,ESP,Osasuna,La Liga,2022,21.0,2001.0,7.1,4,4,2,2,0,3,8,37.5,5,7,4,3,5,9,21,0,DF,20-24,Defender,Spain,Europe
1842,Diego Moreno,ESP,Osasuna,La Liga,2022,21.0,2001.0,7.1,4,4,2,2,0,3,8,37.5,5,7,4,3,5,9,21,0,DF,20-24,Defender,Spain,Europe
1842,Diego Moreno,ESP,Osasuna,La Liga,2022,21.0,2001.0,7.1,4,4,2,2,0,3,8,37.5,5,7,4,3,5,9,21,0,DF,20-24,Defender,Spain,Europe
1842,Diego Moreno,ESP,Osasuna,La Liga,2022,21.0,2001.0,7.1,4,4,2,2,0,3,8,37.5,5,7,4,3,5,9,21,0,DF,20-24,Defender,Spain,Europe
1842,Diego Moreno,ESP,Osasuna,La Liga,2022,21.0,2001.0,7.1,4,4,2,2,0,3,8,37.5,5,7,4,3,5,9,21,0,DF,20-24,Defender,Spain,Europe
1843,Gerard Moreno,ESP,Villarreal,La Liga,2022,30.0,1992.0,13.7,11,6,0,6,5,3,6,50.0,3,6,2,4,5,16,10,0,FW,30-34,Forward,Spain,Europe
1845,Tete Morente,ESP,Elche,La Liga,2022,25.0,1996.0,23.0,33,21,18,13,2,15,36,41.7,21,23,3,20,25,58,28,0,"MF,DF",25-29,Midfielder,Spain,Europe
1847,Manu Morlanes,ESP,Villarreal,La Liga,2022,23.0,1999.0,1.8,3,2,2,1,0,3,3,100.0,0,3,2,1,1,4,2,0,MF,20-24,Midfielder,Spain,Europe
1848,Manu Morlanes,ESP,Mallorca,La Liga,2022,23.0,1999.0,7.8,22,9,12,8,2,13,24,54.2,11,10,5,5,5,27,9,0,MF,20-24,Midfielder,Spain,Europe
1850,Loren Morón,ESP,Betis,La Liga,2022,28.0,1993.0,0.2,2,2,0,1,1,0,0,,0,0,0,0,0,2,1,0,FW,25-29,Forward,Spain,Europe
1851,Cristhian Mosquera,ESP,Valencia,La Liga,2022,18.0,2004.0,1.6,4,2,3,1,0,4,5,80.0,1,1,0,1,1,5,5,0,DF,Under 20,Defender,Spain,Europe
1871,Iker Muniain,ESP,Athletic Club,La Liga,2022,29.0,1992.0,18.8,21,16,7,11,3,6,17,35.3,11,10,1,9,4,25,2,0,"MF,FW",25-29,Midfielder,Spain,Europe
1872,Aihen Muñoz,ESP,Real Sociedad,La Liga,2022,24.0,1997.0,19.5,38,23,17,17,4,22,47,46.8,25,26,5,21,9,47,38,0,DF,20-24,Defender,Spain,Europe
1873,Iker Muñoz,ESP,Osasuna,La Liga,2022,19.0,2002.0,2.8,1,0,0,1,0,0,3,0.0,3,2,1,1,3,4,8,0,MF,Under 20,Midfielder,Spain,Europe
1874,Pablo Muñoz,ESP,Rayo Vallecano,La Liga,2022,18.0,2003.0,0.1,0,0,0,0,0,0,1,0.0,1,0,0,0,0,0,0,0,MF,Under 20,Midfielder,Spain,Europe
1874,Pablo Muñoz,ESP,Rayo Vallecano,La Liga,2022,18.0,2003.0,0.1,0,0,0,0,0,0,1,0.0,1,0,0,0,0,0,0,0,MF,Under 20,Midfielder,Spain,Europe
1874,Pablo Muñoz,ESP,Rayo Vallecano,La Liga,2022,18.0,2003.0,0.1,0,0,0,0,0,0,1,0.0,1,0,0,0,0,0,0,0,MF,Under 20,Midfielder,Spain,Europe
1874,Pablo Muñoz,ESP,Rayo Vallecano,La Liga,2022,18.0,2003.0,0.1,0,0,0,0,0,0,1,0.0,1,0,0,0,0,0,0,0,MF,Under 20,Midfielder,Spain,Europe
1894,Nacho,ESP,Real Madrid,La Liga,2022,32.0,1990.0,18.2,24,16,17,5,2,12,29,41.4,17,11,6,5,18,42,37,0,DF,30-34,Defender,Spain,Europe
1897,Matija Nastasić,SRB,Mallorca,La Liga,2022,29.0,1993.0,10.1,10,8,7,1,2,3,6,50.0,3,11,4,7,18,28,43,1,DF,25-29,Defender,Serbia,Europe
1898,Roberto Navarro,ESP,Real Sociedad,La Liga,2022,20.0,2002.0,3.9,5,4,4,0,1,1,2,50.0,1,7,0,7,2,7,2,0,"MF,FW",20-24,Midfielder,Spain,Europe
1899,Jesús Navas,ESP,Sevilla,La Liga,2022,36.0,1985.0,22.0,19,12,8,3,8,11,22,50.0,11,18,7,11,22,41,52,1,"DF,FW",35-39,Defender,Spain,Europe
1906,Álvaro Negredo,ESP,Cádiz,La Liga,2022,36.0,1985.0,8.4,5,4,1,2,2,2,2,100.0,0,4,1,3,0,5,8,0,FW,35-39,Forward,Spain,Europe
1926,Saúl Ñíguez,ESP,Atlético Madrid,La Liga,2022,27.0,1994.0,12.2,42,27,18,18,6,22,37,59.5,15,27,5,22,15,57,29,0,"MF,DF",25-29,Midfielder,Spain,Europe
1928,Fernando Niño,ESP,Villarreal,La Liga,2022,21.0,2000.0,0.2,0,0,0,0,0,0,0,,0,0,0,0,0,0,0,0,"MF,FW",20-24,Midfielder,Spain,Europe
1936,Hugo Novoa,ESP,RB Leipzig,Bundesliga,2022,19.0,2003.0,2.0,8,2,1,3,4,4,7,57.1,3,4,0,4,1,9,0,0,"DF,FW",Under 20,Defender,Spain,Europe
1943,Unai Núñez,ESP,Celta Vigo,La Liga,2022,25.0,1997.0,35.0,47,35,29,15,3,18,34,52.9,16,27,17,10,72,119,135,1,DF,25-29,Defender,Spain,Europe
1948,Ørjan Nyland,NOR,RB Leipzig,Bundesliga,2022,31.0,1990.0,2.0,0,0,0,0,0,0,0,,0,0,0,0,0,0,0,0,GK,30-34,Goalkeeper,Norway,Europe
1953,Jan Oblak,SVN,Atlético Madrid,La Liga,2022,29.0,1993.0,27.7,0,0,0,0,0,0,0,,0,0,0,0,1,1,8,0,GK,25-29,Goalkeeper,Slovenia,Europe
1958,Álvaro Odriozola,ESP,Real Madrid,La Liga,2022,26.0,1995.0,0.4,0,0,0,0,0,0,0,,0,0,0,0,0,0,0,0,DF,25-29,Defender,Spain,Europe
1966,Olasagasti,ESP,Real Sociedad,La Liga,2022,21.0,2000.0,0.7,4,4,1,2,1,1,2,50.0,1,2,0,2,0,4,1,0,"MF,DF",20-24,Midfielder,Spain,Europe
1971,Brian Oliván,ESP,Espanyol,La Liga,2022,28.0,1994.0,26.7,47,27,30,12,5,17,26,65.4,9,26,6,20,22,69,67,0,DF,25-29,Defender,Spain,Europe
1974,Dani Olmo,ESP,RB Leipzig,Bundesliga,2022,24.0,1998.0,14.2,15,9,1,10,4,6,14,42.9,8,15,0,15,6,21,6,0,"MF,FW",20-24,Midfielder,Spain,Europe
1977,Warmed Omari,COM,Rennes,Ligue 1,2022,22.0,2000.0,15.1,20,11,14,6,0,14,28,50.0,14,13,7,6,17,37,43,1,DF,20-24,Defender,Comoros,Africa
1992,Aimar Oroz,ESP,Osasuna,La Liga,2022,20.0,2001.0,22.4,26,14,8,10,8,8,30,26.7,22,24,1,23,24,50,6,0,"MF,FW",20-24,Midfielder,Spain,Europe
1996,Pedro Ortiz,ESP,Sevilla,La Liga,2022,21.0,2000.0,0.0,0,0,0,0,0,0,0,,0,0,0,0,0,0,0,0,MF,20-24,Midfielder,Spain,Europe
2012,Mikel Oyarzabal,ESP,Real Sociedad,La Liga,2022,25.0,1997.0,13.5,13,7,5,3,5,5,19,26.3,14,14,4,10,3,16,5,0,"FW,MF",25-29,Forward,Spain,Europe
2017,Fernando Pacheco,ESP,Almería,La Liga,2022,30.0,1992.0,1.0,0,0,0,0,0,0,0,,0,0,0,0,0,0,1,0,GK,30-34,Goalkeeper,Spain,Europe
2017,Fernando Pacheco,ESP,Almería,La Liga,2022,30.0,1992.0,1.0,0,0,0,0,0,0,0,,0,0,0,0,0,0,1,0,GK,30-34,Goalkeeper,Spain,Europe
2017,Fernando Pacheco,ESP,Almería,La Liga,2022,30.0,1992.0,1.0,0,0,0,0,0,0,0,,0,0,0,0,0,0,1,0,GK,30-34,Goalkeeper,Spain,Europe
2017,Fernando Pacheco,ESP,Almería,La Liga,2022,30.0,1992.0,1.0,0,0,0,0,0,0,0,,0,0,0,0,0,0,1,0,GK,30-34,Goalkeeper,Spain,Europe
2018,Fernando Pacheco,ESP,Espanyol,La Liga,2022,30.0,1992.0,16.0,0,0,0,0,0,0,1,0.0,1,0,0,0,1,1,11,0,GK,30-34,Goalkeeper,Spain,Europe
2018,Fernando Pacheco,ESP,Espanyol,La Liga,2022,30.0,1992.0,16.0,0,0,0,0,0,0,1,0.0,1,0,0,0,1,1,11,0,GK,30-34,Goalkeeper,Spain,Europe
2018,Fernando Pacheco,ESP,Espanyol,La Liga,2022,30.0,1992.0,16.0,0,0,0,0,0,0,1,0.0,1,0,0,0,1,1,11,0,GK,30-34,Goalkeeper,Spain,Europe
2018,Fernando Pacheco,ESP,Espanyol,La Liga,2022,30.0,1992.0,16.0,0,0,0,0,0,0,1,0.0,1,0,0,0,1,1,11,0,GK,30-34,Goalkeeper,Spain,Europe
2019,Jon Pacheco,ESP,Real Sociedad,La Liga,2022,21.0,2001.0,13.3,16,10,10,6,0,6,10,60.0,4,9,6,3,12,28,37,1,DF,20-24,Defender,Spain,Europe
2025,Isaac Palazón Camacho,ESP,Rayo Vallecano,La Liga,2022,27.0,1994.0,32.9,45,30,11,23,11,24,66,36.4,42,42,3,39,17,62,30,0,"FW,MF",25-29,Forward,Spain,Europe
2031,Miloš Pantović,SRB,Union Berlin,Bundesliga,2022,26.0,1996.0,2.3,4,2,4,0,0,3,5,60.0,2,3,0,3,0,4,5,0,MF,25-29,Midfielder,Serbia,Europe
2036,Aitor Paredes,ESP,Athletic Club,La Liga,2022,22.0,2000.0,9.5,7,6,4,2,1,6,11,54.5,5,11,7,4,14,21,26,0,DF,20-24,Defender,Spain,Europe
2040,Daniel Parejo,ESP,Villarreal,La Liga,2022,33.0,1989.0,36.5,71,40,32,23,16,30,75,40.0,45,40,12,28,29,100,31,2,MF,30-34,Midfielder,Spain,Europe
2042,Moises Parra Gutierrez,ESP,Getafe,La Liga,2022,20.0,2002.0,0.1,1,0,0,1,0,0,0,,0,0,0,0,0,1,0,0,FW,20-24,Forward,Spain,Europe
2043,Raúl Parra,ESP,Cádiz,La Liga,2022,22.0,1999.0,3.4,4,2,4,0,0,4,9,44.4,5,5,3,2,1,5,9,0,DF,20-24,Defender,Spain,Europe
2047,Pascu,ESP,Villarreal,La Liga,2022,19.0,2003.0,0.1,0,0,0,0,0,0,0,,0,0,0,0,0,0,0,0,"DF,FW",Under 20,Defender,Spain,Europe
1902,Youssouf Ndayishimiye,BDI,Nice,Ligue 1,2022,23.0,1998.0,6.3,13,9,8,5,0,6,11,54.5,5,8,5,3,12,25,22,1,"MF,DF",20-24,Midfielder,Burundi,Africa
2049,Javier Pastore,ARG,Elche,La Liga,2022,33.0,1989.0,0.1,0,0,0,0,0,0,0,,0,0,0,0,0,0,0,0,MF,30-34,Midfielder,Argentina,South America
2051,Rui Patrício,POR,Roma,Serie A,2022,34.0,1988.0,35.0,1,1,1,0,0,1,1,100.0,0,0,0,0,2,3,6,3,GK,30-34,Goalkeeper,Portugal,Europe
2052,Nathan Patterson,SCO,Everton,Premier League,2022,20.0,2001.0,14.2,49,24,32,13,4,29,54,53.7,25,24,4,20,15,64,45,0,"DF,MF",20-24,Defender,Scotland,Europe
2053,Paulinho,BRA,Leverkusen,Bundesliga,2022,22.0,2000.0,0.9,0,0,0,0,0,0,0,,0,1,0,1,0,0,2,0,FW,20-24,Forward,Brazil,South America
2053,Paulinho,BRA,Leverkusen,Bundesliga,2022,22.0,2000.0,0.9,0,0,0,0,0,0,0,,0,1,0,1,0,0,2,0,FW,20-24,Forward,Brazil,South America
2053,Paulinho,BRA,Leverkusen,Bundesliga,2022,22.0,2000.0,0.9,0,0,0,0,0,0,0,,0,1,0,1,0,0,2,0,FW,20-24,Forward,Brazil,South America
2053,Paulinho,BRA,Leverkusen,Bundesliga,2022,22.0,2000.0,0.9,0,0,0,0,0,0,0,,0,1,0,1,0,0,2,0,FW,20-24,Forward,Brazil,South America
2053,Paulinho,BRA,Leverkusen,Bundesliga,2022,22.0,2000.0,0.9,0,0,0,0,0,0,0,,0,1,0,1,0,0,2,0,FW,20-24,Forward,Brazil,South America
2053,Paulinho,BRA,Leverkusen,Bundesliga,2022,22.0,2000.0,0.9,0,0,0,0,0,0,0,,0,1,0,1,0,0,2,0,FW,20-24,Forward,Brazil,South America
2053,Paulinho,BRA,Leverkusen,Bundesliga,2022,22.0,2000.0,0.9,0,0,0,0,0,0,0,,0,1,0,1,0,0,2,0,FW,20-24,Forward,Brazil,South America
2053,Paulinho,BRA,Leverkusen,Bundesliga,2022,22.0,2000.0,0.9,0,0,0,0,0,0,0,,0,1,0,1,0,0,2,0,FW,20-24,Forward,Brazil,South America
2053,Paulinho,BRA,Leverkusen,Bundesliga,2022,22.0,2000.0,0.9,0,0,0,0,0,0,0,,0,1,0,1,0,0,2,0,FW,20-24,Forward,Brazil,South America
2053,Paulinho,BRA,Leverkusen,Bundesliga,2022,22.0,2000.0,0.9,0,0,0,0,0,0,0,,0,1,0,1,0,0,2,0,FW,20-24,Forward,Brazil,South America
2053,Paulinho,BRA,Leverkusen,Bundesliga,2022,22.0,2000.0,0.9,0,0,0,0,0,0,0,,0,1,0,1,0,0,2,0,FW,20-24,Forward,Brazil,South America
2053,Paulinho,BRA,Leverkusen,Bundesliga,2022,22.0,2000.0,0.9,0,0,0,0,0,0,0,,0,1,0,1,0,0,2,0,FW,20-24,Forward,Brazil,South America
2053,Paulinho,BRA,Leverkusen,Bundesliga,2022,22.0,2000.0,0.9,0,0,0,0,0,0,0,,0,1,0,1,0,0,2,0,FW,20-24,Forward,Brazil,South America
2053,Paulinho,BRA,Leverkusen,Bundesliga,2022,22.0,2000.0,0.9,0,0,0,0,0,0,0,,0,1,0,1,0,0,2,0,FW,20-24,Forward,Brazil,South America
2053,Paulinho,BRA,Leverkusen,Bundesliga,2022,22.0,2000.0,0.9,0,0,0,0,0,0,0,,0,1,0,1,0,0,2,0,FW,20-24,Forward,Brazil,South America
2053,Paulinho,BRA,Leverkusen,Bundesliga,2022,22.0,2000.0,0.9,0,0,0,0,0,0,0,,0,1,0,1,0,0,2,0,FW,20-24,Forward,Brazil,South America
2053,Paulinho,BRA,Leverkusen,Bundesliga,2022,22.0,2000.0,0.9,0,0,0,0,0,0,0,,0,1,0,1,0,0,2,0,FW,20-24,Forward,Brazil,South America
2053,Paulinho,BRA,Leverkusen,Bundesliga,2022,22.0,2000.0,0.9,0,0,0,0,0,0,0,,0,1,0,1,0,0,2,0,FW,20-24,Forward,Brazil,South America
2053,Paulinho,BRA,Leverkusen,Bundesliga,2022,22.0,2000.0,0.9,0,0,0,0,0,0,0,,0,1,0,1,0,0,2,0,FW,20-24,Forward,Brazil,South America
2053,Paulinho,BRA,Leverkusen,Bundesliga,2022,22.0,2000.0,0.9,0,0,0,0,0,0,0,,0,1,0,1,0,0,2,0,FW,20-24,Forward,Brazil,South America
2053,Paulinho,BRA,Leverkusen,Bundesliga,2022,22.0,2000.0,0.9,0,0,0,0,0,0,0,,0,1,0,1,0,0,2,0,FW,20-24,Forward,Brazil,South America
2053,Paulinho,BRA,Leverkusen,Bundesliga,2022,22.0,2000.0,0.9,0,0,0,0,0,0,0,,0,1,0,1,0,0,2,0,FW,20-24,Forward,Brazil,South America
2053,Paulinho,BRA,Leverkusen,Bundesliga,2022,22.0,2000.0,0.9,0,0,0,0,0,0,0,,0,1,0,1,0,0,2,0,FW,20-24,Forward,Brazil,South America
2053,Paulinho,BRA,Leverkusen,Bundesliga,2022,22.0,2000.0,0.9,0,0,0,0,0,0,0,,0,1,0,1,0,0,2,0,FW,20-24,Forward,Brazil,South America
2053,Paulinho,BRA,Leverkusen,Bundesliga,2022,22.0,2000.0,0.9,0,0,0,0,0,0,0,,0,1,0,1,0,0,2,0,FW,20-24,Forward,Brazil,South America
2053,Paulinho,BRA,Leverkusen,Bundesliga,2022,22.0,2000.0,0.9,0,0,0,0,0,0,0,,0,1,0,1,0,0,2,0,FW,20-24,Forward,Brazil,South America
2053,Paulinho,BRA,Leverkusen,Bundesliga,2022,22.0,2000.0,0.9,0,0,0,0,0,0,0,,0,1,0,1,0,0,2,0,FW,20-24,Forward,Brazil,South America
2053,Paulinho,BRA,Leverkusen,Bundesliga,2022,22.0,2000.0,0.9,0,0,0,0,0,0,0,,0,1,0,1,0,0,2,0,FW,20-24,Forward,Brazil,South America
2053,Paulinho,BRA,Leverkusen,Bundesliga,2022,22.0,2000.0,0.9,0,0,0,0,0,0,0,,0,1,0,1,0,0,2,0,FW,20-24,Forward,Brazil,South America
2053,Paulinho,BRA,Leverkusen,Bundesliga,2022,22.0,2000.0,0.9,0,0,0,0,0,0,0,,0,1,0,1,0,0,2,0,FW,20-24,Forward,Brazil,South America
2053,Paulinho,BRA,Leverkusen,Bundesliga,2022,22.0,2000.0,0.9,0,0,0,0,0,0,0,,0,1,0,1,0,0,2,0,FW,20-24,Forward,Brazil,South America
2053,Paulinho,BRA,Leverkusen,Bundesliga,2022,22.0,2000.0,0.9,0,0,0,0,0,0,0,,0,1,0,1,0,0,2,0,FW,20-24,Forward,Brazil,South America
2053,Paulinho,BRA,Leverkusen,Bundesliga,2022,22.0,2000.0,0.9,0,0,0,0,0,0,0,,0,1,0,1,0,0,2,0,FW,20-24,Forward,Brazil,South America
2053,Paulinho,BRA,Leverkusen,Bundesliga,2022,22.0,2000.0,0.9,0,0,0,0,0,0,0,,0,1,0,1,0,0,2,0,FW,20-24,Forward,Brazil,South America
2053,Paulinho,BRA,Leverkusen,Bundesliga,2022,22.0,2000.0,0.9,0,0,0,0,0,0,0,,0,1,0,1,0,0,2,0,FW,20-24,Forward,Brazil,South America
2053,Paulinho,BRA,Leverkusen,Bundesliga,2022,22.0,2000.0,0.9,0,0,0,0,0,0,0,,0,1,0,1,0,0,2,0,FW,20-24,Forward,Brazil,South America
2053,Paulinho,BRA,Leverkusen,Bundesliga,2022,22.0,2000.0,0.9,0,0,0,0,0,0,0,,0,1,0,1,0,0,2,0,FW,20-24,Forward,Brazil,South America
2053,Paulinho,BRA,Leverkusen,Bundesliga,2022,22.0,2000.0,0.9,0,0,0,0,0,0,0,,0,1,0,1,0,0,2,0,FW,20-24,Forward,Brazil,South America
2053,Paulinho,BRA,Leverkusen,Bundesliga,2022,22.0,2000.0,0.9,0,0,0,0,0,0,0,,0,1,0,1,0,0,2,0,FW,20-24,Forward,Brazil,South America
2053,Paulinho,BRA,Leverkusen,Bundesliga,2022,22.0,2000.0,0.9,0,0,0,0,0,0,0,,0,1,0,1,0,0,2,0,FW,20-24,Forward,Brazil,South America
2053,Paulinho,BRA,Leverkusen,Bundesliga,2022,22.0,2000.0,0.9,0,0,0,0,0,0,0,,0,1,0,1,0,0,2,0,FW,20-24,Forward,Brazil,South America
2053,Paulinho,BRA,Leverkusen,Bundesliga,2022,22.0,2000.0,0.9,0,0,0,0,0,0,0,,0,1,0,1,0,0,2,0,FW,20-24,Forward,Brazil,South America
2053,Paulinho,BRA,Leverkusen,Bundesliga,2022,22.0,2000.0,0.9,0,0,0,0,0,0,0,,0,1,0,1,0,0,2,0,FW,20-24,Forward,Brazil,South America
2053,Paulinho,BRA,Leverkusen,Bundesliga,2022,22.0,2000.0,0.9,0,0,0,0,0,0,0,,0,1,0,1,0,0,2,0,FW,20-24,Forward,Brazil,South America
2053,Paulinho,BRA,Leverkusen,Bundesliga,2022,22.0,2000.0,0.9,0,0,0,0,0,0,0,,0,1,0,1,0,0,2,0,FW,20-24,Forward,Brazil,South America
2053,Paulinho,BRA,Leverkusen,Bundesliga,2022,22.0,2000.0,0.9,0,0,0,0,0,0,0,,0,1,0,1,0,0,2,0,FW,20-24,Forward,Brazil,South America
2053,Paulinho,BRA,Leverkusen,Bundesliga,2022,22.0,2000.0,0.9,0,0,0,0,0,0,0,,0,1,0,1,0,0,2,0,FW,20-24,Forward,Brazil,South America
2053,Paulinho,BRA,Leverkusen,Bundesliga,2022,22.0,2000.0,0.9,0,0,0,0,0,0,0,,0,1,0,1,0,0,2,0,FW,20-24,Forward,Brazil,South America
2053,Paulinho,BRA,Leverkusen,Bundesliga,2022,22.0,2000.0,0.9,0,0,0,0,0,0,0,,0,1,0,1,0,0,2,0,FW,20-24,Forward,Brazil,South America
2053,Paulinho,BRA,Leverkusen,Bundesliga,2022,22.0,2000.0,0.9,0,0,0,0,0,0,0,,0,1,0,1,0,0,2,0,FW,20-24,Forward,Brazil,South America
2053,Paulinho,BRA,Leverkusen,Bundesliga,2022,22.0,2000.0,0.9,0,0,0,0,0,0,0,,0,1,0,1,0,0,2,0,FW,20-24,Forward,Brazil,South America
2053,Paulinho,BRA,Leverkusen,Bundesliga,2022,22.0,2000.0,0.9,0,0,0,0,0,0,0,,0,1,0,1,0,0,2,0,FW,20-24,Forward,Brazil,South America
2053,Paulinho,BRA,Leverkusen,Bundesliga,2022,22.0,2000.0,0.9,0,0,0,0,0,0,0,,0,1,0,1,0,0,2,0,FW,20-24,Forward,Brazil,South America
2053,Paulinho,BRA,Leverkusen,Bundesliga,2022,22.0,2000.0,0.9,0,0,0,0,0,0,0,,0,1,0,1,0,0,2,0,FW,20-24,Forward,Brazil,South America
2053,Paulinho,BRA,Leverkusen,Bundesliga,2022,22.0,2000.0,0.9,0,0,0,0,0,0,0,,0,1,0,1,0,0,2,0,FW,20-24,Forward,Brazil,South America
2053,Paulinho,BRA,Leverkusen,Bundesliga,2022,22.0,2000.0,0.9,0,0,0,0,0,0,0,,0,1,0,1,0,0,2,0,FW,20-24,Forward,Brazil,South America
2053,Paulinho,BRA,Leverkusen,Bundesliga,2022,22.0,2000.0,0.9,0,0,0,0,0,0,0,,0,1,0,1,0,0,2,0,FW,20-24,Forward,Brazil,South America
2053,Paulinho,BRA,Leverkusen,Bundesliga,2022,22.0,2000.0,0.9,0,0,0,0,0,0,0,,0,1,0,1,0,0,2,0,FW,20-24,Forward,Brazil,South America
2053,Paulinho,BRA,Leverkusen,Bundesliga,2022,22.0,2000.0,0.9,0,0,0,0,0,0,0,,0,1,0,1,0,0,2,0,FW,20-24,Forward,Brazil,South America
2053,Paulinho,BRA,Leverkusen,Bundesliga,2022,22.0,2000.0,0.9,0,0,0,0,0,0,0,,0,1,0,1,0,0,2,0,FW,20-24,Forward,Brazil,South America
2053,Paulinho,BRA,Leverkusen,Bundesliga,2022,22.0,2000.0,0.9,0,0,0,0,0,0,0,,0,1,0,1,0,0,2,0,FW,20-24,Forward,Brazil,South America
2053,Paulinho,BRA,Leverkusen,Bundesliga,2022,22.0,2000.0,0.9,0,0,0,0,0,0,0,,0,1,0,1,0,0,2,0,FW,20-24,Forward,Brazil,South America
2053,Paulinho,BRA,Leverkusen,Bundesliga,2022,22.0,2000.0,0.9,0,0,0,0,0,0,0,,0,1,0,1,0,0,2,0,FW,20-24,Forward,Brazil,South America
2053,Paulinho,BRA,Leverkusen,Bundesliga,2022,22.0,2000.0,0.9,0,0,0,0,0,0,0,,0,1,0,1,0,0,2,0,FW,20-24,Forward,Brazil,South America
2053,Paulinho,BRA,Leverkusen,Bundesliga,2022,22.0,2000.0,0.9,0,0,0,0,0,0,0,,0,1,0,1,0,0,2,0,FW,20-24,Forward,Brazil,South America
2053,Paulinho,BRA,Leverkusen,Bundesliga,2022,22.0,2000.0,0.9,0,0,0,0,0,0,0,,0,1,0,1,0,0,2,0,FW,20-24,Forward,Brazil,South America
2053,Paulinho,BRA,Leverkusen,Bundesliga,2022,22.0,2000.0,0.9,0,0,0,0,0,0,0,,0,1,0,1,0,0,2,0,FW,20-24,Forward,Brazil,South America
2053,Paulinho,BRA,Leverkusen,Bundesliga,2022,22.0,2000.0,0.9,0,0,0,0,0,0,0,,0,1,0,1,0,0,2,0,FW,20-24,Forward,Brazil,South America
2053,Paulinho,BRA,Leverkusen,Bundesliga,2022,22.0,2000.0,0.9,0,0,0,0,0,0,0,,0,1,0,1,0,0,2,0,FW,20-24,Forward,Brazil,South America
2053,Paulinho,BRA,Leverkusen,Bundesliga,2022,22.0,2000.0,0.9,0,0,0,0,0,0,0,,0,1,0,1,0,0,2,0,FW,20-24,Forward,Brazil,South America
2053,Paulinho,BRA,Leverkusen,Bundesliga,2022,22.0,2000.0,0.9,0,0,0,0,0,0,0,,0,1,0,1,0,0,2,0,FW,20-24,Forward,Brazil,South America
2053,Paulinho,BRA,Leverkusen,Bundesliga,2022,22.0,2000.0,0.9,0,0,0,0,0,0,0,,0,1,0,1,0,0,2,0,FW,20-24,Forward,Brazil,South America
2053,Paulinho,BRA,Leverkusen,Bundesliga,2022,22.0,2000.0,0.9,0,0,0,0,0,0,0,,0,1,0,1,0,0,2,0,FW,20-24,Forward,Brazil,South America
2053,Paulinho,BRA,Leverkusen,Bundesliga,2022,22.0,2000.0,0.9,0,0,0,0,0,0,0,,0,1,0,1,0,0,2,0,FW,20-24,Forward,Brazil,South America
2053,Paulinho,BRA,Leverkusen,Bundesliga,2022,22.0,2000.0,0.9,0,0,0,0,0,0,0,,0,1,0,1,0,0,2,0,FW,20-24,Forward,Brazil,South America
2053,Paulinho,BRA,Leverkusen,Bundesliga,2022,22.0,2000.0,0.9,0,0,0,0,0,0,0,,0,1,0,1,0,0,2,0,FW,20-24,Forward,Brazil,South America
2053,Paulinho,BRA,Leverkusen,Bundesliga,2022,22.0,2000.0,0.9,0,0,0,0,0,0,0,,0,1,0,1,0,0,2,0,FW,20-24,Forward,Brazil,South America
2053,Paulinho,BRA,Leverkusen,Bundesliga,2022,22.0,2000.0,0.9,0,0,0,0,0,0,0,,0,1,0,1,0,0,2,0,FW,20-24,Forward,Brazil,South America
2053,Paulinho,BRA,Leverkusen,Bundesliga,2022,22.0,2000.0,0.9,0,0,0,0,0,0,0,,0,1,0,1,0,0,2,0,FW,20-24,Forward,Brazil,South America
2053,Paulinho,BRA,Leverkusen,Bundesliga,2022,22.0,2000.0,0.9,0,0,0,0,0,0,0,,0,1,0,1,0,0,2,0,FW,20-24,Forward,Brazil,South America
2053,Paulinho,BRA,Leverkusen,Bundesliga,2022,22.0,2000.0,0.9,0,0,0,0,0,0,0,,0,1,0,1,0,0,2,0,FW,20-24,Forward,Brazil,South America
2053,Paulinho,BRA,Leverkusen,Bundesliga,2022,22.0,2000.0,0.9,0,0,0,0,0,0,0,,0,1,0,1,0,0,2,0,FW,20-24,Forward,Brazil,South America
2053,Paulinho,BRA,Leverkusen,Bundesliga,2022,22.0,2000.0,0.9,0,0,0,0,0,0,0,,0,1,0,1,0,0,2,0,FW,20-24,Forward,Brazil,South America
2053,Paulinho,BRA,Leverkusen,Bundesliga,2022,22.0,2000.0,0.9,0,0,0,0,0,0,0,,0,1,0,1,0,0,2,0,FW,20-24,Forward,Brazil,South America
2053,Paulinho,BRA,Leverkusen,Bundesliga,2022,22.0,2000.0,0.9,0,0,0,0,0,0,0,,0,1,0,1,0,0,2,0,FW,20-24,Forward,Brazil,South America
2053,Paulinho,BRA,Leverkusen,Bundesliga,2022,22.0,2000.0,0.9,0,0,0,0,0,0,0,,0,1,0,1,0,0,2,0,FW,20-24,Forward,Brazil,South America
2053,Paulinho,BRA,Leverkusen,Bundesliga,2022,22.0,2000.0,0.9,0,0,0,0,0,0,0,,0,1,0,1,0,0,2,0,FW,20-24,Forward,Brazil,South America
2053,Paulinho,BRA,Leverkusen,Bundesliga,2022,22.0,2000.0,0.9,0,0,0,0,0,0,0,,0,1,0,1,0,0,2,0,FW,20-24,Forward,Brazil,South America
2053,Paulinho,BRA,Leverkusen,Bundesliga,2022,22.0,2000.0,0.9,0,0,0,0,0,0,0,,0,1,0,1,0,0,2,0,FW,20-24,Forward,Brazil,South America
2053,Paulinho,BRA,Leverkusen,Bundesliga,2022,22.0,2000.0,0.9,0,0,0,0,0,0,0,,0,1,0,1,0,0,2,0,FW,20-24,Forward,Brazil,South America
2053,Paulinho,BRA,Leverkusen,Bundesliga,2022,22.0,2000.0,0.9,0,0,0,0,0,0,0,,0,1,0,1,0,0,2,0,FW,20-24,Forward,Brazil,South America
2053,Paulinho,BRA,Leverkusen,Bundesliga,2022,22.0,2000.0,0.9,0,0,0,0,0,0,0,,0,1,0,1,0,0,2,0,FW,20-24,Forward,Brazil,South America
2053,Paulinho,BRA,Leverkusen,Bundesliga,2022,22.0,2000.0,0.9,0,0,0,0,0,0,0,,0,1,0,1,0,0,2,0,FW,20-24,Forward,Brazil,South America
2053,Paulinho,BRA,Leverkusen,Bundesliga,2022,22.0,2000.0,0.9,0,0,0,0,0,0,0,,0,1,0,1,0,0,2,0,FW,20-24,Forward,Brazil,South America
2053,Paulinho,BRA,Leverkusen,Bundesliga,2022,22.0,2000.0,0.9,0,0,0,0,0,0,0,,0,1,0,1,0,0,2,0,FW,20-24,Forward,Brazil,South America
2053,Paulinho,BRA,Leverkusen,Bundesliga,2022,22.0,2000.0,0.9,0,0,0,0,0,0,0,,0,1,0,1,0,0,2,0,FW,20-24,Forward,Brazil,South America
2053,Paulinho,BRA,Leverkusen,Bundesliga,2022,22.0,2000.0,0.9,0,0,0,0,0,0,0,,0,1,0,1,0,0,2,0,FW,20-24,Forward,Brazil,South America
2053,Paulinho,BRA,Leverkusen,Bundesliga,2022,22.0,2000.0,0.9,0,0,0,0,0,0,0,,0,1,0,1,0,0,2,0,FW,20-24,Forward,Brazil,South America
2053,Paulinho,BRA,Leverkusen,Bundesliga,2022,22.0,2000.0,0.9,0,0,0,0,0,0,0,,0,1,0,1,0,0,2,0,FW,20-24,Forward,Brazil,South America
2053,Paulinho,BRA,Leverkusen,Bundesliga,2022,22.0,2000.0,0.9,0,0,0,0,0,0,0,,0,1,0,1,0,0,2,0,FW,20-24,Forward,Brazil,South America
2053,Paulinho,BRA,Leverkusen,Bundesliga,2022,22.0,2000.0,0.9,0,0,0,0,0,0,0,,0,1,0,1,0,0,2,0,FW,20-24,Forward,Brazil,South America
2053,Paulinho,BRA,Leverkusen,Bundesliga,2022,22.0,2000.0,0.9,0,0,0,0,0,0,0,,0,1,0,1,0,0,2,0,FW,20-24,Forward,Brazil,South America
2053,Paulinho,BRA,Leverkusen,Bundesliga,2022,22.0,2000.0,0.9,0,0,0,0,0,0,0,,0,1,0,1,0,0,2,0,FW,20-24,Forward,Brazil,South America
2053,Paulinho,BRA,Leverkusen,Bundesliga,2022,22.0,2000.0,0.9,0,0,0,0,0,0,0,,0,1,0,1,0,0,2,0,FW,20-24,Forward,Brazil,South America
2053,Paulinho,BRA,Leverkusen,Bundesliga,2022,22.0,2000.0,0.9,0,0,0,0,0,0,0,,0,1,0,1,0,0,2,0,FW,20-24,Forward,Brazil,South America
2053,Paulinho,BRA,Leverkusen,Bundesliga,2022,22.0,2000.0,0.9,0,0,0,0,0,0,0,,0,1,0,1,0,0,2,0,FW,20-24,Forward,Brazil,South America
2053,Paulinho,BRA,Leverkusen,Bundesliga,2022,22.0,2000.0,0.9,0,0,0,0,0,0,0,,0,1,0,1,0,0,2,0,FW,20-24,Forward,Brazil,South America
2053,Paulinho,BRA,Leverkusen,Bundesliga,2022,22.0,2000.0,0.9,0,0,0,0,0,0,0,,0,1,0,1,0,0,2,0,FW,20-24,Forward,Brazil,South America
2053,Paulinho,BRA,Leverkusen,Bundesliga,2022,22.0,2000.0,0.9,0,0,0,0,0,0,0,,0,1,0,1,0,0,2,0,FW,20-24,Forward,Brazil,South America
2053,Paulinho,BRA,Leverkusen,Bundesliga,2022,22.0,2000.0,0.9,0,0,0,0,0,0,0,,0,1,0,1,0,0,2,0,FW,20-24,Forward,Brazil,South America
2053,Paulinho,BRA,Leverkusen,Bundesliga,2022,22.0,2000.0,0.9,0,0,0,0,0,0,0,,0,1,0,1,0,0,2,0,FW,20-24,Forward,Brazil,South America
2053,Paulinho,BRA,Leverkusen,Bundesliga,2022,22.0,2000.0,0.9,0,0,0,0,0,0,0,,0,1,0,1,0,0,2,0,FW,20-24,Forward,Brazil,South America
2053,Paulinho,BRA,Leverkusen,Bundesliga,2022,22.0,2000.0,0.9,0,0,0,0,0,0,0,,0,1,0,1,0,0,2,0,FW,20-24,Forward,Brazil,South America
2053,Paulinho,BRA,Leverkusen,Bundesliga,2022,22.0,2000.0,0.9,0,0,0,0,0,0,0,,0,1,0,1,0,0,2,0,FW,20-24,Forward,Brazil,South America
2053,Paulinho,BRA,Leverkusen,Bundesliga,2022,22.0,2000.0,0.9,0,0,0,0,0,0,0,,0,1,0,1,0,0,2,0,FW,20-24,Forward,Brazil,South America
2053,Paulinho,BRA,Leverkusen,Bundesliga,2022,22.0,2000.0,0.9,0,0,0,0,0,0,0,,0,1,0,1,0,0,2,0,FW,20-24,Forward,Brazil,South America
2053,Paulinho,BRA,Leverkusen,Bundesliga,2022,22.0,2000.0,0.9,0,0,0,0,0,0,0,,0,1,0,1,0,0,2,0,FW,20-24,Forward,Brazil,South America
2053,Paulinho,BRA,Leverkusen,Bundesliga,2022,22.0,2000.0,0.9,0,0,0,0,0,0,0,,0,1,0,1,0,0,2,0,FW,20-24,Forward,Brazil,South America
2053,Paulinho,BRA,Leverkusen,Bundesliga,2022,22.0,2000.0,0.9,0,0,0,0,0,0,0,,0,1,0,1,0,0,2,0,FW,20-24,Forward,Brazil,South America
2053,Paulinho,BRA,Leverkusen,Bundesliga,2022,22.0,2000.0,0.9,0,0,0,0,0,0,0,,0,1,0,1,0,0,2,0,FW,20-24,Forward,Brazil,South America
2053,Paulinho,BRA,Leverkusen,Bundesliga,2022,22.0,2000.0,0.9,0,0,0,0,0,0,0,,0,1,0,1,0,0,2,0,FW,20-24,Forward,Brazil,South America
2053,Paulinho,BRA,Leverkusen,Bundesliga,2022,22.0,2000.0,0.9,0,0,0,0,0,0,0,,0,1,0,1,0,0,2,0,FW,20-24,Forward,Brazil,South America
2053,Paulinho,BRA,Leverkusen,Bundesliga,2022,22.0,2000.0,0.9,0,0,0,0,0,0,0,,0,1,0,1,0,0,2,0,FW,20-24,Forward,Brazil,South America
2053,Paulinho,BRA,Leverkusen,Bundesliga,2022,22.0,2000.0,0.9,0,0,0,0,0,0,0,,0,1,0,1,0,0,2,0,FW,20-24,Forward,Brazil,South America
2053,Paulinho,BRA,Leverkusen,Bundesliga,2022,22.0,2000.0,0.9,0,0,0,0,0,0,0,,0,1,0,1,0,0,2,0,FW,20-24,Forward,Brazil,South America
2053,Paulinho,BRA,Leverkusen,Bundesliga,2022,22.0,2000.0,0.9,0,0,0,0,0,0,0,,0,1,0,1,0,0,2,0,FW,20-24,Forward,Brazil,South America
2053,Paulinho,BRA,Leverkusen,Bundesliga,2022,22.0,2000.0,0.9,0,0,0,0,0,0,0,,0,1,0,1,0,0,2,0,FW,20-24,Forward,Brazil,South America
2053,Paulinho,BRA,Leverkusen,Bundesliga,2022,22.0,2000.0,0.9,0,0,0,0,0,0,0,,0,1,0,1,0,0,2,0,FW,20-24,Forward,Brazil,South America
2053,Paulinho,BRA,Leverkusen,Bundesliga,2022,22.0,2000.0,0.9,0,0,0,0,0,0,0,,0,1,0,1,0,0,2,0,FW,20-24,Forward,Brazil,South America
2053,Paulinho,BRA,Leverkusen,Bundesliga,2022,22.0,2000.0,0.9,0,0,0,0,0,0,0,,0,1,0,1,0,0,2,0,FW,20-24,Forward,Brazil,South America
2053,Paulinho,BRA,Leverkusen,Bundesliga,2022,22.0,2000.0,0.9,0,0,0,0,0,0,0,,0,1,0,1,0,0,2,0,FW,20-24,Forward,Brazil,South America
2053,Paulinho,BRA,Leverkusen,Bundesliga,2022,22.0,2000.0,0.9,0,0,0,0,0,0,0,,0,1,0,1,0,0,2,0,FW,20-24,Forward,Brazil,South America
2053,Paulinho,BRA,Leverkusen,Bundesliga,2022,22.0,2000.0,0.9,0,0,0,0,0,0,0,,0,1,0,1,0,0,2,0,FW,20-24,Forward,Brazil,South America
2053,Paulinho,BRA,Leverkusen,Bundesliga,2022,22.0,2000.0,0.9,0,0,0,0,0,0,0,,0,1,0,1,0,0,2,0,FW,20-24,Forward,Brazil,South America
2053,Paulinho,BRA,Leverkusen,Bundesliga,2022,22.0,2000.0,0.9,0,0,0,0,0,0,0,,0,1,0,1,0,0,2,0,FW,20-24,Forward,Brazil,South America
2053,Paulinho,BRA,Leverkusen,Bundesliga,2022,22.0,2000.0,0.9,0,0,0,0,0,0,0,,0,1,0,1,0,0,2,0,FW,20-24,Forward,Brazil,South America
2053,Paulinho,BRA,Leverkusen,Bundesliga,2022,22.0,2000.0,0.9,0,0,0,0,0,0,0,,0,1,0,1,0,0,2,0,FW,20-24,Forward,Brazil,South America
2053,Paulinho,BRA,Leverkusen,Bundesliga,2022,22.0,2000.0,0.9,0,0,0,0,0,0,0,,0,1,0,1,0,0,2,0,FW,20-24,Forward,Brazil,South America
2053,Paulinho,BRA,Leverkusen,Bundesliga,2022,22.0,2000.0,0.9,0,0,0,0,0,0,0,,0,1,0,1,0,0,2,0,FW,20-24,Forward,Brazil,South America
2053,Paulinho,BRA,Leverkusen,Bundesliga,2022,22.0,2000.0,0.9,0,0,0,0,0,0,0,,0,1,0,1,0,0,2,0,FW,20-24,Forward,Brazil,South America
2053,Paulinho,BRA,Leverkusen,Bundesliga,2022,22.0,2000.0,0.9,0,0,0,0,0,0,0,,0,1,0,1,0,0,2,0,FW,20-24,Forward,Brazil,South America
2053,Paulinho,BRA,Leverkusen,Bundesliga,2022,22.0,2000.0,0.9,0,0,0,0,0,0,0,,0,1,0,1,0,0,2,0,FW,20-24,Forward,Brazil,South America
2053,Paulinho,BRA,Leverkusen,Bundesliga,2022,22.0,2000.0,0.9,0,0,0,0,0,0,0,,0,1,0,1,0,0,2,0,FW,20-24,Forward,Brazil,South America
2053,Paulinho,BRA,Leverkusen,Bundesliga,2022,22.0,2000.0,0.9,0,0,0,0,0,0,0,,0,1,0,1,0,0,2,0,FW,20-24,Forward,Brazil,South America
2053,Paulinho,BRA,Leverkusen,Bundesliga,2022,22.0,2000.0,0.9,0,0,0,0,0,0,0,,0,1,0,1,0,0,2,0,FW,20-24,Forward,Brazil,South America
2053,Paulinho,BRA,Leverkusen,Bundesliga,2022,22.0,2000.0,0.9,0,0,0,0,0,0,0,,0,1,0,1,0,0,2,0,FW,20-24,Forward,Brazil,South America
2053,Paulinho,BRA,Leverkusen,Bundesliga,2022,22.0,2000.0,0.9,0,0,0,0,0,0,0,,0,1,0,1,0,0,2,0,FW,20-24,Forward,Brazil,South America
2053,Paulinho,BRA,Leverkusen,Bundesliga,2022,22.0,2000.0,0.9,0,0,0,0,0,0,0,,0,1,0,1,0,0,2,0,FW,20-24,Forward,Brazil,South America
2053,Paulinho,BRA,Leverkusen,Bundesliga,2022,22.0,2000.0,0.9,0,0,0,0,0,0,0,,0,1,0,1,0,0,2,0,FW,20-24,Forward,Brazil,South America
2053,Paulinho,BRA,Leverkusen,Bundesliga,2022,22.0,2000.0,0.9,0,0,0,0,0,0,0,,0,1,0,1,0,0,2,0,FW,20-24,Forward,Brazil,South America
2053,Paulinho,BRA,Leverkusen,Bundesliga,2022,22.0,2000.0,0.9,0,0,0,0,0,0,0,,0,1,0,1,0,0,2,0,FW,20-24,Forward,Brazil,South America
2053,Paulinho,BRA,Leverkusen,Bundesliga,2022,22.0,2000.0,0.9,0,0,0,0,0,0,0,,0,1,0,1,0,0,2,0,FW,20-24,Forward,Brazil,South America
2053,Paulinho,BRA,Leverkusen,Bundesliga,2022,22.0,2000.0,0.9,0,0,0,0,0,0,0,,0,1,0,1,0,0,2,0,FW,20-24,Forward,Brazil,South America
2053,Paulinho,BRA,Leverkusen,Bundesliga,2022,22.0,2000.0,0.9,0,0,0,0,0,0,0,,0,1,0,1,0,0,2,0,FW,20-24,Forward,Brazil,South America
2053,Paulinho,BRA,Leverkusen,Bundesliga,2022,22.0,2000.0,0.9,0,0,0,0,0,0,0,,0,1,0,1,0,0,2,0,FW,20-24,Forward,Brazil,South America
2053,Paulinho,BRA,Leverkusen,Bundesliga,2022,22.0,2000.0,0.9,0,0,0,0,0,0,0,,0,1,0,1,0,0,2,0,FW,20-24,Forward,Brazil,South America
2053,Paulinho,BRA,Leverkusen,Bundesliga,2022,22.0,2000.0,0.9,0,0,0,0,0,0,0,,0,1,0,1,0,0,2,0,FW,20-24,Forward,Brazil,South America
2053,Paulinho,BRA,Leverkusen,Bundesliga,2022,22.0,2000.0,0.9,0,0,0,0,0,0,0,,0,1,0,1,0,0,2,0,FW,20-24,Forward,Brazil,South America
2053,Paulinho,BRA,Leverkusen,Bundesliga,2022,22.0,2000.0,0.9,0,0,0,0,0,0,0,,0,1,0,1,0,0,2,0,FW,20-24,Forward,Brazil,South America
2053,Paulinho,BRA,Leverkusen,Bundesliga,2022,22.0,2000.0,0.9,0,0,0,0,0,0,0,,0,1,0,1,0,0,2,0,FW,20-24,Forward,Brazil,South America
2053,Paulinho,BRA,Leverkusen,Bundesliga,2022,22.0,2000.0,0.9,0,0,0,0,0,0,0,,0,1,0,1,0,0,2,0,FW,20-24,Forward,Brazil,South America
2053,Paulinho,BRA,Leverkusen,Bundesliga,2022,22.0,2000.0,0.9,0,0,0,0,0,0,0,,0,1,0,1,0,0,2,0,FW,20-24,Forward,Brazil,South America
2053,Paulinho,BRA,Leverkusen,Bundesliga,2022,22.0,2000.0,0.9,0,0,0,0,0,0,0,,0,1,0,1,0,0,2,0,FW,20-24,Forward,Brazil,South America
2053,Paulinho,BRA,Leverkusen,Bundesliga,2022,22.0,2000.0,0.9,0,0,0,0,0,0,0,,0,1,0,1,0,0,2,0,FW,20-24,Forward,Brazil,South America
2053,Paulinho,BRA,Leverkusen,Bundesliga,2022,22.0,2000.0,0.9,0,0,0,0,0,0,0,,0,1,0,1,0,0,2,0,FW,20-24,Forward,Brazil,South America
2053,Paulinho,BRA,Leverkusen,Bundesliga,2022,22.0,2000.0,0.9,0,0,0,0,0,0,0,,0,1,0,1,0,0,2,0,FW,20-24,Forward,Brazil,South America
2053,Paulinho,BRA,Leverkusen,Bundesliga,2022,22.0,2000.0,0.9,0,0,0,0,0,0,0,,0,1,0,1,0,0,2,0,FW,20-24,Forward,Brazil,South America
2053,Paulinho,BRA,Leverkusen,Bundesliga,2022,22.0,2000.0,0.9,0,0,0,0,0,0,0,,0,1,0,1,0,0,2,0,FW,20-24,Forward,Brazil,South America
2053,Paulinho,BRA,Leverkusen,Bundesliga,2022,22.0,2000.0,0.9,0,0,0,0,0,0,0,,0,1,0,1,0,0,2,0,FW,20-24,Forward,Brazil,South America
2054,Gabriel Paulista,BRA,Valencia,La Liga,2022,31.0,1990.0,16.7,17,9,13,4,0,13,19,68.4,6,22,14,8,32,49,79,2,DF,30-34,Defender,Brazil,South America
2055,Benjamin Pavard,FRA,Bayern Munich,Bundesliga,2022,26.0,1996.0,27.0,70,41,36,26,8,36,48,75.0,12,35,16,19,44,114,83,0,DF,25-29,Defender,France,Europe
2057,Dimitri Payet,FRA,Marseille,Ligue 1,2022,35.0,1987.0,9.3,6,4,2,2,2,3,11,27.3,8,4,0,4,0,6,4,0,"MF,FW",35-39,Midfielder,France,Europe
2058,Ben Pearson,ENG,Bournemouth,Premier League,2022,27.0,1995.0,3.2,7,3,3,3,1,1,3,33.3,2,4,0,4,2,9,6,0,MF,25-29,Midfielder,England,Europe
2059,Kristian Pedersen,DEN,Köln,Bundesliga,2022,27.0,1994.0,3.1,5,4,4,1,0,0,2,0.0,2,3,0,3,6,11,17,0,DF,25-29,Defender,Denmark,Europe
2060,Mads Pedersen,DEN,Augsburg,Bundesliga,2022,25.0,1996.0,20.4,44,23,31,11,2,22,33,66.7,11,32,9,23,20,64,41,1,"DF,MF",25-29,Defender,Denmark,Europe
2060,Mads Pedersen,DEN,Augsburg,Bundesliga,2022,25.0,1996.0,20.4,44,23,31,11,2,22,33,66.7,11,32,9,23,20,64,41,1,"DF,MF",25-29,Defender,Denmark,Europe
2060,Mads Pedersen,DEN,Augsburg,Bundesliga,2022,25.0,1996.0,20.4,44,23,31,11,2,22,33,66.7,11,32,9,23,20,64,41,1,"DF,MF",25-29,Defender,Denmark,Europe
2060,Mads Pedersen,DEN,Augsburg,Bundesliga,2022,25.0,1996.0,20.4,44,23,31,11,2,22,33,66.7,11,32,9,23,20,64,41,1,"DF,MF",25-29,Defender,Denmark,Europe
2065,Jordan Pefok,USA,Union Berlin,Bundesliga,2022,26.0,1996.0,15.1,15,7,3,4,8,2,17,11.8,15,17,5,12,4,19,15,0,FW,25-29,Forward,United States,North America
2066,Gianluca Pegolo,ITA,Sassuolo,Serie A,2022,41.0,1981.0,2.0,0,0,0,0,0,0,1,0.0,1,0,0,0,0,0,1,0,GK,Over 40,Goalkeeper,Italy,Europe
2067,Dženan Pejčinović,GER,Wolfsburg,Bundesliga,2022,17.0,2005.0,0.1,0,0,0,0,0,0,0,,0,0,0,0,0,0,0,0,FW,Under 20,Forward,Germany,Europe
2068,Peter Pekarík,SVK,Hertha BSC,Bundesliga,2022,35.0,1986.0,2.3,4,3,4,0,0,4,6,66.7,2,6,2,4,4,8,7,0,DF,35-39,Defender,Slovakia,Europe
2069,Pietro Pellegri,ITA,Torino,Serie A,2022,21.0,2001.0,5.2,6,2,1,3,2,2,3,66.7,1,5,1,4,0,6,4,0,FW,20-24,Forward,Italy,Europe
2070,Lorenzo Pellegrini,ITA,Roma,Serie A,2022,26.0,1996.0,28.3,52,29,24,24,4,22,48,45.8,26,27,4,23,26,78,22,0,MF,25-29,Midfielder,Italy,Europe
2071,Luca Pellegrini,ITA,Lazio,Serie A,2022,23.0,1999.0,2.0,1,0,0,1,0,1,4,25.0,3,3,0,3,7,8,4,0,DF,20-24,Defender,Italy,Europe
2072,Luca Pellegrini,ITA,Eint Frankfurt,Bundesliga,2022,23.0,1999.0,6.2,13,8,10,3,0,8,8,100.0,0,8,2,6,7,20,11,1,DF,20-24,Defender,Italy,Europe
2073,Théo Pellenard,FRA,Auxerre,Ligue 1,2022,28.0,1994.0,1.1,1,0,1,0,0,1,1,100.0,0,3,1,2,2,3,2,0,DF,25-29,Defender,France,Europe
2074,Facundo Pellistri,URU,Manchester Utd,Premier League,2022,20.0,2001.0,0.7,1,1,0,1,0,0,0,,0,0,0,0,0,1,3,0,"FW,MF",20-24,Forward,Uruguay,South America
2075,Timothee Pembele,FRA,Paris S-G,Ligue 1,2022,19.0,2002.0,2.9,5,5,3,1,1,2,4,50.0,2,2,0,2,4,9,2,0,DF,Under 20,Defender,France,Europe
2078,Patrick Pentz,AUT,Reims,Ligue 1,2022,25.0,1997.0,7.0,0,0,0,0,0,0,0,,0,0,0,0,0,0,1,0,GK,25-29,Goalkeeper,Austria,Europe
2079,Nicolas Pépé,CIV,Nice,Ligue 1,2022,27.0,1995.0,16.6,25,13,14,5,6,11,25,44.0,14,17,0,17,3,28,1,0,"FW,MF",25-29,Forward,Ivory Coast,Africa
2080,Ricardo Pepi,USA,Augsburg,Bundesliga,2022,19.0,2003.0,1.1,1,1,1,0,0,1,1,100.0,0,1,0,1,0,1,1,0,FW,Under 20,Forward,United States,North America
2081,Pepín,EQG,Monza,Serie A,2022,25.0,1996.0,12.5,28,19,10,11,7,9,27,33.3,18,14,3,11,13,41,17,0,MF,25-29,Midfielder,Equatorial Guinea,Africa
2083,Juan Perea,COL,Stuttgart,Bundesliga,2022,22.0,2000.0,4.6,5,4,0,2,3,2,4,50.0,2,2,1,1,1,6,3,0,FW,20-24,Forward,Colombia,South America
2084,Andreas Pereira,BRA,Fulham,Premier League,2022,26.0,1996.0,29.9,18,9,3,6,9,8,34,23.5,26,21,3,18,6,24,8,0,MF,25-29,Midfielder,Brazil,South America
2085,Brayann Pereira,FRA,Auxerre,Ligue 1,2022,19.0,2003.0,2.0,6,5,5,1,0,1,5,20.0,4,2,2,0,2,8,8,1,DF,Under 20,Defender,France,Europe
2086,Danilo Pereira,POR,Paris S-G,Ligue 1,2022,30.0,1991.0,26.8,32,17,15,14,3,19,26,73.1,7,26,19,7,36,68,59,1,"DF,MF",30-34,Defender,Portugal,Europe
2087,Mathias Pereira Lage,POR,Brest,Ligue 1,2022,25.0,1996.0,14.0,20,7,5,14,1,11,29,37.9,18,10,1,9,14,34,12,0,"MF,FW",25-29,Midfielder,Portugal,Europe
2088,Ricardo Pereira,POR,Leicester City,Premier League,2022,28.0,1993.0,5.0,11,7,8,3,0,7,17,41.2,10,8,2,6,4,15,20,0,"DF,MF",25-29,Defender,Portugal,Europe
2089,Roberto Pereyra,ARG,Udinese,Serie A,2022,31.0,1991.0,31.3,36,20,21,12,3,16,44,36.4,28,20,5,15,16,52,28,0,"DF,MF",30-34,Defender,Argentina,South America
2097,Nehuén Pérez,ARG,Udinese,Serie A,2022,22.0,2000.0,31.3,77,40,54,20,3,39,55,70.9,16,53,23,30,35,112,106,1,DF,20-24,Defender,Argentina,South America
2098,Simone Perilli,ITA,Hellas Verona,Serie A,2022,27.0,1995.0,1.0,0,0,0,0,0,0,0,,0,0,0,0,0,0,0,0,GK,25-29,Goalkeeper,Italy,Europe
2099,Mattia Perin,ITA,Juventus,Serie A,2022,29.0,1992.0,10.5,0,0,0,0,0,0,0,,0,0,0,0,0,0,0,0,GK,25-29,Goalkeeper,Italy,Europe
2100,Samuele Perisan,ITA,Empoli,Serie A,2022,24.0,1997.0,7.0,0,0,0,0,0,0,0,,0,0,0,0,0,0,2,0,GK,20-24,Goalkeeper,Italy,Europe
2101,Ivan Perišić,CRO,Tottenham,Premier League,2022,33.0,1989.0,23.4,42,24,25,10,7,27,47,57.4,20,29,7,22,22,64,49,1,"DF,MF",30-34,Defender,Croatia,Europe
2102,Romain Perraud,FRA,Southampton,Premier League,2022,24.0,1997.0,20.4,54,33,23,23,8,28,52,53.8,24,24,6,18,20,74,42,0,DF,20-24,Defender,France,Europe
2103,Gaëtan Perrin,FRA,Auxerre,Ligue 1,2022,26.0,1996.0,15.5,17,8,5,6,6,8,30,26.7,22,15,0,15,10,27,9,0,"MF,FW",25-29,Midfielder,France,Europe
2104,Lucas Perrin,FRA,Strasbourg,Ligue 1,2022,23.0,1998.0,19.6,44,27,28,14,2,25,49,51.0,24,13,5,8,36,80,53,0,DF,20-24,Defender,France,Europe
2105,Máximo Perrone,ARG,Manchester City,Premier League,2022,19.0,2003.0,0.2,0,0,0,0,0,0,0,,0,1,0,1,0,0,0,0,MF,Under 20,Midfielder,Argentina,South America
2106,Matteo Pessina,ITA,Monza,Serie A,2022,25.0,1997.0,32.6,57,36,28,21,8,26,62,41.9,36,50,15,35,37,94,33,1,MF,25-29,Midfielder,Italy,Europe
2107,Andrea Petagna,ITA,Monza,Serie A,2022,27.0,1995.0,18.5,7,5,2,3,2,3,6,50.0,3,16,4,12,3,10,18,0,FW,25-29,Forward,Italy,Europe
2108,Nils Petersen,GER,Freiburg,Bundesliga,2022,33.0,1988.0,3.1,6,4,0,3,3,2,5,40.0,3,11,2,9,1,7,6,0,FW,30-34,Forward,Germany,Europe
2109,Lukas Petkov,BUL,Augsburg,Bundesliga,2022,21.0,2000.0,1.6,5,1,4,1,0,2,3,66.7,1,4,1,3,1,6,0,0,"MF,FW",20-24,Midfielder,Bulgaria,Europe
2110,Cameron Peupion,AUS,Brighton,Premier League,2022,19.0,2002.0,0.1,0,0,0,0,0,0,0,,0,0,0,0,0,0,0,0,MF,Under 20,Midfielder,Australia,Oceania
2111,Germán Pezzella,ARG,Betis,La Liga,2022,31.0,1991.0,27.9,41,28,32,9,0,26,38,68.4,12,32,15,17,50,91,129,1,DF,30-34,Defender,Argentina,South America
2112,Giuseppe Pezzella,ITA,Lecce,Serie A,2022,24.0,1997.0,10.2,21,9,16,2,3,9,16,56.3,7,11,3,8,8,29,31,1,DF,20-24,Defender,Italy,Europe
2113,Luca Pfeiffer,GER,Stuttgart,Bundesliga,2022,25.0,1996.0,7.8,1,1,1,0,0,0,1,0.0,1,4,0,4,1,2,5,0,FW,25-29,Forward,Germany,Europe
2114,Maximilian Philipp,GER,Wolfsburg,Bundesliga,2022,28.0,1994.0,1.3,2,1,1,1,0,1,1,100.0,0,1,0,1,0,2,0,0,FW,25-29,Forward,Germany,Europe
2115,Maximilian Philipp,GER,Werder Bremen,Bundesliga,2022,28.0,1994.0,4.9,6,5,3,2,1,1,9,11.1,8,7,1,6,3,9,4,0,"FW,MF",25-29,Forward,Germany,Europe
2116,Kalvin Phillips,ENG,Manchester City,Premier League,2022,26.0,1995.0,3.3,6,4,3,3,0,2,10,20.0,8,7,3,4,5,11,10,0,MF,25-29,Midfielder,England,Europe
2117,Nathaniel Phillips,ENG,Liverpool,Premier League,2022,25.0,1997.0,0.7,2,1,0,2,0,2,2,100.0,0,0,0,0,2,4,1,0,DF,25-29,Defender,England,Europe
2119,Roberto Piccoli,ITA,Hellas Verona,Serie A,2022,21.0,2001.0,2.1,1,0,1,0,0,0,2,0.0,2,2,0,2,0,1,2,0,FW,20-24,Forward,Italy,Europe
2120,Roberto Piccoli,ITA,Empoli,Serie A,2022,21.0,2001.0,5.7,1,1,1,0,0,0,3,0.0,3,4,1,3,1,2,9,0,FW,20-24,Forward,Italy,Europe
2121,Charles Pickel,COD,Cremonese,Serie A,2022,25.0,1997.0,27.6,55,23,25,26,4,32,57,56.1,25,37,5,32,24,79,36,1,MF,25-29,Midfielder,DR Congo,Africa
2122,Jordan Pickford,ENG,Everton,Premier League,2022,28.0,1994.0,37.0,0,0,0,0,0,0,1,0.0,1,0,0,0,4,4,15,3,GK,25-29,Goalkeeper,England,Europe
2123,Amos Pieper,GER,Werder Bremen,Bundesliga,2022,24.0,1998.0,21.7,46,28,25,19,2,24,40,60.0,16,23,11,12,30,76,94,1,DF,20-24,Defender,Germany,Europe
2124,Ronaël Pierre-Gabriel,FRA,Espanyol,La Liga,2022,24.0,1998.0,2.6,17,9,12,4,1,5,11,45.5,6,5,2,3,9,26,11,0,DF,20-24,Defender,France,Europe
2125,Ronaël Pierre-Gabriel,FRA,Strasbourg,Ligue 1,2022,24.0,1998.0,7.3,25,18,11,12,2,15,17,88.2,2,16,3,13,9,34,22,0,DF,20-24,Defender,France,Europe
2126,Andrea Pinamonti,ITA,Sassuolo,Serie A,2022,23.0,1999.0,24.0,10,7,0,5,5,3,7,42.9,4,19,2,17,2,12,11,0,FW,20-24,Forward,Italy,Europe
2127,Ethan Pinnock,JAM,Brentford,Premier League,2022,29.0,1993.0,30.0,52,28,33,12,7,18,24,75.0,6,41,31,10,35,87,215,2,DF,25-29,Defender,Jamaica,North America
2130,Lorenzo Pirola,ITA,Salernitana,Serie A,2022,20.0,2002.0,21.6,33,29,18,14,1,19,27,70.4,8,50,35,15,30,63,85,1,DF,20-24,Defender,Italy,Europe
2131,Niccolò Pisilli,ITA,Roma,Serie A,2022,17.0,2004.0,0.0,0,0,0,0,0,0,0,,0,0,0,0,0,0,0,0,MF,Under 20,Midfielder,Italy,Europe
2132,Marko Pjaca,CRO,Empoli,Serie A,2022,27.0,1995.0,5.8,4,3,3,1,0,3,5,60.0,2,3,0,3,3,7,3,0,"MF,FW",25-29,Midfielder,Croatia,Europe
2134,Gonzalo Plata,ECU,Valladolid,La Liga,2022,21.0,2000.0,25.6,66,35,31,24,11,23,70,32.9,47,40,0,40,12,78,10,1,FW,20-24,Forward,Ecuador,South America
2135,Marvin Plattenhardt,GER,Hertha BSC,Bundesliga,2022,30.0,1992.0,26.7,43,33,24,15,4,29,47,61.7,18,25,11,14,15,58,82,0,DF,30-34,Defender,Germany,Europe
2136,Alassane Pléa,FRA,Gladbach,Bundesliga,2022,29.0,1993.0,19.7,16,8,5,7,4,8,26,30.8,18,23,3,20,12,28,14,0,FW,25-29,Forward,France,Europe
2137,Tommaso Pobega,ITA,Milan,Serie A,2022,23.0,1999.0,9.8,27,16,8,15,4,13,20,65.0,7,12,4,8,9,36,11,0,MF,20-24,Midfielder,Italy,Europe
2138,Daniel Podence,POR,Wolves,Premier League,2022,26.0,1995.0,19.7,27,17,13,9,5,6,32,18.8,26,19,0,19,7,34,6,0,"FW,MF",25-29,Forward,Portugal,Europe
2139,Paul Pogba,FRA,Juventus,Serie A,2022,29.0,1993.0,1.2,0,0,0,0,0,0,1,0.0,1,0,0,0,0,0,2,0,"MF,FW",25-29,Midfielder,France,Europe
2140,Joel Pohjanpalo,FIN,Leverkusen,Bundesliga,2022,27.0,1994.0,0.0,0,0,0,0,0,0,0,,0,0,0,0,0,0,0,0,"FW,MF",25-29,Forward,Finland,Europe
2141,Matteo Politano,ITA,Napoli,Serie A,2022,28.0,1993.0,13.0,18,9,9,5,4,11,25,44.0,14,6,0,6,7,25,7,0,FW,25-29,Forward,Italy,Europe
2142,Sebastian Polter,GER,Schalke 04,Bundesliga,2022,31.0,1991.0,7.0,4,3,0,4,0,1,4,25.0,3,4,0,4,1,5,6,0,FW,30-34,Forward,Germany,Europe
2143,Ezequiel Ponce,ARG,Elche,La Liga,2022,25.0,1997.0,12.5,9,7,0,6,3,0,7,0.0,7,6,1,5,1,10,13,0,"FW,MF",25-29,Forward,Argentina,South America
2144,Julien Ponceau,FRA,Lorient,Ligue 1,2022,21.0,2000.0,18.4,28,19,10,14,4,10,32,31.3,22,27,3,24,14,42,12,0,MF,20-24,Midfielder,France,Europe
2145,Marin Pongračić,CRO,Lecce,Serie A,2022,24.0,1997.0,8.8,16,14,8,7,1,5,7,71.4,2,4,3,1,16,32,31,0,DF,20-24,Defender,Croatia,Europe
2146,Nick Pope,ENG,Newcastle Utd,Premier League,2022,30.0,1992.0,36.2,1,0,1,0,0,1,3,33.3,2,0,0,0,0,1,27,2,GK,30-34,Goalkeeper,England,Europe
2148,Jackson Porozo,ECU,Troyes,Ligue 1,2022,21.0,2000.0,18.0,32,20,24,7,1,13,31,41.9,18,24,17,7,33,65,75,0,DF,20-24,Defender,Ecuador,South America
2152,Stefan Posch,AUT,Bologna,Serie A,2022,25.0,1997.0,28.1,81,43,41,29,11,44,75,58.7,31,44,15,29,35,116,69,0,DF,25-29,Defender,Austria,Europe
2153,Stefan Posch,AUT,Hoffenheim,Bundesliga,2022,25.0,1997.0,0.2,0,0,0,0,0,0,0,,0,0,0,0,0,0,0,0,DF,25-29,Defender,Austria,Europe
2154,Yussuf Poulsen,DEN,RB Leipzig,Bundesliga,2022,28.0,1994.0,4.6,6,4,1,4,1,2,5,40.0,3,3,1,2,0,6,5,0,FW,25-29,Forward,Denmark,Europe
2158,Dennis Praet,BEL,Leicester City,Premier League,2022,28.0,1994.0,7.2,12,9,5,6,1,6,11,54.5,5,12,2,10,5,17,6,0,"MF,FW",25-29,Midfielder,Belgium,Europe
2160,Sanjin Prcić,BIH,Strasbourg,Ligue 1,2022,28.0,1993.0,18.1,27,12,6,16,5,19,31,61.3,12,22,7,15,25,52,22,0,MF,25-29,Midfielder,Bosnia and Herzegovina,Europe
2162,Grischa Prömel,GER,Hoffenheim,Bundesliga,2022,27.0,1995.0,16.2,27,19,14,11,2,9,25,36.0,16,22,4,18,8,35,23,0,MF,25-29,Midfielder,Germany,Europe
2163,Ivan Provedel,ITA,Lazio,Serie A,2022,28.0,1994.0,37.9,1,0,1,0,0,0,0,,0,0,0,0,0,1,15,1,GK,25-29,Goalkeeper,Italy,Europe
2165,Mehdi Puch-Herrantz,FRA,Ajaccio,Ligue 1,2022,18.0,2004.0,0.5,2,2,0,1,1,1,2,50.0,1,1,0,1,3,5,0,0,MF,Under 20,Midfielder,France,Europe
2168,Christian Pulisic,USA,Chelsea,Premier League,2022,23.0,1998.0,9.1,11,6,3,6,2,3,5,60.0,2,8,1,7,4,15,4,0,"FW,DF",20-24,Forward,United States,North America
2169,Ignacio Pussetto,ARG,Sampdoria,Serie A,2022,26.0,1995.0,1.7,6,3,2,3,1,3,4,75.0,1,4,0,4,0,6,3,0,"MF,DF",25-29,Midfielder,Argentina,South America
2170,Niklas Pyyhtiä,FIN,Bologna,Serie A,2022,18.0,2003.0,1.2,1,0,0,1,0,0,1,0.0,1,1,1,0,1,2,4,0,MF,Under 20,Midfielder,Finland,Europe
2171,Fabio Quagliarella,ITA,Sampdoria,Serie A,2022,39.0,1983.0,8.9,2,1,1,1,0,1,7,14.3,6,5,1,4,0,2,9,0,FW,35-39,Forward,Italy,Europe
2172,Giacomo Quagliata,ITA,Cremonese,Serie A,2022,22.0,2000.0,7.8,10,8,7,1,2,5,11,45.5,6,7,2,5,11,21,8,0,DF,20-24,Defender,Italy,Europe
2173,Eduardo Quaresma,POR,Hoffenheim,Bundesliga,2022,20.0,2002.0,1.0,5,3,3,2,0,1,3,33.3,2,3,2,1,0,5,3,0,DF,20-24,Defender,Portugal,Europe
2174,Joshua Quarshie,GER,Hoffenheim,Bundesliga,2022,18.0,2004.0,0.0,0,0,0,0,0,0,0,,0,0,0,0,0,0,0,0,MF,Under 20,Midfielder,Germany,Europe
2175,Ghjuvanni Quilichini,FRA,Ajaccio,Ligue 1,2022,19.0,2002.0,0.9,0,0,0,0,0,0,0,,0,0,0,0,0,0,1,0,GK,Under 20,Goalkeeper,France,Europe
2176,Domingos Quina,POR,Elche,La Liga,2022,22.0,1999.0,3.1,3,2,2,1,0,1,3,33.3,2,5,0,5,3,6,1,0,MF,20-24,Midfielder,Portugal,Europe
2178,Adrien Rabiot,FRA,Juventus,Serie A,2022,27.0,1995.0,30.5,65,35,31,23,11,30,57,52.6,27,37,7,30,26,91,44,1,MF,25-29,Midfielder,France,Europe
2181,Ionuț Radu,ROU,Cremonese,Serie A,2022,25.0,1997.0,9.0,0,0,0,0,0,0,0,,0,0,0,0,0,0,1,3,GK,25-29,Goalkeeper,Romania,Europe
2182,Ionuț Radu,ROU,Auxerre,Ligue 1,2022,25.0,1997.0,17.0,0,0,0,0,0,0,0,,0,0,0,0,0,0,3,3,GK,25-29,Goalkeeper,Romania,Europe
2183,Ștefan Radu,ROU,Lazio,Serie A,2022,35.0,1986.0,0.0,0,0,0,0,0,0,0,,0,0,0,0,0,0,0,0,FW,35-39,Forward,Romania,Europe
2185,Antonio Raimondo,ITA,Bologna,Serie A,2022,18.0,2004.0,0.2,0,0,0,0,0,0,0,,0,0,0,0,0,0,1,0,FW,Under 20,Forward,Italy,Europe
2187,Ivan Rakitić,CRO,Sevilla,La Liga,2022,34.0,1988.0,19.9,37,26,10,18,9,19,40,47.5,21,21,1,20,27,64,20,0,MF,30-34,Midfielder,Croatia,Europe
2188,Diant Ramaj,GER,Eint Frankfurt,Bundesliga,2022,20.0,2001.0,1.0,0,0,0,0,0,0,0,,0,0,0,0,0,0,1,0,GK,20-24,Goalkeeper,Germany,Europe
2189,Largie Ramazani,BEL,Almería,La Liga,2022,21.0,2001.0,15.6,15,9,6,3,6,8,27,29.6,19,11,0,11,15,30,10,0,"FW,MF",20-24,Forward,Belgium,Europe
2190,Simon Ramet,FRA,Lille,Ligue 1,2022,19.0,2003.0,0.0,0,0,0,0,0,0,0,,0,0,0,0,0,0,0,0,DF,Under 20,Defender,France,Europe
2191,Adil Rami,FRA,Troyes,Ligue 1,2022,36.0,1985.0,17.7,19,14,13,5,1,17,32,53.1,15,23,16,7,25,44,75,3,DF,35-39,Defender,France,Europe
2194,Aaron Ramsdale,ENG,Arsenal,Premier League,2022,24.0,1998.0,38.0,1,1,1,0,0,1,1,100.0,0,0,0,0,0,1,20,6,GK,20-24,Goalkeeper,England,Europe
2195,Aaron Ramsey,WAL,Nice,Ligue 1,2022,31.0,1990.0,17.6,47,25,18,19,10,16,39,41.0,23,25,4,21,17,64,18,1,MF,30-34,Midfielder,Wales,Europe
2195,Aaron Ramsey,WAL,Nice,Ligue 1,2022,31.0,1990.0,17.6,47,25,18,19,10,16,39,41.0,23,25,4,21,17,64,18,1,MF,30-34,Midfielder,Wales,Europe
2195,Aaron Ramsey,WAL,Nice,Ligue 1,2022,31.0,1990.0,17.6,47,25,18,19,10,16,39,41.0,23,25,4,21,17,64,18,1,MF,30-34,Midfielder,Wales,Europe
2195,Aaron Ramsey,WAL,Nice,Ligue 1,2022,31.0,1990.0,17.6,47,25,18,19,10,16,39,41.0,23,25,4,21,17,64,18,1,MF,30-34,Midfielder,Wales,Europe
2196,Jacob Ramsey,ENG,Aston Villa,Premier League,2022,21.0,2001.0,29.3,69,39,23,35,11,32,69,46.4,37,48,8,40,23,92,34,0,"MF,FW",20-24,Midfielder,England,Europe
2197,Luca Ranieri,ITA,Fiorentina,Serie A,2022,23.0,1999.0,5.6,9,4,6,3,0,6,9,66.7,3,5,3,2,11,20,15,1,DF,20-24,Defender,Italy,Europe
2198,Andrea Ranocchia,ITA,Monza,Serie A,2022,34.0,1988.0,0.5,3,1,1,2,0,3,4,75.0,1,5,5,0,0,3,7,0,DF,30-34,Defender,Italy,Europe
2199,Filippo Ranocchia,ITA,Monza,Serie A,2022,21.0,2001.0,5.9,11,6,5,4,2,4,12,33.3,8,5,1,4,4,15,7,0,MF,20-24,Midfielder,Italy,Europe
2200,Lilian Raolisoa,FRA,Angers,Ligue 1,2022,22.0,2000.0,1.9,11,9,6,3,2,7,10,70.0,3,3,1,2,3,14,5,0,"DF,MF",20-24,Defender,France,Europe
2201,Raphinha,BRA,Barcelona,La Liga,2022,25.0,1996.0,23.0,29,19,10,7,12,11,31,35.5,20,33,1,32,14,43,11,1,FW,25-29,Forward,Brazil,South America
2202,Nicolai Rapp,GER,Werder Bremen,Bundesliga,2022,25.0,1996.0,0.8,3,1,3,0,0,0,3,0.0,3,0,0,0,0,3,1,0,"MF,DF",25-29,Midfielder,Germany,Europe
2204,Marcus Rashford,ENG,Manchester Utd,Premier League,2022,24.0,1997.0,32.0,20,10,7,8,5,9,24,37.5,15,31,4,27,7,27,14,0,FW,20-24,Forward,England,Europe
2205,Giacomo Raspadori,ITA,Sassuolo,Serie A,2022,22.0,2000.0,0.5,0,0,0,0,0,0,0,,0,0,0,0,0,0,0,0,FW,20-24,Forward,Italy,Europe
2206,Giacomo Raspadori,ITA,Napoli,Serie A,2022,22.0,2000.0,10.1,10,8,0,6,4,4,10,40.0,6,9,0,9,4,14,4,0,"FW,MF",20-24,Forward,Italy,Europe
2207,Rafael Ratão,BRA,Toulouse,Ligue 1,2022,26.0,1995.0,20.6,52,36,29,16,7,27,73,37.0,46,34,0,34,21,73,7,0,"FW,MF",25-29,Forward,Brazil,South America
2208,David Raum,GER,RB Leipzig,Bundesliga,2022,24.0,1998.0,18.7,39,25,23,12,4,17,29,58.6,12,24,6,18,16,55,26,1,"DF,MF",20-24,Defender,Germany,Europe
2209,Nicola Ravaglia,ITA,Sampdoria,Serie A,2022,33.0,1988.0,9.0,0,0,0,0,0,0,1,0.0,1,0,0,0,0,0,7,0,GK,30-34,Goalkeeper,Italy,Europe
2210,Rayan Raveloson,MAD,Auxerre,Ligue 1,2022,25.0,1997.0,27.0,38,23,21,16,1,23,33,69.7,10,43,12,31,39,77,70,0,"DF,MF",25-29,Defender,Madagascar,Africa
2212,Tim Ream,USA,Fulham,Premier League,2022,34.0,1987.0,32.2,30,16,15,12,3,13,26,50.0,13,45,24,21,41,71,116,3,DF,30-34,Defender,United States,North America
2213,Ante Rebić,CRO,Milan,Serie A,2022,28.0,1993.0,10.9,10,8,1,3,6,3,11,27.3,8,6,1,5,1,11,5,0,"FW,MF",25-29,Forward,Croatia,Europe
2215,Nathan Redmond,ENG,Southampton,Premier League,2022,28.0,1994.0,0.0,0,0,0,0,0,0,0,,0,0,0,0,0,0,0,0,DF,25-29,Defender,England,Europe
2216,Harrison Reed,ENG,Fulham,Premier League,2022,27.0,1995.0,31.8,44,27,17,21,6,16,51,31.4,35,54,12,42,19,63,36,0,MF,25-29,Midfielder,England,Europe
2218,Bobby Reid,JAM,Fulham,Premier League,2022,29.0,1993.0,27.5,42,24,14,14,14,16,36,44.4,20,25,3,22,20,62,28,1,"FW,DF",25-29,Forward,Jamaica,North America
2220,Jeff Reine-Adélaïde,FRA,Troyes,Ligue 1,2022,24.0,1998.0,2.6,3,2,2,1,0,1,2,50.0,1,2,0,2,2,5,1,0,MF,20-24,Midfielder,France,Europe
2221,Jeff Reine-Adélaïde,FRA,Lyon,Ligue 1,2022,24.0,1998.0,3.7,8,5,1,5,2,5,9,55.6,4,4,0,4,6,14,0,0,MF,20-24,Midfielder,France,Europe
2222,Reinier,BRA,Girona,La Liga,2022,20.0,2002.0,7.2,12,10,7,3,2,2,8,25.0,6,6,0,6,5,17,4,0,"MF,FW",20-24,Midfielder,Brazil,South America
2223,Rocco Reitz,GER,Gladbach,Bundesliga,2022,20.0,2002.0,0.0,0,0,0,0,0,0,0,,0,0,0,0,0,0,0,0,MF,20-24,Midfielder,Germany,Europe
2224,Karim Rekik,NED,Sevilla,La Liga,2022,27.0,1994.0,13.1,11,5,8,3,0,4,5,80.0,1,12,5,7,10,21,24,0,DF,25-29,Defender,Netherlands,Europe
2226,Panagiotis Retsos,GRE,Hellas Verona,Serie A,2022,23.0,1998.0,1.4,5,4,2,2,1,3,3,100.0,0,4,1,3,2,7,3,0,DF,20-24,Defender,Greece,Europe
2227,Marco Reus,GER,Dortmund,Bundesliga,2022,33.0,1989.0,15.0,30,17,12,14,4,7,24,29.2,17,12,4,8,8,38,8,0,"MF,FW",30-34,Midfielder,Germany,Europe
2230,Gio Reyna,USA,Dortmund,Bundesliga,2022,19.0,2002.0,6.9,14,7,2,5,7,5,10,50.0,5,8,2,6,3,17,5,0,"FW,MF",Under 20,Forward,United States,North America
2231,Chadi Riad,MAR,Barcelona,La Liga,2022,19.0,2003.0,0.0,0,0,0,0,0,0,0,,0,0,0,0,0,0,0,0,MF,Under 20,Midfielder,Morocco,Africa
2233,Alexsandro Ribeiro,BRA,Lille,Ligue 1,2022,22.0,1999.0,17.9,32,18,24,7,1,19,28,67.9,9,11,2,9,25,57,59,1,DF,20-24,Defender,Brazil,South America
2234,Franck Ribéry,FRA,Salernitana,Serie A,2022,39.0,1983.0,0.4,0,0,0,0,0,0,0,,0,1,0,1,0,0,0,0,MF,35-39,Midfielder,France,Europe
2235,Samuele Ricci,ITA,Torino,Serie A,2022,20.0,2001.0,23.0,32,21,17,10,5,18,23,78.3,5,20,5,15,17,49,29,1,MF,20-24,Midfielder,Italy,Europe
2236,Declan Rice,ENG,West Ham,Premier League,2022,23.0,1999.0,36.4,79,38,44,31,4,31,50,62.0,19,45,15,30,63,142,58,0,MF,20-24,Midfielder,England,Europe
2237,Chris Richards,USA,Crystal Palace,Premier League,2022,22.0,2000.0,5.0,9,6,8,1,0,5,7,71.4,2,10,1,9,8,17,31,0,DF,20-24,Defender,United States,North America
2238,Richarlison,BRA,Tottenham,Premier League,2022,25.0,1997.0,11.2,21,16,13,5,3,12,27,44.4,15,14,1,13,5,26,10,0,"MF,FW",25-29,Midfielder,Brazil,South America
2239,Marco Richter,GER,Hertha BSC,Bundesliga,2022,24.0,1997.0,20.4,43,23,18,17,8,19,48,39.6,29,29,2,27,24,67,25,0,"MF,FW",20-24,Midfielder,Germany,Europe
2241,Jaïro Riedewald,NED,Crystal Palace,Premier League,2022,25.0,1996.0,0.7,2,1,2,0,0,0,1,0.0,1,2,0,2,0,2,4,0,"DF,MF",25-29,Defender,Netherlands,Europe
2242,Manuel Riemann,GER,Bochum,Bundesliga,2022,33.0,1988.0,34.0,3,2,3,0,0,3,5,60.0,2,1,0,1,5,8,23,7,GK,30-34,Goalkeeper,Germany,Europe
2243,Tomás Rincón,VEN,Sampdoria,Serie A,2022,34.0,1988.0,28.4,56,27,22,26,8,29,61,47.5,32,37,7,30,30,86,18,0,MF,30-34,Midfielder,Venezuela,South America
2244,Rémy Riou,FRA,Lyon,Ligue 1,2022,34.0,1987.0,6.7,1,0,1,0,0,1,1,100.0,0,0,0,0,0,1,3,0,GK,30-34,Goalkeeper,France,Europe
2245,Renaud Ripart,FRA,Troyes,Ligue 1,2022,29.0,1993.0,14.7,40,23,14,20,6,19,52,36.5,33,29,2,27,7,47,5,0,"FW,MF",25-29,Forward,France,Europe
2247,Matt Ritchie,SCO,Newcastle Utd,Premier League,2022,32.0,1989.0,0.4,1,1,0,1,0,1,3,33.3,2,0,0,0,1,2,0,0,"FW,MF",30-34,Forward,Scotland,Europe
2249,Lucas Robertone,ARG,Almería,La Liga,2022,25.0,1997.0,31.6,50,28,20,21,9,28,64,43.8,36,45,7,38,46,96,46,1,MF,25-29,Midfielder,Argentina,South America
2250,Andrew Robertson,SCO,Liverpool,Premier League,2022,28.0,1994.0,28.7,38,21,12,16,10,21,41,51.2,20,32,5,27,18,56,50,3,DF,25-29,Defender,Scotland,Europe
2251,Antonee Robinson,USA,Fulham,Premier League,2022,24.0,1997.0,34.3,62,38,43,15,4,44,65,67.7,21,49,13,36,53,115,83,3,DF,20-24,Defender,United States,North America
2255,Enzo Roco,CHI,Elche,La Liga,2022,29.0,1992.0,18.4,33,13,23,10,0,15,24,62.5,9,22,15,7,17,50,63,1,DF,25-29,Defender,Chile,South America
2256,Marek Rodák,SVK,Fulham,Premier League,2022,25.0,1996.0,2.0,0,0,0,0,0,0,0,,0,0,0,0,0,0,1,1,GK,25-29,Goalkeeper,Slovakia,Europe
2257,Sebastian Rode,GER,Eint Frankfurt,Bundesliga,2022,31.0,1990.0,15.7,38,24,7,28,3,14,45,31.1,31,18,2,16,16,54,12,0,MF,30-34,Midfielder,Germany,Europe
2258,Joe Rodon,WAL,Rennes,Ligue 1,2022,24.0,1997.0,15.7,11,7,9,2,0,4,10,40.0,6,16,12,4,9,20,54,1,DF,20-24,Defender,Wales,Europe
2262,Álvaro Rodríguez,URU,Real Madrid,La Liga,2022,18.0,2004.0,0.9,2,1,1,0,1,1,1,100.0,0,0,0,0,0,2,1,0,FW,Under 20,Forward,Uruguay,South America
2266,Guido Rodríguez,ARG,Betis,La Liga,2022,28.0,1994.0,31.9,115,75,59,50,6,54,101,53.5,47,58,14,44,42,157,76,1,MF,25-29,Midfielder,Argentina,South America
2269,Ricardo Rodríguez,SUI,Torino,Serie A,2022,29.0,1992.0,29.7,54,33,30,17,7,28,42,66.7,14,30,15,15,38,92,61,0,DF,25-29,Defender,Switzerland,Europe
2270,Rodrygo,BRA,Real Madrid,La Liga,2022,21.0,2001.0,26.4,17,10,3,7,7,4,23,17.4,19,23,0,23,8,25,5,0,"FW,MF",20-24,Forward,Brazil,South America
2271,Mads Roerslev,DEN,Brentford,Premier League,2022,23.0,1999.0,12.3,22,12,19,3,0,16,33,48.5,17,14,5,9,9,31,38,0,DF,20-24,Defender,Denmark,Europe
2272,Agustín Rogel,URU,Hertha BSC,Bundesliga,2022,24.0,1997.0,15.8,18,9,13,5,0,11,17,64.7,6,15,8,7,11,29,74,1,DF,20-24,Defender,Uruguay,South America
2273,Rogério,BRA,Sassuolo,Serie A,2022,24.0,1998.0,33.3,37,21,22,8,7,17,35,48.6,18,32,9,23,37,74,70,0,DF,20-24,Defender,Brazil,South America
2273,Rogério,BRA,Sassuolo,Serie A,2022,24.0,1998.0,33.3,37,21,22,8,7,17,35,48.6,18,32,9,23,37,74,70,0,DF,20-24,Defender,Brazil,South America
2273,Rogério,BRA,Sassuolo,Serie A,2022,24.0,1998.0,33.3,37,21,22,8,7,17,35,48.6,18,32,9,23,37,74,70,0,DF,20-24,Defender,Brazil,South America
2273,Rogério,BRA,Sassuolo,Serie A,2022,24.0,1998.0,33.3,37,21,22,8,7,17,35,48.6,18,32,9,23,37,74,70,0,DF,20-24,Defender,Brazil,South America
2274,Merlin Röhl,GER,Freiburg,Bundesliga,2022,20.0,2002.0,0.6,1,0,1,0,0,0,0,,0,0,0,0,0,1,1,0,"MF,FW",20-24,Midfielder,Germany,Europe
2275,Tony Rölke,GER,Hertha BSC,Bundesliga,2022,19.0,2003.0,0.2,0,0,0,0,0,0,0,,0,1,0,1,0,0,1,0,FW,Under 20,Forward,Germany,Europe
2276,Filippo Romagna,ITA,Sassuolo,Serie A,2022,25.0,1997.0,0.5,0,0,0,0,0,0,0,,0,1,1,0,0,0,2,0,DF,25-29,Defender,Italy,Europe
2277,Alessio Romagnoli,ITA,Lazio,Serie A,2022,27.0,1995.0,32.5,33,15,19,14,0,11,22,50.0,11,33,26,7,38,71,108,0,DF,25-29,Defender,Italy,Europe
2278,Simone Romagnoli,ITA,Lecce,Serie A,2022,32.0,1990.0,1.9,6,5,3,3,0,2,2,100.0,0,4,1,3,1,7,11,0,DF,30-34,Defender,Italy,Europe
2280,Cristian Romero,ARG,Tottenham,Premier League,2022,24.0,1998.0,26.3,68,36,42,24,2,29,46,63.0,17,40,18,22,44,112,102,3,DF,20-24,Defender,Argentina,South America
2282,Luka Romero,ARG,Lazio,Serie A,2022,17.0,2004.0,1.7,0,0,0,0,0,0,3,0.0,3,4,0,4,3,3,1,0,FW,Under 20,Forward,Argentina,South America
2285,Cristiano Ronaldo,POR,Manchester Utd,Premier League,2022,37.0,1985.0,5.8,2,2,1,0,1,1,2,50.0,1,0,0,0,1,3,9,0,FW,35-39,Forward,Portugal,Europe
2286,Connor Ronan,IRL,Wolves,Premier League,2022,24.0,1998.0,0.0,0,0,0,0,0,0,0,,0,0,0,0,0,0,0,0,MF,20-24,Midfielder,Republic of Ireland,Europe
2287,Salomón Rondón,VEN,Everton,Premier League,2022,32.0,1989.0,1.2,0,0,0,0,0,0,0,,0,1,1,0,0,0,0,0,FW,30-34,Forward,Venezuela,South America
2288,Valentin Rongier,FRA,Marseille,Ligue 1,2022,27.0,1994.0,33.7,93,59,33,47,13,41,77,53.2,36,50,11,39,54,147,38,1,MF,25-29,Midfielder,France,Europe
2289,Marten de Roon,NED,Atalanta,Serie A,2022,31.0,1991.0,32.9,77,39,37,35,5,37,81,45.7,44,37,4,33,36,113,58,0,MF,30-34,Midfielder,Netherlands,Europe
2290,Pablo Rosario,NED,Nice,Ligue 1,2022,25.0,1997.0,19.6,46,26,22,20,4,18,34,52.9,16,15,5,10,23,69,32,1,"MF,DF",25-29,Midfielder,Netherlands,Europe
2291,Francesco Rossi,ITA,Atalanta,Serie A,2022,31.0,1991.0,0.0,0,0,0,0,0,0,0,,0,0,0,0,0,0,0,0,GK,30-34,Goalkeeper,Italy,Europe
2292,Tom Rothe,GER,Dortmund,Bundesliga,2022,17.0,2004.0,0.3,1,1,0,1,0,1,1,100.0,0,0,0,0,1,2,2,0,DF,Under 20,Defender,Germany,Europe
2293,Joe Rothwell,ENG,Bournemouth,Premier League,2022,27.0,1995.0,11.3,20,13,7,12,1,7,21,33.3,14,14,3,11,9,29,7,0,MF,25-29,Midfielder,England,Europe
2294,Anthony Rouault,FRA,Toulouse,Ligue 1,2022,21.0,2001.0,36.8,66,37,54,10,2,30,58,51.7,28,52,26,26,56,122,126,4,DF,20-24,Defender,France,Europe
2295,Jérôme Roussillon,FRA,Wolfsburg,Bundesliga,2022,29.0,1993.0,0.2,0,0,0,0,0,0,0,,0,0,0,0,0,0,0,0,"MF,DF",25-29,Midfielder,France,Europe
2296,Jérôme Roussillon,FRA,Union Berlin,Bundesliga,2022,29.0,1993.0,10.6,16,9,6,8,2,8,12,66.7,4,7,2,5,4,20,22,0,DF,25-29,Defender,France,Europe
2297,Nicolò Rovella,ITA,Monza,Serie A,2022,20.0,2001.0,19.3,45,29,22,21,2,13,36,36.1,23,20,1,19,40,85,17,0,MF,20-24,Midfielder,Italy,Europe
2298,Nicolò Rovella,ITA,Juventus,Serie A,2022,20.0,2001.0,0.3,1,1,0,1,0,1,1,100.0,0,0,0,0,0,1,0,0,MF,20-24,Midfielder,Italy,Europe
2300,Ruan,BRA,Sassuolo,Serie A,2022,23.0,1999.0,19.0,38,26,25,12,1,19,29,65.5,10,29,17,12,24,62,80,3,DF,20-24,Defender,Brazil,South America
2302,Antonio Rüdiger,GER,Real Madrid,La Liga,2022,29.0,1993.0,26.8,18,16,12,5,1,14,23,60.9,9,23,13,10,19,37,74,0,DF,25-29,Defender,Germany,Europe
2303,Sebastian Rudy,GER,Hoffenheim,Bundesliga,2022,32.0,1990.0,8.8,26,12,10,16,0,13,27,48.1,14,27,7,20,11,37,13,0,MF,30-34,Midfielder,Germany,Europe
2304,Daniele Rugani,ITA,Juventus,Serie A,2022,28.0,1994.0,6.3,7,0,6,1,0,4,4,100.0,0,7,5,2,7,14,32,0,DF,25-29,Defender,Italy,Europe
2305,Matteo Ruggeri,ITA,Atalanta,Serie A,2022,20.0,2002.0,9.2,17,12,5,9,3,8,16,50.0,8,14,3,11,12,29,16,0,"DF,MF",20-24,Defender,Italy,Europe
2306,Mário Rui,POR,Napoli,Serie A,2022,31.0,1991.0,19.4,34,22,17,13,4,20,41,48.8,21,17,4,13,15,49,24,1,DF,30-34,Defender,Portugal,Europe
2308,Kays Ruiz,FRA,Auxerre,Ligue 1,2022,19.0,2002.0,0.7,1,1,1,0,0,0,1,0.0,1,2,1,1,3,4,0,0,MF,Under 20,Midfielder,France,Europe
2311,Gerónimo Rulli,ARG,Villarreal,La Liga,2022,30.0,1992.0,14.0,0,0,0,0,0,0,0,,0,1,0,1,1,1,6,2,GK,30-34,Goalkeeper,Argentina,South America
2312,Alessandro Russo,ITA,Sassuolo,Serie A,2022,21.0,2001.0,1.0,0,0,0,0,0,0,0,,0,0,0,0,0,0,1,1,GK,20-24,Goalkeeper,Italy,Europe
2312,Alessandro Russo,ITA,Sassuolo,Serie A,2022,21.0,2001.0,1.0,0,0,0,0,0,0,0,,0,0,0,0,0,0,1,1,GK,20-24,Goalkeeper,Italy,Europe
2312,Alessandro Russo,ITA,Sassuolo,Serie A,2022,21.0,2001.0,1.0,0,0,0,0,0,0,0,,0,0,0,0,0,0,1,1,GK,20-24,Goalkeeper,Italy,Europe
2312,Alessandro Russo,ITA,Sassuolo,Serie A,2022,21.0,2001.0,1.0,0,0,0,0,0,0,0,,0,0,0,0,0,0,1,1,GK,20-24,Goalkeeper,Italy,Europe
2313,Franco Russo,ARG,Mallorca,La Liga,2022,27.0,1994.0,1.6,2,1,2,0,0,0,1,0.0,1,5,0,5,3,5,5,0,DF,25-29,Defender,Argentina,South America
2314,Georginio Rutter,FRA,Leeds United,Premier League,2022,20.0,2002.0,3.0,10,9,5,3,2,5,8,62.5,3,5,0,5,3,13,3,0,"FW,MF",20-24,Forward,France,Europe
2315,Georginio Rutter,FRA,Hoffenheim,Bundesliga,2022,20.0,2002.0,11.2,7,4,1,4,2,1,3,33.3,2,10,2,8,5,12,6,0,FW,20-24,Forward,France,Europe
2318,Frederik Rønnow,DEN,Union Berlin,Bundesliga,2022,29.0,1992.0,29.0,0,0,0,0,0,0,5,0.0,5,0,0,0,0,0,9,1,GK,25-29,Goalkeeper,Denmark,Europe
2319,José Sá,POR,Wolves,Premier League,2022,29.0,1993.0,36.0,1,0,1,0,0,1,1,100.0,0,0,0,0,0,1,10,6,GK,25-29,Goalkeeper,Portugal,Europe
2320,Youssouf Sabaly,SEN,Betis,La Liga,2022,29.0,1993.0,18.7,45,23,29,14,2,22,33,66.7,11,35,8,27,19,64,52,1,DF,25-29,Defender,Senegal,Africa
2321,Halid Šabanović,BIH,Angers,Ligue 1,2022,22.0,1999.0,7.1,8,6,7,1,0,6,8,75.0,2,8,2,6,8,16,12,0,DF,20-24,Defender,Bosnia and Herzegovina,Europe
2322,Abdelhamid Sabiri,MAR,Sampdoria,Serie A,2022,25.0,1996.0,11.9,18,7,5,9,4,4,13,30.8,9,18,4,14,2,20,5,0,"MF,FW",25-29,Midfielder,Morocco,Africa
2323,Marcel Sabitzer,AUT,Manchester Utd,Premier League,2022,28.0,1994.0,7.0,12,8,3,8,1,2,11,18.2,9,6,2,4,8,20,11,0,MF,25-29,Midfielder,Austria,Europe
2324,Marcel Sabitzer,AUT,Bayern Munich,Bundesliga,2022,28.0,1994.0,7.0,27,14,11,10,6,10,17,58.8,7,3,0,3,10,37,9,0,MF,25-29,Midfielder,Austria,Europe
2325,Falaye Sacko,MLI,Montpellier,Ligue 1,2022,27.0,1995.0,28.7,46,25,25,15,6,32,51,62.7,19,43,14,29,33,79,75,1,DF,25-29,Defender,Mali,Africa
2326,Umar Sadiq,NGA,Almería,La Liga,2022,25.0,1997.0,2.7,0,0,0,0,0,0,1,0.0,1,2,0,2,0,0,3,0,FW,25-29,Forward,Nigeria,Africa
2327,Umar Sadiq,NGA,Real Sociedad,La Liga,2022,25.0,1997.0,0.9,1,1,0,0,1,0,1,0.0,1,2,0,2,0,1,0,0,FW,25-29,Forward,Nigeria,Africa
2328,Alexis Saelemaekers,BEL,Milan,Serie A,2022,23.0,1999.0,15.6,31,20,12,16,3,19,41,46.3,22,13,1,12,19,50,11,0,"FW,DF",20-24,Forward,Belgium,Europe
2329,Wesley Saïd,FRA,Lens,Ligue 1,2022,27.0,1995.0,7.2,4,1,1,2,1,2,6,33.3,4,4,0,4,1,5,2,0,"FW,MF",25-29,Forward,France,Europe
2330,Allan Saint-Maximin,FRA,Newcastle Utd,Premier League,2022,25.0,1997.0,12.4,10,3,3,6,1,2,11,18.2,9,4,0,4,5,15,2,0,FW,25-29,Forward,France,Europe
2331,Théo Sainte-Luce,FRA,Montpellier,Ligue 1,2022,23.0,1998.0,5.9,13,11,8,5,0,7,14,50.0,7,7,2,5,10,23,11,0,DF,20-24,Defender,France,Europe
2333,Bukayo Saka,ENG,Arsenal,Premier League,2022,20.0,2001.0,35.3,63,34,22,15,26,20,44,45.5,24,38,0,38,14,77,19,0,FW,20-24,Forward,England,Europe
2334,Hamza Sakhi,FRA,Auxerre,Ligue 1,2022,26.0,1996.0,18.4,44,22,22,17,5,22,42,52.4,20,16,1,15,25,69,9,0,MF,25-29,Midfielder,France,Europe
2335,Mamadou Sakho,FRA,Montpellier,Ligue 1,2022,32.0,1990.0,8.5,9,5,4,5,0,3,5,60.0,2,17,12,5,8,17,35,1,DF,30-34,Defender,France,Europe
2336,Jacopo Sala,ITA,Spezia,Serie A,2022,30.0,1991.0,1.2,1,0,1,0,0,0,2,0.0,2,2,0,2,1,2,2,0,MF,30-34,Midfielder,Italy,Europe
2337,Ibrahim Salah,MAR,Rennes,Ligue 1,2022,20.0,2001.0,2.5,8,1,5,3,0,2,15,13.3,13,3,0,3,2,10,0,0,"FW,MF",20-24,Forward,Morocco,Africa
2338,Mohamed Salah,EGY,Liverpool,Premier League,2022,30.0,1992.0,36.6,21,12,4,5,12,10,26,38.5,16,21,0,21,6,27,4,0,FW,30-34,Forward,Egypt,Africa
2339,Amine Salama,FRA,Angers,Ligue 1,2022,22.0,2000.0,13.9,11,9,3,7,1,2,12,16.7,10,8,2,6,10,21,2,0,"FW,MF",20-24,Forward,France,Europe
2341,William Saliba,FRA,Arsenal,Premier League,2022,21.0,2001.0,26.8,34,20,23,9,2,15,18,83.3,3,13,10,3,19,53,85,4,DF,20-24,Defender,France,Europe
2343,Mohammed Salisu,GHA,Southampton,Premier League,2022,23.0,1999.0,21.9,52,29,34,16,2,24,34,70.6,10,56,25,31,30,82,122,1,DF,20-24,Defender,Ghana,Africa
2344,Roland Sallai,HUN,Freiburg,Bundesliga,2022,25.0,1997.0,11.1,11,8,4,3,4,4,10,40.0,6,7,1,6,2,13,11,0,"MF,FW",25-29,Midfielder,Hungary,Europe
2348,Diadie Samassékou,MLI,Hoffenheim,Bundesliga,2022,26.0,1996.0,0.4,1,0,0,1,0,0,1,0.0,1,0,0,0,0,1,0,0,"MF,FW",25-29,Midfielder,Mali,Africa
2349,Mama Samba Baldé,GNB,Troyes,Ligue 1,2022,26.0,1995.0,29.6,46,21,14,21,11,13,28,46.4,15,30,3,27,10,56,13,0,FW,25-29,Forward,Guinea-Bissau,Africa
2350,Brice Samba,FRA,Lens,Ligue 1,2022,28.0,1994.0,37.0,1,0,1,0,0,1,2,50.0,1,1,0,1,0,1,12,2,GK,25-29,Goalkeeper,France,Europe
2351,Albert Sambi Lokonga,BEL,Arsenal,Premier League,2022,22.0,1999.0,2.2,1,1,0,0,1,0,2,0.0,2,1,0,1,5,6,2,0,MF,20-24,Midfielder,Belgium,Europe
2352,Albert Sambi Lokonga,BEL,Crystal Palace,Premier League,2022,22.0,1999.0,6.0,13,10,7,4,2,8,12,66.7,4,8,3,5,7,20,10,0,MF,20-24,Midfielder,Belgium,Europe
2353,Junior Sambia,FRA,Salernitana,Serie A,2022,25.0,1996.0,7.7,12,5,7,4,1,6,10,60.0,4,9,3,6,8,20,16,1,DF,25-29,Defender,France,Europe
2355,Antonio Sanabria,PAR,Torino,Serie A,2022,26.0,1996.0,27.0,11,5,3,3,5,1,7,14.3,6,9,2,7,4,15,7,0,FW,25-29,Forward,Paraguay,South America
2356,Leandro Sanca,GNB,Spezia,Serie A,2022,22.0,2000.0,0.4,1,1,0,0,1,1,1,100.0,0,0,0,0,0,1,0,0,"FW,MF",20-24,Forward,Guinea-Bissau,Africa
2358,Renato Sanches,POR,Paris S-G,Ligue 1,2022,24.0,1997.0,8.0,8,1,1,3,4,5,14,35.7,9,13,3,10,9,17,4,0,MF,20-24,Midfielder,Portugal,Europe
2359,Alexis Sánchez,CHI,Marseille,Ligue 1,2022,33.0,1988.0,29.8,27,17,5,16,6,3,24,12.5,21,14,0,14,5,32,6,0,"FW,MF",30-34,Forward,Chile,South America
2361,Davinson Sánchez,COL,Tottenham,Premier League,2022,26.0,1996.0,9.5,24,11,17,6,1,14,20,70.0,6,16,10,6,12,36,41,0,DF,25-29,Defender,Colombia,South America
2366,Jadon Sancho,ENG,Manchester Utd,Premier League,2022,22.0,2000.0,18.7,16,10,7,5,4,8,28,28.6,20,25,2,23,7,23,6,0,"FW,MF",20-24,Forward,England,Europe
2367,Alex Sandro,BRA,Juventus,Serie A,2022,31.0,1991.0,19.9,35,20,16,16,3,15,22,68.2,7,27,10,17,15,50,64,1,DF,30-34,Defender,Brazil,South America
2368,Leroy Sané,GER,Bayern Munich,Bundesliga,2022,26.0,1996.0,22.3,38,30,11,19,8,18,36,50.0,18,11,1,10,3,41,1,2,"MF,FW",25-29,Midfielder,Germany,Europe
2369,Sidi Sané,GER,Schalke 04,Bundesliga,2022,19.0,2003.0,0.3,1,1,1,0,0,1,1,100.0,0,0,0,0,0,1,0,0,FW,Under 20,Forward,Germany,Europe
2370,Morgan Sanson,FRA,Aston Villa,Premier League,2022,27.0,1994.0,0.1,2,1,1,1,0,1,1,100.0,0,0,0,0,0,2,0,0,MF,25-29,Midfielder,France,Europe
2371,Morgan Sanson,FRA,Strasbourg,Ligue 1,2022,27.0,1994.0,15.8,36,25,10,16,10,17,56,30.4,39,21,1,20,22,58,9,0,MF,25-29,Midfielder,France,Europe
2372,Nicola Sansone,ITA,Bologna,Serie A,2022,30.0,1991.0,8.2,12,4,6,4,2,5,10,50.0,5,0,0,0,0,12,4,0,FW,30-34,Forward,Italy,Europe
2373,Baptiste Santamaria,FRA,Rennes,Ligue 1,2022,27.0,1995.0,20.1,41,22,13,23,5,21,41,51.2,20,21,5,16,21,62,23,0,MF,25-29,Midfielder,France,Europe
2374,Riccardo Saponara,ITA,Fiorentina,Serie A,2022,30.0,1991.0,13.4,10,5,3,6,1,5,9,55.6,4,7,1,6,5,15,9,1,FW,30-34,Forward,Italy,Europe
2377,Jeremy Sarmiento,ECU,Brighton,Premier League,2022,20.0,2002.0,2.0,6,3,4,1,1,2,5,40.0,3,2,0,2,1,7,0,0,MF,20-24,Midfielder,Ecuador,South America
2378,Amin Sarr,SWE,Lyon,Ligue 1,2022,21.0,2001.0,6.0,9,6,1,4,4,1,4,25.0,3,2,0,2,0,9,4,0,FW,20-24,Forward,Sweden,Europe
2379,Bouna Sarr,SEN,Bayern Munich,Bundesliga,2022,30.0,1992.0,0.0,0,0,0,0,0,0,0,,0,0,0,0,0,0,0,0,FW,30-34,Forward,Senegal,Africa
2380,Malang Sarr,FRA,Monaco,Ligue 1,2022,23.0,1999.0,8.0,6,3,5,1,0,1,5,20.0,4,11,7,4,15,21,29,2,DF,20-24,Defender,France,Europe
2381,Mamadou Sarr,FRA,Lyon,Ligue 1,2022,16.0,2005.0,0.1,0,0,0,0,0,0,0,,0,0,0,0,0,0,0,0,MF,Under 20,Midfielder,France,Europe
2382,Mouhamadou Sarr,SEN,Cremonese,Serie A,2022,25.0,1997.0,2.0,0,0,0,0,0,0,0,,0,0,0,0,0,0,2,0,GK,25-29,Goalkeeper,Senegal,Africa
2383,Martin Satriano,URU,Empoli,Serie A,2022,21.0,2001.0,18.9,13,8,5,6,2,6,14,42.9,8,5,0,5,3,16,22,0,FW,20-24,Forward,Uruguay,South America
2384,Téji Savanier,FRA,Montpellier,Ligue 1,2022,30.0,1991.0,28.3,46,30,16,19,11,23,70,32.9,47,30,2,28,30,76,12,1,MF,30-34,Midfielder,France,Europe
2385,Esteban Saveljich,MNE,Rayo Vallecano,La Liga,2022,31.0,1991.0,0.0,0,0,0,0,0,0,0,,0,0,0,0,0,0,0,0,FW,30-34,Forward,Montenegro,Europe
2386,Stefan Savić,MNE,Atlético Madrid,La Liga,2022,31.0,1991.0,21.6,39,26,29,7,3,26,39,66.7,13,17,8,9,33,72,67,2,DF,30-34,Defender,Montenegro,Europe
2387,Joe Scally,USA,Gladbach,Bundesliga,2022,19.0,2002.0,24.5,31,20,25,5,1,24,31,77.4,7,17,6,11,8,39,61,0,DF,Under 20,Defender,United States,North America
2388,Giorgio Scalvini,ITA,Atalanta,Serie A,2022,18.0,2003.0,25.9,54,29,30,18,6,29,55,52.7,26,36,13,23,56,110,57,2,DF,Under 20,Defender,Italy,Europe
2389,Gianluca Scamacca,ITA,West Ham,Premier League,2022,23.0,1999.0,10.3,10,5,1,3,6,2,2,100.0,0,3,0,3,4,14,5,0,FW,20-24,Forward,Italy,Europe
2390,Gustavo Scarpa,BRA,Nott'ham Forest,Premier League,2022,28.0,1994.0,2.0,5,2,3,1,1,2,5,40.0,3,4,0,4,0,5,3,0,"MF,FW",25-29,Midfielder,Brazil,South America
2391,Kevin Schade,GER,Brentford,Premier League,2022,20.0,2001.0,8.1,12,8,7,2,3,5,10,50.0,5,7,0,7,4,16,6,0,FW,20-24,Forward,Germany,Europe
2392,Kevin Schade,GER,Freiburg,Bundesliga,2022,20.0,2001.0,2.0,6,4,3,2,1,3,5,60.0,2,0,0,0,0,6,2,0,"FW,MF",20-24,Forward,Germany,Europe
2393,András Schäfer,HUN,Union Berlin,Bundesliga,2022,23.0,1999.0,9.6,21,9,7,12,2,6,14,42.9,8,12,2,10,4,25,11,0,MF,20-24,Midfielder,Hungary,Europe
2394,Fabian Schär,SUI,Newcastle Utd,Premier League,2022,30.0,1991.0,35.6,47,22,31,13,3,24,39,61.5,15,34,19,15,52,99,139,0,DF,30-34,Defender,Switzerland,Europe
2395,Derry Scherhant,GER,Hertha BSC,Bundesliga,2022,19.0,2002.0,3.2,7,6,3,3,1,4,8,50.0,4,3,0,3,0,7,5,0,"FW,MF",Under 20,Forward,Germany,Europe
2397,Kingsley Schindler,GHA,Köln,Bundesliga,2022,29.0,1993.0,12.1,23,12,13,8,2,18,28,64.3,10,14,2,12,15,38,24,0,"DF,MF",25-29,Defender,Ghana,Africa
2398,Xaver Schlager,AUT,RB Leipzig,Bundesliga,2022,24.0,1997.0,16.7,41,24,13,26,2,20,43,46.5,23,19,2,17,17,58,23,0,MF,20-24,Midfielder,Austria,Europe
2399,Keven Schlotterbeck,GER,Freiburg,Bundesliga,2022,25.0,1997.0,0.2,0,0,0,0,0,0,0,,0,1,1,0,2,2,2,0,DF,25-29,Defender,Germany,Europe
2400,Keven Schlotterbeck,GER,Bochum,Bundesliga,2022,25.0,1997.0,8.2,17,9,12,5,0,9,11,81.8,2,11,5,6,14,31,49,0,DF,25-29,Defender,Germany,Europe
2401,Nico Schlotterbeck,GER,Dortmund,Bundesliga,2022,22.0,1999.0,25.0,59,34,34,24,1,37,53,69.8,16,38,21,17,32,91,71,1,DF,20-24,Defender,Germany,Europe
2402,Jeffrey Schlupp,GHA,Crystal Palace,Premier League,2022,29.0,1992.0,28.1,66,46,28,29,9,22,43,51.2,21,39,8,31,23,89,38,0,"MF,FW",25-29,Midfielder,Ghana,Africa
2403,Kasper Schmeichel,DEN,Nice,Ligue 1,2022,35.0,1986.0,36.0,1,0,1,0,0,1,4,25.0,3,1,0,1,1,2,11,1,GK,35-39,Goalkeeper,Denmark,Europe
2404,Jonathan Schmid,FRA,Freiburg,Bundesliga,2022,32.0,1990.0,0.5,1,1,1,0,0,0,0,,0,1,0,1,1,2,1,1,DF,30-34,Defender,France,Europe
2405,Romano Schmid,AUT,Werder Bremen,Bundesliga,2022,22.0,2000.0,16.9,24,15,5,13,6,10,22,45.5,12,21,3,18,7,31,12,0,"MF,FW",20-24,Midfielder,Austria,Europe
2406,Kenneth Schmidt,GER,Freiburg,Bundesliga,2022,20.0,2002.0,2.8,6,3,4,2,0,5,6,83.3,1,4,2,2,0,6,2,0,DF,20-24,Defender,Germany,Europe
2407,Niklas Schmidt,GER,Werder Bremen,Bundesliga,2022,24.0,1998.0,12.1,25,10,12,11,2,13,28,46.4,15,10,0,10,5,30,12,0,MF,20-24,Midfielder,Germany,Europe
2408,Benno Schmitz,GER,Köln,Bundesliga,2022,27.0,1994.0,26.9,64,42,31,28,5,42,82,51.2,40,34,4,30,26,90,57,0,DF,25-29,Defender,Germany,Europe
2409,Jerdy Schouten,NED,Bologna,Serie A,2022,25.0,1997.0,27.9,63,38,28,33,2,27,49,55.1,22,40,17,23,40,103,43,1,MF,25-29,Midfielder,Netherlands,Europe
2410,Perr Schuurs,NED,Torino,Serie A,2022,22.0,1999.0,25.8,51,25,29,17,5,14,26,53.8,12,28,16,12,28,79,102,0,DF,20-24,Defender,Netherlands,Europe
2411,Marvin Schwäbe,GER,Köln,Bundesliga,2022,27.0,1995.0,34.0,1,0,1,0,0,1,1,100.0,0,0,0,0,2,3,8,2,GK,25-29,Goalkeeper,Germany,Europe
2412,Alexander Schwolow,GER,Schalke 04,Bundesliga,2022,30.0,1992.0,22.6,0,0,0,0,0,0,2,0.0,2,0,0,0,1,1,6,3,GK,30-34,Goalkeeper,Germany,Europe
2413,Demba Seck,SEN,Torino,Serie A,2022,21.0,2001.0,5.8,5,2,3,2,0,2,3,66.7,1,3,1,2,1,6,1,0,"MF,FW",20-24,Midfielder,Senegal,Africa
2414,Haris Seferović,SUI,Celta Vigo,La Liga,2022,30.0,1992.0,9.9,6,3,1,4,1,3,8,37.5,5,7,1,6,1,7,6,1,FW,30-34,Forward,Switzerland,Europe
2415,Telasco Segovia,VEN,Sampdoria,Serie A,2022,19.0,2003.0,0.0,0,0,0,0,0,0,0,,0,0,0,0,0,0,0,0,MF,Under 20,Midfielder,Venezuela,South America
2416,Jacopo Segre,ITA,Torino,Serie A,2022,25.0,1997.0,0.2,0,0,0,0,0,0,0,,0,0,0,0,0,0,0,0,DF,25-29,Defender,Italy,Europe
2417,Paul Seguin,GER,Union Berlin,Bundesliga,2022,27.0,1995.0,7.7,17,8,9,4,4,8,18,44.4,10,6,0,6,6,23,7,0,MF,25-29,Midfielder,Germany,Europe
2418,Alidu Seidu,GHA,Clermont Foot,Ligue 1,2022,22.0,2000.0,27.3,52,31,35,14,3,31,51,60.8,20,28,14,14,52,104,50,2,DF,20-24,Defender,Ghana,Africa
2419,Davie Selke,GER,Hertha BSC,Bundesliga,2022,27.0,1995.0,3.1,2,1,1,1,0,0,1,0.0,1,3,1,2,1,3,5,0,FW,25-29,Forward,Germany,Europe
2420,Davie Selke,GER,Köln,Bundesliga,2022,27.0,1995.0,9.7,0,0,0,0,0,0,4,0.0,4,4,1,3,0,0,11,0,FW,25-29,Forward,Germany,Europe
2421,Matz Sels,BEL,Strasbourg,Ligue 1,2022,30.0,1992.0,38.0,4,3,4,0,0,4,4,100.0,0,0,0,0,4,8,23,0,GK,30-34,Goalkeeper,Belgium,Europe
2422,Nélson Semedo,POR,Wolves,Premier League,2022,28.0,1993.0,29.2,71,42,48,19,4,33,64,51.6,31,42,15,27,29,100,83,2,DF,25-29,Defender,Portugal,Europe
2423,Vivaldo Semedo,POR,Udinese,Serie A,2022,17.0,2005.0,0.4,0,0,0,0,0,0,0,,0,1,0,1,0,0,1,0,"FW,MF",Under 20,Forward,Portugal,Europe
2424,Antoine Semenyo,GHA,Bournemouth,Premier League,2022,22.0,2000.0,2.9,1,0,0,0,1,1,6,16.7,5,10,1,9,2,3,4,0,"FW,MF",20-24,Forward,Ghana,Africa
2426,Marcos Senesi,ARG,Bournemouth,Premier League,2022,25.0,1997.0,27.7,50,35,28,22,0,23,44,52.3,21,38,20,18,43,93,146,2,DF,25-29,Defender,Argentina,South America
2427,Stefano Sensi,ITA,Monza,Serie A,2022,26.0,1995.0,18.0,41,26,25,13,3,18,48,37.5,30,13,3,10,20,61,4,0,MF,25-29,Midfielder,Italy,Europe
2429,Luigi Sepe,ITA,Salernitana,Serie A,2022,31.0,1991.0,17.0,0,0,0,0,0,0,1,0.0,1,0,0,0,0,0,0,0,GK,30-34,Goalkeeper,Italy,Europe
2430,Suat Serdar,GER,Hertha BSC,Bundesliga,2022,25.0,1997.0,22.5,51,23,14,30,7,20,41,48.8,21,48,12,36,29,80,24,0,MF,25-29,Midfielder,Germany,Europe
2431,Leonardo Sernicola,ITA,Cremonese,Serie A,2022,25.0,1997.0,25.7,45,33,25,13,7,29,43,67.4,14,23,6,17,38,83,55,0,DF,25-29,Defender,Italy,Europe
2432,Ryan Sessegnon,ENG,Tottenham,Premier League,2022,22.0,2000.0,9.0,16,11,9,7,0,6,12,50.0,6,8,1,7,6,22,17,1,DF,20-24,Defender,England,Europe
2433,Stephan El Shaarawy,ITA,Roma,Serie A,2022,29.0,1992.0,16.9,21,9,8,10,3,6,22,27.3,16,11,1,10,15,36,11,0,"DF,MF",25-29,Defender,Italy,Europe
2434,Eniss Shabani,ALB,Mainz 05,Bundesliga,2022,19.0,2003.0,0.1,0,0,0,0,0,0,0,,0,0,0,0,0,0,0,0,MF,Under 20,Midfielder,Albania,Europe
2435,Luke Shaw,ENG,Manchester Utd,Premier League,2022,27.0,1995.0,28.4,55,36,31,22,2,32,46,69.6,14,51,17,34,36,91,55,2,DF,25-29,Defender,England,Europe
2436,Jonjo Shelvey,ENG,Newcastle Utd,Premier League,2022,30.0,1992.0,0.4,1,0,1,0,0,0,1,0.0,1,1,0,1,0,1,0,0,MF,30-34,Midfielder,England,Europe
2437,Jonjo Shelvey,ENG,Nott'ham Forest,Premier League,2022,30.0,1992.0,6.0,2,1,0,1,1,1,9,11.1,8,7,2,5,5,7,10,1,MF,30-34,Midfielder,England,Europe
2438,Eldor Shomurodov,UZB,Spezia,Serie A,2022,27.0,1995.0,9.0,5,5,3,1,1,2,11,18.2,9,5,1,4,3,8,4,0,FW,25-29,Forward,Uzbekistan,Asia
2439,Eldor Shomurodov,UZB,Roma,Serie A,2022,27.0,1995.0,1.3,1,0,1,0,0,0,2,0.0,2,1,0,1,1,2,0,0,FW,25-29,Forward,Uzbekistan,Asia
2440,Kaj Sierhuis,NED,Reims,Ligue 1,2022,24.0,1998.0,2.4,3,3,1,0,2,0,5,0.0,5,3,1,2,1,4,2,0,"FW,MF",20-24,Forward,Netherlands,Europe
2441,Vincent Sierro,SUI,Toulouse,Ligue 1,2022,26.0,1995.0,7.4,19,11,9,9,1,11,29,37.9,18,12,3,9,4,23,11,1,MF,25-29,Midfielder,Switzerland,Europe
2442,Kiliann Sildillia,FRA,Freiburg,Bundesliga,2022,20.0,2002.0,22.0,33,20,10,19,4,18,30,60.0,12,24,9,15,21,54,47,1,"DF,MF",20-24,Defender,France,Europe
2443,André Silva,POR,RB Leipzig,Bundesliga,2022,26.0,1995.0,19.3,12,6,2,5,5,3,8,37.5,5,11,1,10,3,15,3,0,FW,25-29,Forward,Portugal,Europe
2443,André Silva,POR,RB Leipzig,Bundesliga,2022,26.0,1995.0,19.3,12,6,2,5,5,3,8,37.5,5,11,1,10,3,15,3,0,FW,25-29,Forward,Portugal,Europe
2443,André Silva,POR,RB Leipzig,Bundesliga,2022,26.0,1995.0,19.3,12,6,2,5,5,3,8,37.5,5,11,1,10,3,15,3,0,FW,25-29,Forward,Portugal,Europe
2443,André Silva,POR,RB Leipzig,Bundesliga,2022,26.0,1995.0,19.3,12,6,2,5,5,3,8,37.5,5,11,1,10,3,15,3,0,FW,25-29,Forward,Portugal,Europe
2443,André Silva,POR,RB Leipzig,Bundesliga,2022,26.0,1995.0,19.3,12,6,2,5,5,3,8,37.5,5,11,1,10,3,15,3,0,FW,25-29,Forward,Portugal,Europe
2443,André Silva,POR,RB Leipzig,Bundesliga,2022,26.0,1995.0,19.3,12,6,2,5,5,3,8,37.5,5,11,1,10,3,15,3,0,FW,25-29,Forward,Portugal,Europe
2443,André Silva,POR,RB Leipzig,Bundesliga,2022,26.0,1995.0,19.3,12,6,2,5,5,3,8,37.5,5,11,1,10,3,15,3,0,FW,25-29,Forward,Portugal,Europe
2443,André Silva,POR,RB Leipzig,Bundesliga,2022,26.0,1995.0,19.3,12,6,2,5,5,3,8,37.5,5,11,1,10,3,15,3,0,FW,25-29,Forward,Portugal,Europe
2443,André Silva,POR,RB Leipzig,Bundesliga,2022,26.0,1995.0,19.3,12,6,2,5,5,3,8,37.5,5,11,1,10,3,15,3,0,FW,25-29,Forward,Portugal,Europe
2444,Bernardo Silva,POR,Manchester City,Premier League,2022,27.0,1994.0,24.5,44,23,11,25,8,18,45,40.0,27,23,6,17,16,60,6,0,"MF,FW",25-29,Midfielder,Portugal,Europe
2445,Caio Henrique Oliveira Silva,BRA,Monaco,Ligue 1,2022,25.0,1997.0,32.2,74,51,42,28,4,44,76,57.9,32,28,8,20,26,100,68,1,DF,25-29,Defender,Brazil,South America
2447,Rui Silva,POR,Betis,La Liga,2022,28.0,1994.0,26.0,4,1,4,0,0,4,4,100.0,0,0,0,0,0,4,12,1,GK,25-29,Goalkeeper,Portugal,Europe
2447,Rui Silva,POR,Betis,La Liga,2022,28.0,1994.0,26.0,4,1,4,0,0,4,4,100.0,0,0,0,0,0,4,12,1,GK,25-29,Goalkeeper,Portugal,Europe
2447,Rui Silva,POR,Betis,La Liga,2022,28.0,1994.0,26.0,4,1,4,0,0,4,4,100.0,0,0,0,0,0,4,12,1,GK,25-29,Goalkeeper,Portugal,Europe
2447,Rui Silva,POR,Betis,La Liga,2022,28.0,1994.0,26.0,4,1,4,0,0,4,4,100.0,0,0,0,0,0,4,12,1,GK,25-29,Goalkeeper,Portugal,Europe
2448,Thiago Silva,BRA,Chelsea,Premier League,2022,37.0,1984.0,26.1,41,27,24,17,0,21,31,67.7,10,38,29,9,34,75,111,3,DF,35-39,Defender,Brazil,South America
2448,Thiago Silva,BRA,Chelsea,Premier League,2022,37.0,1984.0,26.1,41,27,24,17,0,21,31,67.7,10,38,29,9,34,75,111,3,DF,35-39,Defender,Brazil,South America
2448,Thiago Silva,BRA,Chelsea,Premier League,2022,37.0,1984.0,26.1,41,27,24,17,0,21,31,67.7,10,38,29,9,34,75,111,3,DF,35-39,Defender,Brazil,South America
2448,Thiago Silva,BRA,Chelsea,Premier League,2022,37.0,1984.0,26.1,41,27,24,17,0,21,31,67.7,10,38,29,9,34,75,111,3,DF,35-39,Defender,Brazil,South America
2449,Marco Silvestri,ITA,Udinese,Serie A,2022,31.0,1991.0,38.0,2,1,2,0,0,2,3,66.7,1,0,0,0,1,3,15,1,GK,30-34,Goalkeeper,Italy,Europe
2450,Abdallah Sima,SEN,Angers,Ligue 1,2022,21.0,2001.0,20.4,22,13,4,15,3,7,19,36.8,12,8,0,8,4,26,19,0,FW,20-24,Forward,Senegal,Africa
2451,Mohamed Simakan,FRA,RB Leipzig,Bundesliga,2022,22.0,2000.0,16.2,21,14,12,5,4,14,21,66.7,7,21,4,17,16,37,55,0,DF,20-24,Defender,France,Europe
2452,Giovanni Simeone,ARG,Napoli,Serie A,2022,27.0,1995.0,4.5,12,3,3,5,4,3,8,37.5,5,2,1,1,1,13,4,0,FW,25-29,Forward,Argentina,South America
2453,Ellis Simms,ENG,Everton,Premier League,2022,21.0,2001.0,2.5,0,0,0,0,0,0,0,,0,0,0,0,0,0,1,0,FW,20-24,Forward,England,Europe
2455,Moses Simon,NGA,Nantes,Ligue 1,2022,27.0,1995.0,26.1,18,9,6,7,5,7,15,46.7,8,14,1,13,11,29,3,0,"FW,MF",25-29,Forward,Nigeria,Africa
2457,Lassine Sinayoko,MLI,Auxerre,Ligue 1,2022,22.0,1999.0,17.4,33,15,14,12,7,21,40,52.5,19,12,0,12,18,51,17,0,"MF,FW",20-24,Midfielder,Mali,Africa
2458,Wilfried Singo,CIV,Torino,Serie A,2022,21.0,2000.0,22.7,27,17,14,10,3,12,19,63.2,7,15,2,13,12,39,33,1,DF,20-24,Defender,Ivory Coast,Africa
2459,Luis Sinisterra,COL,Leeds United,Premier League,2022,23.0,1999.0,9.6,21,14,8,9,4,11,18,61.1,7,11,1,10,8,29,2,0,FW,20-24,Forward,Colombia,South America
2460,Daley Sinkgraven,NED,Leverkusen,Bundesliga,2022,27.0,1995.0,3.8,10,7,7,3,0,7,9,77.8,2,8,4,4,5,15,7,0,"DF,MF",25-29,Defender,Netherlands,Europe
2461,Tobias Sippel,GER,Gladbach,Bundesliga,2022,34.0,1988.0,5.7,0,0,0,0,0,0,0,,0,0,0,0,0,0,1,1,GK,30-34,Goalkeeper,Germany,Europe
2462,Hugo Siquet,BEL,Freiburg,Bundesliga,2022,20.0,2002.0,0.2,2,2,2,0,0,2,2,100.0,0,1,0,1,0,2,0,0,DF,20-24,Defender,Belgium,Europe
2463,Salvatore Sirigu,ITA,Fiorentina,Serie A,2022,35.0,1987.0,1.0,0,0,0,0,0,0,0,,0,0,0,0,0,0,1,0,GK,35-39,Goalkeeper,Italy,Europe
2464,Ibrahima Sissoko,MLI,Strasbourg,Ligue 1,2022,24.0,1997.0,14.6,40,22,18,17,5,22,42,52.4,20,20,6,14,10,50,19,0,MF,20-24,Midfielder,Mali,Africa
2465,Moussa Sissoko,FRA,Nantes,Ligue 1,2022,32.0,1989.0,21.3,26,16,16,7,3,12,18,66.7,6,22,5,17,16,42,17,0,MF,30-34,Midfielder,France,Europe
2466,Tim Skarke,GER,Union Berlin,Bundesliga,2022,25.0,1996.0,0.6,1,1,0,0,1,0,0,,0,1,0,1,0,1,0,0,"DF,MF",25-29,Defender,Germany,Europe
2467,Tim Skarke,GER,Schalke 04,Bundesliga,2022,25.0,1996.0,4.9,13,7,3,8,2,8,11,72.7,3,5,0,5,0,13,4,0,"FW,MF",25-29,Forward,Germany,Europe
2468,Ellyes Skhiri,TUN,Köln,Bundesliga,2022,27.0,1995.0,31.7,79,44,29,42,8,26,66,39.4,40,52,12,40,56,135,48,0,MF,25-29,Midfielder,Tunisia,Africa
2469,Oliver Skipp,ENG,Tottenham,Premier League,2022,21.0,2000.0,16.6,34,17,18,15,1,16,33,48.5,17,17,8,9,17,51,19,1,MF,20-24,Midfielder,England,Europe
2472,Robert Skov,DEN,Hoffenheim,Bundesliga,2022,26.0,1996.0,15.0,22,11,14,7,1,10,26,38.5,16,22,8,14,8,30,20,2,DF,25-29,Defender,Denmark,Europe
2473,Milan Škriniar,SVK,Inter,Serie A,2022,27.0,1995.0,19.7,29,18,14,11,4,18,32,56.3,14,18,13,5,13,42,46,3,DF,25-29,Defender,Slovakia,Europe
2474,Naatan Skyttä,FIN,Toulouse,Ligue 1,2022,20.0,2002.0,0.3,0,0,0,0,0,0,0,,0,0,0,0,1,1,0,0,MF,20-24,Midfielder,Finland,Europe
2475,Islam Slimani,ALG,Brest,Ligue 1,2022,34.0,1988.0,11.0,5,3,2,2,1,0,3,0.0,3,2,0,2,1,6,11,0,FW,30-34,Forward,Algeria,Africa
2476,Chris Smalling,ENG,Roma,Serie A,2022,32.0,1989.0,31.2,26,15,16,10,0,13,21,61.9,8,51,36,15,43,69,123,0,DF,30-34,Defender,England,Europe
2477,Adam Smith,ENG,Bournemouth,Premier League,2022,31.0,1991.0,32.7,49,29,27,19,3,29,60,48.3,31,30,13,17,25,74,81,1,DF,30-34,Defender,England,Europe
2477,Adam Smith,ENG,Bournemouth,Premier League,2022,31.0,1991.0,32.7,49,29,27,19,3,29,60,48.3,31,30,13,17,25,74,81,1,DF,30-34,Defender,England,Europe
2477,Adam Smith,ENG,Bournemouth,Premier League,2022,31.0,1991.0,32.7,49,29,27,19,3,29,60,48.3,31,30,13,17,25,74,81,1,DF,30-34,Defender,England,Europe
2477,Adam Smith,ENG,Bournemouth,Premier League,2022,31.0,1991.0,32.7,49,29,27,19,3,29,60,48.3,31,30,13,17,25,74,81,1,DF,30-34,Defender,England,Europe
2478,Emile Smith Rowe,ENG,Arsenal,Premier League,2022,22.0,2000.0,1.9,1,1,1,0,0,1,3,33.3,2,1,0,1,0,1,2,0,"MF,FW",20-24,Midfielder,England,Europe
2479,Hrvoje Smolčić,CRO,Eint Frankfurt,Bundesliga,2022,21.0,2000.0,5.2,8,7,6,2,0,5,10,50.0,5,11,4,7,6,14,38,0,DF,20-24,Defender,Croatia,Europe
2480,Cédric Soares,POR,Arsenal,Premier League,2022,30.0,1991.0,0.3,0,0,0,0,0,0,1,0.0,1,1,0,1,0,0,1,0,DF,30-34,Defender,Portugal,Europe
2481,Cédric Soares,POR,Fulham,Premier League,2022,30.0,1991.0,2.2,8,5,4,3,1,3,3,100.0,0,3,1,2,1,9,5,0,DF,30-34,Defender,Portugal,Europe
2482,Danilo Soares,BRA,Bochum,Bundesliga,2022,30.0,1991.0,19.6,72,46,42,23,7,43,72,59.7,29,29,6,23,30,102,56,1,DF,30-34,Defender,Brazil,South America
2483,Eduard Sobol,UKR,Strasbourg,Ligue 1,2022,27.0,1995.0,9.7,19,10,10,6,3,9,13,69.2,4,10,1,9,8,27,19,0,DF,25-29,Defender,Ukraine,Europe
2486,Dominic Solanke,ENG,Bournemouth,Premier League,2022,24.0,1997.0,31.8,15,9,8,3,4,5,22,22.7,17,26,7,19,6,21,46,0,"FW,MF",20-24,Forward,England,Europe
2487,Augusto Solari,ARG,Celta Vigo,La Liga,2022,30.0,1992.0,2.9,10,6,6,3,1,3,11,27.3,8,5,0,5,4,14,3,0,MF,30-34,Midfielder,Argentina,South America
2489,Nikola Soldo,CRO,Köln,Bundesliga,2022,21.0,2001.0,6.6,15,9,8,7,0,7,11,63.6,4,7,6,1,7,22,28,0,DF,20-24,Defender,Croatia,Europe
2492,François-Joseph Sollacaro,FRA,Ajaccio,Ligue 1,2022,28.0,1994.0,6.0,0,0,0,0,0,0,0,,0,0,0,0,0,0,2,2,GK,25-29,Goalkeeper,France,Europe
2493,Manor Solomon,ISR,Fulham,Premier League,2022,23.0,1999.0,6.4,20,12,12,6,2,9,16,56.3,7,8,0,8,5,25,3,0,FW,20-24,Forward,Israel,Asia
2494,Yann Sommer,SUI,Gladbach,Bundesliga,2022,33.0,1988.0,10.0,1,0,1,0,0,1,1,100.0,0,0,0,0,0,1,8,0,GK,30-34,Goalkeeper,Switzerland,Europe
2495,Yann Sommer,SUI,Bayern Munich,Bundesliga,2022,33.0,1988.0,19.0,0,0,0,0,0,0,0,,0,0,0,0,1,1,5,1,GK,30-34,Goalkeeper,Switzerland,Europe
2496,Brandon Soppy,FRA,Udinese,Serie A,2022,20.0,2002.0,1.0,1,1,0,1,0,0,0,,0,4,0,4,1,2,1,0,DF,20-24,Defender,France,Europe
2497,Brandon Soppy,FRA,Atalanta,Serie A,2022,20.0,2002.0,7.1,8,5,4,4,0,3,9,33.3,6,10,0,10,3,11,7,0,DF,20-24,Defender,France,Europe
2499,Roberto Soriano,ITA,Bologna,Serie A,2022,31.0,1991.0,14.7,31,16,9,16,6,13,25,52.0,12,23,2,21,6,37,14,0,"FW,MF",30-34,Forward,Italy,Europe
2500,Borna Sosa,CRO,Stuttgart,Bundesliga,2022,24.0,1998.0,21.7,27,21,18,8,1,21,32,65.6,11,20,5,15,19,46,37,0,DF,20-24,Defender,Croatia,Europe
2501,Joaquin Sosa,URU,Bologna,Serie A,2022,20.0,2002.0,7.6,6,2,5,1,0,4,18,22.2,14,5,3,2,6,12,31,0,DF,20-24,Defender,Uruguay,South America
2503,Florian Sotoca,FRA,Lens,Ligue 1,2022,31.0,1990.0,33.9,39,19,11,17,11,15,40,37.5,25,41,2,39,29,68,51,0,"MF,FW",30-34,Midfielder,France,Europe
2504,Riccardo Sottil,ITA,Fiorentina,Serie A,2022,23.0,1999.0,9.3,4,3,2,0,2,2,5,40.0,3,2,0,2,0,4,0,0,FW,20-24,Forward,Italy,Europe
2506,Matìas Soulé,ARG,Juventus,Serie A,2022,19.0,2003.0,4.7,7,4,3,2,2,5,7,71.4,2,7,1,6,3,10,3,0,"MF,FW",Under 20,Midfielder,Argentina,South America
2507,Moussa Soumano,FRA,Ajaccio,Ligue 1,2022,17.0,2005.0,5.5,2,2,0,1,1,0,6,0.0,6,2,0,2,0,2,0,0,FW,Under 20,Forward,France,Europe
2508,Adama Soumaoro,FRA,Bologna,Serie A,2022,30.0,1992.0,20.7,25,17,11,12,2,5,7,71.4,2,18,13,5,15,40,75,1,DF,30-34,Defender,France,Europe
2509,Boubakary Soumaré,FRA,Leicester City,Premier League,2022,23.0,1999.0,18.1,57,34,29,26,2,23,44,52.3,21,15,4,11,33,90,27,1,MF,20-24,Midfielder,France,Europe
2510,Arnaud Souquet,FRA,Montpellier,Ligue 1,2022,30.0,1992.0,4.0,22,16,13,7,2,11,14,78.6,3,8,3,5,4,26,4,0,"DF,FW",30-34,Defender,France,Europe
2511,Dyego Sousa,POR,Almería,La Liga,2022,32.0,1989.0,5.9,10,6,5,4,1,4,5,80.0,1,4,2,2,1,11,14,0,FW,30-34,Forward,Portugal,Europe
2512,Harry Souttar,AUS,Leicester City,Premier League,2022,23.0,1998.0,11.0,15,9,10,5,0,7,18,38.9,11,16,12,4,12,27,45,0,DF,20-24,Defender,Australia,Oceania
2513,Vinicius Souza,BRA,Espanyol,La Liga,2022,23.0,1999.0,27.0,99,66,41,45,13,33,59,55.9,26,31,14,17,48,147,50,1,MF,20-24,Midfielder,Brazil,South America
2514,Djibril Sow,SUI,Eint Frankfurt,Bundesliga,2022,25.0,1997.0,29.4,41,25,13,25,3,22,44,50.0,22,22,4,18,28,69,23,0,MF,25-29,Midfielder,Switzerland,Europe
2515,Çağlar Söyüncü,TUR,Leicester City,Premier League,2022,26.0,1996.0,5.9,14,9,10,4,0,7,10,70.0,3,9,8,1,7,21,30,0,DF,25-29,Defender,Turkey,Asia
2516,Kevin Spadanuda,SUI,Ajaccio,Ligue 1,2022,25.0,1997.0,11.8,29,18,15,9,5,12,33,36.4,21,18,0,18,11,40,5,0,"MF,FW",25-29,Midfielder,Switzerland,Europe
2517,Djed Spence,ENG,Tottenham,Premier League,2022,21.0,2000.0,0.1,0,0,0,0,0,0,0,,0,0,0,0,0,0,0,0,"FW,DF",20-24,Forward,England,Europe
2518,Djed Spence,ENG,Rennes,Ligue 1,2022,21.0,2000.0,6.4,14,6,8,2,4,11,18,61.1,7,10,3,7,4,18,15,0,DF,20-24,Defender,England,Europe
2519,Stijn Spierings,NED,Toulouse,Ligue 1,2022,26.0,1996.0,34.7,95,67,37,49,9,43,101,42.6,58,49,11,38,53,148,44,0,MF,25-29,Midfielder,Netherlands,Europe
2520,Leonardo Spinazzola,ITA,Roma,Serie A,2022,29.0,1993.0,18.4,15,8,7,6,2,8,23,34.8,15,13,3,10,9,24,25,0,DF,25-29,Defender,Italy,Europe
2521,Marco Sportiello,ITA,Atalanta,Serie A,2022,30.0,1992.0,14.9,1,0,1,0,0,1,3,33.3,2,0,0,0,0,1,2,0,GK,30-34,Goalkeeper,Italy,Europe
2522,Jack Stacey,ENG,Bournemouth,Premier League,2022,26.0,1996.0,3.3,5,4,3,1,1,2,5,40.0,3,3,1,2,5,10,15,0,DF,25-29,Defender,England,Europe
2523,Anton Stach,GER,Mainz 05,Bundesliga,2022,23.0,1998.0,23.0,27,21,10,15,2,16,38,42.1,22,28,2,26,41,68,25,0,MF,20-24,Midfielder,Germany,Europe
2524,Kostas Stafylidis,GRE,Bochum,Bundesliga,2022,28.0,1993.0,11.6,27,16,13,8,6,10,24,41.7,14,21,8,13,20,47,31,1,"DF,MF",25-29,Defender,Greece,Europe
2525,Jens Stage,DEN,Werder Bremen,Bundesliga,2022,25.0,1996.0,20.6,34,17,15,18,1,10,37,27.0,27,34,11,23,16,50,37,0,MF,25-29,Midfielder,Denmark,Europe
2526,Veit Stange,GER,Hertha BSC,Bundesliga,2022,18.0,2004.0,0.1,1,1,1,0,0,1,1,100.0,0,0,0,0,0,1,0,0,MF,Under 20,Midfielder,Germany,Europe
2527,Josip Stanišić,CRO,Bayern Munich,Bundesliga,2022,22.0,2000.0,6.4,19,11,14,2,3,12,17,70.6,5,9,1,8,7,26,11,3,DF,20-24,Defender,Croatia,Europe
2528,Junior Stanislas,ENG,Bournemouth,Premier League,2022,32.0,1989.0,0.7,0,0,0,0,0,0,0,,0,2,1,1,0,0,0,0,MF,30-34,Midfielder,England,Europe
2529,Jay Stansfield,ENG,Fulham,Premier League,2022,19.0,2002.0,1.0,0,0,0,0,0,0,2,0.0,2,4,1,3,1,1,1,0,FW,Under 20,Forward,England,Europe
2530,Niklas Stark,GER,Werder Bremen,Bundesliga,2022,27.0,1995.0,23.1,56,36,29,24,3,27,42,64.3,15,24,13,11,37,93,110,0,DF,25-29,Defender,Germany,Europe
2531,Jason Steele,ENG,Brighton,Premier League,2022,31.0,1990.0,15.0,0,0,0,0,0,0,1,0.0,1,0,0,0,0,0,6,1,GK,30-34,Goalkeeper,England,Europe
2532,Calvin Stengs,NED,Nice,Ligue 1,2022,23.0,1998.0,2.4,2,2,1,0,1,1,2,50.0,1,0,0,0,0,2,0,0,FW,20-24,Forward,Netherlands,Europe
2533,Pascal Stenzel,GER,Stuttgart,Bundesliga,2022,26.0,1996.0,3.7,12,8,8,4,0,5,9,55.6,4,9,2,7,5,17,6,0,DF,25-29,Defender,Germany,Europe
2534,Jack Stephens,ENG,Southampton,Premier League,2022,28.0,1994.0,0.5,2,2,2,0,0,1,1,100.0,0,1,1,0,1,3,2,0,DF,25-29,Defender,England,Europe
2535,Jack Stephens,ENG,Bournemouth,Premier League,2022,28.0,1994.0,13.0,15,11,10,4,1,6,10,60.0,4,23,16,7,16,31,53,0,DF,25-29,Defender,England,Europe
2536,Raheem Sterling,ENG,Chelsea,Premier League,2022,27.0,1994.0,21.0,18,10,5,4,9,8,14,57.1,6,17,0,17,2,20,5,0,"FW,MF",25-29,Forward,England,Europe
2537,Angelo Stiller,GER,Hoffenheim,Bundesliga,2022,21.0,2001.0,7.8,26,12,9,13,4,8,12,66.7,4,12,2,10,10,36,14,0,MF,20-24,Midfielder,Germany,Europe
2538,Lars Stindl,GER,Gladbach,Bundesliga,2022,33.0,1988.0,19.3,24,14,4,17,3,10,28,35.7,18,24,5,19,11,35,19,0,"FW,MF",30-34,Forward,Germany,Europe
2539,Kevin Stöger,AUT,Bochum,Bundesliga,2022,28.0,1993.0,28.9,84,45,38,32,14,31,94,33.0,63,27,4,23,26,110,21,1,MF,25-29,Midfielder,Austria,Europe
2541,John Stones,ENG,Manchester City,Premier League,2022,28.0,1994.0,20.5,23,13,11,8,4,7,10,70.0,3,17,10,7,9,32,40,0,"DF,MF",25-29,Defender,England,Europe
2543,Tony Strata,ROU,Ajaccio,Ligue 1,2022,17.0,2004.0,1.5,4,3,4,0,0,4,5,80.0,1,2,0,2,1,5,7,0,"MF,DF",Under 20,Midfielder,Romania,Europe
2544,Gabriel Strefezza,BRA,Lecce,Serie A,2022,25.0,1997.0,27.1,50,24,18,20,12,27,53,50.9,26,36,3,33,16,66,15,0,"FW,MF",25-29,Forward,Brazil,South America
2545,Dávid Strelec,SVK,Spezia,Serie A,2022,21.0,2001.0,1.9,2,2,0,1,1,2,2,100.0,0,0,0,0,0,2,0,0,FW,20-24,Forward,Slovakia,Europe
2546,Pascal Struijk,NED,Leeds United,Premier League,2022,22.0,1999.0,24.4,84,57,43,31,10,49,75,65.3,26,32,12,20,32,116,70,1,DF,20-24,Defender,Netherlands,Europe
2547,Cristhian Stuani,URU,Girona,La Liga,2022,35.0,1986.0,12.1,13,6,2,7,4,5,14,35.7,9,10,0,10,2,15,5,0,FW,35-39,Forward,Uruguay,South America
2548,Damián Suárez,URU,Getafe,La Liga,2022,34.0,1988.0,21.6,49,33,23,19,7,26,48,54.2,22,40,0,40,15,64,36,0,"DF,MF",30-34,Defender,Uruguay,South America
2551,Gabriel Suazo,CHI,Toulouse,Ligue 1,2022,24.0,1997.0,14.0,38,22,20,15,3,29,63,46.0,34,21,5,16,22,60,24,1,DF,20-24,Defender,Chile,South America
2552,Isaac Success,NGA,Udinese,Serie A,2022,26.0,1996.0,20.2,8,4,2,5,1,3,8,37.5,5,13,2,11,4,12,18,0,FW,25-29,Forward,Nigeria,Africa
2553,Niklas Süle,GER,Dortmund,Bundesliga,2022,26.0,1995.0,23.5,25,19,18,3,4,14,23,60.9,9,28,19,9,17,42,53,0,DF,25-29,Defender,Germany,Europe
2554,Ibrahim Sulemana,GHA,Hellas Verona,Serie A,2022,19.0,2003.0,7.2,19,13,10,7,2,6,12,50.0,6,8,2,6,14,33,15,0,MF,Under 20,Midfielder,Ghana,Africa
2555,Kamaldeen Sulemana,GHA,Southampton,Premier League,2022,20.0,2002.0,10.7,15,9,4,7,4,4,14,28.6,10,16,0,16,6,21,6,0,"FW,MF",20-24,Forward,Ghana,Africa
2556,Kamaldeen Sulemana,GHA,Rennes,Ligue 1,2022,20.0,2002.0,3.6,6,3,1,4,1,1,5,20.0,4,2,0,2,4,10,2,0,"FW,MF",20-24,Forward,Ghana,Africa
2557,Crysencio Summerville,NED,Leeds United,Premier League,2022,20.0,2001.0,15.8,30,20,14,14,2,11,23,47.8,12,20,2,18,13,43,11,0,FW,20-24,Forward,Netherlands,Europe
2558,Ivan Šunjić,BIH,Hertha BSC,Bundesliga,2022,25.0,1996.0,11.0,38,20,16,21,1,16,24,66.7,8,17,5,12,13,51,19,1,MF,25-29,Midfielder,Bosnia and Herzegovina,Europe
2559,Sam Surridge,ENG,Nott'ham Forest,Premier League,2022,24.0,1998.0,3.6,5,0,1,3,1,1,4,25.0,3,5,2,3,0,5,7,0,FW,20-24,Forward,England,Europe
2561,Yuito Suzuki,JPN,Strasbourg,Ligue 1,2022,20.0,2001.0,0.4,0,0,0,0,0,0,0,,0,3,0,3,0,0,0,0,"FW,MF",20-24,Forward,Japan,Asia
2562,Mattias Svanberg,SWE,Wolfsburg,Bundesliga,2022,23.0,1999.0,20.4,25,16,8,16,1,10,30,33.3,20,27,5,22,21,46,25,1,"MF,FW",20-24,Midfielder,Sweden,Europe
2564,Williot Swedberg,SWE,Celta Vigo,La Liga,2022,18.0,2004.0,0.6,3,1,1,0,2,0,0,,0,2,0,2,0,3,1,0,MF,Under 20,Midfielder,Sweden,Europe
2565,Issiaga Sylla,GUI,Montpellier,Ligue 1,2022,28.0,1994.0,14.5,28,16,19,8,1,15,31,48.4,16,19,3,16,32,60,35,0,DF,25-29,Defender,Guinea,Africa
2566,Issiaga Sylla,GUI,Toulouse,Ligue 1,2022,28.0,1994.0,15.2,28,15,14,9,5,15,34,44.1,19,15,5,10,38,66,38,0,DF,25-29,Defender,Guinea,Africa
2568,Dominik Szoboszlai,HUN,RB Leipzig,Bundesliga,2022,21.0,2000.0,27.2,45,28,12,20,13,17,42,40.5,25,43,2,41,17,62,27,0,"MF,FW",20-24,Midfielder,Hungary,Europe
2571,Nicolás Tagliafico,ARG,Lyon,Ligue 1,2022,29.0,1992.0,33.2,91,53,36,41,14,50,78,64.1,28,45,11,34,57,148,47,0,DF,25-29,Defender,Argentina,South America
2572,Jonathan Tah,GER,Leverkusen,Bundesliga,2022,26.0,1996.0,27.6,25,12,21,4,0,12,18,66.7,6,30,18,12,40,65,118,0,DF,25-29,Defender,Germany,Europe
2573,Benjamin Tahirovic,BIH,Roma,Serie A,2022,19.0,2003.0,3.9,8,5,5,2,1,4,12,33.3,8,9,4,5,3,11,3,0,MF,Under 20,Midfielder,Bosnia and Herzegovina,Europe
2574,Waniss Taibi,FRA,Angers,Ligue 1,2022,20.0,2002.0,2.1,9,5,4,4,1,2,4,50.0,2,1,0,1,2,11,2,0,MF,20-24,Midfielder,France,Europe
2575,Flavien Tait,FRA,Rennes,Ligue 1,2022,29.0,1993.0,18.7,30,15,8,17,5,19,42,45.2,23,16,4,12,20,50,12,0,MF,25-29,Midfielder,France,Europe
2576,Montassar Talbi,TUN,Lorient,Ligue 1,2022,24.0,1998.0,38.0,53,25,40,13,0,22,35,62.9,13,55,34,21,40,93,190,3,DF,20-24,Defender,Tunisia,Africa
2577,Thibault Tamas,FRA,Montpellier,Ligue 1,2022,21.0,2001.0,0.1,0,0,0,0,0,0,0,,0,0,0,0,1,1,0,0,DF,20-24,Defender,France,Europe
2578,Adrien Tameze,CMR,Hellas Verona,Serie A,2022,28.0,1994.0,33.7,51,30,21,26,4,28,63,44.4,35,51,14,37,37,88,55,2,MF,25-29,Midfielder,Cameroon,Africa
2579,Japhet Tanganga,ENG,Tottenham,Premier League,2022,23.0,1999.0,1.6,3,2,3,0,0,1,5,20.0,4,1,0,1,2,5,8,0,DF,20-24,Defender,England,Europe
2580,Renato Tapia,PER,Celta Vigo,La Liga,2022,27.0,1995.0,16.1,47,25,21,21,5,18,37,48.6,19,29,11,18,19,66,37,0,"MF,DF",25-29,Midfielder,Peru,South America
2581,Edmond Tapsoba,BFA,Leverkusen,Bundesliga,2022,23.0,1999.0,31.9,51,30,35,12,4,30,42,71.4,12,40,17,23,36,87,109,1,DF,20-24,Defender,Burkina Faso,Africa
2582,Florian Tardieu,FRA,Troyes,Ligue 1,2022,30.0,1992.0,11.2,31,20,19,12,0,12,31,38.7,19,19,4,15,23,54,15,0,MF,30-34,Midfielder,France,Europe
2583,Matt Targett,ENG,Newcastle Utd,Premier League,2022,26.0,1995.0,6.8,13,10,8,3,2,9,24,37.5,15,8,3,5,9,22,16,0,DF,25-29,Defender,England,Europe
2584,James Tarkowski,ENG,Everton,Premier League,2022,29.0,1992.0,38.0,51,26,36,13,2,20,39,51.3,19,99,78,21,51,102,201,3,DF,25-29,Defender,England,Europe
2585,Ciprian Tătărușanu,ROU,Milan,Serie A,2022,36.0,1986.0,16.0,0,0,0,0,0,0,0,,0,0,0,0,1,1,2,0,GK,35-39,Goalkeeper,Romania,Europe
2586,Niklas Tauer,GER,Mainz 05,Bundesliga,2022,21.0,2001.0,1.0,2,1,2,0,0,1,3,33.3,2,2,1,1,2,4,4,0,"DF,MF",20-24,Defender,Germany,Europe
2587,Nuno Tavares,POR,Marseille,Ligue 1,2022,22.0,2000.0,26.1,56,30,19,24,13,28,56,50.0,28,32,4,28,15,71,25,0,"DF,MF",20-24,Defender,Portugal,Europe
2588,Marcus Tavernier,ENG,Bournemouth,Premier League,2022,23.0,1999.0,19.4,33,22,19,11,3,11,33,33.3,22,25,4,21,9,42,23,0,"MF,FW",20-24,Midfielder,England,Europe
2589,Enzo Tchato,CMR,Montpellier,Ligue 1,2022,19.0,2002.0,12.2,26,17,14,11,1,13,22,59.1,9,17,2,15,7,33,33,0,DF,Under 20,Defender,Cameroon,Africa
2590,Aurélien Tchouaméni,FRA,Real Madrid,La Liga,2022,22.0,2000.0,23.5,64,40,23,36,5,23,38,60.5,15,20,6,14,49,113,50,0,MF,20-24,Midfielder,France,Europe
2591,Mathys Tel,FRA,Bayern Munich,Bundesliga,2022,17.0,2005.0,4.6,2,2,0,1,1,1,1,100.0,0,5,1,4,0,2,2,0,FW,Under 20,Forward,France,Europe
2592,Semir Telalovic,GER,Gladbach,Bundesliga,2022,22.0,1999.0,0.1,0,0,0,0,0,0,0,,0,0,0,0,0,0,0,0,"MF,FW",20-24,Midfielder,Germany,Europe
2593,Alex Telles,BRA,Sevilla,La Liga,2022,29.0,1992.0,15.9,21,13,15,6,0,13,25,52.0,12,17,5,12,20,41,38,0,DF,25-29,Defender,Brazil,South America
2594,Marc-André ter Stegen,GER,Barcelona,La Liga,2022,30.0,1992.0,37.2,0,0,0,0,0,0,0,,0,0,0,0,1,1,7,3,GK,30-34,Goalkeeper,Germany,Europe
2595,Simon Terodde,GER,Schalke 04,Bundesliga,2022,34.0,1988.0,20.3,15,8,4,7,4,3,14,21.4,11,6,2,4,6,21,9,0,FW,30-34,Forward,Germany,Europe
2596,Filippo Terracciano,ITA,Hellas Verona,Serie A,2022,19.0,2003.0,9.1,20,13,11,7,2,15,20,75.0,5,7,4,3,10,30,14,0,"DF,MF",Under 20,Defender,Italy,Europe
2597,Pietro Terracciano,ITA,Fiorentina,Serie A,2022,32.0,1990.0,29.0,2,1,2,0,0,2,3,66.7,1,0,0,0,1,3,14,0,GK,30-34,Goalkeeper,Italy,Europe
2600,Martin Terrier,FRA,Rennes,Ligue 1,2022,25.0,1997.0,14.7,25,11,7,9,9,13,24,54.2,11,15,2,13,14,39,6,0,"FW,MF",25-29,Forward,France,Europe
2602,Tetê,BRA,Leicester City,Premier League,2022,22.0,2000.0,8.2,14,8,5,7,2,6,21,28.6,15,9,0,9,2,16,3,0,FW,20-24,Forward,Brazil,South America
2603,Tetê,BRA,Lyon,Ligue 1,2022,22.0,2000.0,12.3,21,10,8,5,8,10,19,52.6,9,9,0,9,13,34,2,0,"FW,MF",20-24,Forward,Brazil,South America
2604,Kenny Tete,NED,Fulham,Premier League,2022,26.0,1995.0,28.5,83,46,41,29,13,38,51,74.5,13,48,17,31,52,135,81,1,DF,25-29,Defender,Netherlands,Europe
2605,Florian Thauvin,FRA,Udinese,Serie A,2022,29.0,1993.0,6.1,2,1,0,2,0,2,13,15.4,11,5,0,5,2,4,2,0,"FW,MF",25-29,Forward,France,Europe
2606,Arthur Theate,BEL,Rennes,Ligue 1,2022,22.0,2000.0,34.7,29,19,17,8,4,17,30,56.7,13,26,14,12,30,59,114,3,DF,20-24,Defender,Belgium,Europe
2607,Malick Thiaw,GER,Milan,Serie A,2022,20.0,2001.0,15.1,31,26,22,9,0,11,20,55.0,9,11,5,6,12,43,65,1,DF,20-24,Defender,Germany,Europe
2608,Malick Thiaw,GER,Schalke 04,Bundesliga,2022,20.0,2001.0,3.0,3,1,2,1,0,1,2,50.0,1,4,3,1,9,12,24,1,DF,20-24,Defender,Germany,Europe
2609,Jan Thielmann,GER,Köln,Bundesliga,2022,20.0,2002.0,9.7,9,8,3,4,2,2,11,18.2,9,16,3,13,9,18,7,0,FW,20-24,Forward,Germany,Europe
2610,Sada Thioub,SEN,Angers,Ligue 1,2022,27.0,1995.0,11.8,19,10,9,8,2,8,17,47.1,9,13,0,13,7,26,5,1,"DF,FW",25-29,Defender,Senegal,Africa
2611,Luke Thomas,ENG,Leicester City,Premier League,2022,21.0,2001.0,11.9,23,19,15,5,3,15,32,46.9,17,20,4,16,27,50,35,0,DF,20-24,Defender,England,Europe
2612,Adrien Thomasson,FRA,Strasbourg,Ligue 1,2022,28.0,1993.0,10.4,19,9,8,6,5,9,30,30.0,21,18,0,18,3,22,2,0,MF,25-29,Midfielder,France,Europe
2613,Adrien Thomasson,FRA,Lens,Ligue 1,2022,28.0,1993.0,14.2,24,17,8,11,5,12,45,26.7,33,25,2,23,4,28,17,0,"MF,FW",25-29,Midfielder,France,Europe
2616,Khéphren Thuram,FRA,Nice,Ligue 1,2022,21.0,2001.0,28.3,51,25,22,23,6,19,43,44.2,24,33,13,20,38,89,34,0,MF,20-24,Midfielder,France,Europe
2617,Marcus Thuram,FRA,Gladbach,Bundesliga,2022,24.0,1997.0,27.9,14,7,3,6,5,6,13,46.2,7,20,3,17,6,20,22,0,FW,20-24,Forward,France,Europe
2618,Alexis Tibidi,FRA,Troyes,Ligue 1,2022,18.0,2003.0,0.8,1,1,1,0,0,0,0,,0,0,0,0,0,1,0,0,"FW,MF",Under 20,Forward,France,Europe
2619,Youri Tielemans,BEL,Leicester City,Premier League,2022,25.0,1997.0,26.0,66,39,27,30,9,23,62,37.1,39,35,8,27,28,94,24,1,MF,25-29,Midfielder,Belgium,Europe
2620,Kieran Tierney,SCO,Arsenal,Premier League,2022,25.0,1997.0,8.8,20,11,9,9,2,12,16,75.0,4,8,2,6,11,31,25,0,DF,25-29,Defender,Scotland,Europe
2621,Steffen Tigges,GER,Köln,Bundesliga,2022,24.0,1998.0,17.7,12,7,1,8,3,4,14,28.6,10,13,2,11,8,20,17,0,FW,20-24,Forward,Germany,Europe
2622,Jean-Clair Todibo,FRA,Nice,Ligue 1,2022,22.0,1999.0,31.9,76,48,54,19,3,41,56,73.2,15,41,19,22,41,117,110,2,DF,20-24,Defender,France,Europe
2623,Harry Toffolo,ENG,Nott'ham Forest,Premier League,2022,26.0,1995.0,10.4,17,8,10,4,3,10,14,71.4,4,16,8,8,10,27,33,0,DF,25-29,Defender,England,Europe
2624,Umut Tohumcu,GER,Hoffenheim,Bundesliga,2022,17.0,2004.0,3.0,10,5,4,5,1,3,9,33.3,6,4,0,4,2,12,8,0,"MF,DF",Under 20,Midfielder,Germany,Europe
2625,Karl Toko Ekambi,CMR,Rennes,Ligue 1,2022,29.0,1992.0,10.8,3,1,1,1,1,3,9,33.3,6,5,0,5,9,12,3,0,"FW,MF",25-29,Forward,Cameroon,Africa
2626,Karl Toko Ekambi,CMR,Lyon,Ligue 1,2022,29.0,1992.0,15.0,9,9,2,4,3,4,15,26.7,11,12,2,10,9,18,6,0,"FW,MF",25-29,Forward,Cameroon,Africa
2627,Corentin Tolisso,FRA,Lyon,Ligue 1,2022,27.0,1994.0,22.6,44,27,16,23,5,25,66,37.9,41,25,5,20,24,68,23,1,MF,25-29,Midfielder,France,Europe
2628,Jeremy Toljan,GER,Sassuolo,Serie A,2022,27.0,1994.0,29.7,36,23,17,14,5,22,33,66.7,11,31,14,17,18,54,60,1,DF,25-29,Defender,Germany,Europe
2629,Rafael Tolói,ITA,Atalanta,Serie A,2022,31.0,1990.0,30.9,69,44,37,32,0,35,64,54.7,29,42,18,24,57,126,88,1,DF,30-34,Defender,Italy,Europe
2631,Tiago Tomás,POR,Stuttgart,Bundesliga,2022,20.0,2002.0,14.3,10,4,2,4,4,8,13,61.5,5,9,2,7,1,11,5,0,"FW,MF",20-24,Forward,Portugal,Europe
2632,Takehiro Tomiyasu,JPN,Arsenal,Premier League,2022,23.0,1998.0,7.4,27,18,12,10,5,13,18,72.2,5,7,0,7,14,41,15,1,DF,20-24,Defender,Japan,Asia
2633,James Tomkins,ENG,Crystal Palace,Premier League,2022,33.0,1989.0,3.8,4,2,2,1,1,1,3,33.3,2,3,2,1,5,9,19,0,DF,30-34,Defender,England,Europe
2634,Fikayo Tomori,ENG,Milan,Serie A,2022,24.0,1997.0,30.7,70,34,44,25,1,22,34,64.7,12,46,25,21,29,99,88,1,DF,20-24,Defender,England,Europe
2635,Sandro Tonali,ITA,Milan,Serie A,2022,22.0,2000.0,30.1,64,41,35,24,5,27,44,61.4,17,34,9,25,25,89,26,1,MF,20-24,Midfielder,Italy,Europe
2636,Lorenzo Tonelli,ITA,Empoli,Serie A,2022,32.0,1990.0,0.2,0,0,0,0,0,0,1,0.0,1,0,0,0,0,0,0,0,DF,30-34,Defender,Italy,Europe
2637,Ivan Toney,ENG,Brentford,Premier League,2022,26.0,1996.0,32.8,23,13,4,9,10,7,23,30.4,16,24,9,15,14,37,36,0,FW,25-29,Forward,England,Europe
2645,Nabil Touaizi,MAR,Espanyol,La Liga,2022,21.0,2001.0,0.0,0,0,0,0,0,0,0,,0,0,0,0,0,0,0,0,MF,20-24,Midfielder,Morocco,Africa
2646,Almamy Touré,MLI,Eint Frankfurt,Bundesliga,2022,26.0,1996.0,4.4,13,7,7,5,1,5,9,55.6,4,9,2,7,10,23,8,0,DF,25-29,Defender,Mali,Africa
2647,Birama Touré,MLI,Auxerre,Ligue 1,2022,30.0,1992.0,37.8,80,47,35,35,10,34,93,36.6,59,54,9,45,67,147,49,0,MF,30-34,Midfielder,Mali,Africa
2648,Mohamed Toure,AUS,Reims,Ligue 1,2022,18.0,2004.0,0.3,0,0,0,0,0,0,0,,0,0,0,0,0,0,0,0,"FW,MF",Under 20,Forward,Australia,Oceania
2649,Souleymane Touré,FRA,Marseille,Ligue 1,2022,19.0,2003.0,0.8,2,1,1,1,0,1,2,50.0,1,1,0,1,0,2,5,0,DF,Under 20,Defender,France,Europe
2650,Souleymane Touré,FRA,Auxerre,Ligue 1,2022,19.0,2003.0,17.6,29,13,19,9,1,16,20,80.0,4,32,12,20,26,55,56,1,DF,Under 20,Defender,France,Europe
2651,Lucas Tousart,FRA,Hertha BSC,Bundesliga,2022,25.0,1997.0,32.7,73,38,35,28,10,27,60,45.0,33,42,6,36,48,121,75,1,MF,25-29,Midfielder,France,Europe
2652,Yoann Touzghar,TUN,Ajaccio,Ligue 1,2022,35.0,1986.0,5.0,3,2,0,2,1,0,1,0.0,1,0,0,0,0,3,1,0,FW,35-39,Forward,Tunisia,Africa
2654,Bertrand Traoré,BFA,Aston Villa,Premier League,2022,26.0,1995.0,2.6,1,1,1,0,0,1,4,25.0,3,5,0,5,2,3,0,0,"FW,MF",25-29,Forward,Burkina Faso,Africa
2655,Boubacar Traoré,MLI,Wolves,Premier League,2022,20.0,2001.0,4.6,12,5,4,5,3,3,7,42.9,4,4,2,2,7,19,1,0,MF,20-24,Midfielder,Mali,Africa
2656,Charles Traore,MLI,Nantes,Ligue 1,2022,30.0,1992.0,5.4,8,5,5,2,1,5,7,71.4,2,9,2,7,10,18,12,0,DF,30-34,Defender,Mali,Africa
2657,Hamari Traoré,MLI,Rennes,Ligue 1,2022,30.0,1992.0,28.1,48,32,26,15,7,28,52,53.8,24,33,7,26,38,86,64,0,DF,30-34,Defender,Mali,Africa
2658,Kevin Trapp,GER,Eint Frankfurt,Bundesliga,2022,32.0,1990.0,33.0,1,1,1,0,0,0,2,0.0,2,2,0,2,0,1,10,0,GK,30-34,Goalkeeper,Germany,Europe
2659,Mark Travers,IRL,Bournemouth,Premier League,2022,23.0,1999.0,11.5,0,0,0,0,0,0,0,,0,1,0,1,0,0,6,0,GK,20-24,Goalkeeper,Republic of Ireland,Europe
2660,Óscar Trejo,ARG,Rayo Vallecano,La Liga,2022,34.0,1988.0,23.8,48,32,12,23,13,9,44,20.5,35,31,3,28,8,56,8,1,"MF,FW",30-34,Midfielder,Argentina,South America
2662,Christopher Trimmel,AUT,Union Berlin,Bundesliga,2022,35.0,1987.0,20.1,31,16,16,12,3,20,31,64.5,11,14,1,13,25,56,48,0,DF,35-39,Defender,Austria,Europe
2663,Théo Trinker,FRA,Nice,Ligue 1,2022,21.0,2001.0,0.0,0,0,0,0,0,0,0,,0,0,0,0,0,0,0,0,MF,20-24,Midfielder,France,Europe
2664,Kieran Trippier,ENG,Newcastle Utd,Premier League,2022,31.0,1990.0,37.1,71,49,36,27,8,46,90,51.1,44,45,15,30,43,114,84,2,DF,30-34,Defender,England,Europe
2665,William Troost-Ekong,NGA,Salernitana,Serie A,2022,28.0,1993.0,4.9,11,3,7,4,0,6,7,85.7,1,7,4,3,6,17,10,0,DF,25-29,Defender,Nigeria,Africa
2666,Leandro Trossard,BEL,Arsenal,Premier League,2022,27.0,1994.0,10.3,12,7,4,2,6,6,18,33.3,12,18,0,18,6,18,3,1,FW,25-29,Forward,Belgium,Europe
2667,Leandro Trossard,BEL,Brighton,Premier League,2022,27.0,1994.0,14.6,10,6,7,1,2,1,8,12.5,7,17,0,17,6,16,1,0,"FW,MF",25-29,Forward,Belgium,Europe
2668,Adrien Truffert,FRA,Rennes,Ligue 1,2022,20.0,2001.0,21.7,62,32,36,17,9,31,46,67.4,15,32,8,24,22,84,55,0,DF,20-24,Defender,France,Europe
2669,Frank Tsadjout,ITA,Cremonese,Serie A,2022,23.0,1999.0,11.7,10,8,3,6,1,3,9,33.3,6,7,1,6,8,18,9,0,FW,20-24,Forward,Italy,Europe
2670,Kostas Tsimikas,GRE,Liverpool,Premier League,2022,26.0,1996.0,8.6,14,9,10,2,2,10,16,62.5,6,8,1,7,12,26,15,0,DF,25-29,Defender,Greece,Europe
2671,Theocharis Tsingaras,GRE,Toulouse,Ligue 1,2022,21.0,2000.0,0.1,0,0,0,0,0,0,0,,0,0,0,0,0,0,0,0,MF,20-24,Midfielder,Greece,Europe
2672,Viktor Tsyhankov,UKR,Girona,La Liga,2022,24.0,1997.0,16.5,8,8,5,1,2,1,14,7.1,13,13,2,11,7,15,12,0,MF,20-24,Midfielder,Ukraine,Europe
2673,Alessandro Tuia,ITA,Lecce,Serie A,2022,32.0,1990.0,5.7,10,6,6,4,0,3,9,33.3,6,3,1,2,15,25,29,0,DF,30-34,Defender,Italy,Europe
2676,Tuta,BRA,Eint Frankfurt,Bundesliga,2022,23.0,1999.0,30.2,53,35,27,19,7,33,57,57.9,24,47,14,33,49,102,134,2,DF,20-24,Defender,Brazil,South America
2677,Destiny Udogie,ITA,Udinese,Serie A,2022,19.0,2002.0,30.0,71,45,42,24,5,34,59,57.6,25,34,6,28,36,107,25,0,DF,Under 20,Defender,Italy,Europe
2678,Ike Ugbo,CAN,Troyes,Ligue 1,2022,23.0,1998.0,9.9,5,2,2,2,1,3,11,27.3,8,8,2,6,2,7,4,0,"FW,MF",20-24,Forward,Canada,North America
2679,Lesley Ugochukwu,FRA,Rennes,Ligue 1,2022,18.0,2004.0,14.8,36,19,13,20,3,16,24,66.7,8,24,10,14,21,57,16,0,MF,Under 20,Midfielder,France,Europe
2681,Sven Ulreich,GER,Bayern Munich,Bundesliga,2022,33.0,1988.0,3.0,1,1,1,0,0,1,1,100.0,0,0,0,0,0,1,0,1,GK,30-34,Goalkeeper,Germany,Europe
2682,Lauren Ulrich,GER,Stuttgart,Bundesliga,2022,17.0,2005.0,0.1,1,1,0,0,1,0,0,,0,0,0,0,0,1,0,0,MF,Under 20,Midfielder,Germany,Europe
2683,Samuel Umtiti,FRA,Lecce,Serie A,2022,28.0,1993.0,23.5,52,34,25,25,2,18,26,69.2,8,26,14,12,26,78,79,0,DF,25-29,Defender,France,Europe
2684,Enes Ünal,TUR,Getafe,La Liga,2022,25.0,1997.0,33.0,26,14,5,19,2,7,25,28.0,18,19,2,17,6,32,35,0,FW,25-29,Forward,Turkey,Asia
2685,Deniz Undav,GER,Brighton,Premier League,2022,26.0,1996.0,7.0,7,4,2,2,3,2,8,25.0,6,4,1,3,0,7,1,0,"FW,MF",25-29,Forward,Germany,Europe
2686,Cengiz Ünder,TUR,Marseille,Ligue 1,2022,25.0,1997.0,27.7,37,19,15,13,9,13,34,38.2,21,18,2,16,18,55,13,0,"MF,DF",25-29,Midfielder,Turkey,Asia
2687,Dayot Upamecano,FRA,Bayern Munich,Bundesliga,2022,23.0,1998.0,26.1,65,37,43,22,0,28,45,62.2,17,26,6,20,27,92,71,4,DF,20-24,Defender,France,Europe
2688,Filip Uremović,CRO,Hertha BSC,Bundesliga,2022,25.0,1997.0,19.2,38,23,29,8,1,14,22,63.6,8,18,13,5,36,74,88,2,DF,25-29,Defender,Croatia,Europe
2689,Oscar Ureña,DOM,Girona,La Liga,2022,19.0,2003.0,1.1,4,2,2,2,0,2,3,66.7,1,2,0,2,1,5,0,0,MF,Under 20,Midfielder,Dominican Republic,North America
2690,Jere Uronen,FIN,Brest,Ligue 1,2022,28.0,1994.0,3.3,8,5,4,4,0,7,12,58.3,5,6,2,4,7,15,5,0,DF,25-29,Defender,Finland,Europe
2691,Jere Uronen,FIN,Schalke 04,Bundesliga,2022,28.0,1994.0,7.5,14,10,6,6,2,6,10,60.0,4,5,2,3,8,22,13,0,DF,25-29,Defender,Finland,Europe
2692,Mark Uth,GER,Köln,Bundesliga,2022,30.0,1991.0,0.5,0,0,0,0,0,0,0,,0,0,0,0,0,0,0,0,"MF,FW",30-34,Midfielder,Germany,Europe
2693,Josha Vagnoman,GER,Stuttgart,Bundesliga,2022,21.0,2000.0,16.4,26,15,12,11,3,15,27,55.6,12,20,2,18,8,34,29,1,DF,20-24,Defender,Germany,Europe
2694,Diego Valencia,CHI,Salernitana,Serie A,2022,22.0,2000.0,2.6,8,5,4,2,2,2,9,22.2,7,10,1,9,1,9,2,0,"MF,FW",20-24,Midfielder,Chile,South America
2696,Emanuele Valeri,ITA,Cremonese,Serie A,2022,23.0,1998.0,30.9,54,27,29,21,4,29,69,42.0,40,17,3,14,22,76,44,1,DF,20-24,Defender,Italy,Europe
2697,Yan Valery,TUN,Southampton,Premier League,2022,23.0,1999.0,0.5,0,0,0,0,0,0,0,,0,1,0,1,0,0,3,0,DF,20-24,Defender,Tunisia,Africa
2698,Yan Valery,TUN,Angers,Ligue 1,2022,23.0,1999.0,27.7,54,39,28,20,6,20,37,54.1,17,35,15,20,34,88,82,0,DF,20-24,Defender,Tunisia,Africa
2699,Martin Valjent,SVK,Mallorca,La Liga,2022,26.0,1995.0,29.5,35,27,22,12,1,19,28,67.9,9,39,21,18,29,64,137,0,DF,25-29,Defender,Slovakia,Europe
2702,Mattia Valoti,ITA,Monza,Serie A,2022,28.0,1993.0,5.0,17,10,7,9,1,5,16,31.3,11,13,3,10,3,20,6,0,"MF,FW",25-29,Midfielder,Italy,Europe
2703,Federico Valverde,URU,Real Madrid,La Liga,2022,24.0,1998.0,27.8,31,20,14,11,6,13,26,50.0,13,31,4,27,17,48,15,0,"MF,FW",20-24,Midfielder,Uruguay,South America
2704,Virgil van Dijk,NED,Liverpool,Premier League,2022,31.0,1991.0,31.5,27,14,13,11,3,8,19,42.1,11,24,16,8,31,58,138,3,DF,30-34,Defender,Netherlands,Europe
2705,Vanderson,BRA,Monaco,Ligue 1,2022,21.0,2001.0,24.6,84,48,36,34,14,44,75,58.7,31,36,9,27,48,132,36,1,"DF,MF",20-24,Defender,Brazil,South America
2705,Vanderson,BRA,Monaco,Ligue 1,2022,21.0,2001.0,24.6,84,48,36,34,14,44,75,58.7,31,36,9,27,48,132,36,1,"DF,MF",20-24,Defender,Brazil,South America
2705,Vanderson,BRA,Monaco,Ligue 1,2022,21.0,2001.0,24.6,84,48,36,34,14,44,75,58.7,31,36,9,27,48,132,36,1,"DF,MF",20-24,Defender,Brazil,South America
2705,Vanderson,BRA,Monaco,Ligue 1,2022,21.0,2001.0,24.6,84,48,36,34,14,44,75,58.7,31,36,9,27,48,132,36,1,"DF,MF",20-24,Defender,Brazil,South America
2706,Raphaël Varane,FRA,Manchester Utd,Premier League,2022,29.0,1993.0,21.2,24,9,18,6,0,7,17,41.2,10,24,17,7,11,35,91,0,DF,25-29,Defender,France,Europe
2707,Jamie Vardy,ENG,Leicester City,Premier League,2022,35.0,1987.0,20.6,9,5,4,2,3,1,8,12.5,7,17,3,14,2,11,30,0,FW,35-39,Forward,England,Europe
2708,Ruben Vargas,SUI,Augsburg,Bundesliga,2022,23.0,1998.0,12.6,15,7,6,7,2,5,11,45.5,6,8,2,6,6,21,16,1,"MF,FW",20-24,Midfielder,Switzerland,Europe
2709,Johan Vásquez,MEX,Cremonese,Serie A,2022,23.0,1998.0,20.1,41,26,34,7,0,18,39,46.2,21,27,20,7,45,86,93,1,DF,20-24,Defender,Mexico,North America
2713,Matías Vecino,URU,Lazio,Serie A,2022,30.0,1991.0,18.8,47,27,13,23,11,23,48,47.9,25,33,10,23,16,63,39,1,MF,30-34,Midfielder,Uruguay,South America
2715,Renato Veiga,POR,Augsburg,Bundesliga,2022,19.0,2003.0,7.1,9,6,4,3,2,7,9,77.8,2,20,6,14,7,16,29,1,DF,Under 20,Defender,Portugal,Europe
2717,Miguel Veloso,POR,Hellas Verona,Serie A,2022,36.0,1986.0,12.9,33,10,20,12,1,16,26,61.5,10,26,6,20,6,39,14,0,MF,35-39,Midfielder,Portugal,Europe
2718,Joël Veltman,NED,Brighton,Premier League,2022,30.0,1992.0,24.3,62,32,44,14,4,37,57,64.9,20,27,8,19,19,81,51,0,DF,30-34,Defender,Netherlands,Europe
2719,Micky van de Ven,NED,Wolfsburg,Bundesliga,2022,21.0,2001.0,33.0,45,30,26,18,1,28,39,71.8,11,42,24,18,26,71,108,2,DF,20-24,Defender,Netherlands,Europe
2721,Lorenzo Venuti,ITA,Fiorentina,Serie A,2022,27.0,1995.0,10.3,18,7,6,11,1,11,18,61.1,7,7,2,5,5,23,17,2,DF,25-29,Defender,Italy,Europe
2722,Daniele Verde,ITA,Spezia,Serie A,2022,26.0,1996.0,11.1,4,4,3,0,1,3,7,42.9,4,6,0,6,8,12,4,0,"FW,MF",25-29,Forward,Italy,Europe
2723,Simone Verdi,ITA,Hellas Verona,Serie A,2022,30.0,1992.0,12.2,15,10,7,5,3,6,17,35.3,11,8,1,7,0,15,2,0,"MF,FW",30-34,Midfielder,Italy,Europe
2725,Jordan Veretout,FRA,Marseille,Ligue 1,2022,29.0,1993.0,31.8,56,35,17,32,7,25,53,47.2,28,22,7,15,36,92,40,2,MF,25-29,Midfielder,France,Europe
2726,Marco Verratti,ITA,Paris S-G,Ligue 1,2022,29.0,1992.0,24.4,76,49,34,36,6,38,89,42.7,51,42,6,36,27,103,11,3,MF,25-29,Midfielder,Italy,Europe
2727,Valerio Verre,ITA,Sampdoria,Serie A,2022,28.0,1994.0,7.5,14,7,6,5,3,8,17,47.1,9,9,1,8,9,23,3,0,MF,25-29,Midfielder,Italy,Europe
2729,Guglielmo Vicario,ITA,Empoli,Serie A,2022,25.0,1996.0,30.9,1,1,1,0,0,1,2,50.0,1,0,0,0,0,1,15,2,GK,25-29,Goalkeeper,Italy,Europe
2730,João Victor,BRA,Nantes,Ligue 1,2022,24.0,1998.0,9.4,19,11,9,7,3,12,22,54.5,10,11,1,10,15,34,30,0,DF,20-24,Defender,Brazil,South America
2730,João Victor,BRA,Nantes,Ligue 1,2022,24.0,1998.0,9.4,19,11,9,7,3,12,22,54.5,10,11,1,10,15,34,30,0,DF,20-24,Defender,Brazil,South America
2730,João Victor,BRA,Nantes,Ligue 1,2022,24.0,1998.0,9.4,19,11,9,7,3,12,22,54.5,10,11,1,10,15,34,30,0,DF,20-24,Defender,Brazil,South America
2730,João Victor,BRA,Nantes,Ligue 1,2022,24.0,1998.0,9.4,19,11,9,7,3,12,22,54.5,10,11,1,10,15,34,30,0,DF,20-24,Defender,Brazil,South America
2730,João Victor,BRA,Nantes,Ligue 1,2022,24.0,1998.0,9.4,19,11,9,7,3,12,22,54.5,10,11,1,10,15,34,30,0,DF,20-24,Defender,Brazil,South America
2730,João Victor,BRA,Nantes,Ligue 1,2022,24.0,1998.0,9.4,19,11,9,7,3,12,22,54.5,10,11,1,10,15,34,30,0,DF,20-24,Defender,Brazil,South America
2730,João Victor,BRA,Nantes,Ligue 1,2022,24.0,1998.0,9.4,19,11,9,7,3,12,22,54.5,10,11,1,10,15,34,30,0,DF,20-24,Defender,Brazil,South America
2730,João Victor,BRA,Nantes,Ligue 1,2022,24.0,1998.0,9.4,19,11,9,7,3,12,22,54.5,10,11,1,10,15,34,30,0,DF,20-24,Defender,Brazil,South America
2730,João Victor,BRA,Nantes,Ligue 1,2022,24.0,1998.0,9.4,19,11,9,7,3,12,22,54.5,10,11,1,10,15,34,30,0,DF,20-24,Defender,Brazil,South America
2730,João Victor,BRA,Nantes,Ligue 1,2022,24.0,1998.0,9.4,19,11,9,7,3,12,22,54.5,10,11,1,10,15,34,30,0,DF,20-24,Defender,Brazil,South America
2730,João Victor,BRA,Nantes,Ligue 1,2022,24.0,1998.0,9.4,19,11,9,7,3,12,22,54.5,10,11,1,10,15,34,30,0,DF,20-24,Defender,Brazil,South America
2730,João Victor,BRA,Nantes,Ligue 1,2022,24.0,1998.0,9.4,19,11,9,7,3,12,22,54.5,10,11,1,10,15,34,30,0,DF,20-24,Defender,Brazil,South America
2730,João Victor,BRA,Nantes,Ligue 1,2022,24.0,1998.0,9.4,19,11,9,7,3,12,22,54.5,10,11,1,10,15,34,30,0,DF,20-24,Defender,Brazil,South America
2730,João Victor,BRA,Nantes,Ligue 1,2022,24.0,1998.0,9.4,19,11,9,7,3,12,22,54.5,10,11,1,10,15,34,30,0,DF,20-24,Defender,Brazil,South America
2730,João Victor,BRA,Nantes,Ligue 1,2022,24.0,1998.0,9.4,19,11,9,7,3,12,22,54.5,10,11,1,10,15,34,30,0,DF,20-24,Defender,Brazil,South America
2730,João Victor,BRA,Nantes,Ligue 1,2022,24.0,1998.0,9.4,19,11,9,7,3,12,22,54.5,10,11,1,10,15,34,30,0,DF,20-24,Defender,Brazil,South America
2730,João Victor,BRA,Nantes,Ligue 1,2022,24.0,1998.0,9.4,19,11,9,7,3,12,22,54.5,10,11,1,10,15,34,30,0,DF,20-24,Defender,Brazil,South America
2730,João Victor,BRA,Nantes,Ligue 1,2022,24.0,1998.0,9.4,19,11,9,7,3,12,22,54.5,10,11,1,10,15,34,30,0,DF,20-24,Defender,Brazil,South America
2730,João Victor,BRA,Nantes,Ligue 1,2022,24.0,1998.0,9.4,19,11,9,7,3,12,22,54.5,10,11,1,10,15,34,30,0,DF,20-24,Defender,Brazil,South America
2730,João Victor,BRA,Nantes,Ligue 1,2022,24.0,1998.0,9.4,19,11,9,7,3,12,22,54.5,10,11,1,10,15,34,30,0,DF,20-24,Defender,Brazil,South America
2730,João Victor,BRA,Nantes,Ligue 1,2022,24.0,1998.0,9.4,19,11,9,7,3,12,22,54.5,10,11,1,10,15,34,30,0,DF,20-24,Defender,Brazil,South America
2730,João Victor,BRA,Nantes,Ligue 1,2022,24.0,1998.0,9.4,19,11,9,7,3,12,22,54.5,10,11,1,10,15,34,30,0,DF,20-24,Defender,Brazil,South America
2730,João Victor,BRA,Nantes,Ligue 1,2022,24.0,1998.0,9.4,19,11,9,7,3,12,22,54.5,10,11,1,10,15,34,30,0,DF,20-24,Defender,Brazil,South America
2730,João Victor,BRA,Nantes,Ligue 1,2022,24.0,1998.0,9.4,19,11,9,7,3,12,22,54.5,10,11,1,10,15,34,30,0,DF,20-24,Defender,Brazil,South America
2730,João Victor,BRA,Nantes,Ligue 1,2022,24.0,1998.0,9.4,19,11,9,7,3,12,22,54.5,10,11,1,10,15,34,30,0,DF,20-24,Defender,Brazil,South America
2732,Clément Vidal,FRA,Ajaccio,Ligue 1,2022,22.0,2000.0,21.1,25,15,14,11,0,18,38,47.4,20,27,16,11,27,52,73,1,"DF,MF",20-24,Defender,France,Europe
2734,Gabriel Vidovic,CRO,Bayern Munich,Bundesliga,2022,18.0,2003.0,0.2,0,0,0,0,0,0,0,,0,0,0,0,0,0,0,0,FW,Under 20,Forward,Croatia,Europe
2735,Fabio Vieira,POR,Arsenal,Premier League,2022,22.0,2000.0,5.7,6,4,3,0,3,3,5,60.0,2,5,0,5,4,10,2,0,"MF,FW",20-24,Midfielder,Portugal,Europe
2736,Ronaldo Vieira,ENG,Torino,Serie A,2022,24.0,1998.0,0.2,1,0,0,1,0,1,1,100.0,0,0,0,0,0,1,2,0,MF,20-24,Midfielder,England,Europe
2737,Ronaldo Vieira,ENG,Sampdoria,Serie A,2022,24.0,1998.0,9.1,18,10,4,12,2,10,13,76.9,3,15,5,10,13,31,10,2,MF,20-24,Midfielder,England,Europe
2738,Emanuel Vignato,ITA,Bologna,Serie A,2022,21.0,2000.0,2.7,4,4,2,2,0,2,4,50.0,2,2,0,2,3,7,0,0,"MF,FW",20-24,Midfielder,Italy,Europe
2739,Emanuel Vignato,ITA,Empoli,Serie A,2022,21.0,2000.0,0.6,2,0,2,0,0,0,0,,0,0,0,0,0,2,1,0,"MF,FW",20-24,Midfielder,Italy,Europe
2740,Samuele Vignato,ITA,Monza,Serie A,2022,18.0,2004.0,0.7,0,0,0,0,0,0,0,,0,1,0,1,0,0,0,0,"MF,FW",Under 20,Midfielder,Italy,Europe
2741,Tonny Vilhena,NED,Salernitana,Serie A,2022,27.0,1995.0,25.2,44,22,16,23,5,20,50,40.0,30,17,7,10,18,62,21,0,MF,25-29,Midfielder,Netherlands,Europe
2748,Matías Viña,URU,Bournemouth,Premier League,2022,24.0,1997.0,5.1,19,11,9,8,2,14,30,46.7,16,13,1,12,4,23,22,0,DF,20-24,Defender,Uruguay,South America
2749,Matías Viña,URU,Roma,Serie A,2022,24.0,1997.0,0.6,3,1,1,1,1,1,3,33.3,2,5,1,4,2,5,5,0,DF,20-24,Defender,Uruguay,South America
2750,Rúben Vinagre,POR,Everton,Premier League,2022,23.0,1999.0,0.3,2,2,1,1,0,1,2,50.0,1,0,0,0,0,2,1,0,"DF,MF",20-24,Defender,Portugal,Europe
2751,Carlos Vinícius,BRA,Fulham,Premier League,2022,27.0,1995.0,12.3,4,1,0,2,2,0,4,0.0,4,7,0,7,0,4,10,0,FW,25-29,Forward,Brazil,South America
2752,Alan Virginius,FRA,Lille,Ligue 1,2022,19.0,2003.0,2.9,3,2,1,1,1,0,4,0.0,4,0,0,0,2,5,1,0,FW,Under 20,Forward,France,Europe
2753,Mattia Viti,ITA,Nice,Ligue 1,2022,20.0,2002.0,7.0,4,2,1,1,2,2,5,40.0,3,9,3,6,8,12,22,0,DF,20-24,Defender,Italy,Europe
2754,Vitinha,POR,Marseille,Ligue 1,2022,22.0,2000.0,5.2,15,7,0,6,9,3,11,27.3,8,3,0,3,2,17,6,0,FW,20-24,Forward,Portugal,Europe
2754,Vitinha,POR,Marseille,Ligue 1,2022,22.0,2000.0,5.2,15,7,0,6,9,3,11,27.3,8,3,0,3,2,17,6,0,FW,20-24,Forward,Portugal,Europe
2754,Vitinha,POR,Marseille,Ligue 1,2022,22.0,2000.0,5.2,15,7,0,6,9,3,11,27.3,8,3,0,3,2,17,6,0,FW,20-24,Forward,Portugal,Europe
2754,Vitinha,POR,Marseille,Ligue 1,2022,22.0,2000.0,5.2,15,7,0,6,9,3,11,27.3,8,3,0,3,2,17,6,0,FW,20-24,Forward,Portugal,Europe
2755,Vitinha,POR,Paris S-G,Ligue 1,2022,22.0,2000.0,27.2,58,25,21,27,10,27,83,32.5,56,27,4,23,25,83,15,0,MF,20-24,Midfielder,Portugal,Europe
2755,Vitinha,POR,Paris S-G,Ligue 1,2022,22.0,2000.0,27.2,58,25,21,27,10,27,83,32.5,56,27,4,23,25,83,15,0,MF,20-24,Midfielder,Portugal,Europe
2755,Vitinha,POR,Paris S-G,Ligue 1,2022,22.0,2000.0,27.2,58,25,21,27,10,27,83,32.5,56,27,4,23,25,83,15,0,MF,20-24,Midfielder,Portugal,Europe
2755,Vitinha,POR,Paris S-G,Ligue 1,2022,22.0,2000.0,27.2,58,25,21,27,10,27,83,32.5,56,27,4,23,25,83,15,0,MF,20-24,Midfielder,Portugal,Europe
2758,Nikola Vlašić,CRO,Torino,Serie A,2022,24.0,1997.0,30.3,32,21,9,16,7,15,34,44.1,19,25,2,23,10,42,14,0,"MF,FW",20-24,Midfielder,Croatia,Europe
2759,Joel Voelkerling Persson,SWE,Lecce,Serie A,2022,19.0,2003.0,1.1,1,1,0,0,1,0,1,0.0,1,1,0,1,0,1,0,0,"FW,MF",Under 20,Forward,Sweden,Europe
2760,Kevin Vogt,GER,Hoffenheim,Bundesliga,2022,30.0,1991.0,19.7,15,10,10,5,0,9,22,40.9,13,18,11,7,26,41,67,0,DF,30-34,Defender,Germany,Europe
2762,Kevin Volland,GER,Monaco,Ligue 1,2022,30.0,1992.0,7.1,8,4,1,5,2,2,8,25.0,6,8,0,8,2,10,0,0,"FW,MF",30-34,Forward,Germany,Europe
2763,Cristian Volpato,ITA,Roma,Serie A,2022,18.0,2003.0,2.5,3,2,1,1,1,0,2,0.0,2,2,0,2,2,5,0,0,MF,Under 20,Midfielder,Italy,Europe
2765,Aster Vranckx,BEL,Milan,Serie A,2022,19.0,2002.0,2.7,3,2,0,2,1,2,7,28.6,5,3,1,2,2,5,1,0,MF,Under 20,Midfielder,Belgium,Europe
2766,Aster Vranckx,BEL,Wolfsburg,Bundesliga,2022,19.0,2002.0,0.1,0,0,0,0,0,0,0,,0,0,0,0,0,0,1,0,MF,Under 20,Midfielder,Belgium,Europe
2767,Stefan de Vrij,NED,Inter,Serie A,2022,30.0,1992.0,21.6,28,18,19,9,0,8,14,57.1,6,18,10,8,40,68,80,0,DF,30-34,Defender,Netherlands,Europe
2768,Robert Wagner,GER,Freiburg,Bundesliga,2022,19.0,2003.0,0.4,0,0,0,0,0,0,0,,0,2,0,2,0,0,2,0,MF,Under 20,Midfielder,Germany,Europe
2769,Elye Wahi,FRA,Montpellier,Ligue 1,2022,19.0,2003.0,27.9,9,3,2,3,4,5,14,35.7,9,14,2,12,3,12,5,0,FW,Under 20,Forward,France,Europe
2770,Walace,BRA,Udinese,Serie A,2022,27.0,1995.0,35.4,82,39,42,31,9,41,90,45.6,49,47,12,35,51,133,51,1,MF,25-29,Midfielder,Brazil,South America
2771,Theo Walcott,ENG,Southampton,Premier League,2022,33.0,1989.0,12.5,13,6,8,4,1,8,27,29.6,19,8,1,7,9,22,7,0,"FW,MF",30-34,Forward,England,Europe
2772,Luca Waldschmidt,GER,Wolfsburg,Bundesliga,2022,26.0,1996.0,5.8,5,2,2,1,2,2,10,20.0,8,6,0,6,3,8,5,0,"FW,MF",25-29,Forward,Germany,Europe
2773,Kyle Walker,ENG,Manchester City,Premier League,2022,32.0,1990.0,21.8,13,9,8,5,0,4,24,16.7,20,12,2,10,18,31,22,0,DF,30-34,Defender,England,Europe
2774,Kyle Walker-Peters,ENG,Southampton,Premier League,2022,25.0,1997.0,29.4,61,32,34,24,3,22,43,51.2,21,47,8,39,27,88,52,0,DF,25-29,Defender,England,Europe
2776,Aaron Wan-Bissaka,ENG,Manchester Utd,Premier League,2022,24.0,1997.0,15.9,40,25,20,17,3,23,25,92.0,2,24,8,16,22,62,41,0,DF,20-24,Defender,England,Europe
2777,Paul Wanner,GER,Bayern Munich,Bundesliga,2022,16.0,2005.0,0.3,3,1,1,2,0,1,1,100.0,0,0,0,0,0,3,1,0,MF,Under 20,Midfielder,Germany,Europe
2778,Danny Ward,WAL,Leicester City,Premier League,2022,29.0,1993.0,26.0,1,1,1,0,0,1,3,33.3,2,0,0,0,0,1,14,2,GK,25-29,Goalkeeper,Wales,Europe
2778,Danny Ward,WAL,Leicester City,Premier League,2022,29.0,1993.0,26.0,1,1,1,0,0,1,3,33.3,2,0,0,0,0,1,14,2,GK,25-29,Goalkeeper,Wales,Europe
2778,Danny Ward,WAL,Leicester City,Premier League,2022,29.0,1993.0,26.0,1,1,1,0,0,1,3,33.3,2,0,0,0,0,1,14,2,GK,25-29,Goalkeeper,Wales,Europe
2778,Danny Ward,WAL,Leicester City,Premier League,2022,29.0,1993.0,26.0,1,1,1,0,0,1,3,33.3,2,0,0,0,0,1,14,2,GK,25-29,Goalkeeper,Wales,Europe
2779,Joel Ward,ENG,Crystal Palace,Premier League,2022,32.0,1989.0,25.1,50,36,30,11,9,30,41,73.2,11,32,16,16,25,75,80,1,DF,30-34,Defender,England,Europe
2780,James Ward-Prowse,ENG,Southampton,Premier League,2022,27.0,1994.0,37.5,65,37,31,27,7,21,61,34.4,40,30,10,20,55,120,48,0,MF,25-29,Midfielder,England,Europe
2781,Ollie Watkins,ENG,Aston Villa,Premier League,2022,26.0,1995.0,34.7,19,13,3,13,3,10,27,37.0,17,21,4,17,10,29,39,0,FW,25-29,Forward,England,Europe
2782,Timothy Weah,USA,Lille,Ligue 1,2022,22.0,2000.0,19.4,24,14,13,9,2,16,29,55.2,13,17,3,14,23,47,18,0,"DF,FW",20-24,Defender,United States,North America
2783,Adam Webster,ENG,Brighton,Premier League,2022,27.0,1995.0,22.1,22,12,10,9,3,11,19,57.9,8,30,19,11,19,41,55,4,DF,25-29,Defender,England,Europe
2784,Wout Weghorst,NED,Manchester Utd,Premier League,2022,29.0,1992.0,8.9,11,5,6,1,4,2,9,22.2,7,7,2,5,7,18,9,0,"FW,MF",25-29,Forward,Netherlands,Europe
2785,Julian Weigl,GER,Gladbach,Bundesliga,2022,26.0,1995.0,21.0,43,16,21,21,1,23,41,56.1,18,23,2,21,18,61,32,0,MF,25-29,Midfielder,Germany,Europe
2786,Nelson Weiper,GER,Mainz 05,Bundesliga,2022,17.0,2005.0,1.1,2,0,0,0,2,1,3,33.3,2,2,0,2,0,2,1,0,"FW,DF",Under 20,Forward,Germany,Europe
2787,Mitchell Weiser,GER,Werder Bremen,Bundesliga,2022,28.0,1994.0,28.0,71,43,38,24,9,38,75,50.7,37,50,7,43,28,99,38,1,"DF,FW",25-29,Defender,Germany,Europe
2788,Noah Weißhaupt,GER,Freiburg,Bundesliga,2022,20.0,2001.0,4.7,11,6,3,7,1,2,7,28.6,5,4,0,4,6,17,8,0,"MF,DF",20-24,Midfielder,Germany,Europe
2789,Shon Weissman,ISR,Valladolid,La Liga,2022,26.0,1996.0,8.3,2,1,1,1,0,0,4,0.0,4,8,0,8,1,3,7,0,FW,25-29,Forward,Israel,Asia
2790,Danny Welbeck,ENG,Brighton,Premier League,2022,31.0,1990.0,20.6,15,7,0,7,8,4,11,36.4,7,24,2,22,5,20,20,0,FW,30-34,Forward,England,Europe
2791,Marcel Wenig,GER,Eint Frankfurt,Bundesliga,2022,18.0,2004.0,0.0,0,0,0,0,0,0,0,,0,0,0,0,0,0,0,0,MF,Under 20,Midfielder,Germany,Europe
2792,Axel Werner,ARG,Elche,La Liga,2022,26.0,1996.0,2.0,0,0,0,0,0,0,1,0.0,1,0,0,0,0,0,0,0,GK,25-29,Goalkeeper,Argentina,South America
2793,Timo Werner,GER,RB Leipzig,Bundesliga,2022,26.0,1996.0,21.5,10,5,4,3,3,4,12,33.3,8,12,0,12,7,17,5,0,"FW,MF",25-29,Forward,Germany,Europe
2794,Ben White,ENG,Arsenal,Premier League,2022,24.0,1997.0,33.9,60,31,23,30,7,42,70,60.0,28,47,11,36,22,82,79,1,DF,20-24,Defender,England,Europe
2795,Harvey White,ENG,Tottenham,Premier League,2022,20.0,2001.0,0.1,0,0,0,0,0,0,1,0.0,1,0,0,0,0,0,0,0,MF,20-24,Midfielder,England,Europe
2796,Joseph Whitworth,ENG,Crystal Palace,Premier League,2022,18.0,2004.0,2.0,0,0,0,0,0,0,0,,0,0,0,0,0,0,1,0,GK,Under 20,Goalkeeper,England,Europe
2797,Silvan Widmer,SUI,Mainz 05,Bundesliga,2022,29.0,1993.0,18.8,26,17,15,10,1,20,39,51.3,19,22,8,14,31,57,28,0,DF,25-29,Defender,Switzerland,Europe
2799,Georginio Wijnaldum,NED,Roma,Serie A,2022,31.0,1990.0,8.5,4,3,1,3,0,0,2,0.0,2,7,1,6,2,6,3,0,MF,30-34,Midfielder,Netherlands,Europe
2800,Iñaki Williams,GHA,Athletic Club,La Liga,2022,28.0,1994.0,31.5,22,16,5,14,3,9,24,37.5,15,18,3,15,7,29,34,0,FW,25-29,Forward,Ghana,Africa
2801,Neco Williams,WAL,Nott'ham Forest,Premier League,2022,21.0,2001.0,20.9,72,47,49,17,6,38,71,53.5,33,33,8,25,33,105,48,0,DF,20-24,Defender,Wales,Europe
2803,Willian,BRA,Fulham,Premier League,2022,33.0,1988.0,23.6,13,8,8,3,2,7,25,28.0,18,13,0,13,9,22,9,0,FW,30-34,Forward,Brazil,South America
2803,Willian,BRA,Fulham,Premier League,2022,33.0,1988.0,23.6,13,8,8,3,2,7,25,28.0,18,13,0,13,9,22,9,0,FW,30-34,Forward,Brazil,South America
2803,Willian,BRA,Fulham,Premier League,2022,33.0,1988.0,23.6,13,8,8,3,2,7,25,28.0,18,13,0,13,9,22,9,0,FW,30-34,Forward,Brazil,South America
2803,Willian,BRA,Fulham,Premier League,2022,33.0,1988.0,23.6,13,8,8,3,2,7,25,28.0,18,13,0,13,9,22,9,0,FW,30-34,Forward,Brazil,South America
2804,Joe Willock,ENG,Newcastle Utd,Premier League,2022,22.0,1999.0,28.4,51,30,13,26,12,25,58,43.1,33,54,8,46,25,76,17,0,MF,20-24,Midfielder,England,Europe
2805,Callum Wilson,ENG,Newcastle Utd,Premier League,2022,30.0,1992.0,20.9,9,3,0,8,1,0,3,0.0,3,8,0,8,1,10,5,0,FW,30-34,Forward,England,Europe
2805,Callum Wilson,ENG,Newcastle Utd,Premier League,2022,30.0,1992.0,20.9,9,3,0,8,1,0,3,0.0,3,8,0,8,1,10,5,0,FW,30-34,Forward,England,Europe
2805,Callum Wilson,ENG,Newcastle Utd,Premier League,2022,30.0,1992.0,20.9,9,3,0,8,1,0,3,0.0,3,8,0,8,1,10,5,0,FW,30-34,Forward,England,Europe
2805,Callum Wilson,ENG,Newcastle Utd,Premier League,2022,30.0,1992.0,20.9,9,3,0,8,1,0,3,0.0,3,8,0,8,1,10,5,0,FW,30-34,Forward,England,Europe
2806,Harry Wilson,WAL,Fulham,Premier League,2022,25.0,1997.0,12.2,21,13,9,9,3,8,18,44.4,10,17,2,15,6,27,14,0,FW,25-29,Forward,Wales,Europe
2807,Patrick Wimmer,AUT,Wolfsburg,Bundesliga,2022,21.0,2001.0,18.3,39,26,18,11,10,12,38,31.6,26,27,2,25,15,54,15,0,"FW,MF",20-24,Forward,Austria,Europe
2808,Jonas Wind,DEN,Wolfsburg,Bundesliga,2022,23.0,1999.0,14.3,14,6,2,7,5,5,10,50.0,5,14,4,10,1,15,10,0,FW,20-24,Forward,Denmark,Europe
2809,Harry Winks,ENG,Sampdoria,Serie A,2022,26.0,1996.0,19.1,27,12,7,18,2,14,43,32.6,29,14,8,6,24,51,24,0,MF,25-29,Midfielder,England,Europe
2810,Frederik Winther,DEN,Augsburg,Bundesliga,2022,21.0,2001.0,1.0,2,2,1,1,0,0,2,0.0,2,1,1,0,0,2,7,0,DF,20-24,Defender,Denmark,Europe
2811,Florian Wirtz,GER,Leverkusen,Bundesliga,2022,19.0,2003.0,12.1,18,10,9,7,2,8,16,50.0,8,15,1,14,1,19,6,0,"FW,MF",Under 20,Forward,Germany,Europe
2813,Yoane Wissa,COD,Brentford,Premier League,2022,25.0,1996.0,17.8,17,12,4,7,6,6,13,46.2,7,10,0,10,6,23,15,0,FW,25-29,Forward,DR Congo,Africa
2814,Axel Witsel,BEL,Atlético Madrid,La Liga,2022,33.0,1989.0,25.1,36,22,22,11,3,17,31,54.8,14,20,11,9,23,59,76,0,"DF,MF",30-34,Defender,Belgium,Europe
2815,Maximilian Wöber,AUT,Leeds United,Premier League,2022,24.0,1998.0,14.1,25,18,9,15,1,16,24,66.7,8,32,14,18,27,52,67,1,DF,20-24,Defender,Austria,Europe
2816,Hannes Wolf,AUT,Gladbach,Bundesliga,2022,23.0,1999.0,5.0,11,8,4,5,2,5,13,38.5,8,3,0,3,3,14,9,0,FW,20-24,Forward,Austria,Europe
2817,Marius Wolf,GER,Dortmund,Bundesliga,2022,27.0,1995.0,17.4,25,18,9,12,4,16,29,55.2,13,40,10,30,18,43,22,1,DF,25-29,Defender,Germany,Europe
2818,Jeong Woo-yeong,KOR,Freiburg,Bundesliga,2022,22.0,1999.0,7.3,7,3,4,2,1,2,5,40.0,3,7,1,6,1,8,7,0,"MF,FW",20-24,Midfielder,South Korea,Asia
2819,Chris Wood,NZL,Newcastle Utd,Premier League,2022,30.0,1991.0,5.0,5,4,0,3,2,3,5,60.0,2,2,2,0,1,6,7,0,FW,30-34,Forward,New Zealand,Oceania
2820,Chris Wood,NZL,Nott'ham Forest,Premier League,2022,30.0,1991.0,4.1,0,0,0,0,0,0,1,0.0,1,2,1,1,1,1,2,0,FW,30-34,Forward,New Zealand,Oceania
2821,Christopher Wooh,CMR,Rennes,Ligue 1,2022,20.0,2001.0,11.2,16,7,8,8,0,9,11,81.8,2,11,5,6,6,22,49,0,DF,20-24,Defender,Cameroon,Africa
2822,Christopher Wooh,CMR,Lens,Ligue 1,2022,20.0,2001.0,0.0,0,0,0,0,0,0,1,0.0,1,0,0,0,0,0,1,0,MF,20-24,Midfielder,Cameroon,Africa
2823,Joe Worrall,ENG,Nott'ham Forest,Premier League,2022,25.0,1997.0,24.7,53,25,39,12,2,25,35,71.4,10,33,23,10,26,79,111,1,DF,25-29,Defender,England,Europe
2824,Xeka,POR,Rennes,Ligue 1,2022,27.0,1994.0,6.1,10,3,6,3,1,7,16,43.8,9,11,2,9,6,16,8,0,MF,25-29,Midfielder,Portugal,Europe
2825,Granit Xhaka,SUI,Arsenal,Premier League,2022,29.0,1992.0,33.3,34,27,11,18,5,16,41,39.0,25,28,10,18,15,49,45,1,MF,25-29,Midfielder,Switzerland,Europe
2827,Jawad El Yamiq,MAR,Valladolid,La Liga,2022,30.0,1992.0,17.9,17,11,10,7,0,6,11,54.5,5,27,19,8,37,54,101,0,DF,30-34,Defender,Morocco,Africa
2828,Ryan Yates,ENG,Nott'ham Forest,Premier League,2022,24.0,1997.0,20.4,38,19,19,16,3,14,22,63.6,8,26,8,18,10,48,44,0,MF,20-24,Midfielder,England,Europe
2829,Yusuf Yazıcı,TUR,Lille,Ligue 1,2022,25.0,1997.0,2.2,0,0,0,0,0,0,0,,0,2,0,2,0,0,1,0,MF,25-29,Midfielder,Turkey,Asia
2830,Kelvin Yeboah,ITA,Augsburg,Bundesliga,2022,22.0,2000.0,3.9,6,4,2,4,0,2,5,40.0,3,7,0,7,1,7,2,0,"FW,MF",20-24,Forward,Italy,Europe
2832,Darlin Yongwa,CMR,Lorient,Ligue 1,2022,21.0,2000.0,8.7,13,11,7,5,1,4,15,26.7,11,13,1,12,5,18,11,0,DF,20-24,Defender,Cameroon,Africa
2833,Leny Yoro,FRA,Lille,Ligue 1,2022,16.0,2005.0,8.5,11,5,8,3,0,4,9,44.4,5,6,1,5,18,29,27,1,DF,Under 20,Defender,France,Europe
2834,Maya Yoshida,JPN,Schalke 04,Bundesliga,2022,33.0,1988.0,28.4,34,22,19,13,2,18,29,62.1,11,40,29,11,46,80,132,2,DF,30-34,Defender,Japan,Asia
2835,Ashley Young,ENG,Aston Villa,Premier League,2022,37.0,1985.0,22.6,50,27,34,15,1,37,50,74.0,13,25,11,14,21,71,65,0,DF,35-39,Defender,England,Europe
2837,Illia Zabarnyi,UKR,Bournemouth,Premier League,2022,19.0,2002.0,3.3,4,2,4,0,0,3,7,42.9,4,7,2,5,3,7,14,0,DF,Under 20,Defender,Ukraine,Europe
2838,Mattia Zaccagni,ITA,Lazio,Serie A,2022,27.0,1995.0,30.8,42,28,16,18,8,14,38,36.8,24,37,3,34,21,63,10,1,FW,25-29,Forward,Italy,Europe
2839,Dan-Axel Zagadou,FRA,Stuttgart,Bundesliga,2022,23.0,1999.0,14.1,14,9,10,4,0,5,14,35.7,9,19,16,3,21,35,81,1,DF,20-24,Defender,France,Europe
2840,Wilfried Zaha,CIV,Crystal Palace,Premier League,2022,29.0,1992.0,25.4,32,20,12,12,8,8,21,38.1,13,21,1,20,16,48,9,0,"FW,MF",25-29,Forward,Ivory Coast,Africa
2841,Warren Zaïre-Emery,FRA,Paris S-G,Ligue 1,2022,16.0,2006.0,10.3,17,10,5,10,2,8,29,27.6,21,11,0,11,12,29,17,0,"MF,DF",Under 20,Midfielder,France,Europe
2842,Denis Zakaria,SUI,Chelsea,Premier League,2022,25.0,1996.0,4.6,9,5,5,2,2,2,8,25.0,6,4,1,3,3,12,10,0,MF,25-29,Midfielder,Switzerland,Europe
2843,Denis Zakaria,SUI,Juventus,Serie A,2022,25.0,1996.0,1.4,6,3,1,4,1,2,2,100.0,0,2,0,2,2,8,1,0,MF,25-29,Midfielder,Switzerland,Europe
2844,Rodrigo Zalazar,URU,Schalke 04,Bundesliga,2022,22.0,1999.0,14.7,16,8,5,9,2,9,24,37.5,15,16,1,15,7,23,13,0,"MF,FW",20-24,Midfielder,Uruguay,South America
2847,Andre-Frank Zambo Anguissa,CMR,Napoli,Serie A,2022,26.0,1995.0,33.9,53,32,16,29,8,16,64,25.0,48,50,4,46,49,102,25,0,MF,25-29,Midfielder,Cameroon,Africa
2848,Oliver Zandén,SWE,Toulouse,Ligue 1,2022,20.0,2001.0,1.6,2,1,1,0,1,2,5,40.0,3,0,0,0,1,3,7,0,"DF,MF",20-24,Defender,Sweden,Europe
2849,Luca Zanimacchia,ITA,Cremonese,Serie A,2022,24.0,1998.0,8.3,21,13,11,6,4,8,21,38.1,13,9,0,9,9,30,5,0,"MF,FW",20-24,Midfielder,Italy,Europe
2850,Nicolò Zaniolo,ITA,Roma,Serie A,2022,23.0,1999.0,9.9,7,5,2,4,1,2,7,28.6,5,11,0,11,2,9,0,0,"MF,FW",20-24,Midfielder,Italy,Europe
2851,Alessandro Zanoli,ITA,Sampdoria,Serie A,2022,21.0,2000.0,17.1,22,14,14,6,2,8,17,47.1,9,19,15,4,12,34,39,0,DF,20-24,Defender,Italy,Europe
2852,Alessandro Zanoli,ITA,Napoli,Serie A,2022,21.0,2000.0,0.1,1,0,0,1,0,0,0,,0,0,0,0,0,1,1,0,DF,20-24,Defender,Italy,Europe
2853,Mattia Zanotti,ITA,Inter,Serie A,2022,19.0,2003.0,0.3,0,0,0,0,0,0,1,0.0,1,2,0,2,0,0,0,0,DF,Under 20,Defender,Italy,Europe
2854,Duván Zapata,COL,Atalanta,Serie A,2022,31.0,1991.0,15.4,8,4,1,3,4,3,5,60.0,2,6,2,4,4,12,17,1,FW,30-34,Forward,Colombia,South America
2855,Davide Zappacosta,ITA,Atalanta,Serie A,2022,30.0,1992.0,16.3,34,18,17,12,5,15,22,68.2,7,23,2,21,9,43,16,0,DF,30-34,Defender,Italy,Europe
2857,Akim Zedadka,ALG,Auxerre,Ligue 1,2022,27.0,1995.0,17.8,35,21,21,10,4,18,32,56.3,14,17,3,14,23,58,51,1,DF,25-29,Defender,Algeria,Africa
2858,Akim Zedadka,ALG,Lille,Ligue 1,2022,27.0,1995.0,3.9,1,1,1,0,0,0,2,0.0,2,3,0,3,2,3,6,0,"DF,MF",25-29,Defender,Algeria,Africa
2859,Karim Zedadka,FRA,Napoli,Serie A,2022,22.0,2000.0,0.2,0,0,0,0,0,0,0,,0,0,0,0,0,0,1,0,FW,20-24,Forward,France,Europe
2860,Deyovaisio Zeefuik,NED,Hellas Verona,Serie A,2022,24.0,1998.0,0.1,1,1,0,1,0,0,0,,0,0,0,0,0,1,0,0,DF,20-24,Defender,Netherlands,Europe
2861,Marvin Zeegelaar,NED,Udinese,Serie A,2022,31.0,1990.0,3.9,8,4,6,2,0,3,4,75.0,1,2,0,2,3,11,5,0,DF,30-34,Defender,Netherlands,Europe
2862,Mehdi Zeffane,ALG,Clermont Foot,Ligue 1,2022,30.0,1992.0,7.3,12,7,5,7,0,4,21,19.0,17,14,6,8,22,34,12,0,"DF,MF",30-34,Defender,Algeria,Africa
2863,Aaron Zehnter,GER,Augsburg,Bundesliga,2022,17.0,2004.0,0.0,0,0,0,0,0,0,1,0.0,1,0,0,0,1,1,0,0,DF,Under 20,Defender,Germany,Europe
2864,Jordan Zemura,ZIM,Bournemouth,Premier League,2022,22.0,1999.0,16.2,39,24,24,14,1,23,44,52.3,21,31,9,22,16,55,32,0,DF,20-24,Defender,Zimbabwe,Africa
2866,Robin Zentner,GER,Mainz 05,Bundesliga,2022,27.0,1994.0,26.0,0,0,0,0,0,0,4,0.0,4,0,0,0,0,0,17,1,GK,25-29,Goalkeeper,Germany,Europe
2867,Alessio Zerbin,ITA,Napoli,Serie A,2022,23.0,1999.0,2.2,10,5,4,5,1,4,8,50.0,4,2,0,2,2,12,2,0,FW,20-24,Forward,Italy,Europe
2868,Michael Zetterer,GER,Werder Bremen,Bundesliga,2022,27.0,1995.0,1.7,0,0,0,0,0,0,0,,0,0,0,0,0,0,1,0,GK,25-29,Goalkeeper,Germany,Europe
2869,Nathan Zeze,FRA,Nantes,Ligue 1,2022,17.0,2005.0,0.7,3,2,2,1,0,1,1,100.0,0,0,0,0,0,3,1,0,DF,Under 20,Defender,France,Europe
2873,Oleksandr Zinchenko,UKR,Arsenal,Premier League,2022,25.0,1996.0,23.5,40,18,14,17,9,21,40,52.5,19,20,2,18,22,62,38,2,DF,25-29,Defender,Ukraine,Europe
2874,Joshua Zirkzee,NED,Bologna,Serie A,2022,21.0,2001.0,9.1,4,2,1,1,2,2,7,28.6,5,4,1,3,4,8,4,0,FW,20-24,Forward,Netherlands,Europe
2875,Hakim Ziyech,MAR,Chelsea,Premier League,2022,29.0,1993.0,7.3,20,12,12,5,3,4,9,44.4,5,8,0,8,5,25,5,1,"FW,MF",25-29,Forward,Morocco,Africa
2876,Jeroen Zoet,NED,Spezia,Serie A,2022,31.0,1991.0,3.7,1,1,1,0,0,1,1,100.0,0,0,0,0,0,1,1,0,GK,30-34,Goalkeeper,Netherlands,Europe
2877,Simon Zoller,GER,Bochum,Bundesliga,2022,31.0,1991.0,16.2,11,4,2,8,1,4,12,33.3,8,14,1,13,6,17,21,0,FW,30-34,Forward,Germany,Europe
2878,Nadir Zortea,ITA,Atalanta,Serie A,2022,23.0,1999.0,2.5,10,5,3,7,0,3,4,75.0,1,4,0,4,0,10,4,0,"DF,MF",20-24,Defender,Italy,Europe
2879,Nadir Zortea,ITA,Sassuolo,Serie A,2022,23.0,1999.0,7.3,15,8,12,2,1,9,14,64.3,5,10,4,6,4,19,21,0,DF,20-24,Defender,Italy,Europe
2880,Tanguy Zoukrou,FRA,Troyes,Ligue 1,2022,19.0,2003.0,5.7,14,7,8,6,0,10,14,71.4,4,18,11,7,2,16,24,0,DF,Under 20,Defender,France,Europe
2881,Kurt Zouma,FRA,West Ham,Premier League,2022,27.0,1994.0,22.1,9,4,4,5,0,5,8,62.5,3,17,14,3,30,39,120,1,DF,25-29,Defender,France,Europe
2882,Petar Zovko,BIH,Spezia,Serie A,2022,20.0,2002.0,0.8,1,0,1,0,0,1,1,100.0,0,0,0,0,0,1,0,0,GK,20-24,Goalkeeper,Bosnia and Herzegovina,Europe
2888,Milan Đurić,BIH,Hellas Verona,Serie A,2022,32.0,1990.0,15.2,2,1,1,0,1,1,3,33.3,2,7,4,3,1,3,24,0,FW,30-34,Forward,Bosnia and Herzegovina,Europe
2050,Patric,ESP,Lazio,Serie A,2022,29.0,1993.0,15.7,17,11,12,3,2,11,16,68.8,5,17,12,5,11,28,53,1,DF,25-29,Defender,Spain,Europe
2056,Jiří Pavlenka,CZE,Werder Bremen,Bundesliga,2022,30.0,1992.0,32.3,1,0,1,0,0,1,5,20.0,4,1,0,1,3,4,21,1,GK,30-34,Goalkeeper,Czech Republic,Europe
2061,Alfonso Pedraza,ESP,Villarreal,La Liga,2022,26.0,1996.0,18.1,35,26,20,10,5,19,29,65.5,10,19,1,18,18,53,31,0,DF,25-29,Defender,Spain,Europe
2062,Pedri,ESP,Barcelona,La Liga,2022,19.0,2002.0,22.0,39,22,15,17,7,13,45,28.9,32,27,0,27,13,52,8,1,MF,Under 20,Midfielder,Spain,Europe
2063,Pedro,ESP,Lazio,Serie A,2022,35.0,1987.0,21.1,35,24,14,10,11,11,30,36.7,19,18,2,16,6,41,4,1,FW,35-39,Forward,Spain,Europe
2063,Pedro,ESP,Lazio,Serie A,2022,35.0,1987.0,21.1,35,24,14,10,11,11,30,36.7,19,18,2,16,6,41,4,1,FW,35-39,Forward,Spain,Europe
2063,Pedro,ESP,Lazio,Serie A,2022,35.0,1987.0,21.1,35,24,14,10,11,11,30,36.7,19,18,2,16,6,41,4,1,FW,35-39,Forward,Spain,Europe
2063,Pedro,ESP,Lazio,Serie A,2022,35.0,1987.0,21.1,35,24,14,10,11,11,30,36.7,19,18,2,16,6,41,4,1,FW,35-39,Forward,Spain,Europe
2063,Pedro,ESP,Lazio,Serie A,2022,35.0,1987.0,21.1,35,24,14,10,11,11,30,36.7,19,18,2,16,6,41,4,1,FW,35-39,Forward,Spain,Europe
2063,Pedro,ESP,Lazio,Serie A,2022,35.0,1987.0,21.1,35,24,14,10,11,11,30,36.7,19,18,2,16,6,41,4,1,FW,35-39,Forward,Spain,Europe
2063,Pedro,ESP,Lazio,Serie A,2022,35.0,1987.0,21.1,35,24,14,10,11,11,30,36.7,19,18,2,16,6,41,4,1,FW,35-39,Forward,Spain,Europe
2063,Pedro,ESP,Lazio,Serie A,2022,35.0,1987.0,21.1,35,24,14,10,11,11,30,36.7,19,18,2,16,6,41,4,1,FW,35-39,Forward,Spain,Europe
2063,Pedro,ESP,Lazio,Serie A,2022,35.0,1987.0,21.1,35,24,14,10,11,11,30,36.7,19,18,2,16,6,41,4,1,FW,35-39,Forward,Spain,Europe
2063,Pedro,ESP,Lazio,Serie A,2022,35.0,1987.0,21.1,35,24,14,10,11,11,30,36.7,19,18,2,16,6,41,4,1,FW,35-39,Forward,Spain,Europe
2063,Pedro,ESP,Lazio,Serie A,2022,35.0,1987.0,21.1,35,24,14,10,11,11,30,36.7,19,18,2,16,6,41,4,1,FW,35-39,Forward,Spain,Europe
2063,Pedro,ESP,Lazio,Serie A,2022,35.0,1987.0,21.1,35,24,14,10,11,11,30,36.7,19,18,2,16,6,41,4,1,FW,35-39,Forward,Spain,Europe
2063,Pedro,ESP,Lazio,Serie A,2022,35.0,1987.0,21.1,35,24,14,10,11,11,30,36.7,19,18,2,16,6,41,4,1,FW,35-39,Forward,Spain,Europe
2063,Pedro,ESP,Lazio,Serie A,2022,35.0,1987.0,21.1,35,24,14,10,11,11,30,36.7,19,18,2,16,6,41,4,1,FW,35-39,Forward,Spain,Europe
2063,Pedro,ESP,Lazio,Serie A,2022,35.0,1987.0,21.1,35,24,14,10,11,11,30,36.7,19,18,2,16,6,41,4,1,FW,35-39,Forward,Spain,Europe
2063,Pedro,ESP,Lazio,Serie A,2022,35.0,1987.0,21.1,35,24,14,10,11,11,30,36.7,19,18,2,16,6,41,4,1,FW,35-39,Forward,Spain,Europe
2064,Adrià Pedrosa,ESP,Espanyol,La Liga,2022,24.0,1998.0,2.5,5,1,5,0,0,4,7,57.1,3,1,1,0,5,10,3,0,"DF,MF",20-24,Defender,Spain,Europe
2076,Iñaki Peña,ESP,Barcelona,La Liga,2022,23.0,1999.0,0.8,0,0,0,0,0,0,0,,0,0,0,0,0,0,0,1,GK,20-24,Goalkeeper,Spain,Europe
2077,Rubén Peña,ESP,Osasuna,La Liga,2022,31.0,1991.0,14.2,32,18,10,18,4,20,41,48.8,21,23,8,15,17,49,31,0,"DF,MF",30-34,Defender,Spain,Europe
2082,Alberto Perea,ESP,Cádiz,La Liga,2022,31.0,1990.0,0.5,2,0,2,0,0,0,0,,0,2,0,2,0,2,0,0,MF,30-34,Midfielder,Spain,Europe
2090,Ayoze Pérez,ESP,Leicester City,Premier League,2022,29.0,1993.0,4.2,11,8,5,4,2,8,19,42.1,11,6,0,6,2,13,3,0,"MF,FW",25-29,Midfielder,Spain,Europe
2091,Ayoze Pérez,ESP,Betis,La Liga,2022,29.0,1993.0,15.4,31,15,9,16,6,10,40,25.0,30,22,0,22,13,44,5,0,"FW,MF",25-29,Forward,Spain,Europe
2092,Carles Pérez,ESP,Celta Vigo,La Liga,2022,24.0,1998.0,23.8,39,23,12,17,10,22,66,33.3,44,29,3,26,6,45,9,0,"MF,FW",20-24,Midfielder,Spain,Europe
2093,Francisco Perez,ESP,Valencia,La Liga,2022,19.0,2002.0,1.6,1,1,1,0,0,0,3,0.0,3,0,0,0,0,1,1,0,"FW,MF",Under 20,Forward,Spain,Europe
2094,Kike Pérez,ESP,Valladolid,La Liga,2022,25.0,1997.0,25.6,67,33,30,32,5,25,68,36.8,43,26,7,19,20,87,28,0,MF,25-29,Midfielder,Spain,Europe
2095,Lucas Pérez,ESP,Cádiz,La Liga,2022,33.0,1988.0,7.0,3,2,2,1,0,1,3,33.3,2,2,0,2,1,4,3,0,FW,30-34,Forward,Spain,Europe
2096,Luis Pérez,ESP,Valladolid,La Liga,2022,27.0,1995.0,13.5,44,24,26,12,6,27,38,71.1,11,13,4,9,16,60,29,0,DF,25-29,Defender,Spain,Europe
2118,Krzysztof Piątek,POL,Salernitana,Serie A,2022,27.0,1995.0,23.8,18,11,3,9,6,5,21,23.8,16,17,4,13,2,20,39,0,FW,25-29,Forward,Poland,Europe
2128,Yeremi Pino,ESP,Villarreal,La Liga,2022,19.0,2002.0,27.2,62,38,25,20,17,21,56,37.5,35,41,4,37,15,77,36,0,"FW,MF",Under 20,Forward,Spain,Europe
2129,Gerard Piqué,ESP,Barcelona,La Liga,2022,35.0,1987.0,4.3,5,4,1,4,0,4,4,100.0,0,2,1,1,2,7,19,0,DF,35-39,Defender,Spain,Europe
2133,Óscar Plano,ESP,Valladolid,La Liga,2022,31.0,1991.0,22.6,40,25,9,17,14,12,37,32.4,25,26,2,24,29,69,23,0,"FW,MF",30-34,Forward,Spain,Europe
2147,Łukasz Poręba,POL,Lens,Ligue 1,2022,22.0,2000.0,2.9,5,4,2,1,2,2,3,66.7,1,3,0,3,4,9,2,0,MF,20-24,Midfielder,Poland,Europe
2149,Pedro Porro,ESP,Tottenham,Premier League,2022,22.0,1999.0,12.6,25,16,8,15,2,14,39,35.9,25,25,2,23,15,40,24,1,"DF,MF",20-24,Defender,Spain,Europe
2150,Francisco Portillo,ESP,Almería,La Liga,2022,32.0,1990.0,8.0,13,6,4,5,4,3,16,18.8,13,7,1,6,7,20,8,0,"MF,FW",30-34,Midfielder,Spain,Europe
2151,Portu,ESP,Getafe,La Liga,2022,30.0,1992.0,19.7,28,21,14,10,4,18,42,42.9,24,23,3,20,17,45,20,1,"MF,DF",30-34,Midfielder,Spain,Europe
2155,José Pozo,ESP,Rayo Vallecano,La Liga,2022,26.0,1996.0,1.0,2,2,0,2,0,0,0,,0,0,0,0,1,3,1,0,"MF,FW",25-29,Midfielder,Spain,Europe
2156,Manuel Pozo,ESP,Valladolid,La Liga,2022,20.0,2001.0,0.2,0,0,0,0,0,0,0,,0,2,0,2,2,2,0,0,FW,20-24,Forward,Spain,Europe
2157,Alejandro Pozo Pozo,ESP,Almería,La Liga,2022,23.0,1999.0,20.9,37,19,17,17,3,27,53,50.9,26,30,5,25,26,63,45,1,DF,20-24,Defender,Spain,Europe
2159,Abdón Prats,ESP,Mallorca,La Liga,2022,29.0,1992.0,4.6,1,0,1,0,0,0,0,,0,5,0,5,0,1,2,0,"FW,MF",25-29,Forward,Spain,Europe
2161,Isaac Price,NIR,Everton,Premier League,2022,18.0,2003.0,0.4,0,0,0,0,0,0,1,0.0,1,1,1,0,0,0,0,0,MF,Under 20,Midfielder,Northern Ireland,Europe
2164,Javi Puado,ESP,Espanyol,La Liga,2022,24.0,1998.0,26.0,20,11,12,5,3,12,28,42.9,16,12,2,10,10,30,14,0,"FW,MF",20-24,Forward,Spain,Europe
2166,Tymoteusz Puchacz,POL,Union Berlin,Bundesliga,2022,23.0,1999.0,0.6,1,0,1,0,0,0,0,,0,0,0,0,0,1,1,0,DF,20-24,Defender,Poland,Europe
2167,Arnau Puigmal,ESP,Almería,La Liga,2022,21.0,2001.0,8.5,22,14,10,7,5,12,17,70.6,5,7,0,7,11,33,6,0,"MF,FW",20-24,Midfielder,Spain,Europe
2177,Rubén Quintanilla,ESP,Mallorca,La Liga,2022,20.0,2002.0,0.0,0,0,0,0,0,0,0,,0,1,0,1,0,0,0,0,DF,20-24,Defender,Spain,Europe
2179,Nemanja Radonjić,SRB,Torino,Serie A,2022,26.0,1996.0,16.2,2,1,2,0,0,0,4,0.0,4,3,0,3,2,4,4,0,"MF,FW",25-29,Midfielder,Serbia,Europe
2180,Ivan Radovanović,SRB,Salernitana,Serie A,2022,33.0,1988.0,7.5,12,4,8,4,0,4,10,40.0,6,9,3,6,7,19,9,1,"MF,DF",30-34,Midfielder,Serbia,Europe
2184,Antonio Raillo,ESP,Mallorca,La Liga,2022,30.0,1991.0,30.7,34,21,23,11,0,10,15,66.7,5,38,29,9,31,65,158,1,DF,30-34,Defender,Spain,Europe
2186,Predrag Rajković,SRB,Mallorca,La Liga,2022,26.0,1995.0,36.0,0,0,0,0,0,0,2,0.0,2,0,0,0,0,0,16,1,GK,25-29,Goalkeeper,Serbia,Europe
2192,Chris Ramos,ESP,Cádiz,La Liga,2022,25.0,1997.0,7.9,12,9,2,7,3,4,11,36.4,7,8,3,5,1,13,19,0,FW,25-29,Forward,Spain,Europe
2193,Sergio Ramos,ESP,Paris S-G,Ligue 1,2022,36.0,1986.0,30.0,34,26,14,18,2,23,44,52.3,21,29,13,16,34,68,93,3,DF,35-39,Defender,Spain,Europe
2211,David Raya,ESP,Brentford,Premier League,2022,26.0,1995.0,38.0,0,0,0,0,0,0,2,0.0,2,1,0,1,1,1,10,3,GK,25-29,Goalkeeper,Spain,Europe
2214,Arkadiusz Reca,POL,Spezia,Serie A,2022,27.0,1995.0,24.1,44,28,22,12,10,19,32,59.4,13,21,5,16,24,68,54,0,DF,25-29,Defender,Poland,Europe
2217,Sergio Reguilón,ESP,Atlético Madrid,La Liga,2022,25.0,1996.0,3.4,7,5,5,2,0,5,7,71.4,2,3,0,3,2,9,4,0,DF,25-29,Defender,Spain,Europe
2219,Pepe Reina,ESP,Villarreal,La Liga,2022,39.0,1982.0,22.0,0,0,0,0,0,0,1,0.0,1,0,0,0,1,1,4,4,GK,35-39,Goalkeeper,Spain,Europe
2225,Álex Remiro,ESP,Real Sociedad,La Liga,2022,27.0,1995.0,38.0,1,1,1,0,0,1,3,33.3,2,0,0,0,0,1,17,3,GK,25-29,Goalkeeper,Spain,Europe
2228,Alejandro Revuelta Montero,ESP,Getafe,La Liga,2022,22.0,2000.0,0.0,0,0,0,0,0,0,0,,0,0,0,0,0,0,1,0,DF,20-24,Defender,Spain,Europe
2232,Nico Ribaudo,ESP,Espanyol,La Liga,2022,21.0,2001.0,13.9,18,13,5,9,4,11,30,36.7,19,19,1,18,5,23,1,0,"MF,FW",20-24,Midfielder,Spain,Europe
2240,Diego Rico,ESP,Real Sociedad,La Liga,2022,29.0,1993.0,18.3,35,21,17,11,7,12,27,44.4,15,18,5,13,20,55,51,1,DF,25-29,Defender,Spain,Europe
2246,Rodrigo Riquelme,ESP,Girona,La Liga,2022,22.0,2000.0,24.2,20,8,8,8,4,9,35,25.7,26,16,0,16,11,31,5,0,"MF,FW",20-24,Midfielder,Spain,Europe
2248,Sergi Roberto,ESP,Barcelona,La Liga,2022,30.0,1992.0,14.5,22,15,12,6,4,7,18,38.9,11,15,7,8,11,33,16,0,"DF,MF",30-34,Defender,Spain,Europe
2252,Joel Robles,ESP,Leeds United,Premier League,2022,32.0,1990.0,4.0,0,0,0,0,0,0,1,0.0,1,0,0,0,0,0,2,1,GK,30-34,Goalkeeper,Spain,Europe
2253,Joel Roca,ESP,Girona,La Liga,2022,17.0,2005.0,0.9,2,2,2,0,0,2,5,40.0,3,1,1,0,0,2,1,0,"MF,FW",Under 20,Midfielder,Spain,Europe
2254,Marc Roca,ESP,Leeds United,Premier League,2022,25.0,1996.0,25.7,66,40,27,34,5,20,65,30.8,45,34,10,24,23,89,24,2,MF,25-29,Midfielder,Spain,Europe
2259,Rodri,ESP,Manchester City,Premier League,2022,26.0,1996.0,32.3,67,41,28,28,11,26,53,49.1,27,40,14,26,33,100,43,1,MF,25-29,Midfielder,Spain,Europe
2259,Rodri,ESP,Manchester City,Premier League,2022,26.0,1996.0,32.3,67,41,28,28,11,26,53,49.1,27,40,14,26,33,100,43,1,MF,25-29,Midfielder,Spain,Europe
2259,Rodri,ESP,Manchester City,Premier League,2022,26.0,1996.0,32.3,67,41,28,28,11,26,53,49.1,27,40,14,26,33,100,43,1,MF,25-29,Midfielder,Spain,Europe
2259,Rodri,ESP,Manchester City,Premier League,2022,26.0,1996.0,32.3,67,41,28,28,11,26,53,49.1,27,40,14,26,33,100,43,1,MF,25-29,Midfielder,Spain,Europe
2260,Rodri,ESP,Betis,La Liga,2022,22.0,2000.0,17.8,16,11,5,9,2,8,17,47.1,9,10,0,10,13,29,2,0,"FW,MF",20-24,Forward,Spain,Europe
2260,Rodri,ESP,Betis,La Liga,2022,22.0,2000.0,17.8,16,11,5,9,2,8,17,47.1,9,10,0,10,13,29,2,0,"FW,MF",20-24,Forward,Spain,Europe
2260,Rodri,ESP,Betis,La Liga,2022,22.0,2000.0,17.8,16,11,5,9,2,8,17,47.1,9,10,0,10,13,29,2,0,"FW,MF",20-24,Forward,Spain,Europe
2260,Rodri,ESP,Betis,La Liga,2022,22.0,2000.0,17.8,16,11,5,9,2,8,17,47.1,9,10,0,10,13,29,2,0,"FW,MF",20-24,Forward,Spain,Europe
2261,Rodrigo,ESP,Leeds United,Premier League,2022,31.0,1991.0,21.5,24,10,2,15,7,8,19,42.1,11,16,4,12,6,30,21,1,"FW,MF",30-34,Forward,Spain,Europe
2263,Ángel Rodríguez,ESP,Mallorca,La Liga,2022,35.0,1987.0,4.4,1,1,0,1,0,0,2,0.0,2,3,0,3,1,2,1,0,"FW,MF",35-39,Forward,Spain,Europe
2264,Óscar Rodríguez Arnaiz,ESP,Celta Vigo,La Liga,2022,24.0,1998.0,19.7,32,25,12,15,5,13,28,46.4,15,16,2,14,24,56,15,0,MF,20-24,Midfielder,Spain,Europe
2265,Dani Rodríguez,ESP,Mallorca,La Liga,2022,34.0,1988.0,23.3,42,23,18,22,2,21,46,45.7,25,31,8,23,21,63,14,0,MF,30-34,Midfielder,Spain,Europe
2265,Dani Rodríguez,ESP,Mallorca,La Liga,2022,34.0,1988.0,23.3,42,23,18,22,2,21,46,45.7,25,31,8,23,21,63,14,0,MF,30-34,Midfielder,Spain,Europe
2265,Dani Rodríguez,ESP,Mallorca,La Liga,2022,34.0,1988.0,23.3,42,23,18,22,2,21,46,45.7,25,31,8,23,21,63,14,0,MF,30-34,Midfielder,Spain,Europe
2265,Dani Rodríguez,ESP,Mallorca,La Liga,2022,34.0,1988.0,23.3,42,23,18,22,2,21,46,45.7,25,31,8,23,21,63,14,0,MF,30-34,Midfielder,Spain,Europe
2267,Miguel Rodríguez,ESP,Celta Vigo,La Liga,2022,19.0,2003.0,2.8,7,5,4,3,0,4,11,36.4,7,6,0,6,1,8,3,0,"MF,FW",Under 20,Midfielder,Spain,Europe
2268,Pablo Rodríguez,ESP,Lecce,Serie A,2022,20.0,2001.0,0.6,2,1,2,0,0,0,2,0.0,2,3,0,3,0,2,0,0,"FW,MF",20-24,Forward,Spain,Europe
2279,Leo Román,ESP,Mallorca,La Liga,2022,22.0,2000.0,1.0,0,0,0,0,0,0,0,,0,0,0,0,0,0,0,0,GK,20-24,Goalkeeper,Spain,Europe
2281,Iván Romero,ESP,Sevilla,La Liga,2022,21.0,2001.0,0.1,0,0,0,0,0,0,0,,0,0,0,0,0,0,0,0,MF,20-24,Midfielder,Spain,Europe
2283,Oriol Romeu,ESP,Southampton,Premier League,2022,30.0,1991.0,0.8,1,0,0,1,0,0,0,,0,1,0,1,1,2,1,0,MF,30-34,Midfielder,Spain,Europe
2284,Oriol Romeu,ESP,Girona,La Liga,2022,30.0,1991.0,32.8,70,38,36,26,8,26,51,51.0,25,48,10,38,37,107,54,0,MF,30-34,Midfielder,Spain,Europe
2301,Rubén,ESP,Espanyol,La Liga,2022,21.0,2001.0,9.9,30,15,18,9,3,20,29,69.0,9,14,4,10,18,48,18,0,"DF,MF",20-24,Defender,Spain,Europe
2307,Aitor Ruibal,ESP,Betis,La Liga,2022,26.0,1996.0,16.2,47,29,35,9,3,31,58,53.4,27,17,2,15,24,71,41,0,"DF,FW",25-29,Defender,Spain,Europe
2309,Fabián Ruiz Peña,ESP,Paris S-G,Ligue 1,2022,26.0,1996.0,21.0,62,28,25,30,7,43,79,54.4,36,24,1,23,18,80,23,1,MF,25-29,Midfielder,Spain,Europe
2310,Víctor Ruiz,ESP,Betis,La Liga,2022,33.0,1989.0,6.2,5,3,3,2,0,3,3,100.0,0,10,7,3,6,11,34,0,DF,30-34,Defender,Spain,Europe
2316,Julian Ryerson,NOR,Union Berlin,Bundesliga,2022,24.0,1997.0,11.5,28,17,17,10,1,15,25,60.0,10,15,3,12,12,40,19,0,DF,20-24,Defender,Norway,Europe
2317,Julian Ryerson,NOR,Dortmund,Bundesliga,2022,24.0,1997.0,15.7,27,15,17,7,3,19,37,51.4,18,13,2,11,8,35,28,0,DF,20-24,Defender,Norway,Europe
2332,Samuel Sáiz,ESP,Girona,La Liga,2022,31.0,1991.0,2.7,2,2,0,2,0,1,2,50.0,1,3,0,3,0,2,1,1,MF,30-34,Midfielder,Spain,Europe
2340,Kike Salas,ESP,Sevilla,La Liga,2022,20.0,2002.0,4.1,1,1,1,0,0,0,0,,0,4,3,1,5,6,23,0,DF,20-24,Defender,Spain,Europe
2342,Dikeni-Rafid Salifou,TOG,Werder Bremen,Bundesliga,2022,19.0,2003.0,0.0,0,0,0,0,0,0,0,,0,0,0,0,0,0,0,0,MF,Under 20,Midfielder,Togo,Africa
2346,Salvi,ESP,Rayo Vallecano,La Liga,2022,31.0,1991.0,5.4,13,8,5,5,3,2,8,25.0,6,0,0,0,2,15,2,0,"FW,MF",30-34,Forward,Spain,Europe
2347,Lazar Samardzic,SRB,Udinese,Serie A,2022,20.0,2002.0,20.5,33,16,9,20,4,17,43,39.5,26,13,0,13,11,44,16,0,MF,20-24,Midfielder,Serbia,Europe
2354,Fede San Emeterio,ESP,Cádiz,La Liga,2022,25.0,1997.0,20.5,41,22,23,16,2,22,46,47.8,24,34,14,20,17,58,28,0,MF,25-29,Midfielder,Spain,Europe
2357,Oihan Sancet,ESP,Athletic Club,La Liga,2022,22.0,2000.0,28.1,27,16,2,19,6,11,37,29.7,26,10,0,10,4,31,9,1,MF,20-24,Midfielder,Spain,Europe
2360,Antonio Sánchez,ESP,Mallorca,La Liga,2022,25.0,1997.0,12.0,19,8,13,4,2,10,34,29.4,24,18,0,18,22,41,14,1,"MF,DF",25-29,Midfielder,Spain,Europe
2362,Iván Sánchez,ESP,Valladolid,La Liga,2022,29.0,1992.0,12.8,20,14,8,8,4,10,27,37.0,17,14,1,13,8,28,4,0,"MF,FW",25-29,Midfielder,Spain,Europe
2363,Javi Sánchez,ESP,Valladolid,La Liga,2022,25.0,1997.0,26.6,43,26,27,15,1,17,26,65.4,9,32,22,10,46,89,116,0,DF,25-29,Defender,Spain,Europe
2364,Manu Sánchez,ESP,Osasuna,La Liga,2022,21.0,2000.0,23.6,51,35,35,9,7,33,63,52.4,30,33,5,28,14,65,51,0,DF,20-24,Defender,Spain,Europe
2365,Robert Sánchez,ESP,Brighton,Premier League,2022,24.0,1997.0,23.0,1,0,1,0,0,0,0,,0,0,0,0,3,4,9,2,GK,20-24,Goalkeeper,Spain,Europe
2375,Pablo Sarabia,ESP,Wolves,Premier League,2022,30.0,1992.0,8.5,12,6,4,5,3,6,15,40.0,9,7,0,7,2,14,4,0,"FW,MF",30-34,Forward,Spain,Europe
2376,Pablo Sarabia,ESP,Paris S-G,Ligue 1,2022,30.0,1992.0,4.1,5,4,2,2,1,1,7,14.3,6,3,0,3,2,7,0,0,"FW,MF",30-34,Forward,Spain,Europe
2396,Patrik Schick,CZE,Leverkusen,Bundesliga,2022,26.0,1996.0,10.5,0,0,0,0,0,0,1,0.0,1,4,1,3,1,1,7,0,FW,25-29,Forward,Czech Republic,Europe
2425,Marvin Senaya,TOG,Strasbourg,Ligue 1,2022,21.0,2001.0,0.1,0,0,0,0,0,0,1,0.0,1,1,0,1,0,0,1,0,DF,20-24,Defender,Togo,Africa
2428,Jaime Seoane,ESP,Getafe,La Liga,2022,25.0,1997.0,3.6,10,4,3,4,3,2,8,25.0,6,7,3,4,1,11,2,0,"MF,FW",25-29,Midfielder,Spain,Europe
2446,David Silva,ESP,Real Sociedad,La Liga,2022,36.0,1986.0,21.5,36,21,11,18,7,11,19,57.9,8,17,2,15,15,51,16,0,MF,35-39,Midfielder,Spain,Europe
2446,David Silva,ESP,Real Sociedad,La Liga,2022,36.0,1986.0,21.5,36,21,11,18,7,11,19,57.9,8,17,2,15,15,51,16,0,MF,35-39,Midfielder,Spain,Europe
2446,David Silva,ESP,Real Sociedad,La Liga,2022,36.0,1986.0,21.5,36,21,11,18,7,11,19,57.9,8,17,2,15,15,51,16,0,MF,35-39,Midfielder,Spain,Europe
2446,David Silva,ESP,Real Sociedad,La Liga,2022,36.0,1986.0,21.5,36,21,11,18,7,11,19,57.9,8,17,2,15,15,51,16,0,MF,35-39,Midfielder,Spain,Europe
2454,Simo,ESP,Espanyol,La Liga,2022,17.0,2005.0,1.6,3,1,3,0,0,2,3,66.7,1,5,4,1,0,3,3,0,DF,Under 20,Defender,Spain,Europe
2456,Unai Simón,ESP,Athletic Club,La Liga,2022,25.0,1997.0,30.5,2,0,2,0,0,1,1,100.0,0,1,0,1,0,2,9,3,GK,25-29,Goalkeeper,Spain,Europe
2470,Leo Skiri Østigård,NOR,Napoli,Serie A,2022,22.0,1999.0,4.7,4,1,3,1,0,1,1,100.0,0,3,3,0,6,10,18,1,DF,20-24,Defender,Norway,Europe
2471,Łukasz Skorupski,POL,Bologna,Serie A,2022,31.0,1991.0,37.0,2,1,2,0,0,1,2,50.0,1,0,0,0,0,2,19,2,GK,30-34,Goalkeeper,Poland,Europe
2484,Rubén Sobrino,ESP,Cádiz,La Liga,2022,30.0,1992.0,27.4,55,37,29,17,9,23,56,41.1,33,33,3,30,24,79,20,1,"MF,FW",30-34,Midfielder,Spain,Europe
2485,Alex Sola,ESP,Real Sociedad,La Liga,2022,23.0,1999.0,3.9,18,9,14,3,1,7,10,70.0,3,7,2,5,7,25,10,0,DF,20-24,Defender,Spain,Europe
2488,Ola Solbakken,NOR,Roma,Serie A,2022,23.0,1998.0,5.6,2,2,1,1,0,2,7,28.6,5,2,0,2,2,4,8,0,"MF,FW",20-24,Midfielder,Norway,Europe
2490,Carlos Soler,ESP,Valencia,La Liga,2022,25.0,1997.0,2.7,2,0,0,1,1,2,3,66.7,1,1,0,1,0,2,2,0,MF,25-29,Midfielder,Spain,Europe
2491,Carlos Soler,ESP,Paris S-G,Ligue 1,2022,25.0,1997.0,13.2,20,12,6,10,4,10,19,52.6,9,12,4,8,4,24,6,0,MF,25-29,Midfielder,Spain,Europe
2498,David Soria,ESP,Getafe,La Liga,2022,29.0,1993.0,38.0,0,0,0,0,0,0,1,0.0,1,0,0,0,1,1,20,4,GK,25-29,Goalkeeper,Spain,Europe
2502,Hugo Sotelo,ESP,Celta Vigo,La Liga,2022,18.0,2003.0,0.2,0,0,0,0,0,0,0,,0,0,0,0,0,0,0,0,MF,Under 20,Midfielder,Spain,Europe
2505,Tomáš Souček,CZE,West Ham,Premier League,2022,27.0,1995.0,31.3,77,37,41,29,7,28,58,48.3,30,42,17,25,53,130,71,3,MF,25-29,Midfielder,Czech Republic,Europe
2540,Petar Stojanović,SVN,Empoli,Serie A,2022,26.0,1995.0,17.0,42,22,28,10,4,26,43,60.5,17,17,5,12,11,53,55,0,DF,25-29,Defender,Slovenia,Europe
2542,Jørgen Strand Larsen,NOR,Celta Vigo,La Liga,2022,22.0,2000.0,18.9,15,7,3,5,7,7,30,23.3,23,14,5,9,3,18,24,0,FW,20-24,Forward,Norway,Europe
2549,Denis Suárez,ESP,Espanyol,La Liga,2022,28.0,1994.0,10.5,26,20,12,12,2,13,45,28.9,32,11,1,10,5,31,4,0,"MF,FW",25-29,Midfielder,Spain,Europe
2550,Mario Suárez,ESP,Rayo Vallecano,La Liga,2022,35.0,1987.0,0.1,0,0,0,0,0,0,0,,0,1,0,1,0,0,0,0,"MF,DF",35-39,Midfielder,Spain,Europe
2560,Suso,ESP,Sevilla,La Liga,2022,28.0,1993.0,11.8,16,10,5,7,4,10,22,45.5,12,7,1,6,2,18,3,0,"MF,FW",25-29,Midfielder,Spain,Europe
2563,Mile Svilar,SRB,Roma,Serie A,2022,22.0,1999.0,3.0,0,0,0,0,0,0,0,,0,0,0,0,0,0,1,0,GK,20-24,Goalkeeper,Serbia,Europe
2567,Wojciech Szczęsny,POL,Juventus,Serie A,2022,32.0,1990.0,27.5,1,0,1,0,0,0,1,0.0,1,0,0,0,0,1,7,0,GK,30-34,Goalkeeper,Poland,Europe
2569,Alexander Sørloth,NOR,Real Sociedad,La Liga,2022,26.0,1995.0,26.5,18,9,3,6,9,7,14,50.0,7,15,1,14,2,20,26,1,FW,25-29,Forward,Norway,Europe
2570,Alexander Sørloth,NOR,RB Leipzig,Bundesliga,2022,26.0,1995.0,0.1,0,0,0,0,0,0,0,,0,0,0,0,0,0,0,0,FW,25-29,Forward,Norway,Europe
2598,Ramón Terrats,ESP,Villarreal,La Liga,2022,21.0,2000.0,9.1,15,10,3,8,4,9,17,52.9,8,11,4,7,8,23,6,2,MF,20-24,Midfielder,Spain,Europe
2599,Ramón Terrats,ESP,Girona,La Liga,2022,21.0,2000.0,2.4,4,2,1,3,0,2,6,33.3,4,6,2,4,3,7,3,1,MF,20-24,Midfielder,Spain,Europe
2601,Aleksa Terzić,SRB,Fiorentina,Serie A,2022,22.0,1999.0,10.4,16,9,9,4,3,11,21,52.4,10,13,4,9,5,21,16,0,DF,20-24,Defender,Serbia,Europe
2614,Morten Thorsby,NOR,Union Berlin,Bundesliga,2022,26.0,1996.0,9.3,22,10,9,11,2,13,21,61.9,8,11,5,6,3,25,20,0,MF,25-29,Midfielder,Norway,Europe
2615,Kristian Thorstvedt,NOR,Sassuolo,Serie A,2022,23.0,1999.0,12.6,16,7,4,9,3,6,17,35.3,11,19,5,14,14,30,13,0,MF,20-24,Midfielder,Norway,Europe
2630,Raúl de Tomás,ESP,Rayo Vallecano,La Liga,2022,27.0,1994.0,8.9,3,2,0,1,2,2,6,33.3,4,4,0,4,0,3,6,0,FW,25-29,Forward,Spain,Europe
2638,Pablo Torre,ESP,Barcelona,La Liga,2022,19.0,2003.0,1.6,2,1,0,1,1,2,4,50.0,2,1,0,1,2,4,1,0,"FW,MF",Under 20,Forward,Spain,Europe
2639,David Torres,ESP,Valladolid,La Liga,2022,19.0,2003.0,4.3,1,1,0,1,0,1,1,100.0,0,4,2,2,3,4,8,0,DF,Under 20,Defender,Spain,Europe
2639,David Torres,ESP,Valladolid,La Liga,2022,19.0,2003.0,4.3,1,1,0,1,0,1,1,100.0,0,4,2,2,3,4,8,0,DF,Under 20,Defender,Spain,Europe
2639,David Torres,ESP,Valladolid,La Liga,2022,19.0,2003.0,4.3,1,1,0,1,0,1,1,100.0,0,4,2,2,3,4,8,0,DF,Under 20,Defender,Spain,Europe
2639,David Torres,ESP,Valladolid,La Liga,2022,19.0,2003.0,4.3,1,1,0,1,0,1,1,100.0,0,4,2,2,3,4,8,0,DF,Under 20,Defender,Spain,Europe
2640,Ferrán Torres,ESP,Barcelona,La Liga,2022,22.0,2000.0,15.5,13,7,4,5,4,5,20,25.0,15,11,2,9,3,16,5,0,"FW,MF",20-24,Forward,Spain,Europe
2641,Óliver Torres,ESP,Sevilla,La Liga,2022,27.0,1994.0,23.7,39,23,12,13,14,18,59,30.5,41,26,5,21,10,49,10,0,"MF,FW",25-29,Midfielder,Spain,Europe
2642,Pau Torres,ESP,Villarreal,La Liga,2022,25.0,1997.0,33.9,43,25,25,13,5,23,36,63.9,13,36,27,9,13,56,146,3,DF,25-29,Defender,Spain,Europe
2643,Roberto Torres,ESP,Osasuna,La Liga,2022,33.0,1989.0,0.1,0,0,0,0,0,0,0,,0,0,0,0,0,0,0,0,"FW,MF",30-34,Forward,Spain,Europe
2644,Lucas Torró,ESP,Osasuna,La Liga,2022,28.0,1994.0,27.5,48,32,28,15,5,18,42,42.9,24,24,3,21,42,90,64,1,MF,25-29,Midfielder,Spain,Europe
2653,Adama Traoré,ESP,Wolves,Premier League,2022,26.0,1996.0,16.6,14,7,7,4,3,4,9,44.4,5,8,1,7,3,17,17,0,"FW,MF",25-29,Forward,Spain,Europe
2653,Adama Traoré,ESP,Wolves,Premier League,2022,26.0,1996.0,16.6,14,7,7,4,3,4,9,44.4,5,8,1,7,3,17,17,0,"FW,MF",25-29,Forward,Spain,Europe
2653,Adama Traoré,ESP,Wolves,Premier League,2022,26.0,1996.0,16.6,14,7,7,4,3,4,9,44.4,5,8,1,7,3,17,17,0,"FW,MF",25-29,Forward,Spain,Europe
2653,Adama Traoré,ESP,Wolves,Premier League,2022,26.0,1996.0,16.6,14,7,7,4,3,4,9,44.4,5,8,1,7,3,17,17,0,"FW,MF",25-29,Forward,Spain,Europe
2653,Adama Traoré,ESP,Wolves,Premier League,2022,26.0,1996.0,16.6,14,7,7,4,3,4,9,44.4,5,8,1,7,3,17,17,0,"FW,MF",25-29,Forward,Spain,Europe
2653,Adama Traoré,ESP,Wolves,Premier League,2022,26.0,1996.0,16.6,14,7,7,4,3,4,9,44.4,5,8,1,7,3,17,17,0,"FW,MF",25-29,Forward,Spain,Europe
2653,Adama Traoré,ESP,Wolves,Premier League,2022,26.0,1996.0,16.6,14,7,7,4,3,4,9,44.4,5,8,1,7,3,17,17,0,"FW,MF",25-29,Forward,Spain,Europe
2653,Adama Traoré,ESP,Wolves,Premier League,2022,26.0,1996.0,16.6,14,7,7,4,3,4,9,44.4,5,8,1,7,3,17,17,0,"FW,MF",25-29,Forward,Spain,Europe
2653,Adama Traoré,ESP,Wolves,Premier League,2022,26.0,1996.0,16.6,14,7,7,4,3,4,9,44.4,5,8,1,7,3,17,17,0,"FW,MF",25-29,Forward,Spain,Europe
2653,Adama Traoré,ESP,Wolves,Premier League,2022,26.0,1996.0,16.6,14,7,7,4,3,4,9,44.4,5,8,1,7,3,17,17,0,"FW,MF",25-29,Forward,Spain,Europe
2653,Adama Traoré,ESP,Wolves,Premier League,2022,26.0,1996.0,16.6,14,7,7,4,3,4,9,44.4,5,8,1,7,3,17,17,0,"FW,MF",25-29,Forward,Spain,Europe
2653,Adama Traoré,ESP,Wolves,Premier League,2022,26.0,1996.0,16.6,14,7,7,4,3,4,9,44.4,5,8,1,7,3,17,17,0,"FW,MF",25-29,Forward,Spain,Europe
2653,Adama Traoré,ESP,Wolves,Premier League,2022,26.0,1996.0,16.6,14,7,7,4,3,4,9,44.4,5,8,1,7,3,17,17,0,"FW,MF",25-29,Forward,Spain,Europe
2653,Adama Traoré,ESP,Wolves,Premier League,2022,26.0,1996.0,16.6,14,7,7,4,3,4,9,44.4,5,8,1,7,3,17,17,0,"FW,MF",25-29,Forward,Spain,Europe
2653,Adama Traoré,ESP,Wolves,Premier League,2022,26.0,1996.0,16.6,14,7,7,4,3,4,9,44.4,5,8,1,7,3,17,17,0,"FW,MF",25-29,Forward,Spain,Europe
2653,Adama Traoré,ESP,Wolves,Premier League,2022,26.0,1996.0,16.6,14,7,7,4,3,4,9,44.4,5,8,1,7,3,17,17,0,"FW,MF",25-29,Forward,Spain,Europe
2661,Manu Trigueros,ESP,Villarreal,La Liga,2022,30.0,1991.0,9.2,20,14,9,5,6,9,22,40.9,13,9,2,7,5,25,4,0,MF,30-34,Midfielder,Spain,Europe
2674,Martin Turk,SVN,Sampdoria,Serie A,2022,18.0,2003.0,4.0,0,0,0,0,0,0,0,,0,0,0,0,0,0,1,0,GK,Under 20,Goalkeeper,Slovenia,Europe
2675,Beñat Turrientes,ESP,Real Sociedad,La Liga,2022,20.0,2002.0,1.2,3,3,3,0,0,1,5,20.0,4,2,0,2,0,3,3,0,"MF,FW",20-24,Midfielder,Spain,Europe
2695,Óscar Valentín,ESP,Rayo Vallecano,La Liga,2022,27.0,1994.0,28.4,92,51,29,50,13,46,121,38.0,75,60,9,51,44,136,30,0,MF,25-29,Midfielder,Spain,Europe
2700,Jesús Vallejo,ESP,Real Madrid,La Liga,2022,25.0,1997.0,0.2,0,0,0,0,0,0,0,,0,0,0,0,0,0,0,0,DF,25-29,Defender,Spain,Europe
2701,Manu Vallejo,ESP,Girona,La Liga,2022,25.0,1997.0,2.3,4,1,1,2,1,1,6,16.7,5,2,0,2,1,5,3,0,"FW,MF",25-29,Forward,Spain,Europe
2710,Jesus Vazquez,ESP,Valencia,La Liga,2022,19.0,2003.0,3.4,13,8,9,1,3,6,11,54.5,5,4,0,4,1,14,8,0,"DF,MF",Under 20,Defender,Spain,Europe
2711,Kevin Vázquez,ESP,Celta Vigo,La Liga,2022,29.0,1993.0,4.9,13,8,5,7,1,8,12,66.7,4,4,1,3,2,15,8,0,"DF,MF",25-29,Defender,Spain,Europe
2712,Lucas Vázquez,ESP,Real Madrid,La Liga,2022,31.0,1991.0,12.7,34,23,22,10,2,20,28,71.4,8,10,0,10,7,41,13,0,DF,30-34,Defender,Spain,Europe
2714,Gabriel Veiga,ESP,Celta Vigo,La Liga,2022,20.0,2002.0,25.5,43,19,14,25,4,16,52,30.8,36,30,3,27,21,64,6,0,MF,20-24,Midfielder,Spain,Europe
2716,Miloš Veljković,SRB,Werder Bremen,Bundesliga,2022,26.0,1995.0,25.2,30,19,17,13,0,18,29,62.1,11,32,16,16,33,63,103,0,DF,25-29,Defender,Serbia,Europe
2720,Unai Vencedor Paris,ESP,Athletic Club,La Liga,2022,21.0,2000.0,2.1,3,1,0,3,0,1,6,16.7,5,5,0,5,1,4,1,0,MF,20-24,Midfielder,Spain,Europe
2724,Gonzalo Verdú,ESP,Elche,La Liga,2022,33.0,1988.0,7.8,10,5,8,2,0,4,8,50.0,4,8,6,2,10,20,33,0,DF,30-34,Defender,Spain,Europe
2728,Mikel Vesga,ESP,Athletic Club,La Liga,2022,29.0,1993.0,28.6,57,35,21,31,5,25,68,36.8,43,39,8,31,36,93,39,3,MF,25-29,Midfielder,Spain,Europe
2731,Aleix Vidal,ESP,Espanyol,La Liga,2022,32.0,1989.0,11.4,11,5,6,3,2,4,22,18.2,18,21,2,19,15,26,14,0,"MF,FW",30-34,Midfielder,Spain,Europe
2733,Nacho Vidal,ESP,Osasuna,La Liga,2022,27.0,1995.0,13.9,27,14,16,6,5,17,32,53.1,15,17,4,13,19,46,33,1,DF,25-29,Defender,Spain,Europe
2742,Toni Villa,ESP,Valladolid,La Liga,2022,27.0,1995.0,1.0,6,3,2,3,1,4,9,44.4,5,0,0,0,0,6,0,0,MF,25-29,Midfielder,Spain,Europe
2743,Toni Villa,ESP,Girona,La Liga,2022,27.0,1995.0,9.9,25,18,9,11,5,10,23,43.5,13,8,0,8,8,33,3,0,"MF,FW",25-29,Midfielder,Spain,Europe
2744,Asier Villalibre,ESP,Athletic Club,La Liga,2022,24.0,1997.0,1.1,0,0,0,0,0,0,0,,0,0,0,0,0,0,1,0,FW,20-24,Forward,Spain,Europe
2745,Gonzalo Villar,ESP,Sampdoria,Serie A,2022,24.0,1998.0,7.7,13,7,4,8,1,7,15,46.7,8,11,3,8,4,17,9,1,MF,20-24,Midfielder,Spain,Europe
2746,Gonzalo Villar,ESP,Getafe,La Liga,2022,24.0,1998.0,5.1,10,5,1,6,3,6,14,42.9,8,9,2,7,6,16,5,0,MF,20-24,Midfielder,Spain,Europe
2747,Iván Villar,ESP,Celta Vigo,La Liga,2022,25.0,1997.0,19.0,0,0,0,0,0,0,1,0.0,1,0,0,0,0,0,7,0,GK,25-29,Goalkeeper,Spain,Europe
2756,Daniel Vivian,ESP,Athletic Club,La Liga,2022,23.0,1999.0,26.4,57,32,36,16,5,36,45,80.0,9,27,14,13,24,81,90,3,DF,20-24,Defender,Spain,Europe
2757,Dušan Vlahović,SRB,Juventus,Serie A,2022,22.0,2000.0,21.4,11,6,0,7,4,4,10,40.0,6,10,3,7,3,14,8,1,FW,20-24,Forward,Serbia,Europe
2764,Lukáš Vorlický,CZE,Atalanta,Serie A,2022,20.0,2002.0,0.3,0,0,0,0,0,0,0,,0,0,0,0,1,1,0,0,"MF,FW",20-24,Midfielder,Czech Republic,Europe
2775,Sebastian Walukiewicz,POL,Empoli,Serie A,2022,22.0,2000.0,6.7,9,6,7,2,0,4,6,66.7,2,10,9,1,7,16,30,0,DF,20-24,Defender,Poland,Europe
2798,Mateusz Wieteska,POL,Clermont Foot,Ligue 1,2022,25.0,1997.0,34.6,41,23,28,13,0,19,33,57.6,14,44,28,16,56,97,97,4,DF,25-29,Defender,Poland,Europe
2802,Nico Williams,ESP,Athletic Club,La Liga,2022,20.0,2002.0,29.5,31,16,10,15,6,19,41,46.3,22,40,2,38,8,39,14,1,FW,20-24,Forward,Spain,Europe
2812,Przemysław Wiśniewski,POL,Spezia,Serie A,2022,24.0,1998.0,11.1,13,6,7,6,0,6,18,33.3,12,16,8,8,11,24,66,0,DF,20-24,Defender,Poland,Europe
2826,Lamine Yamal,ESP,Barcelona,La Liga,2022,15.0,2007.0,0.1,0,0,0,0,0,0,0,,0,0,0,0,0,0,0,0,FW,Under 20,Forward,Spain,Europe
2831,Gerard Yepes,ESP,Sampdoria,Serie A,2022,19.0,2002.0,2.2,5,3,2,3,0,1,3,33.3,2,3,0,3,4,9,3,0,MF,Under 20,Midfielder,Spain,Europe
2836,Mohamed Youssouf,COM,Ajaccio,Ligue 1,2022,34.0,1988.0,27.3,72,44,41,24,7,38,61,62.3,23,32,8,24,65,137,70,0,DF,30-34,Defender,Comoros,Africa
2845,Joseba Zaldúa,ESP,Cádiz,La Liga,2022,30.0,1992.0,7.1,15,8,10,4,1,7,10,70.0,3,4,2,2,11,26,22,0,DF,30-34,Defender,Spain,Europe
2846,Nicola Zalewski,POL,Roma,Serie A,2022,20.0,2002.0,24.4,45,26,25,15,5,22,71,31.0,49,27,1,26,31,76,23,0,DF,20-24,Defender,Poland,Europe
2856,Oier Zarraga,ESP,Athletic Club,La Liga,2022,23.0,1999.0,9.5,14,9,5,7,2,8,20,40.0,12,7,0,7,10,24,5,0,MF,20-24,Midfielder,Spain,Europe
2871,Piotr Zieliński,POL,Napoli,Serie A,2022,28.0,1994.0,25.4,17,10,1,11,5,12,25,48.0,13,16,5,11,14,31,7,0,MF,25-29,Midfielder,Poland,Europe
2872,David Zima,CZE,Torino,Serie A,2022,21.0,2000.0,4.5,9,5,5,4,0,3,4,75.0,1,7,2,5,9,18,11,2,DF,20-24,Defender,Czech Republic,Europe
2883,Igor Zubeldia,ESP,Real Sociedad,La Liga,2022,25.0,1997.0,28.2,35,18,28,7,0,25,35,71.4,10,23,17,6,21,56,93,0,DF,25-29,Defender,Spain,Europe
2884,Martín Zubimendi,ESP,Real Sociedad,La Liga,2022,23.0,1999.0,34.5,59,33,23,30,6,24,45,53.3,21,44,17,27,37,96,55,4,MF,20-24,Midfielder,Spain,Europe
2885,Szymon Żurkowski,POL,Fiorentina,Serie A,2022,24.0,1997.0,0.4,0,0,0,0,0,0,0,,0,0,0,0,0,0,0,0,MF,20-24,Midfielder,Poland,Europe
2886,Szymon Żurkowski,POL,Spezia,Serie A,2022,24.0,1997.0,4.7,9,3,4,4,1,2,15,13.3,13,9,2,7,4,13,6,0,MF,20-24,Midfielder,Poland,Europe
2887,Martin Ødegaard,NOR,Arsenal,Premier League,2022,23.0,1998.0,34.7,36,23,12,14,10,14,47,29.8,33,20,5,15,6,42,12,1,MF,20-24,Midfielder,Norway,Europe
2889,Filip Đuričić,SRB,Sampdoria,Serie A,2022,30.0,1992.0,24.1,43,22,18,20,5,14,32,43.8,18,19,6,13,7,50,8,0,"MF,FW",30-34,Midfielder,Serbia,Europe
67,Mickaël Alphonse,GLP,Dijon,Ligue 1,2019,30.0,1989.0,15.3,39,25,26,12,1,23,37,62.2,14,19,3,16,17,56,64,0,DF,30-34,Defender,France,Europe
78,Thierry Ambrose,GLP,Metz,Ligue 1,2019,22.0,1997.0,6.1,7,5,2,2,3,2,7,28.6,5,3,0,3,3,10,3,0,FW,20-24,Forward,France,Europe
153,Ludovic Baal,GUF,Brest,Ligue 1,2019,33.0,1986.0,9.2,27,15,13,12,2,10,22,45.5,12,9,3,6,17,44,20,0,DF,30-34,Defender,French Guiana,
280,Valon Berisha,KVX,Lazio,Serie A,2019,26.0,1993.0,0.4,1,1,0,1,0,1,2,50.0,1,0,0,0,0,1,1,0,MF,25-29,Midfielder,Sweden,Europe
281,Valon Berisha,KVX,Düsseldorf,Bundesliga,2019,26.0,1993.0,10.5,14,9,3,8,3,6,21,28.6,15,4,1,3,9,23,8,0,MF,25-29,Midfielder,Sweden,Europe
393,Patrick Burner,MTQ,Nice,Ligue 1,2019,23.0,1996.0,15.9,35,25,15,17,3,14,25,56.0,11,11,2,9,30,65,37,0,DF,20-24,Defender,Martinique,
403,Manuel Cabit,MTQ,Metz,Ligue 1,2019,26.0,1993.0,3.0,3,1,1,2,0,2,10,20.0,8,5,0,5,4,7,5,0,DF,25-29,Defender,Martinique,
528,Yannis Clementia,MTQ,Nice,Ligue 1,2019,22.0,1997.0,2.0,0,0,0,0,0,0,0,,0,0,0,0,0,0,0,0,GK,20-24,Goalkeeper,Martinique,
641,Grégoire Defrel,MTQ,Sassuolo,Serie A,2019,28.0,1991.0,10.9,12,8,4,6,2,4,15,26.7,11,9,0,9,3,15,5,0,"FW,MF",25-29,Forward,France,Europe
1036,Sinan Gümüş,Türkiye,Genoa,Serie A,2019,25.0,1994.0,1.1,0,0,0,0,0,0,4,0.0,4,0,0,0,0,0,1,0,"FW,MF",25-29,Forward,Germany,Europe
1077,Christophe Hérelle,MTQ,Nice,Ligue 1,2019,26.0,1992.0,12.3,14,11,10,4,0,3,7,42.9,4,14,8,6,17,31,26,1,DF,25-29,Defender,France,Europe
1402,Donovan Léon,GUF,Brest,Ligue 1,2019,26.0,1992.0,1.4,0,0,0,0,0,0,0,,0,1,0,1,0,0,0,0,GK,25-29,Goalkeeper,French Guiana,
2011,Florent Poulolo,MTQ,Getafe,La Liga,2019,22.0,1997.0,0.0,0,0,0,0,0,0,0,,0,0,0,0,0,0,1,0,DF,20-24,Defender,Martinique,
2070,Milot Rashica,KVX,Werder Bremen,Bundesliga,2019,23.0,1996.0,25.2,21,14,13,6,2,9,33,27.3,24,15,2,13,6,27,16,1,FW,20-24,Forward,Yugoslavia (Republic),
2094,Elvis Rexhbeçaj,KVX,Köln,Bundesliga,2019,21.0,1997.0,6.9,16,12,9,5,2,5,13,38.5,8,7,0,7,3,19,4,0,MF,20-24,Midfielder,,
2172,Amir Rrahmani,KVX,Hellas Verona,Serie A,2019,25.0,1994.0,35.9,50,31,26,19,5,26,46,56.5,20,50,31,19,30,80,151,1,DF,25-29,Defender,Yugoslavia (Republic),
2549,Samir Ujkani,KVX,Torino,Serie A,2019,31.0,1988.0,1.0,0,0,0,0,0,0,0,,0,0,0,0,0,0,1,0,GK,30-34,Goalkeeper,Jugoslawien (SFR),
2710,Arber Zeneli,KVX,Reims,Ligue 1,2019,24.0,1995.0,0.1,0,0,0,0,0,0,0,,0,0,0,0,0,0,0,0,MF,20-24,Midfielder,,
83,Mickaël Alphonse,GLP,Ajaccio,Ligue 1,2022,33.0,1989.0,15.1,35,23,20,11,4,20,33,60.6,13,17,5,12,35,70,44,1,DF,30-34,Defender,France,Europe
152,Fisnik Asllani,KVX,Hoffenheim,Bundesliga,2022,19.0,2002.0,1.9,0,0,0,0,0,0,4,0.0,4,2,0,2,3,3,3,0,FW,Under 20,Forward,,
168,Cédric Avinel,GLP,Ajaccio,Ligue 1,2022,35.0,1986.0,19.9,13,7,8,5,0,8,12,66.7,4,20,13,7,15,28,91,1,DF,35-39,Defender,France,Europe
670,Grégoire Defrel,MTQ,Sassuolo,Serie A,2022,31.0,1991.0,13.0,9,7,5,2,2,4,13,30.8,9,11,0,11,2,11,5,0,FW,30-34,Forward,France,Europe
1071,Andrew Gravillon,GLP,Torino,Serie A,2022,24.0,1998.0,3.5,3,3,0,3,0,0,0,,0,4,2,2,9,12,16,0,DF,20-24,Defender,,
1072,Andrew Gravillon,GLP,Reims,Ligue 1,2022,24.0,1998.0,11.5,16,8,9,6,1,8,13,61.5,5,18,9,9,21,37,36,0,DF,20-24,Defender,,
1180,Christophe Hérelle,MTQ,Brest,Ligue 1,2022,29.0,1992.0,11.8,10,4,7,2,1,4,13,30.8,9,16,11,5,20,30,48,0,DF,25-29,Defender,France,Europe
1358,Atakan Karazor,Türkiye,Stuttgart,Bundesliga,2022,25.0,1996.0,21.8,49,30,18,25,6,24,47,51.1,23,39,11,28,31,80,44,0,MF,25-29,Midfielder,Germany,Europe
1455,Rémy Labeau Lascary,GLP,Lens,Ligue 1,2022,19.0,2003.0,1.4,4,2,4,0,0,0,0,,0,4,0,4,1,5,0,0,"FW,MF",Under 20,Forward,Guadeloupe,
1520,Donovan Léon,GUF,Auxerre,Ligue 1,2022,29.0,1992.0,2.0,0,0,0,0,0,0,0,,0,0,0,0,0,0,1,0,GK,25-29,Goalkeeper,French Guiana,
1635,Mickael Malsa,MTQ,Valladolid,La Liga,2022,26.0,1995.0,0.8,2,2,1,1,0,1,4,25.0,3,1,1,0,2,4,3,0,MF,25-29,Midfielder,,
1877,Vedat Muriqi,KVX,Mallorca,La Liga,2022,28.0,1994.0,32.6,12,7,4,7,1,3,13,23.1,10,19,7,12,12,24,73,0,FW,25-29,Forward,Yugoslavia (Republic),
2203,Elba Rashani,KVX,Clermont Foot,Ligue 1,2022,29.0,1993.0,24.0,39,26,13,19,7,13,39,33.3,26,27,2,25,21,60,19,0,"MF,FW",25-29,Midfielder,,
2229,Elvis Rexhbeçaj,KVX,Augsburg,Bundesliga,2022,24.0,1997.0,28.0,51,30,18,24,9,29,59,49.2,30,39,12,27,17,68,40,0,MF,20-24,Midfielder,,
2299,Amir Rrahmani,KVX,Napoli,Serie A,2022,28.0,1994.0,27.2,33,18,20,13,0,17,26,65.4,9,36,20,16,14,47,79,1,DF,25-29,Defender,Yugoslavia (Republic),
2345,Yoann Salmier,GUF,Troyes,Ligue 1,2022,29.0,1992.0,29.4,51,29,34,12,5,21,35,60.0,14,34,19,15,39,90,124,0,DF,25-29,Defender,France,Europe
2680,Samir Ujkani,KVX,Empoli,Serie A,2022,34.0,1988.0,0.1,0,0,0,0,0,0,0,,0,0,0,0,0,0,0,0,GK,30-34,Goalkeeper,Jugoslawien (SFR),
2761,Mërgim Vojvoda,KVX,Torino,Serie A,2022,27.0,1995.0,19.1,22,12,15,6,1,12,24,50.0,12,14,2,12,10,32,31,1,DF,25-29,Defender,Germany,Europe
2865,Arber Zeneli,KVX,Reims,Ligue 1,2022,27.0,1995.0,11.1,9,3,3,3,3,5,12,41.7,7,8,0,8,2,11,2,0,"FW,MF",25-29,Forward,,
2870,Edon Zhegrova,KVX,Lille,Ligue 1,2022,23.0,1999.0,11.7,18,12,6,7,5,12,20,60.0,8,9,0,9,2,20,2,0,"FW,MF",20-24,Forward,Germany,Europe
1,Ismael Aaneba,FRA,Strasbourg,Ligue 1,2018,19.0,1999.0,2.3,12,6,7,5,0,5,10,50.0,5,5,0,5,8,20,9,0,DF,Under 20,Defender,France,Europe
2,Patrick van Aanholt,NED,Crystal Palace,Premier League,2018,27.0,1990.0,35.5,48,24,35,11,2,24,40,60.0,16,33,9,24,40,88,91,2,DF,25-29,Defender,Netherlands,Europe
3,Ignazio Abate,ITA,Milan,Serie A,2018,31.0,1986.0,14.5,34,19,16,13,5,14,22,63.6,8,19,6,13,18,52,50,0,DF,30-34,Defender,Italy,Europe
4,Yunis Abdelhamid,MAR,Reims,Ligue 1,2018,30.0,1987.0,38.0,60,33,48,11,1,30,40,75.0,10,44,24,20,65,125,196,0,DF,30-34,Defender,Morocco,Africa
5,Mehdi Abeid,ALG,Dijon,Ligue 1,2018,25.0,1992.0,22.5,51,33,27,16,8,15,45,33.3,30,33,7,26,29,80,23,1,MF,25-29,Midfielder,Algeria,Africa
6,Charles Abi,FRA,Saint-Étienne,Ligue 1,2018,18.0,2000.0,0.4,4,4,2,1,1,2,2,100.0,0,1,0,1,0,4,1,0,"DF,FW",Under 20,Defender,France,Europe
7,David Abraham,ARG,Eint Frankfurt,Bundesliga,2018,32.0,1986.0,15.8,22,14,13,8,1,11,25,44.0,14,23,12,11,24,46,64,0,DF,30-34,Defender,Argentina,South America
8,Amir Abrashi,ALB,Freiburg,Bundesliga,2018,28.0,1990.0,8.8,20,11,7,10,3,6,19,31.6,13,11,3,8,14,34,15,0,MF,25-29,Midfielder,Albania,Europe
9,Francesco Acerbi,ITA,Lazio,Serie A,2018,30.0,1988.0,36.8,40,30,22,13,5,12,16,75.0,4,50,32,18,61,101,169,1,DF,30-34,Defender,Italy,Europe
10,Afriyie Acquah,GHA,Empoli,Serie A,2018,26.0,1992.0,16.8,27,9,9,12,6,4,11,36.4,7,11,1,10,12,39,16,0,MF,25-29,Midfielder,Ghana,Africa
11,Tyler Adams,USA,RB Leipzig,Bundesliga,2018,19.0,1999.0,8.0,29,17,12,16,1,11,26,42.3,15,17,1,16,16,45,8,0,MF,Under 20,Midfielder,United States,North America
14,Khaled Adénon,BEN,Amiens,Ligue 1,2018,33.0,1985.0,22.2,31,22,20,11,0,16,28,57.1,12,26,11,15,31,62,101,0,DF,30-34,Defender,Benin,Africa
15,Claud Adjapong,ITA,Sassuolo,Serie A,2018,20.0,1998.0,3.0,4,2,1,3,0,1,2,50.0,1,3,1,2,1,5,4,0,"MF,FW",20-24,Midfielder,Italy,Europe
16,Yacine Adli,FRA,Bordeaux,Ligue 1,2018,18.0,2000.0,2.4,7,2,2,3,2,3,9,33.3,6,3,0,3,2,9,0,0,MF,Under 20,Midfielder,France,Europe
19,Luis Advíncula,PER,Rayo Vallecano,La Liga,2018,28.0,1990.0,26.5,52,38,38,12,2,21,31,67.7,10,22,2,20,19,71,60,1,DF,25-29,Defender,Peru,South America
21,Nayef Aguerd,MAR,Dijon,Ligue 1,2018,22.0,1996.0,11.7,17,12,8,9,0,8,19,42.1,11,20,11,9,14,31,59,1,DF,20-24,Defender,Morocco,Africa
22,Sergio Agüero,ARG,Manchester City,Premier League,2018,30.0,1988.0,27.3,17,9,1,10,6,5,9,55.6,4,15,1,14,9,26,3,0,FW,30-34,Forward,Argentina,South America
23,Ruben Aguilar,FRA,Montpellier,Ligue 1,2018,25.0,1993.0,28.1,88,51,40,33,15,39,69,56.5,30,23,3,20,37,125,50,1,DF,25-29,Defender,France,Europe
25,Emmanuel Agyemang-Badu,GHA,Udinese,Serie A,2018,27.0,1990.0,1.8,4,0,1,2,1,1,1,100.0,0,2,0,2,1,5,2,0,MF,25-29,Midfielder,Ghana,Africa
26,Jean-Eudes Aholou,CIV,Monaco,Ligue 1,2018,24.0,1994.0,11.9,20,11,6,11,3,8,16,50.0,8,7,0,7,17,37,12,0,MF,20-24,Midfielder,Ivory Coast,Africa
27,Antonis Aidonis,GER,Stuttgart,Bundesliga,2018,17.0,2001.0,0.9,3,1,1,1,1,1,4,25.0,3,1,0,1,2,5,2,0,DF,Under 20,Defender,Germany,Europe
28,Ola Aina,NGA,Torino,Serie A,2018,21.0,1996.0,24.0,54,36,32,20,2,23,48,47.9,25,30,3,27,39,93,59,2,DF,20-24,Defender,Nigeria,Africa
29,Youssef Aït Bennasser,MAR,Saint-Étienne,Ligue 1,2018,22.0,1996.0,10.4,25,13,9,12,4,13,28,46.4,15,15,2,13,19,44,6,2,MF,20-24,Midfielder,Morocco,Africa
30,Youssef Aït Bennasser,MAR,Monaco,Ligue 1,2018,22.0,1996.0,11.9,33,16,14,18,1,13,29,44.8,16,15,5,10,15,48,19,0,MF,20-24,Midfielder,Morocco,Africa
31,Rayan Aït-Nouri,ALG,Angers,Ligue 1,2018,17.0,2001.0,0.6,2,2,1,1,0,0,1,0.0,1,0,0,0,0,2,1,0,"DF,MF",Under 20,Defender,Algeria,Africa
32,Ludovic Ajorque,FRA,Strasbourg,Ligue 1,2018,24.0,1994.0,17.0,17,13,1,10,6,4,9,44.4,5,5,0,5,5,22,9,0,FW,20-24,Forward,France,Europe
33,Manuel Akanji,SUI,Dortmund,Bundesliga,2018,23.0,1995.0,24.5,29,19,14,13,2,14,25,56.0,11,22,13,9,27,56,92,2,DF,20-24,Defender,Switzerland,Europe
34,Carlos Akapo,EQG,Huesca,La Liga,2018,25.0,1993.0,11.4,28,15,18,8,2,19,33,57.6,14,12,2,10,23,51,36,0,DF,25-29,Defender,Equatorial Guinea,Africa
35,Nathan Aké,NED,Bournemouth,Premier League,2018,23.0,1995.0,37.9,66,35,42,21,3,22,35,62.9,13,51,35,16,32,98,241,0,DF,20-24,Defender,Netherlands,Europe
37,Chadrac Akolo,COD,Stuttgart,Bundesliga,2018,23.0,1995.0,5.8,9,6,2,7,0,1,3,33.3,2,7,0,7,4,13,1,0,"MF,FW",20-24,Midfielder,DR Congo,Africa
38,Kevin Akpoguma,NGA,Hoffenheim,Bundesliga,2018,23.0,1995.0,5.5,23,15,13,10,0,11,21,52.4,10,18,5,13,12,35,20,2,DF,20-24,Defender,Nigeria,Africa
39,Kevin Akpoguma,NGA,Hannover 96,Bundesliga,2018,23.0,1995.0,3.5,10,6,5,5,0,6,7,85.7,1,7,2,5,10,20,7,2,DF,20-24,Defender,Nigeria,Africa
40,David Alaba,AUT,Bayern Munich,Bundesliga,2018,26.0,1992.0,28.1,34,21,13,13,8,17,26,65.4,9,24,3,21,31,65,40,0,DF,25-29,Defender,Austria,Europe
41,Sofiane Alakouch,MAR,Nîmes,Ligue 1,2018,20.0,1998.0,21.1,81,44,44,31,6,36,63,57.1,27,15,4,11,46,127,57,0,DF,20-24,Defender,Morocco,Africa
42,Lucas Alario,ARG,Leverkusen,Bundesliga,2018,25.0,1992.0,14.1,15,8,5,6,4,4,14,28.6,10,9,0,9,1,16,16,0,"FW,MF",25-29,Forward,Argentina,South America
46,Miiko Albornoz,CHI,Hannover 96,Bundesliga,2018,27.0,1990.0,18.4,46,26,31,10,5,21,45,46.7,24,23,3,20,16,62,37,1,"DF,MF",25-29,Defender,Chile,South America
47,Marc Albrighton,ENG,Leicester City,Premier League,2018,28.0,1989.0,18.1,35,22,18,14,3,13,31,41.9,18,26,3,23,23,58,30,0,"FW,MF",25-29,Forward,England,Europe
52,Toby Alderweireld,BEL,Tottenham,Premier League,2018,29.0,1989.0,32.5,37,23,25,10,2,12,22,54.5,10,41,22,19,24,61,175,0,DF,25-29,Defender,Belgium,Europe
54,Alexis Alegue,FRA,Nantes,Ligue 1,2018,21.0,1996.0,0.1,1,0,0,1,0,0,0,,0,0,0,0,0,1,0,0,FW,20-24,Forward,France,Europe
57,Rúnar Alex Rúnarsson,ISL,Dijon,Ligue 1,2018,23.0,1995.0,25.0,2,0,2,0,0,2,6,33.3,4,0,0,0,1,3,7,2,GK,20-24,Goalkeeper,Iceland,Europe
58,Alexander,ARG,Leganés,La Liga,2018,29.0,1988.0,0.1,1,0,1,0,0,1,1,100.0,0,0,0,0,0,1,0,0,FW,25-29,Forward,Argentina,South America
59,Trent Alexander-Arnold,ENG,Liverpool,Premier League,2018,19.0,1998.0,27.4,61,39,31,22,8,36,68,52.9,32,19,3,16,35,96,68,0,DF,Under 20,Defender,England,Europe
60,Alfonso,MOZ,Hoffenheim,Bundesliga,2018,18.0,1999.0,0.1,1,1,0,1,0,1,2,50.0,1,0,0,0,1,2,0,0,MF,Under 20,Midfielder,Mozambique,Africa
61,Rachid Alioui,MAR,Nîmes,Ligue 1,2018,26.0,1992.0,13.9,15,5,3,9,3,4,9,44.4,5,8,1,7,10,25,11,0,FW,25-29,Forward,Morocco,Africa
62,Alisson,BRA,Liverpool,Premier League,2018,25.0,1992.0,38.0,2,1,2,0,0,2,2,100.0,0,0,0,0,1,3,14,6,GK,25-29,Goalkeeper,Brazil,South America
62,Alisson,BRA,Liverpool,Premier League,2018,25.0,1992.0,38.0,2,1,2,0,0,2,2,100.0,0,0,0,0,1,3,14,6,GK,25-29,Goalkeeper,Brazil,South America
62,Alisson,BRA,Liverpool,Premier League,2018,25.0,1992.0,38.0,2,1,2,0,0,2,2,100.0,0,0,0,0,1,3,14,6,GK,25-29,Goalkeeper,Brazil,South America
62,Alisson,BRA,Liverpool,Premier League,2018,25.0,1992.0,38.0,2,1,2,0,0,2,2,100.0,0,0,0,0,1,3,14,6,GK,25-29,Goalkeeper,Brazil,South America
63,Bobby Allain,FRA,Dijon,Ligue 1,2018,26.0,1991.0,13.0,0,0,0,0,0,0,1,0.0,1,1,0,1,0,0,16,1,GK,25-29,Goalkeeper,France,Europe
64,Allan,BRA,Napoli,Serie A,2018,27.0,1991.0,29.1,106,70,39,55,12,36,107,33.6,71,55,13,42,36,142,28,0,MF,25-29,Midfielder,Brazil,South America
64,Allan,BRA,Napoli,Serie A,2018,27.0,1991.0,29.1,106,70,39,55,12,36,107,33.6,71,55,13,42,36,142,28,0,MF,25-29,Midfielder,Brazil,South America
64,Allan,BRA,Napoli,Serie A,2018,27.0,1991.0,29.1,106,70,39,55,12,36,107,33.6,71,55,13,42,36,142,28,0,MF,25-29,Midfielder,Brazil,South America
64,Allan,BRA,Napoli,Serie A,2018,27.0,1991.0,29.1,106,70,39,55,12,36,107,33.6,71,55,13,42,36,142,28,0,MF,25-29,Midfielder,Brazil,South America
65,Allan,BRA,Eint Frankfurt,Bundesliga,2018,21.0,1997.0,2.0,4,4,2,2,0,0,4,0.0,4,4,2,2,0,4,1,0,MF,20-24,Midfielder,Brazil,South America
65,Allan,BRA,Eint Frankfurt,Bundesliga,2018,21.0,1997.0,2.0,4,4,2,2,0,0,4,0.0,4,4,2,2,0,4,1,0,MF,20-24,Midfielder,Brazil,South America
65,Allan,BRA,Eint Frankfurt,Bundesliga,2018,21.0,1997.0,2.0,4,4,2,2,0,0,4,0.0,4,4,2,2,0,4,1,0,MF,20-24,Midfielder,Brazil,South America
65,Allan,BRA,Eint Frankfurt,Bundesliga,2018,21.0,1997.0,2.0,4,4,2,2,0,0,4,0.0,4,4,2,2,0,4,1,0,MF,20-24,Midfielder,Brazil,South America
66,Dele Alli,ENG,Tottenham,Premier League,2018,22.0,1996.0,20.3,33,19,6,14,13,5,24,20.8,19,33,5,28,19,52,20,0,MF,20-24,Midfielder,England,Europe
67,Miguel Almirón,PAR,Newcastle Utd,Premier League,2018,24.0,1994.0,8.4,20,12,7,10,3,4,10,40.0,6,14,1,13,8,28,5,0,MF,20-24,Midfielder,Paraguay,South America
68,Júnior Alonso,PAR,Celta Vigo,La Liga,2018,25.0,1993.0,6.0,13,9,8,4,1,7,12,58.3,5,8,3,5,5,18,24,1,"DF,MF",25-29,Defender,Paraguay,South America
74,Bruno Alves,POR,Parma,Serie A,2018,36.0,1981.0,32.5,15,8,11,4,0,4,7,57.1,3,36,28,8,29,44,210,0,DF,35-39,Defender,Portugal,Europe
74,Bruno Alves,POR,Parma,Serie A,2018,36.0,1981.0,32.5,15,8,11,4,0,4,7,57.1,3,36,28,8,29,44,210,0,DF,35-39,Defender,Portugal,Europe
74,Bruno Alves,POR,Parma,Serie A,2018,36.0,1981.0,32.5,15,8,11,4,0,4,7,57.1,3,36,28,8,29,44,210,0,DF,35-39,Defender,Portugal,Europe
74,Bruno Alves,POR,Parma,Serie A,2018,36.0,1981.0,32.5,15,8,11,4,0,4,7,57.1,3,36,28,8,29,44,210,0,DF,35-39,Defender,Portugal,Europe
75,Dani Alves,BRA,Paris S-G,Ligue 1,2018,35.0,1983.0,18.0,42,22,16,23,3,13,38,34.2,25,18,5,13,8,50,11,0,"MF,DF",35-39,Midfielder,Brazil,South America
76,Ibrahim Amadou,FRA,Sevilla,La Liga,2018,25.0,1993.0,8.5,27,20,9,15,3,2,9,22.2,7,7,4,3,11,38,24,0,"MF,DF",25-29,Midfielder,France,Europe
77,Romain Amalfitano,FRA,Dijon,Ligue 1,2018,28.0,1989.0,28.0,52,33,20,28,4,25,67,37.3,42,45,13,32,47,99,35,0,"MF,FW",25-29,Midfielder,France,Europe
78,Daniel Amartey,GHA,Leicester City,Premier League,2018,23.0,1994.0,7.1,18,12,11,6,1,10,15,66.7,5,6,4,2,17,35,28,1,DF,20-24,Defender,Ghana,Africa
79,Jordi Amat,IDN,Rayo Vallecano,La Liga,2018,26.0,1992.0,30.7,54,31,34,19,1,24,42,57.1,18,31,10,21,43,97,133,1,DF,25-29,Defender,Indonesia,Asia
80,Amath,SEN,Getafe,La Liga,2018,22.0,1996.0,11.1,20,13,7,11,2,6,27,22.2,21,17,0,17,10,30,12,0,MF,20-24,Midfielder,Senegal,Africa
81,Jordan Amavi,FRA,Marseille,Ligue 1,2018,24.0,1994.0,24.2,74,50,34,26,14,35,56,62.5,21,24,8,16,46,120,93,4,DF,20-24,Defender,France,Europe
82,Kelvin Amian,FRA,Toulouse,Ligue 1,2018,20.0,1998.0,32.0,68,45,54,12,2,20,30,66.7,10,36,13,23,36,104,113,1,DF,20-24,Defender,France,Europe
83,Nadiem Amiri,GER,Hoffenheim,Bundesliga,2018,21.0,1996.0,8.4,14,9,8,4,2,3,13,23.1,10,11,0,11,7,21,4,0,MF,20-24,Midfielder,Germany,Europe
84,Yanis Ammour,FRA,Montpellier,Ligue 1,2018,19.0,1999.0,0.0,0,0,0,0,0,0,0,,0,0,0,0,0,0,0,0,MF,Under 20,Midfielder,France,Europe
85,Luke Amos,ENG,Tottenham,Premier League,2018,21.0,1997.0,0.0,1,0,0,1,0,0,0,,0,0,0,0,0,1,0,0,MF,20-24,Midfielder,England,Europe
86,Joachim Andersen,DEN,Sampdoria,Serie A,2018,22.0,1996.0,32.0,40,27,31,8,1,19,31,61.3,12,30,15,15,35,75,147,1,DF,20-24,Defender,Denmark,Europe
87,Felipe Anderson,BRA,West Ham,Premier League,2018,25.0,1993.0,33.8,89,49,33,44,12,31,101,30.7,70,71,0,71,41,130,18,1,"MF,FW",25-29,Midfielder,Brazil,South America
88,Florin Andone,ROU,Brighton,Premier League,2018,25.0,1993.0,9.8,10,2,3,4,3,1,6,16.7,5,9,1,8,3,13,12,0,FW,25-29,Forward,Romania,Europe
89,Benjamin André,FRA,Rennes,Ligue 1,2018,27.0,1990.0,27.7,101,60,39,50,12,33,85,38.8,52,40,6,34,54,155,58,0,MF,25-29,Midfielder,France,Europe
90,Marco Andreolli,ITA,Cagliari,Serie A,2018,32.0,1986.0,1.2,1,1,1,0,0,1,1,100.0,0,2,1,1,1,2,5,0,DF,30-34,Defender,Italy,Europe
91,Marco Andreolli,ITA,Chievo,Serie A,2018,32.0,1986.0,7.2,10,6,7,2,1,6,10,60.0,4,4,2,2,6,16,33,0,DF,30-34,Defender,Italy,Europe
92,Yoann Andreu,FRA,Angers,Ligue 1,2018,29.0,1989.0,0.0,1,0,1,0,0,0,1,0.0,1,0,0,0,1,2,0,0,DF,25-29,Defender,France,Europe
95,Cristian Ansaldi,ARG,Torino,Serie A,2018,31.0,1986.0,20.1,50,26,19,21,10,15,30,50.0,15,21,4,17,15,65,31,0,"DF,MF",30-34,Defender,Argentina,South America
96,Mirco Antenucci,ITA,SPAL,Serie A,2018,33.0,1984.0,23.7,11,9,5,1,5,1,10,10.0,9,14,0,14,5,16,5,0,FW,30-34,Forward,Italy,Europe
97,Waldemar Anton,GER,Hannover 96,Bundesliga,2018,22.0,1996.0,34.0,49,32,33,14,2,22,50,44.0,28,56,33,23,69,118,169,3,DF,20-24,Defender,Germany,Europe
98,Luca Antonelli,ITA,Empoli,Serie A,2018,31.0,1987.0,8.4,13,11,4,5,4,7,17,41.2,10,19,4,15,16,29,25,1,DF,30-34,Defender,Italy,Europe
99,Mauro Antonio Burruchaga,ARG,Chievo,Serie A,2018,20.0,1998.0,0.6,2,2,1,1,0,0,2,0.0,2,2,1,1,0,2,3,0,MF,20-24,Midfielder,Argentina,South America
100,Michail Antonio,JAM,West Ham,Premier League,2018,28.0,1990.0,23.4,23,14,12,6,5,6,12,50.0,6,38,3,35,18,41,26,1,"MF,FW",25-29,Midfielder,Jamaica,North America
102,Vitorino Antunes,POR,Getafe,La Liga,2018,31.0,1987.0,24.2,41,26,22,17,2,27,45,60.0,18,33,7,26,43,84,75,1,"DF,MF",30-34,Defender,Portugal,Europe
103,Anuar,MAR,Valladolid,La Liga,2018,23.0,1995.0,12.0,33,19,15,16,2,6,14,42.9,8,14,1,13,11,44,25,1,"MF,FW",20-24,Midfielder,Morocco,Africa
104,Dennis Aogo,GER,Stuttgart,Bundesliga,2018,31.0,1987.0,11.4,15,10,6,7,2,6,15,40.0,9,8,1,7,9,24,19,0,MF,30-34,Midfielder,Germany,Europe
105,Houssem Aouar,ALG,Lyon,Ligue 1,2018,20.0,1998.0,34.0,63,38,28,25,10,17,61,27.9,44,33,6,27,32,95,25,3,MF,20-24,Midfielder,Algeria,Africa
106,Emmanuel Apeh,NGA,Celta Vigo,La Liga,2018,21.0,1996.0,0.2,0,0,0,0,0,0,1,0.0,1,0,0,0,0,0,0,0,"FW,MF",20-24,Forward,Nigeria,Africa
107,Mauro Arambarri,URU,Getafe,La Liga,2018,22.0,1995.0,29.7,59,33,18,37,4,23,76,30.3,53,44,9,35,30,89,36,0,MF,20-24,Midfielder,Uruguay,South America
108,Guilherme Arana,BRA,Sevilla,La Liga,2018,21.0,1997.0,7.0,11,6,5,5,1,6,7,85.7,1,6,3,3,9,20,8,0,DF,20-24,Defender,Brazil,South America
109,Charles Aránguiz,CHI,Leverkusen,Bundesliga,2018,29.0,1989.0,21.0,48,30,21,22,5,21,66,31.8,45,31,2,29,25,73,27,1,MF,25-29,Midfielder,Chile,South America
110,Luiz Araújo,BRA,Lille,Ligue 1,2018,22.0,1996.0,8.7,23,17,8,9,6,9,24,37.5,15,6,1,5,3,26,4,0,"FW,MF",20-24,Forward,Brazil,South America
111,Néstor Araujo,MEX,Celta Vigo,La Liga,2018,26.0,1991.0,29.8,42,22,32,9,1,18,22,81.8,4,32,21,11,35,77,153,1,DF,25-29,Defender,Mexico,North America
113,Joaquín Ardaiz,URU,Frosinone,Serie A,2018,19.0,1999.0,0.2,0,0,0,0,0,0,0,,0,0,0,0,0,0,0,0,FW,Under 20,Forward,Uruguay,South America
114,Alphonse Areola,FRA,Paris S-G,Ligue 1,2018,25.0,1993.0,21.0,1,1,1,0,0,1,1,100.0,0,0,0,0,0,1,4,1,GK,25-29,Goalkeeper,France,Europe
115,Santiago Arias,COL,Atlético Madrid,La Liga,2018,26.0,1992.0,19.7,48,32,31,16,1,20,31,64.5,11,14,2,12,34,82,43,0,DF,25-29,Defender,Colombia,South America
116,Lorenzo Ariaudo,ITA,Frosinone,Serie A,2018,29.0,1989.0,18.7,20,14,15,4,1,6,10,60.0,4,31,20,11,14,34,103,0,DF,25-29,Defender,Italy,Europe
117,Nicolò Armini,ITA,Lazio,Serie A,2018,17.0,2001.0,0.4,1,1,0,1,0,1,2,50.0,1,1,0,1,0,1,0,0,DF,Under 20,Defender,Italy,Europe
118,Yoël Armougom,FRA,Caen,Ligue 1,2018,20.0,1998.0,20.6,31,21,20,9,2,15,29,51.7,14,9,3,6,21,52,66,0,DF,20-24,Defender,France,Europe
119,Stuart Armstrong,SCO,Southampton,Premier League,2018,26.0,1992.0,15.9,28,20,14,6,8,8,42,19.0,34,14,0,14,12,40,12,0,MF,25-29,Midfielder,Scotland,Europe
121,Marko Arnautović,AUT,West Ham,Premier League,2018,29.0,1989.0,22.1,9,5,4,3,2,1,7,14.3,6,4,2,2,3,12,6,0,FW,25-29,Forward,Austria,Europe
122,Maximilian Arnold,GER,Wolfsburg,Bundesliga,2018,24.0,1994.0,31.9,52,30,21,27,4,21,61,34.4,40,31,10,21,35,87,48,1,MF,20-24,Midfielder,Germany,Europe
124,Harry Arter,IRL,Cardiff City,Premier League,2018,28.0,1989.0,22.2,62,37,27,26,9,16,46,34.8,30,33,5,28,21,83,21,2,MF,25-29,Midfielder,Republic of Ireland,Europe
125,Kwadwo Asamoah,GHA,Inter,Serie A,2018,29.0,1988.0,29.7,44,26,22,14,8,29,51,56.9,22,21,4,17,40,84,46,1,DF,25-29,Defender,Ghana,Africa
126,Takuma Asano,JPN,Hannover 96,Bundesliga,2018,23.0,1994.0,7.8,5,3,1,1,3,1,6,16.7,5,9,0,9,2,7,2,0,"MF,FW",20-24,Midfielder,Japan,Asia
127,Santiago Ascacíbar,ARG,Stuttgart,Bundesliga,2018,21.0,1997.0,27.0,78,50,43,29,6,34,74,45.9,40,48,10,38,43,121,34,1,MF,20-24,Midfielder,Argentina,South America
131,Simon Asta,GER,Augsburg,Bundesliga,2018,17.0,2001.0,1.0,6,3,4,2,0,2,2,100.0,0,2,1,1,3,9,1,0,DF,Under 20,Defender,Germany,Europe
132,Youcef Atal,ALG,Nice,Ligue 1,2018,22.0,1996.0,25.1,68,44,34,25,9,34,67,50.7,33,38,8,30,56,124,42,0,"DF,FW",20-24,Defender,Algeria,Africa
133,Christian Atsu,GHA,Newcastle Utd,Premier League,2018,26.0,1992.0,16.6,24,15,9,11,4,5,16,31.3,11,13,3,10,7,31,16,0,MF,25-29,Midfielder,Ghana,Africa
134,Pierre-Emerick Aubameyang,GAB,Arsenal,Premier League,2018,29.0,1989.0,30.3,21,17,6,9,6,8,28,28.6,20,26,0,26,8,29,22,0,FW,25-29,Forward,Gabon,Africa
135,Emil Audero,ITA,Sampdoria,Serie A,2018,21.0,1997.0,36.0,4,3,4,0,0,3,3,100.0,0,0,0,0,1,5,21,4,GK,20-24,Goalkeeper,Italy,Europe
136,Jean-Kévin Augustin,FRA,RB Leipzig,Bundesliga,2018,21.0,1997.0,5.1,2,0,0,0,2,0,1,0.0,1,6,0,6,3,5,0,0,FW,20-24,Forward,France,Europe
137,Ludwig Augustinsson,SWE,Werder Bremen,Bundesliga,2018,24.0,1994.0,33.6,53,31,25,22,6,23,39,59.0,16,37,11,26,38,91,86,1,DF,20-24,Defender,Sweden,Europe
138,Serge Aurier,CIV,Tottenham,Premier League,2018,25.0,1992.0,6.3,20,12,12,4,4,8,15,53.3,7,8,2,6,7,27,20,0,DF,25-29,Defender,Ivory Coast,Africa
139,Charlie Austin,ENG,Southampton,Premier League,2018,29.0,1989.0,10.9,13,7,3,6,4,6,11,54.5,5,12,2,10,2,15,13,0,FW,25-29,Forward,England,Europe
140,Ezequiel Ávila,ARG,Huesca,La Liga,2018,24.0,1994.0,22.2,18,10,7,7,4,4,26,15.4,22,21,2,19,13,31,22,0,"FW,MF",20-24,Forward,Argentina,South America
141,Jordan Ayew,GHA,Crystal Palace,Premier League,2018,26.0,1991.0,13.1,38,23,12,19,7,6,20,30.0,14,16,0,16,7,45,6,0,FW,25-29,Forward,Ghana,Africa
142,Kaan Ayhan,TUR,Düsseldorf,Bundesliga,2018,23.0,1994.0,27.2,53,29,38,15,0,23,47,48.9,24,34,16,18,59,112,118,3,DF,20-24,Defender,Turkey,Asia
145,Abdoulaye Ba,SEN,Rayo Vallecano,La Liga,2018,27.0,1991.0,23.4,46,33,37,8,1,29,39,74.4,10,32,18,14,29,75,165,4,DF,25-29,Defender,Senegal,Africa
146,Florian Baak,GER,Hertha BSC,Bundesliga,2018,19.0,1999.0,0.0,0,0,0,0,0,0,0,,0,0,0,0,0,0,0,0,MF,Under 20,Midfielder,Germany,Europe
148,Khouma Babacar,SEN,Sassuolo,Serie A,2018,25.0,1993.0,16.5,7,3,2,5,0,2,10,20.0,8,8,2,6,3,10,25,1,FW,25-29,Forward,Senegal,Africa
149,Ryan Babel,NED,Fulham,Premier League,2018,31.0,1986.0,13.9,8,4,1,5,2,3,9,33.3,6,12,0,12,6,14,13,1,"FW,MF",30-34,Forward,Netherlands,Europe
150,Carlos Bacca,COL,Villarreal,La Liga,2018,31.0,1986.0,14.1,4,2,1,2,1,0,5,0.0,5,4,0,4,8,12,5,0,FW,30-34,Forward,Colombia,South America
151,Juninho Bacuna,CUW,Huddersfield,Premier League,2018,20.0,1997.0,15.7,46,29,22,19,5,22,54,40.7,32,21,1,20,24,70,12,1,"MF,DF",20-24,Midfielder,Curaçao,Europe
152,Leandro Bacuna,CUW,Cardiff City,Premier League,2018,26.0,1991.0,6.2,15,10,5,7,3,8,22,36.4,14,5,2,3,15,30,9,0,MF,25-29,Midfielder,Curaçao,Europe
153,Milan Badelj,CRO,Lazio,Serie A,2018,29.0,1989.0,12.7,33,20,10,19,4,16,37,43.2,21,27,9,18,33,66,20,1,MF,25-29,Midfielder,Croatia,Europe
154,Benoît Badiashile,FRA,Monaco,Ligue 1,2018,17.0,2001.0,19.6,25,18,18,7,0,17,25,68.0,8,12,5,7,21,46,79,2,DF,Under 20,Defender,France,Europe
155,Holger Badstuber,GER,Stuttgart,Bundesliga,2018,29.0,1989.0,5.8,12,4,8,4,0,7,8,87.5,1,6,2,4,9,21,21,1,DF,25-29,Defender,Germany,Europe
156,Stéphane Bahoken,CMR,Angers,Ligue 1,2018,26.0,1992.0,27.4,15,7,0,10,5,3,21,14.3,18,35,3,32,8,23,5,0,FW,25-29,Forward,Cameroon,Africa
157,Daniel Baier,GER,Augsburg,Bundesliga,2018,34.0,1984.0,31.3,62,39,21,37,4,24,66,36.4,42,27,8,19,60,122,48,2,MF,30-34,Midfielder,Germany,Europe
158,Leon Bailey,JAM,Leverkusen,Bundesliga,2018,20.0,1997.0,21.3,15,11,9,2,4,6,20,30.0,14,20,0,20,14,29,11,0,FW,20-24,Forward,Jamaica,North America
159,Eric Bailly,CIV,Manchester Utd,Premier League,2018,24.0,1994.0,7.1,15,9,14,1,0,8,10,80.0,2,9,4,5,13,28,39,1,DF,20-24,Defender,Ivory Coast,Africa
160,Leighton Baines,ENG,Everton,Premier League,2018,33.0,1984.0,4.2,8,6,4,3,1,4,6,66.7,2,2,0,2,2,10,8,0,DF,30-34,Defender,England,Europe
161,Marvin Bakalorz,GER,Hannover 96,Bundesliga,2018,28.0,1989.0,16.3,18,11,7,9,2,6,36,16.7,30,29,4,25,28,46,47,0,MF,25-29,Midfielder,Germany,Europe
162,Tiemoué Bakayoko,FRA,Milan,Serie A,2018,23.0,1994.0,25.6,69,43,22,40,7,26,62,41.9,36,34,5,29,50,119,42,2,MF,20-24,Midfielder,France,Europe
163,Ridle Baku,GER,Mainz 05,Bundesliga,2018,20.0,1998.0,10.4,18,9,6,9,3,2,7,28.6,5,13,1,12,8,26,9,0,MF,20-24,Midfielder,Germany,Europe
164,Fabián Balbuena,PAR,West Ham,Premier League,2018,26.0,1991.0,22.4,40,20,34,6,0,16,42,38.1,26,23,15,8,53,93,175,0,DF,25-29,Defender,Paraguay,South America
165,Keita Baldé,SEN,Inter,Serie A,2018,23.0,1995.0,9.9,10,6,4,2,4,2,9,22.2,7,8,0,8,3,13,1,0,FW,20-24,Forward,Senegal,Africa
166,Gareth Bale,WAL,Real Madrid,La Liga,2018,29.0,1989.0,19.8,16,8,5,7,4,6,20,30.0,14,19,3,16,11,27,13,0,FW,25-29,Forward,Wales,Europe
168,Andrija Balić,CRO,Udinese,Serie A,2018,20.0,1997.0,0.3,1,0,0,0,1,0,1,0.0,1,0,0,0,0,1,1,0,"FW,MF",20-24,Forward,Croatia,Europe
169,Fodé Ballo-Touré,SEN,Lille,Ligue 1,2018,21.0,1997.0,17.7,47,35,26,19,2,21,32,65.6,11,25,7,18,27,74,42,2,DF,20-24,Defender,Senegal,Africa
170,Fodé Ballo-Touré,SEN,Monaco,Ligue 1,2018,21.0,1997.0,17.7,46,31,26,16,4,20,40,50.0,20,20,2,18,28,74,38,2,DF,20-24,Defender,Senegal,Africa
171,Florent Balmont,FRA,Dijon,Ligue 1,2018,38.0,1980.0,12.0,29,16,16,10,3,9,36,25.0,27,13,2,11,6,35,8,0,MF,35-39,Midfielder,France,Europe
172,Leon Balogun,NGA,Brighton,Premier League,2018,30.0,1988.0,6.6,12,6,11,1,0,8,9,88.9,1,5,3,2,17,29,32,1,DF,30-34,Defender,Nigeria,Africa
173,Mario Balotelli,ITA,Nice,Ligue 1,2018,27.0,1990.0,8.4,1,0,0,1,0,1,4,25.0,3,9,1,8,1,2,8,0,FW,25-29,Forward,Italy,Europe
174,Mario Balotelli,ITA,Marseille,Ligue 1,2018,27.0,1990.0,10.4,5,3,1,3,1,2,7,28.6,5,8,2,6,3,8,6,0,FW,25-29,Forward,Italy,Europe
175,Abdoulaye Bamba,CIV,Angers,Ligue 1,2018,28.0,1990.0,28.6,51,29,31,14,6,24,44,54.5,20,20,4,16,37,88,86,0,DF,25-29,Defender,Ivory Coast,Africa
176,Jonathan Bamba,CIV,Lille,Ligue 1,2018,22.0,1996.0,33.4,29,19,7,17,5,13,39,33.3,26,24,1,23,41,70,18,0,"FW,MF",20-24,Forward,Ivory Coast,Africa
177,Sol Bamba,CIV,Cardiff City,Premier League,2018,33.0,1985.0,27.5,74,42,44,30,0,31,55,56.4,24,72,32,40,82,156,181,3,DF,30-34,Defender,Ivory Coast,Africa
178,Yacine Bammou,MAR,Caen,Ligue 1,2018,26.0,1991.0,10.3,14,7,7,4,3,3,8,37.5,5,14,3,11,9,23,17,0,"FW,MF",25-29,Forward,Morocco,Africa
179,Éver Banega,ARG,Sevilla,La Liga,2018,30.0,1988.0,29.6,71,50,32,35,4,20,70,28.6,50,26,5,21,28,99,28,0,MF,30-34,Midfielder,Argentina,South America
180,Mattia Bani,ITA,Chievo,Serie A,2018,24.0,1993.0,29.0,67,40,46,21,0,27,40,67.5,13,51,35,16,57,124,162,2,DF,20-24,Defender,Italy,Europe
181,Léo Baptistão,BRA,Espanyol,La Liga,2018,25.0,1992.0,13.7,22,14,11,5,6,8,27,29.6,19,17,0,17,8,30,14,0,"FW,MF",25-29,Forward,Brazil,South America
183,Federico Barba,ITA,Chievo,Serie A,2018,24.0,1993.0,27.6,30,14,21,9,0,8,21,38.1,13,29,15,14,65,95,129,0,DF,20-24,Defender,Italy,Europe
184,Danilo Barbosa,BRA,Nice,Ligue 1,2018,22.0,1996.0,17.2,29,20,13,13,3,6,17,35.3,11,17,2,15,15,44,25,1,MF,20-24,Midfielder,Brazil,South America
185,Enis Bardhi,MKD,Levante,La Liga,2018,23.0,1995.0,31.5,70,43,30,34,6,28,87,32.2,59,35,3,32,31,101,36,1,MF,20-24,Midfielder,North Macedonia,Europe
186,Francesco Bardi,ITA,Frosinone,Serie A,2018,26.0,1992.0,3.0,0,0,0,0,0,0,0,,0,0,0,0,0,0,2,0,GK,25-29,Goalkeeper,Italy,Europe
187,Phil Bardsley,SCO,Burnley,Premier League,2018,33.0,1985.0,18.6,32,19,15,14,3,12,21,57.1,9,25,12,13,31,63,68,1,DF,30-34,Defender,Scotland,Europe
188,Nicolò Barella,ITA,Cagliari,Serie A,2018,21.0,1997.0,34.5,99,65,38,41,20,30,82,36.6,52,61,2,59,38,137,27,0,MF,20-24,Midfielder,Italy,Europe
189,Philipp Bargfrede,GER,Werder Bremen,Bundesliga,2018,29.0,1989.0,12.0,23,15,9,12,2,10,28,35.7,18,35,11,24,34,57,45,1,"MF,DF",25-29,Midfielder,Germany,Europe
190,Antonino Barillà,ITA,Parma,Serie A,2018,30.0,1988.0,29.1,64,36,40,17,7,19,53,35.8,34,40,13,27,36,100,50,1,MF,30-34,Midfielder,Italy,Europe
191,Ross Barkley,ENG,Chelsea,Premier League,2018,24.0,1993.0,13.8,15,10,5,7,3,4,14,28.6,10,8,1,7,9,24,17,2,MF,20-24,Midfielder,England,Europe
192,Aymen Barkok,MAR,Düsseldorf,Bundesliga,2018,20.0,1998.0,5.7,13,6,4,9,0,4,19,21.1,15,8,1,7,4,17,3,0,MF,20-24,Midfielder,Morocco,Africa
193,Ashley Barnes,ENG,Burnley,Premier League,2018,28.0,1989.0,26.5,28,17,4,17,7,6,29,20.7,23,29,8,21,2,30,25,0,FW,25-29,Forward,England,Europe
194,Harvey Barnes,ENG,Leicester City,Premier League,2018,20.0,1997.0,11.2,10,6,5,4,1,4,6,66.7,2,7,1,6,3,13,7,0,"MF,FW",20-24,Midfielder,England,Europe
196,Antonio Barreca,ITA,Newcastle Utd,Premier League,2018,23.0,1995.0,0.1,0,0,0,0,0,0,0,,0,0,0,0,0,0,0,0,DF,20-24,Defender,Italy,Europe
197,Antonio Barreca,ITA,Monaco,Ligue 1,2018,23.0,1995.0,6.6,11,8,8,3,0,7,11,63.6,4,3,2,1,7,18,18,0,DF,20-24,Defender,Italy,Europe
198,Leandro Barreiro Martins,LUX,Mainz 05,Bundesliga,2018,18.0,2000.0,1.0,4,4,2,0,2,1,2,50.0,1,0,0,0,2,6,1,0,MF,Under 20,Midfielder,Luxembourg,Europe
200,Édgar Barreto,PAR,Sampdoria,Serie A,2018,34.0,1984.0,8.7,28,19,15,6,7,10,26,38.5,16,11,3,8,17,45,7,0,MF,30-34,Midfielder,Paraguay,South America
201,Musa Barrow,GAM,Atalanta,Serie A,2018,19.0,1998.0,6.7,9,5,5,3,1,4,6,66.7,2,4,0,4,0,9,2,0,FW,Under 20,Forward,Gambia,Africa
202,Fin Bartels,GER,Werder Bremen,Bundesliga,2018,31.0,1987.0,0.3,0,0,0,0,0,0,1,0.0,1,0,0,0,1,1,0,0,"MF,FW",30-34,Midfielder,Germany,Europe
204,Andrea Barzagli,ITA,Juventus,Serie A,2018,37.0,1981.0,2.9,1,1,0,1,0,1,2,50.0,1,2,2,0,4,5,10,0,DF,35-39,Defender,Italy,Europe
205,Daniele Baselli,ITA,Torino,Serie A,2018,26.0,1992.0,26.4,65,45,22,34,9,16,44,36.4,28,30,6,24,34,99,32,0,MF,25-29,Midfielder,Italy,Europe
206,Toma Bašić,CRO,Bordeaux,Ligue 1,2018,21.0,1996.0,14.8,32,16,5,21,6,11,31,35.5,20,13,1,12,9,41,22,1,MF,20-24,Midfielder,Croatia,Europe
207,Thomas Basila,FRA,Nantes,Ligue 1,2018,19.0,1999.0,1.0,2,1,1,1,0,0,0,,0,2,1,1,0,2,8,0,DF,Under 20,Defender,France,Europe
209,Alessandro Bastoni,ITA,Parma,Serie A,2018,19.0,1999.0,18.8,25,12,20,5,0,6,15,40.0,9,26,18,8,22,47,96,0,DF,Under 20,Defender,Italy,Europe
210,Bastos,ANG,Lazio,Serie A,2018,27.0,1991.0,12.7,22,17,16,4,2,17,27,63.0,10,16,8,8,7,29,49,1,DF,25-29,Defender,Angola,Africa
211,Michy Batshuayi,BEL,Crystal Palace,Premier League,2018,24.0,1993.0,8.3,2,1,1,1,0,1,2,50.0,1,8,3,5,3,5,0,0,FW,20-24,Forward,Belgium,Europe
212,Michy Batshuayi,BEL,Valencia,La Liga,2018,24.0,1993.0,5.9,1,1,0,1,0,0,3,0.0,3,5,2,3,0,1,3,0,FW,20-24,Forward,Belgium,Europe
213,Robert Bauer,GER,Nürnberg,Bundesliga,2018,23.0,1995.0,19.1,48,29,32,13,3,20,39,51.3,19,19,5,14,28,76,80,0,DF,20-24,Defender,Germany,Europe
214,Oliver Baumann,GER,Hoffenheim,Bundesliga,2018,28.0,1990.0,33.0,0,0,0,0,0,0,0,,0,0,0,0,2,2,11,5,GK,25-29,Goalkeeper,Germany,Europe
215,Timo Baumgartl,GER,Stuttgart,Bundesliga,2018,22.0,1996.0,18.0,33,23,21,12,0,11,19,57.9,8,31,22,9,26,59,100,0,DF,20-24,Defender,Germany,Europe
216,Julian Baumgartlinger,AUT,Leverkusen,Bundesliga,2018,30.0,1988.0,17.3,52,30,24,20,8,20,45,44.4,25,18,6,12,26,78,21,1,MF,30-34,Midfielder,Austria,Europe
217,Christoph Baumgartner,AUT,Hoffenheim,Bundesliga,2018,18.0,1999.0,0.9,1,0,0,0,1,1,3,33.3,2,2,0,2,0,1,0,0,MF,Under 20,Midfielder,Austria,Europe
219,Paul Baysse,FRA,Bordeaux,Ligue 1,2018,30.0,1988.0,0.8,1,0,1,0,0,0,1,0.0,1,1,1,0,1,2,6,0,DF,30-34,Defender,France,Europe
220,Paul Baysse,FRA,Caen,Ligue 1,2018,30.0,1988.0,19.9,25,14,20,5,0,13,18,72.2,5,25,20,5,31,56,113,1,DF,30-34,Defender,France,Europe
221,Noah Joel Sarenren Bazee,NGA,Hannover 96,Bundesliga,2018,21.0,1996.0,1.7,0,0,0,0,0,0,0,,0,1,0,1,0,0,3,0,"FW,MF",20-24,Forward,Nigeria,Africa
223,Bebé,CPV,Rayo Vallecano,La Liga,2018,28.0,1990.0,14.5,19,9,10,4,5,9,19,47.4,10,16,1,15,9,28,16,1,"FW,MF",25-29,Forward,Cape Verde,Africa
224,Bebé,CPV,Eibar,La Liga,2018,28.0,1990.0,0.7,0,0,0,0,0,0,0,,0,1,0,1,1,1,0,0,MF,25-29,Midfielder,Cape Verde,Africa
226,Uffe Bech,DEN,Hannover 96,Bundesliga,2018,25.0,1993.0,0.2,0,0,0,0,0,0,1,0.0,1,0,0,0,0,0,0,0,FW,25-29,Forward,Denmark,Europe
227,Andreas Beck,GER,Stuttgart,Bundesliga,2018,31.0,1987.0,19.7,35,19,17,17,1,11,27,40.7,16,32,6,26,22,57,54,0,DF,30-34,Defender,Germany,Europe
229,Andrea Beghetto,ITA,Frosinone,Serie A,2018,23.0,1994.0,24.7,26,14,13,10,3,15,25,60.0,10,20,4,16,17,43,59,0,DF,20-24,Defender,Italy,Europe
230,Asmir Begović,BIH,Bournemouth,Premier League,2018,31.0,1987.0,24.0,0,0,0,0,0,0,3,0.0,3,1,0,1,1,1,15,7,GK,30-34,Goalkeeper,Bosnia and Herzegovina,Europe
231,Valon Behrami,SUI,Udinese,Serie A,2018,33.0,1985.0,15.1,65,38,25,34,6,18,44,40.9,26,29,12,17,18,83,26,0,MF,30-34,Midfielder,Switzerland,Europe
232,Hanno Behrens,GER,Nürnberg,Bundesliga,2018,28.0,1990.0,29.3,46,26,29,17,0,21,47,44.7,26,43,13,30,33,79,49,0,MF,25-29,Midfielder,Germany,Europe
233,Ishak Belfodil,ALG,Hoffenheim,Bundesliga,2018,26.0,1992.0,20.7,13,10,5,6,2,4,16,25.0,12,6,0,6,3,16,14,0,"FW,MF",25-29,Forward,Algeria,Africa
234,Stefan Bell,GER,Mainz 05,Bundesliga,2018,26.0,1991.0,25.0,31,20,18,13,0,15,34,44.1,19,31,11,20,54,85,122,1,DF,25-29,Defender,Germany,Europe
235,Karim Bellarabi,GER,Leverkusen,Bundesliga,2018,28.0,1990.0,11.7,13,6,7,4,2,3,19,15.8,16,13,0,13,10,23,8,0,FW,25-29,Forward,Germany,Europe
237,Andrea Belotti,ITA,Torino,Serie A,2018,24.0,1993.0,36.7,33,22,8,15,10,6,30,20.0,24,36,5,31,15,48,23,0,FW,20-24,Forward,Italy,Europe
239,Hatem Ben Arfa,FRA,Rennes,Ligue 1,2018,31.0,1987.0,22.6,15,7,4,8,3,7,16,43.8,9,9,0,9,4,19,0,0,"FW,MF",30-34,Forward,France,Europe
240,Wissam Ben Yedder,FRA,Sevilla,La Liga,2018,27.0,1990.0,31.2,18,16,3,11,4,2,12,16.7,10,18,0,18,11,29,2,0,FW,25-29,Forward,France,Europe
241,Diego Benaglio,SUI,Monaco,Ligue 1,2018,34.0,1983.0,22.9,1,0,1,0,0,1,1,100.0,0,0,0,0,0,1,16,0,GK,30-34,Goalkeeper,Switzerland,Europe
242,Marco Benassi,ITA,Fiorentina,Serie A,2018,23.0,1994.0,25.4,30,19,8,15,7,14,41,34.1,27,16,3,13,9,39,27,1,MF,20-24,Midfielder,Italy,Europe
243,Medhi Benatia,MAR,Juventus,Serie A,2018,31.0,1987.0,5.0,7,6,6,1,0,3,5,60.0,2,10,5,5,16,23,18,0,DF,30-34,Defender,Morocco,Africa
244,Lars Bender,GER,Leverkusen,Bundesliga,2018,29.0,1989.0,15.1,43,29,20,20,3,18,35,51.4,17,26,4,22,21,64,26,0,"MF,DF",25-29,Midfielder,Germany,Europe
245,Sven Bender,GER,Leverkusen,Bundesliga,2018,29.0,1989.0,22.1,40,25,25,15,0,18,30,60.0,12,31,14,17,52,92,98,0,DF,25-29,Defender,Germany,Europe
246,László Bénes,SVK,Gladbach,Bundesliga,2018,20.0,1997.0,0.3,3,1,3,0,0,3,3,100.0,0,1,0,1,0,3,0,0,"MF,FW",20-24,Midfielder,Slovakia,Europe
247,Nicolas Benezet,FRA,Guingamp,Ligue 1,2018,27.0,1991.0,18.5,32,19,14,15,3,5,19,26.3,14,12,0,12,19,51,4,0,"MF,FW",25-29,Midfielder,France,Europe
248,Walter Benítez,ARG,Nice,Ligue 1,2018,25.0,1993.0,35.0,1,0,1,0,0,1,2,50.0,1,0,0,0,2,3,6,2,GK,25-29,Goalkeeper,Argentina,South America
249,Ismaël Bennacer,ALG,Empoli,Serie A,2018,20.0,1997.0,32.9,94,57,43,41,10,32,75,42.7,43,38,9,29,57,151,34,0,MF,20-24,Midfielder,Algeria,Africa
250,Joe Bennett,ENG,Cardiff City,Premier League,2018,28.0,1990.0,29.3,50,29,34,16,0,22,38,57.9,16,30,8,22,60,110,93,0,DF,25-29,Defender,England,Europe
251,Ryan Bennett,ENG,Wolves,Premier League,2018,28.0,1990.0,34.0,58,32,41,16,1,25,41,61.0,16,42,21,21,43,101,131,1,DF,25-29,Defender,England,Europe
252,Yassine Benrahou,FRA,Bordeaux,Ligue 1,2018,19.0,1999.0,2.0,9,6,1,7,1,2,5,40.0,3,4,0,4,2,11,1,0,"MF,FW",Under 20,Midfielder,France,Europe
253,Ramy Bensebaini,ALG,Rennes,Ligue 1,2018,23.0,1995.0,23.9,69,48,42,19,8,40,58,69.0,18,24,10,14,41,110,98,0,DF,20-24,Defender,Algeria,Africa
254,Nabil Bentaleb,ALG,Schalke 04,Bundesliga,2018,23.0,1994.0,19.9,32,17,8,21,3,4,18,22.2,14,28,8,20,35,67,19,0,MF,20-24,Midfielder,Algeria,Africa
255,Rodrigo Bentancur,URU,Juventus,Serie A,2018,21.0,1997.0,22.3,53,34,22,29,2,18,39,46.2,21,20,8,12,43,96,42,1,MF,20-24,Midfielder,Uruguay,South America
256,Christian Benteke,BEL,Crystal Palace,Premier League,2018,27.0,1990.0,9.0,5,1,0,4,1,1,4,25.0,3,7,2,5,0,5,14,0,FW,25-29,Forward,Belgium,Europe
257,Karim Benzema,FRA,Real Madrid,La Liga,2018,30.0,1987.0,32.8,24,11,2,11,11,2,17,11.8,15,16,1,15,8,32,25,0,FW,30-34,Forward,France,Europe
258,Yassine Benzia,ALG,Lille,Ligue 1,2018,23.0,1994.0,1.8,1,1,0,1,0,1,1,100.0,0,0,0,0,1,2,1,0,MF,20-24,Midfielder,Algeria,Africa
259,Domenico Berardi,ITA,Sassuolo,Serie A,2018,23.0,1994.0,31.9,38,21,16,9,13,15,73,20.5,58,31,2,29,27,65,24,0,"FW,MF",20-24,Forward,Italy,Europe
263,Jóhann Berg Guðmundsson,ISL,Burnley,Premier League,2018,27.0,1990.0,19.5,27,11,14,10,3,16,34,47.1,18,25,4,21,33,60,34,0,MF,25-29,Midfielder,Iceland,Europe
266,Etrit Berisha,ALB,Atalanta,Serie A,2018,29.0,1989.0,18.0,0,0,0,0,0,0,2,0.0,2,0,0,0,0,0,5,3,GK,25-29,Goalkeeper,Albania,Europe
268,Bernard,BRA,Everton,Premier League,2018,25.0,1992.0,23.5,49,30,19,22,8,15,55,27.3,40,37,2,35,27,76,14,1,"FW,MF",25-29,Forward,Brazil,South America
269,Federico Bernardeschi,ITA,Juventus,Serie A,2018,24.0,1994.0,16.4,14,8,5,6,3,7,18,38.9,11,9,0,9,6,20,10,0,"MF,FW",20-24,Midfielder,Italy,Europe
270,Bernardo,BRA,Brighton,Premier League,2018,23.0,1995.0,19.5,62,43,43,13,6,31,45,68.9,14,32,13,19,34,96,82,0,DF,20-24,Defender,Brazil,South America
270,Bernardo,BRA,Brighton,Premier League,2018,23.0,1995.0,19.5,62,43,43,13,6,31,45,68.9,14,32,13,19,34,96,82,0,DF,20-24,Defender,Brazil,South America
270,Bernardo,BRA,Brighton,Premier League,2018,23.0,1995.0,19.5,62,43,43,13,6,31,45,68.9,14,32,13,19,34,96,82,0,DF,20-24,Defender,Brazil,South America
270,Bernardo,BRA,Brighton,Premier League,2018,23.0,1995.0,19.5,62,43,43,13,6,31,45,68.9,14,32,13,19,34,96,82,0,DF,20-24,Defender,Brazil,South America
271,Paul Bernardoni,FRA,Nîmes,Ligue 1,2018,21.0,1997.0,38.0,1,1,1,0,0,1,2,50.0,1,0,0,0,1,2,20,1,GK,20-24,Goalkeeper,France,Europe
273,Antoine Bernede,FRA,Paris S-G,Ligue 1,2018,19.0,1999.0,1.9,13,7,3,8,2,5,9,55.6,4,3,1,2,3,16,1,1,MF,Under 20,Midfielder,France,Europe
274,Dimitry Bertaud,COD,Montpellier,Ligue 1,2018,20.0,1998.0,1.0,0,0,0,0,0,0,0,,0,0,0,0,0,0,0,0,GK,20-24,Goalkeeper,DR Congo,Africa
275,Ryan Bertrand,ENG,Southampton,Premier League,2018,28.0,1989.0,24.0,46,27,22,20,4,16,31,51.6,15,27,5,22,28,74,51,0,DF,25-29,Defender,England,Europe
276,Daniel Bessa,ITA,Genoa,Serie A,2018,25.0,1993.0,27.1,60,35,28,23,9,11,39,28.2,28,30,4,26,19,79,16,1,MF,25-29,Midfielder,Italy,Europe
277,Marcus Bettinelli,ENG,Fulham,Premier League,2018,26.0,1992.0,7.0,0,0,0,0,0,0,0,,0,0,0,0,0,0,5,0,GK,25-29,Goalkeeper,England,Europe
278,Jordan Beyer,GER,Gladbach,Bundesliga,2018,18.0,2000.0,8.0,32,18,21,10,1,17,24,70.8,7,12,6,6,11,43,32,0,DF,Under 20,Defender,Germany,Europe
279,Jonathan Biabiany,FRA,Parma,Serie A,2018,30.0,1988.0,11.9,30,22,18,10,2,9,17,52.9,8,8,1,7,11,41,11,1,FW,30-34,Forward,France,Europe
280,Giulian Biancone,FRA,Monaco,Ligue 1,2018,18.0,2000.0,1.0,4,3,4,0,0,1,3,33.3,2,0,0,0,3,7,2,0,DF,Under 20,Defender,France,Europe
281,Ermin Bičakčić,BIH,Hoffenheim,Bundesliga,2018,28.0,1990.0,19.9,32,19,18,11,3,13,22,59.1,9,36,15,21,56,88,79,1,DF,25-29,Defender,Bosnia and Herzegovina,Europe
283,Lucas Biglia,ARG,Milan,Serie A,2018,32.0,1986.0,12.4,60,33,31,25,4,20,45,44.4,25,19,3,16,22,82,21,1,MF,30-34,Midfielder,Argentina,South America
284,Philip Billing,DEN,Huddersfield,Premier League,2018,22.0,1996.0,24.3,73,44,26,39,8,19,42,45.2,23,57,16,41,53,126,43,0,MF,20-24,Midfielder,Denmark,Europe
285,Cristiano Biraghi,ITA,Fiorentina,Serie A,2018,25.0,1992.0,35.5,52,33,31,17,4,18,38,47.4,20,40,17,23,44,96,113,0,DF,25-29,Defender,Italy,Europe
286,Davide Biraschi,ITA,Genoa,Serie A,2018,24.0,1994.0,31.6,58,38,37,19,2,25,42,59.5,17,32,13,19,64,122,107,1,DF,20-24,Defender,Italy,Europe
289,Yves Bissouma,MLI,Brighton,Premier League,2018,21.0,1996.0,19.7,62,30,33,27,2,20,38,52.6,18,21,5,16,33,95,29,2,MF,20-24,Midfielder,Mali,Africa
290,Leonardo Bittencourt,GER,Hoffenheim,Bundesliga,2018,24.0,1993.0,11.9,37,26,9,22,6,8,32,25.0,24,22,1,21,13,50,7,0,MF,20-24,Midfielder,Germany,Europe
293,Ludovic Blas,FRA,Guingamp,Ligue 1,2018,20.0,1997.0,26.4,62,38,22,32,8,20,43,46.5,23,44,7,37,26,88,14,0,"MF,FW",20-24,Midfielder,France,Europe
294,Pablo de Blasis,ARG,Eibar,La Liga,2018,30.0,1988.0,16.9,32,19,17,8,7,12,32,37.5,20,18,0,18,13,45,20,0,"DF,MF",30-34,Defender,Argentina,South America
295,Pablo de Blasis,ARG,Mainz 05,Bundesliga,2018,30.0,1988.0,1.0,2,0,0,1,1,2,3,66.7,1,0,0,0,1,3,0,0,FW,30-34,Forward,Argentina,South America
296,Alexis Blin,FRA,Amiens,Ligue 1,2018,21.0,1996.0,22.1,77,45,33,36,8,35,89,39.3,54,39,14,25,33,110,48,1,MF,20-24,Midfielder,France,Europe
297,Danny Blum,GER,Eint Frankfurt,Bundesliga,2018,27.0,1991.0,0.0,0,0,0,0,0,0,0,,0,0,0,0,0,0,5,0,MF,25-29,Midfielder,Germany,Europe
298,Emmanuel Boateng,GHA,Levante,La Liga,2018,22.0,1996.0,7.8,4,3,0,0,4,0,3,0.0,3,5,0,5,1,5,7,0,FW,20-24,Forward,Ghana,Africa
298,Emmanuel Boateng,GHA,Levante,La Liga,2018,22.0,1996.0,7.8,4,3,0,0,4,0,3,0.0,3,5,0,5,1,5,7,0,FW,20-24,Forward,Ghana,Africa
298,Emmanuel Boateng,GHA,Levante,La Liga,2018,22.0,1996.0,7.8,4,3,0,0,4,0,3,0.0,3,5,0,5,1,5,7,0,FW,20-24,Forward,Ghana,Africa
298,Emmanuel Boateng,GHA,Levante,La Liga,2018,22.0,1996.0,7.8,4,3,0,0,4,0,3,0.0,3,5,0,5,1,5,7,0,FW,20-24,Forward,Ghana,Africa
299,Jérôme Boateng,GER,Bayern Munich,Bundesliga,2018,29.0,1988.0,18.8,21,15,12,9,0,10,22,45.5,12,8,3,5,25,46,49,0,DF,25-29,Defender,Germany,Europe
300,Kevin-Prince Boateng,GHA,Sassuolo,Serie A,2018,31.0,1987.0,10.4,5,4,0,4,1,1,4,25.0,3,7,3,4,3,8,13,0,FW,30-34,Forward,Ghana,Africa
301,Kevin-Prince Boateng,GHA,Barcelona,La Liga,2018,31.0,1987.0,2.7,3,2,0,1,2,0,1,0.0,1,1,0,1,1,4,4,0,FW,30-34,Forward,Ghana,Africa
302,Antonin Bobichon,FRA,Nîmes,Ligue 1,2018,22.0,1995.0,23.9,34,16,17,12,5,16,58,27.6,42,15,3,12,15,49,13,0,MF,20-24,Midfielder,France,Europe
303,Yann Bodiger,FRA,Toulouse,Ligue 1,2018,23.0,1995.0,0.1,0,0,0,0,0,0,1,0.0,1,0,0,0,0,0,0,0,MF,20-24,Midfielder,France,Europe
304,Mathieu Bodmer,FRA,Amiens,Ligue 1,2018,35.0,1982.0,11.9,15,11,3,11,1,3,10,30.0,7,3,0,3,2,17,10,0,"MF,FW",35-39,Midfielder,France,Europe
305,Adam Bodzek,GER,Düsseldorf,Bundesliga,2018,32.0,1985.0,17.7,44,27,27,16,1,17,43,39.5,26,15,6,9,26,70,39,0,"MF,DF",30-34,Midfielder,Germany,Europe
306,Jean-Paul Boëtius,NED,Mainz 05,Bundesliga,2018,24.0,1994.0,23.6,51,32,21,25,5,16,44,36.4,28,59,2,57,37,88,13,0,MF,20-24,Midfielder,Netherlands,Europe
307,Sacha Boey,FRA,Rennes,Ligue 1,2018,17.0,2000.0,0.2,0,0,0,0,0,0,0,,0,0,0,0,0,0,0,0,DF,Under 20,Defender,France,Europe
308,Jeremie Boga,CIV,Sassuolo,Serie A,2018,21.0,1997.0,16.0,7,4,5,1,1,4,14,28.6,10,19,0,19,2,9,4,0,"FW,MF",20-24,Forward,Ivory Coast,Africa
309,Willy Boly,CIV,Wolves,Premier League,2018,27.0,1991.0,35.2,85,52,49,34,2,34,56,60.7,22,55,32,23,72,157,177,6,DF,25-29,Defender,Ivory Coast,Africa
310,Léo Bonatini,BRA,Wolves,Premier League,2018,24.0,1994.0,1.5,1,1,0,0,1,1,5,20.0,4,1,0,1,0,1,0,0,FW,20-24,Forward,Brazil,South America
311,Giacomo Bonaventura,ITA,Milan,Serie A,2018,28.0,1989.0,7.2,6,2,2,4,0,2,7,28.6,5,3,0,3,7,13,8,0,MF,25-29,Midfielder,Italy,Europe
312,Daniele Bonera,ITA,Villarreal,La Liga,2018,37.0,1981.0,2.6,2,2,2,0,0,1,1,100.0,0,5,5,0,4,6,10,0,DF,35-39,Defender,Italy,Europe
313,Gaëtan Bong,CMR,Brighton,Premier League,2018,30.0,1988.0,20.1,16,10,7,6,3,6,10,60.0,4,16,6,10,25,41,57,2,DF,30-34,Defender,Cameroon,Africa
314,Kevin Bonifazi,ITA,SPAL,Serie A,2018,22.0,1996.0,25.6,40,24,31,8,1,15,33,45.5,18,38,21,17,36,76,79,0,DF,20-24,Defender,Italy,Europe
315,Leonardo Bonucci,ITA,Juventus,Serie A,2018,31.0,1987.0,27.5,18,9,11,6,1,10,13,76.9,3,32,21,11,38,56,88,3,DF,30-34,Defender,Italy,Europe
316,Fabio Borini,ITA,Milan,Serie A,2018,27.0,1991.0,11.7,14,10,7,7,0,3,9,33.3,6,17,0,17,12,26,28,0,"FW,DF",25-29,Forward,Italy,Europe
317,Robin Bormuth,GER,Düsseldorf,Bundesliga,2018,22.0,1995.0,6.8,7,4,7,0,0,5,10,50.0,5,6,4,2,10,17,49,1,DF,20-24,Defender,Germany,Europe
319,Olivier Boscagli,FRA,Nice,Ligue 1,2018,20.0,1997.0,9.6,20,12,14,4,2,9,20,45.0,11,12,1,11,17,37,37,0,DF,20-24,Defender,France,Europe
320,Gabriel Boschilia,BRA,Nantes,Ligue 1,2018,22.0,1996.0,14.7,33,23,11,9,13,8,33,24.2,25,14,2,12,8,41,7,0,"FW,MF",20-24,Forward,Brazil,South America
321,John Bostock,TRI,Toulouse,Ligue 1,2018,26.0,1992.0,10.9,24,14,14,10,0,9,30,30.0,21,12,2,10,17,41,11,0,MF,25-29,Midfielder,Trinidad and Tobago,North America
322,Denis Bouanga,GAB,Nîmes,Ligue 1,2018,23.0,1994.0,29.3,52,32,21,22,9,13,61,21.3,48,24,3,21,20,72,16,0,"MF,FW",20-24,Midfielder,Gabon,Africa
323,Zacharie Boucher,FRA,Angers,Ligue 1,2018,26.0,1992.0,2.0,0,0,0,0,0,0,0,,0,1,0,1,0,0,1,0,GK,25-29,Goalkeeper,France,Europe
324,Ryad Boudebouz,ALG,Celta Vigo,La Liga,2018,28.0,1990.0,8.0,14,4,4,6,4,3,8,37.5,5,9,1,8,3,17,9,0,"MF,FW",25-29,Midfielder,Algeria,Africa
325,Ryad Boudebouz,ALG,Betis,La Liga,2018,28.0,1990.0,6.0,8,4,4,1,3,4,10,40.0,6,5,1,4,5,13,2,0,"MF,FW",25-29,Midfielder,Algeria,Africa
326,Sofiane Boufal,MAR,Celta Vigo,La Liga,2018,24.0,1993.0,23.2,35,21,18,11,6,15,47,31.9,32,24,0,24,10,45,12,0,"MF,FW",20-24,Midfielder,Morocco,Africa
327,Nassim Boujellab,MAR,Schalke 04,Bundesliga,2018,19.0,1999.0,4.2,10,4,3,6,1,3,11,27.3,8,6,0,6,2,12,3,0,MF,Under 20,Midfielder,Morocco,Africa
328,Arnold Bouka Moutou,CGO,Dijon,Ligue 1,2018,29.0,1988.0,0.7,3,1,2,1,0,0,4,0.0,4,1,0,1,3,6,1,0,"DF,FW",25-29,Defender,Congo,Africa
329,Yassine Bounou,MAR,Girona,La Liga,2018,27.0,1991.0,31.8,0,0,0,0,0,0,2,0.0,2,0,0,0,1,1,7,2,GK,25-29,Goalkeeper,Morocco,Africa
330,Mehdi Bourabia,MAR,Sassuolo,Serie A,2018,26.0,1991.0,22.3,51,28,23,21,7,15,46,32.6,31,28,5,23,33,84,32,0,MF,25-29,Midfielder,Morocco,Africa
331,Benjamin Bourigeaud,FRA,Rennes,Ligue 1,2018,24.0,1994.0,26.9,55,35,23,21,11,20,67,29.9,47,44,5,39,32,87,34,1,"MF,FW",20-24,Midfielder,France,Europe
332,Bilal Boutobba,FRA,Montpellier,Ligue 1,2018,19.0,1998.0,0.4,0,0,0,0,0,0,2,0.0,2,0,0,0,0,0,0,0,"FW,MF",Under 20,Forward,France,Europe
333,Umut Bozok,TUR,Nîmes,Ligue 1,2018,21.0,1996.0,13.7,9,6,0,3,6,2,4,50.0,2,3,0,3,5,14,1,0,FW,20-24,Forward,Turkey,Asia
334,Filip Bradarić,CRO,Cagliari,Serie A,2018,26.0,1992.0,16.6,26,21,11,12,3,10,20,50.0,10,13,3,10,39,65,50,0,MF,25-29,Midfielder,Croatia,Europe
335,Robbie Brady,IRL,Burnley,Premier League,2018,26.0,1992.0,8.0,15,7,5,5,5,6,17,35.3,11,7,1,6,7,22,18,1,MF,25-29,Midfielder,Republic of Ireland,Europe
336,Martin Braithwaite,DEN,Leganés,La Liga,2018,27.0,1991.0,15.6,5,3,0,0,5,0,4,0.0,4,9,0,9,3,8,4,0,FW,25-29,Forward,Denmark,Europe
337,Julian Brandt,GER,Leverkusen,Bundesliga,2018,22.0,1996.0,29.6,27,16,13,10,4,7,43,16.3,36,27,1,26,17,44,12,1,"MF,FW",20-24,Midfielder,Germany,Europe
339,Pedro Brazão,POR,Nice,Ligue 1,2018,15.0,2002.0,0.2,0,0,0,0,0,0,1,0.0,1,0,0,0,0,0,0,0,"MF,FW",Under 20,Midfielder,Portugal,Europe
340,Fabian Bredlow,GER,Nürnberg,Bundesliga,2018,23.0,1995.0,12.5,1,1,1,0,0,1,1,100.0,0,0,0,0,1,2,3,4,GK,20-24,Goalkeeper,Germany,Europe
341,Josip Brekalo,CRO,Wolfsburg,Bundesliga,2018,20.0,1998.0,15.7,15,7,7,6,2,5,18,27.8,13,15,1,14,12,27,9,1,"FW,MF",20-24,Forward,Croatia,Europe
342,Gleison Bremer,BRA,Torino,Serie A,2018,21.0,1997.0,2.0,3,1,1,2,0,1,2,50.0,1,4,1,3,8,11,9,0,DF,20-24,Defender,Brazil,South America
343,Joshua Brenet,CUW,Hoffenheim,Bundesliga,2018,24.0,1994.0,10.1,20,13,12,5,3,7,13,53.8,6,16,1,15,8,28,19,0,DF,20-24,Defender,Curaçao,Europe
345,Anthony Briançon,FRA,Nîmes,Ligue 1,2018,23.0,1994.0,32.5,46,27,36,10,0,27,50,54.0,23,51,38,13,70,116,184,1,DF,20-24,Defender,France,Europe
346,Jimmy Briand,FRA,Bordeaux,Ligue 1,2018,32.0,1985.0,27.7,14,8,2,10,2,4,24,16.7,20,14,6,8,4,18,29,0,FW,30-34,Forward,France,Europe
347,Nicolò Brighenti,ITA,Frosinone,Serie A,2018,28.0,1989.0,11.0,27,17,9,15,3,6,14,42.9,8,17,8,9,31,58,37,0,DF,25-29,Defender,Italy,Europe
348,Matteo Brighi,ITA,Empoli,Serie A,2018,37.0,1981.0,2.6,11,4,2,9,0,2,9,22.2,7,2,0,2,3,14,4,0,MF,35-39,Midfielder,Italy,Europe
349,Enrico Brignola,ITA,Sassuolo,Serie A,2018,19.0,1999.0,1.9,2,2,2,0,0,0,2,0.0,2,0,0,0,1,3,1,0,"FW,MF",Under 20,Forward,Italy,Europe
350,Miguel Britos,URU,Watford,Premier League,2018,33.0,1985.0,2.1,4,2,4,0,0,2,4,50.0,2,1,1,0,3,7,11,1,DF,30-34,Defender,Uruguay,South America
351,David Brooks,WAL,Bournemouth,Premier League,2018,21.0,1997.0,25.1,37,26,12,19,6,19,44,43.2,25,36,7,29,24,61,28,0,"MF,FW",20-24,Midfielder,Wales,Europe
352,John Brooks,USA,Wolfsburg,Bundesliga,2018,25.0,1993.0,29.0,29,15,18,9,2,13,27,48.1,14,28,13,15,37,66,135,3,DF,25-29,Defender,United States,North America
353,Daniel Brosinski,GER,Mainz 05,Bundesliga,2018,30.0,1988.0,24.5,27,16,16,10,1,18,33,54.5,15,30,9,21,26,53,58,0,DF,30-34,Defender,Germany,Europe
354,Marcelo Brozović,CRO,Inter,Serie A,2018,25.0,1992.0,29.4,101,70,47,40,14,31,86,36.0,55,45,8,37,44,145,32,3,MF,25-29,Midfielder,Croatia,Europe
355,Bruma,POR,RB Leipzig,Bundesliga,2018,23.0,1994.0,6.1,5,2,3,1,1,1,5,20.0,4,4,0,4,4,9,2,0,MF,20-24,Midfielder,Portugal,Europe
356,Jeffrey Bruma,NED,Schalke 04,Bundesliga,2018,26.0,1991.0,6.9,12,11,8,4,0,6,12,50.0,6,8,2,6,4,16,35,0,DF,25-29,Defender,Netherlands,Europe
358,Jacob Bruun Larsen,DEN,Dortmund,Bundesliga,2018,19.0,1998.0,14.1,15,9,8,2,5,7,17,41.2,10,15,1,14,13,28,12,0,FW,Under 20,Forward,Denmark,Europe
359,Joe Bryan,ENG,Fulham,Premier League,2018,24.0,1993.0,26.1,61,41,35,21,5,24,42,57.1,18,34,12,22,31,92,82,1,"DF,MF",20-24,Defender,England,Europe
360,Gianluigi Buffon,ITA,Paris S-G,Ligue 1,2018,40.0,1978.0,17.0,0,0,0,0,0,0,1,0.0,1,0,0,0,0,0,5,0,GK,Over 40,Goalkeeper,Italy,Europe
361,Niko Bungert,GER,Mainz 05,Bundesliga,2018,31.0,1986.0,3.2,7,5,5,2,0,5,5,100.0,0,7,6,1,4,11,16,0,DF,30-34,Defender,Germany,Europe
362,Guido Burgstaller,AUT,Schalke 04,Bundesliga,2018,29.0,1989.0,17.0,11,9,2,5,4,3,8,37.5,5,5,0,5,2,13,10,0,FW,25-29,Forward,Austria,Europe
364,Jonathan Burkardt,GER,Mainz 05,Bundesliga,2018,18.0,2000.0,2.9,4,4,2,1,1,1,2,50.0,1,2,0,2,3,7,5,0,"FW,MF",Under 20,Forward,Germany,Europe
365,Roman Bürki,SUI,Dortmund,Bundesliga,2018,27.0,1990.0,32.0,1,0,1,0,0,1,2,50.0,1,1,0,1,2,3,8,4,GK,25-29,Goalkeeper,Switzerland,Europe
368,Gaëtan Bussmann,FRA,Mainz 05,Bundesliga,2018,27.0,1991.0,1.0,2,1,2,0,0,2,5,40.0,3,0,0,0,1,3,2,0,DF,25-29,Defender,France,Europe
370,Ludovic Butelle,FRA,Angers,Ligue 1,2018,35.0,1983.0,36.0,1,0,1,0,0,1,1,100.0,0,0,0,0,1,2,31,1,GK,35-39,Goalkeeper,France,Europe
371,David Button,ENG,Brighton,Premier League,2018,29.0,1989.0,4.0,0,0,0,0,0,0,0,,0,0,0,0,0,0,2,0,GK,25-29,Goalkeeper,England,Europe
373,Erick Cabaco,URU,Levante,La Liga,2018,23.0,1995.0,18.1,22,13,19,3,0,12,29,41.4,17,29,14,15,29,51,69,0,DF,20-24,Defender,Uruguay,South America
374,Willy Caballero,ARG,Chelsea,Premier League,2018,36.0,1981.0,2.0,0,0,0,0,0,0,0,,0,0,0,0,0,0,1,0,GK,35-39,Goalkeeper,Argentina,South America
375,Rémy Cabella,FRA,Saint-Étienne,Ligue 1,2018,28.0,1990.0,33.3,88,51,31,38,19,30,87,34.5,57,39,1,38,19,107,5,3,"MF,FW",25-29,Midfielder,France,Europe
376,Gustavo Cabral,ARG,Celta Vigo,La Liga,2018,32.0,1985.0,21.1,37,26,28,7,2,17,27,63.0,10,31,11,20,33,70,102,1,DF,30-34,Defender,Argentina,South America
377,Rafael Cabral,BRA,Sampdoria,Serie A,2018,28.0,1990.0,2.0,0,0,0,0,0,0,0,,0,0,0,0,0,0,0,0,GK,25-29,Goalkeeper,Brazil,South America
378,Leandro Cabrera,URU,Getafe,La Liga,2018,27.0,1991.0,31.0,47,26,28,17,2,24,41,58.5,17,29,16,13,52,99,216,2,DF,25-29,Defender,Uruguay,South America
379,Fabrizio Cacciatore,ITA,Cagliari,Serie A,2018,31.0,1986.0,6.4,9,7,7,0,2,1,5,20.0,4,6,4,2,7,16,17,0,DF,30-34,Defender,Italy,Europe
380,Fabrizio Cacciatore,ITA,Chievo,Serie A,2018,31.0,1986.0,5.5,8,4,6,2,0,4,9,44.4,5,8,2,6,5,13,20,0,DF,30-34,Defender,Italy,Europe
381,Martín Cáceres,URU,Lazio,Serie A,2018,31.0,1987.0,3.4,4,2,3,1,0,4,6,66.7,2,4,0,4,0,4,12,1,DF,30-34,Defender,Uruguay,South America
382,Martín Cáceres,URU,Juventus,Serie A,2018,31.0,1987.0,7.0,7,3,6,0,1,4,4,100.0,0,6,3,3,4,11,14,0,DF,30-34,Defender,Uruguay,South America
383,Anthony Caci,FRA,Strasbourg,Ligue 1,2018,21.0,1997.0,25.5,56,30,38,14,4,24,46,52.2,22,20,10,10,47,103,63,0,DF,20-24,Defender,France,Europe
384,Mathieu Cafaro,FRA,Reims,Ligue 1,2018,21.0,1997.0,23.3,59,28,29,24,6,18,63,28.6,45,28,0,28,20,79,14,0,"FW,MF",20-24,Forward,France,Europe
385,Gary Cahill,ENG,Chelsea,Premier League,2018,32.0,1985.0,0.3,0,0,0,0,0,0,0,,0,0,0,0,0,0,1,0,DF,30-34,Defender,England,Europe
386,Yannick Cahuzac,FRA,Toulouse,Ligue 1,2018,33.0,1985.0,15.9,33,19,15,15,3,17,32,53.1,15,16,4,12,24,57,55,0,"MF,DF",30-34,Midfielder,France,Europe
387,Felipe Caicedo,ECU,Lazio,Serie A,2018,29.0,1988.0,15.2,16,12,4,6,6,1,8,12.5,7,9,2,7,5,21,5,0,FW,25-29,Forward,Ecuador,South America
388,Marc-Aurèle Caillard,FRA,Guingamp,Ligue 1,2018,24.0,1994.0,21.0,0,0,0,0,0,0,2,0.0,2,0,0,0,2,2,8,3,GK,20-24,Goalkeeper,France,Europe
389,Tom Cairney,SCO,Fulham,Premier League,2018,27.0,1991.0,24.4,37,21,9,22,6,12,16,75.0,4,21,5,16,10,47,13,1,"MF,FW",25-29,Midfielder,Scotland,Europe
390,Caiuby,BRA,Augsburg,Bundesliga,2018,30.0,1988.0,11.2,12,10,5,6,1,3,11,27.3,8,16,1,15,5,17,10,0,"MF,FW",30-34,Midfielder,Brazil,South America
391,Arturo Calabresi,ITA,Bologna,Serie A,2018,22.0,1996.0,15.7,46,27,22,17,7,22,40,55.0,18,18,3,15,34,80,60,0,DF,20-24,Defender,Italy,Europe
392,Davide Calabria,ITA,Milan,Serie A,2018,21.0,1996.0,21.7,79,51,58,16,5,37,67,55.2,30,33,1,32,32,111,78,1,DF,20-24,Defender,Italy,Europe
395,Duje Ćaleta-Car,CRO,Marseille,Ligue 1,2018,21.0,1996.0,17.2,22,16,14,8,0,14,18,77.8,4,15,9,6,20,42,86,2,DF,20-24,Defender,Croatia,Europe
396,Hakan Çalhanoğlu,TUR,Milan,Serie A,2018,24.0,1994.0,32.0,52,31,27,16,9,23,46,50.0,23,27,5,22,28,80,19,0,"MF,FW",20-24,Midfielder,Turkey,Asia
397,Daniel Caligiuri,ITA,Schalke 04,Bundesliga,2018,30.0,1988.0,30.6,93,52,55,29,9,44,103,42.7,59,66,10,56,50,143,72,1,"DF,FW",30-34,Defender,Italy,Europe
399,Jonathan Calleri,ARG,Alavés,La Liga,2018,24.0,1993.0,31.9,20,13,3,11,6,1,24,4.2,23,34,7,27,7,27,53,0,FW,20-24,Forward,Argentina,South America
400,Jan-Ingwer Callsen-Bracker,GER,Augsburg,Bundesliga,2018,33.0,1984.0,0.1,0,0,0,0,0,0,0,,0,0,0,0,0,0,0,0,DF,30-34,Defender,Germany,Europe
401,Dominic Calvert-Lewin,ENG,Everton,Premier League,2018,21.0,1997.0,19.8,13,7,3,3,7,7,15,46.7,8,16,3,13,7,20,19,0,FW,20-24,Forward,England,Europe
404,Rafael Camacho,POR,Liverpool,Premier League,2018,18.0,2000.0,0.0,1,0,1,0,0,1,1,100.0,0,0,0,0,0,1,0,0,DF,Under 20,Defender,Portugal,Europe
405,Mahdi Camara,FRA,Saint-Étienne,Ligue 1,2018,20.0,1998.0,0.1,0,0,0,0,0,0,0,,0,0,0,0,0,0,2,0,FW,20-24,Forward,France,Europe
406,Souleymane Camara,SEN,Montpellier,Ligue 1,2018,35.0,1982.0,1.5,0,0,0,0,0,0,2,0.0,2,0,0,0,0,0,3,0,"FW,MF",35-39,Forward,Senegal,Africa
408,Eduardo Camavinga,FRA,Rennes,Ligue 1,2018,15.0,2002.0,4.0,23,15,8,12,3,8,18,44.4,10,13,2,11,4,27,4,0,MF,Under 20,Midfielder,France,Europe
411,Joel Campbell,CRC,Frosinone,Serie A,2018,26.0,1992.0,9.9,15,10,5,8,2,3,17,17.6,14,2,0,2,3,18,2,1,"FW,MF",25-29,Forward,Costa Rica,North America
412,Emre Can,GER,Juventus,Serie A,2018,24.0,1994.0,20.1,64,38,28,27,9,24,40,60.0,16,43,13,30,28,92,36,2,MF,20-24,Midfielder,Germany,Europe
414,João Cancelo,POR,Juventus,Serie A,2018,24.0,1994.0,21.9,43,28,18,18,7,27,49,55.1,22,14,4,10,15,58,48,0,DF,20-24,Defender,Portugal,Europe
415,Antonio Candreva,ITA,Inter,Serie A,2018,31.0,1987.0,5.6,1,1,0,1,0,1,8,12.5,7,0,0,0,4,5,9,0,"FW,MF",30-34,Forward,Italy,Europe
417,Luan Capanni,BRA,Lazio,Serie A,2018,18.0,2000.0,0.1,1,1,0,0,1,0,0,,0,0,0,0,0,1,0,0,FW,Under 20,Forward,Brazil,South America
418,Pierrick Capelle,FRA,Angers,Ligue 1,2018,31.0,1987.0,20.5,51,31,23,22,6,19,54,35.2,35,23,2,21,38,89,49,0,"DF,MF",30-34,Defender,France,Europe
419,Leonardo Capezzi,ITA,Empoli,Serie A,2018,23.0,1995.0,8.6,14,9,6,8,0,7,13,53.8,6,14,4,10,10,24,13,0,MF,20-24,Midfielder,Italy,Europe
420,Étienne Capoue,FRA,Watford,Premier League,2018,30.0,1988.0,32.7,91,56,36,48,7,33,87,37.9,54,50,13,37,85,176,96,1,MF,30-34,Midfielder,France,Europe
421,Gianluca Caprari,ITA,Sampdoria,Serie A,2018,25.0,1993.0,11.5,15,9,4,9,2,5,12,41.7,7,7,0,7,4,19,3,0,"FW,MF",25-29,Forward,Italy,Europe
422,Marco Capuano,ITA,Frosinone,Serie A,2018,26.0,1991.0,25.6,53,33,37,15,1,26,46,56.5,20,44,31,13,34,87,101,2,DF,25-29,Defender,Italy,Europe
423,Francesco Caputo,ITA,Empoli,Serie A,2018,30.0,1987.0,38.0,13,9,2,4,7,3,10,30.0,7,11,1,10,2,15,11,0,FW,30-34,Forward,Italy,Europe
424,Yoan Cardinale,FRA,Nice,Ligue 1,2018,24.0,1994.0,3.0,1,0,1,0,0,1,1,100.0,0,0,0,0,0,1,1,0,GK,20-24,Goalkeeper,France,Europe
426,Diego Carlos,BRA,Nantes,Ligue 1,2018,25.0,1993.0,35.0,58,34,43,14,1,26,33,78.8,7,44,31,13,50,108,186,1,DF,25-29,Defender,Brazil,South America
427,Jonas Carls,GER,Schalke 04,Bundesliga,2018,21.0,1997.0,1.0,5,2,4,0,1,5,5,100.0,0,0,0,0,1,6,0,0,FW,20-24,Forward,Germany,Europe
428,Louis Carnot,FRA,Guingamp,Ligue 1,2018,17.0,2001.0,0.1,0,0,0,0,0,0,0,,0,0,0,0,0,0,0,0,MF,Under 20,Midfielder,France,Europe
429,Lionel Carole,FRA,Strasbourg,Ligue 1,2018,27.0,1991.0,19.2,25,12,16,7,2,11,16,68.8,5,19,5,14,32,57,51,0,"DF,FW",25-29,Defender,France,Europe
430,Daniel Carriço,POR,Sevilla,La Liga,2018,29.0,1988.0,23.7,35,18,23,11,1,12,20,60.0,8,19,12,7,31,66,104,1,DF,25-29,Defender,Portugal,Europe
431,Guido Carrillo,ARG,Leganés,La Liga,2018,27.0,1991.0,22.1,25,14,4,12,9,6,19,31.6,13,12,1,11,8,33,25,0,FW,25-29,Forward,Argentina,South America
432,Andy Carroll,ENG,West Ham,Premier League,2018,29.0,1989.0,5.1,4,2,1,3,0,1,4,25.0,3,3,2,1,1,5,8,0,FW,25-29,Forward,England,Europe
434,William Carvalho,POR,Betis,La Liga,2018,26.0,1992.0,26.5,45,27,20,21,4,16,29,55.2,13,8,0,8,12,57,30,0,MF,25-29,Midfielder,Portugal,Europe
435,Casemiro,BRA,Real Madrid,La Liga,2018,26.0,1992.0,25.7,86,52,44,35,7,38,94,40.4,56,52,12,40,41,127,56,3,MF,25-29,Midfielder,Brazil,South America
436,Santiago Cáseres,ARG,Villarreal,La Liga,2018,21.0,1997.0,17.6,67,35,20,38,9,25,57,43.9,32,22,9,13,14,81,24,1,MF,20-24,Midfielder,Argentina,South America
437,Moreto Cassamã,GNB,Reims,Ligue 1,2018,20.0,1998.0,0.7,3,3,1,2,0,1,7,14.3,6,1,0,1,1,4,2,0,MF,20-24,Midfielder,Guinea-Bissau,Africa
438,Francesco Cassata,ITA,Frosinone,Serie A,2018,21.0,1997.0,12.5,20,11,12,4,4,9,23,39.1,14,8,1,7,6,26,15,1,MF,20-24,Midfielder,Italy,Europe
439,Timothy Castagne,BEL,Atalanta,Serie A,2018,22.0,1995.0,22.3,61,39,30,22,9,32,57,56.1,25,32,6,26,28,89,50,0,DF,20-24,Defender,Belgium,Europe
440,Koen Casteels,BEL,Wolfsburg,Bundesliga,2018,26.0,1992.0,25.5,1,0,1,0,0,1,2,50.0,1,1,0,1,0,1,11,1,GK,25-29,Goalkeeper,Belgium,Europe
442,Gonzalo Castro,GER,Stuttgart,Bundesliga,2018,31.0,1987.0,18.8,50,28,21,25,4,19,43,44.2,24,23,5,18,29,79,22,1,MF,30-34,Midfielder,Germany,Europe
444,Lucas Castro,ARG,Cagliari,Serie A,2018,29.0,1989.0,10.0,18,11,8,8,2,8,23,34.8,15,20,4,16,17,35,6,0,MF,25-29,Midfielder,Argentina,South America
445,Danilo Cataldi,ITA,Lazio,Serie A,2018,23.0,1994.0,6.4,12,7,4,5,3,2,9,22.2,7,3,0,3,7,19,6,0,"MF,FW",20-24,Midfielder,Italy,Europe
448,Ivan Cavaleiro,POR,Wolves,Premier League,2018,24.0,1993.0,7.7,5,4,3,1,1,1,14,7.1,13,12,0,12,4,9,5,0,"FW,MF",20-24,Forward,Portugal,Europe
449,Edinson Cavani,URU,Paris S-G,Ligue 1,2018,31.0,1987.0,18.6,11,8,1,4,6,3,13,23.1,10,11,2,9,6,17,16,0,FW,30-34,Forward,Uruguay,South America
452,Federico Ceccherini,ITA,Fiorentina,Serie A,2018,26.0,1992.0,11.0,13,10,8,3,2,5,9,55.6,4,12,8,4,21,34,40,0,DF,25-29,Defender,Italy,Europe
455,Zeki Çelik,TUR,Lille,Ligue 1,2018,21.0,1997.0,33.0,90,59,40,39,11,36,89,40.4,53,34,5,29,34,124,89,1,DF,20-24,Defender,Turkey,Asia
456,Luca Ceppitelli,ITA,Cagliari,Serie A,2018,28.0,1989.0,22.8,40,24,28,11,1,13,22,59.1,9,34,24,10,20,60,111,2,DF,25-29,Defender,Italy,Europe
457,Fabio Ceravolo,ITA,Parma,Serie A,2018,31.0,1987.0,13.2,5,1,2,1,2,1,11,9.1,10,9,1,8,2,7,19,0,FW,30-34,Forward,Italy,Europe
458,Alberto Cerri,ITA,Cagliari,Serie A,2018,22.0,1996.0,7.4,3,2,2,1,0,0,7,0.0,7,7,1,6,2,5,4,0,FW,20-24,Forward,Italy,Europe
460,Nacer Chadli,BEL,Monaco,Ligue 1,2018,28.0,1989.0,7.7,11,5,4,4,3,3,8,37.5,5,7,1,6,3,14,7,0,"MF,DF",25-29,Midfielder,Belgium,Europe
461,Fouad Chafik,MAR,Dijon,Ligue 1,2018,31.0,1986.0,20.5,44,31,29,12,3,23,36,63.9,13,17,3,14,25,69,71,0,DF,30-34,Defender,Morocco,Africa
462,Nathaniel Chalobah,ENG,Watford,Premier League,2018,23.0,1994.0,3.0,3,2,1,2,0,2,7,28.6,5,2,1,1,5,8,7,0,MF,20-24,Midfielder,England,Europe
463,Calum Chambers,ENG,Fulham,Premier League,2018,23.0,1995.0,28.8,64,36,32,27,5,16,48,33.3,32,37,12,25,69,133,113,4,"MF,DF",20-24,Midfielder,England,Europe
464,Timothy Chandler,USA,Eint Frankfurt,Bundesliga,2018,28.0,1990.0,0.2,0,0,0,0,0,0,0,,0,0,0,0,0,0,0,0,DF,25-29,Defender,United States,North America
465,Kwon Chang-hoon,KOR,Dijon,Ligue 1,2018,24.0,1994.0,10.4,7,4,3,2,2,0,12,0.0,12,16,0,16,8,15,8,0,"FW,MF",20-24,Forward,South Korea,Asia
466,Charles,BRA,Eibar,La Liga,2018,34.0,1984.0,19.3,7,5,1,3,3,2,13,15.4,11,14,1,13,4,11,14,0,FW,30-34,Forward,Brazil,South America
466,Charles,BRA,Eibar,La Liga,2018,34.0,1984.0,19.3,7,5,1,3,3,2,13,15.4,11,14,1,13,4,11,14,0,FW,30-34,Forward,Brazil,South America
466,Charles,BRA,Eibar,La Liga,2018,34.0,1984.0,19.3,7,5,1,3,3,2,13,15.4,11,14,1,13,4,11,14,0,FW,30-34,Forward,Brazil,South America
466,Charles,BRA,Eibar,La Liga,2018,34.0,1984.0,19.3,7,5,1,3,3,2,13,15.4,11,14,1,13,4,11,14,0,FW,30-34,Forward,Brazil,South America
466,Charles,BRA,Eibar,La Liga,2018,34.0,1984.0,19.3,7,5,1,3,3,2,13,15.4,11,14,1,13,4,11,14,0,FW,30-34,Forward,Brazil,South America
466,Charles,BRA,Eibar,La Liga,2018,34.0,1984.0,19.3,7,5,1,3,3,2,13,15.4,11,14,1,13,4,11,14,0,FW,30-34,Forward,Brazil,South America
466,Charles,BRA,Eibar,La Liga,2018,34.0,1984.0,19.3,7,5,1,3,3,2,13,15.4,11,14,1,13,4,11,14,0,FW,30-34,Forward,Brazil,South America
466,Charles,BRA,Eibar,La Liga,2018,34.0,1984.0,19.3,7,5,1,3,3,2,13,15.4,11,14,1,13,4,11,14,0,FW,30-34,Forward,Brazil,South America
466,Charles,BRA,Eibar,La Liga,2018,34.0,1984.0,19.3,7,5,1,3,3,2,13,15.4,11,14,1,13,4,11,14,0,FW,30-34,Forward,Brazil,South America
466,Charles,BRA,Eibar,La Liga,2018,34.0,1984.0,19.3,7,5,1,3,3,2,13,15.4,11,14,1,13,4,11,14,0,FW,30-34,Forward,Brazil,South America
466,Charles,BRA,Eibar,La Liga,2018,34.0,1984.0,19.3,7,5,1,3,3,2,13,15.4,11,14,1,13,4,11,14,0,FW,30-34,Forward,Brazil,South America
466,Charles,BRA,Eibar,La Liga,2018,34.0,1984.0,19.3,7,5,1,3,3,2,13,15.4,11,14,1,13,4,11,14,0,FW,30-34,Forward,Brazil,South America
466,Charles,BRA,Eibar,La Liga,2018,34.0,1984.0,19.3,7,5,1,3,3,2,13,15.4,11,14,1,13,4,11,14,0,FW,30-34,Forward,Brazil,South America
466,Charles,BRA,Eibar,La Liga,2018,34.0,1984.0,19.3,7,5,1,3,3,2,13,15.4,11,14,1,13,4,11,14,0,FW,30-34,Forward,Brazil,South America
466,Charles,BRA,Eibar,La Liga,2018,34.0,1984.0,19.3,7,5,1,3,3,2,13,15.4,11,14,1,13,4,11,14,0,FW,30-34,Forward,Brazil,South America
466,Charles,BRA,Eibar,La Liga,2018,34.0,1984.0,19.3,7,5,1,3,3,2,13,15.4,11,14,1,13,4,11,14,0,FW,30-34,Forward,Brazil,South America
467,Xavier Chavalerin,FRA,Reims,Ligue 1,2018,27.0,1991.0,36.0,106,61,56,39,11,28,72,38.9,44,44,12,32,72,178,39,1,MF,25-29,Midfielder,France,Europe
468,Pablo Chavarría,ARG,Reims,Ligue 1,2018,30.0,1988.0,21.9,20,12,8,6,6,3,15,20.0,12,11,0,11,4,24,19,0,FW,30-34,Forward,Argentina,South America
470,Pape Cheikh Diop,SEN,Lyon,Ligue 1,2018,20.0,1997.0,5.0,1,0,0,1,0,0,5,0.0,5,6,2,4,2,3,2,1,MF,20-24,Midfielder,Senegal,Africa
472,Denis Cheryshev,RUS,Valencia,La Liga,2018,27.0,1990.0,19.0,46,32,15,22,9,17,37,45.9,20,35,3,32,15,61,16,0,MF,25-29,Midfielder,Russia,Europe
473,Raman Chibsah,GHA,Frosinone,Serie A,2018,25.0,1993.0,29.1,46,27,25,19,2,16,54,29.6,38,45,10,35,32,78,28,1,MF,25-29,Midfielder,Ghana,Africa
474,Leandro Chichizola,ARG,Getafe,La Liga,2018,28.0,1990.0,1.0,0,0,0,0,0,0,0,,0,0,0,0,0,0,1,0,GK,25-29,Goalkeeper,Argentina,South America
475,Giorgio Chiellini,ITA,Juventus,Serie A,2018,33.0,1984.0,22.1,24,13,20,2,2,5,8,62.5,3,22,15,7,30,54,96,1,DF,30-34,Defender,Italy,Europe
476,Federico Chiesa,ITA,Fiorentina,Serie A,2018,20.0,1997.0,33.7,46,27,8,17,21,10,40,25.0,30,24,1,23,10,56,12,0,FW,20-24,Forward,Italy,Europe
477,Ben Chilwell,ENG,Leicester City,Premier League,2018,21.0,1996.0,36.0,55,29,34,18,3,24,55,43.6,31,37,7,30,38,93,156,0,DF,20-24,Defender,England,Europe
478,Vlad Chiricheș,ROU,Napoli,Serie A,2018,28.0,1989.0,1.6,2,1,1,1,0,0,2,0.0,2,2,2,0,1,3,2,0,DF,25-29,Defender,Romania,Europe
479,Tahith Chong,NED,Manchester Utd,Premier League,2018,18.0,1999.0,0.4,0,0,0,0,0,0,0,,0,1,0,1,0,0,1,0,FW,Under 20,Forward,Netherlands,Europe
480,Hamza Choudhury,ENG,Leicester City,Premier League,2018,20.0,1997.0,6.6,24,10,13,10,1,9,15,60.0,6,12,3,9,15,39,13,0,MF,20-24,Midfielder,England,Europe
481,Andreas Christensen,DEN,Chelsea,Premier League,2018,22.0,1996.0,6.9,10,4,2,6,2,2,5,40.0,3,4,2,2,4,14,29,0,DF,20-24,Defender,Denmark,Europe
482,Cyrus Christie,IRL,Fulham,Premier League,2018,25.0,1992.0,21.6,43,23,26,13,4,18,41,43.9,23,25,11,14,29,72,96,1,"DF,MF",25-29,Defender,Republic of Ireland,Europe
483,Samuel Chukwueze,NGA,Villarreal,La Liga,2018,19.0,1999.0,19.0,19,11,7,10,2,9,31,29.0,22,11,2,9,10,29,2,0,"MF,FW",Under 20,Midfielder,Nigeria,Africa
484,Camillo Ciano,ITA,Frosinone,Serie A,2018,28.0,1990.0,27.3,33,15,12,10,11,8,50,16.0,42,28,4,24,8,41,16,0,"FW,MF",25-29,Forward,Italy,Europe
485,Amato Ciciretti,ITA,Parma,Serie A,2018,24.0,1993.0,1.5,1,0,1,0,0,0,0,,0,3,0,3,3,4,0,0,"FW,MF",20-24,Forward,Italy,Europe
486,Luca Cigarini,ITA,Cagliari,Serie A,2018,32.0,1986.0,18.7,54,33,27,22,5,28,63,44.4,35,28,5,23,26,80,41,0,MF,30-34,Midfielder,Italy,Europe
488,Jasper Cillessen,NED,Barcelona,La Liga,2018,29.0,1989.0,3.0,0,0,0,0,0,0,0,,0,0,0,0,0,0,3,2,GK,25-29,Goalkeeper,Netherlands,Europe
489,Laurent Ciman,BEL,Dijon,Ligue 1,2018,32.0,1985.0,8.0,11,6,9,2,0,7,16,43.8,9,13,9,4,7,18,37,0,DF,30-34,Defender,Belgium,Europe
490,Daniel Ciofani,ITA,Frosinone,Serie A,2018,33.0,1985.0,18.0,8,6,2,5,1,3,7,42.9,4,4,0,4,3,11,9,0,FW,30-34,Forward,Italy,Europe
492,Ibrahima Cissé,GUI,Fulham,Premier League,2018,24.0,1994.0,1.0,0,0,0,0,0,0,1,0.0,1,0,0,0,3,3,4,0,MF,20-24,Midfielder,Guinea,Africa
492,Ibrahima Cissé,GUI,Fulham,Premier League,2018,24.0,1994.0,1.0,0,0,0,0,0,0,1,0.0,1,0,0,0,3,3,4,0,MF,20-24,Midfielder,Guinea,Africa
492,Ibrahima Cissé,GUI,Fulham,Premier League,2018,24.0,1994.0,1.0,0,0,0,0,0,0,1,0.0,1,0,0,0,3,3,4,0,MF,20-24,Midfielder,Guinea,Africa
492,Ibrahima Cissé,GUI,Fulham,Premier League,2018,24.0,1994.0,1.0,0,0,0,0,0,0,1,0.0,1,0,0,0,3,3,4,0,MF,20-24,Midfielder,Guinea,Africa
493,Till Cissokho,FRA,Bordeaux,Ligue 1,2018,18.0,2000.0,0.9,1,0,1,0,0,0,0,,0,0,0,0,2,3,3,0,DF,Under 20,Defender,France,Europe
494,Ciaran Clark,IRL,Newcastle Utd,Premier League,2018,28.0,1989.0,9.5,20,17,15,5,0,9,12,75.0,3,11,7,4,12,32,58,0,DF,25-29,Defender,Republic of Ireland,Europe
495,Tom Cleverley,ENG,Watford,Premier League,2018,28.0,1989.0,5.3,17,9,11,4,2,6,22,27.3,16,4,0,4,5,22,11,0,MF,25-29,Midfielder,England,Europe
496,Nathaniel Clyne,ENG,Bournemouth,Premier League,2018,27.0,1991.0,12.7,33,18,16,14,3,11,23,47.8,12,13,3,10,16,49,33,1,DF,25-29,Defender,England,Europe
497,Nathaniel Clyne,ENG,Liverpool,Premier League,2018,27.0,1991.0,1.2,4,3,2,2,0,2,4,50.0,2,1,0,1,2,6,1,0,DF,25-29,Defender,England,Europe
498,Conor Coady,ENG,Wolves,Premier League,2018,25.0,1993.0,38.0,31,19,26,5,0,17,32,53.1,15,35,27,8,30,61,133,3,DF,25-29,Defender,England,Europe
499,Marcus Coco,FRA,Guingamp,Ligue 1,2018,22.0,1996.0,20.4,39,23,20,10,9,16,33,48.5,17,24,0,24,23,62,14,0,"FW,MF",20-24,Forward,France,Europe
501,Joel Coleman,ENG,Huddersfield,Premier League,2018,22.0,1995.0,1.0,0,0,0,0,0,0,0,,0,0,0,0,0,0,0,0,GK,20-24,Goalkeeper,England,Europe
502,Séamus Coleman,IRL,Everton,Premier League,2018,29.0,1988.0,28.4,44,25,23,18,3,19,30,63.3,11,14,5,9,26,70,86,0,DF,25-29,Defender,Republic of Ireland,Europe
504,Omar Colley,GAM,Sampdoria,Serie A,2018,25.0,1992.0,19.6,18,11,12,6,0,12,13,92.3,1,24,16,8,22,40,102,0,DF,25-29,Defender,Gambia,Africa
505,Racine Coly,SEN,Nice,Ligue 1,2018,22.0,1995.0,5.6,7,2,1,5,1,4,11,36.4,7,6,1,5,9,16,11,1,"DF,MF",20-24,Defender,Senegal,Africa
506,Kingsley Coman,FRA,Bayern Munich,Bundesliga,2018,22.0,1996.0,15.3,11,6,4,4,3,6,19,31.6,13,20,0,20,5,16,3,0,"FW,MF",20-24,Forward,France,Europe
508,Daniel Congré,FRA,Montpellier,Ligue 1,2018,33.0,1985.0,36.6,75,45,46,26,3,38,65,58.5,27,35,15,20,67,142,106,1,DF,30-34,Defender,France,Europe
509,Andrea Consigli,ITA,Sassuolo,Serie A,2018,31.0,1987.0,35.7,0,0,0,0,0,0,2,0.0,2,0,0,0,1,1,15,6,GK,30-34,Goalkeeper,Italy,Europe
510,Andrea Conti,ITA,Milan,Serie A,2018,24.0,1994.0,5.6,9,5,3,4,2,2,9,22.2,7,4,0,4,15,24,12,1,DF,20-24,Defender,Italy,Europe
511,Lewis Cook,ENG,Bournemouth,Premier League,2018,21.0,1997.0,8.0,13,6,6,7,0,8,19,42.1,11,8,2,6,8,21,7,1,MF,20-24,Midfielder,England,Europe
512,Steve Cook,ENG,Bournemouth,Premier League,2018,27.0,1991.0,31.0,36,19,31,5,0,20,27,74.1,7,36,21,15,50,86,202,1,DF,25-29,Defender,England,Europe
513,Duje Čop,CRO,Valladolid,La Liga,2018,28.0,1990.0,7.6,5,4,1,2,2,0,8,0.0,8,8,3,5,3,8,3,0,FW,25-29,Forward,Croatia,Europe
514,Francis Coquelin,FRA,Valencia,La Liga,2018,27.0,1991.0,19.6,46,31,25,14,7,17,35,48.6,18,21,5,16,49,95,29,1,MF,25-29,Midfielder,France,Europe
515,Gabriele Corbo,ITA,Bologna,Serie A,2018,18.0,2000.0,0.1,0,0,0,0,0,0,0,,0,0,0,0,0,0,0,0,DF,Under 20,Defender,Italy,Europe
517,Sergio Córdova,VEN,Augsburg,Bundesliga,2018,20.0,1997.0,5.9,9,5,3,4,2,2,6,33.3,4,0,0,0,3,12,5,0,FW,20-24,Forward,Venezuela,South America
518,Benjamin Corgnet,FRA,Strasbourg,Ligue 1,2018,31.0,1987.0,7.5,21,12,7,9,5,4,11,36.4,7,1,0,1,6,27,9,0,"MF,FW",30-34,Midfielder,France,Europe
519,Ante Ćorić,CRO,Roma,Serie A,2018,21.0,1997.0,0.3,0,0,0,0,0,0,0,,0,0,0,0,0,0,0,0,MF,20-24,Midfielder,Croatia,Europe
520,Jack Cork,ENG,Burnley,Premier League,2018,29.0,1989.0,36.8,51,27,12,34,5,18,46,39.1,28,39,16,23,29,80,82,2,MF,25-29,Midfielder,England,Europe
521,Andreas Cornelius,DEN,Bordeaux,Ligue 1,2018,25.0,1993.0,8.8,4,1,1,3,0,1,4,25.0,3,4,1,3,1,5,21,0,FW,25-29,Forward,Denmark,Europe
522,Maxwel Cornet,CIV,Lyon,Ligue 1,2018,21.0,1996.0,14.2,14,11,4,7,3,1,11,9.1,10,10,0,10,5,19,8,0,FW,20-24,Forward,Ivory Coast,Africa
523,Quentin Cornette,FRA,Amiens,Ligue 1,2018,24.0,1994.0,2.3,5,1,2,2,1,3,6,50.0,3,3,0,3,1,6,5,0,"FW,MF",20-24,Forward,France,Europe
524,Ángel Correa,ARG,Atlético Madrid,La Liga,2018,23.0,1995.0,21.3,38,19,19,12,7,10,53,18.9,43,28,5,23,17,55,20,0,"MF,FW",20-24,Midfielder,Argentina,South America
525,Joaquín Correa,ARG,Lazio,Serie A,2018,23.0,1994.0,21.4,21,13,6,12,3,5,18,27.8,13,14,3,11,2,23,7,0,"FW,MF",20-24,Forward,Argentina,South America
526,Danny da Costa,GER,Eint Frankfurt,Bundesliga,2018,25.0,1993.0,33.7,61,35,29,25,7,18,42,42.9,24,51,9,42,32,93,67,0,"DF,FW",25-29,Defender,Germany,Europe
528,Douglas Costa,BRA,Juventus,Serie A,2018,27.0,1990.0,6.9,10,8,2,8,0,4,9,44.4,5,8,0,8,4,14,2,0,"FW,MF",25-29,Forward,Brazil,South America
529,Filippo Costa,ITA,SPAL,Serie A,2018,23.0,1995.0,6.3,15,13,6,6,3,4,9,44.4,5,10,3,7,8,23,31,1,"DF,FW",20-24,Defender,Italy,Europe
530,Hélder Costa,ANG,Wolves,Premier League,2018,24.0,1994.0,14.9,18,14,7,7,4,7,23,30.4,16,15,0,15,9,27,6,0,"FW,MF",20-24,Forward,Angola,Africa
532,Nuno da Costa,CPV,Strasbourg,Ligue 1,2018,27.0,1991.0,22.8,39,27,10,19,10,10,38,26.3,28,24,1,23,14,53,9,0,FW,25-29,Forward,Cape Verde,Africa
534,Benoît Costil,FRA,Bordeaux,Ligue 1,2018,31.0,1987.0,37.0,2,0,2,0,0,2,2,100.0,0,0,0,0,0,2,14,3,GK,30-34,Goalkeeper,France,Europe
535,Kalifa Coulibaly,MLI,Nantes,Ligue 1,2018,26.0,1991.0,19.5,15,7,1,10,4,4,11,36.4,7,8,1,7,4,19,22,0,FW,25-29,Forward,Mali,Africa
536,Senou Coulibaly,MLI,Dijon,Ligue 1,2018,23.0,1994.0,4.6,13,7,10,3,0,3,8,37.5,5,8,2,6,11,24,20,0,DF,20-24,Defender,Mali,Africa
537,Thibaut Courtois,BEL,Real Madrid,La Liga,2018,26.0,1992.0,27.0,0,0,0,0,0,0,2,0.0,2,0,0,0,2,2,5,0,GK,25-29,Goalkeeper,Belgium,Europe
538,Philippe Coutinho,BRA,Barcelona,La Liga,2018,26.0,1992.0,22.4,16,11,1,6,9,7,22,31.8,15,21,2,19,12,28,8,0,"FW,MF",25-29,Forward,Brazil,South America
539,Nicolas Cozza,FRA,Montpellier,Ligue 1,2018,19.0,1999.0,10.9,19,15,14,5,0,4,10,40.0,6,13,10,3,23,42,37,1,DF,Under 20,Defender,France,Europe
540,Alessio Cragno,ITA,Cagliari,Serie A,2018,24.0,1994.0,38.0,0,0,0,0,0,0,1,0.0,1,0,0,0,2,2,19,1,GK,20-24,Goalkeeper,Italy,Europe
541,Aaron Cresswell,ENG,West Ham,Premier League,2018,28.0,1989.0,17.7,29,16,14,11,4,13,25,52.0,12,28,7,21,23,52,58,0,DF,25-29,Defender,England,Europe
542,Domenico Criscito,ITA,Genoa,Serie A,2018,31.0,1986.0,34.1,111,75,64,36,11,57,83,68.7,26,40,11,29,70,181,142,0,DF,30-34,Defender,Italy,Europe
543,Lorenzo Crisetig,ITA,Frosinone,Serie A,2018,25.0,1993.0,5.6,14,11,4,8,2,6,15,40.0,9,8,3,5,12,26,12,0,MF,25-29,Midfielder,Italy,Europe
544,Bryan Cristante,ITA,Roma,Serie A,2018,23.0,1995.0,26.9,63,34,21,35,7,19,49,38.8,30,37,5,32,29,92,48,0,MF,20-24,Midfielder,Italy,Europe
545,Sebastián Cristóforo,URU,Getafe,La Liga,2018,24.0,1993.0,5.0,15,8,4,8,3,5,14,35.7,9,13,0,13,8,23,5,0,MF,20-24,Midfielder,Uruguay,South America
546,Enzo Crivelli,FRA,Caen,Ligue 1,2018,23.0,1995.0,25.1,20,14,10,8,2,8,13,61.5,5,5,0,5,4,24,28,1,FW,20-24,Forward,France,Europe
547,Peter Crouch,ENG,Burnley,Premier League,2018,37.0,1981.0,1.0,1,1,0,1,0,1,1,100.0,0,0,0,0,0,1,2,0,FW,35-39,Forward,England,Europe
549,Juan Cuadrado,COL,Juventus,Serie A,2018,30.0,1988.0,13.6,20,15,6,9,5,5,23,21.7,18,14,3,11,18,38,11,0,"MF,DF",30-34,Midfielder,Colombia,South America
550,Cucho,COL,Huesca,La Liga,2018,19.0,1999.0,23.9,22,13,6,10,6,6,18,33.3,12,23,2,21,9,31,21,0,FW,Under 20,Forward,Colombia,South America
553,Mickaël Cuisance,FRA,Gladbach,Bundesliga,2018,18.0,1999.0,3.1,11,6,6,3,2,3,8,37.5,5,3,0,3,5,16,4,0,MF,Under 20,Midfielder,France,Europe
554,Matheus Cunha,BRA,RB Leipzig,Bundesliga,2018,19.0,1999.0,9.5,10,6,3,5,2,3,13,23.1,10,13,1,12,4,14,8,0,"FW,MF",Under 20,Forward,Brazil,South America
555,Greg Cunningham,IRL,Cardiff City,Premier League,2018,27.0,1991.0,7.0,18,7,11,4,3,9,16,56.3,7,9,3,6,17,35,16,1,DF,25-29,Defender,Republic of Ireland,Europe
556,Patrick Cutrone,ITA,Milan,Serie A,2018,20.0,1998.0,16.2,9,5,0,3,6,2,16,12.5,14,13,2,11,7,16,13,0,FW,20-24,Forward,Italy,Europe
557,Wylan Cyprien,FRA,Nice,Ligue 1,2018,23.0,1995.0,26.2,40,20,16,21,3,15,43,34.9,28,20,5,15,11,51,15,0,MF,20-24,Midfielder,France,Europe
558,Marco D'Alessandro,ITA,Udinese,Serie A,2018,27.0,1991.0,16.6,55,34,34,15,6,29,49,59.2,20,24,2,22,9,64,50,1,DF,25-29,Defender,Italy,Europe
559,Danilo D'Ambrosio,ITA,Inter,Serie A,2018,29.0,1988.0,28.7,69,40,34,27,8,24,57,42.1,33,25,8,17,27,96,39,0,DF,25-29,Defender,Italy,Europe
560,Damien Da Silva,FRA,Rennes,Ligue 1,2018,30.0,1988.0,31.9,41,25,31,9,1,18,24,75.0,6,42,36,6,39,80,152,0,DF,30-34,Defender,France,Europe
561,Kouadio-Yves Dabila,CIV,Lille,Ligue 1,2018,21.0,1997.0,8.7,11,6,10,1,0,5,6,83.3,1,13,9,4,6,17,44,0,DF,20-24,Defender,Ivory Coast,Africa
562,Abdoulaye Dabo,FRA,Nantes,Ligue 1,2018,17.0,2001.0,1.3,3,1,1,0,2,0,0,,0,0,0,0,0,3,0,0,FW,Under 20,Forward,France,Europe
563,Bryan Dabo,BFA,Fiorentina,Serie A,2018,26.0,1992.0,9.2,10,6,1,8,1,1,6,16.7,5,11,6,5,10,20,21,0,"MF,DF",25-29,Midfielder,Burkina Faso,Africa
564,Christoph Daferner,GER,Freiburg,Bundesliga,2018,20.0,1998.0,0.3,1,0,1,0,0,0,0,,0,0,0,0,1,2,0,0,FW,20-24,Forward,Germany,Europe
565,Colin Dagba,FRA,Paris S-G,Ligue 1,2018,19.0,1998.0,10.2,24,12,10,12,2,13,19,68.4,6,10,0,10,9,33,10,1,"DF,MF",Under 20,Defender,France,Europe
566,Mahmoud Dahoud,GER,Dortmund,Bundesliga,2018,22.0,1996.0,7.7,16,10,4,10,2,3,15,20.0,12,10,0,10,17,33,8,0,MF,20-24,Midfielder,Germany,Europe
567,Leon Dajaku,GER,Stuttgart,Bundesliga,2018,17.0,2001.0,0.3,2,1,0,1,1,0,0,,0,1,0,1,0,2,0,0,"DF,MF",Under 20,Defender,Germany,Europe
568,Felipe dal Belo,BRA,SPAL,Serie A,2018,34.0,1984.0,26.2,36,25,21,13,2,16,32,50.0,16,29,18,11,17,53,88,1,DF,30-34,Defender,Brazil,South America
569,Nicola Dalmonte,ITA,Genoa,Serie A,2018,20.0,1997.0,0.5,2,2,0,2,0,0,0,,0,0,0,0,0,2,0,0,"FW,MF",20-24,Forward,Italy,Europe
570,Diogo Dalot,POR,Manchester Utd,Premier League,2018,19.0,1999.0,11.3,24,12,8,14,2,14,19,73.7,5,15,2,13,10,34,35,1,"DF,FW",Under 20,Defender,Portugal,Europe
571,Matty Daly,ENG,Huddersfield,Premier League,2018,17.0,2001.0,0.8,0,0,0,0,0,0,0,,0,0,0,0,0,0,0,0,MF,Under 20,Midfielder,England,Europe
572,Vitalie Damașcan,MDA,Torino,Serie A,2018,19.0,1999.0,0.0,1,1,0,1,0,1,1,100.0,0,0,0,0,0,1,0,0,MF,Under 20,Midfielder,Moldova,Europe
573,Loïc Damour,FRA,Cardiff City,Premier League,2018,27.0,1991.0,0.3,0,0,0,0,0,0,1,0.0,1,0,0,0,0,0,0,0,MF,25-29,Midfielder,France,Europe
574,Charlie Daniels,ENG,Bournemouth,Premier League,2018,31.0,1986.0,17.6,25,15,18,6,1,13,22,59.1,9,14,4,10,20,45,56,2,DF,30-34,Defender,England,Europe
575,Danilo,BRA,Manchester City,Premier League,2018,27.0,1991.0,9.0,20,16,6,12,2,12,17,70.6,5,5,0,5,15,35,22,1,DF,25-29,Defender,Brazil,South America
575,Danilo,BRA,Manchester City,Premier League,2018,27.0,1991.0,9.0,20,16,6,12,2,12,17,70.6,5,5,0,5,15,35,22,1,DF,25-29,Defender,Brazil,South America
575,Danilo,BRA,Manchester City,Premier League,2018,27.0,1991.0,9.0,20,16,6,12,2,12,17,70.6,5,5,0,5,15,35,22,1,DF,25-29,Defender,Brazil,South America
575,Danilo,BRA,Manchester City,Premier League,2018,27.0,1991.0,9.0,20,16,6,12,2,12,17,70.6,5,5,0,5,15,35,22,1,DF,25-29,Defender,Brazil,South America
575,Danilo,BRA,Manchester City,Premier League,2018,27.0,1991.0,9.0,20,16,6,12,2,12,17,70.6,5,5,0,5,15,35,22,1,DF,25-29,Defender,Brazil,South America
575,Danilo,BRA,Manchester City,Premier League,2018,27.0,1991.0,9.0,20,16,6,12,2,12,17,70.6,5,5,0,5,15,35,22,1,DF,25-29,Defender,Brazil,South America
575,Danilo,BRA,Manchester City,Premier League,2018,27.0,1991.0,9.0,20,16,6,12,2,12,17,70.6,5,5,0,5,15,35,22,1,DF,25-29,Defender,Brazil,South America
575,Danilo,BRA,Manchester City,Premier League,2018,27.0,1991.0,9.0,20,16,6,12,2,12,17,70.6,5,5,0,5,15,35,22,1,DF,25-29,Defender,Brazil,South America
575,Danilo,BRA,Manchester City,Premier League,2018,27.0,1991.0,9.0,20,16,6,12,2,12,17,70.6,5,5,0,5,15,35,22,1,DF,25-29,Defender,Brazil,South America
575,Danilo,BRA,Manchester City,Premier League,2018,27.0,1991.0,9.0,20,16,6,12,2,12,17,70.6,5,5,0,5,15,35,22,1,DF,25-29,Defender,Brazil,South America
575,Danilo,BRA,Manchester City,Premier League,2018,27.0,1991.0,9.0,20,16,6,12,2,12,17,70.6,5,5,0,5,15,35,22,1,DF,25-29,Defender,Brazil,South America
575,Danilo,BRA,Manchester City,Premier League,2018,27.0,1991.0,9.0,20,16,6,12,2,12,17,70.6,5,5,0,5,15,35,22,1,DF,25-29,Defender,Brazil,South America
575,Danilo,BRA,Manchester City,Premier League,2018,27.0,1991.0,9.0,20,16,6,12,2,12,17,70.6,5,5,0,5,15,35,22,1,DF,25-29,Defender,Brazil,South America
575,Danilo,BRA,Manchester City,Premier League,2018,27.0,1991.0,9.0,20,16,6,12,2,12,17,70.6,5,5,0,5,15,35,22,1,DF,25-29,Defender,Brazil,South America
575,Danilo,BRA,Manchester City,Premier League,2018,27.0,1991.0,9.0,20,16,6,12,2,12,17,70.6,5,5,0,5,15,35,22,1,DF,25-29,Defender,Brazil,South America
575,Danilo,BRA,Manchester City,Premier League,2018,27.0,1991.0,9.0,20,16,6,12,2,12,17,70.6,5,5,0,5,15,35,22,1,DF,25-29,Defender,Brazil,South America
575,Danilo,BRA,Manchester City,Premier League,2018,27.0,1991.0,9.0,20,16,6,12,2,12,17,70.6,5,5,0,5,15,35,22,1,DF,25-29,Defender,Brazil,South America
575,Danilo,BRA,Manchester City,Premier League,2018,27.0,1991.0,9.0,20,16,6,12,2,12,17,70.6,5,5,0,5,15,35,22,1,DF,25-29,Defender,Brazil,South America
575,Danilo,BRA,Manchester City,Premier League,2018,27.0,1991.0,9.0,20,16,6,12,2,12,17,70.6,5,5,0,5,15,35,22,1,DF,25-29,Defender,Brazil,South America
575,Danilo,BRA,Manchester City,Premier League,2018,27.0,1991.0,9.0,20,16,6,12,2,12,17,70.6,5,5,0,5,15,35,22,1,DF,25-29,Defender,Brazil,South America
575,Danilo,BRA,Manchester City,Premier League,2018,27.0,1991.0,9.0,20,16,6,12,2,12,17,70.6,5,5,0,5,15,35,22,1,DF,25-29,Defender,Brazil,South America
575,Danilo,BRA,Manchester City,Premier League,2018,27.0,1991.0,9.0,20,16,6,12,2,12,17,70.6,5,5,0,5,15,35,22,1,DF,25-29,Defender,Brazil,South America
575,Danilo,BRA,Manchester City,Premier League,2018,27.0,1991.0,9.0,20,16,6,12,2,12,17,70.6,5,5,0,5,15,35,22,1,DF,25-29,Defender,Brazil,South America
575,Danilo,BRA,Manchester City,Premier League,2018,27.0,1991.0,9.0,20,16,6,12,2,12,17,70.6,5,5,0,5,15,35,22,1,DF,25-29,Defender,Brazil,South America
575,Danilo,BRA,Manchester City,Premier League,2018,27.0,1991.0,9.0,20,16,6,12,2,12,17,70.6,5,5,0,5,15,35,22,1,DF,25-29,Defender,Brazil,South America
575,Danilo,BRA,Manchester City,Premier League,2018,27.0,1991.0,9.0,20,16,6,12,2,12,17,70.6,5,5,0,5,15,35,22,1,DF,25-29,Defender,Brazil,South America
575,Danilo,BRA,Manchester City,Premier League,2018,27.0,1991.0,9.0,20,16,6,12,2,12,17,70.6,5,5,0,5,15,35,22,1,DF,25-29,Defender,Brazil,South America
575,Danilo,BRA,Manchester City,Premier League,2018,27.0,1991.0,9.0,20,16,6,12,2,12,17,70.6,5,5,0,5,15,35,22,1,DF,25-29,Defender,Brazil,South America
575,Danilo,BRA,Manchester City,Premier League,2018,27.0,1991.0,9.0,20,16,6,12,2,12,17,70.6,5,5,0,5,15,35,22,1,DF,25-29,Defender,Brazil,South America
575,Danilo,BRA,Manchester City,Premier League,2018,27.0,1991.0,9.0,20,16,6,12,2,12,17,70.6,5,5,0,5,15,35,22,1,DF,25-29,Defender,Brazil,South America
575,Danilo,BRA,Manchester City,Premier League,2018,27.0,1991.0,9.0,20,16,6,12,2,12,17,70.6,5,5,0,5,15,35,22,1,DF,25-29,Defender,Brazil,South America
575,Danilo,BRA,Manchester City,Premier League,2018,27.0,1991.0,9.0,20,16,6,12,2,12,17,70.6,5,5,0,5,15,35,22,1,DF,25-29,Defender,Brazil,South America
575,Danilo,BRA,Manchester City,Premier League,2018,27.0,1991.0,9.0,20,16,6,12,2,12,17,70.6,5,5,0,5,15,35,22,1,DF,25-29,Defender,Brazil,South America
575,Danilo,BRA,Manchester City,Premier League,2018,27.0,1991.0,9.0,20,16,6,12,2,12,17,70.6,5,5,0,5,15,35,22,1,DF,25-29,Defender,Brazil,South America
575,Danilo,BRA,Manchester City,Premier League,2018,27.0,1991.0,9.0,20,16,6,12,2,12,17,70.6,5,5,0,5,15,35,22,1,DF,25-29,Defender,Brazil,South America
575,Danilo,BRA,Manchester City,Premier League,2018,27.0,1991.0,9.0,20,16,6,12,2,12,17,70.6,5,5,0,5,15,35,22,1,DF,25-29,Defender,Brazil,South America
575,Danilo,BRA,Manchester City,Premier League,2018,27.0,1991.0,9.0,20,16,6,12,2,12,17,70.6,5,5,0,5,15,35,22,1,DF,25-29,Defender,Brazil,South America
575,Danilo,BRA,Manchester City,Premier League,2018,27.0,1991.0,9.0,20,16,6,12,2,12,17,70.6,5,5,0,5,15,35,22,1,DF,25-29,Defender,Brazil,South America
575,Danilo,BRA,Manchester City,Premier League,2018,27.0,1991.0,9.0,20,16,6,12,2,12,17,70.6,5,5,0,5,15,35,22,1,DF,25-29,Defender,Brazil,South America
575,Danilo,BRA,Manchester City,Premier League,2018,27.0,1991.0,9.0,20,16,6,12,2,12,17,70.6,5,5,0,5,15,35,22,1,DF,25-29,Defender,Brazil,South America
575,Danilo,BRA,Manchester City,Premier League,2018,27.0,1991.0,9.0,20,16,6,12,2,12,17,70.6,5,5,0,5,15,35,22,1,DF,25-29,Defender,Brazil,South America
575,Danilo,BRA,Manchester City,Premier League,2018,27.0,1991.0,9.0,20,16,6,12,2,12,17,70.6,5,5,0,5,15,35,22,1,DF,25-29,Defender,Brazil,South America
575,Danilo,BRA,Manchester City,Premier League,2018,27.0,1991.0,9.0,20,16,6,12,2,12,17,70.6,5,5,0,5,15,35,22,1,DF,25-29,Defender,Brazil,South America
575,Danilo,BRA,Manchester City,Premier League,2018,27.0,1991.0,9.0,20,16,6,12,2,12,17,70.6,5,5,0,5,15,35,22,1,DF,25-29,Defender,Brazil,South America
575,Danilo,BRA,Manchester City,Premier League,2018,27.0,1991.0,9.0,20,16,6,12,2,12,17,70.6,5,5,0,5,15,35,22,1,DF,25-29,Defender,Brazil,South America
575,Danilo,BRA,Manchester City,Premier League,2018,27.0,1991.0,9.0,20,16,6,12,2,12,17,70.6,5,5,0,5,15,35,22,1,DF,25-29,Defender,Brazil,South America
575,Danilo,BRA,Manchester City,Premier League,2018,27.0,1991.0,9.0,20,16,6,12,2,12,17,70.6,5,5,0,5,15,35,22,1,DF,25-29,Defender,Brazil,South America
575,Danilo,BRA,Manchester City,Premier League,2018,27.0,1991.0,9.0,20,16,6,12,2,12,17,70.6,5,5,0,5,15,35,22,1,DF,25-29,Defender,Brazil,South America
575,Danilo,BRA,Manchester City,Premier League,2018,27.0,1991.0,9.0,20,16,6,12,2,12,17,70.6,5,5,0,5,15,35,22,1,DF,25-29,Defender,Brazil,South America
576,Scott Dann,ENG,Crystal Palace,Premier League,2018,31.0,1987.0,7.4,6,2,5,1,0,3,7,42.9,4,16,12,4,5,11,46,0,DF,30-34,Defender,England,Europe
577,Kevin Danso,AUT,Augsburg,Bundesliga,2018,19.0,1998.0,13.9,25,14,21,3,1,11,14,78.6,3,25,17,8,19,44,72,0,DF,Under 20,Defender,Austria,Europe
578,Dante,BRA,Nice,Ligue 1,2018,34.0,1983.0,35.8,54,40,36,16,2,24,41,58.5,17,56,30,26,38,92,156,2,DF,30-34,Defender,Brazil,South America
579,Palkó Dárdai,HUN,Hertha BSC,Bundesliga,2018,19.0,1999.0,1.3,1,1,1,0,0,0,0,,0,1,0,1,0,1,0,0,"FW,MF",Under 20,Forward,Hungary,Europe
582,Matteo Darmian,ITA,Manchester Utd,Premier League,2018,28.0,1989.0,4.9,14,8,10,4,0,4,11,36.4,7,9,0,9,7,21,20,0,DF,25-29,Defender,Italy,Europe
583,Alphonso Davies,CAN,Bayern Munich,Bundesliga,2018,17.0,2000.0,0.9,1,1,1,0,0,0,0,,0,2,0,2,2,3,1,0,"MF,FW",Under 20,Midfielder,Canada,North America
584,Ben Davies,WAL,Tottenham,Premier League,2018,25.0,1993.0,20.5,56,30,39,13,4,38,54,70.4,16,23,10,13,23,79,68,1,DF,25-29,Defender,Wales,Europe
584,Ben Davies,WAL,Tottenham,Premier League,2018,25.0,1993.0,20.5,56,30,39,13,4,38,54,70.4,16,23,10,13,23,79,68,1,DF,25-29,Defender,Wales,Europe
584,Ben Davies,WAL,Tottenham,Premier League,2018,25.0,1993.0,20.5,56,30,39,13,4,38,54,70.4,16,23,10,13,23,79,68,1,DF,25-29,Defender,Wales,Europe
584,Ben Davies,WAL,Tottenham,Premier League,2018,25.0,1993.0,20.5,56,30,39,13,4,38,54,70.4,16,23,10,13,23,79,68,1,DF,25-29,Defender,Wales,Europe
585,Tom Davies,ENG,Everton,Premier League,2018,20.0,1998.0,10.9,27,17,9,17,1,7,23,30.4,16,15,1,14,16,43,9,1,MF,20-24,Midfielder,England,Europe
585,Tom Davies,ENG,Everton,Premier League,2018,20.0,1998.0,10.9,27,17,9,17,1,7,23,30.4,16,15,1,14,16,43,9,1,MF,20-24,Midfielder,England,Europe
585,Tom Davies,ENG,Everton,Premier League,2018,20.0,1998.0,10.9,27,17,9,17,1,7,23,30.4,16,15,1,14,16,43,9,1,MF,20-24,Midfielder,England,Europe
585,Tom Davies,ENG,Everton,Premier League,2018,20.0,1998.0,10.9,27,17,9,17,1,7,23,30.4,16,15,1,14,16,43,9,1,MF,20-24,Midfielder,England,Europe
587,Kevin De Bruyne,BEL,Manchester City,Premier League,2018,27.0,1991.0,10.8,22,15,6,12,4,7,21,33.3,14,13,1,12,3,25,2,1,MF,25-29,Midfielder,Belgium,Europe
588,Sebastien De Maio,FRA,Udinese,Serie A,2018,31.0,1987.0,13.0,11,7,7,4,0,3,12,25.0,9,22,17,5,12,23,93,0,DF,30-34,Defender,France,Europe
589,Sebastien De Maio,FRA,Bologna,Serie A,2018,31.0,1987.0,5.5,5,4,3,2,0,1,2,50.0,1,8,5,3,1,6,32,0,DF,30-34,Defender,France,Europe
590,Rodrigo De Paul,ARG,Udinese,Serie A,2018,24.0,1994.0,35.4,53,33,21,27,5,13,42,31.0,29,35,2,33,32,85,28,0,"MF,FW",20-24,Midfielder,Argentina,South America
591,Daniele De Rossi,ITA,Roma,Serie A,2018,35.0,1983.0,14.1,16,10,6,7,3,3,14,21.4,11,18,12,6,26,42,33,0,MF,35-39,Midfielder,Italy,Europe
592,Mattia De Sciglio,ITA,Juventus,Serie A,2018,25.0,1992.0,19.4,40,28,24,14,2,17,28,60.7,11,18,6,12,26,66,58,1,DF,25-29,Defender,Italy,Europe
593,Lorenzo De Silvestri,ITA,Torino,Serie A,2018,30.0,1988.0,26.8,15,11,8,5,2,7,24,29.2,17,53,3,50,22,37,69,2,DF,30-34,Defender,Italy,Europe
594,Lucas Deaux,FRA,Guingamp,Ligue 1,2018,29.0,1988.0,13.2,41,28,21,18,2,20,41,48.8,21,10,0,10,11,52,7,0,MF,25-29,Midfielder,France,Europe
595,Mathieu Debuchy,FRA,Saint-Étienne,Ligue 1,2018,33.0,1985.0,21.6,43,26,25,13,5,22,37,59.5,15,17,7,10,47,90,64,0,DF,30-34,Defender,France,Europe
596,Troy Deeney,ENG,Watford,Premier League,2018,30.0,1988.0,28.3,24,14,8,10,6,7,32,21.9,25,22,4,18,7,31,29,0,FW,30-34,Forward,England,Europe
597,Jermain Defoe,ENG,Bournemouth,Premier League,2018,35.0,1982.0,0.3,0,0,0,0,0,0,0,,0,0,0,0,0,0,0,0,FW,35-39,Forward,England,Europe
598,Steven Defour,BEL,Burnley,Premier League,2018,30.0,1988.0,5.0,8,4,2,4,2,3,14,21.4,11,11,3,8,8,16,7,0,MF,30-34,Midfielder,Belgium,Europe
600,Alessandro Deiola,ITA,Cagliari,Serie A,2018,22.0,1995.0,5.0,7,3,1,6,0,3,13,23.1,10,14,0,14,6,13,8,0,MF,20-24,Midfielder,Italy,Europe
601,Alessandro Deiola,ITA,Parma,Serie A,2018,22.0,1995.0,6.1,12,8,4,7,1,4,10,40.0,6,15,4,11,11,23,10,0,"MF,FW",20-24,Midfielder,Italy,Europe
602,Romain Del Castillo,FRA,Rennes,Ligue 1,2018,22.0,1996.0,14.9,36,20,15,13,8,13,37,35.1,24,19,0,19,20,56,7,1,"MF,FW",20-24,Midfielder,France,Europe
603,Thomas Delaney,DEN,Dortmund,Bundesliga,2018,26.0,1991.0,25.4,69,54,28,39,2,19,30,63.3,11,30,9,21,58,127,43,0,MF,25-29,Midfielder,Denmark,Europe
605,Cristian Dell'Orco,ITA,Empoli,Serie A,2018,24.0,1994.0,11.5,18,11,11,5,2,4,11,36.4,7,13,7,6,17,35,44,0,DF,20-24,Defender,Italy,Europe
606,Cristian Dell'Orco,ITA,Sassuolo,Serie A,2018,24.0,1994.0,1.2,1,1,1,0,0,1,3,33.3,2,1,0,1,1,2,3,0,DF,20-24,Defender,Italy,Europe
607,Andy Delort,ALG,Montpellier,Ligue 1,2018,26.0,1991.0,34.6,34,20,7,20,7,8,34,23.5,26,28,7,21,4,38,7,0,FW,25-29,Forward,Algeria,Africa
608,Fabian Delph,ENG,Manchester City,Premier League,2018,28.0,1989.0,8.1,23,14,11,7,5,12,23,52.2,11,3,0,3,13,36,19,1,DF,25-29,Defender,England,Europe
609,Mousa Dembélé,BEL,Tottenham,Premier League,2018,31.0,1987.0,5.7,13,9,6,6,1,4,7,57.1,3,4,1,3,7,20,5,2,MF,30-34,Midfielder,Belgium,Europe
610,Moussa Dembélé,FRA,Lyon,Ligue 1,2018,22.0,1996.0,22.4,12,4,0,8,4,4,14,28.6,10,15,2,13,2,14,13,0,FW,20-24,Forward,France,Europe
611,Ousmane Dembélé,FRA,Barcelona,La Liga,2018,21.0,1997.0,18.5,23,15,4,13,6,6,18,33.3,12,13,0,13,5,28,4,0,"FW,MF",20-24,Forward,France,Europe
612,Jessy Deminguet,FRA,Caen,Ligue 1,2018,20.0,1998.0,14.1,37,25,18,17,2,15,40,37.5,25,19,3,16,18,55,28,1,MF,20-24,Midfielder,France,Europe
613,Merih Demiral,TUR,Sassuolo,Serie A,2018,20.0,1998.0,14.0,24,16,23,1,0,10,13,76.9,3,16,11,5,19,43,80,0,DF,20-24,Defender,Turkey,Asia
614,Kerem Demirbay,GER,Hoffenheim,Bundesliga,2018,25.0,1993.0,22.4,57,35,20,27,10,11,51,21.6,40,34,10,24,22,79,25,0,MF,25-29,Midfielder,Germany,Europe
615,Diego Demme,GER,RB Leipzig,Bundesliga,2018,26.0,1991.0,22.8,75,47,24,43,8,33,67,49.3,34,36,3,33,26,101,15,0,MF,25-29,Midfielder,Germany,Europe
616,Jason Denayer,BEL,Lyon,Ligue 1,2018,23.0,1995.0,30.6,33,21,22,11,0,16,24,66.7,8,36,32,4,26,59,122,1,DF,20-24,Defender,Belgium,Europe
617,Leander Dendoncker,BEL,Wolves,Premier League,2018,23.0,1995.0,16.3,53,26,25,25,3,16,47,34.0,31,35,6,29,23,76,34,1,MF,20-24,Midfielder,Belgium,Europe
618,Fabio Depaoli,ITA,Chievo,Serie A,2018,21.0,1997.0,27.4,74,43,37,32,5,34,67,50.7,33,42,16,26,35,109,99,3,DF,20-24,Defender,Italy,Europe
619,Laurent Depoitre,BEL,Huddersfield,Premier League,2018,29.0,1988.0,11.9,6,4,2,3,1,0,3,0.0,3,9,0,9,2,8,8,0,FW,25-29,Forward,Belgium,Europe
620,Clément Depres,FRA,Nîmes,Ligue 1,2018,23.0,1994.0,4.9,2,2,1,1,0,1,4,25.0,3,3,0,3,0,2,6,0,FW,20-24,Forward,France,Europe
621,Kiril Despodov,BUL,Cagliari,Serie A,2018,21.0,1996.0,1.2,0,0,0,0,0,0,1,0.0,1,1,0,1,0,0,0,0,"FW,MF",20-24,Forward,Bulgaria,Europe
622,Daniele Dessena,ITA,Cagliari,Serie A,2018,31.0,1987.0,3.9,2,2,0,2,0,1,3,33.3,2,3,1,2,3,5,5,0,MF,30-34,Midfielder,Italy,Europe
623,Mattia Destro,ITA,Bologna,Serie A,2018,27.0,1991.0,5.5,3,2,2,0,1,0,0,,0,4,0,4,0,3,6,0,FW,25-29,Forward,Italy,Europe
625,Jacopo Dezi,ITA,Parma,Serie A,2018,26.0,1992.0,1.0,1,1,1,0,0,0,1,0.0,1,1,0,1,3,4,2,0,MF,25-29,Midfielder,Italy,Europe
626,Federico Di Francesco,ITA,Sassuolo,Serie A,2018,24.0,1994.0,11.9,10,6,3,4,3,4,7,57.1,3,12,1,11,5,15,5,0,"FW,MF",20-24,Forward,Italy,Europe
627,Antonio Di Gaudio,ITA,Parma,Serie A,2018,28.0,1989.0,7.8,2,0,0,1,1,1,5,20.0,4,6,1,5,3,5,5,0,FW,25-29,Forward,Italy,Europe
628,Giovanni Di Lorenzo,ITA,Empoli,Serie A,2018,24.0,1993.0,37.0,66,43,38,23,5,24,44,54.5,20,34,13,21,36,102,93,3,"DF,FW",20-24,Defender,Italy,Europe
629,Ángel Di María,ARG,Paris S-G,Ligue 1,2018,30.0,1988.0,25.8,29,17,12,10,7,10,42,23.8,32,24,1,23,16,45,4,0,"FW,MF",30-34,Forward,Argentina,South America
630,Franco Di Santo,ARG,Rayo Vallecano,La Liga,2018,29.0,1989.0,1.9,2,2,1,0,1,1,2,50.0,1,0,0,0,0,2,2,0,FW,25-29,Forward,Argentina,South America
631,Franco Di Santo,ARG,Schalke 04,Bundesliga,2018,29.0,1989.0,2.7,2,1,0,2,0,1,4,25.0,3,3,1,2,1,3,3,0,"MF,FW",25-29,Midfielder,Argentina,South America
632,Boulaye Dia,SEN,Reims,Ligue 1,2018,21.0,1996.0,8.3,12,6,3,8,1,5,11,45.5,6,4,2,2,4,16,9,0,FW,20-24,Forward,Senegal,Africa
633,Fousseni Diabaté,MLI,Leicester City,Premier League,2018,22.0,1995.0,0.6,2,0,2,0,0,0,1,0.0,1,2,0,2,0,2,0,0,FW,20-24,Forward,Mali,Africa
634,Moussa Diaby,FRA,Paris S-G,Ligue 1,2018,19.0,1999.0,12.7,14,8,7,2,5,2,11,18.2,9,7,1,6,12,26,6,0,"MF,DF",Under 20,Midfielder,France,Europe
635,Adama Diakhaby,FRA,Huddersfield,Premier League,2018,22.0,1996.0,6.1,6,3,4,1,1,3,11,27.3,8,7,0,7,1,7,2,0,"FW,MF",20-24,Forward,France,Europe
636,Mouctar Diakhaby,GUI,Valencia,La Liga,2018,21.0,1996.0,17.6,14,8,10,4,0,5,10,50.0,5,24,16,8,20,34,94,1,DF,20-24,Defender,Guinea,Africa
637,Bafodé Diakité,FRA,Toulouse,Ligue 1,2018,17.0,2001.0,7.0,15,7,5,9,1,10,14,71.4,4,15,3,12,11,26,29,0,DF,Under 20,Defender,France,Europe
638,Abdou Diallo,SEN,Dortmund,Bundesliga,2018,22.0,1996.0,26.4,36,20,20,13,3,11,15,73.3,4,28,15,13,26,62,91,1,DF,20-24,Defender,Senegal,Africa
639,Abdoulaye Diallo,SEN,Rennes,Ligue 1,2018,26.0,1992.0,5.5,1,1,1,0,0,1,1,100.0,0,0,0,0,0,1,1,0,GK,25-29,Goalkeeper,Senegal,Africa
639,Abdoulaye Diallo,SEN,Rennes,Ligue 1,2018,26.0,1992.0,5.5,1,1,1,0,0,1,1,100.0,0,0,0,0,0,1,1,0,GK,25-29,Goalkeeper,Senegal,Africa
639,Abdoulaye Diallo,SEN,Rennes,Ligue 1,2018,26.0,1992.0,5.5,1,1,1,0,0,1,1,100.0,0,0,0,0,0,1,1,0,GK,25-29,Goalkeeper,Senegal,Africa
639,Abdoulaye Diallo,SEN,Rennes,Ligue 1,2018,26.0,1992.0,5.5,1,1,1,0,0,1,1,100.0,0,0,0,0,0,1,1,0,GK,25-29,Goalkeeper,Senegal,Africa
640,Mustapha Diallo,SEN,Nîmes,Ligue 1,2018,32.0,1986.0,5.1,16,11,6,9,1,5,13,38.5,8,7,1,6,10,26,14,1,MF,30-34,Midfielder,Senegal,Africa
641,Mohamed Diamé,SEN,Newcastle Utd,Premier League,2018,31.0,1987.0,24.1,76,46,35,36,5,16,54,29.6,38,42,9,33,30,106,39,1,MF,30-34,Midfielder,Senegal,Africa
642,Grady Diangana,COD,West Ham,Premier League,2018,20.0,1998.0,6.8,20,9,8,8,4,5,14,35.7,9,11,0,11,1,21,4,0,"MF,FW",20-24,Midfielder,DR Congo,Africa
643,Lassana Diarra,FRA,Paris S-G,Ligue 1,2018,33.0,1985.0,1.8,2,1,0,2,0,0,1,0.0,1,0,0,0,2,4,3,0,MF,30-34,Midfielder,France,Europe
644,Amadou Diawara,GUI,Napoli,Serie A,2018,21.0,1997.0,7.3,12,4,1,9,2,4,5,80.0,1,6,0,6,11,23,12,0,MF,20-24,Midfielder,Guinea,Africa
645,Brahim Díaz,MAR,Real Madrid,La Liga,2018,18.0,1999.0,4.2,9,7,5,4,0,3,8,37.5,5,2,0,2,0,9,0,0,FW,Under 20,Forward,Morocco,Africa
647,Bakaye Dibassy,MLI,Amiens,Ligue 1,2018,28.0,1989.0,32.7,38,26,18,16,4,18,27,66.7,9,40,21,19,44,82,102,0,DF,25-29,Defender,Mali,Africa
648,Lorenzo Dickmann,ITA,SPAL,Serie A,2018,21.0,1996.0,1.9,5,4,4,1,0,5,7,71.4,2,0,0,0,1,6,5,0,"DF,MF",20-24,Defender,Italy,Europe
649,Daniel Didavi,GER,Stuttgart,Bundesliga,2018,28.0,1990.0,10.6,21,15,8,10,3,7,20,35.0,13,11,1,10,4,25,5,0,"MF,FW",25-29,Midfielder,Germany,Europe
650,Étienne Didot,FRA,Guingamp,Ligue 1,2018,35.0,1983.0,23.4,41,29,12,27,2,17,44,38.6,27,37,10,27,37,78,35,0,MF,35-39,Midfielder,France,Europe
652,Eric Dier,ENG,Tottenham,Premier League,2018,24.0,1994.0,16.7,26,16,7,15,4,19,47,40.4,28,27,12,15,21,47,46,1,"MF,DF",20-24,Midfielder,England,Europe
653,Tim Dierßen,GER,Hannover 96,Bundesliga,2018,22.0,1996.0,0.2,0,0,0,0,0,0,0,,0,1,0,1,0,0,0,0,MF,20-24,Midfielder,Germany,Europe
654,Lucas Digne,FRA,Everton,Premier League,2018,25.0,1993.0,32.9,71,46,45,18,8,28,45,62.2,17,43,9,34,60,131,116,0,DF,25-29,Defender,France,Europe
655,Mitchell Dijks,NED,Bologna,Serie A,2018,25.0,1993.0,22.5,30,18,19,7,4,13,36,36.1,23,18,1,17,23,53,49,0,DF,25-29,Defender,Netherlands,Europe
656,Javairô Dilrosun,NED,Hertha BSC,Bundesliga,2018,20.0,1998.0,10.0,14,10,7,5,2,3,7,42.9,4,18,2,16,7,21,9,0,"FW,MF",20-24,Forward,Netherlands,Europe
657,Federico Dimarco,ITA,Parma,Serie A,2018,20.0,1997.0,9.9,22,7,10,8,4,10,20,50.0,10,13,6,7,15,37,27,0,"DF,MF",20-24,Defender,Italy,Europe
658,Stole Dimitrievski,MKD,Rayo Vallecano,La Liga,2018,24.0,1993.0,21.0,0,0,0,0,0,0,1,0.0,1,0,0,0,0,0,8,1,GK,20-24,Goalkeeper,North Macedonia,Europe
659,Tristan Dingomé,CMR,Reims,Ligue 1,2018,27.0,1991.0,14.9,27,15,11,10,6,7,24,29.2,17,16,3,13,11,38,5,0,MF,25-29,Midfielder,Cameroon,Africa
660,Ismaël Diomandé,CIV,Caen,Ligue 1,2018,25.0,1992.0,14.4,28,15,15,12,1,11,20,55.0,9,17,7,10,10,38,37,0,"MF,DF",25-29,Midfielder,Ivory Coast,Africa
661,Federico Dionisi,ITA,Frosinone,Serie A,2018,31.0,1987.0,2.3,3,1,0,2,1,0,2,0.0,2,0,0,0,0,3,0,0,"FW,MF",30-34,Forward,Italy,Europe
662,Lois Diony,FRA,Saint-Étienne,Ligue 1,2018,25.0,1992.0,17.7,17,12,3,9,5,4,10,40.0,6,14,0,14,1,18,9,0,FW,25-29,Forward,France,Europe
663,Issa Diop,FRA,West Ham,Premier League,2018,21.0,1997.0,33.0,68,38,47,21,0,37,57,64.9,20,58,36,22,64,132,161,4,DF,20-24,Defender,France,Europe
664,Papakouli Diop,SEN,Eibar,La Liga,2018,32.0,1986.0,26.1,66,40,14,44,8,14,34,41.2,20,21,1,20,37,103,27,0,MF,30-34,Midfielder,Senegal,Africa
665,Sofiane Diop,FRA,Monaco,Ligue 1,2018,18.0,2000.0,8.2,12,7,3,6,3,1,15,6.7,14,6,0,6,8,20,6,0,"MF,FW",Under 20,Midfielder,France,Europe
666,Assane Dioussé,SEN,Chievo,Serie A,2018,20.0,1997.0,9.9,24,16,11,8,5,10,23,43.5,13,14,4,10,19,43,13,2,MF,20-24,Midfielder,Senegal,Africa
667,Assane Dioussé,SEN,Saint-Étienne,Ligue 1,2018,20.0,1997.0,2.4,6,4,3,3,0,2,4,50.0,2,2,0,2,1,7,7,1,MF,20-24,Midfielder,Senegal,Africa
668,Axel Disasi,FRA,Reims,Ligue 1,2018,20.0,1998.0,1.8,2,1,1,1,0,1,2,50.0,1,2,1,1,2,4,16,0,DF,20-24,Defender,France,Europe
670,Koffi Djidji,CIV,Torino,Serie A,2018,25.0,1992.0,15.4,37,23,27,9,1,12,20,60.0,8,26,19,7,24,61,72,1,DF,25-29,Defender,Ivory Coast,Africa
671,Koffi Djidji,CIV,Nantes,Ligue 1,2018,25.0,1992.0,1.0,1,1,1,0,0,0,0,,0,1,1,0,1,2,3,0,DF,25-29,Defender,Ivory Coast,Africa
672,Alexander Djiku,GHA,Caen,Ligue 1,2018,23.0,1994.0,30.6,48,37,33,13,2,23,43,53.5,20,56,31,25,83,131,183,3,DF,20-24,Defender,Ghana,Africa
673,Papy Djilobodji,SEN,Guingamp,Ligue 1,2018,29.0,1988.0,1.9,1,1,1,0,0,0,0,,0,4,2,2,0,1,11,0,DF,25-29,Defender,Senegal,Africa
674,Berat Djimsiti,ALB,Atalanta,Serie A,2018,25.0,1993.0,20.1,32,22,18,12,2,13,29,44.8,16,21,11,10,34,66,96,0,DF,25-29,Defender,Albania,Europe
675,Johan Djourou,SUI,SPAL,Serie A,2018,31.0,1987.0,3.1,3,1,3,0,0,2,2,100.0,0,5,3,2,4,7,20,0,DF,30-34,Defender,Switzerland,Europe
677,Matt Doherty,IRL,Wolves,Premier League,2018,26.0,1992.0,34.9,67,42,48,15,4,35,58,60.3,23,49,7,42,60,127,107,2,"DF,MF",25-29,Defender,Republic of Ireland,Europe
678,Keagan Dolly,RSA,Montpellier,Ligue 1,2018,25.0,1993.0,1.0,1,1,0,1,0,0,3,0.0,3,0,0,0,0,1,0,0,FW,25-29,Forward,South Africa,Africa
680,Giulio Donati,ITA,Mainz 05,Bundesliga,2018,28.0,1990.0,6.9,9,7,6,3,0,8,10,80.0,2,5,3,2,16,25,24,0,DF,25-29,Defender,Italy,Europe
681,Ji Dong-won,KOR,Augsburg,Bundesliga,2018,27.0,1991.0,9.9,10,6,5,3,2,6,16,37.5,10,13,2,11,8,18,10,0,"MF,FW",25-29,Midfielder,South Korea,Asia
682,Anastasios Donis,GRE,Stuttgart,Bundesliga,2018,21.0,1996.0,10.7,15,13,8,4,3,3,11,27.3,8,7,0,7,4,19,0,0,"FW,MF",20-24,Forward,Greece,Europe
683,Gianluigi Donnarumma,ITA,Milan,Serie A,2018,19.0,1999.0,34.3,1,1,1,0,0,1,2,50.0,1,0,0,0,1,2,13,3,GK,Under 20,Goalkeeper,Italy,Europe
684,Godfred Donsah,GHA,Bologna,Serie A,2018,22.0,1996.0,1.7,3,1,3,0,0,3,5,60.0,2,4,2,2,0,3,7,0,MF,20-24,Midfielder,Ghana,Africa
685,Riccardo Doratiotto,ITA,Cagliari,Serie A,2018,19.0,1999.0,0.9,1,1,0,0,1,0,0,,0,0,0,0,0,1,0,0,FW,Under 20,Forward,Italy,Europe
687,Abdoulaye Doucouré,MLI,Watford,Premier League,2018,25.0,1993.0,34.0,71,38,27,32,12,19,57,33.3,38,31,8,23,34,105,55,5,MF,25-29,Midfielder,Mali,Africa
688,Cheick Doukouré,CIV,Levante,La Liga,2018,25.0,1992.0,3.5,13,7,3,7,3,4,15,26.7,11,10,2,8,3,16,3,1,MF,25-29,Midfielder,Ivory Coast,Africa
689,Moussa Doumbia,MLI,Reims,Ligue 1,2018,23.0,1994.0,17.8,28,13,13,13,2,11,39,28.2,28,7,2,5,7,35,13,0,"FW,MF",20-24,Forward,Mali,Africa
690,Seydou Doumbia,CIV,Girona,La Liga,2018,30.0,1987.0,6.0,5,1,1,2,2,0,2,0.0,2,2,0,2,3,8,1,0,FW,30-34,Forward,Ivory Coast,Africa
691,Souleyman Doumbia,CIV,Rennes,Ligue 1,2018,21.0,1996.0,6.7,11,7,9,2,0,6,10,60.0,4,6,1,5,4,15,20,0,DF,20-24,Defender,Ivory Coast,Africa
692,Aleksandar Dragović,AUT,Leverkusen,Bundesliga,2018,27.0,1991.0,14.8,18,12,14,4,0,9,14,64.3,5,15,8,7,25,43,66,0,DF,25-29,Defender,Austria,Europe
695,Julian Draxler,GER,Paris S-G,Ligue 1,2018,24.0,1993.0,22.7,41,22,11,19,11,16,43,37.2,27,20,1,19,15,56,2,1,"MF,FW",20-24,Midfielder,Germany,Europe
696,Luke Dreher,ENG,Crystal Palace,Premier League,2018,19.0,1998.0,0.0,0,0,0,0,0,0,0,,0,0,0,0,0,0,0,0,FW,Under 20,Forward,England,Europe
697,Josip Drmić,SUI,Gladbach,Bundesliga,2018,25.0,1992.0,2.5,2,0,0,2,0,1,2,50.0,1,1,0,1,1,3,0,0,FW,25-29,Forward,Switzerland,Europe
699,Óscar Duarte,CRC,Espanyol,La Liga,2018,29.0,1989.0,7.3,12,5,7,5,0,4,7,57.1,3,7,7,0,13,25,34,0,"DF,MF",25-29,Defender,Costa Rica,North America
701,Leo Dubois,FRA,Lyon,Ligue 1,2018,23.0,1994.0,22.7,51,22,25,21,5,20,35,57.1,15,30,10,20,22,73,61,1,DF,20-24,Defender,France,Europe
702,Martin Dúbravka,SVK,Newcastle Utd,Premier League,2018,29.0,1989.0,38.0,2,0,2,0,0,1,3,33.3,2,0,0,0,0,2,20,5,GK,25-29,Goalkeeper,Slovakia,Europe
703,Marvin Ducksch,GER,Düsseldorf,Bundesliga,2018,24.0,1994.0,9.1,3,1,0,2,1,1,5,20.0,4,4,0,4,4,7,11,0,FW,20-24,Forward,Germany,Europe
704,Ondrej Duda,SVK,Hertha BSC,Bundesliga,2018,23.0,1994.0,28.5,54,33,13,35,6,15,55,27.3,40,36,4,32,15,69,17,1,MF,20-24,Midfielder,Slovakia,Europe
705,Shane Duffy,IRL,Brighton,Premier League,2018,26.0,1992.0,34.3,35,20,23,7,5,14,25,56.0,11,57,47,10,36,71,244,3,DF,25-29,Defender,Republic of Ireland,Europe
706,Demeaco Duhaney,ENG,Huddersfield,Premier League,2018,19.0,1998.0,0.5,1,0,1,0,0,1,3,33.3,2,2,0,2,1,2,1,0,DF,Under 20,Defender,England,Europe
707,Paul Dummett,WAL,Newcastle Utd,Premier League,2018,26.0,1991.0,22.1,34,22,24,9,1,19,32,59.4,13,25,11,14,37,71,133,0,DF,25-29,Defender,Wales,Europe
708,Alfred Duncan,GHA,Sassuolo,Serie A,2018,25.0,1993.0,20.5,33,21,15,15,3,19,48,39.6,29,20,6,14,15,48,18,0,MF,25-29,Midfielder,Ghana,Africa
709,Lewis Dunk,ENG,Brighton,Premier League,2018,26.0,1991.0,35.0,42,26,31,10,1,17,39,43.6,22,49,38,11,46,88,196,5,DF,25-29,Defender,England,Europe
710,Maxime Dupé,FRA,Nantes,Ligue 1,2018,25.0,1993.0,10.4,0,0,0,0,0,0,0,,0,0,0,0,0,0,3,1,GK,25-29,Goalkeeper,France,Europe
711,Erik Durm,GER,Huddersfield,Premier League,2018,26.0,1992.0,22.8,35,22,24,8,3,14,33,42.4,19,26,6,20,41,76,42,0,DF,25-29,Defender,Germany,Europe
712,Jimmy Durmaz,SWE,Toulouse,Ligue 1,2018,29.0,1989.0,21.1,34,22,8,13,13,15,38,39.5,23,14,2,12,11,45,16,1,"MF,FW",25-29,Midfielder,Sweden,Europe
713,Riza Durmisi,DEN,Lazio,Serie A,2018,24.0,1994.0,3.6,4,4,2,0,2,2,3,66.7,1,0,0,0,1,5,9,0,DF,20-24,Defender,Denmark,Europe
715,Raphael Dwamena,GHA,Levante,La Liga,2018,22.0,1995.0,2.5,0,0,0,0,0,0,0,,0,2,1,1,0,0,2,0,FW,20-24,Forward,Ghana,Africa
716,Paulo Dybala,ARG,Juventus,Serie A,2018,24.0,1993.0,23.7,17,8,3,9,5,7,23,30.4,16,20,2,18,14,31,1,0,"FW,MF",20-24,Forward,Argentina,South America
717,Edin Džeko,BIH,Roma,Serie A,2018,32.0,1986.0,28.7,13,7,3,5,5,4,16,25.0,12,10,1,9,0,13,36,1,FW,30-34,Forward,Bosnia and Herzegovina,Europe
718,Blerim Džemaili,SUI,Bologna,Serie A,2018,32.0,1986.0,19.4,44,27,22,19,3,19,58,32.8,39,22,1,21,17,61,12,1,MF,30-34,Midfielder,Switzerland,Europe
719,Félix Eboa Eboa,CMR,Guingamp,Ligue 1,2018,21.0,1997.0,27.0,47,33,26,20,1,16,22,72.7,6,37,24,13,39,86,136,2,DF,20-24,Defender,Cameroon,Africa
720,Dennis Eckert,GER,Celta Vigo,La Liga,2018,21.0,1997.0,2.4,3,2,0,1,2,0,2,0.0,2,1,0,1,2,5,3,0,FW,20-24,Forward,Germany,Europe
721,Bruno Ecuele Manga,GAB,Cardiff City,Premier League,2018,30.0,1988.0,37.5,69,36,48,16,5,29,58,50.0,29,62,28,34,81,150,179,4,DF,30-34,Defender,Gabon,Africa
722,Simone Edera,ITA,Torino,Serie A,2018,21.0,1997.0,0.9,0,0,0,0,0,0,1,0.0,1,1,0,1,1,1,0,0,MF,20-24,Midfielder,Italy,Europe
723,Simone Edera,ITA,Bologna,Serie A,2018,21.0,1997.0,2.2,4,4,3,0,1,1,3,33.3,2,5,1,4,0,4,1,0,FW,20-24,Forward,Italy,Europe
724,Ederson,BRA,Manchester City,Premier League,2018,24.0,1993.0,38.0,3,3,2,1,0,3,3,100.0,0,0,0,0,1,4,12,2,GK,20-24,Goalkeeper,Brazil,South America
724,Ederson,BRA,Manchester City,Premier League,2018,24.0,1993.0,38.0,3,3,2,1,0,3,3,100.0,0,0,0,0,1,4,12,2,GK,20-24,Goalkeeper,Brazil,South America
724,Ederson,BRA,Manchester City,Premier League,2018,24.0,1993.0,38.0,3,3,2,1,0,3,3,100.0,0,0,0,0,1,4,12,2,GK,20-24,Goalkeeper,Brazil,South America
724,Ederson,BRA,Manchester City,Premier League,2018,24.0,1993.0,38.0,3,3,2,1,0,3,3,100.0,0,0,0,0,1,4,12,2,GK,20-24,Goalkeeper,Brazil,South America
725,Johannes Eggestein,GER,Werder Bremen,Bundesliga,2018,20.0,1998.0,12.4,13,9,7,4,2,5,19,26.3,14,13,0,13,4,17,7,0,"FW,MF",20-24,Forward,Germany,Europe
726,Maximilian Eggestein,GER,Werder Bremen,Bundesliga,2018,21.0,1996.0,33.9,68,42,29,34,5,24,54,44.4,30,49,10,39,30,98,69,0,MF,20-24,Midfielder,Germany,Europe
727,Albin Ekdal,SWE,Sampdoria,Serie A,2018,29.0,1989.0,29.4,61,39,16,38,7,37,68,54.4,31,42,12,30,53,114,62,1,MF,25-29,Midfielder,Sweden,Europe
728,Josip Elez,CRO,Hannover 96,Bundesliga,2018,24.0,1994.0,7.2,8,3,5,3,0,2,11,18.2,9,13,4,9,6,14,27,0,DF,20-24,Defender,Croatia,Europe
729,Harvey Elliott,ENG,Fulham,Premier League,2018,15.0,2003.0,0.2,0,0,0,0,0,0,0,,0,1,0,1,0,0,0,0,MF,Under 20,Midfielder,England,Europe
730,Mohamed Elneny,EGY,Arsenal,Premier League,2018,26.0,1992.0,4.2,13,4,9,1,3,1,2,50.0,1,7,4,3,2,15,8,0,MF,25-29,Midfielder,Egypt,Africa
733,Nico Elvedi,SUI,Gladbach,Bundesliga,2018,21.0,1996.0,29.1,41,19,34,7,0,23,33,69.7,10,30,13,17,47,88,135,6,DF,20-24,Defender,Switzerland,Europe
734,Rodrigo Ely,BRA,Alavés,La Liga,2018,24.0,1993.0,4.8,8,5,5,3,0,5,7,71.4,2,9,7,2,7,15,30,0,DF,20-24,Defender,Brazil,South America
737,Breel Embolo,SUI,Schalke 04,Bundesliga,2018,21.0,1997.0,14.9,22,17,4,13,5,1,9,11.1,8,11,0,11,4,26,6,0,FW,20-24,Forward,Switzerland,Europe
738,Emerson,BRA,Betis,La Liga,2018,19.0,1999.0,3.5,9,7,6,1,2,3,10,30.0,7,6,0,6,7,16,12,0,"FW,DF",Under 20,Forward,Brazil,South America
739,Youssef En-Nesyri,MAR,Leganés,La Liga,2018,21.0,1997.0,23.4,16,8,6,5,5,4,24,16.7,20,18,3,15,6,22,23,0,FW,20-24,Forward,Morocco,Africa
740,Björn Engels,BEL,Reims,Ligue 1,2018,23.0,1994.0,33.0,11,8,6,5,0,6,16,37.5,10,30,24,6,44,55,181,3,DF,20-24,Defender,Belgium,Europe
743,Christian Eriksen,DEN,Tottenham,Premier League,2018,26.0,1992.0,30.8,41,25,8,20,13,17,59,28.8,42,26,3,23,15,56,13,0,MF,25-29,Midfielder,Denmark,Europe
744,Patrick Erras,GER,Nürnberg,Bundesliga,2018,23.0,1995.0,13.6,15,10,7,7,1,7,19,36.8,12,24,13,11,23,38,45,0,MF,20-24,Midfielder,Germany,Europe
745,Gonzalo Escalante,ARG,Eibar,La Liga,2018,25.0,1993.0,19.9,49,28,11,35,3,19,46,41.3,27,37,2,35,21,70,21,0,MF,25-29,Midfielder,Argentina,South America
747,Bernardo Espinosa,COL,Girona,La Liga,2018,29.0,1989.0,30.3,20,14,16,4,0,8,17,47.1,9,46,31,15,40,60,197,5,DF,25-29,Defender,Colombia,South America
748,Michael Esser,GER,Hannover 96,Bundesliga,2018,30.0,1987.0,32.0,3,2,3,0,0,2,5,40.0,3,1,0,1,1,4,15,0,GK,30-34,Goalkeeper,Germany,Europe
749,Alexander Esswein,GER,Stuttgart,Bundesliga,2018,28.0,1990.0,13.9,17,11,6,4,7,6,21,28.6,15,17,0,17,12,29,16,0,"MF,FW",25-29,Midfielder,Germany,Europe
750,Neil Etheridge,PHI,Cardiff City,Premier League,2018,28.0,1990.0,38.0,1,1,1,0,0,1,2,50.0,1,0,0,0,7,8,19,1,GK,25-29,Goalkeeper,Philippines,Asia
753,Lucas Evangelista,BRA,Nantes,Ligue 1,2018,23.0,1995.0,8.0,30,17,11,12,7,14,25,56.0,11,10,0,10,9,39,6,0,"FW,MF",20-24,Forward,Brazil,South America
755,Ewerton,BRA,Nürnberg,Bundesliga,2018,29.0,1989.0,14.9,24,20,21,3,0,8,14,57.1,6,23,16,7,25,49,108,1,DF,25-29,Defender,Brazil,South America
755,Ewerton,BRA,Nürnberg,Bundesliga,2018,29.0,1989.0,14.9,24,20,21,3,0,8,14,57.1,6,23,16,7,25,49,108,1,DF,25-29,Defender,Brazil,South America
755,Ewerton,BRA,Nürnberg,Bundesliga,2018,29.0,1989.0,14.9,24,20,21,3,0,8,14,57.1,6,23,16,7,25,49,108,1,DF,25-29,Defender,Brazil,South America
755,Ewerton,BRA,Nürnberg,Bundesliga,2018,29.0,1989.0,14.9,24,20,21,3,0,8,14,57.1,6,23,16,7,25,49,108,1,DF,25-29,Defender,Brazil,South America
756,Valentin Eysseric,FRA,Fiorentina,Serie A,2018,26.0,1992.0,4.0,6,5,3,2,1,2,4,50.0,2,6,1,5,4,10,1,0,"FW,MF",25-29,Forward,France,Europe
757,Valentin Eysseric,FRA,Nantes,Ligue 1,2018,26.0,1992.0,2.3,1,1,0,1,0,0,2,0.0,2,2,0,2,0,1,0,0,"MF,FW",25-29,Midfielder,France,Europe
758,Marco Fabián,MEX,Eint Frankfurt,Bundesliga,2018,29.0,1989.0,0.7,3,2,2,1,0,1,1,100.0,0,0,0,0,3,6,0,0,FW,25-29,Forward,Mexico,North America
760,Fabinho,BRA,Liverpool,Premier League,2018,24.0,1993.0,22.4,59,31,17,38,4,24,59,40.7,35,34,6,28,28,87,27,2,MF,20-24,Midfielder,Brazil,South America
760,Fabinho,BRA,Liverpool,Premier League,2018,24.0,1993.0,22.4,59,31,17,38,4,24,59,40.7,35,34,6,28,28,87,27,2,MF,20-24,Midfielder,Brazil,South America
760,Fabinho,BRA,Liverpool,Premier League,2018,24.0,1993.0,22.4,59,31,17,38,4,24,59,40.7,35,34,6,28,28,87,27,2,MF,20-24,Midfielder,Brazil,South America
760,Fabinho,BRA,Liverpool,Premier League,2018,24.0,1993.0,22.4,59,31,17,38,4,24,59,40.7,35,34,6,28,28,87,27,2,MF,20-24,Midfielder,Brazil,South America
760,Fabinho,BRA,Liverpool,Premier League,2018,24.0,1993.0,22.4,59,31,17,38,4,24,59,40.7,35,34,6,28,28,87,27,2,MF,20-24,Midfielder,Brazil,South America
760,Fabinho,BRA,Liverpool,Premier League,2018,24.0,1993.0,22.4,59,31,17,38,4,24,59,40.7,35,34,6,28,28,87,27,2,MF,20-24,Midfielder,Brazil,South America
760,Fabinho,BRA,Liverpool,Premier League,2018,24.0,1993.0,22.4,59,31,17,38,4,24,59,40.7,35,34,6,28,28,87,27,2,MF,20-24,Midfielder,Brazil,South America
760,Fabinho,BRA,Liverpool,Premier League,2018,24.0,1993.0,22.4,59,31,17,38,4,24,59,40.7,35,34,6,28,28,87,27,2,MF,20-24,Midfielder,Brazil,South America
760,Fabinho,BRA,Liverpool,Premier League,2018,24.0,1993.0,22.4,59,31,17,38,4,24,59,40.7,35,34,6,28,28,87,27,2,MF,20-24,Midfielder,Brazil,South America
760,Fabinho,BRA,Liverpool,Premier League,2018,24.0,1993.0,22.4,59,31,17,38,4,24,59,40.7,35,34,6,28,28,87,27,2,MF,20-24,Midfielder,Brazil,South America
760,Fabinho,BRA,Liverpool,Premier League,2018,24.0,1993.0,22.4,59,31,17,38,4,24,59,40.7,35,34,6,28,28,87,27,2,MF,20-24,Midfielder,Brazil,South America
760,Fabinho,BRA,Liverpool,Premier League,2018,24.0,1993.0,22.4,59,31,17,38,4,24,59,40.7,35,34,6,28,28,87,27,2,MF,20-24,Midfielder,Brazil,South America
760,Fabinho,BRA,Liverpool,Premier League,2018,24.0,1993.0,22.4,59,31,17,38,4,24,59,40.7,35,34,6,28,28,87,27,2,MF,20-24,Midfielder,Brazil,South America
760,Fabinho,BRA,Liverpool,Premier League,2018,24.0,1993.0,22.4,59,31,17,38,4,24,59,40.7,35,34,6,28,28,87,27,2,MF,20-24,Midfielder,Brazil,South America
760,Fabinho,BRA,Liverpool,Premier League,2018,24.0,1993.0,22.4,59,31,17,38,4,24,59,40.7,35,34,6,28,28,87,27,2,MF,20-24,Midfielder,Brazil,South America
760,Fabinho,BRA,Liverpool,Premier League,2018,24.0,1993.0,22.4,59,31,17,38,4,24,59,40.7,35,34,6,28,28,87,27,2,MF,20-24,Midfielder,Brazil,South America
760,Fabinho,BRA,Liverpool,Premier League,2018,24.0,1993.0,22.4,59,31,17,38,4,24,59,40.7,35,34,6,28,28,87,27,2,MF,20-24,Midfielder,Brazil,South America
760,Fabinho,BRA,Liverpool,Premier League,2018,24.0,1993.0,22.4,59,31,17,38,4,24,59,40.7,35,34,6,28,28,87,27,2,MF,20-24,Midfielder,Brazil,South America
760,Fabinho,BRA,Liverpool,Premier League,2018,24.0,1993.0,22.4,59,31,17,38,4,24,59,40.7,35,34,6,28,28,87,27,2,MF,20-24,Midfielder,Brazil,South America
760,Fabinho,BRA,Liverpool,Premier League,2018,24.0,1993.0,22.4,59,31,17,38,4,24,59,40.7,35,34,6,28,28,87,27,2,MF,20-24,Midfielder,Brazil,South America
760,Fabinho,BRA,Liverpool,Premier League,2018,24.0,1993.0,22.4,59,31,17,38,4,24,59,40.7,35,34,6,28,28,87,27,2,MF,20-24,Midfielder,Brazil,South America
760,Fabinho,BRA,Liverpool,Premier League,2018,24.0,1993.0,22.4,59,31,17,38,4,24,59,40.7,35,34,6,28,28,87,27,2,MF,20-24,Midfielder,Brazil,South America
760,Fabinho,BRA,Liverpool,Premier League,2018,24.0,1993.0,22.4,59,31,17,38,4,24,59,40.7,35,34,6,28,28,87,27,2,MF,20-24,Midfielder,Brazil,South America
760,Fabinho,BRA,Liverpool,Premier League,2018,24.0,1993.0,22.4,59,31,17,38,4,24,59,40.7,35,34,6,28,28,87,27,2,MF,20-24,Midfielder,Brazil,South America
760,Fabinho,BRA,Liverpool,Premier League,2018,24.0,1993.0,22.4,59,31,17,38,4,24,59,40.7,35,34,6,28,28,87,27,2,MF,20-24,Midfielder,Brazil,South America
761,Fábio,BRA,Nantes,Ligue 1,2018,28.0,1990.0,14.2,53,34,25,27,1,26,53,49.1,27,18,4,14,18,71,27,0,"DF,FW",25-29,Defender,Brazil,South America
765,Ralf Fährmann,GER,Schalke 04,Bundesliga,2018,29.0,1988.0,16.3,0,0,0,0,0,0,0,,0,0,0,0,2,2,10,4,GK,25-29,Goalkeeper,Germany,Europe
766,Romain Faivre,FRA,Monaco,Ligue 1,2018,20.0,1998.0,1.0,1,0,0,1,0,0,1,0.0,1,0,0,0,1,2,1,1,MF,20-24,Midfielder,France,Europe
767,Fayçal Fajr,MAR,Caen,Ligue 1,2018,29.0,1988.0,36.0,65,32,22,33,10,25,66,37.9,41,27,6,21,29,94,19,2,MF,25-29,Midfielder,Morocco,Africa
768,Radamel Falcao,COL,Monaco,Ligue 1,2018,32.0,1986.0,28.4,34,15,6,16,12,8,27,29.6,19,11,6,5,3,37,23,2,FW,30-34,Forward,Colombia,South America
769,Diego Falcinelli,ITA,Bologna,Serie A,2018,27.0,1991.0,7.8,8,5,1,3,4,2,3,66.7,1,4,1,3,1,9,5,0,FW,25-29,Forward,Italy,Europe
770,Simon Falette,GUI,Eint Frankfurt,Bundesliga,2018,26.0,1992.0,6.7,9,6,7,1,1,2,6,33.3,4,11,5,6,14,23,32,0,DF,25-29,Defender,Guinea,Africa
772,Paolo Faragò,ITA,Cagliari,Serie A,2018,25.0,1993.0,18.9,46,29,20,16,10,13,43,30.2,30,28,2,26,15,61,38,0,"MF,DF",25-29,Midfielder,Italy,Europe
773,Mohamed Fares,ALG,SPAL,Serie A,2018,22.0,1996.0,32.8,63,43,37,18,8,25,54,46.3,29,48,4,44,54,117,83,2,DF,20-24,Defender,Algeria,Africa
774,Diego Farias,BRA,Empoli,Serie A,2018,28.0,1990.0,13.3,11,4,2,8,1,3,10,30.0,7,7,1,6,0,11,4,0,FW,25-29,Forward,Brazil,South America
775,Diego Farias,BRA,Cagliari,Serie A,2018,28.0,1990.0,7.8,13,9,3,7,3,2,11,18.2,9,7,1,6,1,14,5,0,FW,25-29,Forward,Brazil,South America
776,Andrea Favilli,ITA,Genoa,Serie A,2018,21.0,1997.0,1.9,1,1,0,0,1,0,1,0.0,1,1,0,1,0,1,1,0,"FW,DF",20-24,Forward,Italy,Europe
777,Federico Fazio,ARG,Roma,Serie A,2018,31.0,1987.0,31.2,28,20,14,11,3,12,25,48.0,13,45,33,12,53,81,171,2,DF,30-34,Defender,Argentina,South America
778,Zouhair Feddal,MAR,Betis,La Liga,2018,29.0,1989.0,18.9,38,23,31,6,1,16,28,57.1,12,19,8,11,31,69,94,2,DF,25-29,Defender,Morocco,Africa
779,Nabil Fekir,FRA,Lyon,Ligue 1,2018,25.0,1993.0,22.1,51,31,16,19,16,13,38,34.2,25,42,0,42,7,58,3,0,MF,25-29,Midfielder,France,Europe
780,Yassin Fekir,FRA,Lyon,Ligue 1,2018,21.0,1997.0,0.1,0,0,0,0,0,0,1,0.0,1,0,0,0,0,0,0,0,FW,20-24,Forward,France,Europe
781,Felipe,BRA,Hannover 96,Bundesliga,2018,31.0,1987.0,12.2,23,15,21,2,0,9,17,52.9,8,17,9,8,35,58,71,0,DF,30-34,Defender,Brazil,South America
781,Felipe,BRA,Hannover 96,Bundesliga,2018,31.0,1987.0,12.2,23,15,21,2,0,9,17,52.9,8,17,9,8,35,58,71,0,DF,30-34,Defender,Brazil,South America
781,Felipe,BRA,Hannover 96,Bundesliga,2018,31.0,1987.0,12.2,23,15,21,2,0,9,17,52.9,8,17,9,8,35,58,71,0,DF,30-34,Defender,Brazil,South America
781,Felipe,BRA,Hannover 96,Bundesliga,2018,31.0,1987.0,12.2,23,15,21,2,0,9,17,52.9,8,17,9,8,35,58,71,0,DF,30-34,Defender,Brazil,South America
782,Luiz Felipe,ITA,Lazio,Serie A,2018,21.0,1997.0,14.3,27,18,20,7,0,13,20,65.0,7,27,15,12,26,53,57,1,DF,20-24,Defender,Italy,Europe
782,Luiz Felipe,ITA,Lazio,Serie A,2018,21.0,1997.0,14.3,27,18,20,7,0,13,20,65.0,7,27,15,12,26,53,57,1,DF,20-24,Defender,Italy,Europe
782,Luiz Felipe,ITA,Lazio,Serie A,2018,21.0,1997.0,14.3,27,18,20,7,0,13,20,65.0,7,27,15,12,26,53,57,1,DF,20-24,Defender,Italy,Europe
782,Luiz Felipe,ITA,Lazio,Serie A,2018,21.0,1997.0,14.3,27,18,20,7,0,13,20,65.0,7,27,15,12,26,53,57,1,DF,20-24,Defender,Italy,Europe
783,Ohis Felix Uduokhai,GER,Wolfsburg,Bundesliga,2018,20.0,1997.0,2.7,13,7,7,5,1,9,10,90.0,1,6,2,4,6,19,11,1,DF,20-24,Defender,Germany,Europe
784,Marouane Fellaini,BEL,Manchester Utd,Premier League,2018,30.0,1987.0,8.4,21,13,11,9,1,9,17,52.9,8,9,5,4,4,25,34,1,MF,30-34,Midfielder,Belgium,Europe
786,Edimilson Fernandes,SUI,Fiorentina,Serie A,2018,22.0,1996.0,21.9,36,24,17,16,3,14,36,38.9,22,31,6,25,26,62,31,0,MF,20-24,Midfielder,Switzerland,Europe
787,Gelson Fernandes,SUI,Eint Frankfurt,Bundesliga,2018,31.0,1986.0,24.7,74,48,33,38,3,23,65,35.4,42,45,9,36,53,127,16,0,MF,30-34,Midfielder,Switzerland,Europe
791,Federico Fernández,ARG,Newcastle Utd,Premier League,2018,29.0,1989.0,16.5,16,12,12,4,0,10,18,55.6,8,19,12,7,25,41,106,1,DF,25-29,Defender,Argentina,South America
794,Fernandinho,BRA,Manchester City,Premier League,2018,33.0,1985.0,26.4,57,43,19,30,8,26,47,55.3,21,28,4,24,41,98,70,0,MF,30-34,Midfielder,Brazil,South America
794,Fernandinho,BRA,Manchester City,Premier League,2018,33.0,1985.0,26.4,57,43,19,30,8,26,47,55.3,21,28,4,24,41,98,70,0,MF,30-34,Midfielder,Brazil,South America
794,Fernandinho,BRA,Manchester City,Premier League,2018,33.0,1985.0,26.4,57,43,19,30,8,26,47,55.3,21,28,4,24,41,98,70,0,MF,30-34,Midfielder,Brazil,South America
794,Fernandinho,BRA,Manchester City,Premier League,2018,33.0,1985.0,26.4,57,43,19,30,8,26,47,55.3,21,28,4,24,41,98,70,0,MF,30-34,Midfielder,Brazil,South America
794,Fernandinho,BRA,Manchester City,Premier League,2018,33.0,1985.0,26.4,57,43,19,30,8,26,47,55.3,21,28,4,24,41,98,70,0,MF,30-34,Midfielder,Brazil,South America
794,Fernandinho,BRA,Manchester City,Premier League,2018,33.0,1985.0,26.4,57,43,19,30,8,26,47,55.3,21,28,4,24,41,98,70,0,MF,30-34,Midfielder,Brazil,South America
794,Fernandinho,BRA,Manchester City,Premier League,2018,33.0,1985.0,26.4,57,43,19,30,8,26,47,55.3,21,28,4,24,41,98,70,0,MF,30-34,Midfielder,Brazil,South America
794,Fernandinho,BRA,Manchester City,Premier League,2018,33.0,1985.0,26.4,57,43,19,30,8,26,47,55.3,21,28,4,24,41,98,70,0,MF,30-34,Midfielder,Brazil,South America
794,Fernandinho,BRA,Manchester City,Premier League,2018,33.0,1985.0,26.4,57,43,19,30,8,26,47,55.3,21,28,4,24,41,98,70,0,MF,30-34,Midfielder,Brazil,South America
794,Fernandinho,BRA,Manchester City,Premier League,2018,33.0,1985.0,26.4,57,43,19,30,8,26,47,55.3,21,28,4,24,41,98,70,0,MF,30-34,Midfielder,Brazil,South America
794,Fernandinho,BRA,Manchester City,Premier League,2018,33.0,1985.0,26.4,57,43,19,30,8,26,47,55.3,21,28,4,24,41,98,70,0,MF,30-34,Midfielder,Brazil,South America
794,Fernandinho,BRA,Manchester City,Premier League,2018,33.0,1985.0,26.4,57,43,19,30,8,26,47,55.3,21,28,4,24,41,98,70,0,MF,30-34,Midfielder,Brazil,South America
794,Fernandinho,BRA,Manchester City,Premier League,2018,33.0,1985.0,26.4,57,43,19,30,8,26,47,55.3,21,28,4,24,41,98,70,0,MF,30-34,Midfielder,Brazil,South America
794,Fernandinho,BRA,Manchester City,Premier League,2018,33.0,1985.0,26.4,57,43,19,30,8,26,47,55.3,21,28,4,24,41,98,70,0,MF,30-34,Midfielder,Brazil,South America
794,Fernandinho,BRA,Manchester City,Premier League,2018,33.0,1985.0,26.4,57,43,19,30,8,26,47,55.3,21,28,4,24,41,98,70,0,MF,30-34,Midfielder,Brazil,South America
794,Fernandinho,BRA,Manchester City,Premier League,2018,33.0,1985.0,26.4,57,43,19,30,8,26,47,55.3,21,28,4,24,41,98,70,0,MF,30-34,Midfielder,Brazil,South America
795,Juan Ferney Otero,COL,Amiens,Ligue 1,2018,23.0,1995.0,24.2,29,13,11,12,6,13,46,28.3,33,23,3,20,22,51,18,0,"FW,MF",20-24,Forward,Colombia,South America
796,Alex Ferrari,ITA,Sampdoria,Serie A,2018,24.0,1994.0,6.0,10,8,4,6,0,5,7,71.4,2,7,4,3,9,19,26,0,DF,20-24,Defender,Italy,Europe
798,Facundo Ferreyra,ARG,Espanyol,La Liga,2018,27.0,1991.0,2.3,5,2,0,4,1,1,3,33.3,2,3,0,3,0,5,5,0,FW,25-29,Forward,Argentina,South America
799,Jordan Ferri,FRA,Nîmes,Ligue 1,2018,26.0,1992.0,20.8,52,31,22,23,7,26,62,41.9,36,27,2,25,15,67,9,1,MF,25-29,Midfielder,France,Europe
800,Jordan Ferri,FRA,Lyon,Ligue 1,2018,26.0,1992.0,1.3,5,3,3,1,1,1,4,25.0,3,4,2,2,1,6,3,0,MF,25-29,Midfielder,France,Europe
801,Oliver Fink,GER,Düsseldorf,Bundesliga,2018,36.0,1982.0,11.7,38,22,17,17,4,12,38,31.6,26,20,3,17,13,51,19,0,MF,35-39,Midfielder,Germany,Europe
802,Alfreð Finnbogason,ISL,Augsburg,Bundesliga,2018,29.0,1989.0,14.8,7,3,2,5,0,1,9,11.1,8,6,1,5,3,10,11,0,FW,25-29,Forward,Iceland,Europe
803,Roberto Firmino,BRA,Liverpool,Premier League,2018,26.0,1991.0,29.0,30,20,5,16,9,7,34,20.6,27,35,1,34,6,36,16,0,"FW,MF",25-29,Forward,Brazil,South America
804,Junior Firpo,DOM,Betis,La Liga,2018,21.0,1996.0,21.5,38,25,16,14,8,10,24,41.7,14,27,2,25,23,61,48,0,"DF,FW",20-24,Defender,Dominican Republic,North America
805,Mathieu Flamini,FRA,Getafe,La Liga,2018,34.0,1984.0,5.0,9,4,4,4,1,4,7,57.1,3,3,1,2,5,14,4,0,MF,30-34,Midfielder,France,Europe
806,Mark Flekken,NED,Freiburg,Bundesliga,2018,25.0,1993.0,1.0,0,0,0,0,0,0,0,,0,0,0,0,0,0,0,0,GK,25-29,Goalkeeper,Netherlands,Europe
807,Sergio Floccari,ITA,SPAL,Serie A,2018,36.0,1981.0,10.8,13,5,1,5,7,1,7,14.3,6,6,2,4,2,15,6,0,FW,35-39,Forward,Italy,Europe
808,Alessandro Florenzi,ITA,Roma,Serie A,2018,27.0,1991.0,24.2,38,21,22,11,5,17,37,45.9,20,27,5,22,46,84,58,0,"DF,FW",25-29,Defender,Italy,Europe
809,Phil Foden,ENG,Manchester City,Premier League,2018,18.0,2000.0,3.7,7,6,1,3,3,2,9,22.2,7,1,0,1,4,11,1,0,MF,Under 20,Midfielder,England,Europe
810,Guessouma Fofana,MTN,Amiens,Ligue 1,2018,25.0,1992.0,2.1,6,4,3,3,0,1,3,33.3,2,2,1,1,3,9,0,0,MF,25-29,Midfielder,Mauritania,Africa
811,Guessouma Fofana,MTN,Guingamp,Ligue 1,2018,25.0,1992.0,5.3,14,9,2,10,2,4,10,40.0,6,3,0,3,6,20,8,0,MF,25-29,Midfielder,Mauritania,Africa
812,Seko Fofana,CIV,Udinese,Serie A,2018,23.0,1995.0,29.3,25,13,14,10,1,6,36,16.7,30,20,7,13,29,54,18,3,MF,20-24,Midfielder,Ivory Coast,Africa
813,Wesley Fofana,FRA,Saint-Étienne,Ligue 1,2018,17.0,2000.0,1.8,7,6,5,2,0,6,13,46.2,7,1,0,1,4,11,9,0,DF,Under 20,Defender,France,Europe
814,Youssouf Fofana,FRA,Strasbourg,Ligue 1,2018,19.0,1999.0,10.1,28,20,5,20,3,9,27,33.3,18,7,0,7,11,39,8,0,MF,Under 20,Midfielder,France,Europe
815,Thomas Foket,BEL,Reims,Ligue 1,2018,23.0,1994.0,32.0,91,52,55,23,13,42,69,60.9,27,30,4,26,49,140,80,1,DF,20-24,Defender,Belgium,Europe
816,Thomas Fontaine,MAD,Reims,Ligue 1,2018,27.0,1991.0,4.7,6,3,5,0,1,2,5,40.0,3,6,2,4,7,13,28,1,"DF,MF",25-29,Defender,Madagascar,Africa
817,José Fonte,POR,Lille,Ligue 1,2018,34.0,1983.0,34.6,27,15,15,9,3,17,24,70.8,7,33,26,7,37,64,153,1,DF,30-34,Defender,Portugal,Europe
818,Rui Fonte,POR,Lille,Ligue 1,2018,28.0,1990.0,7.0,25,12,4,16,5,6,11,54.5,5,4,0,4,2,27,8,0,"FW,MF",25-29,Forward,Portugal,Europe
820,Emil Forsberg,SWE,RB Leipzig,Bundesliga,2018,26.0,1991.0,13.9,12,7,0,12,0,5,16,31.3,11,16,1,15,3,15,6,0,"MF,FW",25-29,Midfielder,Sweden,Europe
821,Fraser Forster,ENG,Southampton,Premier League,2018,30.0,1988.0,1.0,0,0,0,0,0,0,0,,0,0,0,0,0,0,1,0,GK,30-34,Goalkeeper,England,Europe
822,Steven Fortes,CPV,Toulouse,Ligue 1,2018,26.0,1992.0,1.5,3,1,1,2,0,0,0,,0,1,1,0,2,5,9,2,DF,25-29,Defender,Cape Verde,Africa
824,Ben Foster,ENG,Watford,Premier League,2018,35.0,1983.0,38.0,2,2,2,0,0,2,6,33.3,4,0,0,0,2,4,34,3,GK,35-39,Goalkeeper,England,Europe
825,Timothy Fosu-Mensah,NED,Fulham,Premier League,2018,20.0,1998.0,8.8,18,7,12,6,0,8,13,61.5,5,11,5,6,12,30,30,1,DF,20-24,Defender,Netherlands,Europe
826,Dimitri Foulquier,FRA,Getafe,La Liga,2018,25.0,1993.0,20.0,29,12,10,14,5,11,22,50.0,11,23,2,21,20,49,38,0,"MF,DF",25-29,Midfielder,France,Europe
827,Juan Foyth,ARG,Tottenham,Premier League,2018,20.0,1998.0,9.9,31,17,20,11,0,14,19,73.7,5,12,5,7,10,41,50,1,DF,20-24,Defender,Argentina,South America
828,Raphael Framberger,GER,Augsburg,Bundesliga,2018,22.0,1995.0,6.1,8,6,4,4,0,0,3,0.0,3,10,3,7,11,19,15,1,"DF,MF",20-24,Defender,Germany,Europe
829,Simon Francis,ENG,Bournemouth,Premier League,2018,33.0,1985.0,13.7,25,14,19,5,1,12,24,50.0,12,15,7,8,19,44,73,1,DF,30-34,Defender,England,Europe
830,Mike Frantz,GER,Freiburg,Bundesliga,2018,31.0,1986.0,24.6,34,26,15,15,4,6,20,30.0,14,24,4,20,21,55,32,0,"MF,FW",30-34,Midfielder,Germany,Europe
831,Ryan Fraser,SCO,Bournemouth,Premier League,2018,24.0,1994.0,35.2,19,11,9,8,2,10,32,31.3,22,23,6,17,22,41,33,0,"MF,FW",20-24,Midfielder,Scotland,Europe
832,Pierluigi Frattali,ITA,Parma,Serie A,2018,32.0,1985.0,1.0,0,0,0,0,0,0,0,,0,0,0,0,0,0,1,0,GK,30-34,Goalkeeper,Italy,Europe
833,Fred,BRA,Manchester Utd,Premier League,2018,25.0,1993.0,11.6,29,17,12,16,1,15,33,45.5,18,26,2,24,16,45,14,2,MF,25-29,Midfielder,Brazil,South America
834,Ryan Fredericks,ENG,West Ham,Premier League,2018,25.0,1992.0,12.1,38,23,33,5,0,21,32,65.6,11,15,5,10,13,51,49,1,DF,25-29,Defender,England,Europe
835,Remo Freuler,SUI,Atalanta,Serie A,2018,26.0,1992.0,33.6,84,45,34,34,16,30,70,42.9,40,62,12,50,38,122,45,0,MF,25-29,Midfielder,Switzerland,Europe
836,Nicolas Frey,FRA,Chievo,Serie A,2018,34.0,1984.0,2.5,3,1,2,1,0,0,3,0.0,3,3,3,0,7,10,18,0,DF,30-34,Defender,France,Europe
837,Marco Friedl,AUT,Werder Bremen,Bundesliga,2018,20.0,1998.0,5.3,8,6,4,3,1,3,11,27.3,8,9,6,3,13,21,21,0,DF,20-24,Defender,Austria,Europe
838,Alexander Fuchs,GER,Nürnberg,Bundesliga,2018,21.0,1997.0,7.3,14,12,5,7,2,5,15,33.3,10,9,1,8,5,19,10,0,"MF,FW",20-24,Midfielder,Germany,Europe
839,Christian Fuchs,AUT,Leicester City,Premier League,2018,32.0,1986.0,2.3,4,3,0,4,0,1,2,50.0,1,0,0,0,4,8,8,0,DF,30-34,Defender,Austria,Europe
841,Angelo Fulgini,FRA,Angers,Ligue 1,2018,21.0,1996.0,18.2,38,22,18,13,7,12,31,38.7,19,21,3,18,28,66,15,0,"MF,FW",20-24,Midfielder,France,Europe
842,Niclas Füllkrug,GER,Hannover 96,Bundesliga,2018,25.0,1993.0,12.4,3,0,0,1,2,1,5,20.0,4,10,4,6,1,4,17,0,FW,25-29,Forward,Germany,Europe
843,Ramiro Funes Mori,ARG,Villarreal,La Liga,2018,27.0,1991.0,29.2,41,29,30,9,2,19,44,43.2,25,36,24,12,42,83,149,2,"DF,MF",25-29,Defender,Argentina,South America
844,Manolo Gabbiadini,ITA,Southampton,Premier League,2018,26.0,1991.0,5.3,6,2,1,4,1,1,2,50.0,1,5,0,5,3,9,6,0,"FW,MF",25-29,Forward,Italy,Europe
845,Manolo Gabbiadini,ITA,Sampdoria,Serie A,2018,26.0,1991.0,9.0,5,2,1,3,1,3,11,27.3,8,6,1,5,4,9,4,0,FW,25-29,Forward,Italy,Europe
847,Gianluca Gaetano,ITA,Napoli,Serie A,2018,18.0,2000.0,0.1,0,0,0,0,0,0,0,,0,0,0,0,0,0,0,0,"MF,FW",Under 20,Midfielder,Italy,Europe
848,Roberto Gagliardini,ITA,Inter,Serie A,2018,24.0,1994.0,12.1,23,14,13,8,2,10,27,37.0,17,21,3,18,16,39,19,0,MF,20-24,Midfielder,Italy,Europe
849,Riccardo Gagliolo,SWE,Parma,Serie A,2018,28.0,1990.0,33.8,69,45,52,15,2,33,68,48.5,35,60,33,27,66,135,213,2,DF,25-29,Defender,Sweden,Europe
852,Sam Gallagher,ENG,Southampton,Premier League,2018,22.0,1995.0,0.4,0,0,0,0,0,0,0,,0,1,0,1,0,0,1,0,FW,20-24,Forward,England,Europe
856,Kévin Gameiro,FRA,Valencia,La Liga,2018,31.0,1987.0,17.9,14,9,4,6,4,1,6,16.7,5,12,2,10,5,19,3,0,FW,30-34,Forward,France,Europe
857,Idrissa Gana Gueye,SEN,Everton,Premier League,2018,28.0,1989.0,31.4,142,89,70,63,9,38,76,50.0,38,52,8,44,74,216,48,1,MF,25-29,Midfielder,Senegal,Africa
858,Ignatius Ganago,CMR,Nice,Ligue 1,2018,19.0,1999.0,11.5,3,1,0,2,1,0,7,0.0,7,2,0,2,1,4,7,0,FW,Under 20,Forward,Cameroon,Africa
859,Cristian Ganea,ROU,Athletic Club,La Liga,2018,26.0,1992.0,0.5,0,0,0,0,0,0,3,0.0,3,1,0,1,1,1,2,0,DF,25-29,Defender,Romania,Europe
860,Ganso,BRA,Amiens,Ligue 1,2018,28.0,1989.0,5.8,12,8,2,8,2,2,15,13.3,13,5,1,4,6,18,0,0,"MF,FW",25-29,Midfielder,Brazil,South America
861,Ezequiel Garay,ARG,Valencia,La Liga,2018,31.0,1986.0,23.7,20,17,15,3,2,9,18,50.0,9,30,23,7,16,36,140,0,DF,30-34,Defender,Argentina,South America
875,James Garner,ENG,Manchester Utd,Premier League,2018,17.0,2001.0,0.0,0,0,0,0,0,0,0,,0,0,0,0,0,0,0,0,MF,Under 20,Midfielder,England,Europe
877,Paulo Gazzaniga,ARG,Tottenham,Premier League,2018,26.0,1992.0,3.0,0,0,0,0,0,0,0,,0,0,0,0,0,0,1,0,GK,25-29,Goalkeeper,Argentina,South America
878,Marcello Gazzola,ITA,Parma,Serie A,2018,33.0,1985.0,10.2,9,4,2,5,2,5,9,55.6,4,6,3,3,4,13,33,0,"DF,MF",30-34,Defender,Italy,Europe
879,Jean-Philippe Gbamin,CIV,Mainz 05,Bundesliga,2018,22.0,1995.0,29.7,51,31,29,15,7,23,51,45.1,28,39,5,34,30,81,32,1,MF,20-24,Midfielder,Ivory Coast,Africa
882,Dennis Geiger,GER,Hoffenheim,Bundesliga,2018,20.0,1998.0,2.7,2,1,1,1,0,1,6,16.7,5,1,0,1,3,5,1,0,MF,20-24,Midfielder,Germany,Europe
883,Jérémy Gélin,FRA,Rennes,Ligue 1,2018,21.0,1997.0,14.2,30,16,18,10,2,18,34,52.9,16,14,6,8,19,49,29,0,"DF,MF",20-24,Defender,France,Europe
884,Romain Genevois,HAI,Caen,Ligue 1,2018,30.0,1987.0,4.0,10,6,9,1,0,6,11,54.5,5,3,0,3,8,18,13,0,DF,30-34,Defender,Haiti,North America
885,Christian Gentner,GER,Stuttgart,Bundesliga,2018,32.0,1985.0,22.4,61,38,29,26,6,16,50,32.0,34,30,3,27,31,92,41,1,"MF,FW",30-34,Midfielder,Germany,Europe
886,Yannick Gerhardt,GER,Wolfsburg,Bundesliga,2018,24.0,1994.0,27.3,52,34,22,20,10,16,43,37.2,27,35,7,28,30,82,34,0,MF,20-24,Midfielder,Germany,Europe
887,Valère Germain,FRA,Marseille,Ligue 1,2018,28.0,1990.0,24.1,38,25,8,22,8,8,33,24.2,25,20,5,15,6,44,30,0,FW,25-29,Forward,France,Europe
888,Gerson,BRA,Fiorentina,Serie A,2018,21.0,1997.0,27.0,42,26,22,15,5,12,38,31.6,26,46,9,37,16,58,32,0,"MF,FW",20-24,Midfielder,Brazil,South America
889,Gervinho,CIV,Parma,Serie A,2018,31.0,1987.0,25.6,19,12,11,5,3,5,13,38.5,8,7,0,7,10,29,2,0,FW,30-34,Forward,Ivory Coast,Africa
890,Willem Geubbels,FRA,Monaco,Ligue 1,2018,16.0,2001.0,0.1,0,0,0,0,0,0,0,,0,0,0,0,0,0,0,0,MF,Under 20,Midfielder,France,Europe
891,Lamine Ghezali,FRA,Saint-Étienne,Ligue 1,2018,19.0,1999.0,0.5,1,1,0,1,0,1,2,50.0,1,0,0,0,0,1,2,0,"FW,MF",Under 20,Forward,France,Europe
892,Rachid Ghezzal,ALG,Leicester City,Premier League,2018,26.0,1992.0,8.3,14,5,3,7,4,3,18,16.7,15,10,1,9,7,21,4,1,"FW,MF",25-29,Forward,Algeria,Africa
893,Paolo Ghiglione,ITA,Frosinone,Serie A,2018,21.0,1997.0,5.7,8,4,6,1,1,6,14,42.9,8,2,0,2,4,12,22,0,DF,20-24,Defender,Italy,Europe
894,Saman Ghoddos,IRN,Amiens,Ligue 1,2018,24.0,1993.0,20.3,33,17,14,15,4,13,32,40.6,19,15,2,13,7,40,13,0,"FW,MF",20-24,Forward,Iran,Asia
895,Faouzi Ghoulam,ALG,Napoli,Serie A,2018,27.0,1991.0,12.8,9,7,3,5,1,8,9,88.9,1,6,2,4,8,17,17,0,DF,25-29,Defender,Algeria,Africa
896,Emanuele Giaccherini,ITA,Chievo,Serie A,2018,33.0,1985.0,22.3,14,8,5,7,2,6,31,19.4,25,21,2,19,16,30,10,2,"MF,FW",30-34,Midfielder,Italy,Europe
897,Morgan Gibbs-White,ENG,Wolves,Premier League,2018,18.0,2000.0,7.4,6,3,2,4,0,1,4,25.0,3,6,0,6,1,7,0,0,"MF,FW",Under 20,Midfielder,England,Europe
898,Ben Gibson,ENG,Burnley,Premier League,2018,25.0,1993.0,0.7,1,1,1,0,0,0,0,,0,1,1,0,0,1,2,0,DF,25-29,Defender,England,Europe
899,Fabian Giefer,GER,Augsburg,Bundesliga,2018,28.0,1990.0,4.0,0,0,0,0,0,0,2,0.0,2,0,0,0,0,0,1,2,GK,25-29,Goalkeeper,Germany,Europe
900,Niko Gießelmann,GER,Düsseldorf,Bundesliga,2018,26.0,1991.0,28.8,57,37,38,14,5,26,59,44.1,33,25,6,19,36,93,85,1,DF,25-29,Defender,Germany,Europe
902,Daniel Ginczek,GER,Wolfsburg,Bundesliga,2018,27.0,1991.0,14.2,9,7,4,3,2,5,19,26.3,14,12,2,10,3,12,23,1,FW,25-29,Forward,Germany,Europe
903,Matthias Ginter,GER,Gladbach,Bundesliga,2018,24.0,1994.0,26.4,24,14,16,7,1,9,17,52.9,8,31,19,12,17,41,98,1,DF,20-24,Defender,Germany,Europe
904,Andrei Girotto,BRA,Nantes,Ligue 1,2018,26.0,1992.0,16.4,57,40,18,36,3,20,44,45.5,24,22,6,16,29,86,43,1,MF,25-29,Midfielder,Brazil,South America
905,Olivier Giroud,FRA,Chelsea,Premier League,2018,31.0,1986.0,9.4,3,2,0,1,2,1,4,25.0,3,6,1,5,3,6,7,0,FW,30-34,Forward,France,Europe
907,Serge Gnabry,GER,Bayern Munich,Bundesliga,2018,23.0,1995.0,19.6,36,20,12,13,11,5,30,16.7,25,18,0,18,11,47,3,0,"FW,MF",20-24,Forward,Germany,Europe
908,Joris Gnagnon,FRA,Sevilla,La Liga,2018,21.0,1997.0,5.0,11,8,6,4,1,4,7,57.1,3,2,2,0,10,21,16,0,"DF,MF",20-24,Defender,France,Europe
909,Eddy Gnahoré,FRA,Amiens,Ligue 1,2018,24.0,1993.0,24.9,39,27,17,17,5,9,39,23.1,30,29,4,25,23,62,23,1,MF,20-24,Midfielder,France,Europe
910,Massimo Gobbi,ITA,Parma,Serie A,2018,37.0,1980.0,13.1,14,7,5,5,4,8,25,32.0,17,16,8,8,9,23,48,0,DF,35-39,Defender,Italy,Europe
911,Kevin Goden,GER,Nürnberg,Bundesliga,2018,19.0,1999.0,3.0,4,3,3,1,0,2,7,28.6,5,4,1,3,4,8,11,0,"DF,MF",Under 20,Defender,Germany,Europe
912,Diego Godín,URU,Atlético Madrid,La Liga,2018,32.0,1986.0,27.9,52,30,33,19,0,20,42,47.6,22,22,9,13,45,97,141,2,DF,30-34,Defender,Uruguay,South America
913,Mauro Goicoechea,URU,Toulouse,Ligue 1,2018,30.0,1988.0,7.9,0,0,0,0,0,0,0,,0,0,0,0,0,0,7,0,GK,30-34,Goalkeeper,Uruguay,South America
914,Edoardo Goldaniga,ITA,Frosinone,Serie A,2018,24.0,1993.0,29.0,43,28,34,7,2,19,32,59.4,13,29,16,13,57,100,119,0,DF,20-24,Defender,Italy,Europe
915,Pierluigi Gollini,ITA,Atalanta,Serie A,2018,23.0,1995.0,20.0,2,2,2,0,0,1,2,50.0,1,0,0,0,0,2,3,2,GK,20-24,Goalkeeper,Italy,Europe
916,Aleksandr Golovin,RUS,Monaco,Ligue 1,2018,22.0,1996.0,25.4,36,17,3,20,13,10,44,22.7,34,34,3,31,22,58,12,0,"MF,FW",20-24,Midfielder,Russia,Europe
917,André Gomes,POR,Everton,Premier League,2018,25.0,1993.0,22.0,39,23,12,24,3,13,59,22.0,46,27,4,23,20,59,18,0,MF,25-29,Midfielder,Portugal,Europe
917,André Gomes,POR,Everton,Premier League,2018,25.0,1993.0,22.0,39,23,12,24,3,13,59,22.0,46,27,4,23,20,59,18,0,MF,25-29,Midfielder,Portugal,Europe
917,André Gomes,POR,Everton,Premier League,2018,25.0,1993.0,22.0,39,23,12,24,3,13,59,22.0,46,27,4,23,20,59,18,0,MF,25-29,Midfielder,Portugal,Europe
917,André Gomes,POR,Everton,Premier League,2018,25.0,1993.0,22.0,39,23,12,24,3,13,59,22.0,46,27,4,23,20,59,18,0,MF,25-29,Midfielder,Portugal,Europe
918,Angel Gomes,ENG,Manchester Utd,Premier League,2018,17.0,2000.0,0.3,1,0,0,0,1,0,0,,0,0,0,0,0,1,0,0,"MF,FW",Under 20,Midfielder,England,Europe
921,Joe Gomez,ENG,Liverpool,Premier League,2018,21.0,1997.0,11.8,18,11,10,7,1,9,15,60.0,6,10,5,5,14,32,42,0,DF,20-24,Defender,England,Europe
922,Mario Gómez,GER,Stuttgart,Bundesliga,2018,33.0,1985.0,24.6,19,11,6,10,3,2,12,16.7,10,17,6,11,5,24,33,0,FW,30-34,Forward,Germany,Europe
922,Mario Gómez,GER,Stuttgart,Bundesliga,2018,33.0,1985.0,24.6,19,11,6,10,3,2,12,16.7,10,17,6,11,5,24,33,0,FW,30-34,Forward,Germany,Europe
922,Mario Gómez,GER,Stuttgart,Bundesliga,2018,33.0,1985.0,24.6,19,11,6,10,3,2,12,16.7,10,17,6,11,5,24,33,0,FW,30-34,Forward,Germany,Europe
922,Mario Gómez,GER,Stuttgart,Bundesliga,2018,33.0,1985.0,24.6,19,11,6,10,3,2,12,16.7,10,17,6,11,5,24,33,0,FW,30-34,Forward,Germany,Europe
923,Maxi Gómez,URU,Celta Vigo,La Liga,2018,21.0,1996.0,32.9,6,4,1,4,1,1,12,8.3,11,3,0,3,2,8,43,0,FW,20-24,Forward,Uruguay,South America
925,Papu Gómez,ARG,Atalanta,Serie A,2018,30.0,1988.0,32.2,19,14,5,10,4,6,30,20.0,24,21,0,21,16,35,4,0,"MF,FW",30-34,Midfielder,Argentina,South America
927,Alfred Gomis,SEN,SPAL,Serie A,2018,24.0,1993.0,19.2,0,0,0,0,0,0,1,0.0,1,0,0,0,1,1,14,1,GK,20-24,Goalkeeper,Senegal,Africa
928,Maxime Gonalons,FRA,Sevilla,La Liga,2018,29.0,1989.0,6.0,8,4,2,5,1,1,15,6.7,14,10,4,6,5,13,12,0,MF,25-29,Midfielder,France,Europe
929,Anthony Gonçalves,FRA,Strasbourg,Ligue 1,2018,32.0,1986.0,11.8,22,15,12,8,2,7,22,31.8,15,21,2,19,10,32,17,0,"MF,FW",30-34,Midfielder,France,Europe
930,Jérôme Gondorf,GER,Freiburg,Bundesliga,2018,30.0,1988.0,14.4,33,18,12,19,2,14,28,50.0,14,29,5,24,19,52,23,1,"MF,FW",30-34,Midfielder,Germany,Europe
934,Giancarlo González,CRC,Bologna,Serie A,2018,30.0,1988.0,8.3,13,7,12,1,0,5,9,55.6,4,15,11,4,12,25,42,0,DF,30-34,Defender,Costa Rica,North America
935,Nicolás González,ARG,Stuttgart,Bundesliga,2018,20.0,1998.0,24.0,19,14,3,7,9,9,19,47.4,10,32,2,30,11,30,27,0,"FW,MF",20-24,Forward,Argentina,South America
937,Leon Goretzka,GER,Bayern Munich,Bundesliga,2018,23.0,1995.0,22.5,41,22,7,27,7,14,38,36.8,24,25,4,21,26,67,14,1,MF,20-24,Midfielder,Germany,Europe
938,Mathieu Gorgelin,FRA,Lyon,Ligue 1,2018,27.0,1990.0,4.0,0,0,0,0,0,0,0,,0,0,0,0,0,0,3,0,GK,25-29,Goalkeeper,France,Europe
939,Mirko Gori,ITA,Frosinone,Serie A,2018,25.0,1993.0,3.7,16,13,7,9,0,5,16,31.3,11,2,0,2,4,20,9,0,MF,25-29,Midfielder,Italy,Europe
941,Robin Gosens,GER,Atalanta,Serie A,2018,24.0,1994.0,21.6,63,46,32,26,5,37,54,68.5,17,41,3,38,38,101,60,0,"DF,MF",20-24,Defender,Germany,Europe
942,Dan Gosling,ENG,Bournemouth,Premier League,2018,28.0,1990.0,19.3,57,23,27,21,9,28,53,52.8,25,33,11,22,20,77,46,1,MF,25-29,Midfielder,England,Europe
943,Felix Götze,GER,Augsburg,Bundesliga,2018,20.0,1998.0,1.4,4,2,2,2,0,3,3,100.0,0,1,0,1,3,7,7,0,MF,20-24,Midfielder,Germany,Europe
944,Mario Götze,GER,Dortmund,Bundesliga,2018,26.0,1992.0,18.6,26,19,6,11,9,4,25,16.0,21,10,0,10,8,34,4,1,"FW,MF",25-29,Forward,Germany,Europe
945,Prince-Désir Gouano,FRA,Amiens,Ligue 1,2018,24.0,1993.0,29.1,31,18,25,5,1,12,22,54.5,10,36,27,9,46,77,127,6,DF,20-24,Defender,France,Europe
946,Yoann Gourcuff,FRA,Dijon,Ligue 1,2018,32.0,1986.0,1.5,0,0,0,0,0,0,2,0.0,2,1,1,0,0,0,1,0,"MF,FW",30-34,Midfielder,France,Europe
947,Jeffrey Gouweleeuw,NED,Augsburg,Bundesliga,2018,27.0,1991.0,23.2,42,31,23,19,0,24,39,61.5,15,44,21,23,56,98,71,1,DF,25-29,Defender,Netherlands,Europe
948,Paolo Gozzi Iweru,ITA,Juventus,Serie A,2018,17.0,2001.0,1.0,3,2,2,1,0,0,0,,0,0,0,0,3,6,3,0,DF,Under 20,Defender,Italy,Europe
949,Max Gradel,CIV,Toulouse,Ligue 1,2018,30.0,1987.0,36.0,58,35,34,19,5,24,70,34.3,46,53,9,44,18,76,41,0,"FW,MF",30-34,Forward,Ivory Coast,Africa
950,Jonathan Gradit,FRA,Caen,Ligue 1,2018,25.0,1992.0,22.3,52,28,30,21,1,28,52,53.8,24,40,15,25,45,97,82,3,DF,25-29,Defender,France,Europe
951,Samuel Grandsir,FRA,Strasbourg,Ligue 1,2018,21.0,1996.0,2.6,9,6,5,3,1,3,7,42.9,4,2,0,2,1,10,0,0,"MF,FW",20-24,Midfielder,France,Europe
952,Samuel Grandsir,FRA,Monaco,Ligue 1,2018,21.0,1996.0,5.2,12,7,4,5,3,2,10,20.0,8,11,0,11,1,13,5,1,"FW,MF",20-24,Forward,France,Europe
955,Karlan Grant,ENG,Huddersfield,Premier League,2018,20.0,1997.0,9.7,5,2,1,2,2,1,3,33.3,2,8,0,8,2,7,1,1,FW,20-24,Forward,England,Europe
956,Alberto Grassi,ITA,Parma,Serie A,2018,23.0,1995.0,5.1,20,12,7,10,3,2,10,20.0,8,8,2,6,8,28,10,0,MF,20-24,Midfielder,Italy,Europe
957,Andre Gray,JAM,Watford,Premier League,2018,27.0,1991.0,15.2,3,1,0,2,1,1,6,16.7,5,3,1,2,2,5,6,0,FW,25-29,Forward,Jamaica,North America
958,Demarai Gray,JAM,Leicester City,Premier League,2018,22.0,1996.0,22.1,25,12,7,14,4,6,16,37.5,10,19,0,19,9,34,15,0,"FW,MF",20-24,Forward,Jamaica,North America
959,Mason Greenwood,ENG,Manchester Utd,Premier League,2018,16.0,2001.0,1.3,3,3,2,0,1,2,3,66.7,1,2,0,2,0,3,1,0,FW,Under 20,Forward,England,Europe
960,Michael Gregoritsch,AUT,Augsburg,Bundesliga,2018,24.0,1994.0,27.6,22,13,7,9,6,4,28,14.3,24,29,10,19,15,37,58,0,"MF,FW",20-24,Midfielder,Austria,Europe
961,Clément Grenier,FRA,Rennes,Ligue 1,2018,27.0,1991.0,29.6,44,27,7,33,4,21,61,34.4,40,28,4,24,29,73,34,1,MF,25-29,Midfielder,France,Europe
962,Antoine Griezmann,FRA,Atlético Madrid,La Liga,2018,27.0,1991.0,35.5,31,19,8,13,10,8,28,28.6,20,18,1,17,12,43,21,0,"FW,MF",25-29,Forward,France,Europe
963,Vincenzo Grifo,ITA,Hoffenheim,Bundesliga,2018,25.0,1993.0,3.7,6,3,2,3,1,0,5,0.0,5,2,1,1,2,8,5,0,"MF,FW",25-29,Midfielder,Italy,Europe
964,Vincenzo Grifo,ITA,Freiburg,Bundesliga,2018,25.0,1993.0,15.9,26,14,11,8,7,14,27,51.9,13,10,1,9,2,28,10,0,"MF,FW",25-29,Midfielder,Italy,Europe
965,Florian Grillitsch,AUT,Hoffenheim,Bundesliga,2018,22.0,1995.0,26.6,77,49,30,38,9,36,80,45.0,44,34,8,26,72,149,56,1,MF,20-24,Midfielder,Austria,Europe
966,Jérémy Grimm,FRA,Strasbourg,Ligue 1,2018,31.0,1987.0,1.9,4,2,2,2,0,3,5,60.0,2,1,0,1,4,8,5,0,MF,30-34,Midfielder,France,Europe
967,Pascal Groß,GER,Brighton,Premier League,2018,27.0,1991.0,20.7,27,12,12,12,3,11,36,30.6,25,20,8,12,13,40,23,0,"MF,FW",25-29,Midfielder,Germany,Europe
968,Sergej Grubac,MNE,Chievo,Serie A,2018,18.0,2000.0,1.7,2,1,1,0,1,1,1,100.0,0,1,0,1,0,2,1,0,FW,Under 20,Forward,Montenegro,Europe
971,Andrés Guardado,MEX,Betis,La Liga,2018,31.0,1986.0,25.9,24,15,9,12,3,11,47,23.4,36,27,1,26,28,52,28,1,"MF,DF",30-34,Midfielder,Mexico,North America
974,Metehan Güçlü,TUR,Paris S-G,Ligue 1,2018,19.0,1999.0,0.2,0,0,0,0,0,0,0,,0,0,0,0,0,0,0,0,MF,Under 20,Midfielder,Turkey,Asia
975,Gonçalo Guedes,POR,Valencia,La Liga,2018,21.0,1996.0,16.3,31,13,16,12,3,14,43,32.6,29,15,0,15,7,38,1,0,"MF,FW",20-24,Midfielder,Portugal,Europe
976,Mattéo Guendouzi,FRA,Arsenal,Premier League,2018,19.0,1999.0,23.9,44,26,18,23,3,17,47,36.2,30,28,5,23,30,74,24,3,MF,Under 20,Midfielder,France,Europe
978,Raphaël Guerreiro,POR,Dortmund,Bundesliga,2018,24.0,1993.0,17.0,25,12,11,7,7,12,23,52.2,11,7,1,6,18,43,12,1,"FW,DF",20-24,Forward,Portugal,Europe
980,Guido Guerrieri,ITA,Lazio,Serie A,2018,22.0,1996.0,1.0,0,0,0,0,0,0,0,,0,0,0,0,0,0,2,0,GK,20-24,Goalkeeper,Italy,Europe
982,Makhtar Gueye,SEN,Saint-Étienne,Ligue 1,2018,20.0,1997.0,0.6,2,1,2,0,0,2,2,100.0,0,2,0,2,0,2,0,0,"FW,MF",20-24,Forward,Senegal,Africa
983,John Guidetti,SWE,Alavés,La Liga,2018,26.0,1992.0,7.0,4,1,0,3,1,0,4,0.0,4,4,0,4,1,5,6,0,FW,25-29,Forward,Sweden,Europe
984,Josuha Guilavogui,FRA,Wolfsburg,Bundesliga,2018,27.0,1990.0,17.4,31,16,18,13,0,14,25,56.0,11,17,8,9,43,74,56,2,MF,25-29,Midfielder,France,Europe
985,Frederic Guilbert,FRA,Caen,Ligue 1,2018,23.0,1994.0,32.4,98,67,59,29,10,41,83,49.4,42,49,21,28,78,176,121,2,DF,20-24,Defender,France,Europe
986,Baptiste Guillaume,BEL,Nîmes,Ligue 1,2018,23.0,1995.0,13.1,12,6,1,8,3,2,9,22.2,7,6,0,6,2,14,6,0,FW,20-24,Forward,Belgium,Europe
987,Serhou Guirassy,GUI,Amiens,Ligue 1,2018,22.0,1996.0,12.3,7,5,1,5,1,0,4,0.0,4,7,0,7,4,11,14,0,FW,20-24,Forward,Guinea,Africa
988,Péter Gulácsi,HUN,RB Leipzig,Bundesliga,2018,28.0,1990.0,32.5,0,0,0,0,0,0,0,,0,0,0,0,0,0,11,0,GK,25-29,Goalkeeper,Hungary,Europe
989,Manuel Gulde,GER,Freiburg,Bundesliga,2018,27.0,1991.0,19.0,24,16,18,5,1,12,16,75.0,4,25,13,12,26,50,90,0,DF,25-29,Defender,Germany,Europe
991,İlkay Gündoğan,GER,Manchester City,Premier League,2018,27.0,1990.0,23.7,19,12,4,12,3,6,31,19.4,25,12,3,9,28,47,19,1,MF,25-29,Midfielder,Germany,Europe
992,Angus Gunn,SCO,Southampton,Premier League,2018,22.0,1996.0,12.0,0,0,0,0,0,0,0,,0,0,0,0,0,0,8,3,GK,20-24,Goalkeeper,Scotland,Europe
993,Aron Gunnarsson,ISL,Cardiff City,Premier League,2018,29.0,1989.0,25.2,51,29,23,25,3,23,84,27.4,61,40,12,28,38,89,55,1,MF,25-29,Midfielder,Iceland,Europe
994,Christian Günter,GER,Freiburg,Bundesliga,2018,25.0,1993.0,32.0,38,26,16,16,6,20,43,46.5,23,31,7,24,14,52,55,0,"DF,MF",25-29,Defender,Germany,Europe
995,Koray Günter,GER,Genoa,Serie A,2018,23.0,1994.0,9.3,18,13,13,3,2,9,16,56.3,7,9,7,2,18,36,34,0,DF,20-24,Defender,Germany,Europe
996,Serdar Gürler,TUR,Huesca,La Liga,2018,26.0,1991.0,5.4,5,5,3,2,0,3,11,27.3,8,8,0,8,1,6,2,0,"MF,FW",25-29,Midfielder,Turkey,Asia
997,Ahmet Gürleyen,GER,Mainz 05,Bundesliga,2018,19.0,1999.0,0.1,0,0,0,0,0,0,0,,0,0,0,0,0,0,1,0,DF,Under 20,Defender,Germany,Europe
998,Régis Gurtner,FRA,Amiens,Ligue 1,2018,31.0,1986.0,38.0,1,1,1,0,0,0,1,0.0,1,0,0,0,1,2,7,3,GK,30-34,Goalkeeper,France,Europe
1000,Luiz Gustavo,BRA,Marseille,Ligue 1,2018,31.0,1987.0,27.1,72,43,49,18,5,30,66,45.5,36,26,12,14,34,106,61,0,"MF,DF",30-34,Midfielder,Brazil,South America
1000,Luiz Gustavo,BRA,Marseille,Ligue 1,2018,31.0,1987.0,27.1,72,43,49,18,5,30,66,45.5,36,26,12,14,34,106,61,0,"MF,DF",30-34,Midfielder,Brazil,South America
1000,Luiz Gustavo,BRA,Marseille,Ligue 1,2018,31.0,1987.0,27.1,72,43,49,18,5,30,66,45.5,36,26,12,14,34,106,61,0,"MF,DF",30-34,Midfielder,Brazil,South America
1000,Luiz Gustavo,BRA,Marseille,Ligue 1,2018,31.0,1987.0,27.1,72,43,49,18,5,30,66,45.5,36,26,12,14,34,106,61,0,"MF,DF",30-34,Midfielder,Brazil,South America
1001,Jonathan de Guzmán,NED,Eint Frankfurt,Bundesliga,2018,30.0,1987.0,17.4,34,24,11,20,3,13,28,46.4,15,18,2,16,11,45,16,0,MF,30-34,Midfielder,Netherlands,Europe
1002,Janik Haberer,GER,Freiburg,Bundesliga,2018,24.0,1994.0,26.0,71,47,37,24,10,30,75,40.0,45,31,4,27,36,107,49,0,"MF,FW",20-24,Midfielder,Germany,Europe
1003,Hacen,MTN,Valladolid,La Liga,2018,20.0,1997.0,0.0,0,0,0,0,0,0,0,,0,1,0,1,1,1,1,0,MF,20-24,Midfielder,Mauritania,Africa
1004,Alexander Hack,GER,Mainz 05,Bundesliga,2018,24.0,1993.0,11.3,29,13,20,9,0,19,28,67.9,9,26,15,11,41,70,59,2,DF,20-24,Defender,Germany,Europe
1005,Munir El Haddadi,MAR,Sevilla,La Liga,2018,22.0,1995.0,11.6,17,10,5,7,5,2,7,28.6,5,15,0,15,6,23,9,0,"FW,MF",20-24,Forward,Morocco,Africa
1006,Munir El Haddadi,MAR,Barcelona,La Liga,2018,22.0,1995.0,1.7,3,3,1,1,1,1,3,33.3,2,1,0,1,0,3,1,0,FW,20-24,Forward,Morocco,Africa
1007,Oussama Haddadi,TUN,Dijon,Ligue 1,2018,26.0,1992.0,29.7,51,25,38,11,2,24,43,55.8,19,33,8,25,45,96,93,2,DF,25-29,Defender,Tunisia,Africa
1009,Benjamin Hadžić,BIH,Hannover 96,Bundesliga,2018,19.0,1999.0,0.3,0,0,0,0,0,0,1,0.0,1,0,0,0,0,0,0,0,"FW,MF",Under 20,Forward,Bosnia and Herzegovina,Europe
1010,André Hahn,GER,Augsburg,Bundesliga,2018,27.0,1990.0,22.8,64,38,22,39,3,22,53,41.5,31,28,2,26,27,91,32,0,"FW,MF",25-29,Forward,Germany,Europe
1011,Amadou Haidara,MLI,RB Leipzig,Bundesliga,2018,20.0,1998.0,4.2,13,11,4,8,1,8,14,57.1,6,9,1,8,4,17,7,0,MF,20-24,Midfielder,Mali,Africa
1012,Oualid El Hajjam,MAR,Amiens,Ligue 1,2018,27.0,1991.0,6.0,14,9,10,3,1,5,15,33.3,10,8,2,6,12,26,26,0,"DF,MF",25-29,Defender,Morocco,Africa
1013,Achraf Hakimi,MAR,Dortmund,Bundesliga,2018,19.0,1998.0,19.3,34,19,25,8,1,17,36,47.2,19,27,4,23,29,63,45,2,DF,Under 20,Defender,Morocco,Africa
1014,Sébastien Haller,CIV,Eint Frankfurt,Bundesliga,2018,24.0,1994.0,24.2,24,11,7,10,7,8,21,38.1,13,21,1,20,15,39,23,0,FW,20-24,Forward,Ivory Coast,Africa
1015,Emil Hallfreðsson,ISL,Udinese,Serie A,2018,34.0,1984.0,1.5,0,0,0,0,0,0,1,0.0,1,1,1,0,3,3,4,0,MF,30-34,Midfielder,Iceland,Europe
1016,Emil Hallfreðsson,ISL,Frosinone,Serie A,2018,34.0,1984.0,4.4,10,6,5,4,1,0,9,0.0,9,4,1,3,2,12,3,0,MF,30-34,Midfielder,Iceland,Europe
1017,Marcel Halstenberg,GER,RB Leipzig,Bundesliga,2018,26.0,1991.0,26.8,68,44,31,24,13,42,65,64.6,23,27,4,23,38,106,69,0,"DF,FW",25-29,Defender,Germany,Europe
1018,Ben Hamer,ENG,Huddersfield,Premier League,2018,30.0,1987.0,6.1,0,0,0,0,0,0,3,0.0,3,0,0,0,1,1,3,2,GK,30-34,Goalkeeper,England,Europe
1019,Romain Hamouma,FRA,Saint-Étienne,Ligue 1,2018,31.0,1987.0,17.6,30,19,6,18,6,12,32,37.5,20,12,1,11,9,39,7,0,"FW,MF",30-34,Forward,France,Europe
1020,Marek Hamšík,SVK,Napoli,Serie A,2018,31.0,1987.0,10.2,7,5,2,4,1,0,11,0.0,11,8,1,7,12,19,14,1,MF,30-34,Midfielder,Slovakia,Europe
1021,Dávid Hancko,SVK,Fiorentina,Serie A,2018,20.0,1997.0,3.1,7,6,4,3,0,6,9,66.7,3,3,1,2,3,10,12,0,DF,20-24,Defender,Slovakia,Europe
1023,Genki Haraguchi,JPN,Hannover 96,Bundesliga,2018,27.0,1991.0,23.7,44,26,21,20,3,17,66,25.8,49,34,5,29,21,65,33,0,"MF,DF",25-29,Midfielder,Japan,Asia
1024,Féthi Harek,ALG,Nîmes,Ligue 1,2018,35.0,1982.0,2.0,4,4,2,2,0,3,4,75.0,1,1,0,1,1,5,6,0,DF,35-39,Defender,Algeria,Africa
1025,Amine Harit,MAR,Schalke 04,Bundesliga,2018,21.0,1997.0,12.0,15,8,4,9,2,8,24,33.3,16,11,1,10,9,24,2,0,"MF,FW",20-24,Midfielder,Morocco,Africa
1026,Martin Harnik,AUT,Werder Bremen,Bundesliga,2018,31.0,1987.0,9.2,12,7,4,3,5,4,15,26.7,11,8,0,8,3,15,10,0,"FW,MF",30-34,Forward,Austria,Europe
1027,Kadeem Harris,ENG,Cardiff City,Premier League,2018,25.0,1993.0,4.2,12,5,6,4,2,7,8,87.5,1,3,0,3,3,15,5,0,MF,25-29,Midfielder,England,Europe
1028,Joe Hart,ENG,Burnley,Premier League,2018,31.0,1987.0,19.0,0,0,0,0,0,0,1,0.0,1,0,0,0,0,0,11,3,GK,30-34,Goalkeeper,England,Europe
1029,Makoto Hasebe,JPN,Eint Frankfurt,Bundesliga,2018,34.0,1984.0,28.0,52,34,35,17,0,25,42,59.5,17,43,22,21,40,92,101,3,"DF,MF",30-34,Defender,Japan,Asia
1030,Hans Hateboer,NED,Atalanta,Serie A,2018,24.0,1994.0,33.0,43,31,19,19,5,17,34,50.0,17,29,5,24,23,66,47,1,DF,20-24,Defender,Netherlands,Europe
1031,Kai Havertz,GER,Leverkusen,Bundesliga,2018,19.0,1999.0,32.2,26,17,10,11,5,8,32,25.0,24,31,4,27,16,42,29,0,"MF,FW",Under 20,Midfielder,Germany,Europe
1032,Isaac Hayden,ENG,Newcastle Utd,Premier League,2018,23.0,1995.0,20.7,73,43,19,45,9,23,41,56.1,18,32,4,28,40,113,30,0,MF,20-24,Midfielder,England,Europe
1033,Eden Hazard,BEL,Chelsea,Premier League,2018,27.0,1991.0,32.5,14,9,2,1,11,5,17,29.4,12,10,0,10,13,27,6,1,FW,25-29,Forward,Belgium,Europe
1034,Thorgan Hazard,BEL,Gladbach,Bundesliga,2018,25.0,1993.0,31.9,50,33,22,20,8,17,48,35.4,31,35,2,33,27,77,12,0,"FW,MF",25-29,Forward,Belgium,Europe
1035,Rhys Healey,WAL,Cardiff City,Premier League,2018,23.0,1994.0,0.6,1,0,0,1,0,0,1,0.0,1,0,0,0,0,1,0,0,FW,20-24,Forward,Wales,Europe
1036,Tom Heaton,ENG,Burnley,Premier League,2018,32.0,1986.0,19.0,0,0,0,0,0,0,2,0.0,2,0,0,0,0,0,8,2,GK,30-34,Goalkeeper,England,Europe
1037,Dominique Heintz,GER,Freiburg,Bundesliga,2018,24.0,1993.0,33.9,41,21,34,6,1,18,32,56.3,14,45,22,23,45,86,214,0,DF,20-24,Defender,Germany,Europe
1038,Filip Helander,SWE,Bologna,Serie A,2018,25.0,1993.0,19.0,42,26,25,13,4,19,23,82.6,4,27,16,11,14,56,84,0,DF,25-29,Defender,Sweden,Europe
1039,Jordan Henderson,ENG,Liverpool,Premier League,2018,28.0,1990.0,22.1,46,36,20,22,4,16,39,41.0,23,27,3,24,30,76,17,0,MF,25-29,Midfielder,England,Europe
1040,Jeff Hendrick,IRL,Burnley,Premier League,2018,26.0,1992.0,22.9,24,12,13,7,4,9,32,28.1,23,20,5,15,12,36,31,0,"MF,FW",25-29,Midfielder,Republic of Ireland,Europe
1041,Wayne Hennessey,WAL,Crystal Palace,Premier League,2018,31.0,1987.0,17.5,0,0,0,0,0,0,2,0.0,2,0,0,0,0,0,5,1,GK,30-34,Goalkeeper,Wales,Europe
1042,Rouwen Hennings,GER,Düsseldorf,Bundesliga,2018,30.0,1987.0,20.4,14,10,1,8,5,2,13,15.4,11,16,1,15,4,18,20,0,FW,30-34,Forward,Germany,Europe
1043,Benjamin Henrichs,GER,Monaco,Ligue 1,2018,21.0,1997.0,20.3,58,39,32,22,4,16,38,42.1,22,18,0,18,35,93,45,0,"DF,MF",20-24,Defender,Germany,Europe
1044,Benjamin Henrichs,GER,Leverkusen,Bundesliga,2018,21.0,1997.0,0.7,0,0,0,0,0,0,0,,0,2,0,2,3,3,0,0,DF,20-24,Defender,Germany,Europe
1045,Dalbert Henrique,BRA,Inter,Serie A,2018,24.0,1993.0,8.6,33,24,18,14,1,12,21,57.1,9,9,3,6,8,41,20,0,DF,20-24,Defender,Brazil,South America
1046,Uche Henry Agbo,NGA,Rayo Vallecano,La Liga,2018,22.0,1995.0,4.1,7,4,3,4,0,5,10,50.0,5,3,1,2,6,13,1,0,MF,20-24,Midfielder,Nigeria,Africa
1049,Javier Hernández,MEX,West Ham,Premier League,2018,30.0,1988.0,14.8,3,0,0,3,0,0,6,0.0,6,8,1,7,1,4,8,0,FW,30-34,Forward,Mexico,North America
1050,Lucas Hernández,FRA,Atlético Madrid,La Liga,2018,22.0,1996.0,12.4,35,25,20,14,1,17,20,85.0,3,17,9,8,14,49,49,0,DF,20-24,Defender,France,Europe
1051,Theo Hernández,FRA,Real Sociedad,La Liga,2018,20.0,1997.0,22.0,54,33,30,15,9,28,44,63.6,16,21,5,16,33,87,42,3,DF,20-24,Defender,France,Europe
1053,Yangel Herrera,VEN,Huesca,La Liga,2018,20.0,1998.0,12.8,48,24,18,25,5,23,43,53.5,20,13,1,12,14,62,32,0,"MF,DF",20-24,Midfielder,Venezuela,South America
1055,Patrick Herrmann,GER,Gladbach,Bundesliga,2018,27.0,1991.0,12.0,20,14,8,7,5,6,17,35.3,11,6,3,3,6,26,12,0,"FW,DF",25-29,Forward,Germany,Europe
1058,Përparim Hetemaj,FIN,Chievo,Serie A,2018,31.0,1986.0,24.0,53,27,27,23,3,20,68,29.4,48,25,1,24,30,83,24,2,MF,30-34,Midfielder,Finland,Europe
1059,Son Heung-min,KOR,Tottenham,Premier League,2018,26.0,1992.0,22.7,23,12,7,12,4,10,34,29.4,24,26,2,24,8,31,4,1,"FW,MF",25-29,Forward,South Korea,Asia
1060,Gonzalo Higuaín,ARG,Chelsea,Premier League,2018,30.0,1987.0,12.1,10,7,2,4,4,2,11,18.2,9,4,0,4,1,11,5,0,FW,30-34,Forward,Argentina,South America
1061,Gonzalo Higuaín,ARG,Milan,Serie A,2018,30.0,1987.0,14.2,8,6,1,5,2,5,13,38.5,8,3,0,3,0,8,11,1,FW,30-34,Forward,Argentina,South America
1062,Oscar Hiljemark,SWE,Genoa,Serie A,2018,26.0,1992.0,13.3,16,9,8,7,1,5,16,31.3,11,13,3,10,13,29,14,0,MF,25-29,Midfielder,Sweden,Europe
1063,Vitorino Hilton,BRA,Montpellier,Ligue 1,2018,40.0,1977.0,35.9,33,13,28,5,0,12,30,40.0,18,31,15,16,66,99,198,2,DF,Over 40,Defender,Brazil,South America
1064,Martin Hinteregger,AUT,Augsburg,Bundesliga,2018,25.0,1992.0,17.5,48,35,31,16,1,24,35,68.6,11,24,13,11,22,70,68,0,DF,25-29,Defender,Austria,Europe
1065,Martin Hinteregger,AUT,Eint Frankfurt,Bundesliga,2018,25.0,1992.0,12.7,34,26,19,12,3,13,28,46.4,15,20,7,13,13,47,51,0,DF,25-29,Defender,Austria,Europe
1066,Marwin Hitz,SUI,Dortmund,Bundesliga,2018,30.0,1987.0,2.0,0,0,0,0,0,0,0,,0,0,0,0,0,0,0,1,GK,30-34,Goalkeeper,Switzerland,Europe
1067,Andrew Hjulsager,DEN,Celta Vigo,La Liga,2018,23.0,1995.0,4.0,16,10,11,2,3,2,18,11.1,16,4,0,4,2,18,1,0,"MF,FW",20-24,Midfielder,Denmark,Europe
1068,Wesley Hoedt,NED,Southampton,Premier League,2018,24.0,1994.0,13.0,28,12,23,5,0,17,26,65.4,9,20,13,7,23,51,79,2,DF,20-24,Defender,Netherlands,Europe
1069,Wesley Hoedt,NED,Celta Vigo,La Liga,2018,24.0,1994.0,9.9,17,11,15,2,0,12,17,70.6,5,17,11,6,11,28,58,3,DF,20-24,Defender,Netherlands,Europe
1070,André Hoffmann,GER,Düsseldorf,Bundesliga,2018,25.0,1993.0,11.7,22,14,12,10,0,9,25,36.0,16,17,12,5,21,43,44,0,"DF,MF",25-29,Defender,Germany,Europe
1071,Nicolas Höfler,GER,Freiburg,Bundesliga,2018,28.0,1990.0,17.9,45,22,19,22,4,14,36,38.9,22,21,4,17,32,77,41,0,MF,25-29,Midfielder,Germany,Europe
1072,Jonas Hofmann,GER,Gladbach,Bundesliga,2018,26.0,1992.0,21.2,37,18,11,19,7,9,37,24.3,28,33,2,31,16,53,14,1,MF,25-29,Midfielder,Germany,Europe
1072,Jonas Hofmann,GER,Gladbach,Bundesliga,2018,26.0,1992.0,21.2,37,18,11,19,7,9,37,24.3,28,33,2,31,16,53,14,1,MF,25-29,Midfielder,Germany,Europe
1072,Jonas Hofmann,GER,Gladbach,Bundesliga,2018,26.0,1992.0,21.2,37,18,11,19,7,9,37,24.3,28,33,2,31,16,53,14,1,MF,25-29,Midfielder,Germany,Europe
1072,Jonas Hofmann,GER,Gladbach,Bundesliga,2018,26.0,1992.0,21.2,37,18,11,19,7,9,37,24.3,28,33,2,31,16,53,14,1,MF,25-29,Midfielder,Germany,Europe
1073,Jonathan Hogg,ENG,Huddersfield,Premier League,2018,29.0,1988.0,26.3,78,41,18,51,9,27,69,39.1,42,46,7,39,73,151,19,1,MF,25-29,Midfielder,England,Europe
1074,Junior Hoilett,CAN,Cardiff City,Premier League,2018,28.0,1990.0,23.8,40,27,26,11,3,15,53,28.3,38,34,0,34,32,72,30,0,"MF,FW",25-29,Midfielder,Canada,North America
1075,Rob Holding,ENG,Arsenal,Premier League,2018,22.0,1995.0,9.0,11,7,9,2,0,2,8,25.0,6,9,7,2,12,23,40,0,DF,20-24,Defender,England,Europe
1076,José Holebas,GRE,Watford,Premier League,2018,34.0,1984.0,26.6,68,40,44,20,4,28,53,52.8,25,27,8,19,21,89,97,0,DF,30-34,Defender,Greece,Europe
1077,Lucas Höler,GER,Freiburg,Bundesliga,2018,24.0,1994.0,11.2,18,13,6,9,3,4,18,22.2,14,10,1,9,3,21,15,2,FW,20-24,Forward,Germany,Europe
1078,Mason Holgate,ENG,Everton,Premier League,2018,21.0,1996.0,4.5,5,4,4,1,0,1,1,100.0,0,3,2,1,3,8,32,0,DF,20-24,Defender,England,Europe
1079,Gerrit Holtmann,PHI,Mainz 05,Bundesliga,2018,23.0,1995.0,1.6,2,0,1,0,1,1,2,50.0,1,3,2,1,4,6,1,0,"FW,MF",20-24,Forward,Philippines,Asia
1080,Justin Hoogma,NED,Hoffenheim,Bundesliga,2018,20.0,1998.0,1.2,4,2,2,1,1,2,2,100.0,0,3,1,2,2,6,1,0,"DF,MF",20-24,Defender,Netherlands,Europe
1081,Lukáš Hrádecký,FIN,Leverkusen,Bundesliga,2018,28.0,1989.0,32.0,0,0,0,0,0,0,1,0.0,1,0,0,0,1,1,9,1,GK,25-29,Goalkeeper,Finland,Europe
1082,Branimir Hrgota,SWE,Eint Frankfurt,Bundesliga,2018,25.0,1993.0,0.1,0,0,0,0,0,0,0,,0,0,0,0,0,0,0,0,FW,25-29,Forward,Sweden,Europe
1083,Benjamin Hübner,GER,Hoffenheim,Bundesliga,2018,29.0,1989.0,9.0,29,18,18,9,2,14,18,77.8,4,16,7,9,21,50,35,0,DF,25-29,Defender,Germany,Europe
1084,Tomáš Hubočan,SVK,Marseille,Ligue 1,2018,32.0,1985.0,0.8,3,2,3,0,0,3,4,75.0,1,0,0,0,2,5,5,0,DF,30-34,Defender,Slovakia,Europe
1085,Callum Hudson-Odoi,ENG,Chelsea,Premier League,2018,17.0,2000.0,4.4,8,6,8,0,0,2,4,50.0,2,1,0,1,3,11,0,0,FW,Under 20,Forward,England,Europe
1086,Will Hughes,ENG,Watford,Premier League,2018,23.0,1995.0,26.9,74,43,27,35,12,25,59,42.4,34,55,6,49,25,99,30,0,MF,20-24,Midfielder,England,Europe
1087,Vitor Hugo,BRA,Fiorentina,Serie A,2018,27.0,1991.0,27.4,64,42,38,25,1,17,27,63.0,10,28,13,15,74,138,141,2,DF,25-29,Defender,Brazil,South America
1088,Mats Hummels,GER,Bayern Munich,Bundesliga,2018,29.0,1988.0,19.7,26,17,19,6,1,9,24,37.5,15,20,8,12,34,60,50,1,DF,25-29,Defender,Germany,Europe
1089,Adrien Hunou,FRA,Rennes,Ligue 1,2018,24.0,1994.0,13.8,11,7,3,5,3,2,9,22.2,7,14,0,14,5,16,8,0,"FW,MF",20-24,Forward,France,Europe
1090,Emerson Hyndman,USA,Bournemouth,Premier League,2018,22.0,1996.0,0.4,6,2,6,0,0,2,3,66.7,1,0,0,0,1,7,0,0,MF,20-24,Midfielder,United States,North America
1091,Elseid Hysaj,ALB,Napoli,Serie A,2018,24.0,1994.0,23.4,40,28,22,15,3,25,49,51.0,24,11,3,8,24,64,51,0,DF,20-24,Defender,Albania,Europe
1092,Suk Hyun-jun,KOR,Reims,Ligue 1,2018,27.0,1991.0,8.8,11,8,1,6,4,0,8,0.0,8,2,1,1,2,13,4,1,FW,25-29,Forward,South Korea,Asia
1093,Pierre Højbjerg,DEN,Southampton,Premier League,2018,22.0,1995.0,30.7,71,49,20,44,7,24,73,32.9,49,51,8,43,60,131,30,1,MF,20-24,Midfielder,Denmark,Europe
1094,Simone Iacoponi,ITA,Parma,Serie A,2018,31.0,1987.0,37.2,62,43,50,11,1,27,47,57.4,20,40,26,14,37,99,178,3,DF,30-34,Defender,Italy,Europe
1096,Roger Ibanez,BRA,Atalanta,Serie A,2018,19.0,1998.0,0.0,0,0,0,0,0,0,0,,0,0,0,0,0,0,1,0,"DF,FW",Under 20,Defender,Brazil,South America
1097,Jordon Ibe,ENG,Bournemouth,Premier League,2018,22.0,1995.0,8.9,6,5,0,5,1,2,7,28.6,5,2,0,2,4,10,4,0,"MF,DF",20-24,Midfielder,England,Europe
1098,Vedad Ibišević,BIH,Hertha BSC,Bundesliga,2018,33.0,1984.0,20.1,12,8,2,5,5,0,10,0.0,10,10,4,6,3,15,20,0,FW,30-34,Forward,Bosnia and Herzegovina,Europe
1101,Didier Ibrahim Ndong,GAB,Guingamp,Ligue 1,2018,24.0,1994.0,8.3,16,11,3,13,0,5,13,38.5,8,15,3,12,15,31,6,1,MF,20-24,Midfielder,Gabon,Africa
1102,Mauro Icardi,ARG,Inter,Serie A,2018,25.0,1993.0,25.2,9,8,2,2,5,1,6,16.7,5,4,1,3,3,12,20,1,FW,25-29,Forward,Argentina,South America
1103,Salvador Ichazo,URU,Torino,Serie A,2018,26.0,1992.0,2.8,0,0,0,0,0,0,0,,0,0,0,0,0,0,0,0,GK,25-29,Goalkeeper,Uruguay,South America
1104,Edgar Ié,GNB,Lille,Ligue 1,2018,24.0,1994.0,2.7,5,4,3,2,0,3,5,60.0,2,2,1,1,7,12,17,0,DF,20-24,Defender,Guinea-Bissau,Africa
1105,Edgar Ié,GNB,Nantes,Ligue 1,2018,24.0,1994.0,8.6,20,13,12,6,2,9,16,56.3,7,10,3,7,8,28,23,0,DF,20-24,Defender,Guinea-Bissau,Africa
1107,Kelechi Iheanacho,NGA,Leicester City,Premier League,2018,21.0,1996.0,10.5,6,5,4,1,1,1,5,20.0,4,5,0,5,2,8,3,0,"FW,MF",20-24,Forward,Nigeria,Africa
1108,Jordan Ikoko,COD,Guingamp,Ligue 1,2018,24.0,1994.0,19.0,37,24,22,14,1,16,28,57.1,12,18,5,13,24,61,30,0,DF,20-24,Defender,DR Congo,Africa
1109,Jonathan Ikone,FRA,Lille,Ligue 1,2018,20.0,1998.0,31.1,25,14,7,12,6,8,30,26.7,22,24,2,22,6,31,4,0,"MF,FW",20-24,Midfielder,France,Europe
1110,Ivo Iličević,CRO,Nürnberg,Bundesliga,2018,31.0,1986.0,0.4,1,0,0,1,0,1,2,50.0,1,1,0,1,0,1,0,0,MF,30-34,Midfielder,Croatia,Europe
1113,Stefan Ilsanker,AUT,RB Leipzig,Bundesliga,2018,29.0,1989.0,10.4,26,17,15,10,1,14,23,60.9,9,9,2,7,18,44,43,1,"DF,MF",25-29,Defender,Austria,Europe
1114,Giannelli Imbula,COD,Rayo Vallecano,La Liga,2018,25.0,1992.0,19.2,14,7,6,7,1,5,12,41.7,7,12,3,9,8,22,6,0,MF,25-29,Midfielder,DR Congo,Africa
1115,Ciro Immobile,ITA,Lazio,Serie A,2018,28.0,1990.0,31.8,12,6,4,3,5,4,9,44.4,5,18,1,17,1,13,8,0,FW,25-29,Forward,Italy,Europe
1116,Emmanuel Imorou,BEN,Caen,Ligue 1,2018,29.0,1988.0,12.4,18,13,10,7,1,11,17,64.7,6,14,4,10,28,46,49,1,DF,25-29,Defender,Benin,Africa
1117,Svante Ingelsson,SWE,Udinese,Serie A,2018,20.0,1998.0,1.1,1,1,1,0,0,0,0,,0,2,0,2,0,1,4,0,"DF,MF",20-24,Defender,Sweden,Europe
1118,Roberto Inglese,ITA,Parma,Serie A,2018,26.0,1991.0,21.8,20,14,7,7,6,1,13,7.7,12,26,2,24,6,26,27,0,FW,25-29,Forward,Italy,Europe
1119,Danny Ings,ENG,Southampton,Premier League,2018,26.0,1992.0,18.3,30,14,5,19,6,11,28,39.3,17,30,2,28,5,35,9,0,FW,25-29,Forward,England,Europe
1120,Lorenzo Insigne,ITA,Napoli,Serie A,2018,27.0,1991.0,23.0,14,4,5,6,3,6,18,33.3,12,7,0,7,8,22,3,0,"FW,MF",25-29,Forward,Italy,Europe
1121,Emiliano Insúa,ARG,Stuttgart,Bundesliga,2018,29.0,1989.0,23.5,51,33,26,18,7,25,42,59.5,17,29,2,27,31,82,55,1,DF,25-29,Defender,Argentina,South America
1123,Takashi Inui,JPN,Alavés,La Liga,2018,30.0,1988.0,9.2,9,5,6,2,1,5,18,27.8,13,5,0,5,4,13,3,0,"MF,FW",30-34,Midfielder,Japan,Asia
1124,Takashi Inui,JPN,Betis,La Liga,2018,30.0,1988.0,4.2,4,3,0,4,0,3,7,42.9,4,3,0,3,1,5,1,0,MF,30-34,Midfielder,Japan,Asia
1125,Artur Ioniță,MDA,Cagliari,Serie A,2018,27.0,1990.0,33.0,67,38,23,31,13,16,57,28.1,41,40,5,35,27,94,30,0,MF,25-29,Midfielder,Moldova,Europe
1129,Mikael Ishak,SWE,Nürnberg,Bundesliga,2018,25.0,1993.0,21.3,9,6,3,6,0,3,16,18.8,13,8,3,5,3,12,10,0,FW,25-29,Forward,Sweden,Europe
1130,Wilson Isidor,FRA,Monaco,Ligue 1,2018,17.0,2000.0,0.5,0,0,0,0,0,0,0,,0,1,1,0,0,0,1,0,FW,Under 20,Forward,France,Europe
1131,Abass Issah,GHA,Mainz 05,Bundesliga,2018,19.0,1998.0,0.1,0,0,0,0,0,0,0,,0,0,0,0,0,0,0,0,FW,Under 20,Forward,Ghana,Africa
1132,Gian-Luca Itter,GER,Wolfsburg,Bundesliga,2018,19.0,1999.0,1.0,4,3,3,1,0,1,2,50.0,1,2,0,2,1,5,2,0,DF,Under 20,Defender,Germany,Europe
1133,Manuel Iturra,CHI,Villarreal,La Liga,2018,34.0,1984.0,0.8,2,0,0,2,0,0,0,,0,1,0,1,2,4,2,0,MF,30-34,Midfielder,Chile,South America
1136,Alex Iwobi,NGA,Arsenal,Premier League,2018,22.0,1996.0,21.9,28,14,10,16,2,6,25,24.0,19,21,1,20,12,40,13,1,"FW,MF",20-24,Forward,Nigeria,Africa
1137,José Izquierdo,COL,Brighton,Premier League,2018,26.0,1992.0,8.8,15,9,9,4,2,10,20,50.0,10,7,1,6,5,20,7,0,"MF,FW",25-29,Midfielder,Colombia,South America
1138,Armando Izzo,ITA,Torino,Serie A,2018,26.0,1992.0,36.3,76,50,35,35,6,33,53,62.3,20,52,24,28,88,164,149,2,DF,25-29,Defender,Italy,Europe
1139,Koo Ja-cheol,KOR,Augsburg,Bundesliga,2018,29.0,1989.0,18.2,36,23,10,20,6,12,30,40.0,18,28,5,23,27,63,21,0,MF,25-29,Midfielder,South Korea,Asia
1140,Lukas Jäger,AUT,Nürnberg,Bundesliga,2018,24.0,1994.0,0.3,0,0,0,0,0,0,2,0.0,2,0,0,0,0,0,0,0,"FW,MF",20-24,Forward,Austria,Europe
1141,Phil Jagielka,ENG,Everton,Premier League,2018,35.0,1982.0,3.7,7,5,3,4,0,1,4,25.0,3,1,0,1,2,9,14,0,DF,35-39,Defender,England,Europe
1142,Alireza Jahanbakhsh,IRN,Brighton,Premier League,2018,24.0,1993.0,11.3,32,18,17,11,4,11,30,36.7,19,16,0,16,11,43,4,0,"FW,MF",20-24,Forward,Iran,Asia
1143,Christophe Jallet,FRA,Nice,Ligue 1,2018,34.0,1983.0,9.8,29,21,12,13,4,16,27,59.3,11,21,5,16,14,43,32,0,DF,30-34,Defender,France,Europe
1144,Jandrei,BRA,Genoa,Serie A,2018,25.0,1993.0,1.0,0,0,0,0,0,0,1,0.0,1,0,0,0,0,0,0,0,GK,25-29,Goalkeeper,Brazil,South America
1145,Christoph Janker,GER,Augsburg,Bundesliga,2018,33.0,1985.0,0.8,2,1,2,0,0,0,0,,0,1,0,1,0,2,1,0,"MF,FW",30-34,Midfielder,Germany,Europe
1146,Marko Janković,MNE,SPAL,Serie A,2018,23.0,1995.0,0.6,3,1,2,1,0,0,2,0.0,2,0,0,0,0,3,0,0,"DF,MF",20-24,Defender,Montenegro,Europe
1148,Daryl Janmaat,NED,Watford,Premier League,2018,29.0,1989.0,16.9,36,24,23,11,2,20,29,69.0,9,16,6,10,33,69,71,0,DF,25-29,Defender,Netherlands,Europe
1149,Vincent Janssen,NED,Tottenham,Premier League,2018,24.0,1994.0,0.4,2,1,0,2,0,0,0,,0,0,0,0,0,2,1,0,FW,20-24,Forward,Netherlands,Europe
1150,Tony Jantschke,GER,Gladbach,Bundesliga,2018,28.0,1990.0,10.4,15,10,9,5,1,6,8,75.0,2,10,7,3,27,42,51,1,DF,25-29,Defender,Germany,Europe
1151,Adnan Januzaj,BEL,Real Sociedad,La Liga,2018,23.0,1995.0,13.9,11,8,5,2,4,3,13,23.1,10,7,0,7,6,17,6,0,"FW,MF",20-24,Forward,Belgium,Europe
1152,Nicolas Janvier,FRA,Rennes,Ligue 1,2018,19.0,1998.0,0.0,0,0,0,0,0,0,0,,0,0,0,0,0,0,0,0,MF,Under 20,Midfielder,France,Europe
1157,Assil Jaziri,TUN,Nice,Ligue 1,2018,18.0,1999.0,0.4,2,2,0,2,0,1,2,50.0,1,1,0,1,1,3,0,0,FW,Under 20,Forward,Tunisia,Africa
1158,Corentin Jean,FRA,Toulouse,Ligue 1,2018,23.0,1995.0,7.0,9,6,3,6,0,2,8,25.0,6,8,0,8,2,11,5,0,"FW,MF",20-24,Forward,France,Europe
1159,Benjamin Jeannot,FRA,Dijon,Ligue 1,2018,26.0,1992.0,16.0,17,12,5,7,5,6,19,31.6,13,15,3,12,12,29,14,0,"FW,MF",25-29,Forward,France,Europe
1160,Tin Jedvaj,CRO,Leverkusen,Bundesliga,2018,22.0,1995.0,12.5,23,15,9,8,6,10,19,52.6,9,28,2,26,22,45,52,0,DF,20-24,Defender,Croatia,Europe
1161,Jemerson,BRA,Monaco,Ligue 1,2018,25.0,1992.0,24.7,54,38,34,19,1,29,46,63.0,17,29,17,12,25,79,121,1,"DF,MF",25-29,Defender,Brazil,South America
1162,Carl Jenkinson,ENG,Arsenal,Premier League,2018,26.0,1992.0,1.8,3,2,2,0,1,2,3,66.7,1,4,3,1,0,3,2,0,DF,25-29,Defender,England,Europe
1163,Fredrik Jensen,FIN,Augsburg,Bundesliga,2018,20.0,1997.0,2.3,5,4,3,1,1,2,4,50.0,2,6,0,6,2,7,3,0,"FW,MF",20-24,Forward,Finland,Europe
1164,Mathias Jensen,DEN,Celta Vigo,La Liga,2018,22.0,1996.0,2.6,4,2,2,2,0,2,9,22.2,7,2,0,2,4,8,1,0,"MF,FW",20-24,Midfielder,Denmark,Europe
1166,Gabriel Jesus,BRA,Manchester City,Premier League,2018,21.0,1997.0,11.5,10,3,5,2,3,0,5,0.0,5,16,2,14,3,13,4,0,FW,20-24,Forward,Brazil,South America
1167,Juan Jesus,BRA,Roma,Serie A,2018,27.0,1991.0,15.6,37,29,30,5,2,17,30,56.7,13,20,12,8,16,53,41,0,DF,25-29,Defender,Brazil,South America
1168,Raúl Jiménez,MEX,Wolves,Premier League,2018,27.0,1991.0,34.6,30,18,5,17,8,6,23,26.1,17,25,3,22,26,56,40,0,FW,25-29,Forward,Mexico,North America
1170,Joelinton,BRA,Hoffenheim,Bundesliga,2018,21.0,1996.0,23.7,35,22,9,20,6,10,30,33.3,20,36,3,33,14,49,8,0,"FW,MF",20-24,Forward,Brazil,South America
1171,Aron Jóhannsson,USA,Werder Bremen,Bundesliga,2018,27.0,1990.0,0.0,0,0,0,0,0,0,0,,0,0,0,0,0,0,0,0,MF,25-29,Midfielder,United States,North America
1173,Jakob Johansson,SWE,Rennes,Ligue 1,2018,28.0,1990.0,7.9,17,9,5,12,0,10,20,50.0,10,7,3,4,3,20,17,1,MF,25-29,Midfielder,Sweden,Europe
1173,Jakob Johansson,SWE,Rennes,Ligue 1,2018,28.0,1990.0,7.9,17,9,5,12,0,10,20,50.0,10,7,3,4,3,20,17,1,MF,25-29,Midfielder,Sweden,Europe
1173,Jakob Johansson,SWE,Rennes,Ligue 1,2018,28.0,1990.0,7.9,17,9,5,12,0,10,20,50.0,10,7,3,4,3,20,17,1,MF,25-29,Midfielder,Sweden,Europe
1173,Jakob Johansson,SWE,Rennes,Ligue 1,2018,28.0,1990.0,7.9,17,9,5,12,0,10,20,50.0,10,7,3,4,3,20,17,1,MF,25-29,Midfielder,Sweden,Europe
1174,Ben Johnson,ENG,West Ham,Premier League,2018,18.0,2000.0,0.7,1,0,1,0,0,0,1,0.0,1,0,0,0,1,2,5,0,DF,Under 20,Defender,England,Europe
1175,Fabian Johnson,USA,Gladbach,Bundesliga,2018,30.0,1987.0,11.2,13,5,2,8,3,6,8,75.0,2,8,3,5,10,23,16,0,"DF,FW",30-34,Defender,United States,North America
1176,Tyreke Johnson,ENG,Southampton,Premier League,2018,19.0,1998.0,0.0,0,0,0,0,0,0,0,,0,0,0,0,0,0,0,0,MF,Under 20,Midfielder,England,Europe
1177,Karl-Johan Johnsson,SWE,Guingamp,Ligue 1,2018,28.0,1990.0,17.0,0,0,0,0,0,0,1,0.0,1,0,0,0,0,0,4,1,GK,25-29,Goalkeeper,Sweden,Europe
1178,Jonathas,BRA,Hannover 96,Bundesliga,2018,29.0,1989.0,6.7,7,4,3,4,0,3,10,30.0,7,9,1,8,3,10,4,0,FW,25-29,Forward,Brazil,South America
1179,Phil Jones,ENG,Manchester Utd,Premier League,2018,26.0,1992.0,14.0,19,13,12,7,0,8,13,61.5,5,16,11,5,23,42,67,3,DF,25-29,Defender,England,Europe
1182,Bruno Jordão,POR,Lazio,Serie A,2018,19.0,1998.0,1.0,4,3,2,1,1,1,3,33.3,2,1,0,1,0,4,2,0,"MF,DF",Under 20,Midfielder,Portugal,Europe
1183,Jorginho,ITA,Chelsea,Premier League,2018,26.0,1991.0,35.1,76,38,27,41,8,45,96,46.9,51,46,7,39,64,140,38,1,MF,25-29,Midfielder,Italy,Europe
1183,Jorginho,ITA,Chelsea,Premier League,2018,26.0,1991.0,35.1,76,38,27,41,8,45,96,46.9,51,46,7,39,64,140,38,1,MF,25-29,Midfielder,Italy,Europe
1183,Jorginho,ITA,Chelsea,Premier League,2018,26.0,1991.0,35.1,76,38,27,41,8,45,96,46.9,51,46,7,39,64,140,38,1,MF,25-29,Midfielder,Italy,Europe
1183,Jorginho,ITA,Chelsea,Premier League,2018,26.0,1991.0,35.1,76,38,27,41,8,45,96,46.9,51,46,7,39,64,140,38,1,MF,25-29,Midfielder,Italy,Europe
1183,Jorginho,ITA,Chelsea,Premier League,2018,26.0,1991.0,35.1,76,38,27,41,8,45,96,46.9,51,46,7,39,64,140,38,1,MF,25-29,Midfielder,Italy,Europe
1183,Jorginho,ITA,Chelsea,Premier League,2018,26.0,1991.0,35.1,76,38,27,41,8,45,96,46.9,51,46,7,39,64,140,38,1,MF,25-29,Midfielder,Italy,Europe
1183,Jorginho,ITA,Chelsea,Premier League,2018,26.0,1991.0,35.1,76,38,27,41,8,45,96,46.9,51,46,7,39,64,140,38,1,MF,25-29,Midfielder,Italy,Europe
1183,Jorginho,ITA,Chelsea,Premier League,2018,26.0,1991.0,35.1,76,38,27,41,8,45,96,46.9,51,46,7,39,64,140,38,1,MF,25-29,Midfielder,Italy,Europe
1183,Jorginho,ITA,Chelsea,Premier League,2018,26.0,1991.0,35.1,76,38,27,41,8,45,96,46.9,51,46,7,39,64,140,38,1,MF,25-29,Midfielder,Italy,Europe
1183,Jorginho,ITA,Chelsea,Premier League,2018,26.0,1991.0,35.1,76,38,27,41,8,45,96,46.9,51,46,7,39,64,140,38,1,MF,25-29,Midfielder,Italy,Europe
1183,Jorginho,ITA,Chelsea,Premier League,2018,26.0,1991.0,35.1,76,38,27,41,8,45,96,46.9,51,46,7,39,64,140,38,1,MF,25-29,Midfielder,Italy,Europe
1183,Jorginho,ITA,Chelsea,Premier League,2018,26.0,1991.0,35.1,76,38,27,41,8,45,96,46.9,51,46,7,39,64,140,38,1,MF,25-29,Midfielder,Italy,Europe
1183,Jorginho,ITA,Chelsea,Premier League,2018,26.0,1991.0,35.1,76,38,27,41,8,45,96,46.9,51,46,7,39,64,140,38,1,MF,25-29,Midfielder,Italy,Europe
1183,Jorginho,ITA,Chelsea,Premier League,2018,26.0,1991.0,35.1,76,38,27,41,8,45,96,46.9,51,46,7,39,64,140,38,1,MF,25-29,Midfielder,Italy,Europe
1183,Jorginho,ITA,Chelsea,Premier League,2018,26.0,1991.0,35.1,76,38,27,41,8,45,96,46.9,51,46,7,39,64,140,38,1,MF,25-29,Midfielder,Italy,Europe
1183,Jorginho,ITA,Chelsea,Premier League,2018,26.0,1991.0,35.1,76,38,27,41,8,45,96,46.9,51,46,7,39,64,140,38,1,MF,25-29,Midfielder,Italy,Europe
1184,Willian José,BRA,Real Sociedad,La Liga,2018,26.0,1991.0,26.3,5,3,1,3,1,2,7,28.6,5,11,5,6,1,6,27,0,FW,25-29,Forward,Brazil,South America
1186,Evens Joseph,FRA,Caen,Ligue 1,2018,19.0,1999.0,3.8,5,2,1,2,2,1,3,33.3,2,3,0,3,2,7,1,0,"MF,FW",Under 20,Midfielder,France,Europe
1187,Diogo Jota,POR,Wolves,Premier League,2018,21.0,1996.0,26.2,28,16,11,11,6,10,38,26.3,28,20,1,19,13,41,11,0,"FW,MF",20-24,Forward,Portugal,Europe
1190,Stevan Jovetić,MNE,Monaco,Ligue 1,2018,28.0,1989.0,4.4,2,1,1,1,0,1,3,33.3,2,1,0,1,1,3,3,0,"MF,FW",25-29,Midfielder,Montenegro,Europe
1198,Juanpi,VEN,Huesca,La Liga,2018,24.0,1994.0,7.4,16,6,9,5,2,4,12,33.3,8,15,0,15,6,22,3,0,"MF,FW",20-24,Midfielder,Venezuela,South America
1199,Nathaël Julan,FRA,Guingamp,Ligue 1,2018,22.0,1996.0,4.8,1,0,0,0,1,0,3,0.0,3,6,1,5,0,1,2,0,"FW,MF",20-24,Forward,France,Europe
1200,Christopher Jullien,FRA,Toulouse,Ligue 1,2018,25.0,1993.0,33.5,35,24,23,10,2,12,32,37.5,20,39,27,12,41,76,203,4,DF,25-29,Defender,France,Europe
1202,Sebastian Jung,GER,Wolfsburg,Bundesliga,2018,28.0,1990.0,0.6,1,0,0,1,0,1,1,100.0,0,0,0,0,0,1,1,0,DF,25-29,Defender,Germany,Europe
1203,Hamed Junior Traorè,CIV,Empoli,Serie A,2018,18.0,2000.0,25.1,67,38,26,32,9,27,72,37.5,45,29,4,25,30,97,17,0,MF,Under 20,Midfielder,Ivory Coast,Africa
1204,Vinicius Júnior,BRA,Real Madrid,La Liga,2018,18.0,2000.0,9.7,10,6,3,6,1,3,16,18.8,13,6,1,5,7,17,1,0,"FW,MF",Under 20,Forward,Brazil,South America
1205,Musa Juwara,GAM,Chievo,Serie A,2018,16.0,2001.0,0.1,0,0,0,0,0,0,0,,0,0,0,0,1,1,0,0,FW,Under 20,Forward,Gambia,Africa
1206,Mathias Jørgensen,DEN,Huddersfield,Premier League,2018,28.0,1990.0,23.9,49,31,27,21,1,27,46,58.7,19,29,14,15,69,118,83,0,DF,25-29,Defender,Denmark,Europe
1207,Sory Kaba,GUI,Dijon,Ligue 1,2018,23.0,1995.0,2.6,1,1,1,0,0,1,3,33.3,2,2,0,2,0,1,1,0,"FW,MF",20-24,Forward,Guinea,Africa
1208,Ozan Kabak,TUR,Stuttgart,Bundesliga,2018,18.0,2000.0,15.0,33,19,22,9,2,9,19,47.4,10,15,8,7,23,56,58,1,DF,Under 20,Defender,Turkey,Asia
1209,Christian Kabasele,BEL,Watford,Premier League,2018,27.0,1991.0,17.6,25,14,20,5,0,10,23,43.5,13,21,16,5,38,63,111,0,DF,25-29,Defender,Belgium,Europe
1210,Elias Kachunga,COD,Huddersfield,Premier League,2018,26.0,1992.0,13.1,22,9,8,12,2,9,25,36.0,16,16,1,15,4,26,10,0,"FW,MF",25-29,Forward,DR Congo,Africa
1212,Shinji Kagawa,JPN,Dortmund,Bundesliga,2018,29.0,1989.0,1.1,0,0,0,0,0,0,0,,0,0,0,0,0,0,0,0,MF,25-29,Midfielder,Japan,Asia
1213,Florian Kainz,AUT,Werder Bremen,Bundesliga,2018,25.0,1992.0,4.1,6,5,5,1,0,3,6,50.0,3,4,1,3,3,9,5,0,FW,25-29,Forward,Austria,Europe
1214,Gaël Kakuta,COD,Rayo Vallecano,La Liga,2018,27.0,1991.0,8.0,12,7,5,5,2,2,10,20.0,8,4,1,3,9,21,9,0,"MF,FW",25-29,Midfielder,DR Congo,Africa
1215,Nikola Kalinić,CRO,Atlético Madrid,La Liga,2018,30.0,1988.0,7.1,6,4,2,4,0,1,3,33.3,2,1,0,1,2,8,2,0,FW,30-34,Forward,Croatia,Europe
1216,Salomon Kalou,CIV,Hertha BSC,Bundesliga,2018,32.0,1985.0,25.7,21,12,5,11,5,6,24,25.0,18,23,1,22,6,27,25,0,"FW,MF",30-34,Forward,Ivory Coast,Africa
1217,Samuel Kalu,NGA,Bordeaux,Ligue 1,2018,20.0,1997.0,14.2,27,18,15,7,5,4,11,36.4,7,11,3,8,8,35,4,1,FW,20-24,Forward,Nigeria,Africa
1218,François Kamano,GUI,Bordeaux,Ligue 1,2018,22.0,1996.0,28.5,29,18,6,17,6,11,30,36.7,19,27,0,27,17,46,6,1,"FW,MF",20-24,Forward,Guinea,Africa
1219,Aboubakar Kamara,MTN,Fulham,Premier League,2018,23.0,1995.0,7.7,8,4,1,5,2,3,7,42.9,4,6,0,6,1,9,6,0,FW,20-24,Forward,Mauritania,Africa
1220,Boubacar Kamara,FRA,Marseille,Ligue 1,2018,18.0,1999.0,26.8,67,39,38,24,5,32,49,65.3,17,24,13,11,45,112,95,2,DF,Under 20,Defender,France,Europe
1221,Hassane Kamara,CIV,Reims,Ligue 1,2018,24.0,1994.0,10.3,29,21,22,5,2,16,19,84.2,3,6,1,5,14,43,41,0,"DF,FW",20-24,Defender,Ivory Coast,Africa
1223,Patrick Kammerbauer,GER,Freiburg,Bundesliga,2018,21.0,1997.0,0.0,0,0,0,0,0,0,0,,0,0,0,0,1,1,1,0,FW,20-24,Forward,Germany,Europe
1225,Harry Kane,ENG,Tottenham,Premier League,2018,25.0,1993.0,26.9,10,6,2,8,0,1,14,7.1,13,16,6,10,1,11,14,0,FW,25-29,Forward,England,Europe
1226,Lee Kang-in,KOR,Valencia,La Liga,2018,17.0,2001.0,0.3,2,0,1,1,0,1,3,33.3,2,0,0,0,1,3,0,0,"MF,FW",Under 20,Midfielder,South Korea,Asia
1227,Wilfried Kanga,CIV,Angers,Ligue 1,2018,20.0,1998.0,5.5,0,0,0,0,0,0,1,0.0,1,3,0,3,0,0,4,0,FW,20-24,Forward,Ivory Coast,Africa
1228,N'Golo Kanté,FRA,Chelsea,Premier League,2018,27.0,1991.0,34.4,75,41,21,41,13,23,67,34.3,44,63,6,57,44,119,32,1,MF,25-29,Midfielder,France,Europe
1229,Stefanos Kapino,GRE,Werder Bremen,Bundesliga,2018,24.0,1994.0,0.5,0,0,0,0,0,0,0,,0,0,0,0,0,0,0,0,GK,20-24,Goalkeeper,Greece,Europe
1230,Wilfrid Kaptoum,CMR,Betis,La Liga,2018,22.0,1996.0,8.6,15,6,4,10,1,5,11,45.5,6,9,1,8,10,25,6,2,MF,20-24,Midfielder,Cameroon,Africa
1231,Kenan Karaman,TUR,Düsseldorf,Bundesliga,2018,24.0,1994.0,10.2,13,9,3,10,0,7,12,58.3,5,5,1,4,2,15,8,0,"FW,MF",20-24,Forward,Turkey,Asia
1232,Yann Karamoh,FRA,Inter,Serie A,2018,20.0,1998.0,0.1,0,0,0,0,0,0,0,,0,0,0,0,0,0,0,0,"FW,MF",20-24,Forward,France,Europe
1233,Yann Karamoh,FRA,Bordeaux,Ligue 1,2018,20.0,1998.0,13.6,7,3,1,4,2,1,13,7.7,12,9,0,9,6,13,3,0,FW,20-24,Forward,France,Europe
1234,Ibrahim Karamoko,FRA,Chievo,Serie A,2018,17.0,2001.0,0.7,0,0,0,0,0,0,0,,0,1,0,1,0,0,1,0,MF,Under 20,Midfielder,France,Europe
1235,Orestis Karnezis,GRE,Napoli,Serie A,2018,33.0,1985.0,9.0,0,0,0,0,0,0,0,,0,0,0,0,0,0,3,0,GK,30-34,Goalkeeper,Greece,Europe
1236,Rick Karsdorp,NED,Roma,Serie A,2018,23.0,1995.0,6.6,9,6,3,5,1,5,11,45.5,6,4,2,2,12,21,12,1,DF,20-24,Defender,Netherlands,Europe
1237,Grigoris Kastanos,CYP,Juventus,Serie A,2018,20.0,1998.0,0.7,3,1,3,0,0,0,0,,0,3,1,2,0,3,0,0,MF,20-24,Midfielder,Cyprus,Asia
1238,Eiji Kawashima,JPN,Strasbourg,Ligue 1,2018,35.0,1983.0,1.0,0,0,0,0,0,0,0,,0,0,0,0,0,0,0,0,GK,35-39,Goalkeeper,Japan,Asia
1239,Beram Kayal,ISR,Brighton,Premier League,2018,30.0,1988.0,10.4,28,17,16,11,1,5,21,23.8,16,17,10,7,15,43,25,0,MF,30-34,Midfielder,Israel,Asia
1240,Moise Kean,ITA,Juventus,Serie A,2018,18.0,2000.0,6.0,0,0,0,0,0,0,1,0.0,1,1,0,1,2,2,1,0,FW,Under 20,Forward,Italy,Europe
1241,Michael Keane,ENG,Everton,Premier League,2018,25.0,1993.0,33.0,41,25,22,16,3,19,32,59.4,13,30,22,8,43,84,185,4,DF,25-29,Defender,England,Europe
1242,Neeskens Kebano,COD,Fulham,Premier League,2018,26.0,1992.0,1.2,3,1,2,1,0,1,1,100.0,0,3,0,3,0,3,3,0,"FW,MF",25-29,Forward,DR Congo,Africa
1243,Thilo Kehrer,GER,Paris S-G,Ligue 1,2018,21.0,1996.0,21.1,64,43,27,31,6,31,55,56.4,24,32,17,15,31,95,69,1,DF,20-24,Defender,Germany,Europe
1244,Jules Keita,GUI,Dijon,Ligue 1,2018,20.0,1998.0,5.1,10,4,0,3,7,5,12,41.7,7,2,0,2,2,12,1,0,"FW,MF",20-24,Forward,Guinea,Africa
1245,Naby Keïta,GUI,Liverpool,Premier League,2018,23.0,1995.0,15.4,37,15,13,19,5,14,42,33.3,28,29,4,25,12,49,16,1,"MF,FW",20-24,Midfielder,Guinea,Africa
1247,Martin Kelly,ENG,Crystal Palace,Premier League,2018,28.0,1990.0,12.3,21,13,18,2,1,14,19,73.7,5,18,12,6,11,32,88,1,DF,25-29,Defender,England,Europe
1248,Marc-Oliver Kempf,GER,Stuttgart,Bundesliga,2018,23.0,1995.0,22.5,33,18,26,7,0,12,24,50.0,12,35,21,14,46,79,141,1,DF,20-24,Defender,Germany,Europe
1249,Kenedy,BRA,Newcastle Utd,Premier League,2018,22.0,1996.0,15.0,30,22,11,16,3,12,29,41.4,17,10,0,10,32,62,24,1,"MF,DF",20-24,Midfielder,Brazil,South America
1250,Jonjoe Kenny,ENG,Everton,Premier League,2018,21.0,1997.0,8.8,21,16,16,4,1,10,18,55.6,8,13,2,11,17,38,36,1,DF,20-24,Defender,England,Europe
1251,Christophe Kerbrat,FRA,Guingamp,Ligue 1,2018,31.0,1986.0,23.3,40,24,28,12,0,24,38,63.2,14,19,10,9,50,90,140,5,DF,30-34,Defender,France,Europe
1252,Sebastian Kerk,GER,Nürnberg,Bundesliga,2018,24.0,1994.0,13.1,16,9,8,5,3,7,23,30.4,16,14,5,9,3,19,22,1,"MF,FW",20-24,Midfielder,Germany,Europe
1253,Franck Kessié,CIV,Milan,Serie A,2018,21.0,1996.0,33.5,42,27,16,20,6,18,38,47.4,20,35,10,25,27,69,53,2,MF,20-24,Midfielder,Ivory Coast,Africa
1254,Saîf-Eddine Khaoui,TUN,Caen,Ligue 1,2018,23.0,1995.0,15.0,20,14,5,11,4,8,27,29.6,19,9,1,8,20,40,4,0,"MF,FW",20-24,Midfielder,Tunisia,Africa
1255,Wahbi Khazri,TUN,Saint-Étienne,Ligue 1,2018,27.0,1991.0,31.3,41,26,8,14,19,17,49,34.7,32,27,2,25,11,52,5,0,"FW,MF",25-29,Forward,Tunisia,Africa
1256,Rani Khedira,GER,Augsburg,Bundesliga,2018,24.0,1994.0,29.2,56,39,22,28,6,18,36,50.0,18,44,22,22,80,136,95,1,"DF,MF",20-24,Defender,Germany,Europe
1257,Sami Khedira,GER,Juventus,Serie A,2018,31.0,1987.0,7.8,10,9,6,2,2,5,9,55.6,4,8,3,5,5,15,6,0,MF,30-34,Midfielder,Germany,Europe
1258,Isaac Kiese Thelin,SWE,Leverkusen,Bundesliga,2018,26.0,1992.0,2.0,2,1,0,2,0,1,2,50.0,1,1,0,1,0,2,4,0,"FW,MF",25-29,Forward,Sweden,Europe
1260,Max Kilman,ENG,Wolves,Premier League,2018,21.0,1997.0,0.0,0,0,0,0,0,0,0,,0,0,0,0,0,0,0,0,DF,20-24,Defender,England,Europe
1261,Joshua Kimmich,GER,Bayern Munich,Bundesliga,2018,23.0,1995.0,34.0,46,26,17,22,7,25,54,46.3,29,35,9,26,34,80,41,3,"DF,MF",20-24,Defender,Germany,Europe
1262,Presnel Kimpembe,FRA,Paris S-G,Ligue 1,2018,22.0,1995.0,22.3,55,34,26,25,4,24,40,60.0,16,17,10,7,30,85,48,5,DF,20-24,Defender,France,Europe
1264,Sofian Kiyine,MAR,Chievo,Serie A,2018,20.0,1997.0,9.1,28,13,11,14,3,9,18,50.0,9,10,0,10,10,38,4,0,"MF,DF",20-24,Midfielder,Morocco,Africa
1265,Simon Kjær,DEN,Sevilla,La Liga,2018,29.0,1989.0,22.3,29,19,25,3,1,9,16,56.3,7,41,34,7,27,56,136,0,DF,25-29,Defender,Denmark,Europe
1266,Davy Klaassen,NED,Werder Bremen,Bundesliga,2018,25.0,1993.0,31.3,64,47,24,33,7,14,49,28.6,35,44,9,35,47,111,47,0,MF,25-29,Midfielder,Netherlands,Europe
1267,Felix Klaus,GER,Wolfsburg,Bundesliga,2018,25.0,1992.0,4.9,10,7,4,5,1,2,7,28.6,5,5,0,5,4,14,0,0,"FW,MF",25-29,Forward,Germany,Europe
1268,Ragnar Klavan,EST,Cagliari,Serie A,2018,32.0,1985.0,13.7,9,8,5,3,1,5,11,45.5,6,19,13,6,10,19,68,1,DF,30-34,Defender,Estonia,Europe
1269,Tim Kleindienst,GER,Freiburg,Bundesliga,2018,22.0,1995.0,2.2,4,3,1,2,1,1,3,33.3,2,3,0,3,0,4,7,0,FW,20-24,Forward,Germany,Europe
1270,Lukas Klostermann,GER,RB Leipzig,Bundesliga,2018,22.0,1996.0,22.3,50,29,33,12,5,29,45,64.4,16,37,5,32,29,79,74,0,DF,20-24,Defender,Germany,Europe
1271,Justin Kluivert,NED,Roma,Serie A,2018,19.0,1999.0,14.9,28,27,12,9,7,10,23,43.5,13,17,0,17,7,35,12,0,FW,Under 20,Forward,Netherlands,Europe
1272,Lukas Klünter,GER,Hertha BSC,Bundesliga,2018,22.0,1996.0,6.6,11,8,6,5,0,4,5,80.0,1,6,2,4,12,23,20,0,DF,20-24,Defender,Germany,Europe
1273,Robin Knoche,GER,Wolfsburg,Bundesliga,2018,26.0,1992.0,31.0,26,20,19,6,1,16,29,55.2,13,46,29,17,44,70,138,2,DF,25-29,Defender,Germany,Europe
1274,Anthony Knockaert,FRA,Brighton,Premier League,2018,26.0,1991.0,20.4,33,21,12,15,6,13,30,43.3,17,13,0,13,29,62,11,0,"MF,FW",25-29,Midfielder,France,Europe
1275,Törles Knöll,GER,Nürnberg,Bundesliga,2018,20.0,1997.0,4.1,3,2,1,1,1,0,4,0.0,4,5,1,4,0,3,2,0,"FW,MF",20-24,Forward,Germany,Europe
1276,Gregor Kobel,SUI,Hoffenheim,Bundesliga,2018,20.0,1997.0,1.0,0,0,0,0,0,0,0,,0,0,0,0,0,0,0,0,GK,20-24,Goalkeeper,Switzerland,Europe
1277,Gregor Kobel,SUI,Augsburg,Bundesliga,2018,20.0,1997.0,15.4,1,1,1,0,0,1,1,100.0,0,0,0,0,2,3,5,3,GK,20-24,Goalkeeper,Switzerland,Europe
1278,Robin Koch,GER,Freiburg,Bundesliga,2018,22.0,1996.0,21.1,25,14,17,7,1,7,24,29.2,17,31,18,13,32,57,77,4,"MF,DF",20-24,Midfielder,Germany,Europe
1279,Kenan Kodro,BIH,Athletic Club,La Liga,2018,24.0,1993.0,1.8,3,1,1,1,1,1,3,33.3,2,1,0,1,0,3,0,0,"FW,MF",20-24,Forward,Bosnia and Herzegovina,Europe
1280,Dominik Kohr,GER,Leverkusen,Bundesliga,2018,24.0,1994.0,10.8,42,29,21,21,0,14,35,40.0,21,25,12,13,15,57,17,1,MF,20-24,Midfielder,Germany,Europe
1281,Djégui Koita,FRA,Guingamp,Ligue 1,2018,18.0,1999.0,1.9,8,6,8,0,0,3,4,75.0,1,5,3,2,0,8,9,0,DF,Under 20,Defender,France,Europe
1284,Sead Kolašinac,BIH,Arsenal,Premier League,2018,25.0,1993.0,21.0,34,21,21,7,6,20,34,58.8,14,12,3,9,20,54,28,3,"DF,MF",25-29,Defender,Bosnia and Herzegovina,Europe
1285,Randal Kolo Muani,FRA,Nantes,Ligue 1,2018,19.0,1998.0,1.4,2,0,1,1,0,0,1,0.0,1,2,0,2,0,2,2,0,FW,Under 20,Forward,France,Europe
1286,Timothée Kolodziejczak,FRA,Saint-Étienne,Ligue 1,2018,26.0,1991.0,35.4,34,22,21,10,3,20,45,44.4,25,25,11,14,53,87,118,2,DF,25-29,Defender,France,Europe
1287,Vincent Kompany,BEL,Manchester City,Premier League,2018,32.0,1986.0,13.6,16,10,11,3,2,8,9,88.9,1,11,8,3,16,32,55,0,DF,30-34,Defender,Belgium,Europe
1288,Ghislain Konan,CIV,Reims,Ligue 1,2018,22.0,1995.0,20.0,45,28,31,10,4,24,40,60.0,16,18,4,14,40,85,55,1,DF,20-24,Defender,Ivory Coast,Africa
1289,Ibrahima Konaté,FRA,RB Leipzig,Bundesliga,2018,19.0,1999.0,27.0,44,32,30,14,0,17,27,63.0,10,29,18,11,58,102,126,0,DF,Under 20,Defender,France,Europe
1290,Moussa Konaté,SEN,Amiens,Ligue 1,2018,25.0,1993.0,20.8,10,8,3,3,4,2,12,16.7,10,14,3,11,5,15,15,0,FW,25-29,Forward,Senegal,Africa
1291,Geoffrey Kondogbia,CTA,Valencia,La Liga,2018,25.0,1993.0,13.8,47,33,18,23,6,12,27,44.4,15,20,7,13,27,74,22,2,MF,25-29,Midfielder,Central African Republic,Africa
1292,Lamine Koné,CIV,Strasbourg,Ligue 1,2018,29.0,1989.0,23.9,21,16,9,9,3,6,9,66.7,3,18,13,5,33,54,66,3,DF,25-29,Defender,Ivory Coast,Africa
1293,Manu Koné,FRA,Toulouse,Ligue 1,2018,17.0,2001.0,0.8,4,2,0,4,0,2,4,50.0,2,0,0,0,0,4,0,0,MF,Under 20,Midfielder,France,Europe
1294,Youssouf Koné,MLI,Lille,Ligue 1,2018,23.0,1995.0,19.0,67,38,45,19,3,41,65,63.1,24,31,3,28,39,106,52,1,DF,20-24,Defender,Mali,Africa
1295,Terence Kongolo,NED,Huddersfield,Premier League,2018,24.0,1994.0,30.2,74,46,44,26,4,27,47,57.4,20,42,16,26,65,139,106,1,DF,20-24,Defender,Netherlands,Europe
1296,Yevhen Konoplyanka,UKR,Schalke 04,Bundesliga,2018,28.0,1989.0,7.3,2,0,0,0,2,2,4,50.0,2,6,0,6,3,5,3,0,"FW,MF",25-29,Forward,Ukraine,Europe
1297,Pascal Köpke,GER,Hertha BSC,Bundesliga,2018,22.0,1995.0,0.8,1,0,1,0,0,1,2,50.0,1,0,0,0,0,1,0,0,"FW,MF",20-24,Forward,Germany,Europe
1298,Julian Korb,GER,Hannover 96,Bundesliga,2018,26.0,1992.0,11.2,26,17,16,9,1,10,29,34.5,19,27,4,23,23,49,34,1,DF,25-29,Defender,Germany,Europe
1299,Laurent Koscielny,FRA,Arsenal,Premier League,2018,32.0,1985.0,14.8,19,11,9,9,1,10,16,62.5,6,20,15,5,30,49,72,0,DF,30-34,Defender,France,Europe
1301,Christian Kouamé,CIV,Genoa,Serie A,2018,20.0,1997.0,34.1,31,22,8,16,7,2,13,15.4,11,23,3,20,25,56,28,0,FW,20-24,Forward,Ivory Coast,Africa
1303,Kalidou Koulibaly,SEN,Napoli,Serie A,2018,27.0,1991.0,34.8,61,40,37,22,2,19,36,52.8,17,55,33,22,40,101,144,0,DF,25-29,Defender,Senegal,Africa
1304,Jules Koundé,FRA,Bordeaux,Ligue 1,2018,19.0,1998.0,37.0,48,31,37,11,0,27,41,65.9,14,44,23,21,50,98,193,7,DF,Under 20,Defender,France,Europe
1305,Cheikhou Kouyaté,SEN,Crystal Palace,Premier League,2018,28.0,1989.0,21.1,59,33,23,31,5,9,33,27.3,24,29,11,18,16,75,33,0,MF,25-29,Midfielder,Senegal,Africa
1306,Mateo Kovačić,CRO,Chelsea,Premier League,2018,24.0,1994.0,19.3,45,29,23,19,3,20,46,43.5,26,19,2,17,8,53,18,1,MF,20-24,Midfielder,Croatia,Europe
1309,Thomas Kraft,GER,Hertha BSC,Bundesliga,2018,30.0,1988.0,3.5,0,0,0,0,0,0,0,,0,0,0,0,0,0,1,1,GK,30-34,Goalkeeper,Germany,Europe
1310,Emil Krafth,SWE,Amiens,Ligue 1,2018,23.0,1994.0,33.0,55,35,34,14,7,32,65,49.2,33,27,12,15,23,78,94,4,DF,20-24,Defender,Sweden,Europe
1312,Andrej Kramarić,CRO,Hoffenheim,Bundesliga,2018,27.0,1991.0,26.6,9,4,1,5,3,4,26,15.4,22,15,3,12,8,17,13,0,"MF,FW",25-29,Midfielder,Croatia,Europe
1313,Christoph Kramer,GER,Gladbach,Bundesliga,2018,27.0,1991.0,12.6,41,22,17,23,1,15,40,37.5,25,19,4,15,21,62,23,0,MF,25-29,Midfielder,Germany,Europe
1314,Vasyl Kravets,UKR,Leganés,La Liga,2018,20.0,1997.0,5.3,16,11,8,6,2,6,13,46.2,7,5,1,4,4,20,10,1,"DF,FW",20-24,Defender,Ukraine,Europe
1317,Toni Kroos,GER,Real Madrid,La Liga,2018,28.0,1990.0,24.7,51,35,18,24,9,14,57,24.6,43,25,4,21,14,65,13,1,MF,25-29,Midfielder,Germany,Europe
1318,Rade Krunić,BIH,Empoli,Serie A,2018,24.0,1993.0,30.8,38,23,21,14,3,14,41,34.1,27,35,12,23,24,62,32,0,MF,20-24,Midfielder,Bosnia and Herzegovina,Europe
1319,Max Kruse,GER,Werder Bremen,Bundesliga,2018,30.0,1988.0,31.5,17,5,2,13,2,6,38,15.8,32,16,1,15,8,25,6,2,"FW,MF",30-34,Forward,Germany,Europe
1320,Lukas Kübler,GER,Freiburg,Bundesliga,2018,25.0,1992.0,13.2,35,22,23,12,0,16,26,61.5,10,15,5,10,30,65,50,1,"DF,MF",25-29,Defender,Germany,Europe
1321,Yuya Kubo,JPN,Nürnberg,Bundesliga,2018,24.0,1993.0,15.1,21,11,6,10,5,12,33,36.4,21,11,0,11,10,31,6,0,"FW,MF",20-24,Forward,Japan,Asia
1322,Juraj Kucka,SVK,Parma,Serie A,2018,31.0,1987.0,17.1,51,32,17,29,5,19,53,35.8,34,27,7,20,17,68,37,1,MF,30-34,Midfielder,Slovakia,Europe
1323,Dejan Kulusevski,SWE,Atalanta,Serie A,2018,18.0,2000.0,1.2,3,3,0,2,1,1,3,33.3,2,1,0,1,0,3,0,0,MF,Under 20,Midfielder,Sweden,Europe
1324,Pierre Kunde,CMR,Mainz 05,Bundesliga,2018,23.0,1995.0,21.2,48,29,20,26,2,16,27,59.3,11,34,14,20,24,72,49,1,MF,20-24,Midfielder,Cameroon,Africa
1326,Layvin Kurzawa,FRA,Paris S-G,Ligue 1,2018,25.0,1992.0,11.2,19,11,6,5,8,6,16,37.5,10,10,2,8,10,29,16,0,"DF,MF",25-29,Defender,France,Europe
1328,Ahmed Kutucu,TUR,Schalke 04,Bundesliga,2018,18.0,2000.0,4.7,8,3,3,4,1,1,3,33.3,2,2,1,1,0,8,0,0,"FW,MF",Under 20,Forward,Turkey,Asia
1329,Enock Kwateng,FRA,Nantes,Ligue 1,2018,21.0,1997.0,22.7,65,41,34,27,4,33,70,47.1,37,28,4,24,78,143,56,0,DF,20-24,Defender,France,Europe
1330,Grejohn Kyei,FRA,Reims,Ligue 1,2018,22.0,1995.0,0.0,0,0,0,0,0,0,1,0.0,1,0,0,0,0,0,0,0,FW,20-24,Forward,France,Europe
1331,Antonino La Gumina,ITA,Empoli,Serie A,2018,22.0,1996.0,12.1,5,4,1,2,2,2,6,33.3,4,8,2,6,6,11,5,0,"FW,MF",20-24,Forward,Italy,Europe
1332,Rajiv van La Parra,NED,Huddersfield,Premier League,2018,27.0,1991.0,4.5,8,5,1,7,0,1,6,16.7,5,0,0,0,4,12,3,1,"FW,MF",25-29,Forward,Netherlands,Europe
1333,Gaëtan Laborde,FRA,Bordeaux,Ligue 1,2018,24.0,1994.0,1.0,4,3,0,1,3,2,4,50.0,2,0,0,0,0,4,0,0,FW,20-24,Forward,France,Europe
1334,Gaëtan Laborde,FRA,Montpellier,Ligue 1,2018,24.0,1994.0,32.2,36,15,6,15,15,11,27,40.7,16,18,2,16,6,42,27,0,"FW,MF",20-24,Forward,France,Europe
1335,Alexandre Lacazette,FRA,Arsenal,Premier League,2018,27.0,1991.0,27.8,35,16,6,19,10,5,28,17.9,23,27,1,26,15,50,31,0,FW,25-29,Forward,France,Europe
1336,Alban Lafont,FRA,Fiorentina,Serie A,2018,19.0,1999.0,33.5,0,0,0,0,0,0,0,,0,0,0,0,1,1,16,4,GK,Under 20,Goalkeeper,France,Europe
1338,Abdou Lahat Diakhate,SEN,Parma,Serie A,2018,19.0,1998.0,0.0,0,0,0,0,0,0,0,,0,0,0,0,0,0,0,0,MF,Under 20,Midfielder,Senegal,Africa
1339,Konrad Laimer,AUT,RB Leipzig,Bundesliga,2018,21.0,1997.0,20.8,72,38,21,34,17,20,71,28.2,51,67,2,65,32,104,23,0,"MF,DF",20-24,Midfielder,Austria,Europe
1340,Diego Lainez,MEX,Betis,La Liga,2018,18.0,2000.0,3.9,4,4,0,3,1,1,1,100.0,0,2,0,2,1,5,2,0,"FW,MF",Under 20,Forward,Mexico,North America
1341,Kenny Lala,MAD,Strasbourg,Ligue 1,2018,26.0,1991.0,34.0,78,45,48,23,7,30,53,56.6,23,26,9,17,28,106,62,2,"DF,FW",25-29,Defender,Madagascar,Africa
1342,Adam Lallana,ENG,Liverpool,Premier League,2018,30.0,1988.0,5.2,16,9,6,7,3,5,12,41.7,7,10,1,9,5,21,4,0,"MF,FW",30-34,Midfielder,England,Europe
1343,Érik Lamela,ARG,Tottenham,Premier League,2018,26.0,1992.0,10.8,17,13,6,7,4,5,14,35.7,9,14,0,14,7,24,1,0,"MF,FW",25-29,Midfielder,Argentina,South America
1344,Mohamed Lamine Diaby,FRA,Nice,Ligue 1,2018,17.0,2001.0,1.8,1,1,0,1,0,1,1,100.0,0,2,0,2,2,3,0,0,FW,Under 20,Forward,France,Europe
1345,Loïck Landre,FRA,Nîmes,Ligue 1,2018,26.0,1992.0,17.7,31,21,23,8,0,14,22,63.6,8,16,11,5,38,69,83,1,DF,25-29,Defender,France,Europe
1346,Michael Lang,SUI,Gladbach,Bundesliga,2018,27.0,1991.0,13.9,14,9,7,6,1,6,16,37.5,10,14,3,11,16,30,42,1,DF,25-29,Defender,Switzerland,Europe
1347,Sebastian Langkamp,GER,Werder Bremen,Bundesliga,2018,30.0,1988.0,15.7,24,15,18,6,0,7,14,50.0,7,17,11,6,20,44,79,1,DF,30-34,Defender,Germany,Europe
1348,Manuel Lanzini,ARG,West Ham,Premier League,2018,25.0,1993.0,7.6,12,7,5,6,1,5,18,27.8,13,3,1,2,9,21,7,1,MF,25-29,Midfielder,Argentina,South America
1349,Gianluca Lapadula,PER,Genoa,Serie A,2018,28.0,1990.0,4.5,2,1,2,0,0,1,5,20.0,4,2,0,2,1,3,2,0,FW,25-29,Forward,Peru,South America
1351,Danilo Larangeira,BRA,Bologna,Serie A,2018,34.0,1984.0,34.2,40,26,29,11,0,20,30,66.7,10,52,39,13,37,77,182,3,DF,30-34,Defender,Brazil,South America
1352,Johan Larsson,SWE,Guingamp,Ligue 1,2018,28.0,1990.0,1.0,1,1,0,1,0,1,2,50.0,1,0,0,0,1,2,1,1,DF,25-29,Defender,Sweden,Europe
1353,Kevin Lasagna,ITA,Udinese,Serie A,2018,25.0,1992.0,27.3,6,1,0,3,3,2,12,16.7,10,20,2,18,8,14,35,0,FW,25-29,Forward,Italy,Europe
1354,Jamaal Lascelles,ENG,Newcastle Utd,Premier League,2018,24.0,1993.0,30.5,32,21,25,5,2,11,14,78.6,3,43,28,15,39,71,218,3,DF,20-24,Defender,England,Europe
1355,Paul Lasne,FRA,Montpellier,Ligue 1,2018,29.0,1989.0,19.9,53,33,32,16,5,24,43,55.8,19,22,2,20,22,75,23,1,"MF,DF",25-29,Midfielder,France,Europe
1357,Danny Latza,GER,Mainz 05,Bundesliga,2018,28.0,1989.0,20.7,41,22,16,23,2,20,61,32.8,41,49,10,39,20,61,31,0,MF,25-29,Midfielder,Germany,Europe
1358,Alexandre Lauray,FRA,Bordeaux,Ligue 1,2018,21.0,1997.0,2.9,11,6,9,2,0,6,8,75.0,2,2,0,2,4,15,10,0,DF,20-24,Defender,France,Europe
1359,Armand Lauriente,FRA,Rennes,Ligue 1,2018,19.0,1998.0,0.0,0,0,0,0,0,0,0,,0,0,0,0,0,0,0,0,MF,Under 20,Midfielder,France,Europe
1360,Vincent Laurini,FRA,Fiorentina,Serie A,2018,29.0,1989.0,10.2,13,5,6,5,2,6,10,60.0,4,11,5,6,13,26,30,0,DF,25-29,Defender,France,Europe
1361,Wesley Lautoa,NCL,Dijon,Ligue 1,2018,30.0,1987.0,33.6,81,55,46,31,4,34,75,45.3,41,37,14,23,87,168,110,1,"DF,MF",30-34,Defender,New Caledonia,Oceania
1362,Diego Laxalt,URU,Milan,Serie A,2018,25.0,1993.0,7.2,26,13,14,7,5,13,22,59.1,9,23,3,20,8,34,12,0,"DF,MF",25-29,Defender,Uruguay,South America
1363,Miguel Layún,MEX,Villarreal,La Liga,2018,30.0,1988.0,5.6,8,2,0,7,1,2,6,33.3,4,8,2,6,1,9,10,0,"MF,DF",30-34,Midfielder,Mexico,North America
1364,Valentino Lazaro,AUT,Hertha BSC,Bundesliga,2018,22.0,1996.0,30.5,46,31,23,17,6,21,53,39.6,32,52,12,40,44,90,65,0,"DF,FW",20-24,Defender,Austria,Europe
1366,Manuel Lazzari,ITA,SPAL,Serie A,2018,24.0,1993.0,31.5,29,17,16,10,3,13,24,54.2,11,26,5,21,20,49,51,1,DF,20-24,Defender,Italy,Europe
1367,Mickaël Le Bihan,FRA,Nice,Ligue 1,2018,28.0,1990.0,2.3,1,1,0,1,0,1,2,50.0,1,1,0,1,1,2,1,0,FW,25-29,Forward,France,Europe
1368,Maxime Le Marchand,FRA,Fulham,Premier League,2018,28.0,1989.0,25.0,56,36,45,11,0,23,47,48.9,24,30,16,14,54,110,129,2,DF,25-29,Defender,France,Europe
1370,Damien Le Tallec,FRA,Montpellier,Ligue 1,2018,28.0,1990.0,31.2,95,58,42,43,10,33,89,37.1,56,35,8,27,59,154,50,0,MF,25-29,Midfielder,France,Europe
1371,James Lea Siliki,CMR,Rennes,Ligue 1,2018,22.0,1996.0,13.6,26,17,13,10,3,12,35,34.3,23,14,1,13,10,36,7,1,"MF,FW",20-24,Midfielder,Cameroon,Africa
1372,Rafael Leão,POR,Lille,Ligue 1,2018,19.0,1999.0,14.3,5,2,0,4,1,2,15,13.3,13,13,4,9,4,9,12,0,FW,Under 20,Forward,Portugal,Europe
1373,Mathew Leckie,AUS,Hertha BSC,Bundesliga,2018,27.0,1991.0,10.5,20,13,5,10,5,7,16,43.8,9,10,1,9,13,33,16,0,"FW,MF",25-29,Forward,Australia,Oceania
1374,Benjamin Lecomte,FRA,Montpellier,Ligue 1,2018,27.0,1991.0,37.0,1,0,1,0,0,1,3,33.3,2,0,0,0,5,6,24,3,GK,25-29,Goalkeeper,France,Europe
1375,Pierre Lees-Melou,FRA,Nice,Ligue 1,2018,25.0,1993.0,26.6,74,46,31,36,7,25,62,40.3,37,44,8,36,36,110,37,0,MF,25-29,Midfielder,France,Europe
1376,Jordan Lefort,FRA,Amiens,Ligue 1,2018,24.0,1993.0,20.0,33,18,23,6,4,16,25,64.0,9,11,8,3,46,79,107,0,DF,20-24,Defender,France,Europe
1377,Wu Lei,CHN,Espanyol,La Liga,2018,26.0,1991.0,11.8,13,6,5,6,2,5,16,31.3,11,9,0,9,7,20,7,0,"FW,MF",25-29,Forward,China,Asia
1378,Tim Leibold,GER,Nürnberg,Bundesliga,2018,24.0,1993.0,30.7,62,42,45,16,1,33,71,46.5,38,23,3,20,38,100,57,0,DF,20-24,Defender,Germany,Europe
1379,Lucas Leiva,BRA,Lazio,Serie A,2018,31.0,1987.0,22.1,91,54,40,46,5,38,79,48.1,41,27,11,16,52,143,43,3,MF,30-34,Midfielder,Brazil,South America
1380,Florian Lejeune,FRA,Newcastle Utd,Premier League,2018,27.0,1991.0,11.7,25,15,17,7,1,11,24,45.8,13,16,5,11,21,46,49,0,DF,25-29,Defender,France,Europe
1382,Thomas Lemar,FRA,Atlético Madrid,La Liga,2018,22.0,1995.0,20.2,38,21,23,11,4,19,42,45.2,23,26,1,25,22,60,7,1,MF,20-24,Midfielder,France,Europe
1383,Mario Lemina,GAB,Southampton,Premier League,2018,24.0,1993.0,17.9,49,32,23,23,3,15,34,44.1,19,27,3,24,43,92,31,1,MF,20-24,Midfielder,Gabon,Africa
1384,Mauricio Lemos,URU,Sassuolo,Serie A,2018,22.0,1995.0,2.0,2,1,2,0,0,1,2,50.0,1,2,1,1,3,5,10,1,DF,20-24,Defender,Uruguay,South America
1385,Clément Lenglet,FRA,Barcelona,La Liga,2018,23.0,1995.0,21.5,47,29,26,19,2,22,36,61.1,14,30,20,10,21,68,70,0,DF,20-24,Defender,France,Europe
1386,Aaron Lennon,ENG,Burnley,Premier League,2018,31.0,1987.0,13.5,26,16,11,12,3,6,14,42.9,8,24,0,24,10,36,18,0,MF,30-34,Midfielder,England,Europe
1387,Bernd Leno,GER,Arsenal,Premier League,2018,26.0,1992.0,31.5,0,0,0,0,0,0,3,0.0,3,0,0,0,4,4,16,6,GK,25-29,Goalkeeper,Germany,Europe
1390,Lukas Lerager,DEN,Genoa,Serie A,2018,25.0,1993.0,12.5,34,18,12,20,2,13,42,31.0,29,11,1,10,18,52,12,0,MF,25-29,Midfielder,Denmark,Europe
1391,Lukas Lerager,DEN,Bordeaux,Ligue 1,2018,25.0,1993.0,14.4,38,21,14,23,1,18,43,41.9,25,22,10,12,32,70,26,1,MF,25-29,Midfielder,Denmark,Europe
1392,Mehdi Léris,ALG,Chievo,Serie A,2018,20.0,1998.0,17.9,53,33,19,24,10,24,54,44.4,30,34,1,33,28,81,24,1,"MF,DF",20-24,Midfielder,Algeria,Africa
1393,Jefferson Lerma,COL,Bournemouth,Premier League,2018,23.0,1994.0,27.8,45,31,20,20,5,14,54,25.9,40,35,19,16,54,99,88,1,MF,20-24,Midfielder,Colombia,South America
1396,Aaron Leya Iseka,BEL,Toulouse,Ligue 1,2018,20.0,1997.0,16.0,6,4,1,4,1,1,4,25.0,3,5,3,2,1,7,10,0,FW,20-24,Forward,Belgium,Europe
1397,Stephan Lichtsteiner,SUI,Arsenal,Premier League,2018,34.0,1984.0,10.4,15,9,5,4,6,9,16,56.3,7,11,4,7,9,24,25,1,DF,30-34,Defender,Switzerland,Europe
1398,Dimitri Liénard,FRA,Strasbourg,Ligue 1,2018,30.0,1988.0,14.3,33,18,20,9,4,21,45,46.7,24,11,2,9,18,51,22,0,"MF,DF",30-34,Midfielder,France,Europe
1399,Philipp Lienhart,AUT,Freiburg,Bundesliga,2018,22.0,1996.0,6.8,6,6,4,2,0,3,6,50.0,3,9,7,2,11,17,42,0,DF,20-24,Defender,Austria,Europe
1400,Lucas Lima,BRA,Nantes,Ligue 1,2018,26.0,1991.0,27.7,49,28,26,15,8,20,53,37.7,33,39,3,36,29,78,62,1,"DF,FW",25-29,Defender,Brazil,South America
1401,Anthony Limbombe,BEL,Nantes,Ligue 1,2018,24.0,1994.0,13.7,12,10,4,6,2,7,16,43.8,9,5,0,5,8,20,10,0,FW,20-24,Forward,Belgium,Europe
1402,Victor Lindelöf,SWE,Manchester Utd,Premier League,2018,24.0,1994.0,28.9,40,27,28,12,0,13,23,56.5,10,21,12,9,24,64,121,3,DF,20-24,Defender,Sweden,Europe
1404,Jesse Lingard,ENG,Manchester Utd,Premier League,2018,25.0,1992.0,18.5,29,18,8,11,10,7,28,25.0,21,18,2,16,10,39,9,1,"FW,MF",25-29,Forward,England,Europe
1410,Hugo Lloris,FRA,Tottenham,Premier League,2018,31.0,1986.0,33.0,1,0,1,0,0,0,2,0.0,2,0,0,0,0,1,13,5,GK,30-34,Goalkeeper,France,Europe
1411,Giovani Lo Celso,ARG,Betis,La Liga,2018,22.0,1996.0,26.6,52,31,16,28,8,9,35,25.7,26,24,1,23,17,69,8,0,"MF,FW",20-24,Midfielder,Argentina,South America
1412,Giovani Lo Celso,ARG,Paris S-G,Ligue 1,2018,22.0,1996.0,0.1,1,1,0,0,1,0,1,0.0,1,0,0,0,0,1,0,0,MF,20-24,Midfielder,Argentina,South America
1413,Stanislav Lobotka,SVK,Celta Vigo,La Liga,2018,23.0,1994.0,27.7,30,19,10,17,3,9,32,28.1,23,15,1,14,26,56,18,1,MF,20-24,Midfielder,Slovakia,Europe
1414,Jürgen Locadia,CUW,Brighton,Premier League,2018,24.0,1993.0,13.7,15,10,5,8,2,3,7,42.9,4,8,0,8,9,24,13,0,"FW,MF",20-24,Forward,Curaçao,Europe
1415,Manuel Locatelli,ITA,Sassuolo,Serie A,2018,20.0,1998.0,20.5,44,28,19,15,10,13,29,44.8,16,21,3,18,27,71,33,1,MF,20-24,Midfielder,Italy,Europe
1416,Ruben Loftus-Cheek,ENG,Chelsea,Premier League,2018,22.0,1996.0,11.1,18,12,7,7,4,3,12,25.0,9,10,4,6,11,29,5,0,"MF,FW",20-24,Midfielder,England,Europe
1417,Enzo Loiodice,FRA,Dijon,Ligue 1,2018,17.0,2000.0,9.4,25,14,8,15,2,10,21,47.6,11,7,0,7,11,36,7,0,MF,Under 20,Midfielder,France,Europe
1418,Kevin Long,IRL,Burnley,Premier League,2018,27.0,1990.0,5.7,18,10,13,5,0,7,17,41.2,10,7,5,2,7,25,35,1,DF,25-29,Defender,Republic of Ireland,Europe
1419,Shane Long,IRL,Southampton,Premier League,2018,31.0,1987.0,14.1,15,8,4,5,6,3,16,18.8,13,10,1,9,7,22,18,0,"FW,MF",30-34,Forward,Republic of Ireland,Europe
1420,Samuele Longo,ITA,Huesca,La Liga,2018,26.0,1992.0,6.2,4,3,2,2,0,0,6,0.0,6,4,0,4,1,5,7,0,FW,25-29,Forward,Italy,Europe
1421,Sean Longstaff,ENG,Newcastle Utd,Premier League,2018,20.0,1997.0,7.6,17,13,6,11,0,9,24,37.5,15,19,4,15,10,27,7,0,MF,20-24,Midfielder,England,Europe
1422,Ademola Lookman,NGA,Everton,Premier League,2018,20.0,1997.0,6.9,15,7,7,5,3,4,6,66.7,2,10,0,10,7,22,2,0,"FW,MF",20-24,Forward,Nigeria,Africa
1423,Anthony Lopes,POR,Lyon,Ligue 1,2018,27.0,1990.0,34.0,1,0,1,0,0,1,3,33.3,2,3,0,3,2,3,16,3,GK,25-29,Goalkeeper,Portugal,Europe
1424,Rony Lopes,POR,Monaco,Ligue 1,2018,22.0,1995.0,20.5,33,22,10,17,6,9,22,40.9,13,17,1,16,8,41,10,0,"FW,MF",20-24,Forward,Portugal,Europe
1431,Maxime Lopez,FRA,Marseille,Ligue 1,2018,20.0,1997.0,24.2,46,24,17,23,6,19,53,35.8,34,10,2,8,20,66,8,0,MF,20-24,Midfielder,France,Europe
1436,Jonas Lössl,DEN,Huddersfield,Premier League,2018,29.0,1989.0,30.9,0,0,0,0,0,0,1,0.0,1,1,0,1,2,2,12,2,GK,25-29,Goalkeeper,Denmark,Europe
1437,Albert Lottin,FRA,Bordeaux,Ligue 1,2018,16.0,2001.0,0.2,1,1,0,1,0,0,1,0.0,1,1,0,1,0,1,0,0,"MF,FW",Under 20,Midfielder,France,Europe
1438,Imran Louza,MAR,Nantes,Ligue 1,2018,19.0,1999.0,1.0,2,0,1,1,0,1,1,100.0,0,1,0,1,0,2,1,0,MF,Under 20,Midfielder,Morocco,Africa
1439,Davor Lovren,CRO,Düsseldorf,Bundesliga,2018,19.0,1998.0,0.5,1,1,0,0,1,0,0,,0,1,0,1,0,1,0,0,MF,Under 20,Midfielder,Croatia,Europe
1440,Dejan Lovren,CRO,Liverpool,Premier League,2018,29.0,1989.0,11.0,15,9,10,5,0,7,15,46.7,8,11,7,4,11,26,51,2,DF,25-29,Defender,Croatia,Europe
1441,Chris Löwe,GER,Huddersfield,Premier League,2018,29.0,1989.0,22.9,34,18,17,15,2,12,33,36.4,21,21,3,18,23,57,56,0,"DF,MF",25-29,Defender,Germany,Europe
1442,Eduard Löwen,GER,Nürnberg,Bundesliga,2018,21.0,1997.0,18.0,30,22,14,13,3,11,34,32.4,23,15,2,13,8,38,23,0,"MF,FW",20-24,Midfielder,Germany,Europe
1443,Matthew Lowton,ENG,Burnley,Premier League,2018,29.0,1989.0,19.4,56,35,21,31,4,32,60,53.3,28,29,7,22,30,86,80,1,DF,25-29,Defender,England,Europe
1445,Derrick Luckassen,NED,Hertha BSC,Bundesliga,2018,23.0,1995.0,2.8,4,2,4,0,0,1,3,33.3,2,1,0,1,0,4,13,0,DF,20-24,Defender,Netherlands,Europe
1446,Filipe Luís,BRA,Atlético Madrid,La Liga,2018,32.0,1985.0,22.6,66,36,33,25,8,32,58,55.2,26,18,3,15,44,110,47,0,DF,30-34,Defender,Brazil,South America
1449,José Luis Palomino,ARG,Atalanta,Serie A,2018,28.0,1990.0,25.1,49,31,31,15,3,23,38,60.5,15,34,17,17,68,117,79,0,DF,25-29,Defender,Argentina,South America
1450,Luisinho,POR,Huesca,La Liga,2018,33.0,1985.0,5.6,14,10,9,5,0,10,17,58.8,7,6,1,5,16,30,17,0,DF,30-34,Defender,Portugal,Europe
1451,David Luiz,BRA,Chelsea,Premier League,2018,31.0,1987.0,36.0,41,31,27,13,1,21,28,75.0,7,33,18,15,35,76,149,1,DF,30-34,Defender,Brazil,South America
1452,Douglas Luiz,BRA,Girona,La Liga,2018,20.0,1998.0,16.6,34,19,13,20,1,9,38,23.7,29,19,7,12,21,55,26,0,MF,20-24,Midfielder,Brazil,South America
1453,Everton Luiz,BRA,SPAL,Serie A,2018,30.0,1988.0,3.5,11,6,5,5,1,4,7,57.1,3,9,1,8,3,14,7,2,MF,30-34,Midfielder,Brazil,South America
1454,Jordan Lukaku,BEL,Lazio,Serie A,2018,24.0,1994.0,1.9,4,3,2,1,1,3,5,60.0,2,3,0,3,5,9,2,0,"DF,MF",20-24,Defender,Belgium,Europe
1455,Romelu Lukaku,BEL,Manchester Utd,Premier League,2018,25.0,1993.0,23.7,8,4,0,6,2,2,10,20.0,8,12,1,11,2,10,19,0,FW,25-29,Forward,Belgium,Europe
1456,Dodi Lukebakio,BEL,Düsseldorf,Bundesliga,2018,20.0,1997.0,21.9,25,17,11,6,8,8,15,53.3,7,13,0,13,9,34,19,0,"FW,MF",20-24,Forward,Belgium,Europe
1458,Senad Lulić,BIH,Lazio,Serie A,2018,32.0,1986.0,32.5,71,43,37,27,7,32,76,42.1,44,27,3,24,49,120,58,1,"DF,FW",30-34,Defender,Bosnia and Herzegovina,Europe
1460,Andriy Lunin,UKR,Leganés,La Liga,2018,19.0,1999.0,4.1,0,0,0,0,0,0,0,,0,0,0,0,0,0,0,0,GK,Under 20,Goalkeeper,Ukraine,Europe
1461,Sebastiano Luperto,ITA,Napoli,Serie A,2018,21.0,1996.0,8.1,8,6,5,2,1,2,5,40.0,3,7,3,4,13,21,30,0,DF,20-24,Defender,Italy,Europe
1462,Fabian Lustenberger,SUI,Hertha BSC,Bundesliga,2018,30.0,1988.0,24.1,45,30,23,21,1,15,33,45.5,18,39,18,21,39,84,108,2,"DF,MF",30-34,Defender,Switzerland,Europe
1463,Andreas Luthe,GER,Augsburg,Bundesliga,2018,31.0,1987.0,14.6,0,0,0,0,0,0,0,,0,0,0,0,0,0,4,0,GK,30-34,Goalkeeper,Germany,Europe
1464,Lyanco,BRA,Torino,Serie A,2018,21.0,1997.0,1.0,1,1,1,0,0,0,0,,0,1,1,0,4,5,5,0,DF,20-24,Defender,Brazil,South America
1465,Lyanco,BRA,Bologna,Serie A,2018,21.0,1997.0,12.4,29,18,19,10,0,13,18,72.2,5,24,16,8,22,51,64,0,DF,20-24,Defender,Brazil,South America
1466,Hervé Lybohy,NIG,Nîmes,Ligue 1,2018,35.0,1983.0,16.4,22,13,13,9,0,11,16,68.8,5,17,11,6,14,36,70,0,DF,35-39,Defender,Niger,Africa
1467,Charalambos Lykogiannis,GRE,Cagliari,Serie A,2018,24.0,1993.0,9.2,14,8,8,3,3,6,11,54.5,5,18,3,15,19,33,33,0,DF,20-24,Defender,Greece,Europe
1468,Yann M'Vila,FRA,Saint-Étienne,Ligue 1,2018,28.0,1990.0,36.2,72,40,22,48,2,29,72,40.3,43,42,12,30,74,146,86,5,MF,25-29,Midfielder,France,Europe
1469,Darwin Machís,VEN,Udinese,Serie A,2018,25.0,1993.0,5.1,7,6,4,3,0,0,4,0.0,4,6,0,6,2,9,8,0,"FW,MF",25-29,Forward,Venezuela,South America
1470,James Maddison,ENG,Leicester City,Premier League,2018,21.0,1996.0,31.5,48,32,20,25,3,14,58,24.1,44,20,4,16,12,60,10,1,"MF,FW",20-24,Midfielder,England,Europe
1471,Gary Madine,ENG,Cardiff City,Premier League,2018,27.0,1990.0,0.4,1,1,0,1,0,0,0,,0,0,0,0,0,1,0,0,"FW,MF",25-29,Forward,England,Europe
1473,Gabriel Magalhães,BRA,Lille,Ligue 1,2018,20.0,1997.0,11.8,18,11,13,4,1,4,7,57.1,3,14,6,8,19,37,60,2,DF,20-24,Defender,Brazil,South America
1474,Francesco Magnanelli,ITA,Sassuolo,Serie A,2018,33.0,1984.0,20.7,52,33,29,22,1,22,49,44.9,27,18,5,13,24,76,38,2,MF,30-34,Midfielder,Italy,Europe
1475,Giangiacomo Magnani,ITA,Sassuolo,Serie A,2018,22.0,1995.0,16.8,11,9,9,2,0,6,15,40.0,9,17,13,4,16,27,99,1,DF,20-24,Defender,Italy,Europe
1476,Harry Maguire,ENG,Leicester City,Premier League,2018,25.0,1993.0,28.8,31,17,21,9,1,11,17,64.7,6,32,18,14,36,67,155,4,DF,25-29,Defender,England,Europe
1477,Riyad Mahrez,ALG,Manchester City,Premier League,2018,27.0,1991.0,14.9,14,7,3,7,4,6,18,33.3,12,18,1,17,9,23,3,1,"FW,MF",25-29,Forward,Algeria,Africa
1478,Thiago Maia,BRA,Lille,Ligue 1,2018,21.0,1997.0,11.3,32,19,17,13,2,13,33,39.4,20,14,5,9,23,55,23,0,MF,20-24,Midfielder,Brazil,South America
1479,Raffaele Maiello,ITA,Frosinone,Serie A,2018,27.0,1991.0,22.7,42,27,30,8,4,16,27,59.3,11,23,10,13,30,72,41,0,MF,25-29,Midfielder,Italy,Europe
1480,Arne Maier,GER,Hertha BSC,Bundesliga,2018,19.0,1999.0,22.9,31,16,12,19,0,6,25,24.0,19,32,9,23,28,59,35,0,MF,Under 20,Midfielder,Germany,Europe
1481,Domenico Maietta,ITA,Empoli,Serie A,2018,35.0,1982.0,19.0,33,15,22,10,1,16,36,44.4,20,19,14,5,24,57,78,2,DF,35-39,Defender,Italy,Europe
1482,Mike Maignan,FRA,Lille,Ligue 1,2018,23.0,1995.0,38.0,0,0,0,0,0,0,0,,0,1,0,1,0,0,12,1,GK,20-24,Goalkeeper,France,Europe
1483,Linton Maina,GER,Hannover 96,Bundesliga,2018,19.0,1999.0,15.7,28,14,13,10,5,12,23,52.2,11,20,0,20,14,42,4,0,"FW,MF",Under 20,Forward,Germany,Europe
1484,Ainsley Maitland-Niles,ENG,Arsenal,Premier League,2018,20.0,1997.0,11.0,33,22,19,12,2,14,28,50.0,14,22,4,18,19,52,15,2,DF,20-24,Defender,England,Europe
1485,Josh Maja,NGA,Bordeaux,Ligue 1,2018,19.0,1998.0,2.2,2,1,1,1,0,0,1,0.0,1,1,0,1,0,2,0,0,FW,Under 20,Forward,Nigeria,Africa
1486,Abdul Majeed Waris,GHA,Nantes,Ligue 1,2018,26.0,1991.0,25.0,22,13,6,13,3,7,28,25.0,21,9,0,9,7,29,7,0,"FW,MF",25-29,Forward,Ghana,Africa
1487,Jean-Victor Makengo,FRA,Nice,Ligue 1,2018,20.0,1998.0,11.4,10,8,3,6,1,1,5,20.0,4,5,1,4,9,19,5,0,"MF,FW",20-24,Midfielder,France,Europe
1490,Malcom,BRA,Barcelona,La Liga,2018,21.0,1997.0,6.8,3,2,0,1,2,2,3,66.7,1,7,0,7,1,4,1,0,"FW,MF",20-24,Forward,Brazil,South America
1491,Kévin Malcuit,MAR,Napoli,Serie A,2018,27.0,1991.0,20.1,43,31,23,14,6,23,36,63.9,13,18,4,14,44,87,67,0,DF,25-29,Defender,Morocco,Africa
1492,Yunus Mallı,TUR,Wolfsburg,Bundesliga,2018,26.0,1992.0,7.8,15,7,8,6,1,2,11,18.2,9,2,0,2,4,19,1,0,"MF,FW",25-29,Midfielder,Turkey,Asia
1494,Antonio Mance,CRO,Nantes,Ligue 1,2018,22.0,1995.0,0.6,1,1,0,0,1,1,2,50.0,1,0,0,0,0,1,0,0,FW,20-24,Forward,Croatia,Europe
1495,Vincent Manceau,FRA,Angers,Ligue 1,2018,29.0,1989.0,31.0,98,65,64,23,11,33,62,53.2,29,41,10,31,44,142,87,0,DF,25-29,Defender,France,Europe
1496,Gianluca Mancini,ITA,Atalanta,Serie A,2018,22.0,1996.0,25.0,40,30,22,17,1,16,29,55.2,13,19,4,15,48,88,77,1,DF,20-24,Defender,Italy,Europe
1497,Steve Mandanda,FRA,Marseille,Ligue 1,2018,33.0,1985.0,30.4,0,0,0,0,0,0,3,0.0,3,0,0,0,1,1,7,4,GK,30-34,Goalkeeper,France,Europe
1498,Reinildo Mandava,MOZ,Lille,Ligue 1,2018,24.0,1994.0,1.1,3,2,1,2,0,2,3,66.7,1,1,0,1,1,4,0,0,DF,20-24,Defender,Mozambique,Africa
1499,Aïssa Mandi,ALG,Betis,La Liga,2018,26.0,1991.0,34.0,52,34,27,20,5,12,29,41.4,17,39,23,16,41,93,71,2,DF,25-29,Defender,Algeria,Africa
1500,Rolando Mandragora,ITA,Udinese,Serie A,2018,21.0,1997.0,32.4,66,35,25,34,7,24,69,34.8,45,49,9,40,43,109,59,0,MF,20-24,Midfielder,Italy,Europe
1501,Mario Mandžukić,CRO,Juventus,Serie A,2018,32.0,1986.0,22.4,34,25,13,15,6,9,18,50.0,9,17,5,12,13,47,22,0,FW,30-34,Forward,Croatia,Europe
1502,Sadio Mané,SEN,Liverpool,Premier League,2018,26.0,1992.0,34.2,35,29,12,17,6,14,43,32.6,29,28,4,24,15,50,10,1,FW,25-29,Forward,Senegal,Africa
1503,Thomas Mangani,FRA,Angers,Ligue 1,2018,31.0,1987.0,17.8,42,27,13,26,3,19,62,30.6,43,13,2,11,23,65,24,0,MF,30-34,Midfielder,France,Europe
1504,Kostas Manolas,GRE,Roma,Serie A,2018,27.0,1991.0,25.8,32,24,23,8,1,17,26,65.4,9,34,25,9,50,82,117,2,DF,25-29,Defender,Greece,Europe
1506,Martín Mantovani,ARG,Huesca,La Liga,2018,34.0,1984.0,7.8,15,9,12,3,0,6,11,54.5,5,4,3,1,22,37,48,0,DF,30-34,Defender,Argentina,South America
1507,Juan Manuel Valencia,COL,Bologna,Serie A,2018,20.0,1998.0,0.3,0,0,0,0,0,0,0,,0,0,0,0,1,1,0,0,FW,20-24,Forward,Colombia,South America
1508,Harrison Manzala,COD,Angers,Ligue 1,2018,24.0,1994.0,0.8,2,2,1,0,1,0,0,,0,0,0,0,0,2,1,0,"MF,FW",20-24,Midfielder,DR Congo,Africa
1511,Faitout Maouassa,FRA,Nîmes,Ligue 1,2018,20.0,1998.0,23.7,55,30,35,15,5,23,39,59.0,16,24,5,19,23,78,81,1,DF,20-24,Defender,France,Europe
1512,Fernando Marçal,BRA,Lyon,Ligue 1,2018,29.0,1989.0,9.8,25,16,17,7,1,12,15,80.0,3,9,3,6,30,55,42,0,DF,25-29,Defender,Brazil,South America
1514,Marcelo,BRA,Real Madrid,La Liga,2018,30.0,1988.0,20.6,34,19,17,12,5,15,39,38.5,24,19,2,17,17,51,21,0,DF,30-34,Defender,Brazil,South America
1514,Marcelo,BRA,Real Madrid,La Liga,2018,30.0,1988.0,20.6,34,19,17,12,5,15,39,38.5,24,19,2,17,17,51,21,0,DF,30-34,Defender,Brazil,South America
1514,Marcelo,BRA,Real Madrid,La Liga,2018,30.0,1988.0,20.6,34,19,17,12,5,15,39,38.5,24,19,2,17,17,51,21,0,DF,30-34,Defender,Brazil,South America
1514,Marcelo,BRA,Real Madrid,La Liga,2018,30.0,1988.0,20.6,34,19,17,12,5,15,39,38.5,24,19,2,17,17,51,21,0,DF,30-34,Defender,Brazil,South America
1514,Marcelo,BRA,Real Madrid,La Liga,2018,30.0,1988.0,20.6,34,19,17,12,5,15,39,38.5,24,19,2,17,17,51,21,0,DF,30-34,Defender,Brazil,South America
1514,Marcelo,BRA,Real Madrid,La Liga,2018,30.0,1988.0,20.6,34,19,17,12,5,15,39,38.5,24,19,2,17,17,51,21,0,DF,30-34,Defender,Brazil,South America
1514,Marcelo,BRA,Real Madrid,La Liga,2018,30.0,1988.0,20.6,34,19,17,12,5,15,39,38.5,24,19,2,17,17,51,21,0,DF,30-34,Defender,Brazil,South America
1514,Marcelo,BRA,Real Madrid,La Liga,2018,30.0,1988.0,20.6,34,19,17,12,5,15,39,38.5,24,19,2,17,17,51,21,0,DF,30-34,Defender,Brazil,South America
1514,Marcelo,BRA,Real Madrid,La Liga,2018,30.0,1988.0,20.6,34,19,17,12,5,15,39,38.5,24,19,2,17,17,51,21,0,DF,30-34,Defender,Brazil,South America
1515,Marcelo,BRA,Lyon,Ligue 1,2018,31.0,1987.0,32.0,48,33,29,17,2,19,24,79.2,5,30,22,8,62,110,152,2,DF,30-34,Defender,Brazil,South America
1515,Marcelo,BRA,Lyon,Ligue 1,2018,31.0,1987.0,32.0,48,33,29,17,2,19,24,79.2,5,30,22,8,62,110,152,2,DF,30-34,Defender,Brazil,South America
1515,Marcelo,BRA,Lyon,Ligue 1,2018,31.0,1987.0,32.0,48,33,29,17,2,19,24,79.2,5,30,22,8,62,110,152,2,DF,30-34,Defender,Brazil,South America
1515,Marcelo,BRA,Lyon,Ligue 1,2018,31.0,1987.0,32.0,48,33,29,17,2,19,24,79.2,5,30,22,8,62,110,152,2,DF,30-34,Defender,Brazil,South America
1515,Marcelo,BRA,Lyon,Ligue 1,2018,31.0,1987.0,32.0,48,33,29,17,2,19,24,79.2,5,30,22,8,62,110,152,2,DF,30-34,Defender,Brazil,South America
1515,Marcelo,BRA,Lyon,Ligue 1,2018,31.0,1987.0,32.0,48,33,29,17,2,19,24,79.2,5,30,22,8,62,110,152,2,DF,30-34,Defender,Brazil,South America
1515,Marcelo,BRA,Lyon,Ligue 1,2018,31.0,1987.0,32.0,48,33,29,17,2,19,24,79.2,5,30,22,8,62,110,152,2,DF,30-34,Defender,Brazil,South America
1515,Marcelo,BRA,Lyon,Ligue 1,2018,31.0,1987.0,32.0,48,33,29,17,2,19,24,79.2,5,30,22,8,62,110,152,2,DF,30-34,Defender,Brazil,South America
1515,Marcelo,BRA,Lyon,Ligue 1,2018,31.0,1987.0,32.0,48,33,29,17,2,19,24,79.2,5,30,22,8,62,110,152,2,DF,30-34,Defender,Brazil,South America
1516,Solly March,ENG,Brighton,Premier League,2018,24.0,1994.0,27.4,56,24,27,16,13,19,45,42.2,26,34,4,30,27,83,44,0,"FW,MF",20-24,Forward,England,Europe
1517,Federico Marchetti,ITA,Genoa,Serie A,2018,35.0,1983.0,4.0,0,0,0,0,0,0,0,,0,0,0,0,0,0,1,0,GK,35-39,Goalkeeper,Italy,Europe
1518,Gian Marco Ferrari,ITA,Sassuolo,Serie A,2018,26.0,1992.0,31.0,41,23,27,12,2,12,16,75.0,4,36,20,16,36,77,97,1,DF,25-29,Defender,Italy,Europe
1520,Georg Margreitter,AUT,Nürnberg,Bundesliga,2018,29.0,1988.0,22.9,39,24,28,8,3,31,38,81.6,7,29,26,3,26,65,141,0,DF,25-29,Defender,Austria,Europe
1522,José María Giménez,URU,Atlético Madrid,La Liga,2018,23.0,1995.0,19.7,26,15,20,6,0,13,26,50.0,13,27,14,13,44,70,128,2,DF,20-24,Defender,Uruguay,South America
1523,Mariano,DOM,Real Madrid,La Liga,2018,24.0,1993.0,5.0,2,1,1,1,0,0,3,0.0,3,2,0,2,0,2,2,0,FW,20-24,Forward,Dominican Republic,North America
1524,Mariano,DOM,Lyon,Ligue 1,2018,24.0,1993.0,1.6,0,0,0,0,0,0,0,,0,0,0,0,1,1,0,0,FW,20-24,Forward,Dominican Republic,North America
1525,Adrian Mariappa,JAM,Watford,Premier League,2018,31.0,1986.0,21.4,35,22,29,6,0,16,32,50.0,16,23,15,8,26,61,120,2,DF,30-34,Defender,Jamaica,North America
1526,Jordan Marié,FRA,Dijon,Ligue 1,2018,26.0,1991.0,20.0,52,28,15,31,6,21,58,36.2,37,28,5,23,40,92,32,0,MF,25-29,Midfielder,France,Europe
1528,João Mário,POR,Inter,Serie A,2018,25.0,1993.0,12.0,28,16,9,15,4,9,31,29.0,22,14,0,14,6,34,4,1,"MF,FW",25-29,Midfielder,Portugal,Europe
1528,João Mário,POR,Inter,Serie A,2018,25.0,1993.0,12.0,28,16,9,15,4,9,31,29.0,22,14,0,14,6,34,4,1,"MF,FW",25-29,Midfielder,Portugal,Europe
1528,João Mário,POR,Inter,Serie A,2018,25.0,1993.0,12.0,28,16,9,15,4,9,31,29.0,22,14,0,14,6,34,4,1,"MF,FW",25-29,Midfielder,Portugal,Europe
1528,João Mário,POR,Inter,Serie A,2018,25.0,1993.0,12.0,28,16,9,15,4,9,31,29.0,22,14,0,14,6,34,4,1,"MF,FW",25-29,Midfielder,Portugal,Europe
1528,João Mário,POR,Inter,Serie A,2018,25.0,1993.0,12.0,28,16,9,15,4,9,31,29.0,22,14,0,14,6,34,4,1,"MF,FW",25-29,Midfielder,Portugal,Europe
1528,João Mário,POR,Inter,Serie A,2018,25.0,1993.0,12.0,28,16,9,15,4,9,31,29.0,22,14,0,14,6,34,4,1,"MF,FW",25-29,Midfielder,Portugal,Europe
1528,João Mário,POR,Inter,Serie A,2018,25.0,1993.0,12.0,28,16,9,15,4,9,31,29.0,22,14,0,14,6,34,4,1,"MF,FW",25-29,Midfielder,Portugal,Europe
1528,João Mário,POR,Inter,Serie A,2018,25.0,1993.0,12.0,28,16,9,15,4,9,31,29.0,22,14,0,14,6,34,4,1,"MF,FW",25-29,Midfielder,Portugal,Europe
1528,João Mário,POR,Inter,Serie A,2018,25.0,1993.0,12.0,28,16,9,15,4,9,31,29.0,22,14,0,14,6,34,4,1,"MF,FW",25-29,Midfielder,Portugal,Europe
1529,Guillermo Maripán,CHI,Alavés,La Liga,2018,24.0,1994.0,22.3,46,26,34,12,0,26,38,68.4,12,35,19,16,40,86,133,2,DF,20-24,Defender,Chile,South America
1531,Marlon,BRA,Sassuolo,Serie A,2018,22.0,1995.0,16.8,29,18,25,3,1,15,21,71.4,6,22,12,10,24,53,39,0,DF,20-24,Defender,Brazil,South America
1531,Marlon,BRA,Sassuolo,Serie A,2018,22.0,1995.0,16.8,29,18,25,3,1,15,21,71.4,6,22,12,10,24,53,39,0,DF,20-24,Defender,Brazil,South America
1531,Marlon,BRA,Sassuolo,Serie A,2018,22.0,1995.0,16.8,29,18,25,3,1,15,21,71.4,6,22,12,10,24,53,39,0,DF,20-24,Defender,Brazil,South America
1531,Marlon,BRA,Sassuolo,Serie A,2018,22.0,1995.0,16.8,29,18,25,3,1,15,21,71.4,6,22,12,10,24,53,39,0,DF,20-24,Defender,Brazil,South America
1531,Marlon,BRA,Sassuolo,Serie A,2018,22.0,1995.0,16.8,29,18,25,3,1,15,21,71.4,6,22,12,10,24,53,39,0,DF,20-24,Defender,Brazil,South America
1531,Marlon,BRA,Sassuolo,Serie A,2018,22.0,1995.0,16.8,29,18,25,3,1,15,21,71.4,6,22,12,10,24,53,39,0,DF,20-24,Defender,Brazil,South America
1531,Marlon,BRA,Sassuolo,Serie A,2018,22.0,1995.0,16.8,29,18,25,3,1,15,21,71.4,6,22,12,10,24,53,39,0,DF,20-24,Defender,Brazil,South America
1531,Marlon,BRA,Sassuolo,Serie A,2018,22.0,1995.0,16.8,29,18,25,3,1,15,21,71.4,6,22,12,10,24,53,39,0,DF,20-24,Defender,Brazil,South America
1531,Marlon,BRA,Sassuolo,Serie A,2018,22.0,1995.0,16.8,29,18,25,3,1,15,21,71.4,6,22,12,10,24,53,39,0,DF,20-24,Defender,Brazil,South America
1532,Marquinhos,BRA,Paris S-G,Ligue 1,2018,24.0,1994.0,29.9,65,41,34,28,3,31,52,59.6,21,30,13,17,44,109,84,1,"DF,MF",20-24,Defender,Brazil,South America
1532,Marquinhos,BRA,Paris S-G,Ligue 1,2018,24.0,1994.0,29.9,65,41,34,28,3,31,52,59.6,21,30,13,17,44,109,84,1,"DF,MF",20-24,Defender,Brazil,South America
1532,Marquinhos,BRA,Paris S-G,Ligue 1,2018,24.0,1994.0,29.9,65,41,34,28,3,31,52,59.6,21,30,13,17,44,109,84,1,"DF,MF",20-24,Defender,Brazil,South America
1532,Marquinhos,BRA,Paris S-G,Ligue 1,2018,24.0,1994.0,29.9,65,41,34,28,3,31,52,59.6,21,30,13,17,44,109,84,1,"DF,MF",20-24,Defender,Brazil,South America
1532,Marquinhos,BRA,Paris S-G,Ligue 1,2018,24.0,1994.0,29.9,65,41,34,28,3,31,52,59.6,21,30,13,17,44,109,84,1,"DF,MF",20-24,Defender,Brazil,South America
1532,Marquinhos,BRA,Paris S-G,Ligue 1,2018,24.0,1994.0,29.9,65,41,34,28,3,31,52,59.6,21,30,13,17,44,109,84,1,"DF,MF",20-24,Defender,Brazil,South America
1532,Marquinhos,BRA,Paris S-G,Ligue 1,2018,24.0,1994.0,29.9,65,41,34,28,3,31,52,59.6,21,30,13,17,44,109,84,1,"DF,MF",20-24,Defender,Brazil,South America
1532,Marquinhos,BRA,Paris S-G,Ligue 1,2018,24.0,1994.0,29.9,65,41,34,28,3,31,52,59.6,21,30,13,17,44,109,84,1,"DF,MF",20-24,Defender,Brazil,South America
1532,Marquinhos,BRA,Paris S-G,Ligue 1,2018,24.0,1994.0,29.9,65,41,34,28,3,31,52,59.6,21,30,13,17,44,109,84,1,"DF,MF",20-24,Defender,Brazil,South America
1534,Anthony Martial,FRA,Manchester Utd,Premier League,2018,22.0,1995.0,18.0,9,7,2,5,2,1,11,9.1,10,12,0,12,3,12,8,0,FW,20-24,Forward,France,Europe
1536,Jonas Martin,FRA,Strasbourg,Ligue 1,2018,28.0,1990.0,22.9,46,28,23,18,5,17,33,51.5,16,30,12,18,30,76,42,0,MF,25-29,Midfielder,France,Europe
1537,Marvin Martin,FRA,Reims,Ligue 1,2018,30.0,1988.0,6.9,2,1,0,2,0,0,6,0.0,6,2,1,1,2,4,1,0,MF,30-34,Midfielder,France,Europe
1540,Lautaro Martínez,ARG,Inter,Serie A,2018,20.0,1997.0,14.9,6,5,0,2,4,2,6,33.3,4,16,0,16,3,9,7,0,"FW,MF",20-24,Forward,Argentina,South America
1541,Pablo Martinez,FRA,Strasbourg,Ligue 1,2018,29.0,1989.0,31.3,51,34,34,17,0,30,49,61.2,19,37,23,14,52,103,132,1,DF,25-29,Defender,France,Europe
1542,Gelson Martins,POR,Atlético Madrid,La Liga,2018,23.0,1995.0,2.5,5,3,3,1,1,3,4,75.0,1,1,0,1,1,6,1,0,"FW,MF",20-24,Forward,Portugal,Europe
1543,Gelson Martins,POR,Monaco,Ligue 1,2018,23.0,1995.0,15.4,20,12,8,7,5,13,32,40.6,19,9,1,8,8,28,7,0,"FW,MF",20-24,Forward,Portugal,Europe
1544,Adam Marušić,MNE,Lazio,Serie A,2018,25.0,1992.0,23.5,32,15,14,14,4,16,25,64.0,9,25,4,21,24,56,36,0,DF,25-29,Defender,Montenegro,Europe
1545,Omar Mascarell,EQG,Schalke 04,Bundesliga,2018,25.0,1993.0,11.0,20,10,9,9,2,10,24,41.7,14,21,7,14,23,43,8,0,MF,25-29,Midfielder,Equatorial Guinea,Africa
1546,Andrea Masiello,ITA,Atalanta,Serie A,2018,32.0,1986.0,20.4,28,14,13,15,0,17,29,58.6,12,21,6,15,44,72,49,0,DF,30-34,Defender,Italy,Europe
1547,Adam Masina,MAR,Watford,Premier League,2018,24.0,1994.0,11.2,30,17,16,13,1,13,25,52.0,12,19,4,15,17,47,40,0,DF,20-24,Defender,Morocco,Africa
1549,Han-Noah Massengo,FRA,Monaco,Ligue 1,2018,17.0,2001.0,0.7,2,2,2,0,0,2,5,40.0,3,0,0,0,2,4,1,0,MF,Under 20,Midfielder,France,Europe
1550,Arthur Masuaku,COD,West Ham,Premier League,2018,24.0,1993.0,19.5,57,25,38,13,6,31,56,55.4,25,27,6,21,36,93,72,0,DF,20-24,Defender,DR Congo,Africa
1553,Luca Matarese,ITA,Frosinone,Serie A,2018,20.0,1998.0,0.2,0,0,0,0,0,0,0,,0,0,0,0,0,0,0,0,FW,20-24,Forward,Italy,Europe
1554,Jean-Philippe Mateta,FRA,Mainz 05,Bundesliga,2018,21.0,1997.0,27.6,13,9,4,4,5,1,10,10.0,9,15,2,13,3,16,22,0,FW,20-24,Forward,France,Europe
1555,Christian Mathenia,GER,Nürnberg,Bundesliga,2018,26.0,1992.0,21.5,0,0,0,0,0,0,0,,0,1,0,1,1,1,18,2,GK,25-29,Goalkeeper,Germany,Europe
1557,Joël Matip,CMR,Liverpool,Premier League,2018,26.0,1991.0,17.1,39,26,23,12,4,13,24,54.2,11,12,7,5,32,71,78,0,DF,25-29,Defender,Cameroon,Africa
1558,Rabbi Matondo,WAL,Schalke 04,Bundesliga,2018,17.0,2000.0,2.1,4,1,4,0,0,1,5,20.0,4,2,0,2,0,4,1,0,"FW,MF",Under 20,Forward,Wales,Europe
1559,Alessandro Matri,ITA,Sassuolo,Serie A,2018,33.0,1984.0,6.7,2,1,0,0,2,0,3,0.0,3,4,2,2,4,6,7,0,FW,30-34,Forward,Italy,Europe
1560,Federico Mattiello,ITA,Bologna,Serie A,2018,23.0,1995.0,14.8,33,20,19,9,5,15,23,65.2,8,9,3,6,20,53,43,0,"DF,FW",20-24,Defender,Italy,Europe
1561,Blaise Matuidi,FRA,Juventus,Serie A,2018,31.0,1987.0,26.9,59,33,25,21,13,20,36,55.6,16,33,8,25,26,85,21,1,MF,30-34,Midfielder,France,Europe
1562,José Mauri,ITA,Milan,Serie A,2018,22.0,1996.0,2.3,8,4,2,6,0,2,6,33.3,4,0,0,0,5,13,0,0,MF,20-24,Midfielder,Italy,Europe
1563,Stephy Mavididi,ENG,Juventus,Serie A,2018,20.0,1998.0,0.2,0,0,0,0,0,0,0,,0,1,0,1,0,0,0,0,FW,20-24,Forward,England,Europe
1564,Konstantinos Mavropanos,GRE,Arsenal,Premier League,2018,20.0,1997.0,1.6,1,0,0,1,0,1,1,100.0,0,1,1,0,7,8,5,0,DF,20-24,Defender,Greece,Europe
1565,Alfie Mawson,ENG,Fulham,Premier League,2018,24.0,1994.0,12.6,11,7,7,4,0,6,10,60.0,4,20,17,3,19,30,64,1,DF,20-24,Defender,England,Europe
1566,Philipp Max,GER,Augsburg,Bundesliga,2018,24.0,1993.0,28.5,35,24,17,15,3,21,39,53.8,18,16,3,13,22,57,46,1,"DF,MF",20-24,Defender,Germany,Europe
1567,Alexandru Maxim,ROU,Mainz 05,Bundesliga,2018,28.0,1990.0,6.4,16,10,6,9,1,10,19,52.6,9,12,0,12,5,21,7,0,"MF,FW",25-29,Midfielder,Romania,Europe
1568,Eric Maxim Choupo-Moting,CMR,Paris S-G,Ligue 1,2018,29.0,1989.0,8.9,9,4,3,2,4,2,9,22.2,7,7,0,7,3,12,4,0,FW,25-29,Forward,Cameroon,Africa
1570,Róbert Mazáň,SVK,Celta Vigo,La Liga,2018,24.0,1994.0,1.0,3,3,3,0,0,2,2,100.0,0,2,0,2,3,6,0,0,DF,20-24,Defender,Slovakia,Europe
1571,Luca Mazzitelli,ITA,Genoa,Serie A,2018,22.0,1995.0,3.6,5,2,3,1,1,2,3,66.7,1,4,1,3,6,11,7,0,MF,20-24,Midfielder,Italy,Europe
1572,Kylian Mbappé,FRA,Paris S-G,Ligue 1,2018,19.0,1998.0,26.0,8,4,2,1,5,1,6,16.7,5,2,0,2,5,13,2,0,FW,Under 20,Forward,France,Europe
1573,Ibrahima Mbaye,SEN,Bologna,Serie A,2018,23.0,1994.0,22.3,48,32,30,16,2,19,32,59.4,13,21,12,9,19,67,66,1,DF,20-24,Defender,Senegal,Africa
1574,Loïc Mbe Soh,FRA,Paris S-G,Ligue 1,2018,17.0,2001.0,2.0,0,0,0,0,0,0,3,0.0,3,2,2,0,3,3,5,0,DF,Under 20,Defender,France,Europe
1575,Nolan Mbemba,CGO,Reims,Ligue 1,2018,23.0,1995.0,4.0,14,8,10,4,0,6,9,66.7,3,4,1,3,10,24,4,2,"MF,DF",20-24,Midfielder,Congo,Africa
1576,Adama Mbengue,SEN,Caen,Ligue 1,2018,24.0,1993.0,8.2,48,32,34,12,2,19,26,73.1,7,15,4,11,7,55,22,0,DF,20-24,Defender,Senegal,Africa
1577,Isaac Mbenza,BEL,Huddersfield,Premier League,2018,22.0,1996.0,11.0,10,9,5,5,0,2,4,50.0,2,4,0,4,5,15,4,0,"FW,MF",20-24,Forward,Belgium,Europe
1578,Stéphane Mbia,CMR,Toulouse,Ligue 1,2018,32.0,1986.0,5.0,1,0,1,0,0,1,2,50.0,1,9,4,5,7,8,25,1,"DF,MF",30-34,Defender,Cameroon,Africa
1579,Kara Mbodji,SEN,Nantes,Ligue 1,2018,28.0,1989.0,5.6,12,10,10,1,1,6,8,75.0,2,4,1,3,6,18,25,0,DF,25-29,Defender,Senegal,Africa
1581,James McArthur,SCO,Crystal Palace,Premier League,2018,30.0,1987.0,34.0,84,51,38,32,14,30,78,38.5,48,64,22,42,39,123,55,0,MF,30-34,Midfielder,Scotland,Europe
1582,Alex McCarthy,ENG,Southampton,Premier League,2018,28.0,1989.0,25.0,0,0,0,0,0,0,0,,0,0,0,0,0,0,6,2,GK,25-29,Goalkeeper,England,Europe
1583,James McCarthy,IRL,Everton,Premier League,2018,27.0,1990.0,0.2,2,1,1,1,0,0,0,,0,0,0,0,1,3,0,0,MF,25-29,Midfielder,Republic of Ireland,Europe
1584,Kevin McDonald,SCO,Fulham,Premier League,2018,29.0,1988.0,9.3,15,11,6,8,1,5,13,38.5,8,8,2,6,9,24,22,0,MF,25-29,Midfielder,Scotland,Europe
1585,Levan Mchedlidze,GEO,Empoli,Serie A,2018,28.0,1990.0,2.3,1,1,0,0,1,0,1,0.0,1,2,0,2,0,1,5,0,FW,25-29,Forward,Georgia,Asia
1586,Weston McKennie,USA,Schalke 04,Bundesliga,2018,19.0,1998.0,19.4,28,14,5,17,6,11,35,31.4,24,28,9,19,36,64,46,1,"MF,FW",Under 20,Midfielder,United States,North America
1587,Dwight McNeil,ENG,Burnley,Premier League,2018,18.0,1999.0,17.7,36,22,16,17,3,13,44,29.5,31,30,3,27,13,49,35,0,MF,Under 20,Midfielder,England,Europe
1588,Scott McTominay,SCO,Manchester Utd,Premier League,2018,21.0,1996.0,9.6,10,9,3,6,1,4,10,40.0,6,9,4,5,15,25,16,0,"MF,DF",20-24,Midfielder,Scotland,Europe
1589,Iuri Medeiros,POR,Genoa,Serie A,2018,24.0,1994.0,1.2,2,2,0,1,1,1,2,50.0,1,2,0,2,0,2,1,0,"MF,FW",20-24,Midfielder,Portugal,Europe
1590,Nicky Medja,SUI,Fiorentina,Serie A,2018,18.0,2000.0,0.5,1,0,0,0,1,1,2,50.0,1,0,0,0,0,1,0,0,"FW,MF",Under 20,Forward,Switzerland,Europe
1592,Ben Mee,ENG,Burnley,Premier League,2018,28.0,1989.0,38.0,55,24,38,17,0,35,44,79.5,9,59,50,9,48,103,235,4,DF,25-29,Defender,England,Europe
1593,Riccardo Meggiorini,ITA,Chievo,Serie A,2018,32.0,1985.0,17.2,17,13,5,9,3,1,10,10.0,9,20,2,18,8,25,26,0,FW,30-34,Forward,Italy,Europe
1594,Admir Mehmedi,SUI,Wolfsburg,Bundesliga,2018,27.0,1991.0,18.8,46,28,19,19,8,18,44,40.9,26,25,0,25,12,58,9,0,"FW,MF",25-29,Forward,Switzerland,Europe
1595,Soualiho Meïté,FRA,Torino,Serie A,2018,24.0,1994.0,29.5,46,21,13,22,11,23,46,50.0,23,46,6,40,29,75,26,0,MF,20-24,Midfielder,France,Europe
1596,Farid El Melali,ALG,Angers,Ligue 1,2018,21.0,1997.0,3.6,8,4,3,4,1,3,12,25.0,9,2,0,2,5,13,1,0,"MF,FW",20-24,Midfielder,Algeria,Africa
1599,Arthur Melo,BRA,Barcelona,La Liga,2018,21.0,1996.0,15.9,15,10,5,6,4,6,13,46.2,7,8,0,8,9,24,9,1,MF,20-24,Midfielder,Brazil,South America
1600,Memphis,NED,Lyon,Ligue 1,2018,24.0,1994.0,30.4,12,9,0,7,5,5,21,23.8,16,16,2,14,9,21,1,0,"FW,MF",20-24,Forward,Netherlands,Europe
1601,Pedro Mendes,POR,Montpellier,Ligue 1,2018,27.0,1990.0,29.6,71,42,56,13,2,31,47,66.0,16,42,22,20,48,119,73,1,DF,25-29,Defender,Portugal,Europe
1601,Pedro Mendes,POR,Montpellier,Ligue 1,2018,27.0,1990.0,29.6,71,42,56,13,2,31,47,66.0,16,42,22,20,48,119,73,1,DF,25-29,Defender,Portugal,Europe
1601,Pedro Mendes,POR,Montpellier,Ligue 1,2018,27.0,1990.0,29.6,71,42,56,13,2,31,47,66.0,16,42,22,20,48,119,73,1,DF,25-29,Defender,Portugal,Europe
1601,Pedro Mendes,POR,Montpellier,Ligue 1,2018,27.0,1990.0,29.6,71,42,56,13,2,31,47,66.0,16,42,22,20,48,119,73,1,DF,25-29,Defender,Portugal,Europe
1601,Pedro Mendes,POR,Montpellier,Ligue 1,2018,27.0,1990.0,29.6,71,42,56,13,2,31,47,66.0,16,42,22,20,48,119,73,1,DF,25-29,Defender,Portugal,Europe
1601,Pedro Mendes,POR,Montpellier,Ligue 1,2018,27.0,1990.0,29.6,71,42,56,13,2,31,47,66.0,16,42,22,20,48,119,73,1,DF,25-29,Defender,Portugal,Europe
1601,Pedro Mendes,POR,Montpellier,Ligue 1,2018,27.0,1990.0,29.6,71,42,56,13,2,31,47,66.0,16,42,22,20,48,119,73,1,DF,25-29,Defender,Portugal,Europe
1601,Pedro Mendes,POR,Montpellier,Ligue 1,2018,27.0,1990.0,29.6,71,42,56,13,2,31,47,66.0,16,42,22,20,48,119,73,1,DF,25-29,Defender,Portugal,Europe
1601,Pedro Mendes,POR,Montpellier,Ligue 1,2018,27.0,1990.0,29.6,71,42,56,13,2,31,47,66.0,16,42,22,20,48,119,73,1,DF,25-29,Defender,Portugal,Europe
1602,Thiago Mendes,BRA,Lille,Ligue 1,2018,26.0,1992.0,34.2,85,47,42,41,2,39,71,54.9,32,44,11,33,68,153,49,0,MF,25-29,Midfielder,Brazil,South America
1604,Nathaniel Mendez-Laing,GUA,Cardiff City,Premier League,2018,26.0,1992.0,10.9,34,25,18,12,4,12,26,46.2,14,17,1,16,13,47,20,0,"MF,FW",25-29,Midfielder,Guatemala,North America
1605,Stiven Mendoza,COL,Amiens,Ligue 1,2018,26.0,1992.0,20.9,29,18,10,12,7,14,38,36.8,24,18,0,18,17,46,12,0,"FW,MF",25-29,Forward,Colombia,South America
1606,Alexandre Mendy,GNB,Guingamp,Ligue 1,2018,24.0,1994.0,8.5,5,3,0,4,1,3,8,37.5,5,3,0,3,1,6,6,0,FW,20-24,Forward,Guinea-Bissau,Africa
1607,Benjamin Mendy,FRA,Manchester City,Premier League,2018,24.0,1994.0,10.0,16,10,10,5,1,9,17,52.9,8,13,4,9,10,26,18,0,DF,20-24,Defender,France,Europe
1608,Edouard Mendy,SEN,Reims,Ligue 1,2018,26.0,1992.0,38.0,0,0,0,0,0,0,1,0.0,1,1,0,1,2,2,16,3,GK,25-29,Goalkeeper,Senegal,Africa
1609,Ferland Mendy,FRA,Lyon,Ligue 1,2018,23.0,1995.0,28.1,44,28,25,14,5,14,17,82.4,3,22,5,17,34,78,53,2,DF,20-24,Defender,France,Europe
1610,Nampalys Mendy,SEN,Leicester City,Premier League,2018,26.0,1992.0,23.2,33,18,16,16,1,6,22,27.3,16,24,8,16,26,59,26,2,MF,25-29,Midfielder,Senegal,Africa
1611,Hamza Mendyl,MAR,Schalke 04,Bundesliga,2018,20.0,1997.0,6.0,17,15,6,8,3,8,18,44.4,10,11,2,9,8,25,8,0,DF,20-24,Defender,Morocco,Africa
1612,Chris Mepham,WAL,Bournemouth,Premier League,2018,20.0,1997.0,9.4,9,3,9,0,0,7,11,63.6,4,12,5,7,14,23,57,2,DF,20-24,Defender,Wales,Europe
1613,Gabriel Mercado,ARG,Sevilla,La Liga,2018,31.0,1987.0,19.3,35,23,21,12,2,18,36,50.0,18,24,12,12,26,61,75,1,DF,30-34,Defender,Argentina,South America
1614,Alex Meret,ITA,Napoli,Serie A,2018,21.0,1997.0,12.8,0,0,0,0,0,0,0,,0,0,0,0,0,0,3,1,GK,20-24,Goalkeeper,Italy,Europe
1615,Mehdi Merghem,FRA,Guingamp,Ligue 1,2018,21.0,1997.0,8.0,25,18,15,7,3,11,21,52.4,10,14,1,13,9,34,6,0,"FW,MF",20-24,Forward,France,Europe
1619,Dries Mertens,BEL,Napoli,Serie A,2018,31.0,1987.0,25.0,19,11,2,7,10,1,21,4.8,20,7,0,7,13,32,3,0,FW,30-34,Forward,Belgium,Europe
1621,Lionel Messi,ARG,Barcelona,La Liga,2018,31.0,1987.0,30.1,12,7,5,3,4,1,17,5.9,16,10,0,10,3,15,1,0,FW,30-34,Forward,Argentina,South America
1622,Romain Métanire,MAD,Reims,Ligue 1,2018,28.0,1990.0,3.5,12,9,10,1,1,5,7,71.4,2,4,3,1,6,18,13,0,DF,25-29,Defender,Madagascar,Africa
1623,Thomas Meunier,BEL,Paris S-G,Ligue 1,2018,26.0,1991.0,17.9,44,33,25,15,4,21,35,60.0,14,13,2,11,19,63,29,0,DF,25-29,Defender,Belgium,Europe
1624,Mexer,MOZ,Rennes,Ligue 1,2018,29.0,1988.0,27.4,23,12,18,5,0,12,18,66.7,6,26,18,8,30,53,125,0,DF,25-29,Defender,Mozambique,Africa
1625,Max Meyer,GER,Crystal Palace,Premier League,2018,22.0,1995.0,15.7,33,18,14,18,1,11,20,55.0,9,6,0,6,15,48,19,0,MF,20-24,Midfielder,Germany,Europe
1626,Matt Miazga,USA,Nantes,Ligue 1,2018,23.0,1995.0,8.0,12,11,11,1,0,7,9,77.8,2,11,7,4,12,24,41,1,DF,20-24,Defender,United States,North America
1628,Clément Michelin,FRA,Toulouse,Ligue 1,2018,21.0,1997.0,1.0,3,2,2,1,0,2,3,66.7,1,0,0,0,3,6,7,0,DF,20-24,Defender,France,Europe
1631,Florian Miguel,FRA,Nîmes,Ligue 1,2018,21.0,1996.0,12.4,19,16,13,6,0,7,11,63.6,4,15,7,8,21,40,47,0,DF,20-24,Defender,France,Europe
1638,Vincenzo Millico,ITA,Torino,Serie A,2018,17.0,2000.0,0.0,0,0,0,0,0,0,0,,0,0,0,0,0,0,0,0,MF,Under 20,Midfielder,Italy,Europe
1639,James Milner,ENG,Liverpool,Premier League,2018,32.0,1986.0,19.9,43,23,14,24,5,15,41,36.6,26,40,5,35,18,61,30,0,"MF,DF",30-34,Midfielder,England,Europe
1641,Yerry Mina,COL,Everton,Premier League,2018,23.0,1994.0,9.9,14,7,8,6,0,6,9,66.7,3,11,5,6,8,22,54,3,DF,20-24,Defender,Colombia,South America
1642,Tyrone Mings,ENG,Bournemouth,Premier League,2018,25.0,1993.0,1.6,4,3,3,1,0,2,3,66.7,1,5,2,3,6,10,8,0,DF,25-29,Defender,England,Europe
1644,Kevin Mirallas,BEL,Fiorentina,Serie A,2018,30.0,1987.0,14.4,17,7,8,4,5,6,15,40.0,9,17,0,17,4,21,10,0,"FW,MF",30-34,Forward,Belgium,Europe
1646,Miranda,BRA,Inter,Serie A,2018,33.0,1984.0,12.9,11,7,7,4,0,4,8,50.0,4,11,7,4,14,25,48,2,DF,30-34,Defender,Brazil,South America
1647,Antonio Mirante,ITA,Roma,Serie A,2018,35.0,1983.0,11.0,0,0,0,0,0,0,0,,0,0,0,0,0,0,6,1,GK,35-39,Goalkeeper,Italy,Europe
1648,Virgil Misidjan,SUR,Nürnberg,Bundesliga,2018,25.0,1993.0,17.1,21,13,10,5,6,4,25,16.0,21,17,0,17,9,30,5,0,"MF,FW",25-29,Midfielder,Suriname,South America
1649,Simone Missiroli,ITA,SPAL,Serie A,2018,32.0,1986.0,30.5,58,43,31,22,5,25,49,51.0,24,44,11,33,46,104,46,0,MF,30-34,Midfielder,Italy,Europe
1650,Kostas Mitroglou,GRE,Marseille,Ligue 1,2018,30.0,1988.0,6.4,0,0,0,0,0,0,3,0.0,3,0,0,0,0,0,5,0,FW,30-34,Forward,Greece,Europe
1653,Maximilian Mittelstädt,GER,Hertha BSC,Bundesliga,2018,21.0,1997.0,20.0,61,37,33,23,5,23,49,46.9,26,32,4,28,46,107,64,0,"DF,MF",20-24,Defender,Germany,Europe
1654,Henrikh Mkhitaryan,ARM,Arsenal,Premier League,2018,29.0,1989.0,18.2,28,22,8,17,3,6,22,27.3,16,34,2,32,16,44,13,0,"FW,MF",25-29,Forward,Armenia,Asia
1655,Luka Modrić,CRO,Real Madrid,La Liga,2018,32.0,1985.0,29.0,49,30,11,25,13,14,48,29.2,34,20,3,17,31,80,7,1,MF,30-34,Midfielder,Croatia,Europe
1656,Kevin Möhwald,GER,Werder Bremen,Bundesliga,2018,25.0,1993.0,9.7,16,10,3,11,2,3,20,15.0,17,14,0,14,17,33,14,0,MF,25-29,Midfielder,Germany,Europe
1657,Niklas Moisander,FIN,Werder Bremen,Bundesliga,2018,32.0,1985.0,29.3,34,23,26,8,0,22,51,43.1,29,42,19,23,39,73,140,2,DF,30-34,Defender,Finland,Europe
1658,Johan Mojica,COL,Girona,La Liga,2018,25.0,1992.0,0.2,1,1,1,0,0,0,0,,0,0,0,0,0,1,0,0,"FW,MF",25-29,Forward,Colombia,South America
1661,Cristian Molinaro,ITA,Frosinone,Serie A,2018,35.0,1983.0,12.9,15,10,7,7,1,3,9,33.3,6,11,4,7,15,30,43,0,"DF,MF",35-39,Defender,Italy,Europe
1663,Florent Mollet,FRA,Montpellier,Ligue 1,2018,26.0,1991.0,28.5,36,20,8,20,8,13,51,25.5,38,32,1,31,23,59,7,0,MF,25-29,Midfielder,France,Europe
1664,Gabriele Moncini,ITA,SPAL,Serie A,2018,22.0,1996.0,0.1,1,1,1,0,0,0,0,,0,0,0,0,0,1,0,0,MF,20-24,Midfielder,Italy,Europe
1665,Thomas Monconduit,FRA,Amiens,Ligue 1,2018,27.0,1991.0,31.3,76,47,38,33,5,26,63,41.3,37,46,17,29,36,112,77,1,MF,25-29,Midfielder,France,Europe
1666,Kévin Monnet-Paquet,FRA,Saint-Étienne,Ligue 1,2018,29.0,1988.0,16.5,46,25,23,16,7,20,36,55.6,16,22,4,18,14,60,28,0,"DF,MF",25-29,Defender,France,Europe
1671,Aaron Mooy,AUS,Huddersfield,Premier League,2018,27.0,1990.0,25.9,62,42,19,27,16,21,52,40.4,31,43,7,36,14,76,22,0,"MF,FW",25-29,Midfielder,Australia,Oceania
1672,Emre Mor,TUR,Celta Vigo,La Liga,2018,21.0,1997.0,4.1,7,4,1,3,3,2,7,28.6,5,5,0,5,3,10,1,0,"FW,MF",20-24,Forward,Turkey,Asia
1673,Alfredo Morales,USA,Düsseldorf,Bundesliga,2018,28.0,1990.0,17.0,32,18,16,15,1,6,24,25.0,18,18,9,9,24,56,31,0,MF,25-29,Midfielder,United States,North America
1677,Steven Moreira,CPV,Toulouse,Ligue 1,2018,23.0,1994.0,9.6,19,8,13,5,1,10,17,58.8,7,14,0,14,10,29,19,1,"DF,MF",20-24,Defender,Cape Verde,Africa
1678,Jérémy Morel,MAD,Lyon,Ligue 1,2018,34.0,1984.0,11.8,16,10,11,5,0,9,13,69.2,4,18,14,4,18,34,45,1,DF,30-34,Defender,Madagascar,Africa
1682,Héctor Moreno,MEX,Real Sociedad,La Liga,2018,30.0,1988.0,21.5,16,9,12,4,0,9,17,52.9,8,34,19,15,31,47,73,0,DF,30-34,Defender,Mexico,North America
1684,Emiliano Moretti,ITA,Torino,Serie A,2018,37.0,1981.0,22.3,30,21,21,9,0,13,20,65.0,7,14,6,8,24,54,65,1,DF,35-39,Defender,Italy,Europe
1685,Wes Morgan,JAM,Leicester City,Premier League,2018,34.0,1984.0,21.4,27,15,14,12,1,6,7,85.7,1,24,10,14,32,59,109,1,DF,30-34,Defender,Jamaica,North America
1688,Sean Morrison,ENG,Cardiff City,Premier League,2018,27.0,1991.0,33.8,35,17,29,4,2,15,28,53.6,13,47,30,17,52,87,204,5,DF,25-29,Defender,England,Europe
1689,Victor Moses,NGA,Chelsea,Premier League,2018,27.0,1990.0,0.3,0,0,0,0,0,0,0,,0,1,0,1,0,0,0,0,FW,25-29,Forward,Nigeria,Africa
1690,Lebo Mothiba,RSA,Strasbourg,Ligue 1,2018,22.0,1996.0,19.7,10,9,2,7,1,0,8,0.0,8,5,1,4,0,10,6,0,FW,20-24,Forward,South Africa,Africa
1691,Lebo Mothiba,RSA,Lille,Ligue 1,2018,22.0,1996.0,2.8,1,1,0,1,0,0,0,,0,0,0,0,0,1,8,0,FW,20-24,Forward,South Africa,Africa
1692,François Moubandje,SUI,Toulouse,Ligue 1,2018,28.0,1990.0,21.5,38,22,22,10,6,17,22,77.3,5,18,4,14,27,65,74,0,DF,25-29,Defender,Switzerland,Europe
1693,Jessy Moulin,FRA,Saint-Étienne,Ligue 1,2018,32.0,1986.0,1.0,1,0,1,0,0,1,1,100.0,0,0,0,0,0,1,2,0,GK,30-34,Goalkeeper,France,Europe
1694,Steve Mounié,BEN,Huddersfield,Premier League,2018,23.0,1994.0,19.8,9,6,3,4,2,2,12,16.7,10,10,1,9,5,14,15,0,FW,20-24,Forward,Benin,Africa
1695,Lucas Moura,BRA,Tottenham,Premier League,2018,25.0,1992.0,23.6,35,18,8,20,7,9,27,33.3,18,15,1,14,24,59,24,0,"FW,MF",25-29,Forward,Brazil,South America
1696,Herman Moussaki,FRA,Caen,Ligue 1,2018,19.0,1999.0,2.3,3,3,2,1,0,1,4,25.0,3,2,1,1,0,3,3,0,"MF,FW",Under 20,Midfielder,France,Europe
1697,Lys Mousset,FRA,Bournemouth,Premier League,2018,22.0,1996.0,4.1,3,1,1,1,1,1,4,25.0,3,3,0,3,1,4,3,0,FW,20-24,Forward,France,Europe
1698,João Moutinho,POR,Wolves,Premier League,2018,31.0,1986.0,33.7,113,58,50,56,7,44,126,34.9,82,56,11,45,40,153,50,0,MF,30-34,Midfielder,Portugal,Europe
1698,João Moutinho,POR,Wolves,Premier League,2018,31.0,1986.0,33.7,113,58,50,56,7,44,126,34.9,82,56,11,45,40,153,50,0,MF,30-34,Midfielder,Portugal,Europe
1698,João Moutinho,POR,Wolves,Premier League,2018,31.0,1986.0,33.7,113,58,50,56,7,44,126,34.9,82,56,11,45,40,153,50,0,MF,30-34,Midfielder,Portugal,Europe
1698,João Moutinho,POR,Wolves,Premier League,2018,31.0,1986.0,33.7,113,58,50,56,7,44,126,34.9,82,56,11,45,40,153,50,0,MF,30-34,Midfielder,Portugal,Europe
1699,Samuel Moutoussamy,COD,Nantes,Ligue 1,2018,21.0,1996.0,18.3,35,20,16,11,8,12,34,35.3,22,17,2,15,9,44,17,0,"MF,FW",20-24,Midfielder,DR Congo,Africa
1702,Samuel Mráz,SVK,Empoli,Serie A,2018,21.0,1997.0,1.9,0,0,0,0,0,0,0,,0,2,0,2,0,0,2,0,FW,20-24,Forward,Slovakia,Europe
1703,Ndombe Mubele,COD,Toulouse,Ligue 1,2018,24.0,1994.0,5.2,9,4,5,2,2,4,9,44.4,5,4,0,4,2,11,2,0,FW,20-24,Forward,DR Congo,Africa
1704,Lukas Mühl,GER,Nürnberg,Bundesliga,2018,21.0,1997.0,31.0,57,34,49,6,2,32,51,62.7,19,53,18,35,48,105,139,2,DF,20-24,Defender,Germany,Europe
1705,Nordi Mukiele,FRA,RB Leipzig,Bundesliga,2018,20.0,1997.0,13.6,38,21,23,12,3,19,22,86.4,3,17,3,14,24,62,35,0,DF,20-24,Defender,France,Europe
1706,Florian Müller,GER,Mainz 05,Bundesliga,2018,20.0,1997.0,24.0,1,1,1,0,0,1,2,50.0,1,0,0,0,3,4,8,5,GK,20-24,Goalkeeper,Germany,Europe
1707,Nicolai Müller,GER,Hannover 96,Bundesliga,2018,30.0,1987.0,10.0,18,9,7,7,4,8,27,29.6,19,9,1,8,1,19,7,0,"MF,FW",30-34,Midfielder,Germany,Europe
1708,Nicolai Müller,GER,Eint Frankfurt,Bundesliga,2018,30.0,1987.0,2.4,4,2,3,1,0,1,2,50.0,1,4,1,3,0,4,0,0,"FW,MF",30-34,Forward,Germany,Europe
1709,Thomas Müller,GER,Bayern Munich,Bundesliga,2018,28.0,1989.0,26.4,42,23,13,15,14,10,38,26.3,28,46,6,40,9,51,12,0,"MF,FW",25-29,Midfielder,Germany,Europe
1710,Gianni Munari,ITA,Parma,Serie A,2018,35.0,1983.0,0.0,0,0,0,0,0,0,0,,0,0,0,0,0,0,0,0,MF,35-39,Midfielder,Italy,Europe
1714,Ezequiel Muñoz,ARG,Leganés,La Liga,2018,27.0,1990.0,2.3,3,2,1,2,0,0,0,,0,3,1,2,1,4,10,0,DF,25-29,Defender,Argentina,South America
1716,Alessandro Murgia,ITA,SPAL,Serie A,2018,21.0,1996.0,11.9,22,15,9,12,1,7,32,21.9,25,14,2,12,19,41,12,1,MF,20-24,Midfielder,Italy,Europe
1717,Alessandro Murgia,ITA,Lazio,Serie A,2018,21.0,1996.0,0.1,0,0,0,0,0,0,0,,0,0,0,0,0,0,0,0,MF,20-24,Midfielder,Italy,Europe
1718,Luis Muriel,COL,Fiorentina,Serie A,2018,27.0,1991.0,16.0,19,11,4,13,2,6,18,33.3,12,10,0,10,3,22,1,0,FW,25-29,Forward,Colombia,South America
1719,Luis Muriel,COL,Sevilla,La Liga,2018,27.0,1991.0,1.4,0,0,0,0,0,0,6,0.0,6,3,0,3,0,0,1,0,"MF,FW",25-29,Midfielder,Colombia,South America
1720,Jeison Murillo,COL,Valencia,La Liga,2018,26.0,1992.0,1.0,2,1,1,1,0,1,2,50.0,1,1,0,1,2,4,6,0,DF,25-29,Defender,Colombia,South America
1721,Jeison Murillo,COL,Barcelona,La Liga,2018,26.0,1992.0,1.3,2,2,1,1,0,0,3,0.0,3,0,0,0,0,2,5,1,DF,25-29,Defender,Colombia,South America
1722,Jacob Murphy,ENG,Newcastle Utd,Premier League,2018,23.0,1995.0,3.4,6,2,4,2,0,2,4,50.0,2,5,2,3,1,7,7,0,"MF,DF",20-24,Midfielder,England,Europe
1723,Josh Murphy,ENG,Cardiff City,Premier League,2018,23.0,1995.0,20.2,26,17,15,7,4,9,29,31.0,20,30,0,30,11,37,17,0,"MF,FW",20-24,Midfielder,England,Europe
1724,Glenn Murray,ENG,Brighton,Premier League,2018,34.0,1983.0,27.9,17,7,4,7,6,4,20,20.0,16,20,3,17,2,19,17,1,FW,30-34,Forward,England,Europe
1725,Nicola Murru,ITA,Sampdoria,Serie A,2018,23.0,1994.0,32.6,83,59,42,25,16,41,54,75.9,13,50,22,28,41,124,99,0,DF,20-24,Defender,Italy,Europe
1726,Mateo Musacchio,ARG,Milan,Serie A,2018,27.0,1990.0,29.0,41,22,30,8,3,19,27,70.4,8,26,19,7,29,70,114,0,DF,25-29,Defender,Argentina,South America
1728,Juan Musso,ARG,Udinese,Serie A,2018,24.0,1994.0,29.0,0,0,0,0,0,0,1,0.0,1,0,0,0,0,0,10,4,GK,20-24,Goalkeeper,Argentina,South America
1729,Shkodran Mustafi,GER,Arsenal,Premier League,2018,26.0,1992.0,29.0,62,45,42,17,3,31,40,77.5,9,34,17,17,58,120,168,1,DF,25-29,Defender,Germany,Europe
1730,Damián Musto,ARG,Huesca,La Liga,2018,31.0,1987.0,18.7,52,34,22,27,3,16,33,48.5,17,30,11,19,34,86,54,1,"MF,DF",30-34,Midfielder,Argentina,South America
1731,Yoshinori Mutō,JPN,Newcastle Utd,Premier League,2018,26.0,1992.0,5.8,8,4,3,5,0,2,7,28.6,5,9,0,9,5,13,3,1,"FW,MF",25-29,Forward,Japan,Asia
1732,Yvon Mvogo,SUI,RB Leipzig,Bundesliga,2018,24.0,1994.0,1.5,0,0,0,0,0,0,0,,0,0,0,0,0,0,1,0,GK,20-24,Goalkeeper,Switzerland,Europe
1733,Phillipp Mwene,AUT,Mainz 05,Bundesliga,2018,24.0,1994.0,3.0,7,2,3,4,0,5,6,83.3,1,6,0,6,6,13,10,0,"DF,MF",20-24,Defender,Austria,Europe
1734,Obite N'Dicka,CIV,Eint Frankfurt,Bundesliga,2018,18.0,1999.0,25.6,43,28,31,10,2,31,52,59.6,21,29,11,18,29,72,123,0,DF,Under 20,Defender,Ivory Coast,Africa
1735,Kévin N'Doram,FRA,Monaco,Ligue 1,2018,22.0,1996.0,2.2,5,4,1,4,0,3,5,60.0,2,1,1,0,5,10,8,1,"DF,MF",20-24,Defender,France,Europe
1736,Abdallah N'dour,SEN,Strasbourg,Ligue 1,2018,24.0,1993.0,3.2,6,4,3,3,0,4,9,44.4,5,4,2,2,5,11,8,0,DF,20-24,Defender,Senegal,Africa
1737,Cheikh N'Doye,SEN,Angers,Ligue 1,2018,32.0,1986.0,25.9,25,15,14,11,0,10,32,31.3,22,33,8,25,25,50,61,0,MF,30-34,Midfielder,Senegal,Africa
1738,Nathan N'Goumou,FRA,Toulouse,Ligue 1,2018,18.0,2000.0,0.8,1,1,0,1,0,0,1,0.0,1,1,0,1,0,1,3,0,FW,Under 20,Forward,France,Europe
1739,Clinton N'Jie,CMR,Marseille,Ligue 1,2018,24.0,1993.0,4.0,7,4,2,3,2,3,3,100.0,0,2,0,2,2,9,0,0,FW,20-24,Forward,Cameroon,Africa
1740,Georges-Kévin N'Koudou,CMR,Tottenham,Premier League,2018,23.0,1995.0,0.1,0,0,0,0,0,0,0,,0,0,0,0,0,0,0,0,FW,20-24,Forward,Cameroon,Africa
1741,Georges-Kévin N'Koudou,CMR,Monaco,Ligue 1,2018,23.0,1995.0,0.3,2,1,0,0,2,1,1,100.0,0,2,0,2,0,2,0,0,FW,20-24,Forward,Cameroon,Africa
1742,Stanley N'Soki,FRA,Paris S-G,Ligue 1,2018,19.0,1999.0,7.8,20,14,8,10,2,6,13,46.2,7,10,1,9,18,38,20,1,DF,Under 20,Defender,France,Europe
1745,Ádám Nagy,HUN,Bologna,Serie A,2018,23.0,1995.0,10.8,29,21,15,13,1,11,21,52.4,10,13,5,8,25,54,12,2,MF,20-24,Midfielder,Hungary,Europe
1746,Radja Nainggolan,BEL,Inter,Serie A,2018,30.0,1988.0,21.9,35,26,7,20,8,10,24,41.7,14,17,2,15,8,43,5,0,MF,30-34,Midfielder,Belgium,Europe
1747,Naldo,BRA,Espanyol,La Liga,2018,29.0,1988.0,15.1,18,10,9,5,4,6,10,60.0,4,19,13,6,26,44,112,1,DF,25-29,Defender,Brazil,South America
1747,Naldo,BRA,Espanyol,La Liga,2018,29.0,1988.0,15.1,18,10,9,5,4,6,10,60.0,4,19,13,6,26,44,112,1,DF,25-29,Defender,Brazil,South America
1747,Naldo,BRA,Espanyol,La Liga,2018,29.0,1988.0,15.1,18,10,9,5,4,6,10,60.0,4,19,13,6,26,44,112,1,DF,25-29,Defender,Brazil,South America
1747,Naldo,BRA,Espanyol,La Liga,2018,29.0,1988.0,15.1,18,10,9,5,4,6,10,60.0,4,19,13,6,26,44,112,1,DF,25-29,Defender,Brazil,South America
1748,Naldo,BRA,Monaco,Ligue 1,2018,35.0,1982.0,3.3,5,3,4,1,0,2,4,50.0,2,5,2,3,5,10,23,0,DF,35-39,Defender,Brazil,South America
1748,Naldo,BRA,Monaco,Ligue 1,2018,35.0,1982.0,3.3,5,3,4,1,0,2,4,50.0,2,5,2,3,5,10,23,0,DF,35-39,Defender,Brazil,South America
1748,Naldo,BRA,Monaco,Ligue 1,2018,35.0,1982.0,3.3,5,3,4,1,0,2,4,50.0,2,5,2,3,5,10,23,0,DF,35-39,Defender,Brazil,South America
1748,Naldo,BRA,Monaco,Ligue 1,2018,35.0,1982.0,3.3,5,3,4,1,0,2,4,50.0,2,5,2,3,5,10,23,0,DF,35-39,Defender,Brazil,South America
1749,Naldo,BRA,Schalke 04,Bundesliga,2018,35.0,1982.0,7.0,10,7,8,2,0,5,8,62.5,3,8,3,5,14,24,25,0,DF,35-39,Defender,Brazil,South America
1749,Naldo,BRA,Schalke 04,Bundesliga,2018,35.0,1982.0,7.0,10,7,8,2,0,5,8,62.5,3,8,3,5,14,24,25,0,DF,35-39,Defender,Brazil,South America
1749,Naldo,BRA,Schalke 04,Bundesliga,2018,35.0,1982.0,7.0,10,7,8,2,0,5,8,62.5,3,8,3,5,14,24,25,0,DF,35-39,Defender,Brazil,South America
1749,Naldo,BRA,Schalke 04,Bundesliga,2018,35.0,1982.0,7.0,10,7,8,2,0,5,8,62.5,3,8,3,5,14,24,25,0,DF,35-39,Defender,Brazil,South America
1750,Samir Nasri,FRA,West Ham,Premier League,2018,31.0,1987.0,2.7,0,0,0,0,0,0,0,,0,1,0,1,1,1,1,0,MF,30-34,Midfielder,France,Europe
1755,Keylor Navas,CRC,Real Madrid,La Liga,2018,31.0,1986.0,10.0,0,0,0,0,0,0,0,,0,0,0,0,1,1,5,0,GK,30-34,Goalkeeper,Costa Rica,North America
1757,Wilfred Ndidi,NGA,Leicester City,Premier League,2018,21.0,1996.0,36.6,142,98,66,67,9,46,95,48.4,49,64,9,55,83,225,85,2,MF,20-24,Midfielder,Nigeria,Africa
1758,Aly Ndom,FRA,Caen,Ligue 1,2018,22.0,1996.0,0.5,0,0,0,0,0,0,0,,0,0,0,0,1,1,1,0,MF,20-24,Midfielder,France,Europe
1759,Aly Ndom,FRA,Reims,Ligue 1,2018,22.0,1996.0,4.0,11,9,5,5,1,3,7,42.9,4,6,2,4,3,14,9,1,MF,20-24,Midfielder,France,Europe
1760,Tanguy Ndombele,FRA,Lyon,Ligue 1,2018,21.0,1996.0,29.9,66,43,21,35,10,22,54,40.7,32,29,9,20,30,96,13,3,MF,20-24,Midfielder,France,Europe
1761,Angelo Ndrecka,ALB,Chievo,Serie A,2018,16.0,2001.0,1.0,1,1,1,0,0,1,2,50.0,1,3,2,1,0,1,1,0,DF,Under 20,Defender,Albania,Europe
1762,Reiss Nelson,ENG,Hoffenheim,Bundesliga,2018,18.0,1999.0,7.1,17,10,8,4,5,2,13,15.4,11,12,1,11,5,22,2,0,"MF,FW",Under 20,Midfielder,England,Europe
1763,Neto,BRA,Valencia,La Liga,2018,29.0,1989.0,34.0,2,0,2,0,0,2,3,66.7,1,0,0,0,1,3,9,3,GK,25-29,Goalkeeper,Brazil,South America
1763,Neto,BRA,Valencia,La Liga,2018,29.0,1989.0,34.0,2,0,2,0,0,2,3,66.7,1,0,0,0,1,3,9,3,GK,25-29,Goalkeeper,Brazil,South America
1763,Neto,BRA,Valencia,La Liga,2018,29.0,1989.0,34.0,2,0,2,0,0,2,3,66.7,1,0,0,0,1,3,9,3,GK,25-29,Goalkeeper,Brazil,South America
1763,Neto,BRA,Valencia,La Liga,2018,29.0,1989.0,34.0,2,0,2,0,0,2,3,66.7,1,0,0,0,1,3,9,3,GK,25-29,Goalkeeper,Brazil,South America
1763,Neto,BRA,Valencia,La Liga,2018,29.0,1989.0,34.0,2,0,2,0,0,2,3,66.7,1,0,0,0,1,3,9,3,GK,25-29,Goalkeeper,Brazil,South America
1763,Neto,BRA,Valencia,La Liga,2018,29.0,1989.0,34.0,2,0,2,0,0,2,3,66.7,1,0,0,0,1,3,9,3,GK,25-29,Goalkeeper,Brazil,South America
1763,Neto,BRA,Valencia,La Liga,2018,29.0,1989.0,34.0,2,0,2,0,0,2,3,66.7,1,0,0,0,1,3,9,3,GK,25-29,Goalkeeper,Brazil,South America
1763,Neto,BRA,Valencia,La Liga,2018,29.0,1989.0,34.0,2,0,2,0,0,2,3,66.7,1,0,0,0,1,3,9,3,GK,25-29,Goalkeeper,Brazil,South America
1763,Neto,BRA,Valencia,La Liga,2018,29.0,1989.0,34.0,2,0,2,0,0,2,3,66.7,1,0,0,0,1,3,9,3,GK,25-29,Goalkeeper,Brazil,South America
1764,Pedro Neto,POR,Lazio,Serie A,2018,18.0,2000.0,0.5,0,0,0,0,0,0,0,,0,1,0,1,0,0,0,0,"FW,DF",Under 20,Forward,Portugal,Europe
1765,Manuel Neuer,GER,Bayern Munich,Bundesliga,2018,32.0,1986.0,25.6,1,1,1,0,0,0,1,0.0,1,1,0,1,0,1,8,3,GK,30-34,Goalkeeper,Germany,Europe
1766,Florian Neuhaus,GER,Gladbach,Bundesliga,2018,21.0,1997.0,22.9,22,15,9,9,4,10,36,27.8,26,20,1,19,10,32,23,0,MF,20-24,Midfielder,Germany,Europe
1767,Rúben Neves,POR,Wolves,Premier League,2018,21.0,1997.0,33.4,75,32,33,36,6,27,83,32.5,56,57,18,39,73,148,46,3,MF,20-24,Midfielder,Portugal,Europe
1768,Neymar,BRA,Paris S-G,Ligue 1,2018,26.0,1992.0,16.0,14,9,3,10,1,4,21,19.0,17,8,0,8,5,19,1,1,"MF,FW",25-29,Midfielder,Brazil,South America
1769,Yeni Ngbakoto,COD,Guingamp,Ligue 1,2018,26.0,1992.0,6.3,9,4,4,3,2,4,8,50.0,4,7,0,7,4,13,2,0,"MF,FW",25-29,Midfielder,DR Congo,Africa
1770,Moussa Niakhate,SEN,Mainz 05,Bundesliga,2018,22.0,1996.0,31.0,49,30,35,12,2,20,33,60.6,13,42,24,18,44,93,143,1,DF,20-24,Defender,Senegal,Africa
1771,M'Baye Niang,SEN,Rennes,Ligue 1,2018,23.0,1994.0,19.9,16,10,3,8,5,2,11,18.2,9,19,3,16,8,24,14,0,"FW,MF",20-24,Forward,Senegal,Africa
1772,Oumar Niasse,SEN,Cardiff City,Premier League,2018,28.0,1990.0,10.3,12,3,1,5,6,4,8,50.0,4,7,0,7,2,14,7,0,FW,25-29,Forward,Senegal,Africa
1773,Oumar Niasse,SEN,Everton,Premier League,2018,28.0,1990.0,0.7,0,0,0,0,0,0,1,0.0,1,0,0,0,0,0,0,0,FW,25-29,Forward,Senegal,Africa
1774,Hans Nicolussi Caviglia,ITA,Juventus,Serie A,2018,18.0,2000.0,0.6,2,1,0,2,0,0,2,0.0,2,2,1,1,0,2,0,0,MF,Under 20,Midfielder,Italy,Europe
1775,Florian Niederlechner,GER,Freiburg,Bundesliga,2018,27.0,1990.0,10.8,7,5,1,4,2,0,5,0.0,5,12,4,8,6,13,10,0,"FW,MF",25-29,Forward,Germany,Europe
1777,Dimitris Nikolaou,GRE,Empoli,Serie A,2018,19.0,1998.0,3.9,5,3,3,2,0,1,2,50.0,1,2,2,0,2,7,14,0,DF,Under 20,Defender,Greece,Europe
1778,Casimir Ninga,CHA,Caen,Ligue 1,2018,25.0,1993.0,27.4,53,30,23,21,9,20,49,40.8,29,22,1,21,22,75,12,0,"FW,MF",25-29,Forward,Chad,Africa
1779,Eddie Nketiah,ENG,Arsenal,Premier League,2018,19.0,1999.0,0.7,1,1,0,1,0,0,0,,0,0,0,0,0,1,1,0,"MF,FW",Under 20,Midfielder,England,Europe
1780,Nicolas Nkoulou,CMR,Torino,Serie A,2018,28.0,1990.0,35.7,45,29,34,10,1,15,25,60.0,10,42,28,14,70,115,174,2,DF,25-29,Defender,Cameroon,Africa
1781,Christopher Nkunku,FRA,Paris S-G,Ligue 1,2018,20.0,1997.0,12.8,21,16,8,10,3,7,16,43.8,9,12,2,10,9,30,7,1,"MF,FW",20-24,Midfielder,France,Europe
1782,Mark Noble,ENG,West Ham,Premier League,2018,31.0,1987.0,25.5,47,26,19,24,4,17,52,32.7,35,17,2,15,21,68,13,0,MF,30-34,Midfielder,England,Europe
1785,Arnaud Nordin,FRA,Saint-Étienne,Ligue 1,2018,20.0,1998.0,11.7,14,12,4,4,6,4,11,36.4,7,13,2,11,5,19,9,0,"FW,MF",20-24,Forward,France,Europe
1788,Will Norris,ENG,Wolves,Premier League,2018,24.0,1993.0,0.0,0,0,0,0,0,0,0,,0,0,0,0,0,0,0,0,GK,20-24,Goalkeeper,England,Europe
1789,Alexander Nübel,GER,Schalke 04,Bundesliga,2018,21.0,1996.0,17.6,0,0,0,0,0,0,1,0.0,1,0,0,0,1,1,4,1,GK,20-24,Goalkeeper,Germany,Europe
1790,Kasim Nuhu,GHA,Hoffenheim,Bundesliga,2018,23.0,1995.0,10.0,19,11,14,3,2,10,23,43.5,13,11,5,6,23,42,44,0,DF,20-24,Defender,Ghana,Africa
1792,Hans Nunoo Sarpei,GHA,Stuttgart,Bundesliga,2018,19.0,1998.0,0.5,1,1,0,1,0,0,0,,0,0,0,0,0,1,0,0,"FW,MF",Under 20,Forward,Ghana,Africa
1793,Bram Nuytinck,NED,Udinese,Serie A,2018,28.0,1990.0,23.6,50,35,34,13,3,25,33,75.8,8,44,27,17,29,79,126,0,DF,25-29,Defender,Netherlands,Europe
1794,Gerzino Nyamsi,FRA,Rennes,Ligue 1,2018,21.0,1997.0,6.0,6,3,5,1,0,4,9,44.4,5,8,4,4,4,10,17,0,DF,20-24,Defender,France,Europe
1795,Allan Nyom,CMR,Leganés,La Liga,2018,30.0,1988.0,19.0,32,24,20,10,2,12,17,70.6,5,7,2,5,20,52,35,0,"DF,FW",30-34,Defender,Cameroon,Africa
1796,Steven Nzonzi,FRA,Roma,Serie A,2018,29.0,1988.0,29.1,66,45,24,36,6,21,34,61.8,13,40,24,16,27,93,55,2,MF,25-29,Midfielder,France,Europe
1797,Christian Nørgaard,DEN,Fiorentina,Serie A,2018,24.0,1994.0,3.6,4,2,1,2,1,2,5,40.0,3,2,0,2,10,14,16,0,MF,20-24,Midfielder,Denmark,Europe
1798,Michael Obafemi,IRL,Southampton,Premier League,2018,18.0,2000.0,1.5,1,1,0,0,1,0,0,,0,1,1,0,1,2,0,0,FW,Under 20,Forward,Republic of Ireland,Europe
1799,Dimitri Oberlin,SUI,Empoli,Serie A,2018,20.0,1997.0,1.5,1,1,0,0,1,0,3,0.0,3,1,0,1,0,1,1,0,FW,20-24,Forward,Switzerland,Europe
1800,Joel Obi,NGA,Chievo,Serie A,2018,27.0,1991.0,7.3,22,15,9,11,2,7,17,41.2,10,12,1,11,14,36,15,0,MF,25-29,Midfielder,Nigeria,Africa
1801,Pedro Obiang,EQG,West Ham,Premier League,2018,26.0,1992.0,12.5,41,23,23,16,2,18,43,41.9,25,27,9,18,12,53,18,0,MF,25-29,Midfielder,Equatorial Guinea,Africa
1803,Lucas Ocampos,ARG,Marseille,Ligue 1,2018,24.0,1994.0,30.1,80,54,37,33,10,34,80,42.5,46,40,5,35,29,109,30,0,"FW,MF",20-24,Forward,Argentina,South America
1804,Bastian Oczipka,GER,Schalke 04,Bundesliga,2018,29.0,1989.0,20.8,41,27,20,19,2,21,26,80.8,5,23,5,18,24,65,24,2,"DF,FW",25-29,Defender,Germany,Europe
1805,Jens Odgaard,DEN,Sassuolo,Serie A,2018,19.0,1999.0,0.2,0,0,0,0,0,0,0,,0,1,0,1,0,0,1,0,FW,Under 20,Forward,Denmark,Europe
1806,Denis Odoi,GHA,Fulham,Premier League,2018,30.0,1988.0,28.8,48,34,29,16,3,21,33,63.6,12,45,24,21,42,90,153,0,DF,30-34,Defender,Ghana,Africa
1808,Angelo Ogbonna,ITA,West Ham,Premier League,2018,30.0,1988.0,20.8,31,13,23,6,2,14,23,60.9,9,29,19,10,35,66,101,0,DF,30-34,Defender,Italy,Europe
1810,Sheyi Ojo,ENG,Reims,Ligue 1,2018,21.0,1997.0,5.2,8,6,2,4,2,2,8,25.0,6,1,0,1,3,11,2,0,"FW,MF",20-24,Forward,England,Europe
1811,Stefano Okaka,ITA,Watford,Premier League,2018,28.0,1989.0,0.3,0,0,0,0,0,0,0,,0,1,0,1,0,0,0,0,"FW,MF",25-29,Forward,Italy,Europe
1812,Stefano Okaka,ITA,Udinese,Serie A,2018,28.0,1989.0,10.8,13,7,4,5,4,2,8,25.0,6,6,1,5,0,13,16,1,FW,25-29,Forward,Italy,Europe
1813,Shinji Okazaki,JPN,Leicester City,Premier League,2018,32.0,1986.0,3.2,5,5,2,3,0,0,1,0.0,1,7,1,6,2,7,1,0,"MF,FW",30-34,Midfielder,Japan,Asia
1814,Chima Okoroji,NGA,Freiburg,Bundesliga,2018,21.0,1997.0,1.2,3,0,1,1,1,1,1,100.0,0,0,0,0,1,4,1,0,"DF,MF",20-24,Defender,Nigeria,Africa
1815,Orji Okwonkwo,NGA,Bologna,Serie A,2018,20.0,1998.0,2.9,4,3,1,2,1,2,2,100.0,0,0,0,0,1,5,0,0,FW,20-24,Forward,Nigeria,Africa
1816,Lucas Olaza,URU,Celta Vigo,La Liga,2018,24.0,1994.0,10.0,29,18,19,8,2,14,18,77.8,4,13,6,7,8,37,18,0,DF,20-24,Defender,Uruguay,South America
1819,Paulo Oliveira,POR,Eibar,La Liga,2018,26.0,1992.0,24.9,49,39,33,16,0,28,44,63.6,16,25,10,15,36,85,116,0,DF,25-29,Defender,Portugal,Europe
1820,Mathías Olivera,URU,Getafe,La Liga,2018,20.0,1997.0,11.2,24,17,11,8,5,10,18,55.6,8,25,2,23,10,34,22,0,"DF,MF",20-24,Defender,Uruguay,South America
1821,Alexandre Olliero,FRA,Nantes,Ligue 1,2018,22.0,1996.0,1.0,0,0,0,0,0,0,0,,0,0,0,0,0,0,0,0,GK,20-24,Goalkeeper,France,Europe
1822,Robin Olsen,SWE,Roma,Serie A,2018,28.0,1990.0,27.0,0,0,0,0,0,0,1,0.0,1,1,0,1,0,0,10,4,GK,25-29,Goalkeeper,Sweden,Europe
1823,Stephane Omeonga,BEL,Genoa,Serie A,2018,22.0,1996.0,0.6,1,1,1,0,0,0,1,0.0,1,1,0,1,0,1,2,0,MF,20-24,Midfielder,Belgium,Europe
1824,Kenneth Omeruo,NGA,Leganés,La Liga,2018,24.0,1993.0,27.0,49,27,41,8,0,20,29,69.0,9,23,11,12,37,86,159,3,DF,20-24,Defender,Nigeria,Africa
1825,Prince Oniangué,CGO,Caen,Ligue 1,2018,29.0,1988.0,26.0,59,33,22,34,3,24,57,42.1,33,30,10,20,29,88,42,0,MF,25-29,Midfielder,Congo,Africa
1826,Karim Onisiwo,AUT,Mainz 05,Bundesliga,2018,26.0,1992.0,12.9,23,15,6,12,5,4,12,33.3,8,14,3,11,9,32,13,0,"FW,MF",25-29,Forward,Austria,Europe
1827,Nicholas Opoku,GHA,Udinese,Serie A,2018,20.0,1997.0,10.1,16,9,15,1,0,10,17,58.8,7,8,5,3,18,34,29,0,DF,20-24,Defender,Ghana,Africa
1828,Willi Orban,HUN,RB Leipzig,Bundesliga,2018,25.0,1992.0,22.8,49,26,31,15,3,24,38,63.2,14,33,15,18,36,85,140,0,DF,25-29,Defender,Hungary,Europe
1829,Fabián Orellana,CHI,Eibar,La Liga,2018,32.0,1986.0,30.4,44,21,14,16,14,9,42,21.4,33,17,0,17,19,63,4,0,"MF,FW",30-34,Midfielder,Chile,South America
1830,Divock Origi,BEL,Liverpool,Premier League,2018,23.0,1995.0,4.1,6,1,2,3,1,1,4,25.0,3,2,0,2,0,6,2,0,FW,20-24,Forward,Belgium,Europe
1831,Riccardo Orsolini,ITA,Bologna,Serie A,2018,21.0,1997.0,21.8,40,24,16,18,6,9,39,23.1,30,23,2,21,14,54,25,1,"FW,MF",20-24,Forward,Italy,Europe
1832,Yuya Osako,JPN,Werder Bremen,Bundesliga,2018,28.0,1990.0,15.0,23,11,6,12,5,7,22,31.8,15,15,3,12,7,30,8,0,"FW,MF",25-29,Forward,Japan,Asia
1833,David Ospina,COL,Napoli,Serie A,2018,29.0,1988.0,16.2,1,0,1,0,0,1,1,100.0,0,0,0,0,0,1,7,1,GK,25-29,Goalkeeper,Colombia,South America
1834,Matthias Ostrzolek,GER,Hannover 96,Bundesliga,2018,28.0,1990.0,16.3,32,18,24,8,0,20,33,60.6,13,20,5,15,26,58,44,2,DF,25-29,Defender,Germany,Europe
1835,Nicolás Otamendi,ARG,Manchester City,Premier League,2018,30.0,1988.0,13.7,24,14,17,6,1,5,9,55.6,4,6,4,2,29,53,56,1,DF,30-34,Defender,Argentina,South America
1836,Otávio,BRA,Bordeaux,Ligue 1,2018,24.0,1994.0,31.9,127,74,59,64,4,49,109,45.0,60,45,11,34,43,170,54,1,MF,20-24,Midfielder,Brazil,South America
1836,Otávio,BRA,Bordeaux,Ligue 1,2018,24.0,1994.0,31.9,127,74,59,64,4,49,109,45.0,60,45,11,34,43,170,54,1,MF,20-24,Midfielder,Brazil,South America
1836,Otávio,BRA,Bordeaux,Ligue 1,2018,24.0,1994.0,31.9,127,74,59,64,4,49,109,45.0,60,45,11,34,43,170,54,1,MF,20-24,Midfielder,Brazil,South America
1836,Otávio,BRA,Bordeaux,Ligue 1,2018,24.0,1994.0,31.9,127,74,59,64,4,49,109,45.0,60,45,11,34,43,170,54,1,MF,20-24,Midfielder,Brazil,South America
1836,Otávio,BRA,Bordeaux,Ligue 1,2018,24.0,1994.0,31.9,127,74,59,64,4,49,109,45.0,60,45,11,34,43,170,54,1,MF,20-24,Midfielder,Brazil,South America
1836,Otávio,BRA,Bordeaux,Ligue 1,2018,24.0,1994.0,31.9,127,74,59,64,4,49,109,45.0,60,45,11,34,43,170,54,1,MF,20-24,Midfielder,Brazil,South America
1836,Otávio,BRA,Bordeaux,Ligue 1,2018,24.0,1994.0,31.9,127,74,59,64,4,49,109,45.0,60,45,11,34,43,170,54,1,MF,20-24,Midfielder,Brazil,South America
1836,Otávio,BRA,Bordeaux,Ligue 1,2018,24.0,1994.0,31.9,127,74,59,64,4,49,109,45.0,60,45,11,34,43,170,54,1,MF,20-24,Midfielder,Brazil,South America
1836,Otávio,BRA,Bordeaux,Ligue 1,2018,24.0,1994.0,31.9,127,74,59,64,4,49,109,45.0,60,45,11,34,43,170,54,1,MF,20-24,Midfielder,Brazil,South America
1837,David Otto,GER,Hoffenheim,Bundesliga,2018,19.0,1999.0,0.3,2,1,1,1,0,0,1,0.0,1,0,0,0,0,2,0,0,"MF,FW",Under 20,Midfielder,Germany,Europe
1838,Remi Oudin,FRA,Reims,Ligue 1,2018,21.0,1996.0,29.0,51,32,25,18,8,20,45,44.4,25,29,5,24,42,93,34,0,"FW,MF",20-24,Forward,France,Europe
1839,Adam Ounas,ALG,Napoli,Serie A,2018,21.0,1996.0,6.0,5,2,0,3,2,2,11,18.2,9,6,0,6,2,7,0,1,"MF,FW",20-24,Midfielder,Algeria,Africa
1840,Reece Oxford,ENG,Augsburg,Bundesliga,2018,19.0,1998.0,5.6,12,9,9,3,0,4,6,66.7,2,10,9,1,11,23,39,0,DF,Under 20,Defender,England,Europe
1841,Alex Oxlade-Chamberlain,ENG,Liverpool,Premier League,2018,24.0,1993.0,0.2,1,1,0,1,0,1,1,100.0,0,0,0,0,1,2,0,0,MF,20-24,Midfielder,England,Europe
1843,Ambroise Oyongo,CMR,Montpellier,Ligue 1,2018,27.0,1991.0,23.7,44,21,23,16,5,20,38,52.6,18,26,6,20,38,82,60,0,DF,25-29,Defender,Cameroon,Africa
1844,Berkay Özcan,TUR,Stuttgart,Bundesliga,2018,20.0,1998.0,0.6,0,0,0,0,0,0,0,,0,1,0,1,0,0,0,0,"MF,DF",20-24,Midfielder,Turkey,Asia
1845,Ramazan Özcan,AUT,Leverkusen,Bundesliga,2018,34.0,1984.0,2.0,0,0,0,0,0,0,0,,0,0,0,0,1,1,2,0,GK,30-34,Goalkeeper,Austria,Europe
1846,Mesut Özil,GER,Arsenal,Premier League,2018,29.0,1988.0,19.3,12,5,6,3,3,3,21,14.3,18,10,2,8,4,16,5,0,"MF,FW",25-29,Midfielder,Germany,Europe
1847,Levin Öztunalı,GER,Mainz 05,Bundesliga,2018,22.0,1996.0,10.2,17,7,5,9,3,4,18,22.2,14,14,2,12,7,24,10,0,"MF,FW",20-24,Midfielder,Germany,Europe
1848,Pablo,BRA,Bordeaux,Ligue 1,2018,27.0,1991.0,21.5,26,15,22,3,1,13,23,56.5,10,28,22,6,32,58,173,2,DF,25-29,Defender,Brazil,South America
1848,Pablo,BRA,Bordeaux,Ligue 1,2018,27.0,1991.0,21.5,26,15,22,3,1,13,23,56.5,10,28,22,6,32,58,173,2,DF,25-29,Defender,Brazil,South America
1848,Pablo,BRA,Bordeaux,Ligue 1,2018,27.0,1991.0,21.5,26,15,22,3,1,13,23,56.5,10,28,22,6,32,58,173,2,DF,25-29,Defender,Brazil,South America
1848,Pablo,BRA,Bordeaux,Ligue 1,2018,27.0,1991.0,21.5,26,15,22,3,1,13,23,56.5,10,28,22,6,32,58,173,2,DF,25-29,Defender,Brazil,South America
1848,Pablo,BRA,Bordeaux,Ligue 1,2018,27.0,1991.0,21.5,26,15,22,3,1,13,23,56.5,10,28,22,6,32,58,173,2,DF,25-29,Defender,Brazil,South America
1848,Pablo,BRA,Bordeaux,Ligue 1,2018,27.0,1991.0,21.5,26,15,22,3,1,13,23,56.5,10,28,22,6,32,58,173,2,DF,25-29,Defender,Brazil,South America
1848,Pablo,BRA,Bordeaux,Ligue 1,2018,27.0,1991.0,21.5,26,15,22,3,1,13,23,56.5,10,28,22,6,32,58,173,2,DF,25-29,Defender,Brazil,South America
1848,Pablo,BRA,Bordeaux,Ligue 1,2018,27.0,1991.0,21.5,26,15,22,3,1,13,23,56.5,10,28,22,6,32,58,173,2,DF,25-29,Defender,Brazil,South America
1848,Pablo,BRA,Bordeaux,Ligue 1,2018,27.0,1991.0,21.5,26,15,22,3,1,13,23,56.5,10,28,22,6,32,58,173,2,DF,25-29,Defender,Brazil,South America
1850,Gonçalo Paciência,POR,Eint Frankfurt,Bundesliga,2018,23.0,1994.0,4.3,3,2,0,2,1,1,2,50.0,1,8,1,7,0,3,1,0,FW,20-24,Forward,Portugal,Europe
1851,Simone Padoin,ITA,Cagliari,Serie A,2018,34.0,1984.0,21.3,34,25,12,18,4,14,33,42.4,19,18,5,13,14,48,54,0,"DF,MF",30-34,Defender,Italy,Europe
1852,Luca Paganini,ITA,Frosinone,Serie A,2018,25.0,1993.0,12.5,25,13,8,13,4,8,23,34.8,15,19,4,15,19,44,17,1,"DF,MF",25-29,Defender,Italy,Europe
1853,Marko Pajač,CRO,Empoli,Serie A,2018,25.0,1993.0,8.2,7,7,2,3,2,5,11,45.5,6,3,0,3,7,14,18,0,"FW,DF",25-29,Forward,Croatia,Europe
1854,Marko Pajač,CRO,Cagliari,Serie A,2018,25.0,1993.0,1.1,1,1,0,0,1,0,0,,0,1,1,0,1,2,3,0,DF,25-29,Defender,Croatia,Europe
1855,Vincent Pajot,FRA,Angers,Ligue 1,2018,27.0,1990.0,7.9,18,14,6,8,4,4,14,28.6,10,9,0,9,8,26,6,0,MF,25-29,Midfielder,France,Europe
1856,Rodrigo Palacio,ARG,Bologna,Serie A,2018,36.0,1982.0,25.9,24,13,8,12,4,4,34,11.8,30,35,0,35,5,29,13,0,FW,35-39,Forward,Argentina,South America
1857,Federico Palacios Martínez,GER,Nürnberg,Bundesliga,2018,23.0,1995.0,10.5,21,10,11,8,2,10,20,50.0,10,10,0,10,9,30,4,0,"MF,FW",20-24,Midfielder,Germany,Europe
1859,Nicolas Pallois,FRA,Nantes,Ligue 1,2018,30.0,1987.0,24.0,77,48,60,17,0,40,69,58.0,29,30,14,16,34,111,114,0,DF,30-34,Defender,France,Europe
1860,Emerson Palmieri,ITA,Chelsea,Premier League,2018,23.0,1994.0,7.4,14,9,6,5,3,6,10,60.0,4,11,1,10,8,22,14,0,DF,20-24,Defender,Italy,Europe
1861,Alberto Paloschi,ITA,SPAL,Serie A,2018,28.0,1990.0,9.6,13,9,3,5,5,1,2,50.0,1,2,0,2,1,14,0,0,FW,25-29,Forward,Italy,Europe
1862,Goran Pandev,MKD,Genoa,Serie A,2018,35.0,1983.0,12.5,14,10,0,10,4,2,8,25.0,6,7,0,7,1,15,3,0,"FW,MF",35-39,Forward,North Macedonia,Europe
1863,Mickaël Panos,FRA,Saint-Étienne,Ligue 1,2018,21.0,1997.0,0.3,1,0,0,1,0,1,2,50.0,1,2,0,2,1,2,0,0,DF,20-24,Defender,France,Europe
1864,Sokratis Papastathopoulos,GRE,Arsenal,Premier League,2018,30.0,1988.0,24.4,42,25,30,11,1,15,28,53.6,13,34,17,17,26,68,112,1,DF,30-34,Defender,Greece,Europe
1865,Elhadji Pape Diaw,SEN,Angers,Ligue 1,2018,23.0,1994.0,0.2,0,0,0,0,0,0,0,,0,0,0,0,1,1,0,0,DF,20-24,Defender,Senegal,Africa
1866,Lucas Paquetá,BRA,Milan,Serie A,2018,20.0,1997.0,9.4,18,9,9,8,1,7,24,29.2,17,12,0,12,4,22,11,2,MF,20-24,Midfielder,Brazil,South America
1867,Gaëtan Paquiez,FRA,Nîmes,Ligue 1,2018,24.0,1994.0,14.8,43,29,30,10,3,23,48,47.9,25,24,6,18,22,65,50,0,DF,20-24,Defender,France,Europe
1869,Leandro Paredes,ARG,Paris S-G,Ligue 1,2018,24.0,1994.0,13.9,34,19,16,15,3,13,30,43.3,17,17,5,12,14,48,20,2,MF,20-24,Midfielder,Argentina,South America
1871,Vittorio Parigini,ITA,Torino,Serie A,2018,22.0,1996.0,4.2,11,10,3,6,2,6,9,66.7,3,3,0,3,1,12,5,0,"MF,DF",20-24,Midfielder,Italy,Europe
1872,Marco Parolo,ITA,Lazio,Serie A,2018,33.0,1985.0,28.5,68,45,24,37,7,18,56,32.1,38,48,11,37,28,96,56,0,MF,30-34,Midfielder,Italy,Europe
1873,Thomas Partey,GHA,Atlético Madrid,La Liga,2018,25.0,1993.0,23.0,66,42,32,25,9,21,49,42.9,28,26,5,21,49,115,22,2,MF,25-29,Midfielder,Ghana,Africa
1874,Mario Pašalić,CRO,Atalanta,Serie A,2018,23.0,1995.0,18.0,32,19,9,13,10,7,29,24.1,22,19,4,15,12,44,14,1,MF,20-24,Midfielder,Croatia,Europe
1875,Manuel Pasqual,ITA,Empoli,Serie A,2018,36.0,1982.0,14.9,26,19,12,11,3,17,45,37.8,28,7,0,7,11,37,31,0,DF,35-39,Defender,Italy,Europe
1876,Javier Pastore,ARG,Roma,Serie A,2018,29.0,1989.0,6.6,10,4,4,3,3,4,16,25.0,12,7,0,7,3,13,5,0,"MF,FW",25-29,Midfielder,Argentina,South America
1877,Callum Paterson,SCO,Cardiff City,Premier League,2018,23.0,1994.0,22.2,21,14,7,7,7,5,26,19.2,21,23,2,21,8,29,29,0,"FW,MF",20-24,Forward,Scotland,Europe
1879,Rui Patrício,POR,Wolves,Premier League,2018,30.0,1988.0,37.0,2,0,2,0,0,2,3,66.7,1,0,0,0,1,3,7,4,GK,30-34,Goalkeeper,Portugal,Europe
1880,Paulinho,BRA,Leverkusen,Bundesliga,2018,18.0,2000.0,2.0,4,4,2,2,0,1,2,50.0,1,3,0,3,2,6,0,1,"FW,MF",Under 20,Forward,Brazil,South America
1880,Paulinho,BRA,Leverkusen,Bundesliga,2018,18.0,2000.0,2.0,4,4,2,2,0,1,2,50.0,1,3,0,3,2,6,0,1,"FW,MF",Under 20,Forward,Brazil,South America
1880,Paulinho,BRA,Leverkusen,Bundesliga,2018,18.0,2000.0,2.0,4,4,2,2,0,1,2,50.0,1,3,0,3,2,6,0,1,"FW,MF",Under 20,Forward,Brazil,South America
1880,Paulinho,BRA,Leverkusen,Bundesliga,2018,18.0,2000.0,2.0,4,4,2,2,0,1,2,50.0,1,3,0,3,2,6,0,1,"FW,MF",Under 20,Forward,Brazil,South America
1880,Paulinho,BRA,Leverkusen,Bundesliga,2018,18.0,2000.0,2.0,4,4,2,2,0,1,2,50.0,1,3,0,3,2,6,0,1,"FW,MF",Under 20,Forward,Brazil,South America
1880,Paulinho,BRA,Leverkusen,Bundesliga,2018,18.0,2000.0,2.0,4,4,2,2,0,1,2,50.0,1,3,0,3,2,6,0,1,"FW,MF",Under 20,Forward,Brazil,South America
1880,Paulinho,BRA,Leverkusen,Bundesliga,2018,18.0,2000.0,2.0,4,4,2,2,0,1,2,50.0,1,3,0,3,2,6,0,1,"FW,MF",Under 20,Forward,Brazil,South America
1880,Paulinho,BRA,Leverkusen,Bundesliga,2018,18.0,2000.0,2.0,4,4,2,2,0,1,2,50.0,1,3,0,3,2,6,0,1,"FW,MF",Under 20,Forward,Brazil,South America
1880,Paulinho,BRA,Leverkusen,Bundesliga,2018,18.0,2000.0,2.0,4,4,2,2,0,1,2,50.0,1,3,0,3,2,6,0,1,"FW,MF",Under 20,Forward,Brazil,South America
1880,Paulinho,BRA,Leverkusen,Bundesliga,2018,18.0,2000.0,2.0,4,4,2,2,0,1,2,50.0,1,3,0,3,2,6,0,1,"FW,MF",Under 20,Forward,Brazil,South America
1880,Paulinho,BRA,Leverkusen,Bundesliga,2018,18.0,2000.0,2.0,4,4,2,2,0,1,2,50.0,1,3,0,3,2,6,0,1,"FW,MF",Under 20,Forward,Brazil,South America
1880,Paulinho,BRA,Leverkusen,Bundesliga,2018,18.0,2000.0,2.0,4,4,2,2,0,1,2,50.0,1,3,0,3,2,6,0,1,"FW,MF",Under 20,Forward,Brazil,South America
1880,Paulinho,BRA,Leverkusen,Bundesliga,2018,18.0,2000.0,2.0,4,4,2,2,0,1,2,50.0,1,3,0,3,2,6,0,1,"FW,MF",Under 20,Forward,Brazil,South America
1880,Paulinho,BRA,Leverkusen,Bundesliga,2018,18.0,2000.0,2.0,4,4,2,2,0,1,2,50.0,1,3,0,3,2,6,0,1,"FW,MF",Under 20,Forward,Brazil,South America
1880,Paulinho,BRA,Leverkusen,Bundesliga,2018,18.0,2000.0,2.0,4,4,2,2,0,1,2,50.0,1,3,0,3,2,6,0,1,"FW,MF",Under 20,Forward,Brazil,South America
1880,Paulinho,BRA,Leverkusen,Bundesliga,2018,18.0,2000.0,2.0,4,4,2,2,0,1,2,50.0,1,3,0,3,2,6,0,1,"FW,MF",Under 20,Forward,Brazil,South America
1880,Paulinho,BRA,Leverkusen,Bundesliga,2018,18.0,2000.0,2.0,4,4,2,2,0,1,2,50.0,1,3,0,3,2,6,0,1,"FW,MF",Under 20,Forward,Brazil,South America
1880,Paulinho,BRA,Leverkusen,Bundesliga,2018,18.0,2000.0,2.0,4,4,2,2,0,1,2,50.0,1,3,0,3,2,6,0,1,"FW,MF",Under 20,Forward,Brazil,South America
1880,Paulinho,BRA,Leverkusen,Bundesliga,2018,18.0,2000.0,2.0,4,4,2,2,0,1,2,50.0,1,3,0,3,2,6,0,1,"FW,MF",Under 20,Forward,Brazil,South America
1880,Paulinho,BRA,Leverkusen,Bundesliga,2018,18.0,2000.0,2.0,4,4,2,2,0,1,2,50.0,1,3,0,3,2,6,0,1,"FW,MF",Under 20,Forward,Brazil,South America
1880,Paulinho,BRA,Leverkusen,Bundesliga,2018,18.0,2000.0,2.0,4,4,2,2,0,1,2,50.0,1,3,0,3,2,6,0,1,"FW,MF",Under 20,Forward,Brazil,South America
1880,Paulinho,BRA,Leverkusen,Bundesliga,2018,18.0,2000.0,2.0,4,4,2,2,0,1,2,50.0,1,3,0,3,2,6,0,1,"FW,MF",Under 20,Forward,Brazil,South America
1880,Paulinho,BRA,Leverkusen,Bundesliga,2018,18.0,2000.0,2.0,4,4,2,2,0,1,2,50.0,1,3,0,3,2,6,0,1,"FW,MF",Under 20,Forward,Brazil,South America
1880,Paulinho,BRA,Leverkusen,Bundesliga,2018,18.0,2000.0,2.0,4,4,2,2,0,1,2,50.0,1,3,0,3,2,6,0,1,"FW,MF",Under 20,Forward,Brazil,South America
1880,Paulinho,BRA,Leverkusen,Bundesliga,2018,18.0,2000.0,2.0,4,4,2,2,0,1,2,50.0,1,3,0,3,2,6,0,1,"FW,MF",Under 20,Forward,Brazil,South America
1880,Paulinho,BRA,Leverkusen,Bundesliga,2018,18.0,2000.0,2.0,4,4,2,2,0,1,2,50.0,1,3,0,3,2,6,0,1,"FW,MF",Under 20,Forward,Brazil,South America
1880,Paulinho,BRA,Leverkusen,Bundesliga,2018,18.0,2000.0,2.0,4,4,2,2,0,1,2,50.0,1,3,0,3,2,6,0,1,"FW,MF",Under 20,Forward,Brazil,South America
1880,Paulinho,BRA,Leverkusen,Bundesliga,2018,18.0,2000.0,2.0,4,4,2,2,0,1,2,50.0,1,3,0,3,2,6,0,1,"FW,MF",Under 20,Forward,Brazil,South America
1880,Paulinho,BRA,Leverkusen,Bundesliga,2018,18.0,2000.0,2.0,4,4,2,2,0,1,2,50.0,1,3,0,3,2,6,0,1,"FW,MF",Under 20,Forward,Brazil,South America
1880,Paulinho,BRA,Leverkusen,Bundesliga,2018,18.0,2000.0,2.0,4,4,2,2,0,1,2,50.0,1,3,0,3,2,6,0,1,"FW,MF",Under 20,Forward,Brazil,South America
1880,Paulinho,BRA,Leverkusen,Bundesliga,2018,18.0,2000.0,2.0,4,4,2,2,0,1,2,50.0,1,3,0,3,2,6,0,1,"FW,MF",Under 20,Forward,Brazil,South America
1880,Paulinho,BRA,Leverkusen,Bundesliga,2018,18.0,2000.0,2.0,4,4,2,2,0,1,2,50.0,1,3,0,3,2,6,0,1,"FW,MF",Under 20,Forward,Brazil,South America
1880,Paulinho,BRA,Leverkusen,Bundesliga,2018,18.0,2000.0,2.0,4,4,2,2,0,1,2,50.0,1,3,0,3,2,6,0,1,"FW,MF",Under 20,Forward,Brazil,South America
1880,Paulinho,BRA,Leverkusen,Bundesliga,2018,18.0,2000.0,2.0,4,4,2,2,0,1,2,50.0,1,3,0,3,2,6,0,1,"FW,MF",Under 20,Forward,Brazil,South America
1880,Paulinho,BRA,Leverkusen,Bundesliga,2018,18.0,2000.0,2.0,4,4,2,2,0,1,2,50.0,1,3,0,3,2,6,0,1,"FW,MF",Under 20,Forward,Brazil,South America
1880,Paulinho,BRA,Leverkusen,Bundesliga,2018,18.0,2000.0,2.0,4,4,2,2,0,1,2,50.0,1,3,0,3,2,6,0,1,"FW,MF",Under 20,Forward,Brazil,South America
1880,Paulinho,BRA,Leverkusen,Bundesliga,2018,18.0,2000.0,2.0,4,4,2,2,0,1,2,50.0,1,3,0,3,2,6,0,1,"FW,MF",Under 20,Forward,Brazil,South America
1880,Paulinho,BRA,Leverkusen,Bundesliga,2018,18.0,2000.0,2.0,4,4,2,2,0,1,2,50.0,1,3,0,3,2,6,0,1,"FW,MF",Under 20,Forward,Brazil,South America
1880,Paulinho,BRA,Leverkusen,Bundesliga,2018,18.0,2000.0,2.0,4,4,2,2,0,1,2,50.0,1,3,0,3,2,6,0,1,"FW,MF",Under 20,Forward,Brazil,South America
1880,Paulinho,BRA,Leverkusen,Bundesliga,2018,18.0,2000.0,2.0,4,4,2,2,0,1,2,50.0,1,3,0,3,2,6,0,1,"FW,MF",Under 20,Forward,Brazil,South America
1880,Paulinho,BRA,Leverkusen,Bundesliga,2018,18.0,2000.0,2.0,4,4,2,2,0,1,2,50.0,1,3,0,3,2,6,0,1,"FW,MF",Under 20,Forward,Brazil,South America
1880,Paulinho,BRA,Leverkusen,Bundesliga,2018,18.0,2000.0,2.0,4,4,2,2,0,1,2,50.0,1,3,0,3,2,6,0,1,"FW,MF",Under 20,Forward,Brazil,South America
1880,Paulinho,BRA,Leverkusen,Bundesliga,2018,18.0,2000.0,2.0,4,4,2,2,0,1,2,50.0,1,3,0,3,2,6,0,1,"FW,MF",Under 20,Forward,Brazil,South America
1880,Paulinho,BRA,Leverkusen,Bundesliga,2018,18.0,2000.0,2.0,4,4,2,2,0,1,2,50.0,1,3,0,3,2,6,0,1,"FW,MF",Under 20,Forward,Brazil,South America
1880,Paulinho,BRA,Leverkusen,Bundesliga,2018,18.0,2000.0,2.0,4,4,2,2,0,1,2,50.0,1,3,0,3,2,6,0,1,"FW,MF",Under 20,Forward,Brazil,South America
1880,Paulinho,BRA,Leverkusen,Bundesliga,2018,18.0,2000.0,2.0,4,4,2,2,0,1,2,50.0,1,3,0,3,2,6,0,1,"FW,MF",Under 20,Forward,Brazil,South America
1880,Paulinho,BRA,Leverkusen,Bundesliga,2018,18.0,2000.0,2.0,4,4,2,2,0,1,2,50.0,1,3,0,3,2,6,0,1,"FW,MF",Under 20,Forward,Brazil,South America
1880,Paulinho,BRA,Leverkusen,Bundesliga,2018,18.0,2000.0,2.0,4,4,2,2,0,1,2,50.0,1,3,0,3,2,6,0,1,"FW,MF",Under 20,Forward,Brazil,South America
1880,Paulinho,BRA,Leverkusen,Bundesliga,2018,18.0,2000.0,2.0,4,4,2,2,0,1,2,50.0,1,3,0,3,2,6,0,1,"FW,MF",Under 20,Forward,Brazil,South America
1880,Paulinho,BRA,Leverkusen,Bundesliga,2018,18.0,2000.0,2.0,4,4,2,2,0,1,2,50.0,1,3,0,3,2,6,0,1,"FW,MF",Under 20,Forward,Brazil,South America
1880,Paulinho,BRA,Leverkusen,Bundesliga,2018,18.0,2000.0,2.0,4,4,2,2,0,1,2,50.0,1,3,0,3,2,6,0,1,"FW,MF",Under 20,Forward,Brazil,South America
1880,Paulinho,BRA,Leverkusen,Bundesliga,2018,18.0,2000.0,2.0,4,4,2,2,0,1,2,50.0,1,3,0,3,2,6,0,1,"FW,MF",Under 20,Forward,Brazil,South America
1880,Paulinho,BRA,Leverkusen,Bundesliga,2018,18.0,2000.0,2.0,4,4,2,2,0,1,2,50.0,1,3,0,3,2,6,0,1,"FW,MF",Under 20,Forward,Brazil,South America
1880,Paulinho,BRA,Leverkusen,Bundesliga,2018,18.0,2000.0,2.0,4,4,2,2,0,1,2,50.0,1,3,0,3,2,6,0,1,"FW,MF",Under 20,Forward,Brazil,South America
1880,Paulinho,BRA,Leverkusen,Bundesliga,2018,18.0,2000.0,2.0,4,4,2,2,0,1,2,50.0,1,3,0,3,2,6,0,1,"FW,MF",Under 20,Forward,Brazil,South America
1880,Paulinho,BRA,Leverkusen,Bundesliga,2018,18.0,2000.0,2.0,4,4,2,2,0,1,2,50.0,1,3,0,3,2,6,0,1,"FW,MF",Under 20,Forward,Brazil,South America
1880,Paulinho,BRA,Leverkusen,Bundesliga,2018,18.0,2000.0,2.0,4,4,2,2,0,1,2,50.0,1,3,0,3,2,6,0,1,"FW,MF",Under 20,Forward,Brazil,South America
1880,Paulinho,BRA,Leverkusen,Bundesliga,2018,18.0,2000.0,2.0,4,4,2,2,0,1,2,50.0,1,3,0,3,2,6,0,1,"FW,MF",Under 20,Forward,Brazil,South America
1880,Paulinho,BRA,Leverkusen,Bundesliga,2018,18.0,2000.0,2.0,4,4,2,2,0,1,2,50.0,1,3,0,3,2,6,0,1,"FW,MF",Under 20,Forward,Brazil,South America
1880,Paulinho,BRA,Leverkusen,Bundesliga,2018,18.0,2000.0,2.0,4,4,2,2,0,1,2,50.0,1,3,0,3,2,6,0,1,"FW,MF",Under 20,Forward,Brazil,South America
1880,Paulinho,BRA,Leverkusen,Bundesliga,2018,18.0,2000.0,2.0,4,4,2,2,0,1,2,50.0,1,3,0,3,2,6,0,1,"FW,MF",Under 20,Forward,Brazil,South America
1880,Paulinho,BRA,Leverkusen,Bundesliga,2018,18.0,2000.0,2.0,4,4,2,2,0,1,2,50.0,1,3,0,3,2,6,0,1,"FW,MF",Under 20,Forward,Brazil,South America
1880,Paulinho,BRA,Leverkusen,Bundesliga,2018,18.0,2000.0,2.0,4,4,2,2,0,1,2,50.0,1,3,0,3,2,6,0,1,"FW,MF",Under 20,Forward,Brazil,South America
1880,Paulinho,BRA,Leverkusen,Bundesliga,2018,18.0,2000.0,2.0,4,4,2,2,0,1,2,50.0,1,3,0,3,2,6,0,1,"FW,MF",Under 20,Forward,Brazil,South America
1880,Paulinho,BRA,Leverkusen,Bundesliga,2018,18.0,2000.0,2.0,4,4,2,2,0,1,2,50.0,1,3,0,3,2,6,0,1,"FW,MF",Under 20,Forward,Brazil,South America
1880,Paulinho,BRA,Leverkusen,Bundesliga,2018,18.0,2000.0,2.0,4,4,2,2,0,1,2,50.0,1,3,0,3,2,6,0,1,"FW,MF",Under 20,Forward,Brazil,South America
1880,Paulinho,BRA,Leverkusen,Bundesliga,2018,18.0,2000.0,2.0,4,4,2,2,0,1,2,50.0,1,3,0,3,2,6,0,1,"FW,MF",Under 20,Forward,Brazil,South America
1880,Paulinho,BRA,Leverkusen,Bundesliga,2018,18.0,2000.0,2.0,4,4,2,2,0,1,2,50.0,1,3,0,3,2,6,0,1,"FW,MF",Under 20,Forward,Brazil,South America
1880,Paulinho,BRA,Leverkusen,Bundesliga,2018,18.0,2000.0,2.0,4,4,2,2,0,1,2,50.0,1,3,0,3,2,6,0,1,"FW,MF",Under 20,Forward,Brazil,South America
1880,Paulinho,BRA,Leverkusen,Bundesliga,2018,18.0,2000.0,2.0,4,4,2,2,0,1,2,50.0,1,3,0,3,2,6,0,1,"FW,MF",Under 20,Forward,Brazil,South America
1880,Paulinho,BRA,Leverkusen,Bundesliga,2018,18.0,2000.0,2.0,4,4,2,2,0,1,2,50.0,1,3,0,3,2,6,0,1,"FW,MF",Under 20,Forward,Brazil,South America
1880,Paulinho,BRA,Leverkusen,Bundesliga,2018,18.0,2000.0,2.0,4,4,2,2,0,1,2,50.0,1,3,0,3,2,6,0,1,"FW,MF",Under 20,Forward,Brazil,South America
1880,Paulinho,BRA,Leverkusen,Bundesliga,2018,18.0,2000.0,2.0,4,4,2,2,0,1,2,50.0,1,3,0,3,2,6,0,1,"FW,MF",Under 20,Forward,Brazil,South America
1880,Paulinho,BRA,Leverkusen,Bundesliga,2018,18.0,2000.0,2.0,4,4,2,2,0,1,2,50.0,1,3,0,3,2,6,0,1,"FW,MF",Under 20,Forward,Brazil,South America
1880,Paulinho,BRA,Leverkusen,Bundesliga,2018,18.0,2000.0,2.0,4,4,2,2,0,1,2,50.0,1,3,0,3,2,6,0,1,"FW,MF",Under 20,Forward,Brazil,South America
1880,Paulinho,BRA,Leverkusen,Bundesliga,2018,18.0,2000.0,2.0,4,4,2,2,0,1,2,50.0,1,3,0,3,2,6,0,1,"FW,MF",Under 20,Forward,Brazil,South America
1880,Paulinho,BRA,Leverkusen,Bundesliga,2018,18.0,2000.0,2.0,4,4,2,2,0,1,2,50.0,1,3,0,3,2,6,0,1,"FW,MF",Under 20,Forward,Brazil,South America
1880,Paulinho,BRA,Leverkusen,Bundesliga,2018,18.0,2000.0,2.0,4,4,2,2,0,1,2,50.0,1,3,0,3,2,6,0,1,"FW,MF",Under 20,Forward,Brazil,South America
1880,Paulinho,BRA,Leverkusen,Bundesliga,2018,18.0,2000.0,2.0,4,4,2,2,0,1,2,50.0,1,3,0,3,2,6,0,1,"FW,MF",Under 20,Forward,Brazil,South America
1880,Paulinho,BRA,Leverkusen,Bundesliga,2018,18.0,2000.0,2.0,4,4,2,2,0,1,2,50.0,1,3,0,3,2,6,0,1,"FW,MF",Under 20,Forward,Brazil,South America
1880,Paulinho,BRA,Leverkusen,Bundesliga,2018,18.0,2000.0,2.0,4,4,2,2,0,1,2,50.0,1,3,0,3,2,6,0,1,"FW,MF",Under 20,Forward,Brazil,South America
1880,Paulinho,BRA,Leverkusen,Bundesliga,2018,18.0,2000.0,2.0,4,4,2,2,0,1,2,50.0,1,3,0,3,2,6,0,1,"FW,MF",Under 20,Forward,Brazil,South America
1880,Paulinho,BRA,Leverkusen,Bundesliga,2018,18.0,2000.0,2.0,4,4,2,2,0,1,2,50.0,1,3,0,3,2,6,0,1,"FW,MF",Under 20,Forward,Brazil,South America
1880,Paulinho,BRA,Leverkusen,Bundesliga,2018,18.0,2000.0,2.0,4,4,2,2,0,1,2,50.0,1,3,0,3,2,6,0,1,"FW,MF",Under 20,Forward,Brazil,South America
1880,Paulinho,BRA,Leverkusen,Bundesliga,2018,18.0,2000.0,2.0,4,4,2,2,0,1,2,50.0,1,3,0,3,2,6,0,1,"FW,MF",Under 20,Forward,Brazil,South America
1880,Paulinho,BRA,Leverkusen,Bundesliga,2018,18.0,2000.0,2.0,4,4,2,2,0,1,2,50.0,1,3,0,3,2,6,0,1,"FW,MF",Under 20,Forward,Brazil,South America
1880,Paulinho,BRA,Leverkusen,Bundesliga,2018,18.0,2000.0,2.0,4,4,2,2,0,1,2,50.0,1,3,0,3,2,6,0,1,"FW,MF",Under 20,Forward,Brazil,South America
1880,Paulinho,BRA,Leverkusen,Bundesliga,2018,18.0,2000.0,2.0,4,4,2,2,0,1,2,50.0,1,3,0,3,2,6,0,1,"FW,MF",Under 20,Forward,Brazil,South America
1880,Paulinho,BRA,Leverkusen,Bundesliga,2018,18.0,2000.0,2.0,4,4,2,2,0,1,2,50.0,1,3,0,3,2,6,0,1,"FW,MF",Under 20,Forward,Brazil,South America
1880,Paulinho,BRA,Leverkusen,Bundesliga,2018,18.0,2000.0,2.0,4,4,2,2,0,1,2,50.0,1,3,0,3,2,6,0,1,"FW,MF",Under 20,Forward,Brazil,South America
1880,Paulinho,BRA,Leverkusen,Bundesliga,2018,18.0,2000.0,2.0,4,4,2,2,0,1,2,50.0,1,3,0,3,2,6,0,1,"FW,MF",Under 20,Forward,Brazil,South America
1880,Paulinho,BRA,Leverkusen,Bundesliga,2018,18.0,2000.0,2.0,4,4,2,2,0,1,2,50.0,1,3,0,3,2,6,0,1,"FW,MF",Under 20,Forward,Brazil,South America
1880,Paulinho,BRA,Leverkusen,Bundesliga,2018,18.0,2000.0,2.0,4,4,2,2,0,1,2,50.0,1,3,0,3,2,6,0,1,"FW,MF",Under 20,Forward,Brazil,South America
1880,Paulinho,BRA,Leverkusen,Bundesliga,2018,18.0,2000.0,2.0,4,4,2,2,0,1,2,50.0,1,3,0,3,2,6,0,1,"FW,MF",Under 20,Forward,Brazil,South America
1880,Paulinho,BRA,Leverkusen,Bundesliga,2018,18.0,2000.0,2.0,4,4,2,2,0,1,2,50.0,1,3,0,3,2,6,0,1,"FW,MF",Under 20,Forward,Brazil,South America
1880,Paulinho,BRA,Leverkusen,Bundesliga,2018,18.0,2000.0,2.0,4,4,2,2,0,1,2,50.0,1,3,0,3,2,6,0,1,"FW,MF",Under 20,Forward,Brazil,South America
1880,Paulinho,BRA,Leverkusen,Bundesliga,2018,18.0,2000.0,2.0,4,4,2,2,0,1,2,50.0,1,3,0,3,2,6,0,1,"FW,MF",Under 20,Forward,Brazil,South America
1880,Paulinho,BRA,Leverkusen,Bundesliga,2018,18.0,2000.0,2.0,4,4,2,2,0,1,2,50.0,1,3,0,3,2,6,0,1,"FW,MF",Under 20,Forward,Brazil,South America
1880,Paulinho,BRA,Leverkusen,Bundesliga,2018,18.0,2000.0,2.0,4,4,2,2,0,1,2,50.0,1,3,0,3,2,6,0,1,"FW,MF",Under 20,Forward,Brazil,South America
1880,Paulinho,BRA,Leverkusen,Bundesliga,2018,18.0,2000.0,2.0,4,4,2,2,0,1,2,50.0,1,3,0,3,2,6,0,1,"FW,MF",Under 20,Forward,Brazil,South America
1880,Paulinho,BRA,Leverkusen,Bundesliga,2018,18.0,2000.0,2.0,4,4,2,2,0,1,2,50.0,1,3,0,3,2,6,0,1,"FW,MF",Under 20,Forward,Brazil,South America
1880,Paulinho,BRA,Leverkusen,Bundesliga,2018,18.0,2000.0,2.0,4,4,2,2,0,1,2,50.0,1,3,0,3,2,6,0,1,"FW,MF",Under 20,Forward,Brazil,South America
1880,Paulinho,BRA,Leverkusen,Bundesliga,2018,18.0,2000.0,2.0,4,4,2,2,0,1,2,50.0,1,3,0,3,2,6,0,1,"FW,MF",Under 20,Forward,Brazil,South America
1880,Paulinho,BRA,Leverkusen,Bundesliga,2018,18.0,2000.0,2.0,4,4,2,2,0,1,2,50.0,1,3,0,3,2,6,0,1,"FW,MF",Under 20,Forward,Brazil,South America
1880,Paulinho,BRA,Leverkusen,Bundesliga,2018,18.0,2000.0,2.0,4,4,2,2,0,1,2,50.0,1,3,0,3,2,6,0,1,"FW,MF",Under 20,Forward,Brazil,South America
1880,Paulinho,BRA,Leverkusen,Bundesliga,2018,18.0,2000.0,2.0,4,4,2,2,0,1,2,50.0,1,3,0,3,2,6,0,1,"FW,MF",Under 20,Forward,Brazil,South America
1880,Paulinho,BRA,Leverkusen,Bundesliga,2018,18.0,2000.0,2.0,4,4,2,2,0,1,2,50.0,1,3,0,3,2,6,0,1,"FW,MF",Under 20,Forward,Brazil,South America
1880,Paulinho,BRA,Leverkusen,Bundesliga,2018,18.0,2000.0,2.0,4,4,2,2,0,1,2,50.0,1,3,0,3,2,6,0,1,"FW,MF",Under 20,Forward,Brazil,South America
1880,Paulinho,BRA,Leverkusen,Bundesliga,2018,18.0,2000.0,2.0,4,4,2,2,0,1,2,50.0,1,3,0,3,2,6,0,1,"FW,MF",Under 20,Forward,Brazil,South America
1880,Paulinho,BRA,Leverkusen,Bundesliga,2018,18.0,2000.0,2.0,4,4,2,2,0,1,2,50.0,1,3,0,3,2,6,0,1,"FW,MF",Under 20,Forward,Brazil,South America
1880,Paulinho,BRA,Leverkusen,Bundesliga,2018,18.0,2000.0,2.0,4,4,2,2,0,1,2,50.0,1,3,0,3,2,6,0,1,"FW,MF",Under 20,Forward,Brazil,South America
1880,Paulinho,BRA,Leverkusen,Bundesliga,2018,18.0,2000.0,2.0,4,4,2,2,0,1,2,50.0,1,3,0,3,2,6,0,1,"FW,MF",Under 20,Forward,Brazil,South America
1880,Paulinho,BRA,Leverkusen,Bundesliga,2018,18.0,2000.0,2.0,4,4,2,2,0,1,2,50.0,1,3,0,3,2,6,0,1,"FW,MF",Under 20,Forward,Brazil,South America
1880,Paulinho,BRA,Leverkusen,Bundesliga,2018,18.0,2000.0,2.0,4,4,2,2,0,1,2,50.0,1,3,0,3,2,6,0,1,"FW,MF",Under 20,Forward,Brazil,South America
1880,Paulinho,BRA,Leverkusen,Bundesliga,2018,18.0,2000.0,2.0,4,4,2,2,0,1,2,50.0,1,3,0,3,2,6,0,1,"FW,MF",Under 20,Forward,Brazil,South America
1880,Paulinho,BRA,Leverkusen,Bundesliga,2018,18.0,2000.0,2.0,4,4,2,2,0,1,2,50.0,1,3,0,3,2,6,0,1,"FW,MF",Under 20,Forward,Brazil,South America
1880,Paulinho,BRA,Leverkusen,Bundesliga,2018,18.0,2000.0,2.0,4,4,2,2,0,1,2,50.0,1,3,0,3,2,6,0,1,"FW,MF",Under 20,Forward,Brazil,South America
1880,Paulinho,BRA,Leverkusen,Bundesliga,2018,18.0,2000.0,2.0,4,4,2,2,0,1,2,50.0,1,3,0,3,2,6,0,1,"FW,MF",Under 20,Forward,Brazil,South America
1880,Paulinho,BRA,Leverkusen,Bundesliga,2018,18.0,2000.0,2.0,4,4,2,2,0,1,2,50.0,1,3,0,3,2,6,0,1,"FW,MF",Under 20,Forward,Brazil,South America
1880,Paulinho,BRA,Leverkusen,Bundesliga,2018,18.0,2000.0,2.0,4,4,2,2,0,1,2,50.0,1,3,0,3,2,6,0,1,"FW,MF",Under 20,Forward,Brazil,South America
1880,Paulinho,BRA,Leverkusen,Bundesliga,2018,18.0,2000.0,2.0,4,4,2,2,0,1,2,50.0,1,3,0,3,2,6,0,1,"FW,MF",Under 20,Forward,Brazil,South America
1880,Paulinho,BRA,Leverkusen,Bundesliga,2018,18.0,2000.0,2.0,4,4,2,2,0,1,2,50.0,1,3,0,3,2,6,0,1,"FW,MF",Under 20,Forward,Brazil,South America
1880,Paulinho,BRA,Leverkusen,Bundesliga,2018,18.0,2000.0,2.0,4,4,2,2,0,1,2,50.0,1,3,0,3,2,6,0,1,"FW,MF",Under 20,Forward,Brazil,South America
1880,Paulinho,BRA,Leverkusen,Bundesliga,2018,18.0,2000.0,2.0,4,4,2,2,0,1,2,50.0,1,3,0,3,2,6,0,1,"FW,MF",Under 20,Forward,Brazil,South America
1880,Paulinho,BRA,Leverkusen,Bundesliga,2018,18.0,2000.0,2.0,4,4,2,2,0,1,2,50.0,1,3,0,3,2,6,0,1,"FW,MF",Under 20,Forward,Brazil,South America
1880,Paulinho,BRA,Leverkusen,Bundesliga,2018,18.0,2000.0,2.0,4,4,2,2,0,1,2,50.0,1,3,0,3,2,6,0,1,"FW,MF",Under 20,Forward,Brazil,South America
1880,Paulinho,BRA,Leverkusen,Bundesliga,2018,18.0,2000.0,2.0,4,4,2,2,0,1,2,50.0,1,3,0,3,2,6,0,1,"FW,MF",Under 20,Forward,Brazil,South America
1880,Paulinho,BRA,Leverkusen,Bundesliga,2018,18.0,2000.0,2.0,4,4,2,2,0,1,2,50.0,1,3,0,3,2,6,0,1,"FW,MF",Under 20,Forward,Brazil,South America
1880,Paulinho,BRA,Leverkusen,Bundesliga,2018,18.0,2000.0,2.0,4,4,2,2,0,1,2,50.0,1,3,0,3,2,6,0,1,"FW,MF",Under 20,Forward,Brazil,South America
1880,Paulinho,BRA,Leverkusen,Bundesliga,2018,18.0,2000.0,2.0,4,4,2,2,0,1,2,50.0,1,3,0,3,2,6,0,1,"FW,MF",Under 20,Forward,Brazil,South America
1880,Paulinho,BRA,Leverkusen,Bundesliga,2018,18.0,2000.0,2.0,4,4,2,2,0,1,2,50.0,1,3,0,3,2,6,0,1,"FW,MF",Under 20,Forward,Brazil,South America
1880,Paulinho,BRA,Leverkusen,Bundesliga,2018,18.0,2000.0,2.0,4,4,2,2,0,1,2,50.0,1,3,0,3,2,6,0,1,"FW,MF",Under 20,Forward,Brazil,South America
1880,Paulinho,BRA,Leverkusen,Bundesliga,2018,18.0,2000.0,2.0,4,4,2,2,0,1,2,50.0,1,3,0,3,2,6,0,1,"FW,MF",Under 20,Forward,Brazil,South America
1880,Paulinho,BRA,Leverkusen,Bundesliga,2018,18.0,2000.0,2.0,4,4,2,2,0,1,2,50.0,1,3,0,3,2,6,0,1,"FW,MF",Under 20,Forward,Brazil,South America
1880,Paulinho,BRA,Leverkusen,Bundesliga,2018,18.0,2000.0,2.0,4,4,2,2,0,1,2,50.0,1,3,0,3,2,6,0,1,"FW,MF",Under 20,Forward,Brazil,South America
1880,Paulinho,BRA,Leverkusen,Bundesliga,2018,18.0,2000.0,2.0,4,4,2,2,0,1,2,50.0,1,3,0,3,2,6,0,1,"FW,MF",Under 20,Forward,Brazil,South America
1880,Paulinho,BRA,Leverkusen,Bundesliga,2018,18.0,2000.0,2.0,4,4,2,2,0,1,2,50.0,1,3,0,3,2,6,0,1,"FW,MF",Under 20,Forward,Brazil,South America
1880,Paulinho,BRA,Leverkusen,Bundesliga,2018,18.0,2000.0,2.0,4,4,2,2,0,1,2,50.0,1,3,0,3,2,6,0,1,"FW,MF",Under 20,Forward,Brazil,South America
1880,Paulinho,BRA,Leverkusen,Bundesliga,2018,18.0,2000.0,2.0,4,4,2,2,0,1,2,50.0,1,3,0,3,2,6,0,1,"FW,MF",Under 20,Forward,Brazil,South America
1880,Paulinho,BRA,Leverkusen,Bundesliga,2018,18.0,2000.0,2.0,4,4,2,2,0,1,2,50.0,1,3,0,3,2,6,0,1,"FW,MF",Under 20,Forward,Brazil,South America
1880,Paulinho,BRA,Leverkusen,Bundesliga,2018,18.0,2000.0,2.0,4,4,2,2,0,1,2,50.0,1,3,0,3,2,6,0,1,"FW,MF",Under 20,Forward,Brazil,South America
1880,Paulinho,BRA,Leverkusen,Bundesliga,2018,18.0,2000.0,2.0,4,4,2,2,0,1,2,50.0,1,3,0,3,2,6,0,1,"FW,MF",Under 20,Forward,Brazil,South America
1880,Paulinho,BRA,Leverkusen,Bundesliga,2018,18.0,2000.0,2.0,4,4,2,2,0,1,2,50.0,1,3,0,3,2,6,0,1,"FW,MF",Under 20,Forward,Brazil,South America
1880,Paulinho,BRA,Leverkusen,Bundesliga,2018,18.0,2000.0,2.0,4,4,2,2,0,1,2,50.0,1,3,0,3,2,6,0,1,"FW,MF",Under 20,Forward,Brazil,South America
1880,Paulinho,BRA,Leverkusen,Bundesliga,2018,18.0,2000.0,2.0,4,4,2,2,0,1,2,50.0,1,3,0,3,2,6,0,1,"FW,MF",Under 20,Forward,Brazil,South America
1880,Paulinho,BRA,Leverkusen,Bundesliga,2018,18.0,2000.0,2.0,4,4,2,2,0,1,2,50.0,1,3,0,3,2,6,0,1,"FW,MF",Under 20,Forward,Brazil,South America
1880,Paulinho,BRA,Leverkusen,Bundesliga,2018,18.0,2000.0,2.0,4,4,2,2,0,1,2,50.0,1,3,0,3,2,6,0,1,"FW,MF",Under 20,Forward,Brazil,South America
1880,Paulinho,BRA,Leverkusen,Bundesliga,2018,18.0,2000.0,2.0,4,4,2,2,0,1,2,50.0,1,3,0,3,2,6,0,1,"FW,MF",Under 20,Forward,Brazil,South America
1880,Paulinho,BRA,Leverkusen,Bundesliga,2018,18.0,2000.0,2.0,4,4,2,2,0,1,2,50.0,1,3,0,3,2,6,0,1,"FW,MF",Under 20,Forward,Brazil,South America
1880,Paulinho,BRA,Leverkusen,Bundesliga,2018,18.0,2000.0,2.0,4,4,2,2,0,1,2,50.0,1,3,0,3,2,6,0,1,"FW,MF",Under 20,Forward,Brazil,South America
1880,Paulinho,BRA,Leverkusen,Bundesliga,2018,18.0,2000.0,2.0,4,4,2,2,0,1,2,50.0,1,3,0,3,2,6,0,1,"FW,MF",Under 20,Forward,Brazil,South America
1880,Paulinho,BRA,Leverkusen,Bundesliga,2018,18.0,2000.0,2.0,4,4,2,2,0,1,2,50.0,1,3,0,3,2,6,0,1,"FW,MF",Under 20,Forward,Brazil,South America
1880,Paulinho,BRA,Leverkusen,Bundesliga,2018,18.0,2000.0,2.0,4,4,2,2,0,1,2,50.0,1,3,0,3,2,6,0,1,"FW,MF",Under 20,Forward,Brazil,South America
1880,Paulinho,BRA,Leverkusen,Bundesliga,2018,18.0,2000.0,2.0,4,4,2,2,0,1,2,50.0,1,3,0,3,2,6,0,1,"FW,MF",Under 20,Forward,Brazil,South America
1880,Paulinho,BRA,Leverkusen,Bundesliga,2018,18.0,2000.0,2.0,4,4,2,2,0,1,2,50.0,1,3,0,3,2,6,0,1,"FW,MF",Under 20,Forward,Brazil,South America
1880,Paulinho,BRA,Leverkusen,Bundesliga,2018,18.0,2000.0,2.0,4,4,2,2,0,1,2,50.0,1,3,0,3,2,6,0,1,"FW,MF",Under 20,Forward,Brazil,South America
1880,Paulinho,BRA,Leverkusen,Bundesliga,2018,18.0,2000.0,2.0,4,4,2,2,0,1,2,50.0,1,3,0,3,2,6,0,1,"FW,MF",Under 20,Forward,Brazil,South America
1880,Paulinho,BRA,Leverkusen,Bundesliga,2018,18.0,2000.0,2.0,4,4,2,2,0,1,2,50.0,1,3,0,3,2,6,0,1,"FW,MF",Under 20,Forward,Brazil,South America
1880,Paulinho,BRA,Leverkusen,Bundesliga,2018,18.0,2000.0,2.0,4,4,2,2,0,1,2,50.0,1,3,0,3,2,6,0,1,"FW,MF",Under 20,Forward,Brazil,South America
1880,Paulinho,BRA,Leverkusen,Bundesliga,2018,18.0,2000.0,2.0,4,4,2,2,0,1,2,50.0,1,3,0,3,2,6,0,1,"FW,MF",Under 20,Forward,Brazil,South America
1880,Paulinho,BRA,Leverkusen,Bundesliga,2018,18.0,2000.0,2.0,4,4,2,2,0,1,2,50.0,1,3,0,3,2,6,0,1,"FW,MF",Under 20,Forward,Brazil,South America
1880,Paulinho,BRA,Leverkusen,Bundesliga,2018,18.0,2000.0,2.0,4,4,2,2,0,1,2,50.0,1,3,0,3,2,6,0,1,"FW,MF",Under 20,Forward,Brazil,South America
1880,Paulinho,BRA,Leverkusen,Bundesliga,2018,18.0,2000.0,2.0,4,4,2,2,0,1,2,50.0,1,3,0,3,2,6,0,1,"FW,MF",Under 20,Forward,Brazil,South America
1880,Paulinho,BRA,Leverkusen,Bundesliga,2018,18.0,2000.0,2.0,4,4,2,2,0,1,2,50.0,1,3,0,3,2,6,0,1,"FW,MF",Under 20,Forward,Brazil,South America
1880,Paulinho,BRA,Leverkusen,Bundesliga,2018,18.0,2000.0,2.0,4,4,2,2,0,1,2,50.0,1,3,0,3,2,6,0,1,"FW,MF",Under 20,Forward,Brazil,South America
1880,Paulinho,BRA,Leverkusen,Bundesliga,2018,18.0,2000.0,2.0,4,4,2,2,0,1,2,50.0,1,3,0,3,2,6,0,1,"FW,MF",Under 20,Forward,Brazil,South America
1880,Paulinho,BRA,Leverkusen,Bundesliga,2018,18.0,2000.0,2.0,4,4,2,2,0,1,2,50.0,1,3,0,3,2,6,0,1,"FW,MF",Under 20,Forward,Brazil,South America
1880,Paulinho,BRA,Leverkusen,Bundesliga,2018,18.0,2000.0,2.0,4,4,2,2,0,1,2,50.0,1,3,0,3,2,6,0,1,"FW,MF",Under 20,Forward,Brazil,South America
1880,Paulinho,BRA,Leverkusen,Bundesliga,2018,18.0,2000.0,2.0,4,4,2,2,0,1,2,50.0,1,3,0,3,2,6,0,1,"FW,MF",Under 20,Forward,Brazil,South America
1881,Gabriel Paulista,BRA,Valencia,La Liga,2018,27.0,1990.0,29.1,29,16,20,6,3,14,28,50.0,14,37,21,16,70,99,162,1,DF,25-29,Defender,Brazil,South America
1882,Benjamin Pavard,FRA,Stuttgart,Bundesliga,2018,22.0,1996.0,29.0,28,20,21,6,1,12,19,63.2,7,27,19,8,48,76,189,2,DF,20-24,Defender,France,Europe
1884,Mateo Pavlović,BIH,Angers,Ligue 1,2018,28.0,1990.0,27.7,26,18,24,2,0,12,24,50.0,12,37,29,8,20,46,164,2,DF,25-29,Defender,Bosnia and Herzegovina,Europe
1885,Leonardo Pavoletti,ITA,Cagliari,Serie A,2018,29.0,1988.0,30.4,32,21,6,17,9,6,16,37.5,10,12,3,9,7,39,26,0,FW,25-29,Forward,Italy,Europe
1886,Dimitri Payet,FRA,Marseille,Ligue 1,2018,31.0,1987.0,21.2,11,9,2,8,1,5,22,22.7,17,14,0,14,8,19,8,0,"MF,FW",30-34,Midfielder,France,Europe
1887,Nehuén Paz,ARG,Bologna,Serie A,2018,25.0,1993.0,1.3,2,1,2,0,0,1,2,50.0,1,3,1,2,0,2,2,0,DF,25-29,Defender,Argentina,South America
1890,João Pedro,ITA,Cagliari,Serie A,2018,26.0,1992.0,28.4,17,12,4,8,5,4,11,36.4,7,14,5,9,6,23,14,0,"FW,MF",25-29,Forward,Italy,Europe
1890,João Pedro,ITA,Cagliari,Serie A,2018,26.0,1992.0,28.4,17,12,4,8,5,4,11,36.4,7,14,5,9,6,23,14,0,"FW,MF",25-29,Forward,Italy,Europe
1890,João Pedro,ITA,Cagliari,Serie A,2018,26.0,1992.0,28.4,17,12,4,8,5,4,11,36.4,7,14,5,9,6,23,14,0,"FW,MF",25-29,Forward,Italy,Europe
1890,João Pedro,ITA,Cagliari,Serie A,2018,26.0,1992.0,28.4,17,12,4,8,5,4,11,36.4,7,14,5,9,6,23,14,0,"FW,MF",25-29,Forward,Italy,Europe
1890,João Pedro,ITA,Cagliari,Serie A,2018,26.0,1992.0,28.4,17,12,4,8,5,4,11,36.4,7,14,5,9,6,23,14,0,"FW,MF",25-29,Forward,Italy,Europe
1890,João Pedro,ITA,Cagliari,Serie A,2018,26.0,1992.0,28.4,17,12,4,8,5,4,11,36.4,7,14,5,9,6,23,14,0,"FW,MF",25-29,Forward,Italy,Europe
1890,João Pedro,ITA,Cagliari,Serie A,2018,26.0,1992.0,28.4,17,12,4,8,5,4,11,36.4,7,14,5,9,6,23,14,0,"FW,MF",25-29,Forward,Italy,Europe
1890,João Pedro,ITA,Cagliari,Serie A,2018,26.0,1992.0,28.4,17,12,4,8,5,4,11,36.4,7,14,5,9,6,23,14,0,"FW,MF",25-29,Forward,Italy,Europe
1890,João Pedro,ITA,Cagliari,Serie A,2018,26.0,1992.0,28.4,17,12,4,8,5,4,11,36.4,7,14,5,9,6,23,14,0,"FW,MF",25-29,Forward,Italy,Europe
1890,João Pedro,ITA,Cagliari,Serie A,2018,26.0,1992.0,28.4,17,12,4,8,5,4,11,36.4,7,14,5,9,6,23,14,0,"FW,MF",25-29,Forward,Italy,Europe
1890,João Pedro,ITA,Cagliari,Serie A,2018,26.0,1992.0,28.4,17,12,4,8,5,4,11,36.4,7,14,5,9,6,23,14,0,"FW,MF",25-29,Forward,Italy,Europe
1890,João Pedro,ITA,Cagliari,Serie A,2018,26.0,1992.0,28.4,17,12,4,8,5,4,11,36.4,7,14,5,9,6,23,14,0,"FW,MF",25-29,Forward,Italy,Europe
1890,João Pedro,ITA,Cagliari,Serie A,2018,26.0,1992.0,28.4,17,12,4,8,5,4,11,36.4,7,14,5,9,6,23,14,0,"FW,MF",25-29,Forward,Italy,Europe
1890,João Pedro,ITA,Cagliari,Serie A,2018,26.0,1992.0,28.4,17,12,4,8,5,4,11,36.4,7,14,5,9,6,23,14,0,"FW,MF",25-29,Forward,Italy,Europe
1890,João Pedro,ITA,Cagliari,Serie A,2018,26.0,1992.0,28.4,17,12,4,8,5,4,11,36.4,7,14,5,9,6,23,14,0,"FW,MF",25-29,Forward,Italy,Europe
1890,João Pedro,ITA,Cagliari,Serie A,2018,26.0,1992.0,28.4,17,12,4,8,5,4,11,36.4,7,14,5,9,6,23,14,0,"FW,MF",25-29,Forward,Italy,Europe
1890,João Pedro,ITA,Cagliari,Serie A,2018,26.0,1992.0,28.4,17,12,4,8,5,4,11,36.4,7,14,5,9,6,23,14,0,"FW,MF",25-29,Forward,Italy,Europe
1890,João Pedro,ITA,Cagliari,Serie A,2018,26.0,1992.0,28.4,17,12,4,8,5,4,11,36.4,7,14,5,9,6,23,14,0,"FW,MF",25-29,Forward,Italy,Europe
1890,João Pedro,ITA,Cagliari,Serie A,2018,26.0,1992.0,28.4,17,12,4,8,5,4,11,36.4,7,14,5,9,6,23,14,0,"FW,MF",25-29,Forward,Italy,Europe
1890,João Pedro,ITA,Cagliari,Serie A,2018,26.0,1992.0,28.4,17,12,4,8,5,4,11,36.4,7,14,5,9,6,23,14,0,"FW,MF",25-29,Forward,Italy,Europe
1890,João Pedro,ITA,Cagliari,Serie A,2018,26.0,1992.0,28.4,17,12,4,8,5,4,11,36.4,7,14,5,9,6,23,14,0,"FW,MF",25-29,Forward,Italy,Europe
1890,João Pedro,ITA,Cagliari,Serie A,2018,26.0,1992.0,28.4,17,12,4,8,5,4,11,36.4,7,14,5,9,6,23,14,0,"FW,MF",25-29,Forward,Italy,Europe
1890,João Pedro,ITA,Cagliari,Serie A,2018,26.0,1992.0,28.4,17,12,4,8,5,4,11,36.4,7,14,5,9,6,23,14,0,"FW,MF",25-29,Forward,Italy,Europe
1890,João Pedro,ITA,Cagliari,Serie A,2018,26.0,1992.0,28.4,17,12,4,8,5,4,11,36.4,7,14,5,9,6,23,14,0,"FW,MF",25-29,Forward,Italy,Europe
1890,João Pedro,ITA,Cagliari,Serie A,2018,26.0,1992.0,28.4,17,12,4,8,5,4,11,36.4,7,14,5,9,6,23,14,0,"FW,MF",25-29,Forward,Italy,Europe
1890,João Pedro,ITA,Cagliari,Serie A,2018,26.0,1992.0,28.4,17,12,4,8,5,4,11,36.4,7,14,5,9,6,23,14,0,"FW,MF",25-29,Forward,Italy,Europe
1890,João Pedro,ITA,Cagliari,Serie A,2018,26.0,1992.0,28.4,17,12,4,8,5,4,11,36.4,7,14,5,9,6,23,14,0,"FW,MF",25-29,Forward,Italy,Europe
1890,João Pedro,ITA,Cagliari,Serie A,2018,26.0,1992.0,28.4,17,12,4,8,5,4,11,36.4,7,14,5,9,6,23,14,0,"FW,MF",25-29,Forward,Italy,Europe
1890,João Pedro,ITA,Cagliari,Serie A,2018,26.0,1992.0,28.4,17,12,4,8,5,4,11,36.4,7,14,5,9,6,23,14,0,"FW,MF",25-29,Forward,Italy,Europe
1890,João Pedro,ITA,Cagliari,Serie A,2018,26.0,1992.0,28.4,17,12,4,8,5,4,11,36.4,7,14,5,9,6,23,14,0,"FW,MF",25-29,Forward,Italy,Europe
1890,João Pedro,ITA,Cagliari,Serie A,2018,26.0,1992.0,28.4,17,12,4,8,5,4,11,36.4,7,14,5,9,6,23,14,0,"FW,MF",25-29,Forward,Italy,Europe
1890,João Pedro,ITA,Cagliari,Serie A,2018,26.0,1992.0,28.4,17,12,4,8,5,4,11,36.4,7,14,5,9,6,23,14,0,"FW,MF",25-29,Forward,Italy,Europe
1890,João Pedro,ITA,Cagliari,Serie A,2018,26.0,1992.0,28.4,17,12,4,8,5,4,11,36.4,7,14,5,9,6,23,14,0,"FW,MF",25-29,Forward,Italy,Europe
1890,João Pedro,ITA,Cagliari,Serie A,2018,26.0,1992.0,28.4,17,12,4,8,5,4,11,36.4,7,14,5,9,6,23,14,0,"FW,MF",25-29,Forward,Italy,Europe
1890,João Pedro,ITA,Cagliari,Serie A,2018,26.0,1992.0,28.4,17,12,4,8,5,4,11,36.4,7,14,5,9,6,23,14,0,"FW,MF",25-29,Forward,Italy,Europe
1890,João Pedro,ITA,Cagliari,Serie A,2018,26.0,1992.0,28.4,17,12,4,8,5,4,11,36.4,7,14,5,9,6,23,14,0,"FW,MF",25-29,Forward,Italy,Europe
1890,João Pedro,ITA,Cagliari,Serie A,2018,26.0,1992.0,28.4,17,12,4,8,5,4,11,36.4,7,14,5,9,6,23,14,0,"FW,MF",25-29,Forward,Italy,Europe
1890,João Pedro,ITA,Cagliari,Serie A,2018,26.0,1992.0,28.4,17,12,4,8,5,4,11,36.4,7,14,5,9,6,23,14,0,"FW,MF",25-29,Forward,Italy,Europe
1890,João Pedro,ITA,Cagliari,Serie A,2018,26.0,1992.0,28.4,17,12,4,8,5,4,11,36.4,7,14,5,9,6,23,14,0,"FW,MF",25-29,Forward,Italy,Europe
1890,João Pedro,ITA,Cagliari,Serie A,2018,26.0,1992.0,28.4,17,12,4,8,5,4,11,36.4,7,14,5,9,6,23,14,0,"FW,MF",25-29,Forward,Italy,Europe
1890,João Pedro,ITA,Cagliari,Serie A,2018,26.0,1992.0,28.4,17,12,4,8,5,4,11,36.4,7,14,5,9,6,23,14,0,"FW,MF",25-29,Forward,Italy,Europe
1890,João Pedro,ITA,Cagliari,Serie A,2018,26.0,1992.0,28.4,17,12,4,8,5,4,11,36.4,7,14,5,9,6,23,14,0,"FW,MF",25-29,Forward,Italy,Europe
1890,João Pedro,ITA,Cagliari,Serie A,2018,26.0,1992.0,28.4,17,12,4,8,5,4,11,36.4,7,14,5,9,6,23,14,0,"FW,MF",25-29,Forward,Italy,Europe
1890,João Pedro,ITA,Cagliari,Serie A,2018,26.0,1992.0,28.4,17,12,4,8,5,4,11,36.4,7,14,5,9,6,23,14,0,"FW,MF",25-29,Forward,Italy,Europe
1890,João Pedro,ITA,Cagliari,Serie A,2018,26.0,1992.0,28.4,17,12,4,8,5,4,11,36.4,7,14,5,9,6,23,14,0,"FW,MF",25-29,Forward,Italy,Europe
1890,João Pedro,ITA,Cagliari,Serie A,2018,26.0,1992.0,28.4,17,12,4,8,5,4,11,36.4,7,14,5,9,6,23,14,0,"FW,MF",25-29,Forward,Italy,Europe
1890,João Pedro,ITA,Cagliari,Serie A,2018,26.0,1992.0,28.4,17,12,4,8,5,4,11,36.4,7,14,5,9,6,23,14,0,"FW,MF",25-29,Forward,Italy,Europe
1890,João Pedro,ITA,Cagliari,Serie A,2018,26.0,1992.0,28.4,17,12,4,8,5,4,11,36.4,7,14,5,9,6,23,14,0,"FW,MF",25-29,Forward,Italy,Europe
1890,João Pedro,ITA,Cagliari,Serie A,2018,26.0,1992.0,28.4,17,12,4,8,5,4,11,36.4,7,14,5,9,6,23,14,0,"FW,MF",25-29,Forward,Italy,Europe
1890,João Pedro,ITA,Cagliari,Serie A,2018,26.0,1992.0,28.4,17,12,4,8,5,4,11,36.4,7,14,5,9,6,23,14,0,"FW,MF",25-29,Forward,Italy,Europe
1890,João Pedro,ITA,Cagliari,Serie A,2018,26.0,1992.0,28.4,17,12,4,8,5,4,11,36.4,7,14,5,9,6,23,14,0,"FW,MF",25-29,Forward,Italy,Europe
1890,João Pedro,ITA,Cagliari,Serie A,2018,26.0,1992.0,28.4,17,12,4,8,5,4,11,36.4,7,14,5,9,6,23,14,0,"FW,MF",25-29,Forward,Italy,Europe
1890,João Pedro,ITA,Cagliari,Serie A,2018,26.0,1992.0,28.4,17,12,4,8,5,4,11,36.4,7,14,5,9,6,23,14,0,"FW,MF",25-29,Forward,Italy,Europe
1890,João Pedro,ITA,Cagliari,Serie A,2018,26.0,1992.0,28.4,17,12,4,8,5,4,11,36.4,7,14,5,9,6,23,14,0,"FW,MF",25-29,Forward,Italy,Europe
1890,João Pedro,ITA,Cagliari,Serie A,2018,26.0,1992.0,28.4,17,12,4,8,5,4,11,36.4,7,14,5,9,6,23,14,0,"FW,MF",25-29,Forward,Italy,Europe
1890,João Pedro,ITA,Cagliari,Serie A,2018,26.0,1992.0,28.4,17,12,4,8,5,4,11,36.4,7,14,5,9,6,23,14,0,"FW,MF",25-29,Forward,Italy,Europe
1890,João Pedro,ITA,Cagliari,Serie A,2018,26.0,1992.0,28.4,17,12,4,8,5,4,11,36.4,7,14,5,9,6,23,14,0,"FW,MF",25-29,Forward,Italy,Europe
1890,João Pedro,ITA,Cagliari,Serie A,2018,26.0,1992.0,28.4,17,12,4,8,5,4,11,36.4,7,14,5,9,6,23,14,0,"FW,MF",25-29,Forward,Italy,Europe
1890,João Pedro,ITA,Cagliari,Serie A,2018,26.0,1992.0,28.4,17,12,4,8,5,4,11,36.4,7,14,5,9,6,23,14,0,"FW,MF",25-29,Forward,Italy,Europe
1890,João Pedro,ITA,Cagliari,Serie A,2018,26.0,1992.0,28.4,17,12,4,8,5,4,11,36.4,7,14,5,9,6,23,14,0,"FW,MF",25-29,Forward,Italy,Europe
1890,João Pedro,ITA,Cagliari,Serie A,2018,26.0,1992.0,28.4,17,12,4,8,5,4,11,36.4,7,14,5,9,6,23,14,0,"FW,MF",25-29,Forward,Italy,Europe
1890,João Pedro,ITA,Cagliari,Serie A,2018,26.0,1992.0,28.4,17,12,4,8,5,4,11,36.4,7,14,5,9,6,23,14,0,"FW,MF",25-29,Forward,Italy,Europe
1890,João Pedro,ITA,Cagliari,Serie A,2018,26.0,1992.0,28.4,17,12,4,8,5,4,11,36.4,7,14,5,9,6,23,14,0,"FW,MF",25-29,Forward,Italy,Europe
1890,João Pedro,ITA,Cagliari,Serie A,2018,26.0,1992.0,28.4,17,12,4,8,5,4,11,36.4,7,14,5,9,6,23,14,0,"FW,MF",25-29,Forward,Italy,Europe
1890,João Pedro,ITA,Cagliari,Serie A,2018,26.0,1992.0,28.4,17,12,4,8,5,4,11,36.4,7,14,5,9,6,23,14,0,"FW,MF",25-29,Forward,Italy,Europe
1890,João Pedro,ITA,Cagliari,Serie A,2018,26.0,1992.0,28.4,17,12,4,8,5,4,11,36.4,7,14,5,9,6,23,14,0,"FW,MF",25-29,Forward,Italy,Europe
1890,João Pedro,ITA,Cagliari,Serie A,2018,26.0,1992.0,28.4,17,12,4,8,5,4,11,36.4,7,14,5,9,6,23,14,0,"FW,MF",25-29,Forward,Italy,Europe
1890,João Pedro,ITA,Cagliari,Serie A,2018,26.0,1992.0,28.4,17,12,4,8,5,4,11,36.4,7,14,5,9,6,23,14,0,"FW,MF",25-29,Forward,Italy,Europe
1890,João Pedro,ITA,Cagliari,Serie A,2018,26.0,1992.0,28.4,17,12,4,8,5,4,11,36.4,7,14,5,9,6,23,14,0,"FW,MF",25-29,Forward,Italy,Europe
1890,João Pedro,ITA,Cagliari,Serie A,2018,26.0,1992.0,28.4,17,12,4,8,5,4,11,36.4,7,14,5,9,6,23,14,0,"FW,MF",25-29,Forward,Italy,Europe
1890,João Pedro,ITA,Cagliari,Serie A,2018,26.0,1992.0,28.4,17,12,4,8,5,4,11,36.4,7,14,5,9,6,23,14,0,"FW,MF",25-29,Forward,Italy,Europe
1890,João Pedro,ITA,Cagliari,Serie A,2018,26.0,1992.0,28.4,17,12,4,8,5,4,11,36.4,7,14,5,9,6,23,14,0,"FW,MF",25-29,Forward,Italy,Europe
1890,João Pedro,ITA,Cagliari,Serie A,2018,26.0,1992.0,28.4,17,12,4,8,5,4,11,36.4,7,14,5,9,6,23,14,0,"FW,MF",25-29,Forward,Italy,Europe
1890,João Pedro,ITA,Cagliari,Serie A,2018,26.0,1992.0,28.4,17,12,4,8,5,4,11,36.4,7,14,5,9,6,23,14,0,"FW,MF",25-29,Forward,Italy,Europe
1890,João Pedro,ITA,Cagliari,Serie A,2018,26.0,1992.0,28.4,17,12,4,8,5,4,11,36.4,7,14,5,9,6,23,14,0,"FW,MF",25-29,Forward,Italy,Europe
1890,João Pedro,ITA,Cagliari,Serie A,2018,26.0,1992.0,28.4,17,12,4,8,5,4,11,36.4,7,14,5,9,6,23,14,0,"FW,MF",25-29,Forward,Italy,Europe
1890,João Pedro,ITA,Cagliari,Serie A,2018,26.0,1992.0,28.4,17,12,4,8,5,4,11,36.4,7,14,5,9,6,23,14,0,"FW,MF",25-29,Forward,Italy,Europe
1890,João Pedro,ITA,Cagliari,Serie A,2018,26.0,1992.0,28.4,17,12,4,8,5,4,11,36.4,7,14,5,9,6,23,14,0,"FW,MF",25-29,Forward,Italy,Europe
1890,João Pedro,ITA,Cagliari,Serie A,2018,26.0,1992.0,28.4,17,12,4,8,5,4,11,36.4,7,14,5,9,6,23,14,0,"FW,MF",25-29,Forward,Italy,Europe
1890,João Pedro,ITA,Cagliari,Serie A,2018,26.0,1992.0,28.4,17,12,4,8,5,4,11,36.4,7,14,5,9,6,23,14,0,"FW,MF",25-29,Forward,Italy,Europe
1890,João Pedro,ITA,Cagliari,Serie A,2018,26.0,1992.0,28.4,17,12,4,8,5,4,11,36.4,7,14,5,9,6,23,14,0,"FW,MF",25-29,Forward,Italy,Europe
1892,Stef Peeters,BEL,Caen,Ligue 1,2018,26.0,1992.0,4.5,15,8,8,4,3,4,11,36.4,7,1,0,1,6,21,1,0,MF,25-29,Midfielder,Belgium,Europe
1893,Jordan Pefok,USA,Rennes,Ligue 1,2018,22.0,1996.0,6.8,6,2,0,3,3,2,4,50.0,2,7,2,5,4,10,5,0,FW,20-24,Forward,United States,North America
1894,Gianluca Pegolo,ITA,Sassuolo,Serie A,2018,37.0,1981.0,2.3,0,0,0,0,0,0,0,,0,0,0,0,0,0,0,0,GK,35-39,Goalkeeper,Italy,Europe
1895,Peter Pekarík,SVK,Hertha BSC,Bundesliga,2018,31.0,1986.0,2.4,2,1,1,1,0,1,3,33.3,2,2,1,1,1,3,5,0,DF,30-34,Defender,Slovakia,Europe
1896,Pelé,GNB,Monaco,Ligue 1,2018,26.0,1991.0,5.2,8,7,3,5,0,2,6,33.3,4,2,1,1,3,11,10,0,MF,25-29,Midfielder,Guinea-Bissau,Africa
1896,Pelé,GNB,Monaco,Ligue 1,2018,26.0,1991.0,5.2,8,7,3,5,0,2,6,33.3,4,2,1,1,3,11,10,0,MF,25-29,Midfielder,Guinea-Bissau,Africa
1896,Pelé,GNB,Monaco,Ligue 1,2018,26.0,1991.0,5.2,8,7,3,5,0,2,6,33.3,4,2,1,1,3,11,10,0,MF,25-29,Midfielder,Guinea-Bissau,Africa
1896,Pelé,GNB,Monaco,Ligue 1,2018,26.0,1991.0,5.2,8,7,3,5,0,2,6,33.3,4,2,1,1,3,11,10,0,MF,25-29,Midfielder,Guinea-Bissau,Africa
1897,Yohann Pelé,FRA,Marseille,Ligue 1,2018,35.0,1982.0,7.6,0,0,0,0,0,0,2,0.0,2,0,0,0,0,0,1,1,GK,35-39,Goalkeeper,France,Europe
1898,Maxime Pélican,FRA,Nice,Ligue 1,2018,20.0,1998.0,1.0,1,1,0,1,0,0,0,,0,1,0,1,0,1,0,0,"FW,MF",20-24,Forward,France,Europe
1899,Pietro Pellegri,ITA,Monaco,Ligue 1,2018,17.0,2001.0,0.9,1,1,0,0,1,0,0,,0,0,0,0,0,1,0,0,"FW,MF",Under 20,Forward,Italy,Europe
1900,Lorenzo Pellegrini,ITA,Roma,Serie A,2018,22.0,1996.0,20.2,39,23,16,18,5,10,30,33.3,20,20,2,18,12,51,21,0,MF,20-24,Midfielder,Italy,Europe
1901,Luca Pellegrini,ITA,Cagliari,Serie A,2018,19.0,1999.0,10.4,28,19,16,11,1,14,25,56.0,11,13,3,10,18,46,22,0,DF,Under 20,Defender,Italy,Europe
1902,Luca Pellegrini,ITA,Roma,Serie A,2018,19.0,1999.0,1.8,1,1,1,0,0,1,2,50.0,1,2,1,1,3,4,2,0,DF,Under 20,Defender,Italy,Europe
1903,Théo Pellenard,FRA,Angers,Ligue 1,2018,24.0,1994.0,5.5,11,6,7,2,2,5,8,62.5,3,6,2,4,5,16,16,0,DF,20-24,Defender,France,Europe
1904,Sergio Pellissier,ITA,Chievo,Serie A,2018,39.0,1979.0,10.6,4,3,1,1,2,3,4,75.0,1,8,1,7,2,6,8,0,FW,35-39,Forward,Italy,Europe
1905,Andy Pelmard,FRA,Nice,Ligue 1,2018,18.0,2000.0,3.1,5,5,3,2,0,1,4,25.0,3,0,0,0,3,8,3,0,DF,Under 20,Defender,France,Europe
1906,Lee Peltier,ENG,Cardiff City,Premier League,2018,31.0,1986.0,17.2,39,25,27,11,1,15,27,55.6,12,18,12,6,18,57,60,0,DF,30-34,Defender,England,Europe
1907,Federico Peluso,ITA,Sassuolo,Serie A,2018,34.0,1984.0,15.1,23,14,15,5,3,13,16,81.3,3,8,3,5,23,46,70,0,DF,30-34,Defender,Italy,Europe
1909,Nicolas Pépé,CIV,Lille,Ligue 1,2018,23.0,1995.0,36.9,27,10,6,15,6,8,35,22.9,27,33,0,33,13,40,11,1,"FW,MF",20-24,Forward,Ivory Coast,Africa
1910,Pepín,EQG,Parma,Serie A,2018,21.0,1996.0,0.9,4,2,3,1,0,1,4,25.0,3,0,0,0,3,7,0,0,MF,20-24,Midfielder,Equatorial Guinea,Africa
1911,Andreas Pereira,BRA,Manchester Utd,Premier League,2018,22.0,1996.0,6.7,8,6,5,2,1,4,15,26.7,11,9,2,7,11,19,8,1,MF,20-24,Midfielder,Brazil,South America
1912,Matheus Pereira,BRA,Nürnberg,Bundesliga,2018,22.0,1996.0,13.7,16,11,4,8,4,2,13,15.4,11,15,2,13,14,30,7,0,"MF,FW",20-24,Midfielder,Brazil,South America
1912,Matheus Pereira,BRA,Nürnberg,Bundesliga,2018,22.0,1996.0,13.7,16,11,4,8,4,2,13,15.4,11,15,2,13,14,30,7,0,"MF,FW",20-24,Midfielder,Brazil,South America
1912,Matheus Pereira,BRA,Nürnberg,Bundesliga,2018,22.0,1996.0,13.7,16,11,4,8,4,2,13,15.4,11,15,2,13,14,30,7,0,"MF,FW",20-24,Midfielder,Brazil,South America
1912,Matheus Pereira,BRA,Nürnberg,Bundesliga,2018,22.0,1996.0,13.7,16,11,4,8,4,2,13,15.4,11,15,2,13,14,30,7,0,"MF,FW",20-24,Midfielder,Brazil,South America
1912,Matheus Pereira,BRA,Nürnberg,Bundesliga,2018,22.0,1996.0,13.7,16,11,4,8,4,2,13,15.4,11,15,2,13,14,30,7,0,"MF,FW",20-24,Midfielder,Brazil,South America
1912,Matheus Pereira,BRA,Nürnberg,Bundesliga,2018,22.0,1996.0,13.7,16,11,4,8,4,2,13,15.4,11,15,2,13,14,30,7,0,"MF,FW",20-24,Midfielder,Brazil,South America
1912,Matheus Pereira,BRA,Nürnberg,Bundesliga,2018,22.0,1996.0,13.7,16,11,4,8,4,2,13,15.4,11,15,2,13,14,30,7,0,"MF,FW",20-24,Midfielder,Brazil,South America
1912,Matheus Pereira,BRA,Nürnberg,Bundesliga,2018,22.0,1996.0,13.7,16,11,4,8,4,2,13,15.4,11,15,2,13,14,30,7,0,"MF,FW",20-24,Midfielder,Brazil,South America
1912,Matheus Pereira,BRA,Nürnberg,Bundesliga,2018,22.0,1996.0,13.7,16,11,4,8,4,2,13,15.4,11,15,2,13,14,30,7,0,"MF,FW",20-24,Midfielder,Brazil,South America
1913,Pedro Pereira,POR,Genoa,Serie A,2018,20.0,1998.0,15.4,20,14,15,2,3,11,19,57.9,8,10,5,5,14,34,55,1,"DF,FW",20-24,Defender,Portugal,Europe
1913,Pedro Pereira,POR,Genoa,Serie A,2018,20.0,1998.0,15.4,20,14,15,2,3,11,19,57.9,8,10,5,5,14,34,55,1,"DF,FW",20-24,Defender,Portugal,Europe
1913,Pedro Pereira,POR,Genoa,Serie A,2018,20.0,1998.0,15.4,20,14,15,2,3,11,19,57.9,8,10,5,5,14,34,55,1,"DF,FW",20-24,Defender,Portugal,Europe
1913,Pedro Pereira,POR,Genoa,Serie A,2018,20.0,1998.0,15.4,20,14,15,2,3,11,19,57.9,8,10,5,5,14,34,55,1,"DF,FW",20-24,Defender,Portugal,Europe
1914,Ricardo Pereira,POR,Leicester City,Premier League,2018,24.0,1993.0,34.7,118,66,66,40,12,54,112,48.2,58,60,6,54,60,178,130,1,"DF,FW",20-24,Defender,Portugal,Europe
1915,Roberto Pereyra,ARG,Watford,Premier League,2018,27.0,1991.0,31.3,21,12,10,10,1,7,24,29.2,17,26,0,26,24,45,27,2,MF,25-29,Midfielder,Argentina,South America
1918,Hernán Pérez,PAR,Espanyol,La Liga,2018,29.0,1989.0,8.8,13,10,8,3,2,6,27,22.2,21,14,3,11,5,18,13,0,"FW,MF",25-29,Forward,Paraguay,South America
1921,Stipe Perica,CRO,Frosinone,Serie A,2018,23.0,1995.0,5.3,5,3,2,2,1,1,3,33.3,2,3,1,2,0,5,4,0,FW,20-24,Forward,Croatia,Europe
1922,Mattia Perin,ITA,Juventus,Serie A,2018,25.0,1992.0,9.0,0,0,0,0,0,0,0,,0,0,0,0,0,0,3,2,GK,25-29,Goalkeeper,Italy,Europe
1923,Ivan Perišić,CRO,Inter,Serie A,2018,29.0,1989.0,30.0,34,26,7,20,7,16,51,31.4,35,40,4,36,23,57,55,0,FW,25-29,Forward,Croatia,Europe
1924,Diego Perotti,ARG,Roma,Serie A,2018,30.0,1988.0,7.4,14,12,5,5,4,6,19,31.6,13,4,0,4,4,18,2,0,"FW,MF",30-34,Forward,Argentina,South America
1925,Loïc Perrin,FRA,Saint-Étienne,Ligue 1,2018,32.0,1985.0,30.0,53,36,34,17,2,20,33,60.6,13,37,24,13,44,97,118,2,DF,30-34,Defender,France,Europe
1926,Pavao Pervan,AUT,Wolfsburg,Bundesliga,2018,30.0,1987.0,8.5,0,0,0,0,0,0,0,,0,0,0,0,0,0,3,1,GK,30-34,Goalkeeper,Austria,Europe
1927,Matteo Pessina,ITA,Atalanta,Serie A,2018,21.0,1997.0,2.6,4,2,0,4,0,2,3,66.7,1,2,1,1,0,4,4,0,"MF,FW",20-24,Midfielder,Italy,Europe
1928,Andrea Petagna,ITA,SPAL,Serie A,2018,23.0,1995.0,33.7,15,6,5,5,5,2,9,22.2,7,23,8,15,4,19,15,0,FW,20-24,Forward,Italy,Europe
1929,Nils Petersen,GER,Freiburg,Bundesliga,2018,29.0,1988.0,21.4,29,21,10,16,3,4,24,16.7,20,28,2,26,13,42,34,0,FW,25-29,Forward,Germany,Europe
1931,Germán Pezzella,ARG,Fiorentina,Serie A,2018,27.0,1991.0,31.7,56,36,42,13,1,31,51,60.8,20,42,30,12,60,116,159,1,DF,25-29,Defender,Argentina,South America
1932,Giuseppe Pezzella,ITA,Udinese,Serie A,2018,20.0,1997.0,2.0,5,4,4,1,0,2,8,25.0,6,2,1,1,1,6,9,0,DF,20-24,Defender,Italy,Europe
1933,Giuseppe Pezzella,ITA,Genoa,Serie A,2018,20.0,1997.0,1.2,2,1,1,1,0,0,0,,0,1,0,1,1,3,4,0,"DF,MF",20-24,Defender,Italy,Europe
1935,Maximilian Philipp,GER,Dortmund,Bundesliga,2018,24.0,1994.0,8.4,7,5,3,4,0,2,9,22.2,7,10,0,10,3,10,6,0,"FW,MF",20-24,Forward,Germany,Europe
1936,Lebogang Phiri,RSA,Guingamp,Ligue 1,2018,23.0,1994.0,21.4,60,38,16,41,3,24,43,55.8,19,26,3,23,29,89,19,0,MF,20-24,Midfielder,South Africa,Africa
1939,Pablo Piatti,ARG,Espanyol,La Liga,2018,29.0,1989.0,8.3,21,15,8,10,3,8,16,50.0,8,15,0,15,2,23,8,0,"FW,MF",25-29,Forward,Argentina,South America
1940,Lucas Piazon,BRA,Chievo,Serie A,2018,24.0,1994.0,0.9,2,0,1,1,0,0,2,0.0,2,1,0,1,1,3,0,0,"MF,FW",20-24,Midfielder,Brazil,South America
1941,Cristiano Piccini,ITA,Valencia,La Liga,2018,25.0,1992.0,20.8,32,23,25,7,0,13,26,50.0,13,27,7,20,27,59,64,1,DF,25-29,Defender,Italy,Europe
1942,Roberto Piccoli,ITA,Atalanta,Serie A,2018,17.0,2001.0,0.5,2,2,0,1,1,1,1,100.0,0,1,0,1,0,2,0,0,"FW,MF",Under 20,Forward,Italy,Europe
1943,Jordan Pickford,ENG,Everton,Premier League,2018,24.0,1994.0,38.0,0,0,0,0,0,0,0,,0,0,0,0,0,0,20,8,GK,20-24,Goalkeeper,England,Europe
1944,Jérémy Pied,FRA,Lille,Ligue 1,2018,29.0,1989.0,5.2,12,8,5,6,1,3,9,33.3,6,8,1,7,5,17,13,0,DF,25-29,Defender,France,Europe
1945,Ronaël Pierre-Gabriel,FRA,Monaco,Ligue 1,2018,20.0,1998.0,3.9,13,8,10,2,1,9,10,90.0,1,3,1,2,3,16,18,0,DF,20-24,Defender,France,Europe
1946,Erik Pieters,NED,Amiens,Ligue 1,2018,29.0,1988.0,14.0,49,28,28,18,3,25,33,75.8,8,21,13,8,17,66,56,0,DF,25-29,Defender,Netherlands,Europe
1948,Andrea Pinamonti,ITA,Frosinone,Serie A,2018,19.0,1999.0,18.1,14,6,6,5,3,4,20,20.0,16,16,3,13,5,19,17,0,FW,Under 20,Forward,Italy,Europe
1949,Carlo Pinsoglio,ITA,Juventus,Serie A,2018,28.0,1990.0,1.0,0,0,0,0,0,0,0,,0,0,0,0,0,0,0,0,GK,25-29,Goalkeeper,Italy,Europe
1950,Virgile Pinson,FRA,Reims,Ligue 1,2018,22.0,1996.0,0.1,0,0,0,0,0,0,0,,0,0,0,0,0,0,0,0,MF,20-24,Midfielder,France,Europe
1951,Lenny Pintor,FRA,Lyon,Ligue 1,2018,17.0,2000.0,0.0,0,0,0,0,0,0,0,,0,0,0,0,0,0,0,0,FW,Under 20,Forward,France,Europe
1953,Facundo Píriz,URU,Montpellier,Ligue 1,2018,28.0,1990.0,1.3,9,6,3,4,2,4,9,44.4,5,2,1,1,0,9,2,0,"MF,FW",25-29,Midfielder,Uruguay,South America
1954,Fabio Pisacane,ITA,Cagliari,Serie A,2018,32.0,1986.0,25.2,33,17,22,8,3,18,31,58.1,13,36,23,13,23,56,108,0,DF,30-34,Defender,Italy,Europe
1956,Claudio Pizarro,PER,Werder Bremen,Bundesliga,2018,39.0,1978.0,7.7,10,6,4,2,4,4,7,57.1,3,14,1,13,1,11,7,0,FW,35-39,Forward,Peru,South America
1957,Marko Pjaca,CRO,Fiorentina,Serie A,2018,23.0,1995.0,8.3,9,4,3,4,2,2,6,33.3,4,2,0,2,7,16,6,0,"FW,MF",20-24,Forward,Croatia,Europe
1958,Miralem Pjanić,BIH,Juventus,Serie A,2018,28.0,1990.0,25.3,41,20,15,18,8,16,59,27.1,43,34,6,28,36,77,19,2,MF,25-29,Midfielder,Bosnia and Herzegovina,Europe
1962,Marvin Plattenhardt,GER,Hertha BSC,Bundesliga,2018,26.0,1992.0,21.4,27,21,12,10,5,14,21,66.7,7,18,3,15,7,34,56,0,DF,25-29,Defender,Germany,Europe
1963,Stiven Plaza,ECU,Valladolid,La Liga,2018,19.0,1999.0,0.4,0,0,0,0,0,0,0,,0,0,0,0,0,0,0,0,"FW,MF",Under 20,Forward,Ecuador,South America
1964,Alassane Pléa,FRA,Gladbach,Bundesliga,2018,25.0,1993.0,27.8,14,10,7,4,3,5,22,22.7,17,17,2,15,3,17,15,2,FW,25-29,Forward,France,Europe
1965,Luca Plogmann,GER,Werder Bremen,Bundesliga,2018,18.0,2000.0,0.4,0,0,0,0,0,0,0,,0,0,0,0,0,0,0,0,GK,Under 20,Goalkeeper,Germany,Europe
1966,Morgan Poaty,CGO,Montpellier,Ligue 1,2018,21.0,1997.0,1.0,1,1,1,0,0,0,0,,0,1,0,1,0,1,2,0,MF,20-24,Midfielder,Congo,Africa
1967,Paul Pogba,FRA,Manchester Utd,Premier League,2018,25.0,1993.0,33.4,47,30,21,21,5,17,43,39.5,26,30,9,21,18,65,39,0,MF,25-29,Midfielder,France,Europe
1968,Denis-Will Poha,FRA,Rennes,Ligue 1,2018,21.0,1997.0,0.3,0,0,0,0,0,0,1,0.0,1,0,0,0,1,1,1,0,MF,20-24,Midfielder,France,Europe
1969,Andrea Poli,ITA,Bologna,Serie A,2018,28.0,1989.0,21.5,65,47,30,28,7,24,67,35.8,43,36,5,31,35,100,13,2,MF,25-29,Midfielder,Italy,Europe
1970,Matteo Politano,ITA,Inter,Serie A,2018,24.0,1993.0,28.3,18,7,9,4,5,8,30,26.7,22,18,0,18,14,32,10,1,FW,20-24,Forward,Italy,Europe
1971,Pierre-Yves Polomat,FRA,Saint-Étienne,Ligue 1,2018,24.0,1993.0,10.6,18,13,11,6,1,10,18,55.6,8,4,2,2,21,39,27,0,DF,20-24,Defender,France,Europe
1972,Giacomo Poluzzi,ITA,SPAL,Serie A,2018,30.0,1988.0,0.1,0,0,0,0,0,0,0,,0,0,0,0,0,0,0,0,GK,30-34,Goalkeeper,Italy,Europe
1975,Manolo Portanova,ITA,Juventus,Serie A,2018,18.0,2000.0,0.4,1,1,0,1,0,0,1,0.0,1,2,0,2,1,2,2,0,MF,Under 20,Midfielder,Italy,Europe
1978,Stefan Posch,AUT,Hoffenheim,Bundesliga,2018,21.0,1997.0,15.6,45,32,28,15,2,17,28,60.7,11,26,11,15,21,66,58,0,DF,20-24,Defender,Austria,Europe
1980,Yussuf Poulsen,DEN,RB Leipzig,Bundesliga,2018,24.0,1994.0,27.2,20,10,5,10,5,3,25,12.0,22,33,2,31,7,27,28,0,FW,20-24,Forward,Denmark,Europe
1981,Maxime Poundjé,FRA,Bordeaux,Ligue 1,2018,25.0,1992.0,28.2,48,35,34,12,2,31,62,50.0,31,24,5,19,29,77,79,0,DF,25-29,Defender,France,Europe
1982,Gaëtan Poussin,FRA,Bordeaux,Ligue 1,2018,19.0,1999.0,1.0,0,0,0,0,0,0,0,,0,0,0,0,0,0,0,0,GK,Under 20,Goalkeeper,France,Europe
1984,Dennis Praet,BEL,Sampdoria,Serie A,2018,24.0,1994.0,32.1,62,44,30,25,7,27,51,52.9,24,33,4,29,36,98,31,0,MF,20-24,Midfielder,Belgium,Europe
1985,Sanjin Prcić,BIH,Levante,La Liga,2018,24.0,1993.0,5.9,18,13,7,9,2,5,11,45.5,6,11,7,4,11,29,11,1,MF,20-24,Midfielder,Bosnia and Herzegovina,Europe
1986,Sanjin Prcić,BIH,Strasbourg,Ligue 1,2018,24.0,1993.0,11.7,19,14,11,7,1,8,18,44.4,10,22,8,14,18,37,7,1,MF,20-24,Midfielder,Bosnia and Herzegovina,Europe
1987,Nicolas de Préville,FRA,Bordeaux,Ligue 1,2018,27.0,1991.0,14.1,28,19,10,15,3,8,29,27.6,21,23,1,22,10,38,21,1,"FW,MF",25-29,Forward,France,Europe
1988,Edgar Prib,GER,Hannover 96,Bundesliga,2018,28.0,1989.0,2.2,10,9,3,5,2,2,4,50.0,2,4,0,4,2,12,1,0,MF,25-29,Midfielder,Germany,Europe
1989,Alex Pritchard,ENG,Huddersfield,Premier League,2018,25.0,1993.0,23.1,36,24,10,18,8,10,35,28.6,25,26,2,24,17,53,9,0,"MF,FW",25-29,Midfielder,England,Europe
1990,Sebastian Prödl,AUT,Watford,Premier League,2018,31.0,1987.0,0.1,0,0,0,0,0,0,0,,0,0,0,0,0,0,0,0,DF,30-34,Defender,Austria,Europe
1991,Quincy Promes,NED,Sevilla,La Liga,2018,26.0,1992.0,17.6,35,25,23,9,3,15,22,68.2,7,19,3,16,25,60,22,1,"FW,DF",25-29,Forward,Netherlands,Europe
1992,Davy Pröpper,NED,Brighton,Premier League,2018,26.0,1991.0,28.3,50,28,23,21,6,16,52,30.8,36,21,6,15,53,103,37,0,MF,25-29,Midfielder,Netherlands,Europe
1993,Silvio Proto,BEL,Lazio,Serie A,2018,35.0,1983.0,2.0,0,0,0,0,0,0,1,0.0,1,0,0,0,0,0,1,0,GK,35-39,Goalkeeper,Belgium,Europe
1994,Ivan Provedel,ITA,Empoli,Serie A,2018,24.0,1994.0,16.0,0,0,0,0,0,0,1,0.0,1,0,0,0,0,0,4,0,GK,20-24,Goalkeeper,Italy,Europe
1996,Manuel Pucciarelli,ITA,Chievo,Serie A,2018,27.0,1991.0,3.4,4,2,2,1,1,2,5,40.0,3,5,0,5,3,7,4,0,FW,25-29,Forward,Italy,Europe
1998,Erick Pulgar,CHI,Bologna,Serie A,2018,24.0,1994.0,26.2,65,36,35,23,7,22,73,30.1,51,35,5,30,50,115,54,1,MF,20-24,Midfielder,Chile,South America
2000,Christian Pulisic,USA,Dortmund,Bundesliga,2018,19.0,1998.0,10.4,10,6,2,6,2,2,6,33.3,4,12,2,10,6,16,10,0,FW,Under 20,Forward,United States,North America
2001,Jason Puncheon,ENG,Crystal Palace,Premier League,2018,32.0,1986.0,0.1,1,1,1,0,0,0,0,,0,0,0,0,0,1,0,0,MF,30-34,Midfielder,England,Europe
2002,Jason Puncheon,ENG,Huddersfield,Premier League,2018,32.0,1986.0,4.2,7,4,1,5,1,1,7,14.3,6,3,1,2,3,10,8,0,MF,30-34,Midfielder,England,Europe
2003,Ignacio Pussetto,ARG,Udinese,Serie A,2018,22.0,1995.0,24.2,65,40,25,30,10,15,43,34.9,28,28,3,25,29,94,34,0,"FW,MF",20-24,Forward,Argentina,South America
2004,Fabio Quagliarella,ITA,Sampdoria,Serie A,2018,35.0,1983.0,35.5,14,8,6,4,4,2,15,13.3,13,32,1,31,8,22,17,0,FW,35-39,Forward,Italy,Europe
2005,Robin Quaison,SWE,Mainz 05,Bundesliga,2018,24.0,1993.0,24.4,19,12,3,10,6,5,12,41.7,7,9,1,8,7,26,4,0,"FW,MF",20-24,Forward,Sweden,Europe
2006,Collin Quaner,GER,Huddersfield,Premier League,2018,27.0,1991.0,0.4,0,0,0,0,0,0,1,0.0,1,0,0,0,0,0,0,0,FW,25-29,Forward,Germany,Europe
2007,Domingos Quina,POR,Watford,Premier League,2018,18.0,1999.0,3.8,9,7,3,5,1,3,11,27.3,8,6,0,6,3,12,1,0,MF,Under 20,Midfielder,Portugal,Europe
2010,Adrien Rabiot,FRA,Paris S-G,Ligue 1,2018,23.0,1995.0,11.8,35,20,13,17,5,9,12,75.0,3,9,2,7,10,45,20,0,MF,20-24,Midfielder,France,Europe
2014,Ionuț Radu,ROU,Genoa,Serie A,2018,21.0,1997.0,33.0,0,0,0,0,0,0,1,0.0,1,0,0,0,1,1,11,4,GK,20-24,Goalkeeper,Romania,Europe
2015,Ștefan Radu,ROU,Lazio,Serie A,2018,31.0,1986.0,24.9,43,27,24,15,4,25,38,65.8,13,20,14,6,42,85,85,1,DF,30-34,Defender,Romania,Europe
2016,Rafael,BRA,Lyon,Ligue 1,2018,28.0,1990.0,11.4,31,19,14,12,5,17,24,70.8,7,19,2,17,15,46,30,2,DF,25-29,Defender,Brazil,South America
2016,Rafael,BRA,Lyon,Ligue 1,2018,28.0,1990.0,11.4,31,19,14,12,5,17,24,70.8,7,19,2,17,15,46,30,2,DF,25-29,Defender,Brazil,South America
2016,Rafael,BRA,Lyon,Ligue 1,2018,28.0,1990.0,11.4,31,19,14,12,5,17,24,70.8,7,19,2,17,15,46,30,2,DF,25-29,Defender,Brazil,South America
2016,Rafael,BRA,Lyon,Ligue 1,2018,28.0,1990.0,11.4,31,19,14,12,5,17,24,70.8,7,19,2,17,15,46,30,2,DF,25-29,Defender,Brazil,South America
2017,Raffael,BRA,Gladbach,Bundesliga,2018,33.0,1985.0,6.0,8,4,2,4,2,2,7,28.6,5,5,0,5,1,9,0,0,FW,30-34,Forward,Brazil,South America
2018,Rafinha,BRA,Barcelona,La Liga,2018,25.0,1993.0,2.5,8,6,2,3,3,2,2,100.0,0,5,1,4,1,9,2,0,"FW,MF",25-29,Forward,Brazil,South America
2018,Rafinha,BRA,Barcelona,La Liga,2018,25.0,1993.0,2.5,8,6,2,3,3,2,2,100.0,0,5,1,4,1,9,2,0,"FW,MF",25-29,Forward,Brazil,South America
2018,Rafinha,BRA,Barcelona,La Liga,2018,25.0,1993.0,2.5,8,6,2,3,3,2,2,100.0,0,5,1,4,1,9,2,0,"FW,MF",25-29,Forward,Brazil,South America
2018,Rafinha,BRA,Barcelona,La Liga,2018,25.0,1993.0,2.5,8,6,2,3,3,2,2,100.0,0,5,1,4,1,9,2,0,"FW,MF",25-29,Forward,Brazil,South America
2018,Rafinha,BRA,Barcelona,La Liga,2018,25.0,1993.0,2.5,8,6,2,3,3,2,2,100.0,0,5,1,4,1,9,2,0,"FW,MF",25-29,Forward,Brazil,South America
2018,Rafinha,BRA,Barcelona,La Liga,2018,25.0,1993.0,2.5,8,6,2,3,3,2,2,100.0,0,5,1,4,1,9,2,0,"FW,MF",25-29,Forward,Brazil,South America
2018,Rafinha,BRA,Barcelona,La Liga,2018,25.0,1993.0,2.5,8,6,2,3,3,2,2,100.0,0,5,1,4,1,9,2,0,"FW,MF",25-29,Forward,Brazil,South America
2018,Rafinha,BRA,Barcelona,La Liga,2018,25.0,1993.0,2.5,8,6,2,3,3,2,2,100.0,0,5,1,4,1,9,2,0,"FW,MF",25-29,Forward,Brazil,South America
2018,Rafinha,BRA,Barcelona,La Liga,2018,25.0,1993.0,2.5,8,6,2,3,3,2,2,100.0,0,5,1,4,1,9,2,0,"FW,MF",25-29,Forward,Brazil,South America
2018,Rafinha,BRA,Barcelona,La Liga,2018,25.0,1993.0,2.5,8,6,2,3,3,2,2,100.0,0,5,1,4,1,9,2,0,"FW,MF",25-29,Forward,Brazil,South America
2018,Rafinha,BRA,Barcelona,La Liga,2018,25.0,1993.0,2.5,8,6,2,3,3,2,2,100.0,0,5,1,4,1,9,2,0,"FW,MF",25-29,Forward,Brazil,South America
2018,Rafinha,BRA,Barcelona,La Liga,2018,25.0,1993.0,2.5,8,6,2,3,3,2,2,100.0,0,5,1,4,1,9,2,0,"FW,MF",25-29,Forward,Brazil,South America
2018,Rafinha,BRA,Barcelona,La Liga,2018,25.0,1993.0,2.5,8,6,2,3,3,2,2,100.0,0,5,1,4,1,9,2,0,"FW,MF",25-29,Forward,Brazil,South America
2018,Rafinha,BRA,Barcelona,La Liga,2018,25.0,1993.0,2.5,8,6,2,3,3,2,2,100.0,0,5,1,4,1,9,2,0,"FW,MF",25-29,Forward,Brazil,South America
2018,Rafinha,BRA,Barcelona,La Liga,2018,25.0,1993.0,2.5,8,6,2,3,3,2,2,100.0,0,5,1,4,1,9,2,0,"FW,MF",25-29,Forward,Brazil,South America
2018,Rafinha,BRA,Barcelona,La Liga,2018,25.0,1993.0,2.5,8,6,2,3,3,2,2,100.0,0,5,1,4,1,9,2,0,"FW,MF",25-29,Forward,Brazil,South America
2019,Rafinha,BRA,Bayern Munich,Bundesliga,2018,32.0,1985.0,10.0,15,7,6,6,3,6,14,42.9,8,8,3,5,19,34,11,0,DF,30-34,Defender,Brazil,South America
2019,Rafinha,BRA,Bayern Munich,Bundesliga,2018,32.0,1985.0,10.0,15,7,6,6,3,6,14,42.9,8,8,3,5,19,34,11,0,DF,30-34,Defender,Brazil,South America
2019,Rafinha,BRA,Bayern Munich,Bundesliga,2018,32.0,1985.0,10.0,15,7,6,6,3,6,14,42.9,8,8,3,5,19,34,11,0,DF,30-34,Defender,Brazil,South America
2019,Rafinha,BRA,Bayern Munich,Bundesliga,2018,32.0,1985.0,10.0,15,7,6,6,3,6,14,42.9,8,8,3,5,19,34,11,0,DF,30-34,Defender,Brazil,South America
2019,Rafinha,BRA,Bayern Munich,Bundesliga,2018,32.0,1985.0,10.0,15,7,6,6,3,6,14,42.9,8,8,3,5,19,34,11,0,DF,30-34,Defender,Brazil,South America
2019,Rafinha,BRA,Bayern Munich,Bundesliga,2018,32.0,1985.0,10.0,15,7,6,6,3,6,14,42.9,8,8,3,5,19,34,11,0,DF,30-34,Defender,Brazil,South America
2019,Rafinha,BRA,Bayern Munich,Bundesliga,2018,32.0,1985.0,10.0,15,7,6,6,3,6,14,42.9,8,8,3,5,19,34,11,0,DF,30-34,Defender,Brazil,South America
2019,Rafinha,BRA,Bayern Munich,Bundesliga,2018,32.0,1985.0,10.0,15,7,6,6,3,6,14,42.9,8,8,3,5,19,34,11,0,DF,30-34,Defender,Brazil,South America
2019,Rafinha,BRA,Bayern Munich,Bundesliga,2018,32.0,1985.0,10.0,15,7,6,6,3,6,14,42.9,8,8,3,5,19,34,11,0,DF,30-34,Defender,Brazil,South America
2019,Rafinha,BRA,Bayern Munich,Bundesliga,2018,32.0,1985.0,10.0,15,7,6,6,3,6,14,42.9,8,8,3,5,19,34,11,0,DF,30-34,Defender,Brazil,South America
2019,Rafinha,BRA,Bayern Munich,Bundesliga,2018,32.0,1985.0,10.0,15,7,6,6,3,6,14,42.9,8,8,3,5,19,34,11,0,DF,30-34,Defender,Brazil,South America
2019,Rafinha,BRA,Bayern Munich,Bundesliga,2018,32.0,1985.0,10.0,15,7,6,6,3,6,14,42.9,8,8,3,5,19,34,11,0,DF,30-34,Defender,Brazil,South America
2019,Rafinha,BRA,Bayern Munich,Bundesliga,2018,32.0,1985.0,10.0,15,7,6,6,3,6,14,42.9,8,8,3,5,19,34,11,0,DF,30-34,Defender,Brazil,South America
2019,Rafinha,BRA,Bayern Munich,Bundesliga,2018,32.0,1985.0,10.0,15,7,6,6,3,6,14,42.9,8,8,3,5,19,34,11,0,DF,30-34,Defender,Brazil,South America
2019,Rafinha,BRA,Bayern Munich,Bundesliga,2018,32.0,1985.0,10.0,15,7,6,6,3,6,14,42.9,8,8,3,5,19,34,11,0,DF,30-34,Defender,Brazil,South America
2019,Rafinha,BRA,Bayern Munich,Bundesliga,2018,32.0,1985.0,10.0,15,7,6,6,3,6,14,42.9,8,8,3,5,19,34,11,0,DF,30-34,Defender,Brazil,South America
2020,Andrea Raggi,ITA,Monaco,Ligue 1,2018,34.0,1984.0,5.5,7,5,7,0,0,6,6,100.0,0,1,0,1,7,14,21,0,DF,30-34,Defender,Italy,Europe
2021,Baba Rahman,GHA,Reims,Ligue 1,2018,24.0,1994.0,10.7,26,20,17,8,1,18,21,85.7,3,21,3,18,16,42,37,2,DF,20-24,Defender,Ghana,Africa
2022,Baba Rahman,GHA,Schalke 04,Bundesliga,2018,24.0,1994.0,1.8,3,1,1,1,1,1,1,100.0,0,3,0,3,2,5,2,0,DF,20-24,Defender,Ghana,Africa
2023,Ivan Rakitić,CRO,Barcelona,La Liga,2018,30.0,1988.0,29.4,30,24,10,14,6,12,37,32.4,25,32,8,24,51,81,33,0,MF,30-34,Midfielder,Croatia,Europe
2024,Joe Ralls,ENG,Cardiff City,Premier League,2018,24.0,1993.0,21.8,45,23,21,21,3,10,33,30.3,23,21,6,15,29,74,30,0,MF,20-24,Midfielder,England,Europe
2026,Benito Raman,BEL,Düsseldorf,Bundesliga,2018,23.0,1994.0,18.7,35,20,14,16,5,11,53,20.8,42,30,2,28,15,50,8,0,"MF,FW",20-24,Midfielder,Belgium,Europe
2027,Adil Rami,FRA,Marseille,Ligue 1,2018,32.0,1985.0,15.7,14,9,12,2,0,8,12,66.7,4,14,14,0,18,32,52,3,DF,30-34,Defender,France,Europe
2028,Gastón Ramírez,URU,Sampdoria,Serie A,2018,27.0,1990.0,17.5,38,22,12,18,8,11,31,35.5,20,28,4,24,8,46,27,0,MF,25-29,Midfielder,Uruguay,South America
2033,Aaron Ramsey,WAL,Arsenal,Premier League,2018,27.0,1990.0,14.8,34,18,11,15,8,7,25,28.0,18,7,1,6,9,43,3,0,MF,25-29,Midfielder,Wales,Europe
2033,Aaron Ramsey,WAL,Arsenal,Premier League,2018,27.0,1990.0,14.8,34,18,11,15,8,7,25,28.0,18,7,1,6,9,43,3,0,MF,25-29,Midfielder,Wales,Europe
2033,Aaron Ramsey,WAL,Arsenal,Premier League,2018,27.0,1990.0,14.8,34,18,11,15,8,7,25,28.0,18,7,1,6,9,43,3,0,MF,25-29,Midfielder,Wales,Europe
2033,Aaron Ramsey,WAL,Arsenal,Premier League,2018,27.0,1990.0,14.8,34,18,11,15,8,7,25,28.0,18,7,1,6,9,43,3,0,MF,25-29,Midfielder,Wales,Europe
2034,Kayne Ramsey,ENG,Southampton,Premier League,2018,17.0,2000.0,1.0,0,0,0,0,0,0,0,,0,0,0,0,0,0,7,0,DF,Under 20,Defender,England,Europe
2035,Andrea Ranocchia,ITA,Inter,Serie A,2018,30.0,1988.0,0.7,2,2,1,1,0,0,1,0.0,1,1,0,1,0,2,3,0,"DF,FW",30-34,Defender,Italy,Europe
2036,Marcus Rashford,ENG,Manchester Utd,Premier League,2018,20.0,1997.0,25.9,24,12,4,12,8,7,29,24.1,22,27,0,27,3,27,24,0,FW,20-24,Forward,England,Europe
2038,Jacob Rasmussen,DEN,Empoli,Serie A,2018,21.0,1997.0,11.3,18,12,10,6,2,5,14,35.7,9,18,13,5,12,30,55,1,"DF,MF",20-24,Defender,Denmark,Europe
2039,Giacomo Raspadori,ITA,Sassuolo,Serie A,2018,18.0,2000.0,0.0,0,0,0,0,0,0,0,,0,0,0,0,0,0,0,0,DF,Under 20,Defender,Italy,Europe
2040,Yoric Ravet,FRA,Freiburg,Bundesliga,2018,28.0,1989.0,0.8,2,1,1,0,1,1,2,50.0,1,2,1,1,0,2,1,0,"FW,MF",25-29,Forward,France,Europe
2041,Tim Ream,USA,Fulham,Premier League,2018,30.0,1987.0,22.7,23,14,16,7,0,14,28,50.0,14,19,10,9,25,48,80,2,DF,30-34,Defender,United States,North America
2042,Ante Rebić,CRO,Eint Frankfurt,Bundesliga,2018,24.0,1993.0,22.0,22,9,5,12,5,5,12,41.7,7,18,1,17,8,30,3,0,"FW,MF",20-24,Forward,Croatia,Europe
2043,Pedro Rebocho,POR,Guingamp,Ligue 1,2018,23.0,1995.0,36.0,61,35,31,22,8,29,54,53.7,25,48,13,35,40,101,92,1,DF,20-24,Defender,Portugal,Europe
2046,Nathan Redmond,ENG,Southampton,Premier League,2018,24.0,1994.0,36.3,45,22,14,19,12,14,41,34.1,27,54,2,52,20,65,23,1,"MF,FW",20-24,Midfielder,England,Europe
2047,Vasco Regini,ITA,SPAL,Serie A,2018,27.0,1990.0,0.9,1,0,0,1,0,1,3,33.3,2,2,1,1,0,1,4,0,"DF,FW",25-29,Defender,Italy,Europe
12,Antonio Adán,ESP,Atlético Madrid,La Liga,2018,31.0,1987.0,1.0,0,0,0,0,0,0,0,,0,0,0,0,0,0,0,0,GK,30-34,Goalkeeper,Spain,Europe
13,Aday,ESP,Girona,La Liga,2018,30.0,1987.0,7.2,9,8,2,5,2,6,7,85.7,1,1,0,1,7,16,17,1,"DF,MF",30-34,Defender,Spain,Europe
17,Ali Adnan Kadhim,IRQ,Atalanta,Serie A,2018,24.0,1993.0,1.8,1,1,1,0,0,1,2,50.0,1,1,1,0,3,4,6,0,DF,20-24,Defender,Iraq,Asia
18,Aritz Aduriz,ESP,Athletic Club,La Liga,2018,37.0,1981.0,10.5,4,2,1,1,2,1,7,14.3,6,2,1,1,0,4,4,0,FW,35-39,Forward,Spain,Europe
20,Martin Agirregabiria,ESP,Alavés,La Liga,2018,22.0,1996.0,22.6,45,29,32,10,3,28,46,60.9,18,33,11,22,27,72,65,1,DF,20-24,Defender,Spain,Europe
24,Juan Aguilera,ESP,Huesca,La Liga,2018,32.0,1985.0,3.8,2,2,0,1,1,1,4,25.0,3,4,2,2,4,6,2,0,MF,30-34,Midfielder,Spain,Europe
36,Sergio Akieme,ESP,Rayo Vallecano,La Liga,2018,20.0,1997.0,2.0,3,3,3,0,0,2,2,100.0,0,0,0,0,1,4,5,0,DF,20-24,Defender,Spain,Europe
43,Jordi Alba,ESP,Barcelona,La Liga,2018,29.0,1989.0,33.2,42,22,20,15,7,20,48,41.7,28,24,6,18,60,102,76,1,DF,25-29,Defender,Spain,Europe
44,Luis Alberto,ESP,Lazio,Serie A,2018,25.0,1992.0,22.1,53,22,15,29,9,21,55,38.2,34,23,3,20,10,63,10,0,"MF,FW",25-29,Midfielder,Spain,Europe
45,Raúl Albiol,ESP,Napoli,Serie A,2018,32.0,1985.0,19.0,16,8,12,4,0,8,15,53.3,7,19,16,3,20,36,90,1,DF,30-34,Defender,Spain,Europe
48,Paco Alcácer,ESP,Dortmund,Bundesliga,2018,24.0,1993.0,13.5,3,1,2,0,1,0,6,0.0,6,5,0,5,6,9,7,0,FW,20-24,Forward,Spain,Europe
49,Pedro Alcalá,ESP,Girona,La Liga,2018,29.0,1989.0,20.8,32,23,23,9,0,15,23,65.2,8,21,18,3,36,68,120,0,DF,25-29,Defender,Spain,Europe
50,Thiago Alcántara,ESP,Bayern Munich,Bundesliga,2018,27.0,1991.0,26.8,87,65,31,44,12,25,48,52.1,23,23,4,19,44,131,17,1,MF,25-29,Midfielder,Spain,Europe
51,Rubén Alcaraz,ESP,Valladolid,La Liga,2018,27.0,1991.0,33.1,96,54,50,40,6,32,89,36.0,57,59,10,49,38,134,52,1,MF,25-29,Midfielder,Spain,Europe
53,Álex Alegría,ESP,Rayo Vallecano,La Liga,2018,25.0,1992.0,1.6,1,1,0,1,0,0,3,0.0,3,1,0,1,0,1,0,0,"FW,MF",25-29,Forward,Spain,Europe
55,Iván Alejo,ESP,Getafe,La Liga,2018,23.0,1995.0,1.6,2,0,0,2,0,0,4,0.0,4,2,0,2,0,2,3,0,MF,20-24,Midfielder,Spain,Europe
56,Carles Aleñá,ESP,Barcelona,La Liga,2018,20.0,1998.0,7.1,7,4,0,6,1,2,8,25.0,6,4,0,4,2,9,0,0,MF,20-24,Midfielder,Spain,Europe
69,Marcos Alonso,ESP,Chelsea,Premier League,2018,27.0,1990.0,30.7,73,46,44,22,7,33,58,56.9,25,25,2,23,39,112,101,0,DF,25-29,Defender,Spain,Europe
71,Sergio Álvarez,ESP,Eibar,La Liga,2018,26.0,1992.0,11.9,34,25,12,20,2,13,23,56.5,10,9,4,5,17,51,43,0,"DF,MF",25-29,Defender,Spain,Europe
71,Sergio Álvarez,ESP,Eibar,La Liga,2018,26.0,1992.0,11.9,34,25,12,20,2,13,23,56.5,10,9,4,5,17,51,43,0,"DF,MF",25-29,Defender,Spain,Europe
71,Sergio Álvarez,ESP,Eibar,La Liga,2018,26.0,1992.0,11.9,34,25,12,20,2,13,23,56.5,10,9,4,5,17,51,43,0,"DF,MF",25-29,Defender,Spain,Europe
71,Sergio Álvarez,ESP,Eibar,La Liga,2018,26.0,1992.0,11.9,34,25,12,20,2,13,23,56.5,10,9,4,5,17,51,43,0,"DF,MF",25-29,Defender,Spain,Europe
72,Sergio Álvarez,ESP,Celta Vigo,La Liga,2018,31.0,1986.0,13.0,0,0,0,0,0,0,0,,0,0,0,0,0,0,4,0,GK,30-34,Goalkeeper,Spain,Europe
72,Sergio Álvarez,ESP,Celta Vigo,La Liga,2018,31.0,1986.0,13.0,0,0,0,0,0,0,0,,0,0,0,0,0,0,4,0,GK,30-34,Goalkeeper,Spain,Europe
72,Sergio Álvarez,ESP,Celta Vigo,La Liga,2018,31.0,1986.0,13.0,0,0,0,0,0,0,0,,0,0,0,0,0,0,4,0,GK,30-34,Goalkeeper,Spain,Europe
72,Sergio Álvarez,ESP,Celta Vigo,La Liga,2018,31.0,1986.0,13.0,0,0,0,0,0,0,0,,0,0,0,0,0,0,4,0,GK,30-34,Goalkeeper,Spain,Europe
73,Yeray Álvarez,ESP,Athletic Club,La Liga,2018,23.0,1995.0,29.0,55,30,39,14,2,19,33,57.6,14,35,16,19,63,118,149,1,DF,20-24,Defender,Spain,Europe
93,José Ángel,ESP,Eibar,La Liga,2018,28.0,1989.0,33.6,66,46,36,23,7,31,56,55.4,25,24,5,19,41,107,113,1,DF,25-29,Defender,Spain,Europe
94,Miguel Ángel Moyá,ESP,Real Sociedad,La Liga,2018,34.0,1984.0,11.0,1,1,1,0,0,1,2,50.0,1,0,0,0,1,2,9,2,GK,30-34,Goalkeeper,Spain,Europe
101,Antoñito,ESP,Valladolid,La Liga,2018,30.0,1987.0,20.7,35,21,16,15,4,18,42,42.9,24,21,8,13,18,53,31,0,"DF,MF",30-34,Defender,Spain,Europe
112,Anaitz Arbilla,ESP,Eibar,La Liga,2018,31.0,1987.0,21.7,31,24,25,5,1,17,27,63.0,10,12,5,7,46,77,92,2,DF,30-34,Defender,Spain,Europe
120,José Arnaiz,ESP,Leganés,La Liga,2018,23.0,1995.0,1.3,1,1,1,0,0,0,3,0.0,3,0,0,0,2,3,1,0,"MF,FW",20-24,Midfielder,Spain,Europe
123,Kepa Arrizabalaga,ESP,Chelsea,Premier League,2018,23.0,1994.0,36.0,1,1,1,0,0,1,2,50.0,1,1,0,1,0,1,4,2,GK,20-24,Goalkeeper,Spain,Europe
128,Sergio Asenjo,ESP,Villarreal,La Liga,2018,29.0,1989.0,32.0,0,0,0,0,0,0,1,0.0,1,0,0,0,3,3,26,2,GK,25-29,Goalkeeper,Spain,Europe
129,Marco Asensio,ESP,Real Madrid,La Liga,2018,22.0,1996.0,19.8,12,8,3,5,4,2,24,8.3,22,16,1,15,14,26,7,0,FW,20-24,Forward,Spain,Europe
130,Iago Aspas,ESP,Celta Vigo,La Liga,2018,30.0,1987.0,25.0,16,11,4,8,4,4,20,20.0,16,14,0,14,16,32,5,0,"FW,MF",30-34,Forward,Spain,Europe
143,Floyd Ayité,TOG,Fulham,Premier League,2018,29.0,1988.0,5.3,4,4,2,1,1,2,6,33.3,4,8,1,7,7,11,5,0,"FW,MF",25-29,Forward,Togo,Africa
144,César Azpilicueta,ESP,Chelsea,Premier League,2018,28.0,1989.0,37.8,105,60,52,40,13,38,67,56.7,29,63,16,47,43,148,91,3,DF,25-29,Defender,Spain,Europe
167,Mikel Balenziaga,ESP,Athletic Club,La Liga,2018,30.0,1988.0,5.8,10,6,7,1,2,5,8,62.5,3,6,2,4,2,12,21,0,DF,30-34,Defender,Spain,Europe
182,Antonín Barák,CZE,Udinese,Serie A,2018,23.0,1994.0,3.7,9,6,4,5,0,2,11,18.2,9,4,0,4,2,11,2,0,"MF,FW",20-24,Midfielder,Czech Republic,Europe
195,Antonio Barragán,ESP,Betis,La Liga,2018,31.0,1987.0,10.4,14,8,9,4,1,2,12,16.7,10,15,4,11,5,19,30,2,"DF,FW",30-34,Defender,Spain,Europe
199,Ander Barrenetxea,ESP,Real Sociedad,La Liga,2018,16.0,2001.0,4.4,7,2,2,0,5,2,8,25.0,6,8,0,8,4,11,1,0,"FW,MF",Under 20,Forward,Spain,Europe
203,Marc Bartra,ESP,Betis,La Liga,2018,27.0,1991.0,32.5,86,55,55,26,5,41,76,53.9,35,46,21,25,60,146,132,2,DF,25-29,Defender,Spain,Europe
208,Borja Bastón,ESP,Alavés,La Liga,2018,25.0,1992.0,16.0,16,7,4,9,3,2,24,8.3,22,16,5,11,4,20,10,0,FW,25-29,Forward,Spain,Europe
218,Jon Bautista,ESP,Real Sociedad,La Liga,2018,23.0,1995.0,6.6,5,3,0,3,2,0,3,0.0,3,8,1,7,5,10,4,0,FW,20-24,Forward,Spain,Europe
225,Ihlas Bebou,TOG,Hannover 96,Bundesliga,2018,24.0,1994.0,11.8,15,9,4,10,1,4,9,44.4,5,18,2,16,9,24,9,0,"MF,FW",20-24,Midfielder,Togo,Africa
228,Jan Bednarek,POL,Southampton,Premier League,2018,22.0,1996.0,23.9,41,25,25,16,0,21,37,56.8,16,44,27,17,71,112,171,0,DF,20-24,Defender,Poland,Europe
236,Héctor Bellerín,ESP,Arsenal,Premier League,2018,23.0,1995.0,17.0,15,12,8,4,3,6,13,46.2,7,17,5,12,20,35,37,3,DF,20-24,Defender,Spain,Europe
238,Fran Beltrán,ESP,Celta Vigo,La Liga,2018,19.0,1999.0,16.9,23,17,8,12,3,13,31,41.9,18,19,2,17,19,42,15,1,MF,Under 20,Midfielder,Spain,Europe
260,Yuri Berchiche,ESP,Athletic Club,La Liga,2018,28.0,1990.0,34.7,46,31,26,11,9,23,46,50.0,23,34,9,25,42,88,82,0,"DF,FW",25-29,Defender,Spain,Europe
261,Álex Berenguer,ESP,Torino,Serie A,2018,23.0,1995.0,16.5,31,20,12,17,2,14,34,41.2,20,20,1,19,8,39,14,0,"MF,DF",20-24,Midfielder,Spain,Europe
262,Bartosz Bereszyński,POL,Sampdoria,Serie A,2018,26.0,1992.0,24.4,46,30,27,15,4,24,51,47.1,27,22,7,15,31,77,76,0,DF,25-29,Defender,Poland,Europe
264,Markel Bergara,ESP,Getafe,La Liga,2018,32.0,1986.0,0.6,2,2,0,1,1,2,3,66.7,1,3,0,3,1,3,2,0,MF,30-34,Midfielder,Spain,Europe
265,Robert Berić,SVN,Saint-Étienne,Ligue 1,2018,27.0,1991.0,13.1,12,5,1,9,2,1,11,9.1,10,8,2,6,4,16,3,0,FW,25-29,Forward,Slovenia,Europe
272,Juan Bernat,ESP,Paris S-G,Ligue 1,2018,25.0,1993.0,20.4,47,32,22,19,6,22,46,47.8,24,19,5,14,20,67,41,1,"DF,MF",25-29,Defender,Spain,Europe
282,Pedro Bigas,ESP,Eibar,La Liga,2018,27.0,1990.0,6.5,4,3,2,0,2,1,5,20.0,4,6,2,4,8,12,22,0,DF,25-29,Defender,Spain,Europe
287,Valter Birsa,SVN,Cagliari,Serie A,2018,31.0,1986.0,3.9,5,3,1,3,1,4,8,50.0,4,5,0,5,4,9,3,0,"MF,FW",30-34,Midfielder,Slovenia,Europe
288,Valter Birsa,SVN,Chievo,Serie A,2018,31.0,1986.0,12.2,14,9,4,7,3,4,17,23.5,13,9,1,8,6,20,13,0,"MF,FW",30-34,Midfielder,Slovenia,Europe
291,Alejandro Blanco,ESP,Alavés,La Liga,2018,19.0,1998.0,0.2,1,1,1,0,0,1,3,33.3,2,1,0,1,0,1,0,0,"FW,MF",Under 20,Forward,Spain,Europe
292,Rubén Blanco,ESP,Celta Vigo,La Liga,2018,23.0,1995.0,25.0,1,0,1,0,0,1,2,50.0,1,1,0,1,2,3,13,2,GK,20-24,Goalkeeper,Spain,Europe
318,Artur Boruc,POL,Bournemouth,Premier League,2018,38.0,1980.0,12.0,1,0,1,0,0,1,3,33.3,2,0,0,0,0,1,1,0,GK,35-39,Goalkeeper,Poland,Europe
338,Darko Brašanac,SRB,Alavés,La Liga,2018,26.0,1992.0,17.6,32,16,15,13,4,10,26,38.5,16,17,4,13,13,45,19,0,MF,25-29,Midfielder,Serbia,Europe
344,Rajko Brežančić,SRB,Huesca,La Liga,2018,28.0,1989.0,0.7,1,0,0,0,1,0,0,,0,0,0,0,0,1,0,0,DF,25-29,Defender,Serbia,Europe
357,Bruno,ESP,Brighton,Premier League,2018,37.0,1980.0,12.6,25,16,20,3,2,14,18,77.8,4,7,2,5,11,36,30,1,DF,35-39,Defender,Spain,Europe
357,Bruno,ESP,Brighton,Premier League,2018,37.0,1980.0,12.6,25,16,20,3,2,14,18,77.8,4,7,2,5,11,36,30,1,DF,35-39,Defender,Spain,Europe
357,Bruno,ESP,Brighton,Premier League,2018,37.0,1980.0,12.6,25,16,20,3,2,14,18,77.8,4,7,2,5,11,36,30,1,DF,35-39,Defender,Spain,Europe
357,Bruno,ESP,Brighton,Premier League,2018,37.0,1980.0,12.6,25,16,20,3,2,14,18,77.8,4,7,2,5,11,36,30,1,DF,35-39,Defender,Spain,Europe
363,Burgui,ESP,Alavés,La Liga,2018,24.0,1993.0,6.2,6,6,4,2,0,1,3,33.3,2,4,0,4,0,6,2,1,"MF,FW",20-24,Midfielder,Spain,Europe
367,Sergio Busquets,ESP,Barcelona,La Liga,2018,30.0,1988.0,30.2,90,60,35,45,10,41,89,46.1,48,43,8,35,54,144,22,1,MF,30-34,Midfielder,Spain,Europe
369,Unai Bustinza,ESP,Leganés,La Liga,2018,26.0,1992.0,22.5,41,31,25,14,2,17,33,51.5,16,31,13,18,53,94,110,2,DF,25-29,Defender,Spain,Europe
372,Jakub Błaszczykowski,POL,Wolfsburg,Bundesliga,2018,32.0,1985.0,0.1,0,0,0,0,0,0,0,,0,0,0,0,0,0,0,0,MF,30-34,Midfielder,Poland,Europe
393,Jordi Calavera,ESP,Eibar,La Liga,2018,22.0,1995.0,0.0,0,0,0,0,0,0,0,,0,0,0,0,0,0,0,0,DF,20-24,Defender,Spain,Europe
394,Fernando Calero,ESP,Valladolid,La Liga,2018,22.0,1995.0,34.8,51,31,33,18,0,23,38,60.5,15,55,31,24,55,106,170,0,DF,20-24,Defender,Spain,Europe
398,José Callejón,ESP,Napoli,Serie A,2018,31.0,1987.0,29.4,34,18,12,14,8,18,57,31.6,39,34,5,29,22,56,11,0,"MF,FW",30-34,Midfielder,Spain,Europe
402,Ignacio Camacho,ESP,Wolfsburg,Bundesliga,2018,28.0,1990.0,6.0,15,9,9,6,0,3,7,42.9,4,7,2,5,18,33,12,0,MF,25-29,Midfielder,Spain,Europe
403,Juanjo Camacho,ESP,Huesca,La Liga,2018,37.0,1980.0,0.4,1,1,1,0,0,1,1,100.0,0,0,0,0,0,1,1,0,"MF,DF",35-39,Midfielder,Spain,Europe
407,Víctor Camarasa,ESP,Cardiff City,Premier League,2018,24.0,1994.0,28.5,28,15,8,15,5,6,31,19.4,25,17,2,15,33,61,28,1,MF,20-24,Midfielder,Spain,Europe
409,Sergio Camello,ESP,Atlético Madrid,La Liga,2018,17.0,2001.0,0.5,1,0,1,0,0,1,1,100.0,0,0,0,0,0,1,0,0,FW,Under 20,Forward,Spain,Europe
410,José Campaña,ESP,Levante,La Liga,2018,25.0,1993.0,35.7,65,45,31,29,5,27,86,31.4,59,51,7,44,48,113,46,1,MF,25-29,Midfielder,Spain,Europe
413,Sergio Canales,ESP,Betis,La Liga,2018,27.0,1991.0,29.5,44,30,19,18,7,11,53,20.8,42,34,3,31,9,53,8,1,MF,25-29,Midfielder,Spain,Europe
416,Ander Capa,ESP,Athletic Club,La Liga,2018,26.0,1992.0,18.2,43,27,32,8,3,13,27,48.1,14,20,2,18,30,73,47,0,"DF,FW",25-29,Defender,Spain,Europe
425,Marc Cardona,ESP,Eibar,La Liga,2018,23.0,1995.0,6.7,7,5,2,1,4,2,6,33.3,4,7,0,7,1,8,3,0,"FW,MF",20-24,Forward,Spain,Europe
433,Dani Carvajal,ESP,Real Madrid,La Liga,2018,26.0,1992.0,23.4,40,24,17,15,8,18,41,43.9,23,31,7,24,26,66,35,0,DF,25-29,Defender,Spain,Europe
441,Samu Castillejo,ESP,Milan,Serie A,2018,23.0,1995.0,11.4,15,10,10,2,3,4,25,16.0,21,16,0,16,8,23,11,0,"FW,MF",20-24,Forward,Spain,Europe
443,Jonny Castro,ESP,Wolves,Premier League,2018,24.0,1994.0,30.8,79,43,42,33,4,31,60,51.7,29,45,8,37,60,139,64,2,"DF,MF",20-24,Defender,Spain,Europe
446,Catena,ESP,Rayo Vallecano,La Liga,2018,23.0,1994.0,2.0,4,4,3,1,0,2,2,100.0,0,4,2,2,8,12,8,0,DF,20-24,Defender,Spain,Europe
447,Craig Cathcart,NIR,Watford,Premier League,2018,29.0,1989.0,34.4,50,31,36,11,3,21,37,56.8,16,42,30,12,38,88,184,4,DF,25-29,Defender,Northern Ireland,Europe
450,Santi Cazorla,ESP,Villarreal,La Liga,2018,33.0,1984.0,29.4,69,34,32,26,11,24,69,34.8,45,35,6,29,28,97,17,1,"MF,FW",30-34,Midfielder,Spain,Europe
451,Dani Ceballos,ESP,Real Madrid,La Liga,2018,21.0,1996.0,13.9,32,21,9,16,7,11,31,35.5,20,26,1,25,15,47,6,0,"MF,FW",20-24,Midfielder,Spain,Europe
453,Petr Čech,CZE,Arsenal,Premier League,2018,36.0,1982.0,6.5,1,1,1,0,0,1,1,100.0,0,0,0,0,0,1,5,2,GK,35-39,Goalkeeper,Czech Republic,Europe
454,Žan Celar,SVN,Roma,Serie A,2018,19.0,1999.0,0.1,0,0,0,0,0,0,0,,0,0,0,0,0,0,0,0,FW,Under 20,Forward,Slovenia,Europe
459,Boštjan Cesar,SVN,Chievo,Serie A,2018,36.0,1982.0,12.0,16,10,9,7,0,7,17,41.2,10,14,8,6,14,30,60,2,DF,35-39,Defender,Slovenia,Europe
469,Chechu,ESP,Rayo Vallecano,La Liga,2018,36.0,1982.0,1.0,0,0,0,0,0,0,2,0.0,2,0,0,0,2,2,5,0,DF,35-39,Defender,Spain,Europe
471,Chema,ESP,Levante,La Liga,2018,26.0,1992.0,13.9,27,19,16,9,2,13,19,68.4,6,19,11,8,19,46,83,0,DF,25-29,Defender,Spain,Europe
487,Per Ciljan Skjelbred,NOR,Hertha BSC,Bundesliga,2018,31.0,1987.0,11.1,26,18,13,12,1,5,22,22.7,17,10,1,9,20,46,14,0,MF,30-34,Midfielder,Norway,Europe
491,Thiago Cionek,POL,SPAL,Serie A,2018,32.0,1986.0,28.2,75,44,46,25,4,29,56,51.8,27,34,22,12,55,130,144,0,DF,30-34,Defender,Poland,Europe
500,Coke,ESP,Levante,La Liga,2018,31.0,1987.0,20.2,44,27,24,17,3,26,56,46.4,30,18,8,10,40,84,54,1,DF,30-34,Defender,Spain,Europe
503,Álex Collado,ESP,Barcelona,La Liga,2018,19.0,1999.0,0.9,1,0,0,1,0,0,1,0.0,1,3,0,3,0,1,2,0,FW,Under 20,Forward,Spain,Europe
507,Santi Comesaña,ESP,Rayo Vallecano,La Liga,2018,21.0,1996.0,22.6,56,35,29,25,2,22,61,36.1,39,30,5,25,30,86,45,2,MF,20-24,Midfielder,Spain,Europe
516,Iñigo Córdoba,ESP,Athletic Club,La Liga,2018,21.0,1997.0,14.7,37,23,15,17,5,14,47,29.8,33,27,0,27,17,54,13,0,"FW,MF",20-24,Forward,Spain,Europe
527,Diego Costa,ESP,Atlético Madrid,La Liga,2018,29.0,1988.0,12.4,4,1,0,4,0,1,8,12.5,7,5,0,5,2,6,6,0,FW,25-29,Forward,Spain,Europe
527,Diego Costa,ESP,Atlético Madrid,La Liga,2018,29.0,1988.0,12.4,4,1,0,4,0,1,8,12.5,7,5,0,5,2,6,6,0,FW,25-29,Forward,Spain,Europe
527,Diego Costa,ESP,Atlético Madrid,La Liga,2018,29.0,1988.0,12.4,4,1,0,4,0,1,8,12.5,7,5,0,5,2,6,6,0,FW,25-29,Forward,Spain,Europe
527,Diego Costa,ESP,Atlético Madrid,La Liga,2018,29.0,1988.0,12.4,4,1,0,4,0,1,8,12.5,7,5,0,5,2,6,6,0,FW,25-29,Forward,Spain,Europe
531,Jaume Costa,ESP,Villarreal,La Liga,2018,30.0,1988.0,16.6,33,21,26,5,2,20,33,60.6,13,12,3,9,21,54,61,0,DF,30-34,Defender,Spain,Europe
533,David Costas,ESP,Celta Vigo,La Liga,2018,23.0,1995.0,13.0,25,13,21,4,0,10,15,66.7,5,12,6,6,18,43,58,1,DF,20-24,Defender,Spain,Europe
551,Marc Cucurella,ESP,Eibar,La Liga,2018,20.0,1998.0,26.2,49,37,13,21,15,10,23,43.5,13,36,3,33,20,69,24,0,"MF,FW",20-24,Midfielder,Spain,Europe
552,Iván Cuéllar,ESP,Leganés,La Liga,2018,34.0,1984.0,33.9,0,0,0,0,0,0,1,0.0,1,0,0,0,2,2,10,0,GK,30-34,Goalkeeper,Spain,Europe
580,Sergi Darder,ESP,Espanyol,La Liga,2018,24.0,1993.0,30.1,60,35,23,32,5,25,69,36.2,44,18,3,15,22,82,30,0,MF,20-24,Midfielder,Spain,Europe
581,Vladimír Darida,CZE,Hertha BSC,Bundesliga,2018,27.0,1990.0,4.2,8,5,3,4,1,2,3,66.7,1,5,0,5,8,16,5,0,MF,25-29,Midfielder,Czech Republic,Europe
586,Steven Davis,NIR,Southampton,Premier League,2018,33.0,1985.0,1.1,2,2,0,2,0,0,0,,0,2,0,2,1,3,5,0,MF,30-34,Midfielder,Northern Ireland,Europe
604,Moisés Delgado,ESP,Valladolid,La Liga,2018,24.0,1994.0,3.0,7,6,3,3,1,2,3,66.7,1,2,1,1,3,10,9,0,DF,20-24,Defender,Spain,Europe
624,Gerard Deulofeu,ESP,Watford,Premier League,2018,24.0,1994.0,23.0,11,6,5,3,3,4,26,15.4,22,16,0,16,14,25,3,0,"FW,MF",20-24,Forward,Spain,Europe
646,Javier Díaz,ESP,Sevilla,La Liga,2018,21.0,1997.0,1.0,0,0,0,0,0,0,0,,0,0,0,0,0,0,0,0,GK,20-24,Goalkeeper,Spain,Europe
651,Adrián Diéguez,ESP,Huesca,La Liga,2018,22.0,1996.0,8.3,16,10,11,4,1,9,16,56.3,7,9,4,5,12,28,46,1,DF,20-24,Defender,Spain,Europe
669,Djené,TOG,Getafe,La Liga,2018,26.0,1991.0,33.1,54,34,43,11,0,26,43,60.5,17,27,11,16,74,128,154,3,DF,25-29,Defender,Togo,Africa
676,Marko Dmitrović,SRB,Eibar,La Liga,2018,26.0,1992.0,24.0,0,0,0,0,0,0,0,,0,0,0,0,2,2,11,3,GK,25-29,Goalkeeper,Serbia,Europe
679,Jaume Doménech,ESP,Valencia,La Liga,2018,27.0,1990.0,4.0,0,0,0,0,0,0,1,0.0,1,0,0,0,0,0,1,0,GK,25-29,Goalkeeper,Spain,Europe
686,Mathieu Dossevi,TOG,Toulouse,Ligue 1,2018,30.0,1988.0,27.4,42,28,20,11,11,13,40,32.5,27,29,1,28,33,75,13,0,"FW,MF",30-34,Forward,Togo,Africa
693,Bartłomiej Drągowski,POL,Fiorentina,Serie A,2018,20.0,1997.0,2.5,0,0,0,0,0,0,0,,0,0,0,0,0,0,2,0,GK,20-24,Goalkeeper,Poland,Europe
694,Bartłomiej Drągowski,POL,Empoli,Serie A,2018,20.0,1997.0,14.0,0,0,0,0,0,0,1,0.0,1,0,0,0,0,0,7,1,GK,20-24,Goalkeeper,Poland,Europe
698,Jaroslav Drobný,CZE,Düsseldorf,Bundesliga,2018,38.0,1979.0,2.0,0,0,0,0,0,0,0,,0,0,0,0,0,0,1,0,GK,35-39,Goalkeeper,Czech Republic,Europe
700,Rubén Duarte,ESP,Alavés,La Liga,2018,22.0,1995.0,30.8,72,35,45,20,7,34,64,53.1,30,46,12,34,57,129,130,1,DF,20-24,Defender,Spain,Europe
714,Hugo Duro,ESP,Getafe,La Liga,2018,18.0,1999.0,4.6,6,4,1,2,3,3,6,50.0,3,6,1,5,3,9,4,0,"MF,FW",Under 20,Midfielder,Spain,Europe
731,Aritz Elustondo,ESP,Real Sociedad,La Liga,2018,24.0,1994.0,25.0,47,29,31,14,2,26,41,63.4,15,23,7,16,39,86,150,0,DF,20-24,Defender,Spain,Europe
732,Gorka Elustondo,ESP,Rayo Vallecano,La Liga,2018,31.0,1987.0,3.2,7,5,4,3,0,5,8,62.5,3,6,1,5,6,13,10,0,"MF,DF",30-34,Midfielder,Spain,Europe
735,Mohamed Elyounoussi,NOR,Southampton,Premier League,2018,23.0,1994.0,8.8,16,12,7,6,3,6,19,31.6,13,11,1,10,6,22,5,0,MF,20-24,Midfielder,Norway,Europe
736,Adri Embarba,ESP,Rayo Vallecano,La Liga,2018,26.0,1992.0,25.4,54,26,20,24,10,22,61,36.1,39,38,2,36,29,83,22,0,"MF,FW",25-29,Midfielder,Spain,Europe
741,Sergi Enrich,ESP,Eibar,La Liga,2018,28.0,1990.0,28.7,27,17,3,11,13,7,30,23.3,23,11,1,10,6,33,14,0,FW,25-29,Forward,Spain,Europe
742,Javier Eraso,ESP,Leganés,La Liga,2018,28.0,1990.0,7.0,6,3,3,2,1,0,6,0.0,6,3,1,2,7,13,4,0,"MF,FW",25-29,Midfielder,Spain,Europe
746,Sergio Escudero,ESP,Sevilla,La Liga,2018,28.0,1989.0,17.2,43,29,20,18,5,18,35,51.4,17,22,4,18,24,67,52,0,"DF,FW",25-29,Defender,Spain,Europe
751,Beñat Etxebarria,ESP,Athletic Club,La Liga,2018,31.0,1987.0,22.6,47,24,14,25,8,19,59,32.2,40,18,1,17,24,71,11,0,MF,30-34,Midfielder,Spain,Europe
752,Xabier Etxeita,ESP,Huesca,La Liga,2018,30.0,1987.0,29.7,47,23,32,12,3,26,47,55.3,21,38,25,13,39,86,163,3,DF,30-34,Defender,Spain,Europe
754,Jonny Evans,NIR,Leicester City,Premier League,2018,30.0,1988.0,22.2,24,13,20,4,0,13,18,72.2,5,28,10,18,33,57,152,3,DF,30-34,Defender,Northern Ireland,Europe
759,Łukasz Fabiański,POL,West Ham,Premier League,2018,33.0,1985.0,38.0,1,0,1,0,0,1,3,33.3,2,0,0,0,1,2,10,1,GK,30-34,Goalkeeper,Poland,Europe
762,Cesc Fàbregas,ESP,Chelsea,Premier League,2018,31.0,1987.0,2.0,6,4,4,2,0,1,5,20.0,4,2,1,1,1,7,0,0,MF,30-34,Midfielder,Spain,Europe
763,Cesc Fàbregas,ESP,Monaco,Ligue 1,2018,31.0,1987.0,10.7,14,10,5,5,4,8,28,28.6,20,12,3,9,9,23,5,1,MF,30-34,Midfielder,Spain,Europe
764,Fabricio,ESP,Fulham,Premier League,2018,30.0,1987.0,2.0,1,1,1,0,0,0,0,,0,0,0,0,0,1,3,2,GK,30-34,Goalkeeper,Spain,Europe
771,Iago Falque,ESP,Torino,Serie A,2018,28.0,1990.0,17.9,13,8,3,8,2,3,16,18.8,13,14,0,14,3,16,2,0,"FW,MF",25-29,Forward,Spain,Europe
785,Kiko Femenía,ESP,Watford,Premier League,2018,27.0,1991.0,22.8,48,30,34,12,2,24,51,47.1,27,24,6,18,36,84,68,0,DF,25-29,Defender,Spain,Europe
788,Aitor Fernández,ESP,Levante,La Liga,2018,27.0,1991.0,16.0,1,0,1,0,0,1,1,100.0,0,0,0,0,1,2,10,1,GK,25-29,Goalkeeper,Spain,Europe
788,Aitor Fernández,ESP,Levante,La Liga,2018,27.0,1991.0,16.0,1,0,1,0,0,1,1,100.0,0,0,0,0,1,2,10,1,GK,25-29,Goalkeeper,Spain,Europe
788,Aitor Fernández,ESP,Levante,La Liga,2018,27.0,1991.0,16.0,1,0,1,0,0,1,1,100.0,0,0,0,0,1,2,10,1,GK,25-29,Goalkeeper,Spain,Europe
788,Aitor Fernández,ESP,Levante,La Liga,2018,27.0,1991.0,16.0,1,0,1,0,0,1,1,100.0,0,0,0,0,1,2,10,1,GK,25-29,Goalkeeper,Spain,Europe
789,Andrés Fernández,ESP,Villarreal,La Liga,2018,31.0,1986.0,6.0,1,0,1,0,0,1,1,100.0,0,0,0,0,0,1,4,1,GK,30-34,Goalkeeper,Spain,Europe
790,Borja Fernández,ESP,Valladolid,La Liga,2018,37.0,1981.0,9.3,17,12,7,9,1,6,16,37.5,10,14,2,12,14,31,25,0,"MF,DF",35-39,Midfielder,Spain,Europe
790,Borja Fernández,ESP,Valladolid,La Liga,2018,37.0,1981.0,9.3,17,12,7,9,1,6,16,37.5,10,14,2,12,14,31,25,0,"MF,DF",35-39,Midfielder,Spain,Europe
790,Borja Fernández,ESP,Valladolid,La Liga,2018,37.0,1981.0,9.3,17,12,7,9,1,6,16,37.5,10,14,2,12,14,31,25,0,"MF,DF",35-39,Midfielder,Spain,Europe
790,Borja Fernández,ESP,Valladolid,La Liga,2018,37.0,1981.0,9.3,17,12,7,9,1,6,16,37.5,10,14,2,12,14,31,25,0,"MF,DF",35-39,Midfielder,Spain,Europe
792,Joaquín Fernández,ESP,Valladolid,La Liga,2018,22.0,1996.0,9.3,16,9,14,1,1,8,16,50.0,8,9,7,2,17,33,45,0,"DF,MF",20-24,Defender,Spain,Europe
792,Joaquín Fernández,ESP,Valladolid,La Liga,2018,22.0,1996.0,9.3,16,9,14,1,1,8,16,50.0,8,9,7,2,17,33,45,0,"DF,MF",20-24,Defender,Spain,Europe
792,Joaquín Fernández,ESP,Valladolid,La Liga,2018,22.0,1996.0,9.3,16,9,14,1,1,8,16,50.0,8,9,7,2,17,33,45,0,"DF,MF",20-24,Defender,Spain,Europe
792,Joaquín Fernández,ESP,Valladolid,La Liga,2018,22.0,1996.0,9.3,16,9,14,1,1,8,16,50.0,8,9,7,2,17,33,45,0,"DF,MF",20-24,Defender,Spain,Europe
793,Valery Fernández,ESP,Girona,La Liga,2018,18.0,1999.0,9.9,20,15,13,6,1,10,17,58.8,7,15,1,14,8,28,10,0,"DF,FW",Under 20,Defender,Spain,Europe
797,David Ferreiro,ESP,Huesca,La Liga,2018,30.0,1988.0,25.3,36,22,13,19,4,11,64,17.2,53,27,1,26,24,60,14,2,"MF,FW",30-34,Midfielder,Spain,Europe
819,Pablo Fornals,ESP,Villarreal,La Liga,2018,22.0,1996.0,27.5,49,26,14,26,9,15,54,27.8,39,32,4,28,24,73,19,0,"MF,FW",20-24,Midfielder,Spain,Europe
823,Iver Fossum,NOR,Hannover 96,Bundesliga,2018,22.0,1996.0,5.1,9,5,1,7,1,4,8,50.0,4,8,2,6,7,16,10,0,MF,20-24,Midfielder,Norway,Europe
840,Javi Fuego,ESP,Villarreal,La Liga,2018,34.0,1984.0,2.6,6,3,5,1,0,4,8,50.0,4,2,0,2,3,9,9,0,MF,30-34,Midfielder,Spain,Europe
846,Mijat Gaćinović,SRB,Eint Frankfurt,Bundesliga,2018,23.0,1995.0,18.1,31,20,7,13,11,11,42,26.2,31,26,1,25,24,55,10,0,MF,20-24,Midfielder,Serbia,Europe
850,Milan Gajić,SRB,Bordeaux,Ligue 1,2018,22.0,1996.0,1.0,2,1,1,0,1,1,1,100.0,0,0,0,0,1,3,7,0,DF,20-24,Defender,Serbia,Europe
851,Javi Galán,ESP,Huesca,La Liga,2018,23.0,1994.0,16.0,61,39,36,23,2,34,59,57.6,25,22,1,21,19,80,52,1,"DF,FW",20-24,Defender,Spain,Europe
853,Álex Gallar,ESP,Huesca,La Liga,2018,26.0,1992.0,11.2,15,9,6,5,4,8,19,42.1,11,9,1,8,9,24,5,0,"MF,FW",25-29,Midfielder,Spain,Europe
854,Enric Gallego,ESP,Huesca,La Liga,2018,31.0,1986.0,17.1,21,15,3,13,5,3,19,15.8,16,17,2,15,8,29,32,0,FW,30-34,Forward,Spain,Europe
855,Álex Gálvez,ESP,Rayo Vallecano,La Liga,2018,29.0,1989.0,15.7,38,28,25,13,0,14,28,50.0,14,7,2,5,45,83,69,1,DF,25-29,Defender,Spain,Europe
862,Borja Garcés,ESP,Atlético Madrid,La Liga,2018,18.0,1999.0,0.2,0,0,0,0,0,0,0,,0,0,0,0,0,0,0,0,FW,Under 20,Forward,Spain,Europe
863,Alberto García,ESP,Rayo Vallecano,La Liga,2018,33.0,1985.0,17.0,1,1,1,0,0,1,3,33.3,2,1,0,1,2,3,1,2,GK,30-34,Goalkeeper,Spain,Europe
864,Aleix García,ESP,Girona,La Liga,2018,21.0,1997.0,18.5,37,19,17,20,0,13,36,36.1,23,21,6,15,21,58,18,0,MF,20-24,Midfielder,Spain,Europe
865,Álvaro García,ESP,Rayo Vallecano,La Liga,2018,25.0,1992.0,19.6,22,19,11,7,4,4,25,16.0,21,24,0,24,19,41,30,0,"FW,MF",25-29,Forward,Spain,Europe
865,Álvaro García,ESP,Rayo Vallecano,La Liga,2018,25.0,1992.0,19.6,22,19,11,7,4,4,25,16.0,21,24,0,24,19,41,30,0,"FW,MF",25-29,Forward,Spain,Europe
865,Álvaro García,ESP,Rayo Vallecano,La Liga,2018,25.0,1992.0,19.6,22,19,11,7,4,4,25,16.0,21,24,0,24,19,41,30,0,"FW,MF",25-29,Forward,Spain,Europe
865,Álvaro García,ESP,Rayo Vallecano,La Liga,2018,25.0,1992.0,19.6,22,19,11,7,4,4,25,16.0,21,24,0,24,19,41,30,0,"FW,MF",25-29,Forward,Spain,Europe
865,Álvaro García,ESP,Rayo Vallecano,La Liga,2018,25.0,1992.0,19.6,22,19,11,7,4,4,25,16.0,21,24,0,24,19,41,30,0,"FW,MF",25-29,Forward,Spain,Europe
865,Álvaro García,ESP,Rayo Vallecano,La Liga,2018,25.0,1992.0,19.6,22,19,11,7,4,4,25,16.0,21,24,0,24,19,41,30,0,"FW,MF",25-29,Forward,Spain,Europe
865,Álvaro García,ESP,Rayo Vallecano,La Liga,2018,25.0,1992.0,19.6,22,19,11,7,4,4,25,16.0,21,24,0,24,19,41,30,0,"FW,MF",25-29,Forward,Spain,Europe
865,Álvaro García,ESP,Rayo Vallecano,La Liga,2018,25.0,1992.0,19.6,22,19,11,7,4,4,25,16.0,21,24,0,24,19,41,30,0,"FW,MF",25-29,Forward,Spain,Europe
865,Álvaro García,ESP,Rayo Vallecano,La Liga,2018,25.0,1992.0,19.6,22,19,11,7,4,4,25,16.0,21,24,0,24,19,41,30,0,"FW,MF",25-29,Forward,Spain,Europe
865,Álvaro García,ESP,Rayo Vallecano,La Liga,2018,25.0,1992.0,19.6,22,19,11,7,4,4,25,16.0,21,24,0,24,19,41,30,0,"FW,MF",25-29,Forward,Spain,Europe
865,Álvaro García,ESP,Rayo Vallecano,La Liga,2018,25.0,1992.0,19.6,22,19,11,7,4,4,25,16.0,21,24,0,24,19,41,30,0,"FW,MF",25-29,Forward,Spain,Europe
865,Álvaro García,ESP,Rayo Vallecano,La Liga,2018,25.0,1992.0,19.6,22,19,11,7,4,4,25,16.0,21,24,0,24,19,41,30,0,"FW,MF",25-29,Forward,Spain,Europe
865,Álvaro García,ESP,Rayo Vallecano,La Liga,2018,25.0,1992.0,19.6,22,19,11,7,4,4,25,16.0,21,24,0,24,19,41,30,0,"FW,MF",25-29,Forward,Spain,Europe
865,Álvaro García,ESP,Rayo Vallecano,La Liga,2018,25.0,1992.0,19.6,22,19,11,7,4,4,25,16.0,21,24,0,24,19,41,30,0,"FW,MF",25-29,Forward,Spain,Europe
865,Álvaro García,ESP,Rayo Vallecano,La Liga,2018,25.0,1992.0,19.6,22,19,11,7,4,4,25,16.0,21,24,0,24,19,41,30,0,"FW,MF",25-29,Forward,Spain,Europe
865,Álvaro García,ESP,Rayo Vallecano,La Liga,2018,25.0,1992.0,19.6,22,19,11,7,4,4,25,16.0,21,24,0,24,19,41,30,0,"FW,MF",25-29,Forward,Spain,Europe
866,Borja García,ESP,Girona,La Liga,2018,27.0,1990.0,29.2,39,27,17,15,7,22,44,50.0,22,23,2,21,38,77,17,0,"MF,FW",25-29,Midfielder,Spain,Europe
867,Dani García,ESP,Athletic Club,La Liga,2018,28.0,1990.0,27.5,56,34,21,32,3,24,63,38.1,39,28,8,20,49,105,46,1,MF,25-29,Midfielder,Spain,Europe
868,Javi García,ESP,Betis,La Liga,2018,31.0,1987.0,5.8,3,1,3,0,0,2,3,66.7,1,5,1,4,5,8,27,0,"DF,MF",30-34,Defender,Spain,Europe
869,Manu García,ESP,Alavés,La Liga,2018,32.0,1986.0,25.9,83,48,29,40,14,24,77,31.2,53,42,7,35,23,106,67,0,MF,30-34,Midfielder,Spain,Europe
869,Manu García,ESP,Alavés,La Liga,2018,32.0,1986.0,25.9,83,48,29,40,14,24,77,31.2,53,42,7,35,23,106,67,0,MF,30-34,Midfielder,Spain,Europe
869,Manu García,ESP,Alavés,La Liga,2018,32.0,1986.0,25.9,83,48,29,40,14,24,77,31.2,53,42,7,35,23,106,67,0,MF,30-34,Midfielder,Spain,Europe
869,Manu García,ESP,Alavés,La Liga,2018,32.0,1986.0,25.9,83,48,29,40,14,24,77,31.2,53,42,7,35,23,106,67,0,MF,30-34,Midfielder,Spain,Europe
870,Manu García,ESP,Toulouse,Ligue 1,2018,20.0,1998.0,20.5,37,26,14,17,6,15,49,30.6,34,16,1,15,15,52,5,0,MF,20-24,Midfielder,Spain,Europe
870,Manu García,ESP,Toulouse,Ligue 1,2018,20.0,1998.0,20.5,37,26,14,17,6,15,49,30.6,34,16,1,15,15,52,5,0,MF,20-24,Midfielder,Spain,Europe
870,Manu García,ESP,Toulouse,Ligue 1,2018,20.0,1998.0,20.5,37,26,14,17,6,15,49,30.6,34,16,1,15,15,52,5,0,MF,20-24,Midfielder,Spain,Europe
870,Manu García,ESP,Toulouse,Ligue 1,2018,20.0,1998.0,20.5,37,26,14,17,6,15,49,30.6,34,16,1,15,15,52,5,0,MF,20-24,Midfielder,Spain,Europe
871,Raúl García,ESP,Athletic Club,La Liga,2018,32.0,1986.0,26.3,61,41,13,37,11,22,68,32.4,46,56,1,55,21,82,39,0,"MF,FW",30-34,Midfielder,Spain,Europe
871,Raúl García,ESP,Athletic Club,La Liga,2018,32.0,1986.0,26.3,61,41,13,37,11,22,68,32.4,46,56,1,55,21,82,39,0,"MF,FW",30-34,Midfielder,Spain,Europe
871,Raúl García,ESP,Athletic Club,La Liga,2018,32.0,1986.0,26.3,61,41,13,37,11,22,68,32.4,46,56,1,55,21,82,39,0,"MF,FW",30-34,Midfielder,Spain,Europe
871,Raúl García,ESP,Athletic Club,La Liga,2018,32.0,1986.0,26.3,61,41,13,37,11,22,68,32.4,46,56,1,55,21,82,39,0,"MF,FW",30-34,Midfielder,Spain,Europe
872,Raúl García,ESP,Leganés,La Liga,2018,29.0,1989.0,4.2,8,6,4,4,0,6,8,75.0,2,5,2,3,6,14,28,1,DF,25-29,Defender,Spain,Europe
872,Raúl García,ESP,Leganés,La Liga,2018,29.0,1989.0,4.2,8,6,4,4,0,6,8,75.0,2,5,2,3,6,14,28,1,DF,25-29,Defender,Spain,Europe
872,Raúl García,ESP,Leganés,La Liga,2018,29.0,1989.0,4.2,8,6,4,4,0,6,8,75.0,2,5,2,3,6,14,28,1,DF,25-29,Defender,Spain,Europe
872,Raúl García,ESP,Leganés,La Liga,2018,29.0,1989.0,4.2,8,6,4,4,0,6,8,75.0,2,5,2,3,6,14,28,1,DF,25-29,Defender,Spain,Europe
873,Raúl García,ESP,Girona,La Liga,2018,29.0,1989.0,9.4,21,12,11,7,3,11,16,68.8,5,14,4,10,11,32,35,1,DF,25-29,Defender,Spain,Europe
873,Raúl García,ESP,Girona,La Liga,2018,29.0,1989.0,9.4,21,12,11,7,3,11,16,68.8,5,14,4,10,11,32,35,1,DF,25-29,Defender,Spain,Europe
873,Raúl García,ESP,Girona,La Liga,2018,29.0,1989.0,9.4,21,12,11,7,3,11,16,68.8,5,14,4,10,11,32,35,1,DF,25-29,Defender,Spain,Europe
873,Raúl García,ESP,Girona,La Liga,2018,29.0,1989.0,9.4,21,12,11,7,3,11,16,68.8,5,14,4,10,11,32,35,1,DF,25-29,Defender,Spain,Europe
874,Sergio García,ESP,Espanyol,La Liga,2018,35.0,1983.0,16.5,18,10,4,11,3,3,16,18.8,13,6,1,5,10,28,4,0,"FW,MF",35-39,Forward,Spain,Europe
874,Sergio García,ESP,Espanyol,La Liga,2018,35.0,1983.0,16.5,18,10,4,11,3,3,16,18.8,13,6,1,5,10,28,4,0,"FW,MF",35-39,Forward,Spain,Europe
874,Sergio García,ESP,Espanyol,La Liga,2018,35.0,1983.0,16.5,18,10,4,11,3,3,16,18.8,13,6,1,5,10,28,4,0,"FW,MF",35-39,Forward,Spain,Europe
874,Sergio García,ESP,Espanyol,La Liga,2018,35.0,1983.0,16.5,18,10,4,11,3,3,16,18.8,13,6,1,5,10,28,4,0,"FW,MF",35-39,Forward,Spain,Europe
876,Mario Gaspar,ESP,Villarreal,La Liga,2018,27.0,1990.0,28.9,62,43,39,17,6,29,49,59.2,20,48,11,37,42,104,91,0,DF,25-29,Defender,Spain,Europe
880,David de Gea,ESP,Manchester Utd,Premier League,2018,27.0,1990.0,38.0,0,0,0,0,0,0,2,0.0,2,1,0,1,0,0,11,4,GK,25-29,Goalkeeper,Spain,Europe
881,Theodor Gebre Selassie,CZE,Werder Bremen,Bundesliga,2018,31.0,1986.0,31.3,53,38,27,16,10,22,51,43.1,29,33,8,25,69,122,100,0,DF,30-34,Defender,Czech Republic,Europe
901,Bryan Gil,ESP,Sevilla,La Liga,2018,17.0,2001.0,1.9,6,4,4,1,1,1,5,20.0,4,0,0,0,1,7,0,0,"MF,FW",Under 20,Midfielder,Spain,Europe
906,Kamil Glik,POL,Monaco,Ligue 1,2018,30.0,1988.0,33.0,32,23,26,5,1,16,32,50.0,16,25,17,8,61,93,200,1,DF,30-34,Defender,Poland,Europe
919,Ibai Gómez,ESP,Athletic Club,La Liga,2018,28.0,1989.0,6.4,6,3,3,2,1,4,9,44.4,5,8,1,7,2,8,8,0,FW,25-29,Forward,Spain,Europe
920,Ibai Gómez,ESP,Alavés,La Liga,2018,28.0,1989.0,16.1,14,8,9,3,2,6,19,31.6,13,10,0,10,8,22,17,0,"MF,FW",25-29,Midfielder,Spain,Europe
924,Moi Gómez,ESP,Huesca,La Liga,2018,24.0,1994.0,33.9,42,28,15,25,2,11,46,23.9,35,27,3,24,28,70,27,0,MF,20-24,Midfielder,Spain,Europe
926,Sergi Gómez,ESP,Sevilla,La Liga,2018,26.0,1992.0,30.7,49,38,33,12,4,18,28,64.3,10,30,20,10,40,89,135,1,DF,25-29,Defender,Spain,Europe
931,Álvaro González,ESP,Villarreal,La Liga,2018,28.0,1990.0,32.9,49,35,33,14,2,25,35,71.4,10,34,24,10,37,86,177,2,DF,25-29,Defender,Spain,Europe
931,Álvaro González,ESP,Villarreal,La Liga,2018,28.0,1990.0,32.9,49,35,33,14,2,25,35,71.4,10,34,24,10,37,86,177,2,DF,25-29,Defender,Spain,Europe
931,Álvaro González,ESP,Villarreal,La Liga,2018,28.0,1990.0,32.9,49,35,33,14,2,25,35,71.4,10,34,24,10,37,86,177,2,DF,25-29,Defender,Spain,Europe
931,Álvaro González,ESP,Villarreal,La Liga,2018,28.0,1990.0,32.9,49,35,33,14,2,25,35,71.4,10,34,24,10,37,86,177,2,DF,25-29,Defender,Spain,Europe
932,Bruno González,ESP,Getafe,La Liga,2018,28.0,1990.0,18.9,23,10,14,8,1,9,18,50.0,9,13,6,7,22,45,110,0,DF,25-29,Defender,Spain,Europe
933,Cristo González,ESP,Real Madrid,La Liga,2018,20.0,1997.0,0.5,1,0,0,1,0,0,0,,0,0,0,0,1,2,0,0,FW,20-24,Forward,Spain,Europe
936,Jon Gorenc Stanković,SVN,Huddersfield,Premier League,2018,22.0,1996.0,7.9,26,18,18,7,1,14,26,53.8,12,16,9,7,9,35,20,1,"MF,DF",20-24,Midfielder,Slovenia,Europe
940,Andoni Gorosabel,ESP,Real Sociedad,La Liga,2018,21.0,1996.0,5.1,16,9,10,5,1,8,13,61.5,5,5,1,4,4,20,20,1,DF,20-24,Defender,Spain,Europe
953,Álex Granell,ESP,Girona,La Liga,2018,29.0,1988.0,26.6,64,28,30,31,3,34,83,41.0,49,34,5,29,35,99,36,1,"MF,DF",25-29,Midfielder,Spain,Europe
954,Esteban Granero,ESP,Espanyol,La Liga,2018,31.0,1987.0,22.4,50,32,26,18,6,17,50,34.0,33,42,8,34,26,76,34,2,MF,30-34,Midfielder,Spain,Europe
969,Marko Grujić,SRB,Hertha BSC,Bundesliga,2018,22.0,1996.0,19.8,45,33,17,20,8,13,38,34.2,25,29,6,23,29,74,51,1,MF,20-24,Midfielder,Serbia,Europe
970,Vicente Guaita,ESP,Crystal Palace,Premier League,2018,31.0,1987.0,19.5,0,0,0,0,0,0,0,,0,0,0,0,0,0,5,2,GK,30-34,Goalkeeper,Spain,Europe
972,Sergi Guardiola,ESP,Valladolid,La Liga,2018,27.0,1991.0,16.8,19,11,1,10,8,2,13,15.4,11,12,0,12,5,24,17,0,FW,25-29,Forward,Spain,Europe
973,Sergi Guardiola,ESP,Getafe,La Liga,2018,27.0,1991.0,0.3,1,1,0,1,0,0,0,,0,0,0,0,0,1,0,0,"MF,FW",25-29,Midfielder,Spain,Europe
977,Javi Guerra,ESP,Rayo Vallecano,La Liga,2018,36.0,1982.0,2.6,3,3,1,1,1,0,3,0.0,3,2,0,2,1,4,0,0,"FW,MF",35-39,Forward,Spain,Europe
977,Javi Guerra,ESP,Rayo Vallecano,La Liga,2018,36.0,1982.0,2.6,3,3,1,1,1,0,3,0.0,3,2,0,2,1,4,0,0,"FW,MF",35-39,Forward,Spain,Europe
977,Javi Guerra,ESP,Rayo Vallecano,La Liga,2018,36.0,1982.0,2.6,3,3,1,1,1,0,3,0.0,3,2,0,2,1,4,0,0,"FW,MF",35-39,Forward,Spain,Europe
977,Javi Guerra,ESP,Rayo Vallecano,La Liga,2018,36.0,1982.0,2.6,3,3,1,1,1,0,3,0.0,3,2,0,2,1,4,0,0,"FW,MF",35-39,Forward,Spain,Europe
979,Francis Guerrero,ESP,Betis,La Liga,2018,22.0,1996.0,19.8,51,28,25,16,10,23,41,56.1,18,15,1,14,21,72,47,4,"DF,FW",20-24,Defender,Spain,Europe
981,Ander Guevara,ESP,Real Sociedad,La Liga,2018,21.0,1997.0,1.0,3,1,0,3,0,2,6,33.3,4,1,0,1,1,4,0,0,MF,20-24,Midfielder,Spain,Europe
990,Gerard Gumbau,ESP,Leganés,La Liga,2018,23.0,1994.0,13.3,22,16,9,13,0,6,25,24.0,19,15,2,13,13,35,13,0,MF,20-24,Midfielder,Spain,Europe
999,Gorka Guruzeta,ESP,Athletic Club,La Liga,2018,21.0,1996.0,0.6,1,1,1,0,0,0,2,0.0,2,1,0,1,2,3,0,0,"MF,FW",20-24,Midfielder,Spain,Europe
1022,Samir Handanović,SVN,Inter,Serie A,2018,34.0,1984.0,38.0,1,0,1,0,0,1,1,100.0,0,0,0,0,0,1,12,1,GK,30-34,Goalkeeper,Slovenia,Europe
1048,Mario Hermoso,ESP,Espanyol,La Liga,2018,23.0,1995.0,31.2,38,24,29,7,2,21,39,53.8,18,34,25,9,37,75,175,2,DF,20-24,Defender,Spain,Europe
1052,Ander Herrera,ESP,Manchester Utd,Premier League,2018,28.0,1989.0,15.6,54,28,24,22,8,21,61,34.4,40,38,6,32,37,91,25,1,MF,25-29,Midfielder,Spain,Europe
1054,Iago Herrerín,ESP,Athletic Club,La Liga,2018,30.0,1988.0,31.0,0,0,0,0,0,0,2,0.0,2,0,0,0,0,0,11,2,GK,30-34,Goalkeeper,Spain,Europe
1056,Pablo Hervías,ESP,Valladolid,La Liga,2018,25.0,1993.0,1.8,1,0,0,1,0,0,1,0.0,1,0,0,0,2,3,0,0,MF,25-29,Midfielder,Spain,Europe
1057,Pablo Hervías,ESP,Eibar,La Liga,2018,25.0,1993.0,2.0,1,1,0,1,0,0,4,0.0,4,2,0,2,0,1,0,0,MF,25-29,Midfielder,Spain,Europe
1095,Robert Ibáñez,ESP,Getafe,La Liga,2018,25.0,1993.0,0.8,2,2,1,1,0,0,1,0.0,1,3,0,3,0,2,0,0,MF,25-29,Midfielder,Spain,Europe
1099,Vicente Iborra,ESP,Leicester City,Premier League,2018,30.0,1988.0,2.5,4,1,1,3,0,0,7,0.0,7,1,0,1,8,12,4,1,MF,30-34,Midfielder,Spain,Europe
1100,Vicente Iborra,ESP,Villarreal,La Liga,2018,30.0,1988.0,18.5,31,18,22,5,4,14,37,37.8,23,25,7,18,22,53,41,1,MF,30-34,Midfielder,Spain,Europe
1106,Borja Iglesias,ESP,Espanyol,La Liga,2018,25.0,1993.0,34.2,23,14,7,8,8,5,24,20.8,19,14,6,8,7,30,41,0,FW,25-29,Forward,Spain,Europe
1111,Josip Iličić,SVN,Atalanta,Serie A,2018,30.0,1988.0,23.8,15,7,2,7,6,5,20,25.0,15,20,1,19,5,20,2,0,"FW,MF",30-34,Forward,Slovenia,Europe
1112,Asier Illarramendi,ESP,Real Sociedad,La Liga,2018,28.0,1990.0,20.2,39,24,22,14,3,21,51,41.2,30,36,9,27,31,70,46,1,MF,25-29,Midfielder,Spain,Europe
1122,Pablo Insua,ESP,Huesca,La Liga,2018,24.0,1993.0,8.6,23,10,14,9,0,8,15,53.3,7,2,0,2,12,35,40,0,DF,20-24,Defender,Spain,Europe
1126,Gorka Iraizoz,ESP,Girona,La Liga,2018,37.0,1981.0,6.2,1,0,1,0,0,1,1,100.0,0,0,0,0,1,2,7,0,GK,35-39,Goalkeeper,Spain,Europe
1127,Carlos Isaac,ESP,Atlético Madrid,La Liga,2018,20.0,1998.0,1.0,0,0,0,0,0,0,2,0.0,2,2,0,2,1,1,2,0,DF,20-24,Defender,Spain,Europe
1128,Isco,ESP,Real Madrid,La Liga,2018,26.0,1992.0,13.2,29,14,14,8,7,14,34,41.2,20,9,1,8,6,35,3,0,"MF,FW",25-29,Midfielder,Spain,Europe
1134,Ander Iturraspe,ESP,Athletic Club,La Liga,2018,29.0,1989.0,1.1,2,2,1,1,0,1,1,100.0,0,0,0,0,6,8,2,0,MF,25-29,Midfielder,Spain,Europe
1135,Ivi,ESP,Valladolid,La Liga,2018,24.0,1994.0,0.2,0,0,0,0,0,0,0,,0,0,0,0,0,0,0,0,"MF,FW",20-24,Midfielder,Spain,Europe
1147,Jakub Jankto,CZE,Sampdoria,Serie A,2018,22.0,1996.0,10.7,7,4,5,2,0,4,15,26.7,11,18,2,16,9,16,16,0,MF,20-24,Midfielder,Czech Republic,Europe
1153,Paweł Jaroszyński,POL,Chievo,Serie A,2018,23.0,1994.0,15.0,29,18,17,8,4,16,32,50.0,16,15,4,11,24,53,41,1,DF,20-24,Defender,Poland,Europe
1154,Rune Jarstein,NOR,Hertha BSC,Bundesliga,2018,33.0,1984.0,30.5,0,0,0,0,0,0,0,,0,0,0,0,1,1,8,1,GK,30-34,Goalkeeper,Norway,Europe
1155,Jason,ESP,Levante,La Liga,2018,24.0,1994.0,25.9,44,25,22,11,11,20,71,28.2,51,25,4,21,46,90,27,0,"DF,FW",20-24,Defender,Spain,Europe
1156,Dennis Jastrzembski,POL,Hertha BSC,Bundesliga,2018,18.0,2000.0,0.7,0,0,0,0,0,0,3,0.0,3,0,0,0,1,1,0,0,"FW,DF",Under 20,Forward,Poland,Europe
1165,Jesé,ESP,Betis,La Liga,2018,25.0,1993.0,8.7,7,4,3,3,1,2,8,25.0,6,8,0,8,1,8,1,0,"FW,MF",25-29,Forward,Spain,Europe
1169,Joaquín,ESP,Betis,La Liga,2018,37.0,1981.0,18.8,10,4,4,2,4,3,7,42.9,4,13,2,11,14,24,31,1,"FW,MF",35-39,Forward,Spain,Europe
1172,Stefan Johansen,NOR,Fulham,Premier League,2018,27.0,1991.0,4.6,11,3,4,7,0,5,8,62.5,3,5,0,5,3,14,6,0,MF,25-29,Midfielder,Norway,Europe
1180,Jony,ESP,Alavés,La Liga,2018,27.0,1991.0,33.0,20,14,6,7,7,7,37,18.9,30,18,0,18,22,42,12,2,"MF,FW",25-29,Midfielder,Spain,Europe
1181,Joan Jordán,ESP,Eibar,La Liga,2018,24.0,1994.0,31.9,63,40,16,38,9,28,80,35.0,52,38,4,34,32,95,18,1,MF,20-24,Midfielder,Spain,Europe
1185,Joselu,ESP,Newcastle Utd,Premier League,2018,28.0,1990.0,6.6,14,8,4,5,5,4,9,44.4,5,5,0,5,3,17,15,0,FW,25-29,Forward,Spain,Europe
1188,Aleksandar Jovanović,SRB,Huesca,La Liga,2018,25.0,1992.0,12.0,0,0,0,0,0,0,0,,0,0,0,0,1,1,3,0,GK,25-29,Goalkeeper,Serbia,Europe
1189,Vukašin Jovanović,SRB,Bordeaux,Ligue 1,2018,22.0,1996.0,15.3,26,21,21,5,0,13,19,68.4,6,23,12,11,36,62,105,0,DF,20-24,Defender,Serbia,Europe
1191,Luka Jović,SRB,Eint Frankfurt,Bundesliga,2018,20.0,1997.0,24.9,10,5,1,8,1,1,12,8.3,11,8,0,8,3,13,30,0,"FW,MF",20-24,Forward,Serbia,Europe
1192,Jozabed,ESP,Celta Vigo,La Liga,2018,27.0,1991.0,12.8,19,10,8,8,3,8,24,33.3,16,8,2,6,9,28,13,2,MF,25-29,Midfielder,Spain,Europe
1193,Miguel Juan Llambrich,ESP,Villarreal,La Liga,2018,22.0,1996.0,6.0,21,14,11,9,1,6,14,42.9,8,9,2,7,12,33,17,0,"DF,FW",20-24,Defender,Spain,Europe
1194,Juanfran,ESP,Leganés,La Liga,2018,29.0,1988.0,16.2,20,12,13,5,2,9,16,56.3,7,9,4,5,19,39,37,0,"DF,FW",25-29,Defender,Spain,Europe
1195,Juanfran,ESP,Atlético Madrid,La Liga,2018,33.0,1985.0,17.9,35,22,27,5,3,24,38,63.2,14,13,5,8,19,54,36,1,DF,30-34,Defender,Spain,Europe
1196,Juanmi,ESP,Real Sociedad,La Liga,2018,25.0,1993.0,16.9,21,12,7,11,3,8,22,36.4,14,12,0,12,16,37,13,0,"FW,MF",25-29,Forward,Spain,Europe
1197,Juanpe,ESP,Girona,La Liga,2018,27.0,1991.0,30.7,48,25,32,15,1,24,45,53.3,21,31,15,16,57,105,138,0,DF,25-29,Defender,Spain,Europe
1201,David Juncà,ESP,Celta Vigo,La Liga,2018,24.0,1993.0,19.5,55,30,40,13,2,28,46,60.9,18,27,6,21,35,90,63,1,DF,20-24,Defender,Spain,Europe
1211,Pavel Kadeřábek,CZE,Hoffenheim,Bundesliga,2018,26.0,1992.0,27.9,30,19,12,13,5,11,24,45.8,13,37,10,27,34,64,71,1,DF,25-29,Defender,Czech Republic,Europe
1222,Marcin Kamiński,POL,Düsseldorf,Bundesliga,2018,26.0,1992.0,27.0,18,13,14,3,1,7,11,63.6,4,21,11,10,39,57,103,2,DF,25-29,Defender,Poland,Europe
1224,Kevin Kampl,SVN,RB Leipzig,Bundesliga,2018,27.0,1990.0,23.5,41,24,16,21,4,8,28,28.6,20,32,2,30,33,74,22,0,MF,25-29,Midfielder,Slovenia,Europe
1246,Keko,ESP,Valladolid,La Liga,2018,26.0,1991.0,17.0,42,18,21,15,6,18,50,36.0,32,20,1,19,14,56,17,0,"MF,FW",25-29,Midfielder,Spain,Europe
1259,Kiké,ESP,Eibar,La Liga,2018,28.0,1989.0,14.4,7,4,1,2,4,1,5,20.0,4,18,0,18,4,11,6,0,FW,25-29,Forward,Spain,Europe
1263,Joshua King,NOR,Bournemouth,Premier League,2018,26.0,1992.0,32.9,30,19,7,19,4,8,29,27.6,21,28,4,24,7,37,14,0,"FW,MF",25-29,Forward,Norway,Europe
1282,Koke,ESP,Atlético Madrid,La Liga,2018,26.0,1992.0,28.7,84,46,41,32,11,34,86,39.5,52,25,5,20,31,115,37,1,MF,25-29,Midfielder,Spain,Europe
1283,Aleksandar Kolarov,SRB,Roma,Serie A,2018,32.0,1985.0,32.3,38,26,22,10,6,21,34,61.8,13,23,15,8,41,79,82,2,DF,30-34,Defender,Serbia,Europe
1300,Filip Kostić,SRB,Eint Frankfurt,Bundesliga,2018,25.0,1992.0,32.8,64,42,35,22,7,23,65,35.4,42,80,6,74,23,87,50,0,"DF,FW",25-29,Defender,Serbia,Europe
1302,Tomáš Koubek,CZE,Rennes,Ligue 1,2018,25.0,1992.0,32.5,0,0,0,0,0,0,1,0.0,1,0,0,0,0,0,26,4,GK,25-29,Goalkeeper,Czech Republic,Europe
1307,Dawid Kownacki,POL,Sampdoria,Serie A,2018,21.0,1997.0,1.9,2,1,0,1,1,1,4,25.0,3,0,0,0,0,2,0,0,FW,20-24,Forward,Poland,Europe
1308,Dawid Kownacki,POL,Düsseldorf,Bundesliga,2018,21.0,1997.0,6.4,13,6,9,3,1,7,16,43.8,9,8,0,8,2,15,8,0,"MF,FW",20-24,Midfielder,Poland,Europe
1311,Luka Krajnc,SVN,Frosinone,Serie A,2018,23.0,1994.0,8.8,10,8,6,3,1,5,6,83.3,1,11,3,8,11,21,42,0,DF,20-24,Defender,Slovenia,Europe
1315,Ladislav Krejčí,CZE,Bologna,Serie A,2018,26.0,1992.0,11.8,16,12,6,9,1,7,12,58.3,5,8,2,6,6,22,18,0,"DF,MF",25-29,Defender,Czech Republic,Europe
1316,Rene Krhin,SVN,Nantes,Ligue 1,2018,28.0,1990.0,11.7,22,14,7,12,3,11,19,57.9,8,7,4,3,21,43,32,0,MF,25-29,Midfielder,Slovenia,Europe
1325,Jasmin Kurtić,SVN,SPAL,Serie A,2018,29.0,1989.0,28.4,35,20,19,13,3,13,41,31.7,28,30,3,27,20,55,52,0,MF,25-29,Midfielder,Slovenia,Europe
1327,Rafał Kurzawa,POL,Amiens,Ligue 1,2018,25.0,1993.0,2.7,8,3,6,2,0,2,6,33.3,4,1,0,1,3,11,3,0,FW,25-29,Forward,Poland,Europe
1337,Víctor Laguardia,ESP,Alavés,La Liga,2018,28.0,1989.0,36.0,47,34,37,10,0,24,33,72.7,9,42,19,23,53,100,232,0,DF,25-29,Defender,Spain,Europe
1350,Aymeric Laporte,ESP,Manchester City,Premier League,2018,24.0,1994.0,34.0,42,20,27,14,1,22,34,64.7,12,16,9,7,39,81,98,2,DF,20-24,Defender,Spain,Europe
1356,Toni Lato,ESP,Valencia,La Liga,2018,20.0,1997.0,3.0,6,4,4,1,1,1,5,20.0,4,9,3,6,6,12,13,0,DF,20-24,Defender,Spain,Europe
1365,Darko Lazović,SRB,Genoa,Serie A,2018,27.0,1990.0,28.2,28,17,13,8,7,14,31,45.2,17,21,6,15,20,48,33,0,"DF,FW",25-29,Defender,Serbia,Europe
1369,Robin Le Normand,ESP,Real Sociedad,La Liga,2018,21.0,1996.0,3.2,5,2,2,3,0,1,3,33.3,2,3,0,3,4,9,13,1,DF,20-24,Defender,Spain,Europe
1381,Iñigo Lekue,ESP,Athletic Club,La Liga,2018,25.0,1993.0,2.3,5,2,3,2,0,2,7,28.6,5,4,0,4,4,9,11,0,DF,25-29,Defender,Spain,Europe
1388,Pedro León,ESP,Eibar,La Liga,2018,31.0,1986.0,4.7,7,4,2,2,3,4,7,57.1,3,10,0,10,4,11,2,0,"MF,FW",30-34,Midfielder,Spain,Europe
1389,Sergio León,ESP,Betis,La Liga,2018,29.0,1989.0,7.1,4,2,2,1,1,2,8,25.0,6,4,0,4,2,6,6,0,"FW,MF",25-29,Forward,Spain,Europe
1394,Robert Lewandowski,POL,Bayern Munich,Bundesliga,2018,29.0,1988.0,32.9,12,9,0,8,4,3,11,27.3,8,11,1,10,7,19,15,0,FW,25-29,Forward,Poland,Europe
1395,Igor Lewczuk,POL,Bordeaux,Ligue 1,2018,33.0,1985.0,5.0,12,7,8,2,2,1,4,25.0,3,2,2,0,4,16,27,0,DF,30-34,Defender,Poland,Europe
1403,Karol Linetty,POL,Sampdoria,Serie A,2018,23.0,1995.0,27.9,72,48,26,32,14,15,69,21.7,54,39,4,35,25,97,17,0,MF,20-24,Midfielder,Poland,Europe
1405,Pol Lirola,ESP,Sassuolo,Serie A,2018,20.0,1997.0,33.1,35,22,19,11,5,21,34,61.8,13,25,5,20,32,67,89,0,"DF,MF",20-24,Defender,Spain,Europe
1406,Adem Ljajić,SRB,Torino,Serie A,2018,26.0,1991.0,0.3,0,0,0,0,0,0,1,0.0,1,0,0,0,0,0,0,0,MF,25-29,Midfielder,Serbia,Europe
1407,Diego Llorente,ESP,Real Sociedad,La Liga,2018,24.0,1993.0,19.5,26,15,16,8,2,17,29,58.6,12,27,15,12,26,52,83,2,DF,20-24,Defender,Spain,Europe
1407,Diego Llorente,ESP,Real Sociedad,La Liga,2018,24.0,1993.0,19.5,26,15,16,8,2,17,29,58.6,12,27,15,12,26,52,83,2,DF,20-24,Defender,Spain,Europe
1407,Diego Llorente,ESP,Real Sociedad,La Liga,2018,24.0,1993.0,19.5,26,15,16,8,2,17,29,58.6,12,27,15,12,26,52,83,2,DF,20-24,Defender,Spain,Europe
1407,Diego Llorente,ESP,Real Sociedad,La Liga,2018,24.0,1993.0,19.5,26,15,16,8,2,17,29,58.6,12,27,15,12,26,52,83,2,DF,20-24,Defender,Spain,Europe
1408,Fernando Llorente,ESP,Tottenham,Premier League,2018,33.0,1985.0,7.7,4,2,3,0,1,2,3,66.7,1,7,2,5,1,5,10,0,FW,30-34,Forward,Spain,Europe
1409,Marcos Llorente,ESP,Real Madrid,La Liga,2018,23.0,1995.0,6.0,16,12,7,7,2,8,18,44.4,10,8,0,8,7,23,12,0,MF,20-24,Midfielder,Spain,Europe
1425,Álex López,ESP,Espanyol,La Liga,2018,21.0,1997.0,1.2,3,1,1,2,0,2,3,66.7,1,0,0,0,3,6,1,0,MF,20-24,Midfielder,Spain,Europe
1425,Álex López,ESP,Espanyol,La Liga,2018,21.0,1997.0,1.2,3,1,1,2,0,2,3,66.7,1,0,0,0,3,6,1,0,MF,20-24,Midfielder,Spain,Europe
1425,Álex López,ESP,Espanyol,La Liga,2018,21.0,1997.0,1.2,3,1,1,2,0,2,3,66.7,1,0,0,0,3,6,1,0,MF,20-24,Midfielder,Spain,Europe
1425,Álex López,ESP,Espanyol,La Liga,2018,21.0,1997.0,1.2,3,1,1,2,0,2,3,66.7,1,0,0,0,3,6,1,0,MF,20-24,Midfielder,Spain,Europe
1426,Cristian López,ESP,Angers,Ligue 1,2018,29.0,1989.0,4.1,6,3,1,2,3,1,8,12.5,7,4,0,4,1,7,2,0,FW,25-29,Forward,Spain,Europe
1427,David López,ESP,Espanyol,La Liga,2018,28.0,1989.0,20.2,27,18,15,10,2,10,22,45.5,12,18,12,6,28,55,65,2,DF,25-29,Defender,Spain,Europe
1427,David López,ESP,Espanyol,La Liga,2018,28.0,1989.0,20.2,27,18,15,10,2,10,22,45.5,12,18,12,6,28,55,65,2,DF,25-29,Defender,Spain,Europe
1427,David López,ESP,Espanyol,La Liga,2018,28.0,1989.0,20.2,27,18,15,10,2,10,22,45.5,12,18,12,6,28,55,65,2,DF,25-29,Defender,Spain,Europe
1427,David López,ESP,Espanyol,La Liga,2018,28.0,1989.0,20.2,27,18,15,10,2,10,22,45.5,12,18,12,6,28,55,65,2,DF,25-29,Defender,Spain,Europe
1428,Diego López,ESP,Espanyol,La Liga,2018,36.0,1981.0,38.0,0,0,0,0,0,0,0,,0,0,0,0,2,2,9,3,GK,35-39,Goalkeeper,Spain,Europe
1428,Diego López,ESP,Espanyol,La Liga,2018,36.0,1981.0,38.0,0,0,0,0,0,0,0,,0,0,0,0,2,2,9,3,GK,35-39,Goalkeeper,Spain,Europe
1428,Diego López,ESP,Espanyol,La Liga,2018,36.0,1981.0,38.0,0,0,0,0,0,0,0,,0,0,0,0,2,2,9,3,GK,35-39,Goalkeeper,Spain,Europe
1428,Diego López,ESP,Espanyol,La Liga,2018,36.0,1981.0,38.0,0,0,0,0,0,0,0,,0,0,0,0,2,2,9,3,GK,35-39,Goalkeeper,Spain,Europe
1428,Diego López,ESP,Espanyol,La Liga,2018,36.0,1981.0,38.0,0,0,0,0,0,0,0,,0,0,0,0,2,2,9,3,GK,35-39,Goalkeeper,Spain,Europe
1428,Diego López,ESP,Espanyol,La Liga,2018,36.0,1981.0,38.0,0,0,0,0,0,0,0,,0,0,0,0,2,2,9,3,GK,35-39,Goalkeeper,Spain,Europe
1428,Diego López,ESP,Espanyol,La Liga,2018,36.0,1981.0,38.0,0,0,0,0,0,0,0,,0,0,0,0,2,2,9,3,GK,35-39,Goalkeeper,Spain,Europe
1428,Diego López,ESP,Espanyol,La Liga,2018,36.0,1981.0,38.0,0,0,0,0,0,0,0,,0,0,0,0,2,2,9,3,GK,35-39,Goalkeeper,Spain,Europe
1428,Diego López,ESP,Espanyol,La Liga,2018,36.0,1981.0,38.0,0,0,0,0,0,0,0,,0,0,0,0,2,2,9,3,GK,35-39,Goalkeeper,Spain,Europe
1429,Javi López,ESP,Espanyol,La Liga,2018,32.0,1986.0,21.6,63,40,37,22,4,28,60,46.7,32,27,5,22,40,103,90,0,DF,30-34,Defender,Spain,Europe
1429,Javi López,ESP,Espanyol,La Liga,2018,32.0,1986.0,21.6,63,40,37,22,4,28,60,46.7,32,27,5,22,40,103,90,0,DF,30-34,Defender,Spain,Europe
1429,Javi López,ESP,Espanyol,La Liga,2018,32.0,1986.0,21.6,63,40,37,22,4,28,60,46.7,32,27,5,22,40,103,90,0,DF,30-34,Defender,Spain,Europe
1429,Javi López,ESP,Espanyol,La Liga,2018,32.0,1986.0,21.6,63,40,37,22,4,28,60,46.7,32,27,5,22,40,103,90,0,DF,30-34,Defender,Spain,Europe
1430,Lluis López,ESP,Espanyol,La Liga,2018,21.0,1997.0,5.8,5,3,4,1,0,3,6,50.0,3,6,2,4,7,12,21,0,DF,20-24,Defender,Spain,Europe
1432,Pedro López Muñoz,ESP,Levante,La Liga,2018,34.0,1983.0,5.2,5,3,5,0,0,3,7,42.9,4,8,3,5,8,13,7,0,DF,30-34,Defender,Spain,Europe
1433,Pau López,ESP,Betis,La Liga,2018,23.0,1994.0,33.0,0,0,0,0,0,0,2,0.0,2,1,0,1,2,2,17,2,GK,20-24,Goalkeeper,Spain,Europe
1434,Roberto López,ESP,Real Sociedad,La Liga,2018,18.0,2000.0,0.3,0,0,0,0,0,0,1,0.0,1,1,0,1,1,1,2,0,MF,Under 20,Midfielder,Spain,Europe
1435,Unai López,ESP,Athletic Club,La Liga,2018,22.0,1995.0,3.6,7,5,3,2,2,2,12,16.7,10,10,3,7,1,8,2,0,MF,20-24,Midfielder,Spain,Europe
1444,Anthony Lozano,HON,Girona,La Liga,2018,25.0,1993.0,8.1,6,5,3,3,0,0,6,0.0,6,7,1,6,0,6,6,0,"FW,MF",25-29,Forward,Honduras,North America
1447,José Luis Gayà,ESP,Valencia,La Liga,2018,23.0,1995.0,34.9,83,59,56,20,7,46,80,57.5,34,48,6,42,43,126,105,1,DF,20-24,Defender,Spain,Europe
1448,José Luis Morales,ESP,Levante,La Liga,2018,31.0,1987.0,35.5,21,15,6,10,5,8,49,16.3,41,22,1,21,12,33,17,0,"FW,MF",30-34,Forward,Spain,Europe
1457,Saša Lukić,SRB,Torino,Serie A,2018,21.0,1996.0,11.0,21,11,5,11,5,5,16,31.3,11,13,4,9,12,33,11,0,MF,20-24,Midfielder,Serbia,Europe
1459,Antonio Luna,ESP,Levante,La Liga,2018,27.0,1991.0,14.0,14,10,6,7,1,6,23,26.1,17,22,7,15,15,29,48,1,"DF,FW",25-29,Defender,Spain,Europe
1472,Pablo Maffeo,ESP,Stuttgart,Bundesliga,2018,21.0,1997.0,6.6,15,13,10,5,0,6,13,46.2,7,8,4,4,13,28,17,0,"DF,MF",20-24,Defender,Spain,Europe
1488,Nemanja Maksimović,SRB,Getafe,La Liga,2018,23.0,1995.0,35.7,77,45,21,51,5,21,61,34.4,40,60,15,45,71,148,33,0,MF,20-24,Midfielder,Serbia,Europe
1489,Nikola Maksimović,SRB,Napoli,Serie A,2018,26.0,1991.0,15.3,20,13,14,6,0,6,12,50.0,6,16,10,6,28,48,56,1,DF,25-29,Defender,Serbia,Europe
1493,Hugo Mallo,ESP,Celta Vigo,La Liga,2018,27.0,1991.0,34.4,73,41,41,27,5,27,52,51.9,25,44,13,31,50,123,135,1,DF,25-29,Defender,Spain,Europe
1505,Javier Manquillo,ESP,Newcastle Utd,Premier League,2018,24.0,1994.0,12.2,27,19,14,11,2,9,14,64.3,5,9,1,8,17,44,58,0,DF,20-24,Defender,Spain,Europe
1509,Fran Manzanara,ESP,Levante,La Liga,2018,21.0,1996.0,1.7,7,5,3,3,1,4,4,100.0,0,3,2,1,1,8,7,0,"DF,MF",20-24,Defender,Spain,Europe
1510,Myziane Maolida,COM,Nice,Ligue 1,2018,19.0,1999.0,10.6,12,8,5,5,2,2,4,50.0,2,5,0,5,1,13,5,0,FW,Under 20,Forward,Comoros,Africa
1513,Iván Marcano,ESP,Roma,Serie A,2018,31.0,1987.0,9.0,8,4,4,4,0,5,8,62.5,3,13,6,7,24,32,45,0,DF,30-34,Defender,Spain,Europe
1519,Óscar de Marcos,ESP,Athletic Club,La Liga,2018,29.0,1989.0,26.9,60,32,34,17,9,29,62,46.8,33,29,4,25,27,87,62,0,"DF,FW",25-29,Defender,Spain,Europe
1521,Miguel Marí,ESP,Eibar,La Liga,2018,21.0,1997.0,0.8,0,0,0,0,0,0,2,0.0,2,0,0,0,1,1,2,0,MF,20-24,Midfielder,Spain,Europe
1527,Adrián Marín,ESP,Alavés,La Liga,2018,21.0,1997.0,3.2,13,8,8,5,0,4,7,57.1,3,1,0,1,7,20,13,0,"DF,MF",20-24,Defender,Spain,Europe
1530,Lazar Marković,SRB,Fulham,Premier League,2018,24.0,1994.0,0.5,0,0,0,0,0,0,0,,0,0,0,0,0,0,2,0,MF,20-24,Midfielder,Serbia,Europe
1533,Roger Martí,ESP,Levante,La Liga,2018,27.0,1991.0,21.0,8,6,1,4,3,1,19,5.3,18,14,1,13,4,12,9,0,FW,25-29,Forward,Spain,Europe
1535,Aarón Martín,ESP,Mainz 05,Bundesliga,2018,21.0,1997.0,32.0,55,30,29,21,5,20,38,52.6,18,38,11,27,38,93,75,1,DF,20-24,Defender,Spain,Europe
1538,Iñigo Martínez,ESP,Athletic Club,La Liga,2018,27.0,1991.0,32.2,53,26,36,16,1,23,37,62.2,14,24,14,10,69,122,144,0,DF,25-29,Defender,Spain,Europe
1539,Javi Martínez,ESP,Bayern Munich,Bundesliga,2018,29.0,1988.0,14.5,26,15,7,17,2,5,16,31.3,11,17,5,12,31,57,13,0,MF,25-29,Midfielder,Spain,Europe
1539,Javi Martínez,ESP,Bayern Munich,Bundesliga,2018,29.0,1988.0,14.5,26,15,7,17,2,5,16,31.3,11,17,5,12,31,57,13,0,MF,25-29,Midfielder,Spain,Europe
1539,Javi Martínez,ESP,Bayern Munich,Bundesliga,2018,29.0,1988.0,14.5,26,15,7,17,2,5,16,31.3,11,17,5,12,31,57,13,0,MF,25-29,Midfielder,Spain,Europe
1539,Javi Martínez,ESP,Bayern Munich,Bundesliga,2018,29.0,1988.0,14.5,26,15,7,17,2,5,16,31.3,11,17,5,12,31,57,13,0,MF,25-29,Midfielder,Spain,Europe
1548,Jordi Masip,ESP,Valladolid,La Liga,2018,29.0,1989.0,35.0,1,1,1,0,0,0,0,,0,1,0,1,1,2,3,3,GK,25-29,Goalkeeper,Spain,Europe
1551,Jaime Mata,ESP,Getafe,La Liga,2018,29.0,1988.0,27.0,30,21,8,14,8,7,26,26.9,19,14,0,14,17,47,27,0,"FW,MF",25-29,Forward,Spain,Europe
1552,Juan Mata,ESP,Manchester Utd,Premier League,2018,30.0,1988.0,14.3,9,4,7,1,1,6,21,28.6,15,8,1,7,6,15,6,0,"FW,MF",30-34,Forward,Spain,Europe
1556,Nemanja Matić,SRB,Manchester Utd,Premier League,2018,29.0,1988.0,27.1,50,30,27,19,4,30,59,50.8,29,39,18,21,31,81,53,4,MF,25-29,Midfielder,Serbia,Europe
1569,Borja Mayoral,ESP,Levante,La Liga,2018,21.0,1997.0,18.0,9,4,1,6,2,5,16,31.3,11,10,1,9,5,14,5,0,FW,20-24,Forward,Spain,Europe
1580,Jordi Mboula,ESP,Monaco,Ligue 1,2018,19.0,1999.0,3.1,3,0,0,1,2,3,6,50.0,3,1,0,1,1,4,5,0,"FW,MF",Under 20,Forward,Spain,Europe
1591,Álvaro Medrán,ESP,Rayo Vallecano,La Liga,2018,24.0,1994.0,12.8,15,8,5,6,4,6,21,28.6,15,10,1,9,17,32,9,0,MF,20-24,Midfielder,Spain,Europe
1597,Óscar Melendo,ESP,Espanyol,La Liga,2018,20.0,1997.0,22.2,17,8,7,6,4,10,26,38.5,16,17,1,16,13,30,9,0,"MF,FW",20-24,Midfielder,Spain,Europe
1598,Gonzalo Melero,ESP,Huesca,La Liga,2018,24.0,1994.0,14.9,26,23,5,19,2,11,48,22.9,37,14,4,10,2,28,23,0,MF,20-24,Midfielder,Spain,Europe
1603,Brais Méndez,ESP,Celta Vigo,La Liga,2018,21.0,1997.0,26.1,61,31,23,29,9,14,53,26.4,39,32,3,29,24,85,24,0,"MF,FW",20-24,Midfielder,Spain,Europe
1616,Mikel Merino,ESP,Real Sociedad,La Liga,2018,22.0,1996.0,22.8,50,28,19,25,6,14,52,26.9,38,37,2,35,29,79,37,1,MF,20-24,Midfielder,Spain,Europe
1617,Sabin Merino,ESP,Leganés,La Liga,2018,26.0,1992.0,3.3,1,1,0,0,1,1,1,100.0,0,1,0,1,0,1,4,0,"FW,MF",25-29,Forward,Spain,Europe
1618,Martín Merquelanz,ESP,Real Sociedad,La Liga,2018,23.0,1995.0,0.1,0,0,0,0,0,0,0,,0,0,0,0,0,0,0,0,MF,20-24,Midfielder,Spain,Europe
1620,Roque Mesa,ESP,Sevilla,La Liga,2018,29.0,1989.0,19.4,46,27,16,22,8,15,38,39.5,23,16,0,16,14,60,12,4,MF,25-29,Midfielder,Spain,Europe
1627,Míchel,ESP,Valladolid,La Liga,2018,30.0,1988.0,28.4,60,38,25,31,4,18,73,24.7,55,40,4,36,43,103,30,1,MF,30-34,Midfielder,Spain,Europe
1629,Petar Mićin,SRB,Udinese,Serie A,2018,19.0,1998.0,0.0,0,0,0,0,0,0,0,,0,0,0,0,0,0,0,0,MF,Under 20,Midfielder,Serbia,Europe
1630,Miguel,ESP,Valladolid,La Liga,2018,18.0,1999.0,0.1,0,0,0,0,0,0,1,0.0,1,0,0,0,1,1,0,0,FW,Under 20,Forward,Spain,Europe
1632,Nikola Milenković,SRB,Fiorentina,Serie A,2018,20.0,1997.0,33.4,59,40,36,21,2,17,33,51.5,16,39,21,18,48,107,143,0,DF,20-24,Defender,Serbia,Europe
1633,Arkadiusz Milik,POL,Napoli,Serie A,2018,24.0,1994.0,26.6,19,9,1,8,10,1,20,5.0,19,7,2,5,3,22,15,0,FW,20-24,Forward,Poland,Europe
1634,Sergej Milinković-Savić,SRB,Lazio,Serie A,2018,23.0,1995.0,26.6,44,28,17,21,6,23,60,38.3,37,28,4,24,27,71,48,0,MF,20-24,Midfielder,Serbia,Europe
1635,Vanja Milinković-Savić,SRB,SPAL,Serie A,2018,21.0,1997.0,1.8,0,0,0,0,0,0,0,,0,0,0,0,0,0,1,0,GK,20-24,Goalkeeper,Serbia,Europe
1636,Luka Milivojević,SRB,Crystal Palace,Premier League,2018,27.0,1991.0,38.0,90,69,36,47,7,39,91,42.9,52,47,15,32,72,162,68,3,MF,25-29,Midfielder,Serbia,Europe
1637,Pere Milla,ESP,Eibar,La Liga,2018,25.0,1992.0,3.8,7,6,1,5,1,0,5,0.0,5,4,1,3,2,9,1,0,"MF,FW",25-29,Midfielder,Spain,Europe
1640,Santi Mina,ESP,Valencia,La Liga,2018,22.0,1995.0,20.6,17,10,1,15,1,3,25,12.0,22,19,2,17,4,21,20,0,FW,20-24,Forward,Spain,Europe
1643,Ignasi Miquel,ESP,Getafe,La Liga,2018,25.0,1992.0,3.5,1,0,0,1,0,1,2,50.0,1,4,4,0,5,6,25,0,DF,25-29,Defender,Spain,Europe
1645,Jorge Miramón,ESP,Huesca,La Liga,2018,29.0,1989.0,27.7,73,55,49,17,7,34,53,64.2,19,34,11,23,44,117,65,1,DF,25-29,Defender,Spain,Europe
1651,Aleksandar Mitrović,SRB,Fulham,Premier League,2018,23.0,1994.0,36.4,19,9,3,13,3,5,15,33.3,10,22,8,14,6,25,53,0,FW,20-24,Forward,Serbia,Europe
1652,Stefan Mitrović,SRB,Strasbourg,Ligue 1,2018,28.0,1990.0,33.6,23,16,20,3,0,12,24,50.0,12,41,31,10,46,69,146,2,DF,25-29,Defender,Serbia,Europe
1660,Jorge Molina,ESP,Getafe,La Liga,2018,36.0,1982.0,29.4,12,9,1,4,7,2,15,13.3,13,22,0,22,7,19,26,1,FW,35-39,Forward,Spain,Europe
1662,Victor Mollejo,ESP,Atlético Madrid,La Liga,2018,17.0,2001.0,0.7,0,0,0,0,0,0,2,0.0,2,0,0,0,0,0,0,0,"FW,DF",Under 20,Forward,Spain,Europe
1667,Nacho Monreal,ESP,Arsenal,Premier League,2018,32.0,1986.0,20.7,35,17,21,9,5,15,25,60.0,10,28,10,18,31,66,62,0,DF,30-34,Defender,Spain,Europe
1668,Francisco Montero,ESP,Atlético Madrid,La Liga,2018,19.0,1999.0,4.5,8,4,5,3,0,5,6,83.3,1,10,4,6,5,13,18,1,DF,Under 20,Defender,Spain,Europe
1669,Cristóbal Montiel,ESP,Fiorentina,Serie A,2018,18.0,2000.0,0.1,0,0,0,0,0,0,0,,0,0,0,0,0,0,0,0,FW,Under 20,Forward,Spain,Europe
1670,Martín Montoya,ESP,Brighton,Premier League,2018,27.0,1991.0,24.1,58,35,29,21,8,32,55,58.2,23,30,10,20,48,106,76,1,DF,25-29,Defender,Spain,Europe
1674,Álvaro Morata,ESP,Chelsea,Premier League,2018,25.0,1992.0,10.5,8,5,0,5,3,1,7,14.3,6,6,1,5,0,8,6,0,FW,25-29,Forward,Spain,Europe
1675,Álvaro Morata,ESP,Atlético Madrid,La Liga,2018,25.0,1992.0,12.0,20,14,2,7,11,3,10,30.0,7,7,0,7,5,25,13,0,FW,25-29,Forward,Spain,Europe
1676,Jan Morávek,CZE,Augsburg,Bundesliga,2018,28.0,1989.0,8.4,38,21,17,16,5,19,42,45.2,23,21,1,20,9,47,13,0,MF,25-29,Midfielder,Czech Republic,Europe
1679,Alberto Moreno,ESP,Liverpool,Premier League,2018,26.0,1992.0,1.7,3,2,1,2,0,1,3,33.3,2,1,0,1,2,5,0,0,DF,25-29,Defender,Spain,Europe
1679,Alberto Moreno,ESP,Liverpool,Premier League,2018,26.0,1992.0,1.7,3,2,1,2,0,1,3,33.3,2,1,0,1,2,5,0,0,DF,25-29,Defender,Spain,Europe
1679,Alberto Moreno,ESP,Liverpool,Premier League,2018,26.0,1992.0,1.7,3,2,1,2,0,1,3,33.3,2,1,0,1,2,5,0,0,DF,25-29,Defender,Spain,Europe
1679,Alberto Moreno,ESP,Liverpool,Premier League,2018,26.0,1992.0,1.7,3,2,1,2,0,1,3,33.3,2,1,0,1,2,5,0,0,DF,25-29,Defender,Spain,Europe
1680,Álex Moreno,ESP,Rayo Vallecano,La Liga,2018,25.0,1993.0,34.8,63,40,41,18,4,29,53,54.7,24,35,9,26,41,104,97,0,DF,25-29,Defender,Spain,Europe
1681,Gerard Moreno,ESP,Villarreal,La Liga,2018,26.0,1992.0,25.7,22,12,2,15,5,8,27,29.6,19,23,9,14,9,31,39,0,FW,25-29,Forward,Spain,Europe
1683,Sergio Moreno,ESP,Rayo Vallecano,La Liga,2018,19.0,1999.0,0.2,0,0,0,0,0,0,0,,0,0,0,0,0,0,0,0,FW,Under 20,Forward,Spain,Europe
1686,Manu Morlanes,ESP,Villarreal,La Liga,2018,19.0,1999.0,6.8,21,11,9,9,3,7,19,36.8,12,7,3,4,5,26,9,0,MF,Under 20,Midfielder,Spain,Europe
1687,Loren Morón,ESP,Betis,La Liga,2018,24.0,1993.0,21.7,18,12,4,11,3,6,27,22.2,21,24,1,23,6,24,18,0,FW,20-24,Forward,Spain,Europe
1700,Toni Moya,ESP,Atlético Madrid,La Liga,2018,20.0,1998.0,1.0,2,2,2,0,0,0,1,0.0,1,0,0,0,0,2,3,0,DF,20-24,Defender,Spain,Europe
1701,Javi Moyano,ESP,Valladolid,La Liga,2018,32.0,1986.0,23.3,25,17,17,6,2,15,30,50.0,15,20,9,11,25,50,88,2,DF,30-34,Defender,Spain,Europe
1711,Iker Muniain,ESP,Athletic Club,La Liga,2018,25.0,1992.0,26.5,29,20,10,14,5,6,29,20.7,23,17,3,14,12,41,6,0,"MF,FW",25-29,Midfielder,Spain,Europe
1712,Marc Muniesa,ESP,Girona,La Liga,2018,26.0,1992.0,15.6,49,34,27,17,5,15,28,53.6,13,18,6,12,37,86,49,1,"DF,MF",25-29,Defender,Spain,Europe
1713,Aihen Muñoz,ESP,Real Sociedad,La Liga,2018,20.0,1997.0,10.6,13,8,11,2,0,10,19,52.6,9,19,9,10,7,20,26,0,DF,20-24,Defender,Spain,Europe
1715,Joaquín Muñoz,ESP,Atlético Madrid,La Liga,2018,19.0,1999.0,0.0,0,0,0,0,0,0,0,,0,0,0,0,0,0,0,0,FW,Under 20,Forward,Spain,Europe
1743,Nacho,ESP,Valladolid,La Liga,2018,29.0,1989.0,35.0,110,66,73,30,7,67,100,67.0,33,43,10,33,45,155,113,2,DF,25-29,Defender,Spain,Europe
1744,Nacho,ESP,Real Madrid,La Liga,2018,28.0,1990.0,18.9,26,19,14,7,5,11,22,50.0,11,19,7,12,32,58,65,1,DF,25-29,Defender,Spain,Europe
1751,Matija Nastasić,SRB,Schalke 04,Bundesliga,2018,25.0,1993.0,27.2,35,23,22,13,0,20,29,69.0,9,32,20,12,38,73,114,1,DF,25-29,Defender,Serbia,Europe
1752,Marc Navarro,ESP,Watford,Premier League,2018,23.0,1995.0,0.9,4,2,3,1,0,3,4,75.0,1,0,0,0,0,4,4,0,DF,20-24,Defender,Spain,Europe
1753,Ximo Navarro,ESP,Alavés,La Liga,2018,28.0,1990.0,28.1,57,35,44,12,1,32,45,71.1,13,25,11,14,47,104,143,1,DF,25-29,Defender,Spain,Europe
1753,Ximo Navarro,ESP,Alavés,La Liga,2018,28.0,1990.0,28.1,57,35,44,12,1,32,45,71.1,13,25,11,14,47,104,143,1,DF,25-29,Defender,Spain,Europe
1753,Ximo Navarro,ESP,Alavés,La Liga,2018,28.0,1990.0,28.1,57,35,44,12,1,32,45,71.1,13,25,11,14,47,104,143,1,DF,25-29,Defender,Spain,Europe
1753,Ximo Navarro,ESP,Alavés,La Liga,2018,28.0,1990.0,28.1,57,35,44,12,1,32,45,71.1,13,25,11,14,47,104,143,1,DF,25-29,Defender,Spain,Europe
1754,Jesús Navas,ESP,Sevilla,La Liga,2018,32.0,1985.0,30.1,28,21,15,11,2,16,24,66.7,8,23,5,18,29,57,62,0,"DF,FW",30-34,Defender,Spain,Europe
1756,Raúl Navas,ESP,Real Sociedad,La Liga,2018,30.0,1988.0,14.6,23,14,20,3,0,13,21,61.9,8,20,9,11,20,43,60,1,DF,30-34,Defender,Spain,Europe
1776,Saúl Ñíguez,ESP,Atlético Madrid,La Liga,2018,23.0,1994.0,32.5,83,56,35,41,7,32,81,39.5,49,57,10,47,42,125,86,1,"MF,DF",20-24,Midfielder,Spain,Europe
1783,Peru Nolaskoain,ESP,Athletic Club,La Liga,2018,19.0,1998.0,5.2,11,8,7,4,0,5,9,55.6,4,11,6,5,10,21,18,0,DF,Under 20,Defender,Spain,Europe
1784,Nolito,ESP,Sevilla,La Liga,2018,31.0,1986.0,0.8,3,2,1,1,1,1,2,50.0,1,2,0,2,0,3,1,0,"FW,DF",30-34,Forward,Spain,Europe
1786,Håvard Nordtveit,NOR,Fulham,Premier League,2018,28.0,1990.0,4.0,9,4,8,1,0,4,5,80.0,1,3,3,0,8,17,15,1,DF,25-29,Defender,Norway,Europe
1787,Håvard Nordtveit,NOR,Hoffenheim,Bundesliga,2018,28.0,1990.0,5.2,8,5,2,4,2,3,7,42.9,4,8,5,3,4,12,14,0,"MF,DF",25-29,Midfielder,Norway,Europe
1791,Unai Núñez,ESP,Athletic Club,La Liga,2018,21.0,1997.0,11.8,15,11,11,4,0,7,11,63.6,4,20,12,8,28,43,60,2,DF,20-24,Defender,Spain,Europe
1802,Jan Oblak,SVN,Atlético Madrid,La Liga,2018,25.0,1993.0,37.0,1,0,1,0,0,1,1,100.0,0,0,0,0,1,2,13,1,GK,25-29,Goalkeeper,Slovenia,Europe
1807,Álvaro Odriozola,ESP,Real Madrid,La Liga,2018,22.0,1995.0,13.1,28,25,13,11,4,14,18,77.8,4,11,1,10,11,39,17,1,DF,20-24,Defender,Spain,Europe
1809,Dani Ojeda,ESP,Leganés,La Liga,2018,23.0,1994.0,2.1,3,2,2,0,1,1,3,33.3,2,2,0,2,2,5,2,0,"MF,DF",20-24,Midfielder,Spain,Europe
1817,Oier Olazábal,ESP,Levante,La Liga,2018,28.0,1989.0,21.0,1,1,1,0,0,1,2,50.0,1,1,0,1,1,2,15,2,GK,25-29,Goalkeeper,Spain,Europe
1818,Kiko Olivas,ESP,Valladolid,La Liga,2018,29.0,1988.0,34.4,51,38,35,15,1,22,48,45.8,26,31,18,13,46,97,173,2,DF,25-29,Defender,Spain,Europe
1842,Mikel Oyarzabal,ESP,Real Sociedad,La Liga,2018,21.0,1997.0,35.0,36,20,15,15,6,12,49,24.5,37,54,3,51,14,50,26,0,"FW,MF",20-24,Forward,Spain,Europe
1849,Fernando Pacheco,ESP,Alavés,La Liga,2018,26.0,1992.0,35.0,0,0,0,0,0,0,1,0.0,1,0,0,0,1,1,23,0,GK,25-29,Goalkeeper,Spain,Europe
1849,Fernando Pacheco,ESP,Alavés,La Liga,2018,26.0,1992.0,35.0,0,0,0,0,0,0,1,0.0,1,0,0,0,1,1,23,0,GK,25-29,Goalkeeper,Spain,Europe
1849,Fernando Pacheco,ESP,Alavés,La Liga,2018,26.0,1992.0,35.0,0,0,0,0,0,0,1,0.0,1,0,0,0,1,1,23,0,GK,25-29,Goalkeeper,Spain,Europe
1849,Fernando Pacheco,ESP,Alavés,La Liga,2018,26.0,1992.0,35.0,0,0,0,0,0,0,1,0.0,1,0,0,0,1,1,23,0,GK,25-29,Goalkeeper,Spain,Europe
1858,Sergi Palencia,ESP,Bordeaux,Ligue 1,2018,22.0,1996.0,22.1,74,50,46,20,8,27,55,49.1,28,22,3,19,17,91,70,1,DF,20-24,Defender,Spain,Europe
1868,Rubén Pardo,ESP,Real Sociedad,La Liga,2018,25.0,1992.0,15.2,11,7,2,9,0,4,17,23.5,13,14,6,8,21,32,9,0,"MF,FW",25-29,Midfielder,Spain,Europe
1870,Daniel Parejo,ESP,Valencia,La Liga,2018,29.0,1989.0,34.0,73,42,41,24,8,31,90,34.4,59,41,7,34,46,119,26,2,MF,25-29,Midfielder,Spain,Europe
1878,Patric,ESP,Lazio,Serie A,2018,25.0,1993.0,12.1,19,11,8,8,3,8,15,53.3,7,14,7,7,12,31,29,1,DF,25-29,Defender,Spain,Europe
1883,Jiří Pavlenka,CZE,Werder Bremen,Bundesliga,2018,26.0,1992.0,33.1,3,0,3,0,0,3,6,50.0,3,1,0,1,3,6,14,1,GK,25-29,Goalkeeper,Czech Republic,Europe
1888,Alfonso Pedraza,ESP,Villarreal,La Liga,2018,22.0,1996.0,23.3,59,44,34,19,6,22,62,35.5,40,33,7,26,29,88,55,0,"DF,FW",20-24,Defender,Spain,Europe
1889,Pedro,ESP,Chelsea,Premier League,2018,31.0,1987.0,19.8,27,14,11,10,6,9,35,25.7,26,13,2,11,18,45,8,1,FW,30-34,Forward,Spain,Europe
1889,Pedro,ESP,Chelsea,Premier League,2018,31.0,1987.0,19.8,27,14,11,10,6,9,35,25.7,26,13,2,11,18,45,8,1,FW,30-34,Forward,Spain,Europe
1889,Pedro,ESP,Chelsea,Premier League,2018,31.0,1987.0,19.8,27,14,11,10,6,9,35,25.7,26,13,2,11,18,45,8,1,FW,30-34,Forward,Spain,Europe
1889,Pedro,ESP,Chelsea,Premier League,2018,31.0,1987.0,19.8,27,14,11,10,6,9,35,25.7,26,13,2,11,18,45,8,1,FW,30-34,Forward,Spain,Europe
1889,Pedro,ESP,Chelsea,Premier League,2018,31.0,1987.0,19.8,27,14,11,10,6,9,35,25.7,26,13,2,11,18,45,8,1,FW,30-34,Forward,Spain,Europe
1889,Pedro,ESP,Chelsea,Premier League,2018,31.0,1987.0,19.8,27,14,11,10,6,9,35,25.7,26,13,2,11,18,45,8,1,FW,30-34,Forward,Spain,Europe
1889,Pedro,ESP,Chelsea,Premier League,2018,31.0,1987.0,19.8,27,14,11,10,6,9,35,25.7,26,13,2,11,18,45,8,1,FW,30-34,Forward,Spain,Europe
1889,Pedro,ESP,Chelsea,Premier League,2018,31.0,1987.0,19.8,27,14,11,10,6,9,35,25.7,26,13,2,11,18,45,8,1,FW,30-34,Forward,Spain,Europe
1889,Pedro,ESP,Chelsea,Premier League,2018,31.0,1987.0,19.8,27,14,11,10,6,9,35,25.7,26,13,2,11,18,45,8,1,FW,30-34,Forward,Spain,Europe
1889,Pedro,ESP,Chelsea,Premier League,2018,31.0,1987.0,19.8,27,14,11,10,6,9,35,25.7,26,13,2,11,18,45,8,1,FW,30-34,Forward,Spain,Europe
1889,Pedro,ESP,Chelsea,Premier League,2018,31.0,1987.0,19.8,27,14,11,10,6,9,35,25.7,26,13,2,11,18,45,8,1,FW,30-34,Forward,Spain,Europe
1889,Pedro,ESP,Chelsea,Premier League,2018,31.0,1987.0,19.8,27,14,11,10,6,9,35,25.7,26,13,2,11,18,45,8,1,FW,30-34,Forward,Spain,Europe
1889,Pedro,ESP,Chelsea,Premier League,2018,31.0,1987.0,19.8,27,14,11,10,6,9,35,25.7,26,13,2,11,18,45,8,1,FW,30-34,Forward,Spain,Europe
1889,Pedro,ESP,Chelsea,Premier League,2018,31.0,1987.0,19.8,27,14,11,10,6,9,35,25.7,26,13,2,11,18,45,8,1,FW,30-34,Forward,Spain,Europe
1889,Pedro,ESP,Chelsea,Premier League,2018,31.0,1987.0,19.8,27,14,11,10,6,9,35,25.7,26,13,2,11,18,45,8,1,FW,30-34,Forward,Spain,Europe
1889,Pedro,ESP,Chelsea,Premier League,2018,31.0,1987.0,19.8,27,14,11,10,6,9,35,25.7,26,13,2,11,18,45,8,1,FW,30-34,Forward,Spain,Europe
1891,Adrià Pedrosa,ESP,Espanyol,La Liga,2018,20.0,1998.0,8.5,14,9,11,2,1,7,14,50.0,7,10,4,6,8,22,27,0,DF,20-24,Defender,Spain,Europe
1908,Rubén Peña,ESP,Eibar,La Liga,2018,27.0,1991.0,29.7,63,46,24,27,12,24,53,45.3,29,37,9,28,35,98,57,0,DF,25-29,Defender,Spain,Europe
1916,Ayoze Pérez,ESP,Newcastle Utd,Premier League,2018,25.0,1993.0,32.4,59,22,24,28,7,17,63,27.0,46,55,4,51,42,101,33,1,"MF,FW",25-29,Midfielder,Spain,Europe
1917,Carles Pérez,ESP,Barcelona,La Liga,2018,20.0,1998.0,0.2,0,0,0,0,0,0,0,,0,1,0,1,0,0,0,0,FW,20-24,Forward,Spain,Europe
1919,Lucas Pérez,ESP,West Ham,Premier League,2018,29.0,1988.0,5.3,6,4,3,2,1,1,3,33.3,2,2,1,1,2,8,2,0,"FW,MF",25-29,Forward,Spain,Europe
1920,Rubén Pérez,ESP,Leganés,La Liga,2018,29.0,1989.0,27.5,71,42,27,40,4,32,80,40.0,48,35,8,27,40,111,34,1,MF,25-29,Midfielder,Spain,Europe
1930,Ondřej Petrák,CZE,Nürnberg,Bundesliga,2018,26.0,1992.0,18.0,36,24,17,18,1,14,25,56.0,11,18,4,14,40,76,22,0,MF,25-29,Midfielder,Czech Republic,Europe
1937,Krzysztof Piątek,POL,Genoa,Serie A,2018,23.0,1995.0,17.7,9,4,2,5,2,1,15,6.7,14,18,3,15,3,12,19,0,FW,20-24,Forward,Poland,Europe
1938,Krzysztof Piątek,POL,Milan,Serie A,2018,23.0,1995.0,15.3,8,6,2,1,5,3,10,30.0,7,7,2,5,1,9,15,0,FW,20-24,Forward,Poland,Europe
1947,Tomás Pina Isla,ESP,Alavés,La Liga,2018,30.0,1987.0,26.0,64,41,23,36,5,18,46,39.1,28,15,4,11,41,105,43,1,MF,30-34,Midfielder,Spain,Europe
1952,Gerard Piqué,ESP,Barcelona,La Liga,2018,31.0,1987.0,35.0,42,27,25,17,0,24,37,64.9,13,41,27,14,36,78,154,5,DF,30-34,Defender,Spain,Europe
1955,Łukasz Piszczek,POL,Dortmund,Bundesliga,2018,33.0,1985.0,19.5,57,36,34,15,8,18,33,54.5,15,26,3,23,39,96,69,0,DF,30-34,Defender,Poland,Europe
1959,Carles Planas,ESP,Girona,La Liga,2018,27.0,1991.0,4.7,12,6,7,5,0,4,11,36.4,7,2,0,2,4,16,15,0,DF,25-29,Defender,Spain,Europe
1960,Óscar Plano,ESP,Valladolid,La Liga,2018,27.0,1991.0,29.9,63,45,23,28,12,14,48,29.2,34,19,3,16,22,85,28,1,"MF,FW",25-29,Midfielder,Spain,Europe
1961,Jaroslav Plašil,CZE,Bordeaux,Ligue 1,2018,36.0,1982.0,16.0,34,26,11,20,3,18,44,40.9,26,21,5,16,19,53,28,1,MF,35-39,Midfielder,Czech Republic,Europe
1973,Pere Pons,ESP,Girona,La Liga,2018,25.0,1993.0,31.0,83,46,34,38,11,30,82,36.6,52,48,12,36,35,118,39,0,MF,25-29,Midfielder,Spain,Europe
1974,Pedro Porro,ESP,Girona,La Liga,2018,18.0,1999.0,24.6,51,31,28,16,7,32,80,40.0,48,36,2,34,39,90,60,1,DF,Under 20,Defender,Spain,Europe
1976,Francisco Portillo,ESP,Getafe,La Liga,2018,28.0,1990.0,22.2,26,16,6,15,5,9,29,31.0,20,14,0,14,17,43,9,0,MF,25-29,Midfielder,Spain,Europe
1977,Portu,ESP,Girona,La Liga,2018,26.0,1992.0,31.3,33,24,8,15,10,12,43,27.9,31,16,1,15,8,41,5,0,"FW,MF",25-29,Forward,Spain,Europe
1979,Sergio Postigo,ESP,Levante,La Liga,2018,29.0,1988.0,16.1,25,15,22,3,0,15,19,78.9,4,21,12,9,20,45,77,0,DF,25-29,Defender,Spain,Europe
1983,José Pozo,ESP,Rayo Vallecano,La Liga,2018,22.0,1996.0,18.0,13,10,4,5,4,4,25,16.0,21,7,1,6,4,17,6,0,MF,20-24,Midfielder,Spain,Europe
1995,Javi Puado,ESP,Espanyol,La Liga,2018,20.0,1998.0,4.0,2,1,0,2,0,0,7,0.0,7,5,1,4,6,8,4,0,"FW,MF",20-24,Forward,Spain,Europe
1997,Riqui Puig,ESP,Barcelona,La Liga,2018,18.0,1999.0,1.7,3,3,0,2,1,2,3,66.7,1,0,0,0,0,3,1,0,MF,Under 20,Midfielder,Spain,Europe
1999,Jorge Pulido,ESP,Huesca,La Liga,2018,27.0,1991.0,30.9,63,42,40,19,4,32,51,62.7,19,39,18,21,50,113,158,0,DF,25-29,Defender,Spain,Europe
2008,Xavi Quintillà,ESP,Villarreal,La Liga,2018,21.0,1996.0,7.0,10,4,5,4,1,6,12,50.0,6,5,2,3,8,18,17,0,DF,20-24,Defender,Spain,Europe
2009,Dani Raba,ESP,Villarreal,La Liga,2018,22.0,1995.0,2.1,6,5,1,2,3,1,5,20.0,4,1,0,1,1,7,0,0,"MF,FW",20-24,Midfielder,Spain,Europe
2011,Nemanja Radonjić,SRB,Marseille,Ligue 1,2018,22.0,1996.0,7.6,8,5,1,5,2,5,16,31.3,11,3,0,3,5,13,4,0,"FW,MF",20-24,Forward,Serbia,Europe
2012,Ivan Radovanović,SRB,Genoa,Serie A,2018,29.0,1988.0,14.2,20,12,11,8,1,8,17,47.1,9,12,4,8,13,33,20,1,MF,25-29,Midfielder,Serbia,Europe
2013,Ivan Radovanović,SRB,Chievo,Serie A,2018,29.0,1988.0,19.0,27,22,20,7,0,11,31,35.5,20,19,7,12,26,53,36,0,MF,25-29,Midfielder,Serbia,Europe
2025,Jonás Ramalho,ESP,Girona,La Liga,2018,25.0,1993.0,18.0,13,6,12,1,0,8,14,57.1,6,24,11,13,16,29,80,1,DF,25-29,Defender,Spain,Europe
2029,Sandro Ramírez,ESP,Real Sociedad,La Liga,2018,23.0,1995.0,11.7,19,10,7,10,2,4,11,36.4,7,12,1,11,9,28,3,0,"FW,MF",20-24,Forward,Spain,Europe
2030,Iván Ramis,ESP,Eibar,La Liga,2018,33.0,1984.0,18.6,23,13,10,11,2,17,23,73.9,6,10,5,5,18,41,65,2,DF,30-34,Defender,Spain,Europe
2031,Chris Ramos,ESP,Valladolid,La Liga,2018,21.0,1997.0,0.7,1,1,0,0,1,1,1,100.0,0,0,0,0,0,1,1,0,FW,20-24,Forward,Spain,Europe
2032,Sergio Ramos,ESP,Real Madrid,La Liga,2018,32.0,1986.0,27.5,41,32,25,12,4,22,39,56.4,17,29,15,14,37,78,90,2,DF,30-34,Defender,Spain,Europe
2044,Arkadiusz Reca,POL,Atalanta,Serie A,2018,23.0,1995.0,0.5,2,0,1,0,1,0,1,0.0,1,0,0,0,3,5,0,0,DF,20-24,Defender,Poland,Europe
2045,Recio,ESP,Leganés,La Liga,2018,27.0,1991.0,14.3,30,21,14,13,3,6,24,25.0,18,14,2,12,14,44,14,0,MF,25-29,Midfielder,Spain,Europe
2048,Sergio Reguilón,ESP,Real Madrid,La Liga,2018,21.0,1996.0,12.4,25,14,15,9,1,10,21,47.6,11,13,3,10,20,45,41,1,DF,20-24,Defender,Spain,Europe
2049,Bobby Reid,JAM,Cardiff City,Premier League,2018,25.0,1993.0,15.8,16,9,6,7,3,3,8,37.5,5,13,0,13,3,19,12,0,"FW,MF",25-29,Forward,Jamaica,North America
2051,Jeff Reine-Adélaïde,FRA,Angers,Ligue 1,2018,20.0,1998.0,28.4,40,22,18,19,3,16,39,41.0,23,20,0,20,19,59,10,0,"FW,MF",20-24,Forward,France,Europe
2052,Karim Rekik,NED,Hertha BSC,Bundesliga,2018,23.0,1994.0,23.0,36,22,23,12,1,12,18,66.7,6,24,16,8,34,70,88,0,DF,20-24,Defender,Netherlands,Europe
2053,Loïc Rémy,FRA,Lille,Ligue 1,2018,31.0,1987.0,13.4,2,1,0,2,0,0,3,0.0,3,3,1,2,2,4,17,1,FW,30-34,Forward,France,Europe
2054,Michael Rensing,GER,Düsseldorf,Bundesliga,2018,34.0,1984.0,32.0,2,1,2,0,0,1,5,20.0,4,1,0,1,2,4,13,2,GK,30-34,Goalkeeper,Germany,Europe
2055,Marco Reus,GER,Dortmund,Bundesliga,2018,29.0,1989.0,25.7,33,22,11,16,6,6,31,19.4,25,28,1,27,8,41,32,0,"MF,FW",25-29,Midfielder,Germany,Europe
2057,Diego Reyes,MEX,Leganés,La Liga,2018,25.0,1992.0,3.6,7,4,4,3,0,3,4,75.0,1,4,4,0,7,14,17,1,DF,25-29,Defender,Mexico,North America
2057,Diego Reyes,MEX,Leganés,La Liga,2018,25.0,1992.0,3.6,7,4,4,3,0,3,4,75.0,1,4,4,0,7,14,17,1,DF,25-29,Defender,Mexico,North America
2057,Diego Reyes,MEX,Leganés,La Liga,2018,25.0,1992.0,3.6,7,4,4,3,0,3,4,75.0,1,4,4,0,7,14,17,1,DF,25-29,Defender,Mexico,North America
2057,Diego Reyes,MEX,Leganés,La Liga,2018,25.0,1992.0,3.6,7,4,4,3,0,3,4,75.0,1,4,4,0,7,14,17,1,DF,25-29,Defender,Mexico,North America
2058,Baptiste Reynet,FRA,Toulouse,Ligue 1,2018,27.0,1990.0,30.0,0,0,0,0,0,0,3,0.0,3,0,0,0,1,1,14,2,GK,25-29,Goalkeeper,France,Europe
2059,Simon Rhein,GER,Nürnberg,Bundesliga,2018,20.0,1998.0,5.5,7,4,7,0,0,2,7,28.6,5,6,1,5,7,14,6,0,MF,20-24,Midfielder,Germany,Europe
2060,Franck Ribéry,FRA,Bayern Munich,Bundesliga,2018,35.0,1983.0,13.0,15,7,7,6,2,4,10,40.0,6,9,0,9,7,22,1,0,"MF,FW",35-39,Midfielder,France,Europe
2061,Declan Rice,ENG,West Ham,Premier League,2018,19.0,1999.0,33.4,98,60,35,58,5,38,88,43.2,50,51,12,39,52,150,56,0,MF,Under 20,Midfielder,England,Europe
2062,Jazz Richards,WAL,Cardiff City,Premier League,2018,27.0,1991.0,1.5,0,0,0,0,0,0,1,0.0,1,2,1,1,2,2,5,0,"DF,MF",25-29,Defender,Wales,Europe
2063,Richarlison,BRA,Everton,Premier League,2018,21.0,1997.0,29.6,49,34,19,20,10,8,24,33.3,16,30,2,28,16,65,39,0,"FW,MF",20-24,Forward,Brazil,South America
2064,Marco Richter,GER,Augsburg,Bundesliga,2018,20.0,1997.0,15.8,13,8,4,5,4,7,20,35.0,13,16,1,15,13,26,9,1,"MF,FW",20-24,Midfielder,Germany,Europe
2069,Sascha Riether,GER,Schalke 04,Bundesliga,2018,35.0,1983.0,0.0,0,0,0,0,0,0,0,,0,0,0,0,0,0,0,0,FW,35-39,Forward,Germany,Europe
2070,Emiliano Rigoni,ARG,Atalanta,Serie A,2018,25.0,1993.0,5.8,6,1,2,2,2,2,6,33.3,4,3,0,3,3,9,3,0,"FW,MF",25-29,Forward,Argentina,South America
2071,Luca Rigoni,ITA,Parma,Serie A,2018,33.0,1984.0,19.6,42,25,25,15,2,9,26,34.6,17,19,2,17,18,60,39,0,MF,30-34,Midfielder,Italy,Europe
2072,Nicola Rigoni,ITA,Chievo,Serie A,2018,27.0,1990.0,21.7,43,25,22,15,6,22,51,43.1,29,20,5,15,23,66,45,1,MF,25-29,Midfielder,Italy,Europe
2074,Tomás Rincón,VEN,Torino,Serie A,2018,30.0,1988.0,31.1,75,44,25,41,9,31,68,45.6,37,35,5,30,42,117,71,1,MF,30-34,Midfielder,Venezuela,South America
2075,Renaud Ripart,FRA,Nîmes,Ligue 1,2018,25.0,1993.0,33.4,76,49,41,22,13,32,76,42.1,44,43,7,36,27,103,79,0,"FW,DF",25-29,Forward,France,Europe
2077,Matt Ritchie,SCO,Newcastle Utd,Premier League,2018,28.0,1989.0,32.5,70,44,35,27,8,19,47,40.4,28,34,11,23,51,121,76,1,"DF,MF",25-29,Defender,Scotland,Europe
2079,Arjen Robben,NED,Bayern Munich,Bundesliga,2018,34.0,1984.0,6.3,3,1,0,3,0,0,1,0.0,1,6,1,5,3,6,0,0,"FW,MF",30-34,Forward,Netherlands,Europe
2082,Patrick Roberts,ENG,Girona,La Liga,2018,21.0,1997.0,6.7,7,6,5,2,0,3,15,20.0,12,5,0,5,3,10,2,1,"MF,FW",20-24,Midfielder,England,Europe
2083,Andrew Robertson,SCO,Liverpool,Premier League,2018,24.0,1994.0,35.7,80,49,41,31,8,39,70,55.7,31,33,6,27,29,109,57,3,DF,20-24,Defender,Scotland,Europe
2086,Christopher Rocchia,FRA,Marseille,Ligue 1,2018,20.0,1998.0,0.0,0,0,0,0,0,0,0,,0,0,0,0,0,0,1,0,DF,20-24,Defender,France,Europe
2087,Kenny Rocha Santos,CPV,Saint-Étienne,Ligue 1,2018,18.0,2000.0,0.0,0,0,0,0,0,0,0,,0,0,0,0,0,0,0,0,MF,Under 20,Midfielder,Cape Verde,Africa
2089,Sebastian Rode,GER,Eint Frankfurt,Bundesliga,2018,27.0,1990.0,10.3,31,19,17,9,5,16,35,45.7,19,17,0,17,19,50,14,0,MF,25-29,Midfielder,Germany,Europe
2090,Ronny Rodelin,FRA,Guingamp,Ligue 1,2018,28.0,1989.0,8.8,13,5,2,7,4,3,8,37.5,5,8,1,7,8,21,13,0,"MF,FW",25-29,Midfielder,France,Europe
2093,Kévin Rodrigues,POR,Real Sociedad,La Liga,2018,24.0,1994.0,5.4,21,11,14,6,1,9,17,52.9,8,13,3,10,8,29,15,0,DF,20-24,Defender,Portugal,Europe
2097,James Rodríguez,COL,Bayern Munich,Bundesliga,2018,27.0,1991.0,12.6,12,8,3,4,5,5,19,26.3,14,9,0,9,4,16,1,0,MF,25-29,Midfielder,Colombia,South America
2098,Ricardo Rodríguez,SUI,Milan,Serie A,2018,25.0,1992.0,33.9,57,32,34,21,2,32,39,82.1,7,25,5,20,38,95,98,0,DF,25-29,Defender,Switzerland,Europe
2099,Marko Rog,CRO,Napoli,Serie A,2018,23.0,1995.0,3.7,12,9,3,7,2,5,11,45.5,6,8,2,6,5,17,1,0,MF,20-24,Midfielder,Croatia,Europe
2100,Marko Rog,CRO,Sevilla,La Liga,2018,23.0,1995.0,4.0,12,11,4,8,0,5,9,55.6,4,4,0,4,8,20,1,0,MF,20-24,Midfielder,Croatia,Europe
2101,Rogério,BRA,Sassuolo,Serie A,2018,20.0,1998.0,29.7,55,38,35,13,7,30,55,54.5,25,32,7,25,37,92,109,1,"DF,MF",20-24,Defender,Brazil,South America
2101,Rogério,BRA,Sassuolo,Serie A,2018,20.0,1998.0,29.7,55,38,35,13,7,30,55,54.5,25,32,7,25,37,92,109,1,"DF,MF",20-24,Defender,Brazil,South America
2101,Rogério,BRA,Sassuolo,Serie A,2018,20.0,1998.0,29.7,55,38,35,13,7,30,55,54.5,25,32,7,25,37,92,109,1,"DF,MF",20-24,Defender,Brazil,South America
2101,Rogério,BRA,Sassuolo,Serie A,2018,20.0,1998.0,29.7,55,38,35,13,7,30,55,54.5,25,32,7,25,37,92,109,1,"DF,MF",20-24,Defender,Brazil,South America
2102,Marcos Rojo,ARG,Manchester Utd,Premier League,2018,28.0,1990.0,2.4,5,3,3,2,0,1,6,16.7,5,3,2,1,6,11,9,1,DF,25-29,Defender,Argentina,South America
2103,Diego Rolán,URU,Leganés,La Liga,2018,25.0,1993.0,2.4,6,4,3,3,0,2,9,22.2,7,2,0,2,3,9,3,0,"MF,FW",25-29,Midfielder,Uruguay,South America
2104,Diego Rolán,URU,Alavés,La Liga,2018,25.0,1993.0,3.3,7,4,3,1,3,0,2,0.0,2,1,0,1,1,8,4,0,"MF,FW",25-29,Midfielder,Uruguay,South America
2105,Rolando,POR,Marseille,Ligue 1,2018,32.0,1985.0,8.9,18,7,15,3,0,8,10,80.0,2,8,6,2,11,29,25,0,DF,30-34,Defender,Portugal,Europe
2106,Esteban Rolón,ARG,Genoa,Serie A,2018,23.0,1995.0,11.6,46,29,14,20,12,20,44,45.5,24,18,2,16,16,62,12,0,MF,20-24,Midfielder,Argentina,South America
2107,Filippo Romagna,ITA,Cagliari,Serie A,2018,21.0,1997.0,16.4,14,9,10,4,0,4,8,50.0,4,20,12,8,19,33,68,0,DF,20-24,Defender,Italy,Europe
2108,Alessio Romagnoli,ITA,Milan,Serie A,2018,23.0,1995.0,31.6,34,19,26,6,2,16,19,84.2,3,48,32,16,37,71,173,1,DF,20-24,Defender,Italy,Europe
2110,Cristian Romero,ARG,Genoa,Serie A,2018,20.0,1998.0,26.0,61,35,38,18,5,27,40,67.5,13,49,27,22,37,98,128,1,DF,20-24,Defender,Argentina,South America
2112,Rômulo,ITA,Genoa,Serie A,2018,31.0,1987.0,15.0,26,18,9,10,7,7,17,41.2,10,16,3,13,18,44,20,0,"MF,FW",30-34,Midfielder,Italy,Europe
2112,Rômulo,ITA,Genoa,Serie A,2018,31.0,1987.0,15.0,26,18,9,10,7,7,17,41.2,10,16,3,13,18,44,20,0,"MF,FW",30-34,Midfielder,Italy,Europe
2112,Rômulo,ITA,Genoa,Serie A,2018,31.0,1987.0,15.0,26,18,9,10,7,7,17,41.2,10,16,3,13,18,44,20,0,"MF,FW",30-34,Midfielder,Italy,Europe
2112,Rômulo,ITA,Genoa,Serie A,2018,31.0,1987.0,15.0,26,18,9,10,7,7,17,41.2,10,16,3,13,18,44,20,0,"MF,FW",30-34,Midfielder,Italy,Europe
2112,Rômulo,ITA,Genoa,Serie A,2018,31.0,1987.0,15.0,26,18,9,10,7,7,17,41.2,10,16,3,13,18,44,20,0,"MF,FW",30-34,Midfielder,Italy,Europe
2112,Rômulo,ITA,Genoa,Serie A,2018,31.0,1987.0,15.0,26,18,9,10,7,7,17,41.2,10,16,3,13,18,44,20,0,"MF,FW",30-34,Midfielder,Italy,Europe
2112,Rômulo,ITA,Genoa,Serie A,2018,31.0,1987.0,15.0,26,18,9,10,7,7,17,41.2,10,16,3,13,18,44,20,0,"MF,FW",30-34,Midfielder,Italy,Europe
2112,Rômulo,ITA,Genoa,Serie A,2018,31.0,1987.0,15.0,26,18,9,10,7,7,17,41.2,10,16,3,13,18,44,20,0,"MF,FW",30-34,Midfielder,Italy,Europe
2112,Rômulo,ITA,Genoa,Serie A,2018,31.0,1987.0,15.0,26,18,9,10,7,7,17,41.2,10,16,3,13,18,44,20,0,"MF,FW",30-34,Midfielder,Italy,Europe
2112,Rômulo,ITA,Genoa,Serie A,2018,31.0,1987.0,15.0,26,18,9,10,7,7,17,41.2,10,16,3,13,18,44,20,0,"MF,FW",30-34,Midfielder,Italy,Europe
2112,Rômulo,ITA,Genoa,Serie A,2018,31.0,1987.0,15.0,26,18,9,10,7,7,17,41.2,10,16,3,13,18,44,20,0,"MF,FW",30-34,Midfielder,Italy,Europe
2112,Rômulo,ITA,Genoa,Serie A,2018,31.0,1987.0,15.0,26,18,9,10,7,7,17,41.2,10,16,3,13,18,44,20,0,"MF,FW",30-34,Midfielder,Italy,Europe
2112,Rômulo,ITA,Genoa,Serie A,2018,31.0,1987.0,15.0,26,18,9,10,7,7,17,41.2,10,16,3,13,18,44,20,0,"MF,FW",30-34,Midfielder,Italy,Europe
2112,Rômulo,ITA,Genoa,Serie A,2018,31.0,1987.0,15.0,26,18,9,10,7,7,17,41.2,10,16,3,13,18,44,20,0,"MF,FW",30-34,Midfielder,Italy,Europe
2112,Rômulo,ITA,Genoa,Serie A,2018,31.0,1987.0,15.0,26,18,9,10,7,7,17,41.2,10,16,3,13,18,44,20,0,"MF,FW",30-34,Midfielder,Italy,Europe
2112,Rômulo,ITA,Genoa,Serie A,2018,31.0,1987.0,15.0,26,18,9,10,7,7,17,41.2,10,16,3,13,18,44,20,0,"MF,FW",30-34,Midfielder,Italy,Europe
2113,Rômulo,ITA,Lazio,Serie A,2018,31.0,1987.0,8.6,10,5,8,2,0,5,7,71.4,2,10,2,8,5,15,13,0,DF,30-34,Defender,Italy,Europe
2113,Rômulo,ITA,Lazio,Serie A,2018,31.0,1987.0,8.6,10,5,8,2,0,5,7,71.4,2,10,2,8,5,15,13,0,DF,30-34,Defender,Italy,Europe
2113,Rômulo,ITA,Lazio,Serie A,2018,31.0,1987.0,8.6,10,5,8,2,0,5,7,71.4,2,10,2,8,5,15,13,0,DF,30-34,Defender,Italy,Europe
2113,Rômulo,ITA,Lazio,Serie A,2018,31.0,1987.0,8.6,10,5,8,2,0,5,7,71.4,2,10,2,8,5,15,13,0,DF,30-34,Defender,Italy,Europe
2113,Rômulo,ITA,Lazio,Serie A,2018,31.0,1987.0,8.6,10,5,8,2,0,5,7,71.4,2,10,2,8,5,15,13,0,DF,30-34,Defender,Italy,Europe
2113,Rômulo,ITA,Lazio,Serie A,2018,31.0,1987.0,8.6,10,5,8,2,0,5,7,71.4,2,10,2,8,5,15,13,0,DF,30-34,Defender,Italy,Europe
2113,Rômulo,ITA,Lazio,Serie A,2018,31.0,1987.0,8.6,10,5,8,2,0,5,7,71.4,2,10,2,8,5,15,13,0,DF,30-34,Defender,Italy,Europe
2113,Rômulo,ITA,Lazio,Serie A,2018,31.0,1987.0,8.6,10,5,8,2,0,5,7,71.4,2,10,2,8,5,15,13,0,DF,30-34,Defender,Italy,Europe
2113,Rômulo,ITA,Lazio,Serie A,2018,31.0,1987.0,8.6,10,5,8,2,0,5,7,71.4,2,10,2,8,5,15,13,0,DF,30-34,Defender,Italy,Europe
2113,Rômulo,ITA,Lazio,Serie A,2018,31.0,1987.0,8.6,10,5,8,2,0,5,7,71.4,2,10,2,8,5,15,13,0,DF,30-34,Defender,Italy,Europe
2113,Rômulo,ITA,Lazio,Serie A,2018,31.0,1987.0,8.6,10,5,8,2,0,5,7,71.4,2,10,2,8,5,15,13,0,DF,30-34,Defender,Italy,Europe
2113,Rômulo,ITA,Lazio,Serie A,2018,31.0,1987.0,8.6,10,5,8,2,0,5,7,71.4,2,10,2,8,5,15,13,0,DF,30-34,Defender,Italy,Europe
2113,Rômulo,ITA,Lazio,Serie A,2018,31.0,1987.0,8.6,10,5,8,2,0,5,7,71.4,2,10,2,8,5,15,13,0,DF,30-34,Defender,Italy,Europe
2113,Rômulo,ITA,Lazio,Serie A,2018,31.0,1987.0,8.6,10,5,8,2,0,5,7,71.4,2,10,2,8,5,15,13,0,DF,30-34,Defender,Italy,Europe
2113,Rômulo,ITA,Lazio,Serie A,2018,31.0,1987.0,8.6,10,5,8,2,0,5,7,71.4,2,10,2,8,5,15,13,0,DF,30-34,Defender,Italy,Europe
2113,Rômulo,ITA,Lazio,Serie A,2018,31.0,1987.0,8.6,10,5,8,2,0,5,7,71.4,2,10,2,8,5,15,13,0,DF,30-34,Defender,Italy,Europe
2114,Cristiano Ronaldo,POR,Juventus,Serie A,2018,33.0,1985.0,29.9,10,7,5,4,1,1,11,9.1,10,7,2,5,6,16,32,0,FW,30-34,Forward,Portugal,Europe
2115,Facundo Roncaglia,ARG,Valencia,La Liga,2018,31.0,1987.0,6.7,13,10,8,5,0,4,6,66.7,2,4,2,2,10,23,22,0,DF,30-34,Defender,Argentina,South America
2116,Facundo Roncaglia,ARG,Celta Vigo,La Liga,2018,31.0,1987.0,11.9,34,22,26,8,0,17,24,70.8,7,12,5,7,20,54,51,2,DF,30-34,Defender,Argentina,South America
2117,Salomón Rondón,VEN,Newcastle Utd,Premier League,2018,28.0,1989.0,28.9,8,3,2,4,2,4,24,16.7,20,14,3,11,5,13,39,0,FW,25-29,Forward,Venezuela,South America
2118,Valentin Rongier,FRA,Nantes,Ligue 1,2018,23.0,1994.0,35.8,86,54,24,46,16,26,65,40.0,39,46,6,40,33,119,19,0,MF,20-24,Midfielder,France,Europe
2119,Marten de Roon,NED,Atalanta,Serie A,2018,27.0,1991.0,33.1,102,57,32,61,9,34,94,36.2,60,48,9,39,53,155,49,1,MF,25-29,Midfielder,Netherlands,Europe
2120,Roberto Rosales,VEN,Espanyol,La Liga,2018,29.0,1988.0,19.4,48,31,22,16,10,21,44,47.7,23,19,7,12,22,70,68,0,DF,25-29,Defender,Venezuela,South America
2121,Danny Rose,ENG,Tottenham,Premier League,2018,28.0,1990.0,20.0,49,31,26,16,7,20,32,62.5,12,24,4,20,24,73,28,3,DF,25-29,Defender,England,Europe
2122,Valentin Rosier,FRA,Dijon,Ligue 1,2018,21.0,1996.0,16.2,44,25,22,19,3,16,31,51.6,15,25,4,21,32,76,45,1,"DF,MF",20-24,Defender,France,Europe
2123,Luca Rossettini,ITA,Chievo,Serie A,2018,33.0,1985.0,20.3,26,17,18,8,0,15,20,75.0,5,23,15,8,35,61,114,0,DF,30-34,Defender,Italy,Europe
2124,Francesco Rossi,ITA,Atalanta,Serie A,2018,27.0,1991.0,0.0,0,0,0,0,0,0,0,,0,0,0,0,0,0,0,0,GK,25-29,Goalkeeper,Italy,Europe
2125,Jérôme Roussillon,FRA,Wolfsburg,Bundesliga,2018,25.0,1993.0,27.3,42,29,25,15,2,20,30,66.7,10,50,7,43,31,73,54,0,DF,25-29,Defender,France,Europe
2126,Nolan Roux,FRA,Guingamp,Ligue 1,2018,30.0,1988.0,17.1,11,9,0,6,5,4,14,28.6,10,6,2,4,4,15,21,0,FW,30-34,Forward,France,Europe
2127,Aaron Rowe,ENG,Huddersfield,Premier League,2018,17.0,2000.0,0.8,1,0,1,0,0,0,0,,0,0,0,0,1,2,1,0,FW,Under 20,Forward,England,Europe
2129,John Ruddy,ENG,Wolves,Premier League,2018,31.0,1986.0,1.0,0,0,0,0,0,0,0,,0,0,0,0,0,0,0,0,GK,30-34,Goalkeeper,England,Europe
2130,Antonio Rüdiger,GER,Chelsea,Premier League,2018,25.0,1993.0,31.9,34,16,27,6,1,15,27,55.6,12,15,8,7,32,66,96,1,DF,25-29,Defender,Germany,Europe
2131,Sebastian Rudy,GER,Schalke 04,Bundesliga,2018,28.0,1990.0,15.1,44,24,11,27,6,11,41,26.8,30,23,2,21,15,59,15,0,MF,25-29,Midfielder,Germany,Europe
2132,Stéphane Ruffier,FRA,Saint-Étienne,Ligue 1,2018,31.0,1986.0,37.0,2,2,2,0,0,2,4,50.0,2,0,0,0,0,2,18,3,GK,30-34,Goalkeeper,France,Europe
2133,Daniele Rugani,ITA,Juventus,Serie A,2018,24.0,1994.0,15.0,8,5,5,3,0,2,5,40.0,3,19,14,5,16,24,51,1,DF,20-24,Defender,Italy,Europe
2134,Mário Rui,POR,Napoli,Serie A,2018,27.0,1991.0,15.7,24,18,9,12,3,14,25,56.0,11,15,3,12,21,45,38,0,DF,25-29,Defender,Portugal,Europe
2138,Gerónimo Rulli,ARG,Real Sociedad,La Liga,2018,26.0,1992.0,27.0,2,1,2,0,0,1,3,33.3,2,1,0,1,1,3,12,6,GK,25-29,Goalkeeper,Argentina,South America
2139,Lukas Rupp,GER,Hoffenheim,Bundesliga,2018,27.0,1991.0,0.3,1,1,0,0,1,0,0,,0,0,0,0,0,1,0,0,"MF,DF",25-29,Midfielder,Germany,Europe
2140,Marco Russ,GER,Eint Frankfurt,Bundesliga,2018,32.0,1985.0,4.2,7,2,5,2,0,4,6,66.7,2,2,2,0,7,14,8,0,DF,30-34,Defender,Germany,Europe
2141,Mathew Ryan,AUS,Brighton,Premier League,2018,26.0,1992.0,34.0,1,0,1,0,0,1,2,50.0,1,0,0,0,0,1,13,1,GK,25-29,Goalkeeper,Australia,Oceania
2142,Frederik Rønnow,DEN,Eint Frankfurt,Bundesliga,2018,25.0,1992.0,1.4,0,0,0,0,0,0,0,,0,0,0,0,0,0,1,0,GK,25-29,Goalkeeper,Denmark,Europe
2143,Idriss Saadi,ALG,Strasbourg,Ligue 1,2018,26.0,1992.0,0.1,0,0,0,0,0,0,0,,0,0,0,0,0,0,0,0,"FW,MF",25-29,Forward,Algeria,Africa
2144,Youssouf Sabaly,SEN,Bordeaux,Ligue 1,2018,25.0,1993.0,21.2,46,32,32,12,2,25,46,54.3,21,19,2,17,26,72,42,0,DF,25-29,Defender,Senegal,Africa
2145,Abdelhamid Sabiri,MAR,Huddersfield,Premier League,2018,21.0,1996.0,0.5,2,1,1,1,0,0,0,,0,1,0,1,1,3,0,0,FW,20-24,Forward,Morocco,Africa
2146,Marcel Sabitzer,AUT,RB Leipzig,Bundesliga,2018,24.0,1994.0,26.1,45,28,17,21,7,18,46,39.1,28,21,2,19,33,78,31,0,MF,20-24,Midfielder,Austria,Europe
2147,Ihsan Sacko,FRA,Nice,Ligue 1,2018,21.0,1997.0,4.9,7,2,2,5,0,2,5,40.0,3,5,0,5,2,9,2,0,FW,20-24,Forward,France,Europe
2148,Nuri Şahin,TUR,Werder Bremen,Bundesliga,2018,29.0,1988.0,16.4,60,33,22,33,5,23,59,39.0,36,30,3,27,37,97,39,1,MF,25-29,Midfielder,Turkey,Asia
2149,Samuel Şahin-Radlinger,AUT,Hannover 96,Bundesliga,2018,25.0,1992.0,1.0,0,0,0,0,0,0,0,,0,1,0,1,0,0,2,0,GK,25-29,Goalkeeper,Austria,Europe
2150,Wesley Saïd,FRA,Dijon,Ligue 1,2018,23.0,1995.0,25.0,25,18,6,11,8,5,20,25.0,15,9,0,9,9,34,9,0,"FW,MF",20-24,Forward,France,Europe
2151,Allan Saint-Maximin,FRA,Nice,Ligue 1,2018,21.0,1997.0,32.2,12,6,1,7,4,2,14,14.3,12,11,0,11,4,16,3,0,FW,20-24,Forward,France,Europe
2152,Théo Sainte-Luce,FRA,Nîmes,Ligue 1,2018,19.0,1998.0,0.0,0,0,0,0,0,0,0,,0,0,0,0,0,0,0,0,MF,Under 20,Midfielder,France,Europe
2153,Romain Saïss,MAR,Wolves,Premier League,2018,28.0,1990.0,12.8,39,26,23,14,2,20,37,54.1,17,25,12,13,26,65,61,0,"MF,DF",25-29,Midfielder,Morocco,Africa
2155,Bukayo Saka,ENG,Arsenal,Premier League,2018,16.0,2001.0,0.1,0,0,0,0,0,0,0,,0,0,0,0,0,0,0,0,FW,Under 20,Forward,England,Europe
2156,Hiroki Sakai,JPN,Marseille,Ligue 1,2018,28.0,1990.0,26.4,59,41,30,23,6,29,54,53.7,25,25,10,15,37,96,77,0,DF,25-29,Defender,Japan,Asia
2157,Diafra Sakho,SEN,Rennes,Ligue 1,2018,28.0,1989.0,1.6,2,1,0,0,2,0,0,,0,0,0,0,0,2,0,0,FW,25-29,Forward,Senegal,Africa
2158,Mamadou Sakho,FRA,Crystal Palace,Premier League,2018,28.0,1990.0,26.8,25,16,22,3,0,11,18,61.1,7,26,16,10,41,66,136,2,DF,25-29,Defender,France,Europe
2159,Bakary Sako,MLI,Crystal Palace,Premier League,2018,30.0,1988.0,0.3,2,1,2,0,0,1,1,100.0,0,0,0,0,0,2,0,0,FW,30-34,Forward,Mali,Africa
2160,Emiliano Sala,ARG,Nantes,Ligue 1,2018,27.0,1990.0,15.2,7,5,0,2,5,1,8,12.5,7,8,1,7,2,9,20,0,FW,25-29,Forward,Argentina,South America
2161,Jacopo Sala,ITA,Sampdoria,Serie A,2018,26.0,1991.0,16.9,38,23,20,14,4,23,41,56.1,18,11,3,8,20,58,47,2,DF,25-29,Defender,Italy,Europe
2162,Mohamed Salah,EGY,Liverpool,Premier League,2018,26.0,1992.0,36.1,21,9,3,11,7,5,16,31.3,11,9,0,9,5,26,6,0,FW,25-29,Forward,Egypt,Africa
2164,Carlos Salcedo,MEX,Eint Frankfurt,Bundesliga,2018,24.0,1993.0,5.1,7,3,4,3,0,4,7,57.1,3,7,3,4,9,16,22,0,DF,20-24,Defender,Mexico,North America
2165,William Saliba,FRA,Saint-Étienne,Ligue 1,2018,17.0,2001.0,14.2,32,20,28,4,0,16,24,66.7,8,11,10,1,28,60,44,2,DF,Under 20,Defender,France,Europe
2166,Yannis Salibur,FRA,Saint-Étienne,Ligue 1,2018,27.0,1991.0,9.8,9,5,1,7,1,1,7,14.3,6,6,0,6,8,17,4,0,"FW,MF",25-29,Forward,France,Europe
2167,Yannis Salibur,FRA,Guingamp,Ligue 1,2018,27.0,1991.0,0.2,0,0,0,0,0,0,0,,0,0,0,0,0,0,0,0,MF,25-29,Midfielder,France,Europe
2168,Roland Sallai,HUN,Freiburg,Bundesliga,2018,21.0,1997.0,5.9,12,7,5,5,2,5,13,38.5,8,3,0,3,3,15,8,0,MF,20-24,Midfielder,Hungary,Europe
2169,Edgar Salli,CMR,Nürnberg,Bundesliga,2018,25.0,1992.0,1.3,2,1,1,1,0,0,1,0.0,1,0,0,0,1,3,1,0,"FW,MF",25-29,Forward,Cameroon,Africa
2170,Brice Samba,FRA,Caen,Ligue 1,2018,24.0,1994.0,38.0,1,0,1,0,0,0,1,0.0,1,0,0,0,1,2,12,4,GK,20-24,Goalkeeper,France,Europe
2171,Junior Sambia,FRA,Montpellier,Ligue 1,2018,21.0,1996.0,10.3,15,7,7,7,1,6,15,40.0,9,14,2,12,5,20,3,0,"MF,FW",20-24,Midfielder,France,Europe
2172,Paolo Sammarco,ITA,Frosinone,Serie A,2018,35.0,1983.0,6.1,16,7,7,6,3,6,9,66.7,3,5,0,5,3,19,1,2,MF,35-39,Midfielder,Italy,Europe
2173,Frédéric Sammaritano,FRA,Dijon,Ligue 1,2018,32.0,1986.0,6.0,11,5,5,5,1,5,13,38.5,8,8,1,7,8,19,2,1,"FW,MF",30-34,Forward,France,Europe
2175,Antonio Sanabria,PAR,Genoa,Serie A,2018,22.0,1996.0,8.5,6,3,1,1,4,0,1,0.0,1,8,0,8,4,10,3,0,FW,20-24,Forward,Paraguay,South America
2176,Antonio Sanabria,PAR,Betis,La Liga,2018,22.0,1996.0,9.0,8,6,0,5,3,1,6,16.7,5,8,2,6,3,11,4,0,FW,20-24,Forward,Paraguay,South America
2177,Renato Sanches,POR,Bayern Munich,Bundesliga,2018,20.0,1997.0,6.4,5,5,2,1,2,3,10,30.0,7,7,0,7,4,9,2,0,MF,20-24,Midfielder,Portugal,Europe
2178,Alexis Sánchez,CHI,Manchester Utd,Premier League,2018,29.0,1988.0,9.8,17,10,5,9,3,5,13,38.5,8,7,0,7,9,26,2,0,"FW,MF",25-29,Forward,Chile,South America
2179,Carlos Sánchez,COL,West Ham,Premier League,2018,32.0,1986.0,2.7,4,3,4,0,0,3,8,37.5,5,1,0,1,1,5,5,2,MF,30-34,Midfielder,Colombia,South America
2180,Davinson Sánchez,COL,Tottenham,Premier League,2018,22.0,1996.0,21.6,37,20,28,9,0,20,37,54.1,17,17,9,8,30,67,103,2,DF,20-24,Defender,Colombia,South America
2183,Jadon Sancho,ENG,Dortmund,Bundesliga,2018,18.0,2000.0,27.3,19,10,7,6,6,10,31,32.3,21,21,1,20,14,33,12,1,"FW,MF",Under 20,Forward,England,Europe
2184,Sandro,BRA,Udinese,Serie A,2018,29.0,1989.0,6.6,18,10,10,8,0,7,13,53.8,6,14,5,9,11,29,16,0,MF,25-29,Midfielder,Brazil,South America
2184,Sandro,BRA,Udinese,Serie A,2018,29.0,1989.0,6.6,18,10,10,8,0,7,13,53.8,6,14,5,9,11,29,16,0,MF,25-29,Midfielder,Brazil,South America
2184,Sandro,BRA,Udinese,Serie A,2018,29.0,1989.0,6.6,18,10,10,8,0,7,13,53.8,6,14,5,9,11,29,16,0,MF,25-29,Midfielder,Brazil,South America
2184,Sandro,BRA,Udinese,Serie A,2018,29.0,1989.0,6.6,18,10,10,8,0,7,13,53.8,6,14,5,9,11,29,16,0,MF,25-29,Midfielder,Brazil,South America
2185,Sandro,BRA,Genoa,Serie A,2018,29.0,1989.0,7.9,27,17,12,11,4,9,17,52.9,8,9,4,5,20,47,25,0,MF,25-29,Midfielder,Brazil,South America
2185,Sandro,BRA,Genoa,Serie A,2018,29.0,1989.0,7.9,27,17,12,11,4,9,17,52.9,8,9,4,5,20,47,25,0,MF,25-29,Midfielder,Brazil,South America
2185,Sandro,BRA,Genoa,Serie A,2018,29.0,1989.0,7.9,27,17,12,11,4,9,17,52.9,8,9,4,5,20,47,25,0,MF,25-29,Midfielder,Brazil,South America
2185,Sandro,BRA,Genoa,Serie A,2018,29.0,1989.0,7.9,27,17,12,11,4,9,17,52.9,8,9,4,5,20,47,25,0,MF,25-29,Midfielder,Brazil,South America
2186,Alex Sandro,BRA,Juventus,Serie A,2018,27.0,1991.0,26.5,68,45,28,33,7,21,36,58.3,15,32,8,24,38,106,71,0,DF,25-29,Defender,Brazil,South America
2187,Leroy Sané,GER,Manchester City,Premier League,2018,22.0,1996.0,20.7,24,15,8,7,9,2,23,8.7,21,21,2,19,8,32,2,0,FW,20-24,Forward,Germany,Europe
2188,Salif Sané,SEN,Schalke 04,Bundesliga,2018,27.0,1990.0,29.0,54,37,34,19,1,27,46,58.7,19,44,29,15,68,122,146,3,DF,25-29,Defender,Senegal,Africa
2190,Ibrahim Sangaré,CIV,Toulouse,Ligue 1,2018,20.0,1997.0,27.4,102,66,50,44,8,32,63,50.8,31,52,20,32,29,131,49,2,MF,20-24,Midfielder,Ivory Coast,Africa
2191,Younousse Sankharé,SEN,Bordeaux,Ligue 1,2018,28.0,1989.0,16.4,25,12,2,19,4,6,19,31.6,13,14,0,14,9,34,4,0,MF,25-29,Midfielder,Senegal,Africa
2192,Baissama Sankoh,GUI,Caen,Ligue 1,2018,26.0,1992.0,7.2,4,1,4,0,0,1,4,25.0,3,8,1,7,5,9,16,0,"MF,FW",25-29,Midfielder,Guinea,Africa
2193,Yaya Sanogo,FRA,Toulouse,Ligue 1,2018,25.0,1993.0,13.8,4,2,0,2,2,2,4,50.0,2,3,0,3,3,7,15,0,FW,25-29,Forward,France,Europe
2194,Morgan Sanson,FRA,Marseille,Ligue 1,2018,23.0,1994.0,26.7,70,47,27,35,8,21,77,27.3,56,40,1,39,42,112,8,1,MF,20-24,Midfielder,France,Europe
2195,Nicola Sansone,ITA,Bologna,Serie A,2018,26.0,1991.0,12.7,29,17,9,14,6,9,27,33.3,18,13,1,12,9,38,4,0,FW,25-29,Forward,Italy,Europe
2196,Nicola Sansone,ITA,Villarreal,La Liga,2018,26.0,1991.0,0.4,0,0,0,0,0,0,0,,0,0,0,0,0,0,0,0,"FW,MF",25-29,Forward,Italy,Europe
2197,Baptiste Santamaria,FRA,Angers,Ligue 1,2018,23.0,1995.0,36.1,118,60,48,63,7,51,106,48.1,55,41,4,37,57,175,57,2,MF,20-24,Midfielder,France,Europe
2199,Federico Santander,PAR,Bologna,Serie A,2018,27.0,1991.0,22.9,18,10,6,8,4,2,23,8.7,21,20,2,18,9,27,30,0,FW,25-29,Forward,Paraguay,South America
2200,Davide Santon,ITA,Roma,Serie A,2018,27.0,1991.0,11.2,14,6,8,6,0,8,12,66.7,4,11,7,4,15,29,27,0,DF,25-29,Defender,Italy,Europe
2201,Michael Santos,URU,Leganés,La Liga,2018,25.0,1993.0,6.2,12,5,1,7,4,2,7,28.6,5,7,1,6,1,13,1,0,"FW,MF",25-29,Forward,Uruguay,South America
2202,Samir Santos,BRA,Udinese,Serie A,2018,23.0,1994.0,20.0,47,33,27,18,2,19,25,76.0,6,18,9,9,34,81,96,0,DF,20-24,Defender,Brazil,South America
2203,Riccardo Saponara,ITA,Sampdoria,Serie A,2018,26.0,1991.0,10.1,12,6,2,6,4,3,12,25.0,9,5,1,4,4,16,10,0,MF,25-29,Midfielder,Italy,Europe
2205,Marcelo Saracchi,URU,RB Leipzig,Bundesliga,2018,20.0,1998.0,7.3,17,11,12,4,1,8,13,61.5,5,12,1,11,11,28,14,0,DF,20-24,Defender,Uruguay,South America
2206,Josh Sargent,USA,Werder Bremen,Bundesliga,2018,18.0,2000.0,2.4,2,1,1,0,1,2,2,100.0,0,2,0,2,0,2,3,0,FW,Under 20,Forward,United States,North America
2207,Bouna Sarr,SEN,Marseille,Ligue 1,2018,26.0,1992.0,24.9,67,48,27,27,13,26,42,61.9,16,28,3,25,39,106,56,1,"DF,MF",25-29,Defender,Senegal,Africa
2208,Ismaila Sarr,SEN,Rennes,Ligue 1,2018,20.0,1998.0,31.0,35,24,16,15,4,17,34,50.0,17,17,2,15,14,49,4,0,"FW,MF",20-24,Forward,Senegal,Africa
2209,Malang Sarr,FRA,Nice,Ligue 1,2018,19.0,1999.0,33.3,59,36,38,17,4,31,57,54.4,26,29,12,17,68,127,107,2,DF,Under 20,Defender,France,Europe
2211,Marco Sau,ITA,Sampdoria,Serie A,2018,30.0,1987.0,0.6,0,0,0,0,0,0,0,,0,1,0,1,0,0,0,0,"MF,FW",30-34,Midfielder,Italy,Europe
2212,Marco Sau,ITA,Cagliari,Serie A,2018,30.0,1987.0,6.2,4,2,0,2,2,0,3,0.0,3,5,0,5,1,5,4,0,"FW,MF",30-34,Forward,Italy,Europe
2213,Téji Savanier,FRA,Nîmes,Ligue 1,2018,26.0,1991.0,31.8,95,58,35,52,8,43,116,37.1,73,32,15,17,64,159,53,2,MF,25-29,Midfielder,France,Europe
2214,Stefan Savić,MNE,Atlético Madrid,La Liga,2018,27.0,1991.0,15.5,11,10,9,2,0,7,12,58.3,5,13,9,4,22,33,67,0,DF,25-29,Defender,Montenegro,Europe
2215,Fabian Schär,SUI,Newcastle Utd,Premier League,2018,26.0,1991.0,22.2,60,39,37,19,4,24,50,48.0,26,40,16,24,67,127,145,2,DF,25-29,Defender,Switzerland,Europe
2216,Ezequiel Schelotto,ITA,Chievo,Serie A,2018,29.0,1989.0,1.6,3,0,3,0,0,2,3,66.7,1,1,0,1,2,5,8,0,DF,25-29,Defender,Italy,Europe
2217,Nicolás Schiappacasse,URU,Parma,Serie A,2018,19.0,1999.0,0.9,0,0,0,0,0,0,0,,0,2,0,2,0,0,0,0,"FW,MF",Under 20,Forward,Uruguay,South America
2218,Pasquale Schiattarella,ITA,SPAL,Serie A,2018,31.0,1987.0,20.5,43,27,18,21,4,13,38,34.2,25,17,5,12,22,65,25,1,MF,30-34,Midfielder,Italy,Europe
2220,Julian Schieber,GER,Augsburg,Bundesliga,2018,29.0,1989.0,2.9,3,2,1,2,0,0,1,0.0,1,1,0,1,1,4,3,0,FW,25-29,Forward,Germany,Europe
2221,Christopher Schindler,GER,Huddersfield,Premier League,2018,28.0,1990.0,36.2,61,36,46,14,1,27,47,57.4,20,69,34,35,70,131,138,4,DF,25-29,Defender,Germany,Europe
2222,Keven Schlotterbeck,GER,Freiburg,Bundesliga,2018,21.0,1997.0,8.6,22,16,19,2,1,8,12,66.7,4,17,11,6,13,35,26,0,DF,20-24,Defender,Germany,Europe
2223,Nico Schlotterbeck,GER,Freiburg,Bundesliga,2018,18.0,1999.0,2.5,6,6,6,0,0,2,2,100.0,0,3,1,2,5,11,10,0,DF,Under 20,Defender,Germany,Europe
2224,Jeffrey Schlupp,GHA,Crystal Palace,Premier League,2018,25.0,1992.0,18.6,41,20,18,18,5,10,27,37.0,17,30,8,22,19,60,27,1,"MF,FW",25-29,Midfielder,Ghana,Africa
2225,Kasper Schmeichel,DEN,Leicester City,Premier League,2018,31.0,1986.0,38.0,1,1,1,0,0,1,1,100.0,0,0,0,0,3,4,14,3,GK,30-34,Goalkeeper,Denmark,Europe
2226,Marcel Schmelzer,GER,Dortmund,Bundesliga,2018,30.0,1988.0,6.3,10,5,7,2,1,5,9,55.6,4,7,1,6,9,19,14,0,DF,30-34,Defender,Germany,Europe
2227,Jonathan Schmid,FRA,Augsburg,Bundesliga,2018,28.0,1990.0,28.0,44,22,23,19,2,16,28,57.1,12,22,8,14,43,87,70,2,DF,25-29,Defender,France,Europe
2228,Morgan Schneiderlin,FRA,Everton,Premier League,2018,28.0,1989.0,9.3,24,16,11,11,2,6,14,42.9,8,16,3,13,15,39,16,0,MF,25-29,Midfielder,France,Europe
2229,Alessandro Schöpf,AUT,Schalke 04,Bundesliga,2018,24.0,1994.0,11.2,26,16,12,13,1,12,29,41.4,17,14,0,14,9,35,12,0,"MF,DF",20-24,Midfielder,Austria,Europe
2230,Nico Schulz,GER,Hoffenheim,Bundesliga,2018,25.0,1993.0,28.2,34,20,19,12,3,15,36,41.7,21,32,4,28,24,58,36,0,DF,25-29,Defender,Germany,Europe
2231,André Schürrle,GER,Fulham,Premier League,2018,27.0,1990.0,18.2,30,19,14,10,6,12,42,28.6,30,16,1,15,8,38,17,1,"FW,MF",25-29,Forward,Germany,Europe
2232,Pirmin Schwegler,SUI,Hannover 96,Bundesliga,2018,31.0,1987.0,23.1,63,34,30,29,4,34,60,56.7,26,21,5,16,41,104,54,0,MF,30-34,Midfielder,Switzerland,Europe
2233,Alexander Schwolow,GER,Freiburg,Bundesliga,2018,26.0,1992.0,33.0,0,0,0,0,0,0,1,0.0,1,0,0,0,0,0,13,2,GK,25-29,Goalkeeper,Germany,Europe
2234,Matteo Scozzarella,ITA,Parma,Serie A,2018,30.0,1988.0,16.2,18,13,9,8,1,9,33,27.3,24,22,10,12,23,41,33,0,MF,30-34,Midfielder,Italy,Europe
2235,Simone Scuffet,ITA,Udinese,Serie A,2018,22.0,1996.0,9.0,0,0,0,0,0,0,1,0.0,1,0,0,0,0,0,4,2,GK,20-24,Goalkeeper,Italy,Europe
2236,Andrea Seculin,ITA,Chievo,Serie A,2018,28.0,1990.0,1.0,0,0,0,0,0,0,0,,0,0,0,0,0,0,1,0,GK,25-29,Goalkeeper,Italy,Europe
2238,Davie Selke,GER,Hertha BSC,Bundesliga,2018,23.0,1995.0,19.3,5,2,1,4,0,2,9,22.2,7,11,0,11,1,6,7,0,FW,20-24,Forward,Germany,Europe
2240,Matz Sels,BEL,Strasbourg,Ligue 1,2018,26.0,1992.0,37.0,0,0,0,0,0,0,1,0.0,1,0,0,0,1,1,24,1,GK,25-29,Goalkeeper,Belgium,Europe
2241,Ken Sema,SWE,Watford,Premier League,2018,24.0,1993.0,8.4,15,7,7,5,3,9,21,42.9,12,7,0,7,8,23,5,0,"MF,FW",20-24,Midfielder,Sweden,Europe
2242,Alfa Semedo,GNB,Espanyol,La Liga,2018,20.0,1997.0,0.5,0,0,0,0,0,0,3,0.0,3,1,1,0,2,2,0,0,MF,20-24,Midfielder,Guinea-Bissau,Africa
2243,Nélson Semedo,POR,Barcelona,La Liga,2018,24.0,1993.0,17.8,38,27,23,12,3,12,18,66.7,6,23,7,16,22,60,26,0,DF,20-24,Defender,Portugal,Europe
2244,Rúben Semedo,POR,Huesca,La Liga,2018,24.0,1994.0,9.4,20,16,14,6,0,12,16,75.0,4,15,9,6,16,36,35,2,DF,20-24,Defender,Portugal,Europe
2245,Adrian Šemper,CRO,Chievo,Serie A,2018,20.0,1998.0,6.0,0,0,0,0,0,0,0,,0,0,0,0,1,1,3,0,GK,20-24,Goalkeeper,Croatia,Europe
2246,Stefano Sensi,ITA,Sassuolo,Serie A,2018,22.0,1995.0,21.9,36,20,15,18,3,6,30,20.0,24,36,7,29,33,69,17,0,MF,20-24,Midfielder,Italy,Europe
2247,Luigi Sepe,ITA,Parma,Serie A,2018,27.0,1991.0,37.0,1,1,1,0,0,1,2,50.0,1,0,0,0,3,4,21,3,GK,25-29,Goalkeeper,Italy,Europe
2248,Suat Serdar,GER,Schalke 04,Bundesliga,2018,21.0,1997.0,19.2,51,32,20,26,5,14,49,28.6,35,37,6,31,23,74,5,1,MF,20-24,Midfielder,Germany,Europe
2249,Jean Seri,CIV,Fulham,Premier League,2018,27.0,1991.0,24.9,41,28,20,20,1,13,45,28.9,32,40,9,31,32,73,17,4,MF,25-29,Midfielder,Ivory Coast,Africa
2250,Leonardo Sernicola,ITA,Sassuolo,Serie A,2018,21.0,1997.0,0.1,0,0,0,0,0,0,0,,0,0,0,0,0,0,0,0,FW,20-24,Forward,Italy,Europe
2251,Julien Serrano,FRA,Monaco,Ligue 1,2018,20.0,1998.0,1.3,5,4,3,2,0,3,6,50.0,3,1,0,1,3,8,3,0,"MF,DF",20-24,Midfielder,France,Europe
2252,Grégory Sertic,FRA,Marseille,Ligue 1,2018,28.0,1989.0,1.2,2,0,1,1,0,0,1,0.0,1,2,1,1,1,3,2,0,MF,25-29,Midfielder,France,Europe
2253,Ryan Sessegnon,ENG,Fulham,Premier League,2018,18.0,2000.0,25.6,22,14,8,8,6,6,22,27.3,16,25,2,23,19,41,49,1,"FW,DF",Under 20,Forward,England,Europe
2254,Paik Seung-ho,KOR,Girona,La Liga,2018,21.0,1997.0,0.7,0,0,0,0,0,0,1,0.0,1,1,0,1,3,3,1,0,"FW,MF",20-24,Forward,South Korea,Asia
2255,Stephan El Shaarawy,ITA,Roma,Serie A,2018,25.0,1992.0,23.4,27,14,14,8,5,9,24,37.5,15,11,2,9,20,47,9,0,"FW,MF",25-29,Forward,Italy,Europe
2256,Meritan Shabani,ALB,Bayern Munich,Bundesliga,2018,19.0,1999.0,0.0,0,0,0,0,0,0,0,,0,0,0,0,0,0,0,0,MF,Under 20,Midfielder,Albania,Europe
2257,Xherdan Shaqiri,SUI,Liverpool,Premier League,2018,26.0,1991.0,11.8,14,4,3,9,2,9,19,47.4,10,6,1,5,6,20,6,0,"FW,MF",25-29,Forward,Switzerland,Europe
2258,Luke Shaw,ENG,Manchester Utd,Premier League,2018,23.0,1995.0,28.8,55,29,17,31,7,28,47,59.6,19,42,12,30,21,76,93,2,DF,20-24,Defender,England,Europe
2259,Jonjo Shelvey,ENG,Newcastle Utd,Premier League,2018,26.0,1992.0,10.5,22,12,10,9,3,8,17,47.1,9,10,3,7,7,29,15,0,MF,25-29,Midfielder,England,Europe
2260,Gaku Shibasaki,JPN,Getafe,La Liga,2018,26.0,1992.0,4.3,7,3,2,4,1,3,6,50.0,3,2,0,2,3,10,4,0,"MF,FW",25-29,Midfielder,Japan,Asia
2261,Gen Shoji,JPN,Toulouse,Ligue 1,2018,25.0,1992.0,18.0,24,13,16,8,0,11,24,45.8,13,22,14,8,21,45,56,0,DF,25-29,Defender,Japan,Asia
2262,Djibril Sidibé,FRA,Monaco,Ligue 1,2018,26.0,1992.0,23.1,50,34,27,12,11,26,48,54.2,22,25,9,16,30,80,51,0,"DF,MF",25-29,Defender,France,Europe
2263,Kalidou Sidibé,FRA,Toulouse,Ligue 1,2018,19.0,1999.0,14.0,24,12,11,12,1,7,15,46.7,8,16,3,13,17,41,26,1,MF,Under 20,Midfielder,France,Europe
2264,Sidnei,BRA,Betis,La Liga,2018,28.0,1989.0,19.4,48,29,33,12,3,18,34,52.9,16,21,8,13,41,89,57,0,DF,25-29,Defender,Brazil,South America
2265,Francisco Sierralta,CHI,Parma,Serie A,2018,21.0,1997.0,3.0,11,8,8,3,0,4,6,66.7,2,1,1,0,4,15,27,0,DF,20-24,Defender,Chile,South America
2266,Gylfi Sigurðsson,ISL,Everton,Premier League,2018,28.0,1989.0,34.6,56,36,20,25,11,16,47,34.0,31,38,4,34,28,84,24,0,MF,25-29,Midfielder,Iceland,Europe
2267,Luca Siligardi,ITA,Parma,Serie A,2018,30.0,1988.0,18.2,30,20,10,13,7,8,23,34.8,15,19,3,16,15,45,11,0,FW,30-34,Forward,Italy,Europe
2268,Adrien Silva,POR,Leicester City,Premier League,2018,29.0,1989.0,1.0,2,2,0,1,1,0,2,0.0,2,1,0,1,1,3,1,0,MF,25-29,Midfielder,Portugal,Europe
2269,Adrien Silva,POR,Monaco,Ligue 1,2018,29.0,1989.0,13.2,50,31,19,26,5,30,62,48.4,32,15,2,13,16,66,23,0,MF,25-29,Midfielder,Portugal,Europe
2270,André Silva,POR,Sevilla,La Liga,2018,22.0,1995.0,24.0,8,5,1,4,3,1,11,9.1,10,17,1,16,3,11,32,0,FW,20-24,Forward,Portugal,Europe
2270,André Silva,POR,Sevilla,La Liga,2018,22.0,1995.0,24.0,8,5,1,4,3,1,11,9.1,10,17,1,16,3,11,32,0,FW,20-24,Forward,Portugal,Europe
2270,André Silva,POR,Sevilla,La Liga,2018,22.0,1995.0,24.0,8,5,1,4,3,1,11,9.1,10,17,1,16,3,11,32,0,FW,20-24,Forward,Portugal,Europe
2270,André Silva,POR,Sevilla,La Liga,2018,22.0,1995.0,24.0,8,5,1,4,3,1,11,9.1,10,17,1,16,3,11,32,0,FW,20-24,Forward,Portugal,Europe
2270,André Silva,POR,Sevilla,La Liga,2018,22.0,1995.0,24.0,8,5,1,4,3,1,11,9.1,10,17,1,16,3,11,32,0,FW,20-24,Forward,Portugal,Europe
2270,André Silva,POR,Sevilla,La Liga,2018,22.0,1995.0,24.0,8,5,1,4,3,1,11,9.1,10,17,1,16,3,11,32,0,FW,20-24,Forward,Portugal,Europe
2270,André Silva,POR,Sevilla,La Liga,2018,22.0,1995.0,24.0,8,5,1,4,3,1,11,9.1,10,17,1,16,3,11,32,0,FW,20-24,Forward,Portugal,Europe
2270,André Silva,POR,Sevilla,La Liga,2018,22.0,1995.0,24.0,8,5,1,4,3,1,11,9.1,10,17,1,16,3,11,32,0,FW,20-24,Forward,Portugal,Europe
2270,André Silva,POR,Sevilla,La Liga,2018,22.0,1995.0,24.0,8,5,1,4,3,1,11,9.1,10,17,1,16,3,11,32,0,FW,20-24,Forward,Portugal,Europe
2271,Bernardo Silva,POR,Manchester City,Premier League,2018,23.0,1994.0,31.7,52,39,18,21,13,16,67,23.9,51,47,3,44,25,77,26,1,"MF,FW",20-24,Midfielder,Portugal,Europe
2273,Gabriel Silva,BRA,Saint-Étienne,Ligue 1,2018,27.0,1991.0,15.9,19,10,13,6,0,6,17,35.3,11,15,3,12,14,33,60,1,DF,25-29,Defender,Brazil,South America
2273,Gabriel Silva,BRA,Saint-Étienne,Ligue 1,2018,27.0,1991.0,15.9,19,10,13,6,0,6,17,35.3,11,15,3,12,14,33,60,1,DF,25-29,Defender,Brazil,South America
2273,Gabriel Silva,BRA,Saint-Étienne,Ligue 1,2018,27.0,1991.0,15.9,19,10,13,6,0,6,17,35.3,11,15,3,12,14,33,60,1,DF,25-29,Defender,Brazil,South America
2273,Gabriel Silva,BRA,Saint-Étienne,Ligue 1,2018,27.0,1991.0,15.9,19,10,13,6,0,6,17,35.3,11,15,3,12,14,33,60,1,DF,25-29,Defender,Brazil,South America
2274,Jonathan Silva,ARG,Leganés,La Liga,2018,24.0,1994.0,30.0,51,38,30,17,4,23,52,44.2,29,23,2,21,29,80,86,0,"DF,FW",20-24,Defender,Argentina,South America
2274,Jonathan Silva,ARG,Leganés,La Liga,2018,24.0,1994.0,30.0,51,38,30,17,4,23,52,44.2,29,23,2,21,29,80,86,0,"DF,FW",20-24,Defender,Argentina,South America
2274,Jonathan Silva,ARG,Leganés,La Liga,2018,24.0,1994.0,30.0,51,38,30,17,4,23,52,44.2,29,23,2,21,29,80,86,0,"DF,FW",20-24,Defender,Argentina,South America
2274,Jonathan Silva,ARG,Leganés,La Liga,2018,24.0,1994.0,30.0,51,38,30,17,4,23,52,44.2,29,23,2,21,29,80,86,0,"DF,FW",20-24,Defender,Argentina,South America
2275,Matheus Pereira da Silva,BRA,Juventus,Serie A,2018,20.0,1998.0,1.0,3,2,0,2,1,2,4,50.0,2,1,0,1,0,3,1,0,MF,20-24,Midfielder,Brazil,South America
2276,Thiago Silva,BRA,Paris S-G,Ligue 1,2018,33.0,1984.0,23.1,16,13,7,8,1,6,11,54.5,5,28,20,8,32,48,99,1,DF,30-34,Defender,Brazil,South America
2276,Thiago Silva,BRA,Paris S-G,Ligue 1,2018,33.0,1984.0,23.1,16,13,7,8,1,6,11,54.5,5,28,20,8,32,48,99,1,DF,30-34,Defender,Brazil,South America
2276,Thiago Silva,BRA,Paris S-G,Ligue 1,2018,33.0,1984.0,23.1,16,13,7,8,1,6,11,54.5,5,28,20,8,32,48,99,1,DF,30-34,Defender,Brazil,South America
2276,Thiago Silva,BRA,Paris S-G,Ligue 1,2018,33.0,1984.0,23.1,16,13,7,8,1,6,11,54.5,5,28,20,8,32,48,99,1,DF,30-34,Defender,Brazil,South America
2277,Xande Silva,POR,West Ham,Premier League,2018,21.0,1997.0,0.2,0,0,0,0,0,0,0,,0,1,0,1,0,0,0,0,FW,20-24,Forward,Portugal,Europe
2278,Matías Silvestre,ARG,Empoli,Serie A,2018,33.0,1984.0,34.0,31,17,22,5,4,17,26,65.4,9,29,24,5,21,52,165,0,DF,30-34,Defender,Argentina,South America
2279,Giovanni Simeone,ARG,Fiorentina,Serie A,2018,23.0,1995.0,27.3,43,27,10,23,10,7,29,24.1,22,26,2,24,4,47,14,0,FW,20-24,Forward,Argentina,South America
2280,Lorenco Šimić,CRO,SPAL,Serie A,2018,22.0,1996.0,2.6,6,3,5,1,0,2,4,50.0,2,2,1,1,12,18,19,1,DF,20-24,Defender,Croatia,Europe
2281,Moses Simon,NGA,Levante,La Liga,2018,23.0,1995.0,8.7,14,8,10,2,2,5,9,55.6,4,10,1,9,12,26,14,0,"DF,MF",20-24,Defender,Nigeria,Africa
2283,Danny Simpson,ENG,Leicester City,Premier League,2018,31.0,1987.0,3.2,11,3,8,3,0,3,5,60.0,2,7,3,4,6,17,20,0,DF,30-34,Defender,England,Europe
2284,Jack Simpson,ENG,Bournemouth,Premier League,2018,21.0,1996.0,4.5,9,5,8,1,0,6,9,66.7,3,5,4,1,9,18,25,2,DF,20-24,Defender,England,Europe
2285,Josh Sims,ENG,Southampton,Premier League,2018,21.0,1997.0,2.4,1,0,1,0,0,1,3,33.3,2,2,0,2,1,2,1,0,MF,20-24,Midfielder,England,Europe
2286,Giovanni Sio,CIV,Montpellier,Ligue 1,2018,29.0,1989.0,0.7,0,0,0,0,0,0,0,,0,0,0,0,0,0,0,0,FW,25-29,Forward,Ivory Coast,Africa
2287,Dimitris Siovas,GRE,Leganés,La Liga,2018,29.0,1988.0,32.9,57,32,38,18,1,27,47,57.4,20,32,15,17,65,122,155,1,DF,25-29,Defender,Greece,Europe
2288,Salvatore Sirigu,ITA,Torino,Serie A,2018,31.0,1987.0,35.2,0,0,0,0,0,0,2,0.0,2,0,0,0,2,2,21,1,GK,30-34,Goalkeeper,Italy,Europe
2289,Ibrahima Sissoko,MLI,Strasbourg,Ligue 1,2018,20.0,1997.0,29.6,60,41,23,34,3,23,55,41.8,32,37,3,34,34,94,39,1,MF,20-24,Midfielder,Mali,Africa
2290,Moussa Sissoko,FRA,Tottenham,Premier League,2018,28.0,1989.0,25.9,36,25,18,14,4,15,29,51.7,14,31,4,27,16,52,25,2,"MF,FW",25-29,Midfielder,France,Europe
2291,Pione Sisto,DEN,Celta Vigo,La Liga,2018,23.0,1995.0,9.4,4,3,4,0,0,0,9,0.0,9,5,0,5,3,7,3,0,"FW,MF",20-24,Forward,Denmark,Europe
2293,Ellyes Skhiri,TUN,Montpellier,Ligue 1,2018,23.0,1995.0,34.3,105,58,31,64,10,43,91,47.3,48,60,7,53,60,165,41,0,MF,20-24,Midfielder,Tunisia,Africa
2294,Oliver Skipp,ENG,Tottenham,Premier League,2018,17.0,2000.0,2.4,7,3,4,3,0,4,6,66.7,2,2,1,1,1,8,7,0,MF,Under 20,Midfielder,England,Europe
2296,Milan Škriniar,SVK,Inter,Serie A,2018,23.0,1995.0,35.0,64,37,46,17,1,38,60,63.3,22,48,29,19,27,91,138,0,DF,20-24,Defender,Slovakia,Europe
2297,Steven Skrzybski,GER,Schalke 04,Bundesliga,2018,25.0,1992.0,7.4,9,3,0,6,3,3,11,27.3,8,8,1,7,3,12,2,0,"FW,MF",25-29,Forward,Germany,Europe
2299,Callum Slattery,ENG,Southampton,Premier League,2018,19.0,1999.0,1.2,4,3,0,4,0,3,7,42.9,4,1,1,0,2,6,1,0,MF,Under 20,Midfielder,England,Europe
2300,Naïm Sliti,TUN,Dijon,Ligue 1,2018,26.0,1992.0,25.4,56,33,24,19,13,15,46,32.6,31,18,0,18,11,67,9,0,"MF,FW",25-29,Midfielder,Tunisia,Africa
2301,Chris Smalling,ENG,Manchester Utd,Premier League,2018,28.0,1989.0,23.6,30,17,21,9,0,11,17,64.7,6,37,25,12,26,56,109,1,DF,25-29,Defender,England,Europe
2302,Adam Smith,ENG,Bournemouth,Premier League,2018,27.0,1991.0,23.0,46,32,26,14,6,19,41,46.3,22,26,7,19,31,77,68,1,"DF,MF",25-29,Defender,England,Europe
2302,Adam Smith,ENG,Bournemouth,Premier League,2018,27.0,1991.0,23.0,46,32,26,14,6,19,41,46.3,22,26,7,19,31,77,68,1,"DF,MF",25-29,Defender,England,Europe
2302,Adam Smith,ENG,Bournemouth,Premier League,2018,27.0,1991.0,23.0,46,32,26,14,6,19,41,46.3,22,26,7,19,31,77,68,1,"DF,MF",25-29,Defender,England,Europe
2302,Adam Smith,ENG,Bournemouth,Premier League,2018,27.0,1991.0,23.0,46,32,26,14,6,19,41,46.3,22,26,7,19,31,77,68,1,"DF,MF",25-29,Defender,England,Europe
2303,Emile Smith Rowe,ENG,RB Leipzig,Bundesliga,2018,18.0,2000.0,0.3,1,0,0,1,0,1,1,100.0,0,0,0,0,1,2,0,0,MF,Under 20,Midfielder,England,Europe
2304,Tommy Smith,ENG,Huddersfield,Premier League,2018,26.0,1992.0,12.7,26,13,14,11,1,10,25,40.0,15,12,4,8,18,44,25,0,DF,25-29,Defender,England,Europe
2304,Tommy Smith,ENG,Huddersfield,Premier League,2018,26.0,1992.0,12.7,26,13,14,11,1,10,25,40.0,15,12,4,8,18,44,25,0,DF,25-29,Defender,England,Europe
2304,Tommy Smith,ENG,Huddersfield,Premier League,2018,26.0,1992.0,12.7,26,13,14,11,1,10,25,40.0,15,12,4,8,18,44,25,0,DF,25-29,Defender,England,Europe
2304,Tommy Smith,ENG,Huddersfield,Premier League,2018,26.0,1992.0,12.7,26,13,14,11,1,10,25,40.0,15,12,4,8,18,44,25,0,DF,25-29,Defender,England,Europe
2305,Robert Snodgrass,SCO,West Ham,Premier League,2018,30.0,1987.0,24.7,44,27,18,24,2,13,46,28.3,33,24,4,20,11,55,23,0,MF,30-34,Midfielder,Scotland,Europe
2306,Cédric Soares,POR,Southampton,Premier League,2018,26.0,1991.0,16.6,22,16,15,6,1,9,15,60.0,6,21,5,16,22,44,60,2,DF,25-29,Defender,Portugal,Europe
2307,Cédric Soares,POR,Inter,Serie A,2018,26.0,1991.0,2.9,8,6,2,4,2,4,7,57.1,3,4,1,3,2,10,3,0,DF,25-29,Defender,Portugal,Europe
2308,Ramadan Sobhi,EGY,Huddersfield,Premier League,2018,21.0,1997.0,0.9,1,1,0,1,0,0,0,,0,2,0,2,1,2,0,0,"FW,MF",20-24,Forward,Egypt,Africa
2309,Marcel Sobottka,GER,Düsseldorf,Bundesliga,2018,24.0,1994.0,10.5,30,20,12,18,0,10,19,52.6,9,13,5,8,24,54,17,0,MF,20-24,Midfielder,Germany,Europe
2312,Danilo Soddimo,ITA,Frosinone,Serie A,2018,30.0,1987.0,2.8,11,9,3,6,2,3,6,50.0,3,2,1,1,7,18,3,0,"MF,FW",30-34,Midfielder,Italy,Europe
2314,Dominic Solanke,ENG,Bournemouth,Premier League,2018,20.0,1997.0,3.9,8,3,1,4,3,1,8,12.5,7,4,1,3,2,10,9,0,"FW,MF",20-24,Forward,England,Europe
2315,Andrés Solano,COL,Atlético Madrid,La Liga,2018,20.0,1998.0,0.5,4,3,2,2,0,2,2,100.0,0,1,0,1,0,4,1,0,DF,20-24,Defender,Colombia,South America
2317,Oumar Solet,FRA,Lyon,Ligue 1,2018,18.0,2000.0,0.7,1,0,1,0,0,1,1,100.0,0,1,0,1,0,1,0,0,DF,Under 20,Defender,France,Europe
2318,Yann Sommer,SUI,Gladbach,Bundesliga,2018,29.0,1988.0,34.0,2,2,2,0,0,2,2,100.0,0,1,0,1,1,3,12,5,GK,25-29,Goalkeeper,Switzerland,Europe
2319,Kévin Soni,CMR,Girona,La Liga,2018,20.0,1998.0,0.9,3,2,0,2,1,2,4,50.0,2,3,0,3,1,4,0,0,"FW,DF",20-24,Forward,Cameroon,Africa
2320,Jérémy Sorbon,FRA,Guingamp,Ligue 1,2018,34.0,1983.0,29.4,33,20,23,10,0,14,22,63.6,8,33,23,10,34,67,105,2,DF,30-34,Defender,France,Europe
2321,Oliver Sorg,GER,Hannover 96,Bundesliga,2018,28.0,1990.0,17.6,42,28,26,16,0,20,43,46.5,23,16,9,7,46,88,47,0,DF,25-29,Defender,Germany,Europe
2324,Roberto Soriano,ITA,Torino,Serie A,2018,27.0,1991.0,5.2,9,5,0,5,4,1,8,12.5,7,9,0,9,6,15,1,0,MF,25-29,Midfielder,Italy,Europe
2325,Roberto Soriano,ITA,Bologna,Serie A,2018,27.0,1991.0,16.5,27,18,14,10,3,8,24,33.3,16,21,2,19,3,30,11,0,MF,25-29,Midfielder,Italy,Europe
2326,Stefano Sorrentino,ITA,Chievo,Serie A,2018,39.0,1979.0,31.0,1,1,1,0,0,1,2,50.0,1,0,0,0,3,4,10,1,GK,35-39,Goalkeeper,Italy,Europe
2327,Borna Sosa,CRO,Stuttgart,Bundesliga,2018,20.0,1998.0,6.8,13,7,8,4,1,4,9,44.4,5,5,1,4,6,19,34,0,"DF,MF",20-24,Defender,Croatia,Europe
2328,Sebastian Soto,USA,Hannover 96,Bundesliga,2018,18.0,2000.0,0.3,0,0,0,0,0,0,0,,0,0,0,0,0,0,0,0,"MF,FW",Under 20,Midfielder,United States,North America
2329,Riccardo Sottil,ITA,Fiorentina,Serie A,2018,19.0,1999.0,0.2,1,1,0,1,0,1,1,100.0,0,0,0,0,0,1,0,0,"FW,MF",Under 20,Forward,Italy,Europe
2330,Pape Souaré,SEN,Crystal Palace,Premier League,2018,28.0,1990.0,0.0,0,0,0,0,0,0,0,,0,0,0,0,1,1,0,0,DF,25-29,Defender,Senegal,Africa
2331,Adama Soumaoro,FRA,Lille,Ligue 1,2018,26.0,1992.0,19.1,14,11,12,2,0,4,6,66.7,2,21,18,3,21,35,92,1,DF,25-29,Defender,France,Europe
2332,Boubakary Soumaré,FRA,Lille,Ligue 1,2018,19.0,1999.0,6.3,20,15,9,11,0,10,18,55.6,8,9,3,6,7,27,5,0,MF,Under 20,Midfielder,France,Europe
2333,Çağlar Söyüncü,TUR,Leicester City,Premier League,2018,22.0,1996.0,4.1,5,2,4,1,0,3,6,50.0,3,8,5,3,7,12,22,3,DF,20-24,Defender,Turkey,Asia
2334,Julián Speroni,ARG,Crystal Palace,Premier League,2018,39.0,1979.0,1.0,0,0,0,0,0,0,0,,0,0,0,0,0,0,1,2,GK,35-39,Goalkeeper,Argentina,South America
2335,Leonardo Spinazzola,ITA,Juventus,Serie A,2018,25.0,1993.0,6.7,9,4,4,2,3,4,8,50.0,4,5,0,5,3,12,7,0,DF,25-29,Defender,Italy,Europe
2336,Nicolás Spolli,ARG,Genoa,Serie A,2018,35.0,1983.0,6.0,7,6,3,4,0,0,2,0.0,2,8,6,2,7,14,39,1,DF,35-39,Defender,Argentina,South America
2337,Marco Sportiello,ITA,Frosinone,Serie A,2018,26.0,1992.0,35.0,1,0,1,0,0,1,1,100.0,0,1,0,1,0,1,8,2,GK,25-29,Goalkeeper,Italy,Europe
2338,Mattia Sprocati,ITA,Parma,Serie A,2018,25.0,1993.0,7.2,10,4,5,5,0,5,11,45.5,6,6,0,6,7,17,6,0,"FW,MF",25-29,Forward,Italy,Europe
2339,Bassem Srarfi,TUN,Nice,Ligue 1,2018,21.0,1997.0,9.1,20,11,8,8,4,6,17,35.3,11,8,0,8,5,25,5,0,"FW,MF",20-24,Forward,Tunisia,Africa
2340,Darijo Srna,CRO,Cagliari,Serie A,2018,36.0,1982.0,23.2,24,16,6,13,5,9,14,64.3,5,24,5,19,18,42,66,0,DF,35-39,Defender,Croatia,Europe
2341,Kostas Stafylidis,GRE,Augsburg,Bundesliga,2018,24.0,1993.0,10.2,22,14,17,4,1,10,19,52.6,9,13,2,11,15,37,31,0,DF,20-24,Defender,Greece,Europe
2342,Benjamin Stambouli,FRA,Schalke 04,Bundesliga,2018,27.0,1990.0,19.6,51,31,24,24,3,25,46,54.3,21,41,9,32,32,83,65,2,"DF,MF",25-29,Defender,France,Europe
2343,Jozo Stanić,CRO,Augsburg,Bundesliga,2018,19.0,1999.0,0.0,0,0,0,0,0,0,0,,0,0,0,0,0,0,0,0,MF,Under 20,Midfielder,Croatia,Europe
2344,Junior Stanislas,ENG,Bournemouth,Premier League,2018,28.0,1989.0,11.5,12,6,5,4,3,3,7,42.9,4,8,1,7,2,14,15,0,"MF,FW",25-29,Midfielder,England,Europe
2345,Niklas Stark,GER,Hertha BSC,Bundesliga,2018,23.0,1995.0,20.8,34,19,23,11,0,9,24,37.5,15,45,26,19,37,71,141,1,DF,20-24,Defender,Germany,Europe
2346,Timo Stavitski,FIN,Caen,Ligue 1,2018,19.0,1999.0,0.2,0,0,0,0,0,0,1,0.0,1,0,0,0,0,0,0,0,"MF,FW",Under 20,Midfielder,Finland,Europe
2347,Renato Steffen,SUI,Wolfsburg,Bundesliga,2018,26.0,1991.0,16.7,26,17,5,17,4,7,17,41.2,10,13,2,11,16,42,14,0,"FW,MF",25-29,Forward,Switzerland,Europe
2348,Marc Stendera,GER,Eint Frankfurt,Bundesliga,2018,22.0,1995.0,1.2,6,1,2,4,0,2,4,50.0,2,4,1,3,0,6,0,0,MF,20-24,Midfielder,Germany,Europe
2349,Pascal Stenzel,GER,Freiburg,Bundesliga,2018,22.0,1996.0,16.1,42,26,26,14,2,24,43,55.8,19,16,3,13,30,72,48,1,"DF,MF",20-24,Defender,Germany,Europe
2350,Dale Stephens,ENG,Brighton,Premier League,2018,29.0,1989.0,27.6,83,57,37,41,5,28,74,37.8,46,33,13,20,46,129,47,0,MF,25-29,Midfielder,England,Europe
2351,Jack Stephens,ENG,Southampton,Premier League,2018,24.0,1994.0,18.9,25,13,17,7,1,16,28,57.1,12,25,13,12,37,62,96,2,DF,20-24,Defender,England,Europe
2353,Raheem Sterling,ENG,Manchester City,Premier League,2018,23.0,1994.0,30.8,32,16,11,12,9,9,25,36.0,16,28,3,25,17,49,4,0,FW,20-24,Forward,England,Europe
2354,Lars Stindl,GER,Gladbach,Bundesliga,2018,29.0,1988.0,16.8,21,14,8,11,2,3,15,20.0,12,22,2,20,14,35,13,0,"FW,MF",25-29,Forward,Germany,Europe
2355,Kevin Stöger,AUT,Düsseldorf,Bundesliga,2018,24.0,1993.0,23.5,63,35,28,27,8,30,67,44.8,37,32,5,27,31,94,19,1,MF,20-24,Midfielder,Austria,Europe
2356,John Stones,ENG,Manchester City,Premier League,2018,24.0,1994.0,19.6,16,11,9,5,2,4,9,44.4,5,15,9,6,14,30,64,1,DF,20-24,Defender,England,Europe
2357,Thomas Strakosha,ALB,Lazio,Serie A,2018,23.0,1995.0,35.0,1,1,1,0,0,1,1,100.0,0,0,0,0,1,2,8,1,GK,20-24,Goalkeeper,Albania,Europe
2358,Tobias Strobl,GER,Gladbach,Bundesliga,2018,28.0,1990.0,25.5,31,17,17,13,1,9,29,31.0,20,36,14,22,29,60,35,1,"MF,DF",25-29,Midfielder,Germany,Europe
2359,Kevin Strootman,NED,Roma,Serie A,2018,28.0,1990.0,1.0,2,2,1,0,1,0,1,0.0,1,5,0,5,2,4,2,0,MF,25-29,Midfielder,Netherlands,Europe
2360,Kevin Strootman,NED,Marseille,Ligue 1,2018,28.0,1990.0,21.6,76,40,21,47,8,20,52,38.5,32,24,6,18,24,100,26,0,MF,25-29,Midfielder,Netherlands,Europe
2361,Jens Stryger Larsen,DEN,Udinese,Serie A,2018,27.0,1991.0,35.9,42,20,24,14,4,22,44,50.0,22,27,8,19,26,68,98,1,DF,25-29,Defender,Denmark,Europe
2362,Cristhian Stuani,URU,Girona,La Liga,2018,31.0,1986.0,30.3,23,13,7,13,3,5,20,25.0,15,13,1,12,4,27,39,0,FW,30-34,Forward,Uruguay,South America
2364,Stefano Sturaro,ITA,Genoa,Serie A,2018,25.0,1993.0,2.4,4,3,0,3,1,2,9,22.2,7,3,1,2,3,7,2,0,"MF,FW",25-29,Midfielder,Italy,Europe
2365,Daniel Sturridge,ENG,Liverpool,Premier League,2018,28.0,1989.0,5.7,3,3,1,1,1,2,3,66.7,1,4,0,4,1,4,0,0,"FW,MF",25-29,Forward,England,Europe
2366,Damián Suárez,URU,Getafe,La Liga,2018,30.0,1988.0,36.0,96,62,43,41,12,53,120,44.2,67,47,6,41,46,142,57,2,DF,30-34,Defender,Uruguay,South America
2369,Leonardo Suárez,ARG,Valladolid,La Liga,2018,22.0,1996.0,5.7,3,3,2,0,1,2,4,50.0,2,7,1,6,1,4,4,0,"FW,MF",20-24,Forward,Argentina,South America
2370,Luis Suárez,URU,Barcelona,La Liga,2018,31.0,1987.0,31.4,18,11,1,6,11,4,10,40.0,6,12,4,8,8,26,24,0,FW,30-34,Forward,Uruguay,South America
2370,Luis Suárez,URU,Barcelona,La Liga,2018,31.0,1987.0,31.4,18,11,1,6,11,4,10,40.0,6,12,4,8,8,26,24,0,FW,30-34,Forward,Uruguay,South America
2370,Luis Suárez,URU,Barcelona,La Liga,2018,31.0,1987.0,31.4,18,11,1,6,11,4,10,40.0,6,12,4,8,8,26,24,0,FW,30-34,Forward,Uruguay,South America
2370,Luis Suárez,URU,Barcelona,La Liga,2018,31.0,1987.0,31.4,18,11,1,6,11,4,10,40.0,6,12,4,8,8,26,24,0,FW,30-34,Forward,Uruguay,South America
2372,Mathías Suárez,URU,Montpellier,Ligue 1,2018,22.0,1996.0,6.1,20,11,7,10,3,10,23,43.5,13,11,0,11,9,29,18,0,DF,20-24,Defender,Uruguay,South America
2373,Danijel Subašić,CRO,Monaco,Ligue 1,2018,33.0,1984.0,12.6,0,0,0,0,0,0,1,0.0,1,0,0,0,0,0,6,2,GK,30-34,Goalkeeper,Croatia,Europe
2375,Isaac Success,NGA,Watford,Premier League,2018,22.0,1996.0,11.7,15,12,4,8,3,2,5,40.0,3,6,0,6,2,17,11,0,"FW,MF",20-24,Forward,Nigeria,Africa
2376,Niklas Süle,GER,Bayern Munich,Bundesliga,2018,22.0,1995.0,29.5,28,23,17,10,1,18,25,72.0,7,23,13,10,40,68,83,0,DF,20-24,Defender,Germany,Europe
2377,Ki Sung-yueng,KOR,Newcastle Utd,Premier League,2018,29.0,1989.0,14.5,14,10,5,8,1,3,12,25.0,9,11,1,10,19,33,20,0,MF,25-29,Midfielder,South Korea,Asia
2378,Andrew Surman,ENG,Bournemouth,Premier League,2018,31.0,1986.0,16.0,11,6,6,5,0,3,13,23.1,10,20,7,13,10,21,34,1,MF,30-34,Midfielder,England,Europe
2379,Sam Surridge,ENG,Bournemouth,Premier League,2018,20.0,1998.0,0.1,1,0,0,0,1,0,0,,0,0,0,0,0,1,0,0,"MF,FW",20-24,Midfielder,England,Europe
2382,Markus Suttner,AUT,Düsseldorf,Bundesliga,2018,31.0,1987.0,5.4,10,7,5,4,1,4,8,50.0,4,8,3,5,8,18,10,0,"DF,MF",30-34,Defender,Austria,Europe
2383,Mattias Svanberg,SWE,Bologna,Serie A,2018,19.0,1999.0,13.1,22,11,14,7,1,11,25,44.0,14,25,6,19,11,33,16,2,MF,Under 20,Midfielder,Sweden,Europe
2384,Sanasi Sy,FRA,Amiens,Ligue 1,2018,19.0,1999.0,0.0,0,0,0,0,0,0,0,,0,0,0,0,0,0,0,0,MF,Under 20,Midfielder,France,Europe
2385,Seydou Sy,SEN,Monaco,Ligue 1,2018,22.0,1995.0,2.5,0,0,0,0,0,0,0,,0,0,0,0,0,0,0,1,GK,20-24,Goalkeeper,Senegal,Africa
2386,Issiaga Sylla,GUI,Toulouse,Ligue 1,2018,24.0,1994.0,22.2,54,36,30,24,0,28,53,52.8,25,36,10,26,39,93,77,0,"DF,MF",20-24,Defender,Guinea,Africa
2387,Moussa Sylla,MLI,Monaco,Ligue 1,2018,18.0,1999.0,8.5,6,4,4,1,1,2,6,33.3,4,5,2,3,2,8,5,0,"FW,MF",Under 20,Forward,Mali,Africa
2388,Eddy Sylvestre,FRA,Nice,Ligue 1,2018,18.0,1999.0,3.0,3,2,0,3,0,3,9,33.3,6,1,0,1,0,3,0,0,"FW,MF",Under 20,Forward,France,Europe
2389,Ádám Szalai,HUN,Hoffenheim,Bundesliga,2018,30.0,1987.0,18.1,19,13,3,12,4,4,11,36.4,7,8,1,7,4,23,8,0,FW,30-34,Forward,Hungary,Europe
2392,Franck Tabanou,FRA,Guingamp,Ligue 1,2018,29.0,1989.0,2.0,4,3,4,0,0,1,2,50.0,1,0,0,0,6,10,15,0,DF,25-29,Defender,France,Europe
2393,Jonathan Tah,GER,Leverkusen,Bundesliga,2018,22.0,1996.0,32.6,44,30,30,10,4,17,32,53.1,15,39,26,13,45,89,142,1,DF,20-24,Defender,Germany,Europe
2394,Flavien Tait,FRA,Angers,Ligue 1,2018,25.0,1993.0,33.2,58,35,33,16,9,23,59,39.0,36,29,2,27,28,86,15,0,"MF,FW",25-29,Midfielder,France,Europe
2395,Adrien Tameze,CMR,Nice,Ligue 1,2018,24.0,1994.0,32.7,74,44,32,31,11,39,92,42.4,53,53,12,41,56,130,59,1,MF,20-24,Midfielder,Cameroon,Africa
2397,Matt Targett,ENG,Southampton,Premier League,2018,22.0,1995.0,13.2,27,19,15,7,5,12,26,46.2,14,19,3,16,27,54,42,0,DF,20-24,Defender,England,Europe
2399,James Tarkowski,ENG,Burnley,Premier League,2018,25.0,1992.0,34.3,71,36,52,18,1,29,50,58.0,21,72,56,16,42,113,240,2,DF,25-29,Defender,England,Europe
2400,Ciprian Tătărușanu,ROU,Nantes,Ligue 1,2018,32.0,1986.0,26.6,0,0,0,0,0,0,0,,0,0,0,0,2,2,20,0,GK,30-34,Goalkeeper,Romania,Europe
2401,Júlio Tavares,CPV,Dijon,Ligue 1,2018,29.0,1988.0,31.2,15,9,1,7,7,3,9,33.3,6,17,3,14,13,28,51,0,FW,25-29,Forward,Cape Verde,Africa
2402,Júnior Tavares,BRA,Sampdoria,Serie A,2018,21.0,1996.0,2.0,2,1,1,1,0,2,4,50.0,2,0,0,0,2,4,1,0,DF,20-24,Defender,Brazil,South America
2403,Taleb Tawatha,ISR,Eint Frankfurt,Bundesliga,2018,26.0,1992.0,1.4,1,1,1,0,0,1,2,50.0,1,0,0,0,0,1,1,0,"FW,DF",25-29,Forward,Israel,Asia
2404,Charlie Taylor,ENG,Burnley,Premier League,2018,24.0,1993.0,36.0,55,26,37,15,3,24,50,48.0,26,74,35,39,40,95,120,0,DF,20-24,Defender,England,Europe
2405,Malik Tchokounté,FRA,Caen,Ligue 1,2018,29.0,1988.0,16.4,21,13,6,12,3,5,10,50.0,5,11,0,11,6,27,26,0,"FW,MF",25-29,Forward,France,Europe
2406,Aurélien Tchouaméni,FRA,Bordeaux,Ligue 1,2018,18.0,2000.0,7.8,24,12,10,14,0,7,18,38.9,11,11,5,6,21,45,14,0,MF,Under 20,Midfielder,France,Europe
2407,Georg Teigl,AUT,Augsburg,Bundesliga,2018,27.0,1991.0,3.3,5,3,4,0,1,2,2,100.0,0,1,0,1,7,12,5,1,"MF,FW",25-29,Midfielder,Austria,Europe
2410,Hidde ter Avest,NED,Udinese,Serie A,2018,21.0,1997.0,10.8,26,14,17,6,3,14,20,70.0,6,14,3,11,10,36,39,1,"DF,FW",20-24,Defender,Netherlands,Europe
2411,Marc-André ter Stegen,GER,Barcelona,La Liga,2018,26.0,1992.0,35.0,0,0,0,0,0,0,3,0.0,3,0,0,0,2,2,5,2,GK,25-29,Goalkeeper,Germany,Europe
2412,Pietro Terracciano,ITA,Fiorentina,Serie A,2018,28.0,1990.0,2.0,0,0,0,0,0,0,0,,0,0,0,0,0,0,1,1,GK,25-29,Goalkeeper,Italy,Europe
2413,Pietro Terracciano,ITA,Empoli,Serie A,2018,28.0,1990.0,8.0,0,0,0,0,0,0,0,,0,0,0,0,1,1,4,0,GK,25-29,Goalkeeper,Italy,Europe
2414,Marco Terrazzino,GER,Freiburg,Bundesliga,2018,27.0,1991.0,5.7,6,3,4,2,0,1,7,14.3,6,5,2,3,3,9,2,0,"MF,FW",25-29,Midfielder,Germany,Europe
2415,Martin Terrier,FRA,Lyon,Ligue 1,2018,21.0,1997.0,16.5,23,13,5,13,5,9,23,39.1,14,17,2,15,6,29,14,0,FW,20-24,Forward,France,Europe
2416,Kenny Tete,NED,Lyon,Ligue 1,2018,22.0,1995.0,11.6,30,23,11,16,3,13,19,68.4,6,13,5,8,18,48,29,0,DF,20-24,Defender,Netherlands,Europe
2417,Cedric Teuchert,GER,Schalke 04,Bundesliga,2018,21.0,1997.0,1.8,0,0,0,0,0,0,0,,0,2,0,2,1,1,0,0,"FW,MF",20-24,Forward,Germany,Europe
2418,Florian Thauvin,FRA,Marseille,Ligue 1,2018,25.0,1993.0,29.0,42,23,10,21,11,16,35,45.7,19,19,1,18,8,50,4,0,"FW,MF",25-29,Forward,France,Europe
2419,Cyril Théréau,FRA,Fiorentina,Serie A,2018,35.0,1983.0,0.3,0,0,0,0,0,0,0,,0,0,0,0,0,0,1,0,"FW,MF",35-39,Forward,France,Europe
2420,Cyril Théréau,FRA,Cagliari,Serie A,2018,35.0,1983.0,1.5,1,1,0,1,0,1,1,100.0,0,0,0,0,0,1,2,0,FW,35-39,Forward,France,Europe
2421,Sada Thioub,SEN,Nîmes,Ligue 1,2018,23.0,1995.0,27.5,30,19,13,10,7,20,45,44.4,25,29,1,28,16,46,11,0,"MF,FW",20-24,Midfielder,Senegal,Africa
2422,Romain Thomas,FRA,Angers,Ligue 1,2018,30.0,1988.0,26.6,35,26,25,10,0,14,19,73.7,5,31,24,7,29,64,133,1,DF,30-34,Defender,France,Europe
2423,Adrien Thomasson,FRA,Strasbourg,Ligue 1,2018,24.0,1993.0,27.5,54,27,18,23,13,21,66,31.8,45,29,5,24,18,72,12,1,"MF,FW",20-24,Midfielder,France,Europe
2424,Erik Thommy,GER,Stuttgart,Bundesliga,2018,23.0,1994.0,8.8,5,3,3,1,1,1,7,14.3,6,16,1,15,14,19,4,0,"MF,FW",20-24,Midfielder,Germany,Europe
2425,Marcus Thuram,FRA,Guingamp,Ligue 1,2018,20.0,1997.0,28.6,45,28,23,15,7,20,43,46.5,23,24,1,23,10,55,14,0,"FW,MF",20-24,Forward,France,Europe
2426,Youri Tielemans,BEL,Leicester City,Premier League,2018,21.0,1997.0,12.1,17,8,5,9,3,5,17,29.4,12,13,2,11,5,22,13,1,MF,20-24,Midfielder,Belgium,Europe
2427,Youri Tielemans,BEL,Monaco,Ligue 1,2018,21.0,1997.0,18.7,45,24,17,23,5,24,47,51.1,23,20,3,17,18,63,22,0,MF,20-24,Midfielder,Belgium,Europe
2428,Timmy Tillman,GER,Nürnberg,Bundesliga,2018,19.0,1999.0,2.3,0,0,0,0,0,0,4,0.0,4,3,0,3,3,3,0,2,"FW,MF",Under 20,Forward,Germany,Europe
2429,Cheick Timite,CIV,Amiens,Ligue 1,2018,20.0,1997.0,16.2,18,13,5,7,6,3,16,18.8,13,14,2,12,12,30,13,0,"FW,MF",20-24,Forward,Ivory Coast,Africa
2431,George Timotheou,AUS,Schalke 04,Bundesliga,2018,21.0,1997.0,1.0,3,3,3,0,0,0,0,,0,1,1,0,1,4,4,0,DF,20-24,Defender,Australia,Oceania
2432,Marcel Tisserand,COD,Wolfsburg,Bundesliga,2018,25.0,1993.0,9.8,14,9,9,5,0,10,13,76.9,3,12,5,7,20,34,42,1,DF,25-29,Defender,DR Congo,Africa
2434,Jean-Clair Todibo,FRA,Barcelona,La Liga,2018,18.0,1999.0,1.7,7,2,4,3,0,5,6,83.3,1,1,0,1,3,10,8,0,DF,Under 20,Defender,France,Europe
2435,Jean-Clair Todibo,FRA,Toulouse,Ligue 1,2018,18.0,1999.0,9.3,21,18,19,2,0,11,13,84.6,2,14,5,9,14,35,62,2,DF,Under 20,Defender,France,Europe
2436,Karl Toko Ekambi,CMR,Villarreal,La Liga,2018,25.0,1992.0,23.8,11,8,1,6,4,2,14,14.3,12,8,0,8,11,22,9,1,"FW,MF",25-29,Forward,Cameroon,Africa
2437,Corentin Tolisso,FRA,Bayern Munich,Bundesliga,2018,23.0,1994.0,0.6,0,0,0,0,0,0,2,0.0,2,1,1,0,0,0,0,0,MF,20-24,Midfielder,France,Europe
2438,Rafael Tolói,ITA,Atalanta,Serie A,2018,27.0,1990.0,19.4,27,17,15,9,3,16,24,66.7,8,28,10,18,33,60,54,1,DF,25-29,Defender,Italy,Europe
2440,James Tomkins,ENG,Crystal Palace,Premier League,2018,29.0,1989.0,28.4,34,20,27,7,0,15,28,53.6,13,23,10,13,34,68,184,3,DF,25-29,Defender,England,Europe
2442,Lorenzo Tonelli,ITA,Sampdoria,Serie A,2018,28.0,1990.0,18.4,31,22,19,9,3,15,19,78.9,4,27,21,6,24,55,92,0,DF,25-29,Defender,Italy,Europe
2444,Ömer Toprak,TUR,Dortmund,Bundesliga,2018,29.0,1989.0,2.6,1,1,0,1,0,0,1,0.0,1,1,1,0,0,1,7,0,DF,25-29,Defender,Turkey,Asia
2445,Lucas Torreira,URU,Arsenal,Premier League,2018,22.0,1996.0,26.5,65,39,24,32,9,25,57,43.9,32,34,7,27,41,106,33,2,MF,20-24,Midfielder,Uruguay,South America
2446,Daniel Torres,COL,Alavés,La Liga,2018,28.0,1989.0,0.8,2,1,2,0,0,0,3,0.0,3,0,0,0,2,4,0,0,MF,25-29,Midfielder,Colombia,South America
2449,Jordan Torunarigha,GER,Hertha BSC,Bundesliga,2018,20.0,1997.0,12.9,34,30,23,10,1,18,28,64.3,10,19,7,12,29,63,55,0,DF,20-24,Defender,Germany,Europe
2450,Cenk Tosun,TUR,Everton,Premier League,2018,27.0,1991.0,11.8,13,9,3,6,4,4,13,30.8,9,12,0,12,5,18,3,0,FW,25-29,Forward,Turkey,Asia
2451,Abdoulaye Touré,GUI,Nantes,Ligue 1,2018,24.0,1994.0,30.5,48,31,14,28,6,19,56,33.9,37,25,10,15,47,95,29,1,MF,20-24,Midfielder,Guinea,Africa
2451,Abdoulaye Touré,GUI,Nantes,Ligue 1,2018,24.0,1994.0,30.5,48,31,14,28,6,19,56,33.9,37,25,10,15,47,95,29,1,MF,20-24,Midfielder,Guinea,Africa
2451,Abdoulaye Touré,GUI,Nantes,Ligue 1,2018,24.0,1994.0,30.5,48,31,14,28,6,19,56,33.9,37,25,10,15,47,95,29,1,MF,20-24,Midfielder,Guinea,Africa
2451,Abdoulaye Touré,GUI,Nantes,Ligue 1,2018,24.0,1994.0,30.5,48,31,14,28,6,19,56,33.9,37,25,10,15,47,95,29,1,MF,20-24,Midfielder,Guinea,Africa
2452,Almamy Touré,MLI,Monaco,Ligue 1,2018,22.0,1996.0,3.8,13,6,6,7,0,3,10,30.0,7,3,1,2,11,24,12,0,DF,20-24,Defender,Mali,Africa
2453,Almamy Touré,MLI,Eint Frankfurt,Bundesliga,2018,22.0,1996.0,5.8,18,11,7,11,0,5,8,62.5,3,4,1,3,9,27,25,0,"DF,MF",20-24,Defender,Mali,Africa
2454,Lucas Tousart,FRA,Lyon,Ligue 1,2018,21.0,1997.0,19.2,74,38,33,34,7,25,59,42.4,34,30,13,17,26,100,27,0,MF,20-24,Midfielder,France,Europe
2455,Andros Townsend,ENG,Crystal Palace,Premier League,2018,27.0,1991.0,33.4,62,35,38,16,8,35,89,39.3,54,48,5,43,38,100,28,0,"FW,MF",25-29,Forward,England,Europe
2457,Adama Traoré,MLI,Monaco,Ligue 1,2018,23.0,1995.0,2.7,2,1,1,0,1,1,4,25.0,3,4,0,4,3,5,1,0,MF,20-24,Midfielder,Mali,Africa
2457,Adama Traoré,MLI,Monaco,Ligue 1,2018,23.0,1995.0,2.7,2,1,1,0,1,1,4,25.0,3,4,0,4,3,5,1,0,MF,20-24,Midfielder,Mali,Africa
2457,Adama Traoré,MLI,Monaco,Ligue 1,2018,23.0,1995.0,2.7,2,1,1,0,1,1,4,25.0,3,4,0,4,3,5,1,0,MF,20-24,Midfielder,Mali,Africa
2457,Adama Traoré,MLI,Monaco,Ligue 1,2018,23.0,1995.0,2.7,2,1,1,0,1,1,4,25.0,3,4,0,4,3,5,1,0,MF,20-24,Midfielder,Mali,Africa
2457,Adama Traoré,MLI,Monaco,Ligue 1,2018,23.0,1995.0,2.7,2,1,1,0,1,1,4,25.0,3,4,0,4,3,5,1,0,MF,20-24,Midfielder,Mali,Africa
2457,Adama Traoré,MLI,Monaco,Ligue 1,2018,23.0,1995.0,2.7,2,1,1,0,1,1,4,25.0,3,4,0,4,3,5,1,0,MF,20-24,Midfielder,Mali,Africa
2457,Adama Traoré,MLI,Monaco,Ligue 1,2018,23.0,1995.0,2.7,2,1,1,0,1,1,4,25.0,3,4,0,4,3,5,1,0,MF,20-24,Midfielder,Mali,Africa
2457,Adama Traoré,MLI,Monaco,Ligue 1,2018,23.0,1995.0,2.7,2,1,1,0,1,1,4,25.0,3,4,0,4,3,5,1,0,MF,20-24,Midfielder,Mali,Africa
2457,Adama Traoré,MLI,Monaco,Ligue 1,2018,23.0,1995.0,2.7,2,1,1,0,1,1,4,25.0,3,4,0,4,3,5,1,0,MF,20-24,Midfielder,Mali,Africa
2457,Adama Traoré,MLI,Monaco,Ligue 1,2018,23.0,1995.0,2.7,2,1,1,0,1,1,4,25.0,3,4,0,4,3,5,1,0,MF,20-24,Midfielder,Mali,Africa
2457,Adama Traoré,MLI,Monaco,Ligue 1,2018,23.0,1995.0,2.7,2,1,1,0,1,1,4,25.0,3,4,0,4,3,5,1,0,MF,20-24,Midfielder,Mali,Africa
2457,Adama Traoré,MLI,Monaco,Ligue 1,2018,23.0,1995.0,2.7,2,1,1,0,1,1,4,25.0,3,4,0,4,3,5,1,0,MF,20-24,Midfielder,Mali,Africa
2457,Adama Traoré,MLI,Monaco,Ligue 1,2018,23.0,1995.0,2.7,2,1,1,0,1,1,4,25.0,3,4,0,4,3,5,1,0,MF,20-24,Midfielder,Mali,Africa
2457,Adama Traoré,MLI,Monaco,Ligue 1,2018,23.0,1995.0,2.7,2,1,1,0,1,1,4,25.0,3,4,0,4,3,5,1,0,MF,20-24,Midfielder,Mali,Africa
2457,Adama Traoré,MLI,Monaco,Ligue 1,2018,23.0,1995.0,2.7,2,1,1,0,1,1,4,25.0,3,4,0,4,3,5,1,0,MF,20-24,Midfielder,Mali,Africa
2457,Adama Traoré,MLI,Monaco,Ligue 1,2018,23.0,1995.0,2.7,2,1,1,0,1,1,4,25.0,3,4,0,4,3,5,1,0,MF,20-24,Midfielder,Mali,Africa
2458,Bertrand Traoré,BFA,Lyon,Ligue 1,2018,22.0,1995.0,23.5,36,22,19,13,4,12,26,46.2,14,23,5,18,15,51,18,0,FW,20-24,Forward,Burkina Faso,Africa
2459,Charles Traore,MLI,Nantes,Ligue 1,2018,26.0,1992.0,12.9,40,20,22,16,2,23,34,67.6,11,16,3,13,19,59,46,0,"DF,FW",25-29,Defender,Mali,Africa
2460,Cheick Traoré,MLI,Guingamp,Ligue 1,2018,23.0,1995.0,16.8,37,21,23,11,3,15,25,60.0,10,13,3,10,23,60,46,1,DF,20-24,Defender,Mali,Africa
2461,Gaoussou Traoré,MLI,Amiens,Ligue 1,2018,18.0,1999.0,1.2,10,5,6,4,0,4,8,50.0,4,1,0,1,0,10,0,0,MF,Under 20,Midfielder,Mali,Africa
2462,Hamari Traoré,MLI,Rennes,Ligue 1,2018,26.0,1992.0,33.0,61,33,32,27,2,36,71,50.7,35,39,11,28,44,105,82,0,DF,25-29,Defender,Mali,Africa
2463,Ibrahima Traoré,GUI,Gladbach,Bundesliga,2018,30.0,1988.0,6.1,12,6,8,2,2,3,11,27.3,8,3,1,2,3,15,1,0,"FW,MF",30-34,Forward,Guinea,Africa
2464,Ismaël Traoré,CIV,Angers,Ligue 1,2018,31.0,1986.0,29.3,27,11,19,8,0,9,24,37.5,15,27,16,11,42,69,120,2,DF,30-34,Defender,Ivory Coast,Africa
2465,Kevin Trapp,GER,Eint Frankfurt,Bundesliga,2018,28.0,1990.0,32.6,0,0,0,0,0,0,2,0.0,2,0,0,0,0,0,17,1,GK,25-29,Goalkeeper,Germany,Europe
2466,Mark Travers,IRL,Bournemouth,Premier League,2018,19.0,1999.0,2.0,0,0,0,0,0,0,0,,0,0,0,0,0,0,2,0,GK,Under 20,Goalkeeper,Republic of Ireland,Europe
2467,Óscar Trejo,ARG,Rayo Vallecano,La Liga,2018,30.0,1988.0,19.6,57,41,21,25,11,8,33,24.2,25,24,2,22,18,75,15,0,"MF,FW",30-34,Midfielder,Argentina,South America
2468,Driss Trichard,FRA,Bordeaux,Ligue 1,2018,23.0,1995.0,1.0,2,2,2,0,0,1,1,100.0,0,1,0,1,1,3,4,0,DF,20-24,Defender,France,Europe
2470,Kieran Trippier,ENG,Tottenham,Premier League,2018,27.0,1990.0,25.3,67,37,43,16,8,37,62,59.7,25,38,5,33,23,90,77,2,DF,25-29,Defender,England,Europe
2471,William Troost-Ekong,NGA,Udinese,Serie A,2018,24.0,1993.0,34.0,31,15,21,9,1,13,24,54.2,11,53,41,12,40,71,200,2,DF,20-24,Defender,Nigeria,Africa
2472,Marcello Trotta,ITA,Frosinone,Serie A,2018,25.0,1992.0,4.4,7,6,2,4,1,1,3,33.3,2,2,1,1,3,10,3,0,FW,25-29,Forward,Italy,Europe
2473,Marcello Trotta,ITA,Sassuolo,Serie A,2018,25.0,1992.0,0.1,0,0,0,0,0,0,1,0.0,1,0,0,0,0,0,0,0,MF,25-29,Midfielder,Italy,Europe
2474,Philipp Tschauner,GER,Hannover 96,Bundesliga,2018,32.0,1985.0,1.0,0,0,0,0,0,0,0,,0,0,0,0,0,0,0,0,GK,30-34,Goalkeeper,Germany,Europe
2475,Marco Tumminello,ITA,Atalanta,Serie A,2018,19.0,1998.0,0.1,0,0,0,0,0,0,0,,0,0,0,0,0,0,0,0,"FW,DF",Under 20,Forward,Italy,Europe
2476,Patrick Twumasi,GHA,Alavés,La Liga,2018,24.0,1994.0,1.9,3,3,2,0,1,0,4,0.0,4,2,0,2,1,4,1,0,"MF,FW",20-24,Midfielder,Ghana,Africa
2477,Salih Uçan,TUR,Empoli,Serie A,2018,24.0,1994.0,2.9,10,4,3,5,2,3,10,30.0,7,4,0,4,6,16,2,0,MF,20-24,Midfielder,Turkey,Asia
2478,Anthony Ujah,NGA,Mainz 05,Bundesliga,2018,27.0,1990.0,8.2,2,0,0,1,1,1,2,50.0,1,7,2,5,1,3,10,0,FW,25-29,Forward,Nigeria,Africa
2479,Sven Ulreich,GER,Bayern Munich,Bundesliga,2018,29.0,1988.0,8.4,0,0,0,0,0,0,0,,0,0,0,0,0,0,2,1,GK,25-29,Goalkeeper,Germany,Europe
2480,Samuel Umtiti,FRA,Barcelona,La Liga,2018,24.0,1993.0,13.2,8,5,3,4,1,4,6,66.7,2,10,8,2,18,26,28,2,DF,20-24,Defender,France,Europe
2481,Enes Ünal,TUR,Valladolid,La Liga,2018,21.0,1997.0,23.9,17,10,3,4,10,4,24,16.7,20,17,4,13,2,19,18,0,FW,20-24,Forward,Turkey,Asia
2482,Cengiz Ünder,TUR,Roma,Serie A,2018,21.0,1997.0,15.3,6,3,3,3,0,2,11,18.2,9,7,0,7,13,19,5,0,FW,20-24,Forward,Turkey,Asia
2483,Joel Untersee,SUI,Empoli,Serie A,2018,24.0,1994.0,1.4,3,2,1,2,0,2,3,66.7,1,2,1,1,1,4,5,1,DF,20-24,Defender,Switzerland,Europe
2484,Dayot Upamecano,FRA,RB Leipzig,Bundesliga,2018,19.0,1998.0,14.4,22,16,14,8,0,15,18,83.3,3,19,5,14,33,55,47,0,DF,Under 20,Defender,France,Europe
2485,Takashi Usami,JPN,Düsseldorf,Bundesliga,2018,26.0,1992.0,9.8,18,12,7,11,0,9,26,34.6,17,15,2,13,8,26,13,1,"MF,FW",25-29,Midfielder,Japan,Asia
2486,Mark Uth,GER,Schalke 04,Bundesliga,2018,26.0,1991.0,15.6,20,11,8,8,4,4,23,17.4,19,19,2,17,8,28,12,0,"FW,MF",25-29,Forward,Germany,Europe
2488,Valentín Vada,ARG,Bordeaux,Ligue 1,2018,22.0,1996.0,0.4,2,1,0,2,0,1,1,100.0,0,0,0,0,0,2,0,0,MF,20-24,Midfielder,Argentina,South America
2489,Valentín Vada,ARG,Saint-Étienne,Ligue 1,2018,22.0,1996.0,4.5,7,4,4,3,0,3,12,25.0,9,4,1,3,7,14,4,0,MF,20-24,Midfielder,Argentina,South America
2490,William Vainqueur,FRA,Monaco,Ligue 1,2018,29.0,1988.0,0.9,6,3,4,2,0,1,1,100.0,0,1,0,1,0,6,0,0,MF,25-29,Midfielder,France,Europe
2491,Mirko Valdifiori,ITA,SPAL,Serie A,2018,32.0,1986.0,7.4,20,15,12,7,1,8,14,57.1,6,4,2,2,5,25,9,0,MF,30-34,Midfielder,Italy,Europe
2492,Pierrick Valdivia,FRA,Nîmes,Ligue 1,2018,30.0,1988.0,0.3,1,1,0,1,0,1,2,50.0,1,1,0,1,1,2,0,0,MF,30-34,Midfielder,France,Europe
2493,Antonio Valencia,ECU,Manchester Utd,Premier League,2018,32.0,1985.0,5.2,8,6,2,4,2,3,4,75.0,1,9,0,9,5,13,10,0,DF,30-34,Defender,Ecuador,South America
2494,Enrico Valentini,ITA,Nürnberg,Bundesliga,2018,29.0,1989.0,14.4,44,27,31,10,3,22,40,55.0,18,17,3,14,13,57,58,0,DF,25-29,Defender,Italy,Europe
2496,Yan Valery,TUN,Southampton,Premier League,2018,19.0,1999.0,19.0,42,36,26,10,6,16,29,55.2,13,24,3,21,22,64,72,1,DF,Under 20,Defender,Tunisia,Africa
2498,Theo Valls,FRA,Nîmes,Ligue 1,2018,22.0,1995.0,19.7,37,21,16,19,2,15,43,34.9,28,17,4,13,22,59,15,0,MF,20-24,Midfielder,France,Europe
2499,Mattia Valoti,ITA,SPAL,Serie A,2018,24.0,1993.0,13.6,33,19,13,14,6,13,29,44.8,16,23,0,23,19,52,17,1,MF,20-24,Midfielder,Italy,Europe
2500,Federico Valverde,URU,Real Madrid,La Liga,2018,20.0,1998.0,7.3,12,8,3,7,2,5,11,45.5,6,10,2,8,21,33,10,0,MF,20-24,Midfielder,Uruguay,South America
2501,Luca Valzania,ITA,Frosinone,Serie A,2018,22.0,1996.0,10.0,21,12,7,10,4,13,33,39.4,20,18,0,18,16,37,8,1,MF,20-24,Midfielder,Italy,Europe
2502,Luca Valzania,ITA,Atalanta,Serie A,2018,22.0,1996.0,0.8,5,4,2,3,0,3,5,60.0,2,0,0,0,1,6,0,0,MF,20-24,Midfielder,Italy,Europe
2503,Virgil van Dijk,NED,Liverpool,Premier League,2018,27.0,1991.0,37.6,38,28,26,11,1,14,14,100.0,0,29,18,11,40,78,201,1,DF,25-29,Defender,Netherlands,Europe
2504,Raphaël Varane,FRA,Real Madrid,La Liga,2018,25.0,1993.0,30.6,33,18,25,7,1,15,19,78.9,4,21,9,12,32,65,141,1,DF,25-29,Defender,France,Europe
2505,Jamie Vardy,ENG,Leicester City,Premier League,2018,31.0,1987.0,30.3,14,8,3,6,5,4,17,23.5,13,16,1,15,6,20,28,0,FW,30-34,Forward,England,Europe
2506,Franco Vázquez,ARG,Sevilla,La Liga,2018,29.0,1989.0,25.3,51,37,21,21,9,23,66,34.8,43,25,2,23,23,74,27,1,MF,25-29,Midfielder,Argentina,South America
2509,Matías Vecino,URU,Inter,Serie A,2018,26.0,1991.0,22.4,50,39,18,23,9,26,53,49.1,27,38,9,29,17,67,22,0,MF,25-29,Midfielder,Uruguay,South America
2511,Emiliano Velázquez,URU,Rayo Vallecano,La Liga,2018,24.0,1994.0,14.2,49,32,38,9,2,20,34,58.8,14,29,7,22,47,96,106,1,DF,20-24,Defender,Uruguay,South America
2513,Miguel Veloso,POR,Genoa,Serie A,2018,32.0,1986.0,14.0,31,20,14,13,4,9,26,34.6,17,12,1,11,13,44,21,0,MF,30-34,Midfielder,Portugal,Europe
2514,Daniele Verde,ITA,Valladolid,La Liga,2018,22.0,1996.0,7.3,6,3,2,2,2,1,6,16.7,5,3,0,3,7,13,3,1,"MF,FW",20-24,Midfielder,Italy,Europe
2515,Francesco Verde,ITA,Cagliari,Serie A,2018,19.0,1999.0,0.1,1,0,0,1,0,0,0,,0,0,0,0,0,1,0,0,FW,Under 20,Forward,Italy,Europe
2515,Francesco Verde,ITA,Cagliari,Serie A,2018,19.0,1999.0,0.1,1,0,0,1,0,0,0,,0,0,0,0,0,1,0,0,FW,Under 20,Forward,Italy,Europe
2515,Francesco Verde,ITA,Cagliari,Serie A,2018,19.0,1999.0,0.1,1,0,0,1,0,0,0,,0,0,0,0,0,1,0,0,FW,Under 20,Forward,Italy,Europe
2515,Francesco Verde,ITA,Cagliari,Serie A,2018,19.0,1999.0,0.1,1,0,0,1,0,0,0,,0,0,0,0,0,1,0,0,FW,Under 20,Forward,Italy,Europe
2516,Simone Verdi,ITA,Napoli,Serie A,2018,26.0,1992.0,7.8,16,11,5,9,2,8,16,50.0,8,6,0,6,4,20,3,0,"MF,FW",25-29,Midfielder,Italy,Europe
2517,Jordan Veretout,FRA,Fiorentina,Serie A,2018,25.0,1993.0,32.7,64,40,22,31,11,21,52,40.4,31,33,7,26,46,110,54,2,MF,25-29,Midfielder,France,Europe
2518,Paul Verhaegh,NED,Wolfsburg,Bundesliga,2018,34.0,1983.0,2.0,1,0,0,0,1,1,2,50.0,1,5,0,5,1,2,7,1,DF,30-34,Defender,Netherlands,Europe
2519,Thomas Vermaelen,BEL,Barcelona,La Liga,2018,32.0,1985.0,6.5,6,4,3,3,0,3,7,42.9,4,4,2,2,6,12,21,0,DF,30-34,Defender,Belgium,Europe
2520,Marco Verratti,ITA,Paris S-G,Ligue 1,2018,25.0,1992.0,20.9,72,42,25,39,8,36,81,44.4,45,26,1,25,18,90,8,2,MF,25-29,Midfielder,Italy,Europe
2521,Jan Vertonghen,BEL,Tottenham,Premier League,2018,31.0,1987.0,21.2,39,24,17,20,2,14,24,58.3,10,18,11,7,32,71,81,0,DF,30-34,Defender,Belgium,Europe
2522,Freddie Veseli,ALB,Empoli,Serie A,2018,25.0,1992.0,28.2,34,21,16,15,3,19,27,70.4,8,28,17,11,30,64,99,1,DF,25-29,Defender,Albania,Europe
2524,Jannik Vestergaard,DEN,Southampton,Premier League,2018,25.0,1992.0,22.5,53,33,37,13,3,28,45,62.2,17,35,20,15,35,88,174,1,DF,25-29,Defender,Denmark,Europe
2525,Rúben Vezo,POR,Levante,La Liga,2018,24.0,1994.0,14.9,26,17,17,8,1,14,22,63.6,8,23,20,3,19,45,88,0,DF,20-24,Defender,Portugal,Europe
2526,Rúben Vezo,POR,Valencia,La Liga,2018,24.0,1994.0,2.2,2,1,2,0,0,2,4,50.0,2,2,1,1,2,4,10,0,DF,20-24,Defender,Portugal,Europe
2527,Francesco Vicari,ITA,SPAL,Serie A,2018,23.0,1994.0,25.9,28,24,21,7,0,18,28,64.3,10,31,24,7,34,62,139,1,DF,20-24,Defender,Italy,Europe
2529,Arturo Vidal,CHI,Barcelona,La Liga,2018,31.0,1987.0,21.4,78,44,32,37,9,30,69,43.5,39,46,5,41,29,107,23,1,MF,30-34,Midfielder,Chile,South America
2530,Ronaldo Vieira,ENG,Sampdoria,Serie A,2018,20.0,1998.0,6.7,19,10,3,14,2,5,9,55.6,4,10,2,8,8,27,24,1,MF,20-24,Midfielder,England,Europe
2531,Luciano Vietto,ARG,Fulham,Premier League,2018,24.0,1993.0,11.0,15,11,5,5,5,4,19,21.1,15,9,0,9,6,21,5,0,"FW,MF",20-24,Forward,Argentina,South America
2533,Emanuel Vignato,ITA,Chievo,Serie A,2018,17.0,2000.0,7.3,8,4,4,3,1,0,6,0.0,6,4,0,4,10,18,0,0,"MF,FW",Under 20,Midfielder,Italy,Europe
2536,Rúben Vinagre,POR,Wolves,Premier League,2018,19.0,1999.0,7.9,14,9,7,7,0,2,5,40.0,3,10,2,8,14,28,16,1,"DF,MF",Under 20,Defender,Portugal,Europe
2537,Carlos Vinícius,BRA,Monaco,Ligue 1,2018,23.0,1995.0,5.8,4,1,1,2,1,0,1,0.0,1,7,0,7,1,5,2,0,"FW,MF",20-24,Forward,Brazil,South America
2539,Federico Viviani,ITA,Frosinone,Serie A,2018,26.0,1992.0,3.7,6,5,2,3,1,3,8,37.5,5,6,3,3,8,14,2,0,MF,25-29,Midfielder,Italy,Europe
2540,Emiliano Viviano,ITA,SPAL,Serie A,2018,32.0,1985.0,16.9,0,0,0,0,0,0,0,,0,0,0,0,0,0,5,2,GK,30-34,Goalkeeper,Italy,Europe
2541,Felipe Vizeu,BRA,Udinese,Serie A,2018,21.0,1997.0,0.4,0,0,0,0,0,0,0,,0,0,0,0,0,0,0,0,"FW,DF",20-24,Forward,Brazil,South America
2543,Rai Vloet,NED,Frosinone,Serie A,2018,23.0,1995.0,1.4,4,2,1,2,1,0,3,0.0,3,4,0,4,0,4,1,0,MF,20-24,Midfielder,Netherlands,Europe
2544,Kevin Vogt,GER,Hoffenheim,Bundesliga,2018,26.0,1991.0,26.6,24,15,20,4,0,12,32,37.5,20,28,11,17,33,57,103,3,DF,25-29,Defender,Germany,Europe
2545,Sam Vokes,WAL,Burnley,Premier League,2018,28.0,1989.0,10.2,4,2,1,2,1,0,0,,0,2,1,1,0,4,17,0,FW,25-29,Forward,Wales,Europe
2546,Kevin Volland,GER,Leverkusen,Bundesliga,2018,26.0,1992.0,31.3,33,20,7,14,12,13,27,48.1,14,17,1,16,6,39,33,0,FW,25-29,Forward,Germany,Europe
2547,Michel Vorm,NED,Tottenham,Premier League,2018,34.0,1983.0,2.0,0,0,0,0,0,0,0,,0,0,0,0,0,0,1,0,GK,30-34,Goalkeeper,Netherlands,Europe
2548,Stefan de Vrij,NED,Inter,Serie A,2018,26.0,1992.0,28.0,25,16,14,10,1,8,15,53.3,7,32,23,9,25,50,95,1,DF,25-29,Defender,Netherlands,Europe
2549,Šime Vrsaljko,CRO,Inter,Serie A,2018,26.0,1992.0,8.1,20,14,8,6,6,9,14,64.3,5,5,1,4,11,31,27,1,DF,25-29,Defender,Croatia,Europe
2550,Nikola Vukčević,MNE,Levante,La Liga,2018,26.0,1991.0,7.4,25,18,12,9,4,9,24,37.5,15,15,5,10,10,35,17,0,MF,25-29,Midfielder,Montenegro,Europe
2552,Paul Wade,FRA,Nice,Ligue 1,2018,18.0,2000.0,0.1,0,0,0,0,0,0,3,0.0,3,0,0,0,0,0,1,0,MF,Under 20,Midfielder,France,Europe
2553,Sandro Wagner,GER,Bayern Munich,Bundesliga,2018,30.0,1987.0,1.6,3,2,0,2,1,0,1,0.0,1,0,0,0,0,3,2,0,FW,30-34,Forward,Germany,Europe
2554,Molla Wagué,MLI,Udinese,Serie A,2018,27.0,1991.0,1.1,1,1,1,0,0,0,1,0.0,1,1,0,1,4,5,5,0,DF,25-29,Defender,Mali,Africa
2555,Moussa Wagué,SEN,Barcelona,La Liga,2018,19.0,1998.0,2.5,6,5,1,4,1,3,7,42.9,4,1,0,1,4,10,3,0,"DF,FW",Under 20,Defender,Senegal,Africa
2556,Wakaso,GHA,Alavés,La Liga,2018,28.0,1990.0,18.5,46,30,23,19,4,12,36,33.3,24,37,9,28,16,62,19,2,MF,25-29,Midfielder,Ghana,Africa
2557,Walace,BRA,Hannover 96,Bundesliga,2018,23.0,1995.0,22.2,52,22,17,28,7,27,61,44.3,34,30,4,26,45,97,36,1,MF,20-24,Midfielder,Brazil,South America
2558,Theo Walcott,ENG,Everton,Premier League,2018,29.0,1989.0,23.5,27,17,11,9,7,10,22,45.5,12,17,1,16,22,49,8,0,"FW,MF",25-29,Forward,England,Europe
2559,Luca Waldschmidt,GER,Freiburg,Bundesliga,2018,22.0,1996.0,19.1,20,13,7,10,3,2,20,10.0,18,20,3,17,13,33,8,1,"FW,MF",20-24,Forward,Germany,Europe
2560,Kyle Walker,ENG,Manchester City,Premier League,2018,28.0,1990.0,30.9,40,26,20,20,0,24,38,63.2,14,19,5,14,36,76,58,2,DF,25-29,Defender,England,Europe
2561,Kyle Walker-Peters,ENG,Tottenham,Premier League,2018,21.0,1997.0,4.2,7,4,4,2,1,3,4,75.0,1,5,1,4,4,11,6,0,DF,20-24,Defender,England,Europe
2562,Wallace,BRA,Lazio,Serie A,2018,23.0,1994.0,13.7,17,13,11,6,0,8,17,47.1,9,13,7,6,30,47,60,2,DF,20-24,Defender,Brazil,South America
2562,Wallace,BRA,Lazio,Serie A,2018,23.0,1994.0,13.7,17,13,11,6,0,8,17,47.1,9,13,7,6,30,47,60,2,DF,20-24,Defender,Brazil,South America
2562,Wallace,BRA,Lazio,Serie A,2018,23.0,1994.0,13.7,17,13,11,6,0,8,17,47.1,9,13,7,6,30,47,60,2,DF,20-24,Defender,Brazil,South America
2562,Wallace,BRA,Lazio,Serie A,2018,23.0,1994.0,13.7,17,13,11,6,0,8,17,47.1,9,13,7,6,30,47,60,2,DF,20-24,Defender,Brazil,South America
2562,Wallace,BRA,Lazio,Serie A,2018,23.0,1994.0,13.7,17,13,11,6,0,8,17,47.1,9,13,7,6,30,47,60,2,DF,20-24,Defender,Brazil,South America
2562,Wallace,BRA,Lazio,Serie A,2018,23.0,1994.0,13.7,17,13,11,6,0,8,17,47.1,9,13,7,6,30,47,60,2,DF,20-24,Defender,Brazil,South America
2562,Wallace,BRA,Lazio,Serie A,2018,23.0,1994.0,13.7,17,13,11,6,0,8,17,47.1,9,13,7,6,30,47,60,2,DF,20-24,Defender,Brazil,South America
2562,Wallace,BRA,Lazio,Serie A,2018,23.0,1994.0,13.7,17,13,11,6,0,8,17,47.1,9,13,7,6,30,47,60,2,DF,20-24,Defender,Brazil,South America
2562,Wallace,BRA,Lazio,Serie A,2018,23.0,1994.0,13.7,17,13,11,6,0,8,17,47.1,9,13,7,6,30,47,60,2,DF,20-24,Defender,Brazil,South America
2564,Rémi Walter,FRA,Nice,Ligue 1,2018,23.0,1995.0,9.3,20,12,7,10,3,5,15,33.3,10,9,1,8,6,26,11,0,MF,20-24,Midfielder,France,Europe
2565,Aaron Wan-Bissaka,ENG,Crystal Palace,Premier League,2018,20.0,1997.0,34.8,129,90,90,33,6,55,65,84.6,10,49,16,33,84,213,161,0,DF,20-24,Defender,England,Europe
2566,Victor Wanyama,KEN,Tottenham,Premier League,2018,27.0,1991.0,5.7,13,13,8,5,0,6,12,50.0,6,9,3,6,7,20,11,0,MF,25-29,Midfielder,Kenya,Africa
2567,Danny Ward,ENG,Cardiff City,Premier League,2018,26.0,1991.0,4.9,2,1,0,1,1,0,3,0.0,3,3,1,2,0,2,9,0,FW,25-29,Forward,England,Europe
2567,Danny Ward,ENG,Cardiff City,Premier League,2018,26.0,1991.0,4.9,2,1,0,1,1,0,3,0.0,3,3,1,2,0,2,9,0,FW,25-29,Forward,England,Europe
2567,Danny Ward,ENG,Cardiff City,Premier League,2018,26.0,1991.0,4.9,2,1,0,1,1,0,3,0.0,3,3,1,2,0,2,9,0,FW,25-29,Forward,England,Europe
2567,Danny Ward,ENG,Cardiff City,Premier League,2018,26.0,1991.0,4.9,2,1,0,1,1,0,3,0.0,3,3,1,2,0,2,9,0,FW,25-29,Forward,England,Europe
2568,Joel Ward,ENG,Crystal Palace,Premier League,2018,28.0,1989.0,6.1,12,7,7,4,1,3,10,30.0,7,2,0,2,10,22,35,0,DF,25-29,Defender,England,Europe
2569,Stephen Ward,IRL,Burnley,Premier League,2018,32.0,1985.0,2.5,4,2,1,2,1,1,4,25.0,3,3,1,2,4,8,14,0,DF,30-34,Defender,Republic of Ireland,Europe
2570,James Ward-Prowse,ENG,Southampton,Premier League,2018,23.0,1994.0,21.6,36,17,19,13,4,14,43,32.6,29,30,6,24,27,63,59,0,"MF,DF",20-24,Midfielder,England,Europe
2571,Daniel Wass,DEN,Valencia,La Liga,2018,29.0,1989.0,26.2,35,25,9,19,7,20,42,47.6,22,23,4,19,34,69,49,0,"DF,MF",25-29,Defender,Denmark,Europe
2572,Timothy Weah,USA,Paris S-G,Ligue 1,2018,18.0,2000.0,0.6,0,0,0,0,0,0,0,,0,0,0,0,0,0,0,0,FW,Under 20,Forward,United States,North America
2573,Wout Weghorst,NED,Wolfsburg,Bundesliga,2018,25.0,1992.0,32.5,30,23,10,12,8,7,35,20.0,28,27,3,24,9,39,33,0,FW,25-29,Forward,Netherlands,Europe
2574,Julian Weigl,GER,Dortmund,Bundesliga,2018,22.0,1995.0,16.2,32,18,19,12,1,24,41,58.5,17,18,10,8,16,48,56,2,"DF,MF",20-24,Defender,Germany,Europe
2575,Mitchell Weiser,GER,Leverkusen,Bundesliga,2018,24.0,1994.0,23.5,63,37,34,22,7,26,50,52.0,24,31,3,28,27,90,48,0,DF,20-24,Defender,Germany,Europe
2576,Danny Welbeck,ENG,Arsenal,Premier League,2018,27.0,1990.0,1.7,3,2,0,2,1,0,0,,0,2,0,2,1,4,2,0,"FW,MF",25-29,Forward,England,Europe
2577,Wendell,BRA,Leverkusen,Bundesliga,2018,25.0,1993.0,25.3,75,48,47,24,4,34,57,59.6,23,49,13,36,29,104,66,0,DF,25-29,Defender,Brazil,South America
2577,Wendell,BRA,Leverkusen,Bundesliga,2018,25.0,1993.0,25.3,75,48,47,24,4,34,57,59.6,23,49,13,36,29,104,66,0,DF,25-29,Defender,Brazil,South America
2577,Wendell,BRA,Leverkusen,Bundesliga,2018,25.0,1993.0,25.3,75,48,47,24,4,34,57,59.6,23,49,13,36,29,104,66,0,DF,25-29,Defender,Brazil,South America
2577,Wendell,BRA,Leverkusen,Bundesliga,2018,25.0,1993.0,25.3,75,48,47,24,4,34,57,59.6,23,49,13,36,29,104,66,0,DF,25-29,Defender,Brazil,South America
2577,Wendell,BRA,Leverkusen,Bundesliga,2018,25.0,1993.0,25.3,75,48,47,24,4,34,57,59.6,23,49,13,36,29,104,66,0,DF,25-29,Defender,Brazil,South America
2577,Wendell,BRA,Leverkusen,Bundesliga,2018,25.0,1993.0,25.3,75,48,47,24,4,34,57,59.6,23,49,13,36,29,104,66,0,DF,25-29,Defender,Brazil,South America
2577,Wendell,BRA,Leverkusen,Bundesliga,2018,25.0,1993.0,25.3,75,48,47,24,4,34,57,59.6,23,49,13,36,29,104,66,0,DF,25-29,Defender,Brazil,South America
2577,Wendell,BRA,Leverkusen,Bundesliga,2018,25.0,1993.0,25.3,75,48,47,24,4,34,57,59.6,23,49,13,36,29,104,66,0,DF,25-29,Defender,Brazil,South America
2577,Wendell,BRA,Leverkusen,Bundesliga,2018,25.0,1993.0,25.3,75,48,47,24,4,34,57,59.6,23,49,13,36,29,104,66,0,DF,25-29,Defender,Brazil,South America
2578,Oscar Wendt,SWE,Gladbach,Bundesliga,2018,32.0,1985.0,30.3,45,34,34,8,3,31,53,58.5,22,37,11,26,19,64,90,0,DF,30-34,Defender,Sweden,Europe
2579,Axel Werner,ARG,Huesca,La Liga,2018,22.0,1996.0,6.0,0,0,0,0,0,0,0,,0,0,0,0,0,0,2,0,GK,20-24,Goalkeeper,Argentina,South America
2580,Timo Werner,GER,RB Leipzig,Bundesliga,2018,22.0,1996.0,27.9,18,12,6,8,4,3,16,18.8,13,18,2,16,3,21,7,0,FW,20-24,Forward,Germany,Europe
2581,Ashley Westwood,ENG,Burnley,Premier League,2018,28.0,1990.0,31.4,58,30,24,27,7,14,39,35.9,25,38,9,29,47,105,42,2,MF,25-29,Midfielder,England,Europe
2582,Hendrik Weydandt,GER,Hannover 96,Bundesliga,2018,23.0,1995.0,19.1,18,12,7,8,3,3,24,12.5,21,14,4,10,5,23,44,0,FW,20-24,Forward,Germany,Europe
2583,Connor Wickham,ENG,Crystal Palace,Premier League,2018,25.0,1993.0,0.7,0,0,0,0,0,0,0,,0,0,0,0,0,0,2,0,"FW,MF",25-29,Forward,England,Europe
2584,Georginio Wijnaldum,NED,Liverpool,Premier League,2018,27.0,1990.0,30.3,41,28,14,20,7,14,27,51.9,13,21,7,14,21,62,24,0,MF,25-29,Midfielder,Netherlands,Europe
2585,Jetro Willems,NED,Eint Frankfurt,Bundesliga,2018,24.0,1994.0,8.1,20,15,10,8,2,9,15,60.0,6,10,4,6,10,30,14,0,"MF,DF",20-24,Midfielder,Netherlands,Europe
2586,William,BRA,Wolfsburg,Bundesliga,2018,23.0,1995.0,29.7,82,57,52,21,9,35,75,46.7,40,41,2,39,85,167,127,3,DF,20-24,Defender,Brazil,South America
2586,William,BRA,Wolfsburg,Bundesliga,2018,23.0,1995.0,29.7,82,57,52,21,9,35,75,46.7,40,41,2,39,85,167,127,3,DF,20-24,Defender,Brazil,South America
2586,William,BRA,Wolfsburg,Bundesliga,2018,23.0,1995.0,29.7,82,57,52,21,9,35,75,46.7,40,41,2,39,85,167,127,3,DF,20-24,Defender,Brazil,South America
2586,William,BRA,Wolfsburg,Bundesliga,2018,23.0,1995.0,29.7,82,57,52,21,9,35,75,46.7,40,41,2,39,85,167,127,3,DF,20-24,Defender,Brazil,South America
2586,William,BRA,Wolfsburg,Bundesliga,2018,23.0,1995.0,29.7,82,57,52,21,9,35,75,46.7,40,41,2,39,85,167,127,3,DF,20-24,Defender,Brazil,South America
2586,William,BRA,Wolfsburg,Bundesliga,2018,23.0,1995.0,29.7,82,57,52,21,9,35,75,46.7,40,41,2,39,85,167,127,3,DF,20-24,Defender,Brazil,South America
2586,William,BRA,Wolfsburg,Bundesliga,2018,23.0,1995.0,29.7,82,57,52,21,9,35,75,46.7,40,41,2,39,85,167,127,3,DF,20-24,Defender,Brazil,South America
2586,William,BRA,Wolfsburg,Bundesliga,2018,23.0,1995.0,29.7,82,57,52,21,9,35,75,46.7,40,41,2,39,85,167,127,3,DF,20-24,Defender,Brazil,South America
2586,William,BRA,Wolfsburg,Bundesliga,2018,23.0,1995.0,29.7,82,57,52,21,9,35,75,46.7,40,41,2,39,85,167,127,3,DF,20-24,Defender,Brazil,South America
2586,William,BRA,Wolfsburg,Bundesliga,2018,23.0,1995.0,29.7,82,57,52,21,9,35,75,46.7,40,41,2,39,85,167,127,3,DF,20-24,Defender,Brazil,South America
2586,William,BRA,Wolfsburg,Bundesliga,2018,23.0,1995.0,29.7,82,57,52,21,9,35,75,46.7,40,41,2,39,85,167,127,3,DF,20-24,Defender,Brazil,South America
2586,William,BRA,Wolfsburg,Bundesliga,2018,23.0,1995.0,29.7,82,57,52,21,9,35,75,46.7,40,41,2,39,85,167,127,3,DF,20-24,Defender,Brazil,South America
2586,William,BRA,Wolfsburg,Bundesliga,2018,23.0,1995.0,29.7,82,57,52,21,9,35,75,46.7,40,41,2,39,85,167,127,3,DF,20-24,Defender,Brazil,South America
2586,William,BRA,Wolfsburg,Bundesliga,2018,23.0,1995.0,29.7,82,57,52,21,9,35,75,46.7,40,41,2,39,85,167,127,3,DF,20-24,Defender,Brazil,South America
2586,William,BRA,Wolfsburg,Bundesliga,2018,23.0,1995.0,29.7,82,57,52,21,9,35,75,46.7,40,41,2,39,85,167,127,3,DF,20-24,Defender,Brazil,South America
2586,William,BRA,Wolfsburg,Bundesliga,2018,23.0,1995.0,29.7,82,57,52,21,9,35,75,46.7,40,41,2,39,85,167,127,3,DF,20-24,Defender,Brazil,South America
2587,Danny Williams,USA,Huddersfield,Premier League,2018,29.0,1989.0,1.1,0,0,0,0,0,0,0,,0,4,1,3,1,1,2,0,MF,25-29,Midfielder,United States,North America
2587,Danny Williams,USA,Huddersfield,Premier League,2018,29.0,1989.0,1.1,0,0,0,0,0,0,0,,0,4,1,3,1,1,2,0,MF,25-29,Midfielder,United States,North America
2587,Danny Williams,USA,Huddersfield,Premier League,2018,29.0,1989.0,1.1,0,0,0,0,0,0,0,,0,4,1,3,1,1,2,0,MF,25-29,Midfielder,United States,North America
2587,Danny Williams,USA,Huddersfield,Premier League,2018,29.0,1989.0,1.1,0,0,0,0,0,0,0,,0,4,1,3,1,1,2,0,MF,25-29,Midfielder,United States,North America
2588,Iñaki Williams,GHA,Athletic Club,La Liga,2018,24.0,1994.0,33.6,27,18,9,7,11,5,22,22.7,17,22,1,21,7,34,33,0,FW,20-24,Forward,Ghana,Africa
2589,Willian,BRA,Chelsea,Premier League,2018,29.0,1988.0,23.3,35,21,11,15,9,9,25,36.0,16,16,1,15,14,49,12,2,FW,25-29,Forward,Brazil,South America
2589,Willian,BRA,Chelsea,Premier League,2018,29.0,1988.0,23.3,35,21,11,15,9,9,25,36.0,16,16,1,15,14,49,12,2,FW,25-29,Forward,Brazil,South America
2589,Willian,BRA,Chelsea,Premier League,2018,29.0,1988.0,23.3,35,21,11,15,9,9,25,36.0,16,16,1,15,14,49,12,2,FW,25-29,Forward,Brazil,South America
2589,Willian,BRA,Chelsea,Premier League,2018,29.0,1988.0,23.3,35,21,11,15,9,9,25,36.0,16,16,1,15,14,49,12,2,FW,25-29,Forward,Brazil,South America
2590,Joe Willock,ENG,Arsenal,Premier League,2018,18.0,1999.0,0.7,1,0,0,1,0,0,0,,0,1,0,1,1,2,0,0,"MF,FW",Under 20,Midfielder,England,Europe
2591,Ben Wilmot,ENG,Watford,Premier League,2018,18.0,1999.0,0.3,0,0,0,0,0,0,1,0.0,1,2,1,1,0,0,1,0,"MF,DF",Under 20,Midfielder,England,Europe
2592,Ben Wilmot,ENG,Udinese,Serie A,2018,18.0,1999.0,2.2,0,0,0,0,0,0,2,0.0,2,2,2,0,2,2,11,0,"DF,MF",Under 20,Defender,England,Europe
2593,Jack Wilshere,ENG,West Ham,Premier League,2018,26.0,1992.0,4.4,7,4,1,4,2,2,6,33.3,4,3,1,2,7,14,0,0,MF,25-29,Midfielder,England,Europe
2594,Callum Wilson,ENG,Bournemouth,Premier League,2018,26.0,1992.0,28.1,9,7,4,3,2,0,8,0.0,8,14,4,10,4,13,16,0,FW,25-29,Forward,England,Europe
2594,Callum Wilson,ENG,Bournemouth,Premier League,2018,26.0,1992.0,28.1,9,7,4,3,2,0,8,0.0,8,14,4,10,4,13,16,0,FW,25-29,Forward,England,Europe
2594,Callum Wilson,ENG,Bournemouth,Premier League,2018,26.0,1992.0,28.1,9,7,4,3,2,0,8,0.0,8,14,4,10,4,13,16,0,FW,25-29,Forward,England,Europe
2594,Callum Wilson,ENG,Bournemouth,Premier League,2018,26.0,1992.0,28.1,9,7,4,3,2,0,8,0.0,8,14,4,10,4,13,16,0,FW,25-29,Forward,England,Europe
2595,Kevin Wimmer,AUT,Hannover 96,Bundesliga,2018,25.0,1992.0,18.7,25,17,17,6,2,15,27,55.6,12,30,23,7,41,66,63,0,DF,25-29,Defender,Austria,Europe
2596,Harry Winks,ENG,Tottenham,Premier League,2018,22.0,1996.0,17.7,22,13,12,9,1,5,30,16.7,25,19,3,16,21,43,19,0,MF,20-24,Midfielder,England,Europe
2597,Axel Witsel,BEL,Dortmund,Bundesliga,2018,29.0,1989.0,31.9,47,33,19,24,4,17,28,60.7,11,33,6,27,47,94,49,0,MF,25-29,Midfielder,Belgium,Europe
2598,Maximilian Wöber,AUT,Sevilla,La Liga,2018,20.0,1998.0,6.0,12,9,8,2,2,3,6,50.0,3,6,0,6,7,19,16,0,DF,20-24,Defender,Austria,Europe
2599,Marius Wolf,GER,Dortmund,Bundesliga,2018,23.0,1995.0,9.2,14,10,11,3,0,5,13,38.5,8,6,0,6,13,27,12,0,"DF,FW",20-24,Defender,Germany,Europe
2600,Jeong Woo-yeong,KOR,Bayern Munich,Bundesliga,2018,18.0,1999.0,0.1,0,0,0,0,0,0,1,0.0,1,0,0,0,0,0,0,0,FW,Under 20,Forward,South Korea,Asia
2601,Bobby Wood,USA,Hannover 96,Bundesliga,2018,25.0,1992.0,13.1,13,10,2,10,1,5,8,62.5,3,2,0,2,4,17,6,0,"FW,MF",25-29,Forward,United States,North America
2602,Chris Wood,NZL,Burnley,Premier League,2018,26.0,1991.0,28.8,12,8,0,7,5,5,17,29.4,12,17,4,13,3,15,26,0,FW,25-29,Forward,New Zealand,Oceania
2603,Haji Wright,USA,Schalke 04,Bundesliga,2018,20.0,1998.0,2.2,3,2,1,1,1,0,1,0.0,1,1,0,1,0,3,1,0,FW,20-24,Forward,United States,North America
2604,Xeka,POR,Lille,Ligue 1,2018,23.0,1994.0,25.1,59,31,25,27,7,18,57,31.6,39,20,2,18,21,80,30,4,MF,20-24,Midfielder,Portugal,Europe
2605,Granit Xhaka,SUI,Arsenal,Premier League,2018,25.0,1992.0,27.8,52,29,29,20,3,24,59,40.7,35,35,9,26,36,88,56,3,"MF,DF",25-29,Midfielder,Switzerland,Europe
2606,Cédric Yamberé,CTA,Dijon,Ligue 1,2018,27.0,1990.0,31.2,47,31,36,11,0,21,39,53.8,18,45,32,13,52,99,136,4,DF,25-29,Defender,Central African Republic,Africa
2607,Andriy Yarmolenko,UKR,West Ham,Premier League,2018,28.0,1989.0,5.1,4,1,2,1,1,4,6,66.7,2,4,1,3,2,6,4,2,"MF,FW",25-29,Midfielder,Ukraine,Europe
2608,John Yeboah,ECU,Wolfsburg,Bundesliga,2018,18.0,2000.0,0.6,0,0,0,0,0,0,3,0.0,3,1,0,1,1,1,0,0,"MF,FW",Under 20,Midfielder,Ecuador,South America
2609,DeAndre Yedlin,USA,Newcastle Utd,Premier League,2018,25.0,1993.0,27.5,54,32,36,14,4,19,41,46.3,22,36,10,26,28,82,88,0,DF,25-29,Defender,United States,North America
2611,Okay Yokuşlu,TUR,Celta Vigo,La Liga,2018,24.0,1994.0,24.4,61,39,31,28,2,28,45,62.2,17,32,11,21,37,98,53,2,MF,20-24,Midfielder,Turkey,Asia
2612,Maya Yoshida,JPN,Southampton,Premier League,2018,29.0,1988.0,16.9,16,12,5,10,1,4,13,30.8,9,24,20,4,42,58,103,1,DF,25-29,Defender,Japan,Asia
2613,Elie Youan,FRA,Nantes,Ligue 1,2018,19.0,1999.0,0.2,1,0,0,1,0,0,0,,0,0,0,0,0,1,0,0,FW,Under 20,Forward,France,Europe
2614,Amin Younes,GER,Napoli,Serie A,2018,24.0,1993.0,5.5,11,6,3,6,2,3,6,50.0,3,7,0,7,2,13,0,0,"MF,FW",20-24,Midfielder,Germany,Europe
2615,Ashley Young,ENG,Manchester Utd,Premier League,2018,33.0,1985.0,28.5,52,32,34,16,2,20,39,51.3,19,36,10,26,55,107,74,0,DF,30-34,Defender,England,Europe
2617,Pablo Zabaleta,ARG,West Ham,Premier League,2018,33.0,1985.0,23.2,47,24,26,15,6,17,44,38.6,27,39,15,24,48,95,96,3,DF,30-34,Defender,Argentina,South America
2618,Dan-Axel Zagadou,FRA,Dortmund,Bundesliga,2018,19.0,1999.0,14.1,13,10,10,2,1,4,6,66.7,2,17,11,6,25,38,70,2,DF,Under 20,Defender,France,Europe
2619,Wilfried Zaha,CIV,Crystal Palace,Premier League,2018,25.0,1992.0,33.7,39,20,11,23,5,12,34,35.3,22,19,0,19,10,49,4,0,FW,25-29,Forward,Ivory Coast,Africa
2622,Denis Zakaria,SUI,Gladbach,Bundesliga,2018,21.0,1996.0,21.8,40,21,15,24,1,12,30,40.0,18,38,9,29,26,66,20,0,MF,20-24,Midfielder,Switzerland,Europe
2624,Andre-Frank Zambo Anguissa,CMR,Fulham,Premier League,2018,22.0,1995.0,16.9,48,29,23,20,5,18,52,34.6,34,25,6,19,34,82,32,0,MF,20-24,Midfielder,Cameroon,Africa
2625,Francesco Zampano,ITA,Frosinone,Serie A,2018,24.0,1993.0,23.4,35,25,23,9,3,15,31,48.4,16,24,4,20,13,48,48,0,"DF,MF",20-24,Defender,Italy,Europe
2626,Nicolò Zaniolo,ITA,Roma,Serie A,2018,19.0,1999.0,19.6,35,21,7,18,10,7,37,18.9,30,14,0,14,13,48,8,0,"MF,FW",Under 20,Midfielder,Italy,Europe
2627,Cristián Zapata,COL,Milan,Serie A,2018,31.0,1986.0,11.4,23,16,15,7,1,9,10,90.0,1,18,15,3,8,31,59,0,DF,30-34,Defender,Colombia,South America
2628,Duván Zapata,COL,Atalanta,Serie A,2018,27.0,1991.0,32.2,9,5,3,2,4,1,9,11.1,8,26,6,20,4,13,25,0,FW,25-29,Forward,Colombia,South America
2629,Davide Zappacosta,ITA,Chelsea,Premier League,2018,26.0,1992.0,1.4,0,0,0,0,0,0,1,0.0,1,0,0,0,3,3,5,0,DF,25-29,Defender,Italy,Europe
2630,Simone Zaza,ITA,Torino,Serie A,2018,27.0,1991.0,16.0,20,9,3,12,5,1,8,12.5,7,12,1,11,4,24,9,0,"FW,MF",25-29,Forward,Italy,Europe
2631,Marvin Zeegelaar,NED,Udinese,Serie A,2018,27.0,1990.0,10.6,30,23,21,6,3,16,24,66.7,8,11,2,9,17,47,38,0,DF,25-29,Defender,Netherlands,Europe
2632,Mehdi Zeffane,ALG,Rennes,Ligue 1,2018,26.0,1992.0,13.5,19,13,12,7,0,10,26,38.5,16,14,5,9,18,37,35,1,"DF,MF",25-29,Defender,Algeria,Africa
2634,Mootaz Zemzemi,TUN,Strasbourg,Ligue 1,2018,18.0,1999.0,0.0,1,0,0,0,1,0,0,,0,0,0,0,0,1,0,0,"FW,MF",Under 20,Forward,Tunisia,Africa
2636,Robin Zentner,GER,Mainz 05,Bundesliga,2018,23.0,1994.0,10.0,0,0,0,0,0,0,1,0.0,1,0,0,0,1,1,3,0,GK,20-24,Goalkeeper,Germany,Europe
2637,Nabil El Zhar,MAR,Leganés,La Liga,2018,31.0,1986.0,10.7,8,4,2,4,2,0,5,0.0,5,4,0,4,4,12,1,0,"MF,FW",30-34,Midfielder,Morocco,Africa
2638,Luca Zidane,FRA,Real Madrid,La Liga,2018,20.0,1998.0,1.0,0,0,0,0,0,0,0,,0,0,0,0,0,0,0,0,GK,20-24,Goalkeeper,France,Europe
2639,Ron-Robert Zieler,GER,Stuttgart,Bundesliga,2018,29.0,1989.0,34.0,2,1,2,0,0,1,4,25.0,3,1,0,1,1,3,19,3,GK,25-29,Goalkeeper,Germany,Europe
2641,Jean Zimmer,GER,Düsseldorf,Bundesliga,2018,24.0,1993.0,15.9,17,11,11,5,1,6,16,37.5,10,13,2,11,11,28,32,1,"DF,FW",20-24,Defender,Germany,Europe
2642,Matthias Zimmermann,GER,Düsseldorf,Bundesliga,2018,26.0,1992.0,33.9,97,64,69,24,4,45,90,50.0,45,51,18,33,67,164,90,2,"DF,MF",25-29,Defender,Germany,Europe
2643,Oleksandr Zinchenko,UKR,Manchester City,Premier League,2018,21.0,1996.0,12.8,34,20,13,15,6,14,33,42.4,19,14,3,11,20,54,19,1,DF,20-24,Defender,Ukraine,Europe
2644,Kévin Zohi,MLI,Strasbourg,Ligue 1,2018,21.0,1996.0,7.0,14,10,6,6,2,5,9,55.6,4,8,0,8,7,21,5,0,"FW,MF",20-24,Forward,Mali,Africa
2645,Kenneth Zohore,DEN,Cardiff City,Premier League,2018,24.0,1994.0,8.4,3,2,0,3,0,1,3,33.3,2,4,2,2,2,5,5,0,FW,20-24,Forward,Denmark,Europe
2646,Kurt Zouma,FRA,Everton,Premier League,2018,23.0,1994.0,29.0,32,21,16,14,2,4,11,36.4,7,27,12,15,54,86,126,2,DF,20-24,Defender,France,Europe
2647,Adam Zreľák,SVK,Nürnberg,Bundesliga,2018,24.0,1994.0,10.5,14,9,2,11,1,5,9,55.6,4,14,2,12,2,16,13,0,FW,20-24,Forward,Slovakia,Europe
2649,Steven Zuber,SUI,Hoffenheim,Bundesliga,2018,26.0,1991.0,6.3,12,9,5,6,1,6,13,46.2,7,5,1,4,5,17,4,0,"MF,FW",25-29,Midfielder,Switzerland,Europe
2650,Steven Zuber,SUI,Stuttgart,Bundesliga,2018,26.0,1991.0,11.7,6,3,2,2,2,1,13,7.7,12,14,2,12,6,12,6,0,"MF,FW",25-29,Midfielder,Switzerland,Europe
2652,Ervin Zukanović,BIH,Genoa,Serie A,2018,31.0,1987.0,21.8,28,16,20,7,1,17,30,56.7,13,17,9,8,19,47,96,0,DF,30-34,Defender,Bosnia and Herzegovina,Europe
2653,Bongani Zungu,RSA,Amiens,Ligue 1,2018,25.0,1992.0,2.6,3,2,0,1,2,2,8,25.0,6,0,0,0,2,5,5,0,MF,25-29,Midfielder,South Africa,Africa
2050,Pepe Reina,ESP,Milan,Serie A,2018,35.0,1982.0,3.7,0,0,0,0,0,0,0,,0,0,0,0,0,0,1,0,GK,35-39,Goalkeeper,Spain,Europe
2065,Diego Rico,ESP,Bournemouth,Premier League,2018,25.0,1993.0,6.8,14,9,8,2,4,4,12,33.3,8,13,2,11,14,28,20,0,"DF,MF",25-29,Defender,Spain,Europe
2066,Mikel Rico,ESP,Athletic Club,La Liga,2018,33.0,1984.0,2.7,5,2,1,4,0,2,7,28.6,5,3,2,1,2,7,3,0,MF,30-34,Midfielder,Spain,Europe
2067,Sergio Rico,ESP,Fulham,Premier League,2018,24.0,1993.0,29.0,1,1,1,0,0,1,1,100.0,0,0,0,0,1,2,13,5,GK,20-24,Goalkeeper,Spain,Europe
2068,Asier Riesgo,ESP,Eibar,La Liga,2018,34.0,1983.0,14.0,1,1,1,0,0,1,3,33.3,2,0,0,0,0,1,8,1,GK,30-34,Goalkeeper,Spain,Europe
2076,Mihailo Ristić,SRB,Montpellier,Ligue 1,2018,22.0,1995.0,3.6,14,9,8,5,1,6,10,60.0,4,11,3,8,9,23,6,0,"DF,MF",20-24,Defender,Serbia,Europe
2078,Cristian Rivera,ESP,Huesca,La Liga,2018,21.0,1997.0,18.8,38,25,18,19,1,11,25,44.0,14,21,4,17,31,69,31,0,MF,20-24,Midfielder,Spain,Europe
2080,Rober,ESP,Levante,La Liga,2018,23.0,1995.0,31.7,41,29,33,6,2,24,48,50.0,24,52,36,16,51,92,129,2,DF,20-24,Defender,Spain,Europe
2081,Sergi Roberto,ESP,Barcelona,La Liga,2018,26.0,1992.0,23.2,28,20,15,9,4,16,24,66.7,8,18,3,15,43,71,31,0,"DF,MF",25-29,Defender,Spain,Europe
2084,Joel Robles,ESP,Betis,La Liga,2018,28.0,1990.0,5.0,1,0,1,0,0,1,1,100.0,0,0,0,0,0,1,5,1,GK,25-29,Goalkeeper,Spain,Europe
2085,Marc Roca,ESP,Espanyol,La Liga,2018,21.0,1996.0,34.6,71,45,36,26,9,28,70,40.0,42,43,21,22,36,107,60,3,MF,20-24,Midfielder,Spain,Europe
2088,Rubén Rochina,ESP,Levante,La Liga,2018,27.0,1991.0,20.0,51,33,26,16,9,23,81,28.4,58,29,0,29,21,72,19,1,MF,25-29,Midfielder,Spain,Europe
2091,Rodri,ESP,Atlético Madrid,La Liga,2018,22.0,1996.0,30.4,103,70,45,50,8,39,75,52.0,36,35,11,24,41,144,68,0,MF,20-24,Midfielder,Spain,Europe
2091,Rodri,ESP,Atlético Madrid,La Liga,2018,22.0,1996.0,30.4,103,70,45,50,8,39,75,52.0,36,35,11,24,41,144,68,0,MF,20-24,Midfielder,Spain,Europe
2091,Rodri,ESP,Atlético Madrid,La Liga,2018,22.0,1996.0,30.4,103,70,45,50,8,39,75,52.0,36,35,11,24,41,144,68,0,MF,20-24,Midfielder,Spain,Europe
2091,Rodri,ESP,Atlético Madrid,La Liga,2018,22.0,1996.0,30.4,103,70,45,50,8,39,75,52.0,36,35,11,24,41,144,68,0,MF,20-24,Midfielder,Spain,Europe
2092,Rodrigo,ESP,Valencia,La Liga,2018,27.0,1991.0,28.1,21,10,6,9,6,3,17,17.6,14,17,1,16,3,24,18,0,FW,25-29,Forward,Spain,Europe
2094,Alejandro Rodríguez,ESP,Empoli,Serie A,2018,27.0,1991.0,0.3,0,0,0,0,0,0,0,,0,0,0,0,0,0,1,0,MF,25-29,Midfielder,Spain,Europe
2095,Ángel Rodríguez,ESP,Getafe,La Liga,2018,31.0,1987.0,20.2,16,7,1,6,9,6,26,23.1,20,15,1,14,8,24,8,0,FW,30-34,Forward,Spain,Europe
2096,Óscar Rodríguez Arnaiz,ESP,Leganés,La Liga,2018,20.0,1998.0,27.8,46,25,26,15,5,16,58,27.6,42,12,2,10,16,62,16,0,MF,20-24,Midfielder,Spain,Europe
2109,Alaixys Romao,TOG,Reims,Ligue 1,2018,34.0,1984.0,35.1,118,71,61,50,7,43,102,42.2,59,44,16,28,58,176,65,1,MF,30-34,Midfielder,Togo,Africa
2111,Oriol Romeu,ESP,Southampton,Premier League,2018,26.0,1991.0,23.7,81,46,39,38,4,32,77,41.6,45,43,17,26,52,133,44,1,MF,25-29,Midfielder,Spain,Europe
2128,Waldo Rubio,ESP,Valladolid,La Liga,2018,22.0,1995.0,5.5,4,2,3,1,0,1,6,16.7,5,2,0,2,1,5,8,1,MF,20-24,Midfielder,Spain,Europe
2135,Abel Ruiz,ESP,Barcelona,La Liga,2018,18.0,2000.0,0.2,1,1,1,0,0,1,1,100.0,0,0,0,0,0,1,0,0,FW,Under 20,Forward,Spain,Europe
2136,Fabián Ruiz Peña,ESP,Napoli,Serie A,2018,22.0,1996.0,22.1,54,33,22,25,7,20,46,43.5,26,23,4,19,21,75,29,2,MF,20-24,Midfielder,Spain,Europe
2137,Víctor Ruiz,ESP,Villarreal,La Liga,2018,29.0,1989.0,21.9,28,19,20,6,2,13,18,72.2,5,28,16,12,38,66,67,1,DF,25-29,Defender,Spain,Europe
2154,Samuel Sáiz,ESP,Getafe,La Liga,2018,27.0,1991.0,3.4,4,3,0,3,1,2,5,40.0,3,1,0,1,0,4,2,0,MF,25-29,Midfielder,Spain,Europe
2163,Bartosz Salamon,POL,Frosinone,Serie A,2018,27.0,1991.0,19.2,17,10,12,5,0,6,14,42.9,8,27,19,8,27,44,143,1,DF,25-29,Defender,Poland,Europe
2174,Mikel San José,ESP,Athletic Club,La Liga,2018,29.0,1989.0,19.3,43,25,19,19,5,15,48,31.3,33,27,6,21,21,64,35,0,MF,25-29,Midfielder,Spain,Europe
2181,Javi Sánchez,ESP,Real Madrid,La Liga,2018,21.0,1997.0,0.5,1,0,1,0,0,0,0,,0,0,0,0,0,1,4,0,DF,20-24,Defender,Spain,Europe
2182,Víctor Sánchez,ESP,Espanyol,La Liga,2018,30.0,1987.0,14.1,45,30,21,17,7,14,67,20.9,53,17,2,15,25,70,25,0,MF,30-34,Midfielder,Spain,Europe
2189,Luca Sangalli,ESP,Real Sociedad,La Liga,2018,23.0,1995.0,11.1,19,13,6,11,2,5,22,22.7,17,9,1,8,5,24,5,0,"MF,FW",20-24,Midfielder,Spain,Europe
2198,Roberto Santamaría,ESP,Huesca,La Liga,2018,33.0,1985.0,20.0,0,0,0,0,0,0,0,,0,0,0,0,1,1,12,1,GK,30-34,Goalkeeper,Spain,Europe
2204,Pablo Sarabia,ESP,Sevilla,La Liga,2018,26.0,1992.0,30.3,30,15,6,15,9,6,47,12.8,41,30,3,27,22,52,20,0,"MF,FW",25-29,Midfielder,Spain,Europe
2210,Lluís Sastre,ESP,Huesca,La Liga,2018,32.0,1986.0,1.3,5,3,0,5,0,0,1,0.0,1,0,0,0,1,6,0,0,MF,30-34,Midfielder,Spain,Europe
2219,Patrik Schick,CZE,Roma,Serie A,2018,22.0,1996.0,14.6,11,5,3,5,3,1,19,5.3,18,19,2,17,3,14,15,1,"FW,MF",20-24,Forward,Czech Republic,Europe
2239,Ole Selnæs,NOR,Saint-Étienne,Ligue 1,2018,24.0,1994.0,18.5,44,26,12,23,9,13,35,37.1,22,24,7,17,19,63,29,0,MF,20-24,Midfielder,Norway,Europe
2272,David Silva,ESP,Manchester City,Premier League,2018,32.0,1986.0,26.7,30,18,12,11,7,1,20,5.0,19,18,1,17,22,52,15,0,MF,30-34,Midfielder,Spain,Europe
2272,David Silva,ESP,Manchester City,Premier League,2018,32.0,1986.0,26.7,30,18,12,11,7,1,20,5.0,19,18,1,17,22,52,15,0,MF,30-34,Midfielder,Spain,Europe
2272,David Silva,ESP,Manchester City,Premier League,2018,32.0,1986.0,26.7,30,18,12,11,7,1,20,5.0,19,18,1,17,22,52,15,0,MF,30-34,Midfielder,Spain,Europe
2272,David Silva,ESP,Manchester City,Premier League,2018,32.0,1986.0,26.7,30,18,12,11,7,1,20,5.0,19,18,1,17,22,52,15,0,MF,30-34,Midfielder,Spain,Europe
2282,Unai Simón,ESP,Athletic Club,La Liga,2018,21.0,1997.0,7.0,0,0,0,0,0,0,1,0.0,1,0,0,0,1,1,1,1,GK,20-24,Goalkeeper,Spain,Europe
2292,Antonio Sivera,ESP,Alavés,La Liga,2018,21.0,1996.0,3.0,0,0,0,0,0,0,0,,0,0,0,0,0,0,4,1,GK,20-24,Goalkeeper,Spain,Europe
2295,Łukasz Skorupski,POL,Bologna,Serie A,2018,27.0,1991.0,38.0,0,0,0,0,0,0,0,,0,0,0,0,3,3,12,4,GK,25-29,Goalkeeper,Poland,Europe
2298,Petar Škuletić,SRB,Montpellier,Ligue 1,2018,28.0,1990.0,6.7,9,5,4,2,3,1,15,6.7,14,7,1,6,3,12,14,1,FW,25-29,Forward,Serbia,Europe
2310,Rubén Sobrino,ESP,Alavés,La Liga,2018,26.0,1992.0,10.7,16,11,7,6,3,5,13,38.5,8,16,1,15,2,18,13,0,"FW,MF",25-29,Forward,Spain,Europe
2311,Rubén Sobrino,ESP,Valencia,La Liga,2018,26.0,1992.0,2.1,6,3,1,4,1,1,1,100.0,0,1,1,0,1,7,1,0,"FW,MF",25-29,Forward,Spain,Europe
2313,Alex Sola,ESP,Real Sociedad,La Liga,2018,19.0,1999.0,1.0,4,3,0,3,1,3,4,75.0,1,0,0,0,1,5,2,0,DF,Under 20,Defender,Spain,Europe
2316,Carlos Soler,ESP,Valencia,La Liga,2018,21.0,1997.0,27.3,41,28,15,23,3,16,65,24.6,49,46,6,40,19,60,37,0,MF,20-24,Midfielder,Spain,Europe
2322,David Soria,ESP,Getafe,La Liga,2018,25.0,1993.0,37.0,1,0,1,0,0,1,2,50.0,1,2,0,2,1,2,15,6,GK,25-29,Goalkeeper,Spain,Europe
2323,Juan Soriano,ESP,Sevilla,La Liga,2018,20.0,1997.0,4.0,0,0,0,0,0,0,0,,0,0,0,0,1,1,1,0,GK,20-24,Goalkeeper,Spain,Europe
2352,Mariusz Stępiński,POL,Chievo,Serie A,2018,23.0,1995.0,27.5,18,13,1,11,6,1,17,5.9,16,10,2,8,5,23,20,0,FW,20-24,Forward,Poland,Europe
2363,Leo Štulac,SVN,Parma,Serie A,2018,23.0,1994.0,16.1,21,13,10,10,1,4,17,23.5,13,29,13,16,34,55,31,1,MF,20-24,Midfielder,Slovenia,Europe
2367,Denis Suárez,ESP,Arsenal,Premier League,2018,24.0,1994.0,0.8,1,1,0,1,0,0,5,0.0,5,0,0,0,1,2,0,0,"MF,FW",20-24,Midfielder,Spain,Europe
2368,Denis Suárez,ESP,Barcelona,La Liga,2018,24.0,1994.0,0.2,0,0,0,0,0,0,0,,0,1,0,1,0,0,0,0,"MF,DF",20-24,Midfielder,Spain,Europe
2371,Mario Suárez,ESP,Rayo Vallecano,La Liga,2018,31.0,1987.0,11.4,37,23,17,17,3,15,28,53.6,13,10,3,7,14,51,17,2,MF,30-34,Midfielder,Spain,Europe
2374,Neven Subotić,SRB,Saint-Étienne,Ligue 1,2018,29.0,1988.0,23.9,44,23,36,7,1,20,39,51.3,19,14,6,8,38,82,107,3,DF,25-29,Defender,Serbia,Europe
2380,Markel Susaeta,ESP,Athletic Club,La Liga,2018,30.0,1987.0,15.3,17,10,4,6,7,3,23,13.0,20,10,1,9,12,29,5,0,"FW,MF",30-34,Forward,Spain,Europe
2381,Suso,ESP,Milan,Serie A,2018,24.0,1993.0,33.5,28,18,10,14,4,10,41,24.4,31,26,1,25,16,44,3,0,"FW,MF",20-24,Forward,Spain,Europe
2390,Wojciech Szczęsny,POL,Juventus,Serie A,2018,28.0,1990.0,28.0,2,1,2,0,0,1,1,100.0,0,0,0,0,1,3,8,2,GK,25-29,Goalkeeper,Poland,Europe
2391,Alexander Sørloth,NOR,Crystal Palace,Premier League,2018,22.0,1995.0,2.1,2,1,0,0,2,1,2,50.0,1,0,0,0,0,2,3,0,FW,20-24,Forward,Norway,Europe
2396,Strahinja Tanasijević,SRB,Chievo,Serie A,2018,21.0,1997.0,0.2,0,0,0,0,0,0,0,,0,0,0,0,0,0,0,0,"DF,MF",20-24,Defender,Serbia,Europe
2398,Rodrigo Tarín,ESP,Leganés,La Liga,2018,22.0,1996.0,15.9,22,14,15,5,2,7,10,70.0,3,11,5,6,31,53,79,0,DF,20-24,Defender,Spain,Europe
2408,Cristian Tello,ESP,Betis,La Liga,2018,26.0,1991.0,17.5,32,20,18,9,5,17,35,48.6,18,19,0,19,16,48,17,1,"DF,FW",25-29,Defender,Spain,Europe
2409,Łukasz Teodorczyk,POL,Udinese,Serie A,2018,27.0,1991.0,4.4,4,2,2,2,0,2,8,25.0,6,8,2,6,1,5,4,0,FW,25-29,Forward,Poland,Europe
2430,David Timor,ESP,Girona,La Liga,2018,28.0,1989.0,1.8,2,2,1,1,0,0,1,0.0,1,1,1,0,3,5,3,0,MF,25-29,Midfielder,Spain,Europe
2433,Tito,ESP,Rayo Vallecano,La Liga,2018,33.0,1985.0,12.2,14,9,12,2,0,7,22,31.8,15,22,2,20,17,31,41,0,DF,30-34,Defender,Spain,Europe
2439,Raúl de Tomás,ESP,Rayo Vallecano,La Liga,2018,23.0,1994.0,31.3,8,3,0,7,1,0,12,0.0,12,18,4,14,9,17,45,0,FW,20-24,Forward,Spain,Europe
2441,Nenad Tomović,SRB,Chievo,Serie A,2018,30.0,1987.0,8.2,9,7,5,4,0,7,10,70.0,3,5,1,4,13,22,34,0,DF,30-34,Defender,Serbia,Europe
2443,Toño,ESP,Levante,La Liga,2018,28.0,1989.0,19.6,17,13,12,3,2,10,21,47.6,11,20,5,15,14,31,42,0,"DF,FW",25-29,Defender,Spain,Europe
2443,Toño,ESP,Levante,La Liga,2018,28.0,1989.0,19.6,17,13,12,3,2,10,21,47.6,11,20,5,15,14,31,42,0,"DF,FW",25-29,Defender,Spain,Europe
2443,Toño,ESP,Levante,La Liga,2018,28.0,1989.0,19.6,17,13,12,3,2,10,21,47.6,11,20,5,15,14,31,42,0,"DF,FW",25-29,Defender,Spain,Europe
2443,Toño,ESP,Levante,La Liga,2018,28.0,1989.0,19.6,17,13,12,3,2,10,21,47.6,11,20,5,15,14,31,42,0,"DF,FW",25-29,Defender,Spain,Europe
2447,Ferrán Torres,ESP,Valencia,La Liga,2018,18.0,2000.0,9.4,15,8,4,8,3,5,11,45.5,6,10,1,9,10,25,9,0,MF,Under 20,Midfielder,Spain,Europe
2448,Lucas Torró,ESP,Eint Frankfurt,Bundesliga,2018,24.0,1994.0,6.2,14,7,5,7,2,5,11,45.5,6,12,1,11,14,28,13,0,MF,20-24,Midfielder,Spain,Europe
2456,Adama Traoré,ESP,Wolves,Premier League,2018,22.0,1996.0,10.0,16,13,11,3,2,4,9,44.4,5,11,0,11,6,22,7,0,"FW,MF",20-24,Forward,Spain,Europe
2456,Adama Traoré,ESP,Wolves,Premier League,2018,22.0,1996.0,10.0,16,13,11,3,2,4,9,44.4,5,11,0,11,6,22,7,0,"FW,MF",20-24,Forward,Spain,Europe
2456,Adama Traoré,ESP,Wolves,Premier League,2018,22.0,1996.0,10.0,16,13,11,3,2,4,9,44.4,5,11,0,11,6,22,7,0,"FW,MF",20-24,Forward,Spain,Europe
2456,Adama Traoré,ESP,Wolves,Premier League,2018,22.0,1996.0,10.0,16,13,11,3,2,4,9,44.4,5,11,0,11,6,22,7,0,"FW,MF",20-24,Forward,Spain,Europe
2456,Adama Traoré,ESP,Wolves,Premier League,2018,22.0,1996.0,10.0,16,13,11,3,2,4,9,44.4,5,11,0,11,6,22,7,0,"FW,MF",20-24,Forward,Spain,Europe
2456,Adama Traoré,ESP,Wolves,Premier League,2018,22.0,1996.0,10.0,16,13,11,3,2,4,9,44.4,5,11,0,11,6,22,7,0,"FW,MF",20-24,Forward,Spain,Europe
2456,Adama Traoré,ESP,Wolves,Premier League,2018,22.0,1996.0,10.0,16,13,11,3,2,4,9,44.4,5,11,0,11,6,22,7,0,"FW,MF",20-24,Forward,Spain,Europe
2456,Adama Traoré,ESP,Wolves,Premier League,2018,22.0,1996.0,10.0,16,13,11,3,2,4,9,44.4,5,11,0,11,6,22,7,0,"FW,MF",20-24,Forward,Spain,Europe
2456,Adama Traoré,ESP,Wolves,Premier League,2018,22.0,1996.0,10.0,16,13,11,3,2,4,9,44.4,5,11,0,11,6,22,7,0,"FW,MF",20-24,Forward,Spain,Europe
2456,Adama Traoré,ESP,Wolves,Premier League,2018,22.0,1996.0,10.0,16,13,11,3,2,4,9,44.4,5,11,0,11,6,22,7,0,"FW,MF",20-24,Forward,Spain,Europe
2456,Adama Traoré,ESP,Wolves,Premier League,2018,22.0,1996.0,10.0,16,13,11,3,2,4,9,44.4,5,11,0,11,6,22,7,0,"FW,MF",20-24,Forward,Spain,Europe
2456,Adama Traoré,ESP,Wolves,Premier League,2018,22.0,1996.0,10.0,16,13,11,3,2,4,9,44.4,5,11,0,11,6,22,7,0,"FW,MF",20-24,Forward,Spain,Europe
2456,Adama Traoré,ESP,Wolves,Premier League,2018,22.0,1996.0,10.0,16,13,11,3,2,4,9,44.4,5,11,0,11,6,22,7,0,"FW,MF",20-24,Forward,Spain,Europe
2456,Adama Traoré,ESP,Wolves,Premier League,2018,22.0,1996.0,10.0,16,13,11,3,2,4,9,44.4,5,11,0,11,6,22,7,0,"FW,MF",20-24,Forward,Spain,Europe
2456,Adama Traoré,ESP,Wolves,Premier League,2018,22.0,1996.0,10.0,16,13,11,3,2,4,9,44.4,5,11,0,11,6,22,7,0,"FW,MF",20-24,Forward,Spain,Europe
2456,Adama Traoré,ESP,Wolves,Premier League,2018,22.0,1996.0,10.0,16,13,11,3,2,4,9,44.4,5,11,0,11,6,22,7,0,"FW,MF",20-24,Forward,Spain,Europe
2469,Manu Trigueros,ESP,Villarreal,La Liga,2018,26.0,1991.0,17.2,46,35,18,23,5,20,57,35.1,37,17,6,11,16,62,17,0,MF,25-29,Midfielder,Spain,Europe
2487,Tomáš Vaclík,CZE,Sevilla,La Liga,2018,29.0,1989.0,33.0,0,0,0,0,0,0,1,0.0,1,0,0,0,0,0,9,6,GK,25-29,Goalkeeper,Czech Republic,Europe
2495,Borja Valero,ESP,Inter,Serie A,2018,33.0,1985.0,13.7,22,19,9,10,3,8,30,26.7,22,11,1,10,16,38,27,2,MF,30-34,Midfielder,Spain,Europe
2497,Jesús Vallejo,ESP,Real Madrid,La Liga,2018,21.0,1997.0,3.5,6,5,4,2,0,5,6,83.3,1,4,4,0,7,13,12,0,DF,20-24,Defender,Spain,Europe
2507,Kevin Vázquez,ESP,Celta Vigo,La Liga,2018,25.0,1993.0,2.4,6,5,5,0,1,4,7,57.1,3,8,3,5,2,8,9,0,DF,25-29,Defender,Spain,Europe
2508,Lucas Vázquez,ESP,Real Madrid,La Liga,2018,27.0,1991.0,16.8,43,26,11,21,11,15,41,36.6,26,16,1,15,12,55,11,0,"FW,MF",25-29,Forward,Spain,Europe
2510,Koke Vegas,ESP,Levante,La Liga,2018,22.0,1995.0,1.0,0,0,0,0,0,0,0,,0,0,0,0,0,0,0,0,GK,20-24,Goalkeeper,Spain,Europe
2512,Miloš Veljković,SRB,Werder Bremen,Bundesliga,2018,22.0,1995.0,20.9,36,24,29,6,1,22,37,59.5,15,27,13,14,27,63,111,0,DF,20-24,Defender,Serbia,Europe
2523,Mikel Vesga,ESP,Leganés,La Liga,2018,25.0,1993.0,23.0,50,32,27,15,8,20,82,24.4,62,42,4,38,39,89,26,0,MF,25-29,Midfielder,Spain,Europe
2528,Aleix Vidal,ESP,Sevilla,La Liga,2018,28.0,1989.0,5.9,13,11,5,5,3,5,14,35.7,9,5,0,5,4,17,12,0,"DF,MF",25-29,Defender,Spain,Europe
2532,Carlos Vigaray,ESP,Alavés,La Liga,2018,23.0,1994.0,7.2,15,8,10,4,1,9,15,60.0,6,6,1,5,6,21,24,1,DF,20-24,Defender,Spain,Europe
2534,Dídac Vilà,ESP,Espanyol,La Liga,2018,29.0,1989.0,26.2,67,31,33,26,8,31,58,53.4,27,41,12,29,53,120,94,1,DF,25-29,Defender,Spain,Europe
2535,Toni Villa,ESP,Valladolid,La Liga,2018,23.0,1995.0,19.6,51,32,24,18,9,20,47,42.6,27,15,0,15,12,63,10,0,"MF,FW",20-24,Midfielder,Spain,Europe
2538,Vitolo,ESP,Atlético Madrid,La Liga,2018,28.0,1989.0,8.4,17,13,8,6,3,6,19,31.6,13,8,1,7,10,27,6,0,"MF,FW",25-29,Midfielder,Spain,Europe
2538,Vitolo,ESP,Atlético Madrid,La Liga,2018,28.0,1989.0,8.4,17,13,8,6,3,6,19,31.6,13,8,1,7,10,27,6,0,"MF,FW",25-29,Midfielder,Spain,Europe
2538,Vitolo,ESP,Atlético Madrid,La Liga,2018,28.0,1989.0,8.4,17,13,8,6,3,6,19,31.6,13,8,1,7,10,27,6,0,"MF,FW",25-29,Midfielder,Spain,Europe
2538,Vitolo,ESP,Atlético Madrid,La Liga,2018,28.0,1989.0,8.4,17,13,8,6,3,6,19,31.6,13,8,1,7,10,27,6,0,"MF,FW",25-29,Midfielder,Spain,Europe
2542,Dušan Vlahović,SRB,Fiorentina,Serie A,2018,18.0,2000.0,1.8,0,0,0,0,0,0,0,,0,2,0,2,0,0,4,0,FW,Under 20,Forward,Serbia,Europe
2551,Matěj Vydra,CZE,Burnley,Premier League,2018,26.0,1992.0,3.5,2,1,0,1,1,0,3,0.0,3,4,1,3,1,3,6,0,FW,25-29,Forward,Czech Republic,Europe
2610,Yoel,ESP,Valladolid,La Liga,2018,29.0,1988.0,3.0,0,0,0,0,0,0,0,,0,0,0,0,0,0,0,1,GK,25-29,Goalkeeper,Spain,Europe
2616,Zaydou Youssouf,COM,Bordeaux,Ligue 1,2018,19.0,1999.0,4.7,7,5,3,4,0,3,7,42.9,4,5,1,4,5,12,0,0,"MF,FW",Under 20,Midfielder,Comoros,Africa
2620,Younn Zahary,COM,Caen,Ligue 1,2018,19.0,1998.0,8.2,16,9,7,6,3,8,14,57.1,6,13,8,5,16,32,35,0,DF,Under 20,Defender,Comoros,Africa
2621,Miha Zajc,SVN,Empoli,Serie A,2018,24.0,1994.0,13.0,6,4,1,1,4,2,11,18.2,9,15,4,11,5,11,8,0,"MF,FW",20-24,Midfielder,Slovenia,Europe
2623,Joseba Zaldúa,ESP,Real Sociedad,La Liga,2018,26.0,1992.0,23.8,36,27,23,10,3,15,32,46.9,17,19,3,16,38,74,72,0,DF,25-29,Defender,Spain,Europe
2640,Piotr Zieliński,POL,Napoli,Serie A,2018,24.0,1994.0,31.9,41,25,11,20,10,13,34,38.2,21,30,4,26,20,61,18,0,MF,20-24,Midfielder,Poland,Europe
2648,Igor Zubeldia,ESP,Real Sociedad,La Liga,2018,21.0,1997.0,28.3,61,35,32,24,5,22,54,40.7,32,30,6,24,45,106,60,0,MF,20-24,Midfielder,Spain,Europe
2651,Martín Zubimendi,ESP,Real Sociedad,La Liga,2018,19.0,1999.0,0.1,1,0,0,1,0,0,1,0.0,1,0,0,0,0,1,0,0,MF,Under 20,Midfielder,Spain,Europe
2654,David Zurutuza,ESP,Real Sociedad,La Liga,2018,32.0,1986.0,13.6,27,16,9,15,3,8,22,36.4,14,19,4,15,24,51,26,1,MF,30-34,Midfielder,Spain,Europe
2655,Filip Đorđević,SRB,Chievo,Serie A,2018,30.0,1987.0,7.0,11,6,3,6,2,3,12,25.0,9,7,1,6,2,13,8,1,FW,30-34,Forward,Serbia,Europe
2656,Filip Đuričić,SRB,Sassuolo,Serie A,2018,26.0,1992.0,13.9,17,13,2,11,4,5,22,22.7,17,20,1,19,8,25,8,1,"FW,MF",25-29,Forward,Serbia,Europe
1,Max Aarons,ENG,Norwich City,Premier League,2021,21.0,2000.0,32.0,64,44,49,15,0,37,55,67.3,18,39,19,20,28,92,96,1,DF,20-24,Defender,England,Europe
2,Yunis Abdelhamid,MAR,Reims,Ligue 1,2021,33.0,1987.0,33.1,48,27,34,14,0,16,32,50.0,16,50,25,25,68,116,104,0,DF,30-34,Defender,Morocco,Africa
3,Salis Abdul Samed,GHA,Clermont Foot,Ligue 1,2021,21.0,2000.0,27.4,43,23,25,16,2,20,57,35.1,37,18,1,17,42,85,15,0,MF,20-24,Midfielder,Ghana,Africa
4,Laurent Abergel,FRA,Lorient,Ligue 1,2021,28.0,1993.0,32.8,110,60,44,53,13,71,166,42.8,95,58,1,57,55,165,13,0,MF,25-29,Midfielder,France,Europe
5,Charles Abi,FRA,Saint-Étienne,Ligue 1,2021,21.0,2000.0,0.5,0,0,0,0,0,0,1,0.0,1,2,0,2,0,0,0,0,FW,20-24,Forward,France,Europe
6,Dickson Abiama,NGA,Greuther Fürth,Bundesliga,2021,22.0,1998.0,8.1,11,7,4,5,2,2,10,20.0,8,12,1,11,4,15,8,0,FW,20-24,Forward,Nigeria,Africa
7,Matthis Abline,FRA,Rennes,Ligue 1,2021,18.0,2003.0,1.1,0,0,0,0,0,0,0,,0,2,0,2,0,0,1,0,FW,Under 20,Forward,France,Europe
8,Tammy Abraham,ENG,Roma,Serie A,2021,23.0,1997.0,34.3,27,13,7,14,6,9,22,40.9,13,17,3,14,5,32,27,0,FW,20-24,Forward,England,Europe
9,Luis Abram,PER,Granada,La Liga,2021,25.0,1996.0,6.2,6,3,3,3,0,2,4,50.0,2,6,5,1,5,11,37,1,DF,25-29,Defender,Peru,South America
10,Francesco Acerbi,ITA,Lazio,Serie A,2021,33.0,1988.0,28.2,25,12,15,9,1,12,19,63.2,7,37,28,9,34,59,92,0,DF,30-34,Defender,Italy,Europe
11,Ragnar Ache,GER,Eint Frankfurt,Bundesliga,2021,23.0,1998.0,2.9,2,0,0,1,1,1,4,25.0,3,3,0,3,0,2,1,0,"MF,FW",20-24,Midfielder,Germany,Europe
12,Mohamed Achi,FRA,Nantes,Ligue 1,2021,19.0,2002.0,0.1,0,0,0,0,0,0,0,,0,0,0,0,0,0,0,0,MF,Under 20,Midfielder,France,Europe
13,Marcos Acuña,ARG,Sevilla,La Liga,2021,29.0,1991.0,25.1,50,29,27,14,9,30,46,65.2,16,22,5,17,14,64,25,1,DF,25-29,Defender,Argentina,South America
14,Che Adams,SCO,Southampton,Premier League,2021,25.0,1996.0,22.7,13,6,5,5,3,2,16,12.5,14,18,2,16,8,21,18,0,FW,25-29,Forward,Scotland,Europe
15,Tyler Adams,USA,RB Leipzig,Bundesliga,2021,22.0,1999.0,15.0,23,7,5,16,2,7,25,28.0,18,24,1,23,16,39,19,2,MF,20-24,Midfielder,United States,North America
16,Sargis Adamyan,ARM,Hoffenheim,Bundesliga,2021,28.0,1993.0,3.7,8,6,3,4,1,3,11,27.3,8,4,0,4,1,9,2,0,"FW,MF",25-29,Forward,Armenia,Asia
17,Martin Adeline,FRA,Reims,Ligue 1,2021,17.0,2003.0,3.9,15,11,5,8,2,8,16,50.0,8,0,0,0,11,26,6,0,"MF,FW",Under 20,Midfielder,France,Europe
18,Amine Adli,MAR,Leverkusen,Bundesliga,2021,21.0,2000.0,14.0,27,14,10,14,3,8,15,53.3,7,26,2,24,11,38,12,0,"FW,MF",20-24,Forward,Morocco,Africa
19,Yacine Adli,FRA,Bordeaux,Ligue 1,2021,21.0,2000.0,25.1,43,27,22,14,7,19,68,27.9,49,33,3,30,37,80,11,2,"MF,FW",20-24,Midfielder,France,Europe
20,Michel Aebischer,SUI,Bologna,Serie A,2021,24.0,1997.0,4.9,14,5,5,8,1,6,11,54.5,5,4,1,3,6,20,3,0,MF,20-24,Midfielder,Switzerland,Europe
21,Felix Afena-Gyan,GHA,Roma,Serie A,2021,18.0,2003.0,7.4,10,3,1,6,3,4,7,57.1,3,4,0,4,3,13,0,0,"FW,MF",Under 20,Forward,Ghana,Africa
24,Lucien Agoume,FRA,Brest,Ligue 1,2021,19.0,2002.0,20.8,51,31,24,20,7,23,45,51.1,22,30,9,21,52,103,27,1,MF,Under 20,Midfielder,France,Europe
25,Kevin Agudelo,COL,Spezia,Serie A,2021,22.0,1998.0,13.7,44,26,13,26,5,7,20,35.0,13,22,0,22,8,52,6,0,"MF,FW",20-24,Midfielder,Colombia,South America
26,Nayef Aguerd,MAR,Rennes,Ligue 1,2021,25.0,1996.0,30.4,27,18,16,11,0,14,24,58.3,10,24,14,10,24,51,127,1,DF,25-29,Defender,Morocco,Africa
27,Sergio Agüero,ARG,Barcelona,La Liga,2021,33.0,1988.0,1.7,1,1,0,0,1,0,2,0.0,2,0,0,0,0,1,0,0,FW,30-34,Forward,Argentina,South America
28,Ruben Aguilar,FRA,Monaco,Ligue 1,2021,28.0,1993.0,23.8,78,53,39,32,7,43,68,63.2,25,19,4,15,44,122,57,0,DF,25-29,Defender,France,Europe
30,Naouirou Ahamada,FRA,Stuttgart,Bundesliga,2021,19.0,2002.0,0.7,1,0,1,0,0,1,3,33.3,2,0,0,0,0,1,0,0,"MF,DF",Under 20,Midfielder,France,Europe
31,Anel Ahmedhodžić,BIH,Bordeaux,Ligue 1,2021,22.0,1999.0,15.0,38,26,27,9,2,20,31,64.5,11,16,8,8,22,60,44,0,DF,20-24,Defender,Bosnia and Herzegovina,Europe
32,Jean-Eudes Aholou,CIV,Strasbourg,Ligue 1,2021,27.0,1994.0,11.2,16,9,4,9,3,5,19,26.3,14,8,1,7,19,35,7,0,MF,25-29,Midfielder,Ivory Coast,Africa
33,Joseph Aidoo,GHA,Celta Vigo,La Liga,2021,25.0,1995.0,29.3,39,26,28,10,1,17,31,54.8,14,23,13,10,38,77,96,3,DF,25-29,Defender,Ghana,Africa
34,Ola Aina,NGA,Torino,Serie A,2021,24.0,1996.0,16.0,27,19,11,10,6,15,23,65.2,8,17,3,14,28,55,30,0,DF,20-24,Defender,Nigeria,Africa
35,Rayan Aït-Nouri,ALG,Wolves,Premier League,2021,20.0,2001.0,20.3,64,36,46,15,3,22,44,50.0,22,24,2,22,22,86,39,1,"DF,MF",20-24,Defender,Algeria,Africa
37,Ludovic Ajorque,FRA,Strasbourg,Ligue 1,2021,27.0,1994.0,30.4,36,25,5,19,12,7,40,17.5,33,28,3,25,8,44,31,1,FW,25-29,Forward,France,Europe
38,Manuel Akanji,SUI,Dortmund,Bundesliga,2021,26.0,1995.0,25.1,33,23,20,11,2,22,32,68.8,10,26,15,11,35,68,58,0,DF,25-29,Defender,Switzerland,Europe
39,Carlos Akapo,EQG,Cádiz,La Liga,2021,28.0,1993.0,20.5,43,31,26,15,2,21,37,56.8,16,26,7,19,51,94,61,0,DF,25-29,Defender,Equatorial Guinea,Africa
40,Marley Aké,FRA,Juventus,Serie A,2021,20.0,2001.0,0.9,0,0,0,0,0,0,2,0.0,2,0,0,0,1,1,0,0,"FW,MF",20-24,Forward,France,Europe
41,Nathan Aké,NED,Manchester City,Premier League,2021,26.0,1995.0,10.3,16,9,7,8,1,6,8,75.0,2,7,5,2,8,24,23,0,DF,25-29,Defender,Netherlands,Europe
42,Ilias Akhomach,MAR,Barcelona,La Liga,2021,17.0,2004.0,1.4,2,0,0,1,1,0,0,,0,0,0,0,0,2,0,0,FW,Under 20,Forward,Morocco,Africa
43,Maghnes Akliouche,FRA,Monaco,Ligue 1,2021,19.0,2002.0,0.6,2,0,0,2,0,0,1,0.0,1,2,0,2,0,2,0,0,"MF,FW",Under 20,Midfielder,France,Europe
44,Paul Akouokou,CIV,Betis,La Liga,2021,23.0,1997.0,5.7,14,9,5,7,2,8,12,66.7,4,6,0,6,11,25,6,0,MF,20-24,Midfielder,Ivory Coast,Africa
45,Jean-Daniel Akpa-Akpro,CIV,Lazio,Serie A,2021,28.0,1992.0,3.5,17,10,7,9,1,7,12,58.3,5,4,2,2,2,19,6,0,MF,25-29,Midfielder,Ivory Coast,Africa
46,Kevin Akpoguma,NGA,Hoffenheim,Bundesliga,2021,26.0,1995.0,17.0,33,19,16,11,6,16,28,57.1,12,32,2,30,20,53,29,2,"DF,FW",25-29,Defender,Nigeria,Africa
47,David Alaba,AUT,Real Madrid,La Liga,2021,29.0,1992.0,29.4,23,13,15,6,2,9,19,47.4,10,26,15,11,22,45,70,1,DF,25-29,Defender,Austria,Europe
48,Sofiane Alakouch,MAR,Metz,Ligue 1,2021,23.0,1998.0,1.8,7,4,3,4,0,2,5,40.0,3,4,0,4,1,8,4,0,"DF,MF",20-24,Defender,Morocco,Africa
49,Tomás Alarcón,CHI,Cádiz,La Liga,2021,22.0,1999.0,15.8,31,20,17,10,4,10,31,32.3,21,19,7,12,30,61,31,0,MF,20-24,Midfielder,Chile,South America
50,Lucas Alario,ARG,Leverkusen,Bundesliga,2021,28.0,1992.0,7.3,6,5,0,2,4,2,5,40.0,3,5,0,5,1,7,6,0,FW,25-29,Forward,Argentina,South America
55,Marc Albrighton,ENG,Leicester City,Premier League,2021,31.0,1989.0,12.6,31,19,16,9,6,10,47,21.3,37,15,3,12,14,45,20,0,"FW,DF",30-34,Forward,England,Europe
59,Omar Alderete,PAR,Valencia,La Liga,2021,24.0,1996.0,26.7,53,34,34,17,2,34,53,64.2,19,30,18,12,35,88,153,0,DF,20-24,Defender,Paraguay,South America
61,Doğan Alemdar,TUR,Rennes,Ligue 1,2021,18.0,2002.0,12.0,0,0,0,0,0,0,0,,0,0,0,0,0,0,9,1,GK,Under 20,Goalkeeper,Turkey,Asia
63,Trent Alexander-Arnold,ENG,Liverpool,Premier League,2021,22.0,1998.0,31.7,40,23,19,13,8,27,60,45.0,33,22,4,18,43,83,40,0,DF,20-24,Defender,England,Europe
64,Mohamed Ali Cho,FRA,Angers,Ligue 1,2021,17.0,2004.0,20.4,10,5,1,4,5,5,17,29.4,12,17,1,16,8,18,0,1,FW,Under 20,Forward,France,Europe
65,Alisson,BRA,Liverpool,Premier League,2021,28.0,1992.0,36.0,3,1,3,0,0,3,5,60.0,2,1,0,1,0,3,28,1,GK,25-29,Goalkeeper,Brazil,South America
65,Alisson,BRA,Liverpool,Premier League,2021,28.0,1992.0,36.0,3,1,3,0,0,3,5,60.0,2,1,0,1,0,3,28,1,GK,25-29,Goalkeeper,Brazil,South America
65,Alisson,BRA,Liverpool,Premier League,2021,28.0,1992.0,36.0,3,1,3,0,0,3,5,60.0,2,1,0,1,0,3,28,1,GK,25-29,Goalkeeper,Brazil,South America
65,Alisson,BRA,Liverpool,Premier League,2021,28.0,1992.0,36.0,3,1,3,0,0,3,5,60.0,2,1,0,1,0,3,28,1,GK,25-29,Goalkeeper,Brazil,South America
66,Allan,BRA,Everton,Premier League,2021,30.0,1991.0,24.3,74,44,28,39,7,34,105,32.4,71,40,9,31,23,97,39,1,MF,30-34,Midfielder,Brazil,South America
66,Allan,BRA,Everton,Premier League,2021,30.0,1991.0,24.3,74,44,28,39,7,34,105,32.4,71,40,9,31,23,97,39,1,MF,30-34,Midfielder,Brazil,South America
66,Allan,BRA,Everton,Premier League,2021,30.0,1991.0,24.3,74,44,28,39,7,34,105,32.4,71,40,9,31,23,97,39,1,MF,30-34,Midfielder,Brazil,South America
66,Allan,BRA,Everton,Premier League,2021,30.0,1991.0,24.3,74,44,28,39,7,34,105,32.4,71,40,9,31,23,97,39,1,MF,30-34,Midfielder,Brazil,South America
67,Jim Allevinah,GAB,Clermont Foot,Ligue 1,2021,26.0,1995.0,16.5,18,13,8,8,2,5,18,27.8,13,11,0,11,6,24,4,0,FW,25-29,Forward,Gabon,Africa
68,Dele Alli,ENG,Tottenham,Premier League,2021,25.0,1996.0,7.3,14,8,10,3,1,5,17,29.4,12,22,5,17,6,20,16,0,MF,25-29,Midfielder,England,Europe
69,Dele Alli,ENG,Everton,Premier League,2021,25.0,1996.0,3.8,7,2,3,4,0,0,4,0.0,4,7,2,5,6,13,10,0,"MF,FW",25-29,Midfielder,England,Europe
70,Miguel Almirón,PAR,Newcastle Utd,Premier League,2021,27.0,1994.0,19.1,47,29,23,17,7,11,44,25.0,33,14,1,13,20,67,13,0,"MF,FW",25-29,Midfielder,Paraguay,South America
72,Giorgio Altare,ITA,Cagliari,Serie A,2021,22.0,1998.0,16.3,39,28,18,18,3,21,26,80.8,5,17,5,12,30,69,70,0,DF,20-24,Defender,Italy,Europe
75,Dani Alves,BRA,Barcelona,La Liga,2021,38.0,1983.0,12.2,30,19,13,13,4,14,26,53.8,12,10,3,7,11,41,10,2,DF,35-39,Defender,Brazil,South America
76,Steven Alzate,COL,Brighton,Premier League,2021,22.0,1998.0,4.5,10,4,4,5,1,4,7,57.1,3,2,1,1,10,20,10,0,MF,20-24,Midfielder,Colombia,South America
77,Ibrahim Amadou,FRA,Metz,Ligue 1,2021,28.0,1993.0,9.0,16,8,10,6,0,8,15,53.3,7,4,2,2,14,30,26,0,"DF,MF",25-29,Defender,France,Europe
78,Emmanuel Amankwaa Akurugu,GHA,Getafe,La Liga,2021,19.0,2001.0,0.9,0,0,0,0,0,0,2,0.0,2,1,0,1,0,0,0,0,DF,Under 20,Defender,Ghana,Africa
79,Daniel Amartey,GHA,Leicester City,Premier League,2021,26.0,1994.0,23.6,26,13,19,7,0,19,29,65.5,10,30,22,8,21,47,93,4,DF,25-29,Defender,Ghana,Africa
80,Amath,SEN,Mallorca,La Liga,2021,25.0,1996.0,9.8,21,11,11,6,4,7,17,41.2,10,12,0,12,7,28,7,0,"FW,MF",25-29,Forward,Senegal,Africa
81,Jordan Amavi,FRA,Nice,Ligue 1,2021,27.0,1994.0,4.6,16,10,8,7,1,10,17,58.8,7,3,1,2,15,31,7,0,DF,25-29,Defender,France,Europe
82,Jordan Amavi,FRA,Marseille,Ligue 1,2021,27.0,1994.0,1.4,6,5,3,1,2,5,10,50.0,5,1,0,1,1,7,3,0,"DF,FW",25-29,Defender,France,Europe
83,Wisdom Amey,ITA,Bologna,Serie A,2021,15.0,2005.0,0.8,3,2,1,1,1,2,3,66.7,1,2,0,2,3,6,1,0,DF,Under 20,Defender,Italy,Europe
84,Kelvin Amian,FRA,Spezia,Serie A,2021,23.0,1998.0,29.4,66,42,43,18,5,30,41,73.2,11,39,21,18,32,98,75,0,DF,20-24,Defender,France,Europe
85,Nadiem Amiri,GER,Genoa,Serie A,2021,24.0,1996.0,7.6,6,4,2,2,2,2,9,22.2,7,7,0,7,0,6,0,0,"MF,FW",20-24,Midfielder,Germany,Europe
86,Nadiem Amiri,GER,Leverkusen,Bundesliga,2021,24.0,1996.0,4.1,8,4,3,2,3,4,8,50.0,4,4,2,2,5,13,0,0,"MF,FW",20-24,Midfielder,Germany,Europe
87,Ethan Ampadu,WAL,Venezia,Serie A,2021,20.0,2000.0,25.4,67,43,37,27,3,24,58,41.4,34,49,19,30,51,118,76,0,"MF,DF",20-24,Midfielder,Wales,Europe
88,Sofyan Amrabat,MAR,Fiorentina,Serie A,2021,24.0,1996.0,10.5,24,13,9,13,2,11,19,57.9,8,25,8,17,5,29,6,1,MF,20-24,Midfielder,Morocco,Africa
89,Joachim Andersen,DEN,Crystal Palace,Premier League,2021,25.0,1996.0,32.4,30,23,21,9,0,16,27,59.3,11,29,19,10,37,67,125,3,DF,25-29,Defender,Denmark,Europe
90,Felipe Anderson,BRA,Lazio,Serie A,2021,28.0,1993.0,32.1,71,45,30,33,8,27,99,27.3,72,65,6,59,20,91,16,0,FW,25-29,Forward,Brazil,South America
91,Sebastian Andersson,SWE,Köln,Bundesliga,2021,30.0,1991.0,14.0,11,7,0,3,8,3,9,33.3,6,8,0,8,3,14,14,0,FW,30-34,Forward,Sweden,Europe
92,Florin Andone,ROU,Cádiz,La Liga,2021,28.0,1993.0,2.0,1,1,1,0,0,0,1,0.0,1,2,0,2,0,1,1,0,FW,25-29,Forward,Romania,Europe
93,Andrés Andrade Cedeño,PAN,Arminia,Bundesliga,2021,22.0,1998.0,11.6,27,16,18,8,1,17,35,48.6,18,16,7,9,19,46,44,0,DF,20-24,Defender,Panama,North America
94,Benjamin André,FRA,Lille,Ligue 1,2021,30.0,1990.0,30.6,123,69,49,65,9,51,113,45.1,62,49,11,38,50,173,56,0,MF,30-34,Midfielder,France,Europe
96,Marcos André,BRA,Valencia,La Liga,2021,24.0,1996.0,10.8,15,11,4,6,5,5,16,31.3,11,15,0,15,7,22,13,0,"FW,MF",20-24,Forward,Brazil,South America
96,Marcos André,BRA,Valencia,La Liga,2021,24.0,1996.0,10.8,15,11,4,6,5,5,16,31.3,11,15,0,15,7,22,13,0,"FW,MF",20-24,Forward,Brazil,South America
96,Marcos André,BRA,Valencia,La Liga,2021,24.0,1996.0,10.8,15,11,4,6,5,5,16,31.3,11,15,0,15,7,22,13,0,"FW,MF",20-24,Forward,Brazil,South America
96,Marcos André,BRA,Valencia,La Liga,2021,24.0,1996.0,10.8,15,11,4,6,5,5,16,31.3,11,15,0,15,7,22,13,0,"FW,MF",20-24,Forward,Brazil,South America
97,Robert Andrich,GER,Leverkusen,Bundesliga,2021,26.0,1994.0,20.2,33,17,18,14,1,14,28,50.0,14,19,7,12,31,64,46,0,MF,25-29,Midfielder,Germany,Europe
100,Ebenezer Annan,GHA,Bologna,Serie A,2021,18.0,2002.0,0.3,1,1,1,0,0,0,0,,0,0,0,0,1,2,1,0,DF,Under 20,Defender,Ghana,Africa
101,Cristian Ansaldi,ARG,Torino,Serie A,2021,34.0,1986.0,7.7,20,9,11,7,2,10,13,76.9,3,9,1,8,6,26,10,0,DF,30-34,Defender,Argentina,South America
102,Janis Antiste,FRA,Spezia,Serie A,2021,18.0,2002.0,8.8,18,11,6,6,6,5,13,38.5,8,7,1,6,4,22,6,0,FW,Under 20,Forward,France,Europe
103,Waldemar Anton,GER,Stuttgart,Bundesliga,2021,25.0,1996.0,28.8,40,26,22,15,3,19,32,59.4,13,27,16,11,32,72,116,1,DF,25-29,Defender,Germany,Europe
105,Michail Antonio,JAM,West Ham,Premier League,2021,31.0,1990.0,33.0,23,17,5,9,9,7,18,38.9,11,19,1,18,3,26,13,0,FW,30-34,Forward,Jamaica,North America
106,Christopher Antwi-Adjei,GHA,Bochum,Bundesliga,2021,27.0,1994.0,12.6,21,18,7,8,6,6,26,23.1,20,12,0,12,1,22,8,0,"FW,MF",25-29,Forward,Ghana,Africa
107,Houssem Aouar,ALG,Lyon,Ligue 1,2021,23.0,1998.0,27.8,46,30,9,25,12,27,54,50.0,27,26,1,25,20,66,5,0,"MF,FW",20-24,Midfielder,Algeria,Africa
108,Adil Aouchiche,FRA,Saint-Étienne,Ligue 1,2021,19.0,2002.0,12.0,13,6,5,5,3,5,33,15.2,28,18,1,17,17,30,4,0,"MF,FW",Under 20,Midfielder,France,Europe
109,Dennis Appiah,FRA,Nantes,Ligue 1,2021,29.0,1992.0,23.3,55,34,35,18,2,28,48,58.3,20,30,13,17,27,82,74,0,DF,25-29,Defender,France,Europe
110,Mauro Arambarri,URU,Getafe,La Liga,2021,25.0,1995.0,29.6,62,37,19,32,11,20,68,29.4,48,35,5,30,32,94,18,0,MF,25-29,Midfielder,Uruguay,South America
111,Mattia Aramu,ITA,Venezia,Serie A,2021,26.0,1995.0,23.3,20,15,5,9,6,8,33,24.2,25,20,2,18,8,28,19,0,"MF,FW",25-29,Midfielder,Italy,Europe
112,Charles Aránguiz,CHI,Leverkusen,Bundesliga,2021,32.0,1989.0,17.5,45,25,18,21,6,22,52,42.3,30,24,4,20,33,78,21,0,MF,30-34,Midfielder,Chile,South America
113,Néstor Araujo,MEX,Celta Vigo,La Liga,2021,29.0,1991.0,29.1,22,14,17,5,0,9,21,42.9,12,17,10,7,27,49,105,2,DF,25-29,Defender,Mexico,North America
114,Ronald Araújo,URU,Barcelona,La Liga,2021,22.0,1999.0,25.2,41,23,29,12,0,21,25,84.0,4,37,20,17,23,64,66,1,DF,20-24,Defender,Uruguay,South America
115,Cameron Archer,ENG,Aston Villa,Premier League,2021,20.0,2001.0,0.3,0,0,0,0,0,0,0,,0,0,0,0,0,0,0,0,"FW,MF",20-24,Forward,England,Europe
116,Alphonse Areola,FRA,West Ham,Premier League,2021,28.0,1993.0,1.0,0,0,0,0,0,0,0,,0,0,0,0,0,0,1,0,GK,25-29,Goalkeeper,France,Europe
118,Matias Arezo,URU,Granada,La Liga,2021,18.0,2002.0,1.8,5,3,2,1,2,4,9,44.4,5,1,0,1,1,6,1,0,"FW,MF",Under 20,Forward,Uruguay,South America
119,Santiago Arias,COL,Granada,La Liga,2021,29.0,1992.0,4.9,12,5,8,3,1,4,9,44.4,5,8,4,4,5,17,10,0,DF,25-29,Defender,Colombia,South America
120,Adam Armstrong,ENG,Southampton,Premier League,2021,24.0,1997.0,15.7,10,4,2,2,6,0,6,0.0,6,13,1,12,3,13,6,0,FW,20-24,Forward,England,Europe
121,Stuart Armstrong,SCO,Southampton,Premier League,2021,29.0,1992.0,16.4,27,19,15,6,6,9,23,39.1,14,10,1,9,8,35,15,0,MF,25-29,Midfielder,Scotland,Europe
122,Marko Arnautović,AUT,Bologna,Serie A,2021,32.0,1989.0,29.9,17,9,1,11,5,7,30,23.3,23,13,2,11,7,24,17,0,FW,30-34,Forward,Austria,Europe
123,Maximilian Arnold,GER,Wolfsburg,Bundesliga,2021,27.0,1994.0,33.3,37,20,19,16,2,20,50,40.0,30,43,15,28,37,74,55,0,MF,25-29,Midfielder,Germany,Europe
125,Tolgay Arslan,GER,Udinese,Serie A,2021,30.0,1990.0,18.4,35,20,15,16,4,19,50,38.0,31,17,4,13,13,48,23,1,MF,30-34,Midfielder,Germany,Europe
126,Santiago Arzamendia,PAR,Cádiz,La Liga,2021,23.0,1998.0,5.2,14,6,6,5,3,6,13,46.2,7,6,0,6,4,18,7,0,MF,20-24,Midfielder,Paraguay,South America
127,Takuma Asano,JPN,Bochum,Bundesliga,2021,26.0,1994.0,17.9,11,6,3,6,2,5,19,26.3,14,14,1,13,7,18,7,0,"FW,MF",25-29,Forward,Japan,Asia
128,Santiago Ascacíbar,ARG,Hertha BSC,Bundesliga,2021,24.0,1997.0,26.4,93,54,50,37,6,38,89,42.7,51,31,6,25,41,134,42,0,MF,20-24,Midfielder,Argentina,South America
132,Harrison Ashby,SCO,West Ham,Premier League,2021,19.0,2001.0,0.1,0,0,0,0,0,0,0,,0,1,0,1,1,1,1,0,DF,Under 20,Defender,Scotland,Europe
135,Kristjan Asllani,ALB,Empoli,Serie A,2021,19.0,2002.0,15.0,18,9,9,8,1,11,29,37.9,18,16,7,9,19,37,15,1,MF,Under 20,Midfielder,Albania,Europe
138,Simon Asta,GER,Greuther Fürth,Bundesliga,2021,20.0,2001.0,8.7,13,6,4,5,4,4,8,50.0,4,14,2,12,8,21,16,0,DF,20-24,Defender,Germany,Europe
139,Youcef Atal,ALG,Nice,Ligue 1,2021,25.0,1996.0,12.7,29,19,17,10,2,14,25,56.0,11,13,2,11,32,61,21,0,DF,25-29,Defender,Algeria,Africa
140,Pierre-Emerick Aubameyang,GAB,Arsenal,Premier League,2021,32.0,1989.0,11.5,11,5,6,4,1,3,10,30.0,7,12,1,11,0,11,4,0,FW,30-34,Forward,Gabon,Africa
141,Pierre-Emerick Aubameyang,GAB,Barcelona,La Liga,2021,32.0,1989.0,12.0,2,2,0,1,1,0,5,0.0,5,9,1,8,2,4,4,0,FW,30-34,Forward,Gabon,Africa
142,Emil Audero,ITA,Sampdoria,Serie A,2021,24.0,1997.0,28.4,3,1,3,0,0,3,5,60.0,2,0,0,0,2,5,17,2,GK,20-24,Goalkeeper,Italy,Europe
143,Tommaso Augello,ITA,Sampdoria,Serie A,2021,26.0,1994.0,26.6,36,20,22,8,6,17,29,58.6,12,19,4,15,29,65,68,1,DF,25-29,Defender,Italy,Europe
144,Jean-Kévin Augustin,FRA,Nantes,Ligue 1,2021,24.0,1997.0,0.9,1,0,0,0,1,0,3,0.0,3,1,0,1,0,1,0,0,"FW,MF",20-24,Forward,France,Europe
145,Ludwig Augustinsson,SWE,Sevilla,La Liga,2021,27.0,1994.0,8.8,18,14,11,3,4,8,13,61.5,5,10,3,7,5,23,21,0,"DF,FW",25-29,Defender,Sweden,Europe
146,Serge Aurier,CIV,Villarreal,La Liga,2021,28.0,1992.0,11.2,14,9,11,2,1,4,7,57.1,3,14,7,7,11,25,25,0,DF,25-29,Defender,Ivory Coast,Africa
147,Ezequiel Ávila,ARG,Osasuna,La Liga,2021,27.0,1994.0,20.8,17,7,6,7,4,7,21,33.3,14,14,2,12,13,30,15,1,"FW,MF",25-29,Forward,Argentina,South America
148,Taiwo Awoniyi,NGA,Union Berlin,Bundesliga,2021,23.0,1997.0,24.2,11,7,3,6,2,1,9,11.1,8,11,2,9,2,13,29,0,FW,20-24,Forward,Nigeria,Africa
149,Ramzi Aya,ITA,Salernitana,Serie A,2021,30.0,1990.0,1.5,1,1,1,0,0,1,1,100.0,0,0,0,0,0,1,4,0,DF,30-34,Defender,Italy,Europe
150,Jordan Ayew,GHA,Crystal Palace,Premier League,2021,29.0,1991.0,22.4,47,30,20,20,7,17,31,54.8,14,33,3,30,15,62,15,0,FW,25-29,Forward,Ghana,Africa
151,Kaan Ayhan,TUR,Sassuolo,Serie A,2021,26.0,1994.0,15.0,20,12,14,6,0,7,15,46.7,8,20,14,6,13,33,57,0,DF,25-29,Defender,Turkey,Asia
152,Luke Ayling,ENG,Leeds United,Premier League,2021,29.0,1991.0,25.2,74,42,46,23,5,51,97,52.6,46,46,25,21,28,102,52,1,DF,25-29,Defender,England,Europe
153,Karim Azamoum,FRA,Troyes,Ligue 1,2021,31.0,1990.0,4.3,6,5,4,2,0,3,5,60.0,2,4,2,2,1,7,10,0,DF,30-34,Defender,France,Europe
154,Sardar Azmoun,IRN,Leverkusen,Bundesliga,2021,26.0,1995.0,4.0,3,1,0,2,1,0,5,0.0,5,2,0,2,0,3,8,0,"FW,MF",25-29,Forward,Iran,Asia
156,Iddrisu Baba,GHA,Mallorca,La Liga,2021,25.0,1996.0,21.5,57,30,31,23,3,25,43,58.1,18,19,5,14,24,81,34,1,MF,25-29,Midfielder,Ghana,Africa
157,Carlos Bacca,COL,Granada,La Liga,2021,34.0,1986.0,5.7,4,4,2,0,2,0,3,0.0,3,5,0,5,1,5,5,0,FW,30-34,Forward,Colombia,South America
158,Daniel Bachmann,AUT,Watford,Premier League,2021,27.0,1994.0,12.0,0,0,0,0,0,0,0,,0,0,0,0,1,1,5,0,GK,25-29,Goalkeeper,Austria,Europe
159,Loïc Bade,FRA,Rennes,Ligue 1,2021,21.0,2000.0,10.9,6,5,4,2,0,3,5,60.0,2,12,10,2,12,18,48,0,DF,20-24,Defender,France,Europe
160,Milan Badelj,CRO,Genoa,Serie A,2021,32.0,1989.0,31.6,64,37,25,30,9,34,80,42.5,46,39,7,32,85,149,43,0,MF,30-34,Midfielder,Croatia,Europe
162,Benoît Badiashile,FRA,Monaco,Ligue 1,2021,20.0,2001.0,20.4,36,19,21,15,0,14,23,60.9,9,18,12,6,28,64,68,1,DF,20-24,Defender,France,Europe
163,Youssouph Badji,SEN,Brest,Ligue 1,2021,19.0,2001.0,1.5,1,0,0,1,0,0,1,0.0,1,0,0,0,0,1,0,0,"FW,MF",Under 20,Forward,Senegal,Africa
165,Nicola Bagnolini,ITA,Bologna,Serie A,2021,17.0,2004.0,0.0,0,0,0,0,0,0,0,,0,0,0,0,0,0,0,0,GK,Under 20,Goalkeeper,Italy,Europe
166,Issa Bah,LUX,Venezia,Serie A,2021,19.0,2002.0,0.1,0,0,0,0,0,0,0,,0,0,0,0,0,0,0,0,FW,Under 20,Forward,Luxembourg,Europe
167,Stéphane Bahoken,CMR,Angers,Ligue 1,2021,29.0,1992.0,12.2,13,8,2,7,4,1,9,11.1,8,15,0,15,3,16,3,0,FW,25-29,Forward,Cameroon,Africa
168,Leon Bailey,JAM,Aston Villa,Premier League,2021,23.0,1997.0,8.5,17,11,6,8,3,6,13,46.2,7,10,1,9,1,18,2,0,"FW,MF",20-24,Forward,Jamaica,North America
169,Eric Bailly,CIV,Manchester Utd,Premier League,2021,27.0,1994.0,2.4,5,4,4,0,1,3,4,75.0,1,4,2,2,3,8,11,0,DF,25-29,Defender,Ivory Coast,Africa
170,Dénys Bain,FRA,Brest,Ligue 1,2021,28.0,1993.0,2.0,3,3,1,2,0,1,1,100.0,0,3,1,2,3,6,5,0,DF,25-29,Defender,France,Europe
171,Stefan Bajic,FRA,Saint-Étienne,Ligue 1,2021,19.0,2001.0,5.7,0,0,0,0,0,0,0,,0,0,0,0,0,0,4,0,GK,Under 20,Goalkeeper,France,Europe
172,Nedim Bajrami,ALB,Empoli,Serie A,2021,22.0,1999.0,22.8,21,14,5,13,3,4,14,28.6,10,11,0,11,3,24,8,0,"MF,FW",20-24,Midfielder,Albania,Europe
173,Cédric Bakambu,COD,Marseille,Ligue 1,2021,30.0,1991.0,4.0,2,0,1,0,1,0,3,0.0,3,2,0,2,0,2,1,0,FW,30-34,Forward,DR Congo,Africa
174,Abdoulaye Bakayoko,FRA,Saint-Étienne,Ligue 1,2021,18.0,2002.0,3.4,15,9,13,2,0,8,12,66.7,4,5,4,1,12,27,15,0,DF,Under 20,Defender,France,Europe
175,Tiemoué Bakayoko,FRA,Milan,Serie A,2021,26.0,1994.0,5.6,19,13,9,7,3,5,16,31.3,11,8,1,7,9,28,10,2,MF,25-29,Midfielder,France,Europe
176,Mitchel Bakker,NED,Leverkusen,Bundesliga,2021,21.0,2000.0,20.2,33,22,16,12,5,20,34,58.8,14,13,2,11,23,56,42,3,DF,20-24,Defender,Netherlands,Europe
177,Ridle Baku,GER,Wolfsburg,Bundesliga,2021,23.0,1998.0,27.2,62,37,30,24,8,25,65,38.5,40,43,1,42,21,83,52,1,"DF,FW",20-24,Defender,Germany,Europe
178,Dilane Bakwa,FRA,Bordeaux,Ligue 1,2021,18.0,2002.0,0.5,1,1,0,1,0,1,2,50.0,1,0,0,0,0,1,1,0,"FW,MF",Under 20,Forward,France,Europe
179,Tommaso Baldanzi,ITA,Empoli,Serie A,2021,18.0,2003.0,0.2,0,0,0,0,0,0,0,,0,1,0,1,0,0,0,0,FW,Under 20,Forward,Italy,Europe
181,Ibrahima Baldé,FRA,Lens,Ligue 1,2021,18.0,2003.0,0.6,0,0,0,0,0,0,0,,0,0,0,0,0,0,0,0,"FW,MF",Under 20,Forward,France,Europe
182,Keita Baldé,SEN,Cagliari,Serie A,2021,26.0,1995.0,13.7,8,4,1,5,2,1,10,10.0,9,6,0,6,4,12,6,0,FW,25-29,Forward,Senegal,Africa
183,Gareth Bale,WAL,Real Madrid,La Liga,2021,32.0,1989.0,3.1,2,1,1,0,1,1,4,25.0,3,2,0,2,2,4,1,0,FW,30-34,Forward,Wales,Europe
185,Leonardo Balerdi,ARG,Marseille,Ligue 1,2021,22.0,1999.0,10.6,9,6,9,0,0,5,14,35.7,9,11,4,7,19,28,30,0,DF,20-24,Defender,Argentina,South America
186,Iván Balliu,ALB,Rayo Vallecano,La Liga,2021,29.0,1992.0,35.0,45,22,25,11,9,19,31,61.3,12,24,5,19,39,84,64,0,DF,25-29,Defender,Albania,Europe
187,Fodé Ballo-Touré,SEN,Milan,Serie A,2021,24.0,1997.0,5.0,18,14,5,13,0,4,9,44.4,5,6,2,4,3,21,5,0,DF,20-24,Defender,Senegal,Africa
188,Folarin Balogun,USA,Arsenal,Premier League,2021,20.0,2001.0,0.8,1,1,0,0,1,0,0,,0,1,0,1,0,1,1,0,FW,20-24,Forward,United States,North America
189,Abdoulaye Bamba,CIV,Angers,Ligue 1,2021,31.0,1990.0,5.1,6,5,6,0,0,4,11,36.4,7,5,1,4,9,15,13,0,"DF,FW",30-34,Defender,Ivory Coast,Africa
190,Jonathan Bamba,CIV,Lille,Ligue 1,2021,25.0,1996.0,27.0,30,12,13,9,8,13,36,36.1,23,24,1,23,21,51,10,0,"MF,FW",25-29,Midfielder,Ivory Coast,Africa
191,Patrick Bamford,ENG,Leeds United,Premier League,2021,27.0,1993.0,6.2,1,0,0,1,0,0,3,0.0,3,8,2,6,2,3,8,0,FW,25-29,Forward,England,Europe
192,Filippo Bandinelli,ITA,Empoli,Serie A,2021,26.0,1995.0,21.7,33,20,10,17,6,15,31,48.4,16,22,5,17,10,43,37,2,MF,25-29,Midfielder,Italy,Europe
193,Mattia Bani,ITA,Genoa,Serie A,2021,27.0,1993.0,13.5,23,13,17,6,0,14,18,77.8,4,19,11,8,20,43,76,0,DF,25-29,Defender,Italy,Europe
194,Simon Banza,COD,Lens,Ligue 1,2021,24.0,1996.0,1.4,2,1,0,0,2,0,2,0.0,2,1,0,1,1,3,2,0,FW,20-24,Forward,DR Congo,Africa
195,Shandon Baptiste,GRN,Brentford,Premier League,2021,23.0,1998.0,10.1,14,4,9,4,1,6,15,40.0,9,10,0,10,11,25,12,0,MF,20-24,Midfielder,Grenada,North America
198,Danilo Barbosa,BRA,Nice,Ligue 1,2021,25.0,1996.0,1.0,0,0,0,0,0,0,0,,0,1,1,0,2,2,10,0,DF,25-29,Defender,Brazil,South America
200,Bradley Barcola,FRA,Lyon,Ligue 1,2021,18.0,2002.0,2.9,7,4,2,3,2,1,8,12.5,7,7,1,6,2,9,1,0,"FW,MF",Under 20,Forward,France,Europe
201,Melvin Bard,FRA,Nice,Ligue 1,2021,20.0,2000.0,28.8,59,37,38,17,4,41,63,65.1,22,33,10,23,51,110,56,0,DF,20-24,Defender,France,Europe
202,Enis Bardhi,MKD,Levante,La Liga,2021,26.0,1995.0,18.9,29,12,12,14,3,12,35,34.3,23,13,2,11,10,39,7,0,"MF,FW",25-29,Midfielder,North Macedonia,Europe
203,Francesco Bardi,ITA,Bologna,Serie A,2021,29.0,1992.0,2.0,0,0,0,0,0,0,0,,0,0,0,0,0,0,0,0,GK,25-29,Goalkeeper,Italy,Europe
204,Keidi Bare,ALB,Espanyol,La Liga,2021,23.0,1997.0,16.5,27,17,14,12,1,11,31,35.5,20,20,10,10,15,42,26,1,MF,20-24,Midfielder,Albania,Europe
205,Nicolò Barella,ITA,Inter,Serie A,2021,24.0,1997.0,32.4,63,42,17,35,11,29,55,52.7,26,26,2,24,21,84,8,2,MF,20-24,Midfielder,Italy,Europe
207,Ross Barkley,ENG,Chelsea,Premier League,2021,27.0,1993.0,2.0,0,0,0,0,0,0,1,0.0,1,1,0,1,1,1,0,0,"MF,FW",25-29,Midfielder,England,Europe
208,Aymen Barkok,MAR,Eint Frankfurt,Bundesliga,2021,23.0,1998.0,1.8,6,2,2,3,1,2,7,28.6,5,4,1,3,5,11,6,0,"MF,DF",20-24,Midfielder,Morocco,Africa
209,Ashley Barnes,ENG,Burnley,Premier League,2021,31.0,1989.0,9.0,11,2,2,7,2,2,9,22.2,7,8,1,7,2,13,5,0,FW,30-34,Forward,England,Europe
210,Harvey Barnes,ENG,Leicester City,Premier League,2021,23.0,1997.0,23.3,31,16,9,11,11,7,23,30.4,16,24,1,23,5,36,7,0,"FW,MF",20-24,Forward,England,Europe
212,Leandro Barreiro Martins,LUX,Mainz 05,Bundesliga,2021,21.0,2000.0,19.9,63,32,23,27,13,29,50,58.0,21,23,6,17,32,95,23,0,MF,20-24,Midfielder,Luxembourg,Europe
214,Jacob Barrett Laursen,DEN,Arminia,Bundesliga,2021,26.0,1994.0,18.1,16,12,10,6,0,8,21,38.1,13,19,7,12,28,44,43,0,DF,25-29,Defender,Denmark,Europe
215,Musa Barrow,GAM,Bologna,Serie A,2021,22.0,1998.0,23.7,12,4,4,4,4,6,20,30.0,14,20,1,19,6,18,8,0,"FW,MF",20-24,Forward,Gambia,Africa
216,Abdourahmane Barry,GUI,Greuther Fürth,Bundesliga,2021,21.0,2000.0,2.3,6,4,3,3,0,5,7,71.4,2,5,2,3,4,10,1,0,DF,20-24,Defender,Guinea,Africa
218,Daniele Baselli,ITA,Torino,Serie A,2021,29.0,1992.0,1.7,3,3,2,0,1,2,6,33.3,4,0,0,0,1,4,2,0,"MF,FW",25-29,Midfielder,Italy,Europe
219,Daniele Baselli,ITA,Cagliari,Serie A,2021,29.0,1992.0,3.2,6,5,3,1,2,1,5,20.0,4,2,0,2,2,8,5,0,MF,25-29,Midfielder,Italy,Europe
220,Toma Bašić,CRO,Lazio,Serie A,2021,24.0,1996.0,10.9,12,8,3,9,0,5,17,29.4,12,13,4,9,4,16,21,0,MF,20-24,Midfielder,Croatia,Europe
221,Toma Bašić,CRO,Bordeaux,Ligue 1,2021,24.0,1996.0,2.3,2,2,1,0,1,0,4,0.0,4,4,1,3,2,4,0,0,MF,20-24,Midfielder,Croatia,Europe
222,Amine Bassi,FRA,Metz,Ligue 1,2021,23.0,1997.0,2.0,6,3,2,3,1,1,3,33.3,2,5,0,5,0,6,0,0,"MF,FW",20-24,Midfielder,France,Europe
224,Alessandro Bastoni,ITA,Inter,Serie A,2021,22.0,1999.0,25.7,44,25,28,13,3,17,34,50.0,17,22,12,10,35,79,59,1,DF,20-24,Defender,Italy,Europe
225,Simone Bastoni,ITA,Spezia,Serie A,2021,24.0,1996.0,25.4,52,34,28,17,7,21,65,32.3,44,38,11,27,30,82,31,0,"MF,DF",20-24,Midfielder,Italy,Europe
226,Lewis Bate,ENG,Leeds United,Premier League,2021,18.0,2002.0,1.6,1,0,0,0,1,0,8,0.0,8,1,0,1,1,2,1,0,MF,Under 20,Midfielder,England,Europe
227,Rodrigo Battaglia,ARG,Mallorca,La Liga,2021,30.0,1991.0,13.1,32,16,13,19,0,15,30,50.0,15,21,10,11,10,42,36,0,MF,30-34,Midfielder,Argentina,South America
228,Maximilian Bauer,GER,Greuther Fürth,Bundesliga,2021,21.0,2000.0,18.8,28,15,17,10,1,11,28,39.3,17,24,14,10,29,57,99,0,DF,20-24,Defender,Germany,Europe
229,Oliver Baumann,GER,Hoffenheim,Bundesliga,2021,31.0,1990.0,33.0,0,0,0,0,0,0,3,0.0,3,0,0,0,0,0,19,1,GK,30-34,Goalkeeper,Germany,Europe
230,Timo Baumgartl,GER,Union Berlin,Bundesliga,2021,25.0,1996.0,24.1,59,28,34,21,4,31,47,66.0,16,27,11,16,37,96,58,0,DF,25-29,Defender,Germany,Europe
231,Julian Baumgartlinger,AUT,Leverkusen,Bundesliga,2021,33.0,1988.0,1.0,3,1,2,1,0,1,2,50.0,1,1,0,1,2,5,0,0,"MF,FW",30-34,Midfielder,Austria,Europe
232,Christoph Baumgartner,AUT,Hoffenheim,Bundesliga,2021,21.0,1999.0,21.0,28,15,14,7,7,13,32,40.6,19,24,3,21,8,36,16,0,"MF,FW",20-24,Midfielder,Austria,Europe
234,Paul Baysse,FRA,Bordeaux,Ligue 1,2021,33.0,1988.0,0.1,1,1,0,1,0,0,0,,0,0,0,0,0,1,1,0,"MF,DF",30-34,Midfielder,France,Europe
235,Noah Joel Sarenren Bazee,NGA,Augsburg,Bundesliga,2021,24.0,1996.0,2.7,5,2,2,2,1,3,4,75.0,1,8,2,6,1,6,4,0,"MF,FW",20-24,Midfielder,Nigeria,Africa
236,Bebé,CPV,Rayo Vallecano,La Liga,2021,31.0,1990.0,9.6,6,5,1,3,2,4,16,25.0,12,18,0,18,3,9,6,0,FW,30-34,Forward,Cape Verde,Africa
238,Rodrigo Becão,BRA,Udinese,Serie A,2021,25.0,1996.0,34.8,81,46,49,30,2,34,60,56.7,26,45,20,25,42,123,89,3,DF,25-29,Defender,Brazil,South America
239,Mads Bech Sørensen,DEN,Brentford,Premier League,2021,22.0,1999.0,9.3,8,7,6,2,0,6,7,85.7,1,9,6,3,6,14,25,0,DF,20-24,Defender,Denmark,Europe
240,Sheraldo Becker,SUR,Union Berlin,Bundesliga,2021,26.0,1995.0,19.5,9,6,3,4,2,6,18,33.3,12,11,0,11,2,11,4,0,"FW,MF",25-29,Forward,Suriname,South America
242,Donny van de Beek,NED,Manchester Utd,Premier League,2021,24.0,1997.0,0.8,6,4,4,1,1,1,2,50.0,1,5,1,4,2,8,1,0,MF,20-24,Midfielder,Netherlands,Europe
243,Donny van de Beek,NED,Everton,Premier League,2021,24.0,1997.0,5.4,15,7,8,6,1,6,13,46.2,7,6,2,4,6,21,4,0,MF,20-24,Midfielder,Netherlands,Europe
244,Asmir Begović,BIH,Everton,Premier League,2021,34.0,1987.0,3.0,0,0,0,0,0,0,0,,0,0,0,0,0,0,3,0,GK,30-34,Goalkeeper,Bosnia and Herzegovina,Europe
245,Valon Behrami,SUI,Genoa,Serie A,2021,36.0,1985.0,3.5,3,1,0,2,1,0,7,0.0,7,4,1,3,1,4,4,0,"MF,FW",35-39,Midfielder,Switzerland,Europe
246,Kevin Behrens,GER,Union Berlin,Bundesliga,2021,30.0,1991.0,5.5,3,2,1,1,1,0,4,0.0,4,3,0,3,3,6,7,0,FW,30-34,Forward,Germany,Europe
247,Youcef Belaïli,ALG,Brest,Ligue 1,2021,29.0,1992.0,9.2,2,1,0,0,2,2,9,22.2,7,5,1,4,7,9,4,0,"MF,FW",25-29,Midfielder,Algeria,Africa
249,Ishak Belfodil,ALG,Hertha BSC,Bundesliga,2021,29.0,1992.0,18.2,9,6,4,4,1,4,8,50.0,4,9,1,8,5,14,16,0,FW,25-29,Forward,Algeria,Africa
250,Haris Belkebla,ALG,Brest,Ligue 1,2021,27.0,1994.0,25.7,46,23,21,21,4,18,39,46.2,21,26,6,20,48,94,30,1,MF,25-29,Midfielder,Algeria,Africa
251,Stefan Bell,GER,Mainz 05,Bundesliga,2021,29.0,1991.0,31.8,54,23,37,16,1,30,63,47.6,33,26,15,11,41,95,112,1,DF,25-29,Defender,Germany,Europe
252,Armel Bella Kotchap,GER,Bochum,Bundesliga,2021,19.0,2001.0,19.6,34,20,25,9,0,18,28,64.3,10,21,16,5,42,76,84,2,DF,Under 20,Defender,Germany,Europe
253,Raoul Bellanova,ITA,Cagliari,Serie A,2021,21.0,2000.0,27.7,29,15,14,12,3,6,27,22.2,21,39,8,31,21,50,51,0,"DF,FW",20-24,Defender,Italy,Europe
254,Karim Bellarabi,GER,Leverkusen,Bundesliga,2021,31.0,1990.0,7.6,9,4,4,4,1,3,13,23.1,10,5,0,5,9,18,4,0,"FW,MF",30-34,Forward,Germany,Europe
255,Jean-Ricner Bellegarde,FRA,Strasbourg,Ligue 1,2021,23.0,1998.0,25.9,51,32,21,21,9,17,41,41.5,24,29,4,25,27,78,19,0,MF,20-24,Midfielder,France,Europe
257,Jude Bellingham,ENG,Dortmund,Bundesliga,2021,18.0,2003.0,31.0,52,34,15,31,6,21,53,39.6,32,50,4,46,42,94,32,0,MF,Under 20,Midfielder,England,Europe
258,George Bello,USA,Arminia,Bundesliga,2021,19.0,2002.0,4.8,7,7,7,0,0,4,4,100.0,0,5,4,1,6,13,11,0,DF,Under 20,Defender,United States,North America
259,Jeanuël Belocian,FRA,Rennes,Ligue 1,2021,16.0,2005.0,0.1,0,0,0,0,0,0,0,,0,0,0,0,0,0,0,0,DF,Under 20,Defender,France,Europe
260,Andrea Belotti,ITA,Torino,Serie A,2021,27.0,1993.0,15.2,7,3,2,2,3,3,12,25.0,9,12,4,8,2,9,9,0,FW,25-29,Forward,Italy,Europe
262,Hatem Ben Arfa,FRA,Lille,Ligue 1,2021,34.0,1987.0,3.5,4,2,2,1,1,2,4,50.0,2,3,0,3,0,4,1,0,"FW,MF",30-34,Forward,France,Europe
263,Salim Ben Seghir,FRA,Marseille,Ligue 1,2021,18.0,2003.0,0.0,0,0,0,0,0,0,0,,0,0,0,0,0,0,0,0,MF,Under 20,Midfielder,France,Europe
264,Wissam Ben Yedder,FRA,Monaco,Ligue 1,2021,30.0,1990.0,28.1,18,8,1,11,6,6,15,40.0,9,12,1,11,0,18,1,0,FW,30-34,Forward,France,Europe
265,Marco Benassi,ITA,Fiorentina,Serie A,2021,26.0,1994.0,1.8,1,0,1,0,0,1,2,50.0,1,3,0,3,3,4,3,0,"DF,MF",25-29,Defender,Italy,Europe
266,Marco Benassi,ITA,Empoli,Serie A,2021,26.0,1994.0,4.2,6,3,3,2,1,1,10,10.0,9,4,0,4,3,9,6,0,MF,25-29,Midfielder,Italy,Europe
267,Darío Benedetto,ARG,Elche,La Liga,2021,31.0,1990.0,6.6,5,1,2,2,1,3,6,50.0,3,4,0,4,1,6,1,0,"FW,MF",30-34,Forward,Argentina,South America
268,Darío Benedetto,ARG,Marseille,Ligue 1,2021,31.0,1990.0,0.6,0,0,0,0,0,0,0,,0,2,0,2,0,0,0,0,"FW,MF",30-34,Forward,Argentina,South America
269,László Bénes,SVK,Gladbach,Bundesliga,2021,23.0,1997.0,2.7,5,3,1,3,1,1,6,16.7,5,5,2,3,2,7,5,0,MF,20-24,Midfielder,Slovakia,Europe
270,Walter Benítez,ARG,Nice,Ligue 1,2021,28.0,1993.0,37.0,0,0,0,0,0,0,2,0.0,2,1,0,1,0,0,12,2,GK,25-29,Goalkeeper,Argentina,South America
272,Loris Benito,SUI,Bordeaux,Ligue 1,2021,29.0,1992.0,0.7,0,0,0,0,0,0,0,,0,0,0,0,1,1,3,1,DF,25-29,Defender,Switzerland,Europe
274,Filip Benković,CRO,Udinese,Serie A,2021,24.0,1997.0,0.1,0,0,0,0,0,0,0,,0,0,0,0,0,0,0,0,"DF,FW",20-24,Defender,Croatia,Europe
275,Ismaël Bennacer,ALG,Milan,Serie A,2021,23.0,1997.0,16.9,44,30,22,15,7,21,50,42.0,29,20,4,16,25,69,15,0,MF,20-24,Midfielder,Algeria,Africa
276,Keanan Bennetts,ENG,Gladbach,Bundesliga,2021,22.0,1999.0,0.6,2,0,1,1,0,1,1,100.0,0,1,0,1,0,2,0,0,"FW,DF",20-24,Forward,England,Europe
277,Saïd Benrahma,ALG,West Ham,Premier League,2021,25.0,1995.0,24.1,28,17,16,9,3,15,38,39.5,23,17,1,16,9,37,8,0,"FW,MF",25-29,Forward,Algeria,Africa
278,Ramy Bensebaini,ALG,Gladbach,Bundesliga,2021,26.0,1995.0,22.4,42,30,24,15,3,27,44,61.4,17,33,7,26,39,81,77,1,DF,25-29,Defender,Algeria,Africa
279,Nabil Bentaleb,ALG,Angers,Ligue 1,2021,26.0,1994.0,16.8,42,24,15,20,7,16,29,55.2,13,24,9,15,28,70,13,0,MF,25-29,Midfielder,Algeria,Africa
280,Rodrigo Bentancur,URU,Tottenham,Premier League,2021,24.0,1997.0,15.1,36,18,14,14,8,16,32,50.0,16,24,9,15,20,56,35,0,MF,20-24,Midfielder,Uruguay,South America
281,Rodrigo Bentancur,URU,Juventus,Serie A,2021,24.0,1997.0,12.8,32,18,11,18,3,7,20,35.0,13,15,2,13,26,58,15,1,MF,20-24,Midfielder,Uruguay,South America
282,Christian Benteke,BEL,Crystal Palace,Premier League,2021,30.0,1990.0,12.7,3,2,1,2,0,2,6,33.3,4,7,3,4,2,5,33,0,FW,30-34,Forward,Belgium,Europe
283,Karim Benzema,FRA,Real Madrid,La Liga,2021,33.0,1987.0,28.8,11,9,5,3,3,2,9,22.2,7,10,0,10,4,15,13,0,FW,30-34,Forward,France,Europe
284,Alessandro Berardi,ITA,Hellas Verona,Serie A,2021,30.0,1991.0,1.0,0,0,0,0,0,0,0,,0,0,0,0,0,0,0,0,GK,30-34,Goalkeeper,Italy,Europe
285,Domenico Berardi,ITA,Sassuolo,Serie A,2021,26.0,1994.0,31.3,32,19,9,16,7,15,57,26.3,42,39,2,37,31,63,23,0,FW,25-29,Forward,Italy,Europe
289,Jóhann Berg Guðmundsson,ISL,Burnley,Premier League,2021,30.0,1990.0,12.2,16,6,7,7,2,5,20,25.0,15,11,2,9,12,28,22,0,MF,30-34,Midfielder,Iceland,Europe
291,Mitchell van Bergen,NED,Reims,Ligue 1,2021,21.0,1999.0,10.9,8,5,7,0,1,6,15,40.0,9,9,0,9,4,12,7,0,"FW,MF",20-24,Forward,Netherlands,Europe
292,Steven Bergwijn,NED,Tottenham,Premier League,2021,23.0,1997.0,6.3,3,2,2,1,0,1,10,10.0,9,3,0,3,1,4,8,0,"FW,MF",20-24,Forward,Netherlands,Europe
293,Etrit Berisha,ALB,Torino,Serie A,2021,32.0,1989.0,10.0,0,0,0,0,0,0,0,,0,0,0,0,0,0,4,0,GK,30-34,Goalkeeper,Albania,Europe
295,Federico Bernardeschi,ITA,Juventus,Serie A,2021,27.0,1994.0,16.4,16,10,7,4,5,6,13,46.2,7,12,4,8,5,21,15,0,"MF,FW",25-29,Midfielder,Italy,Europe
296,Paul Bernardoni,FRA,Angers,Ligue 1,2021,24.0,1997.0,13.0,3,2,3,0,0,3,4,75.0,1,0,0,0,0,3,8,1,GK,20-24,Goalkeeper,France,Europe
297,Paul Bernardoni,FRA,Saint-Étienne,Ligue 1,2021,24.0,1997.0,19.0,0,0,0,0,0,0,0,,0,0,0,0,0,0,14,2,GK,20-24,Goalkeeper,France,Europe
299,Dimitry Bertaud,COD,Montpellier,Ligue 1,2021,23.0,1998.0,9.3,0,0,0,0,0,0,1,0.0,1,0,0,0,0,0,5,1,GK,20-24,Goalkeeper,DR Congo,Africa
300,Jason Berthomier,FRA,Clermont Foot,Ligue 1,2021,31.0,1990.0,19.2,29,14,5,17,7,12,34,35.3,22,14,2,12,8,37,4,1,MF,30-34,Midfielder,France,Europe
301,Nicolò Bertola,ITA,Spezia,Serie A,2021,18.0,2003.0,0.4,3,2,3,0,0,3,4,75.0,1,0,0,0,3,6,1,0,"MF,DF",Under 20,Midfielder,Italy,Europe
302,Ryan Bertrand,ENG,Leicester City,Premier League,2021,31.0,1989.0,3.7,8,5,3,4,1,2,5,40.0,3,8,3,5,1,9,7,0,DF,30-34,Defender,England,Europe
303,Daniel Bessa,ITA,Hellas Verona,Serie A,2021,28.0,1993.0,8.5,7,2,3,3,1,4,15,26.7,11,13,3,10,5,12,11,0,MF,25-29,Midfielder,Italy,Europe
304,Beto,GNB,Udinese,Serie A,2021,23.0,1998.0,24.1,21,6,2,14,5,9,19,47.4,10,16,1,15,5,26,25,1,FW,20-24,Forward,Guinea-Bissau,Africa
304,Beto,GNB,Udinese,Serie A,2021,23.0,1998.0,24.1,21,6,2,14,5,9,19,47.4,10,16,1,15,5,26,25,1,FW,20-24,Forward,Guinea-Bissau,Africa
304,Beto,GNB,Udinese,Serie A,2021,23.0,1998.0,24.1,21,6,2,14,5,9,19,47.4,10,16,1,15,5,26,25,1,FW,20-24,Forward,Guinea-Bissau,Africa
304,Beto,GNB,Udinese,Serie A,2021,23.0,1998.0,24.1,21,6,2,14,5,9,19,47.4,10,16,1,15,5,26,25,1,FW,20-24,Forward,Guinea-Bissau,Africa
305,Jordan Beyer,GER,Gladbach,Bundesliga,2021,21.0,2000.0,15.4,46,27,32,13,1,23,39,59.0,16,18,5,13,15,61,52,2,DF,20-24,Defender,Germany,Europe
306,Giulian Biancone,FRA,Troyes,Ligue 1,2021,21.0,2000.0,25.5,70,42,44,22,4,40,69,58.0,29,23,8,15,53,123,71,1,"DF,MF",20-24,Defender,France,Europe
308,Ermin Bičakčić,BIH,Hoffenheim,Bundesliga,2021,31.0,1990.0,0.1,0,0,0,0,0,0,0,,0,0,0,0,0,0,0,0,DF,30-34,Defender,Bosnia and Herzegovina,Europe
309,Mads Bidstrup,DEN,Brentford,Premier League,2021,20.0,2001.0,0.5,1,0,0,1,0,0,3,0.0,3,0,0,0,1,2,2,0,MF,20-24,Midfielder,Denmark,Europe
311,El Bilal Touré,MLI,Reims,Ligue 1,2021,19.0,2001.0,13.3,13,6,4,6,3,2,7,28.6,5,10,3,7,6,19,19,0,FW,Under 20,Forward,Mali,Africa
312,Jean-Claude Billong,CMR,Clermont Foot,Ligue 1,2021,27.0,1993.0,10.9,17,8,14,1,2,8,11,72.7,3,9,1,8,10,27,35,0,DF,25-29,Defender,Cameroon,Africa
313,Luis Binks,ENG,Bologna,Serie A,2021,19.0,2001.0,7.2,8,4,7,1,0,4,6,66.7,2,6,5,1,17,25,33,1,DF,Under 20,Defender,England,Europe
314,Cristiano Biraghi,ITA,Fiorentina,Serie A,2021,28.0,1992.0,35.0,37,24,17,15,5,22,53,41.5,31,28,10,18,19,56,31,1,DF,25-29,Defender,Italy,Europe
315,Davide Biraschi,ITA,Genoa,Serie A,2021,27.0,1994.0,10.3,31,16,19,9,3,17,24,70.8,7,16,9,7,16,47,26,0,DF,25-29,Defender,Italy,Europe
316,Tom Bischof,GER,Hoffenheim,Bundesliga,2021,16.0,2005.0,0.2,0,0,0,0,0,0,0,,0,1,0,1,0,0,1,0,MF,Under 20,Midfielder,Germany,Europe
317,Yves Bissouma,MLI,Brighton,Premier League,2021,24.0,1996.0,23.5,76,49,35,37,4,21,37,56.8,16,33,3,30,50,126,49,0,MF,20-24,Midfielder,Mali,Africa
318,Nathan Bitumazala,FRA,Paris S-G,Ligue 1,2021,18.0,2002.0,0.1,0,0,0,0,0,0,0,,0,1,0,1,0,0,0,0,DF,Under 20,Defender,France,Europe
319,Marco Bizot,NED,Brest,Ligue 1,2021,30.0,1991.0,38.0,3,1,3,0,0,3,5,60.0,2,1,0,1,0,3,24,1,GK,30-34,Goalkeeper,Netherlands,Europe
320,Bjarki Bjarkason,ISL,Venezia,Serie A,2021,21.0,2000.0,0.0,0,0,0,0,0,0,0,,0,0,0,0,0,0,0,0,MF,20-24,Midfielder,Iceland,Europe
322,Ludovic Blas,FRA,Nantes,Ligue 1,2021,23.0,1997.0,32.9,33,18,7,20,6,15,44,34.1,29,33,3,30,31,64,6,1,"MF,FW",20-24,Midfielder,France,Europe
323,Danny Blum,GER,Bochum,Bundesliga,2021,30.0,1991.0,3.8,2,1,0,0,2,0,2,0.0,2,4,0,4,2,4,1,0,FW,30-34,Forward,Germany,Europe
324,Myron Boadu,NED,Monaco,Ligue 1,2021,20.0,2001.0,10.7,9,7,2,3,4,1,5,20.0,4,6,0,6,2,11,1,0,FW,20-24,Forward,Netherlands,Europe
325,Jérôme Boateng,GER,Lyon,Ligue 1,2021,32.0,1988.0,18.0,20,15,11,9,0,9,17,52.9,8,20,10,10,20,40,73,0,DF,30-34,Defender,Germany,Europe
326,Kevin-Prince Boateng,GHA,Hertha BSC,Bundesliga,2021,34.0,1987.0,7.7,6,5,1,4,1,3,9,33.3,6,7,2,5,6,12,11,0,"MF,FW",30-34,Midfielder,Ghana,Africa
327,Antonin Bobichon,FRA,Angers,Ligue 1,2021,25.0,1995.0,0.4,1,0,0,1,0,0,0,,0,0,0,0,1,2,0,0,"MF,FW",25-29,Midfielder,France,Europe
328,Herbert Bockhorn,GER,Bochum,Bundesliga,2021,26.0,1995.0,9.4,20,14,13,4,3,12,20,60.0,8,10,1,9,14,34,18,0,DF,25-29,Defender,Germany,Europe
329,Jean-Paul Boëtius,NED,Mainz 05,Bundesliga,2021,27.0,1994.0,20.0,40,23,18,17,5,22,53,41.5,31,41,3,38,25,65,11,0,MF,25-29,Midfielder,Netherlands,Europe
330,Jeremie Boga,CIV,Atalanta,Serie A,2021,24.0,1997.0,8.5,7,3,0,4,3,4,6,66.7,2,6,0,6,1,8,3,1,"FW,MF",20-24,Forward,Ivory Coast,Africa
331,Jeremie Boga,CIV,Sassuolo,Serie A,2021,24.0,1997.0,7.4,7,4,1,2,4,2,3,66.7,1,3,0,3,2,9,1,1,"FW,MF",20-24,Forward,Ivory Coast,Africa
332,Luka Bogdan,CRO,Salernitana,Serie A,2021,25.0,1996.0,4.4,6,3,6,0,0,4,8,50.0,4,3,2,1,6,12,21,0,DF,25-29,Defender,Croatia,Europe
334,Quentin Boisgard,FRA,Lorient,Ligue 1,2021,24.0,1997.0,10.6,19,11,6,10,3,8,17,47.1,9,15,0,15,6,25,5,0,"MF,FW",20-24,Midfielder,France,Europe
335,Charles Boli,FRA,Lens,Ligue 1,2021,22.0,1998.0,0.4,2,1,0,2,0,0,0,,0,0,0,0,0,2,0,0,"MF,DF",20-24,Midfielder,France,Europe
336,Willy Boly,CIV,Wolves,Premier League,2021,30.0,1991.0,10.0,25,19,18,7,0,8,15,53.3,7,14,6,8,14,39,35,0,DF,30-34,Defender,Ivory Coast,Africa
337,Giacomo Bonaventura,ITA,Fiorentina,Serie A,2021,31.0,1989.0,25.2,33,17,12,16,5,21,46,45.7,25,20,2,18,14,47,9,1,MF,30-34,Midfielder,Italy,Europe
338,Federico Bonazzoli,ITA,Salernitana,Serie A,2021,24.0,1997.0,20.7,24,12,9,8,7,6,25,24.0,19,17,1,16,6,30,7,0,"FW,MF",20-24,Forward,Italy,Europe
339,Tarsis Bonga,GER,Bochum,Bundesliga,2021,24.0,1997.0,0.2,0,0,0,0,0,0,0,,0,0,0,0,0,0,0,0,"MF,FW",20-24,Midfielder,Germany,Europe
340,Kevin Bonifazi,ITA,Bologna,Serie A,2021,25.0,1996.0,13.4,25,16,16,7,2,13,14,92.9,1,22,7,15,16,41,35,0,DF,25-29,Defender,Italy,Europe
341,Solomon Bonnah,NED,RB Leipzig,Bundesliga,2021,17.0,2003.0,0.1,0,0,0,0,0,0,0,,0,1,0,1,1,1,0,0,DF,Under 20,Defender,Netherlands,Europe
342,Leonardo Bonucci,ITA,Juventus,Serie A,2021,34.0,1987.0,22.3,14,5,4,10,0,8,13,61.5,5,22,17,5,26,40,82,0,DF,30-34,Defender,Italy,Europe
343,Sebastiaan Bornauw,BEL,Wolfsburg,Bundesliga,2021,22.0,1999.0,22.3,30,19,23,5,2,16,25,64.0,9,29,8,21,42,72,97,1,DF,20-24,Defender,Belgium,Europe
344,Rafael Borré,COL,Eint Frankfurt,Bundesliga,2021,25.0,1995.0,26.4,31,22,4,13,14,7,33,21.2,26,24,4,20,5,36,9,0,FW,25-29,Forward,Colombia,South America
345,Sven Botman,NED,Lille,Ligue 1,2021,21.0,2000.0,25.0,24,11,13,11,0,12,18,66.7,6,32,21,11,26,50,116,0,DF,20-24,Defender,Netherlands,Europe
346,Denis Bouanga,GAB,Saint-Étienne,Ligue 1,2021,26.0,1994.0,27.1,46,25,14,13,19,22,63,34.9,41,30,0,30,8,54,34,1,"FW,MF",25-29,Forward,Gabon,Africa
347,Hicham Boudaoui,ALG,Nice,Ligue 1,2021,21.0,1999.0,18.0,31,18,15,10,6,13,36,36.1,23,17,4,13,18,49,15,0,MF,20-24,Midfielder,Algeria,Africa
348,Ryad Boudebouz,ALG,Saint-Étienne,Ligue 1,2021,31.0,1990.0,25.0,27,15,11,12,4,12,29,41.4,17,17,2,15,10,37,5,0,"MF,FW",30-34,Midfielder,Algeria,Africa
349,Sofiane Boufal,MAR,Angers,Ligue 1,2021,27.0,1993.0,25.9,44,29,19,16,9,18,38,47.4,20,19,2,17,7,51,1,0,"FW,MF",25-29,Forward,Morocco,Africa
350,Farid Boulaya,ALG,Metz,Ligue 1,2021,28.0,1993.0,17.0,18,10,7,9,2,14,38,36.8,24,8,2,6,12,30,5,0,"MF,FW",25-29,Midfielder,Algeria,Africa
351,Yassine Bounou,MAR,Sevilla,La Liga,2021,30.0,1991.0,31.0,0,0,0,0,0,0,0,,0,0,0,0,0,0,11,1,GK,30-34,Goalkeeper,Morocco,Africa
353,Mehdi Bourabia,MAR,Spezia,Serie A,2021,29.0,1991.0,3.1,5,1,2,3,0,3,11,27.3,8,7,6,1,3,8,10,0,MF,25-29,Midfielder,Morocco,Africa
354,Benjamin Bourigeaud,FRA,Rennes,Ligue 1,2021,27.0,1994.0,35.5,46,24,16,18,12,24,67,35.8,43,33,3,30,30,76,44,0,"FW,MF",25-29,Forward,France,Europe
355,Redwan Bourles,FRA,Lorient,Ligue 1,2021,18.0,2003.0,0.2,0,0,0,0,0,0,0,,0,0,0,0,0,0,0,0,"MF,FW",Under 20,Midfielder,France,Europe
356,Edoardo Bove,ITA,Roma,Serie A,2021,19.0,2002.0,0.8,1,1,1,0,0,0,2,0.0,2,1,0,1,1,2,0,0,"MF,DF",Under 20,Midfielder,Italy,Europe
357,Jarrod Bowen,ENG,West Ham,Premier League,2021,24.0,1996.0,33.1,36,20,20,11,5,17,44,38.6,27,29,2,27,21,57,14,0,FW,20-24,Forward,England,Europe
358,Dedryck Boyata,BEL,Hertha BSC,Bundesliga,2021,30.0,1990.0,21.1,15,13,11,3,1,8,11,72.7,3,17,13,4,17,32,134,1,DF,30-34,Defender,Belgium,Europe
359,Lucas Boyé,ARG,Elche,La Liga,2021,25.0,1996.0,19.0,27,13,5,15,7,9,24,37.5,15,24,1,23,2,29,23,0,FW,25-29,Forward,Argentina,South America
360,Domagoj Bradarić,CRO,Lille,Ligue 1,2021,21.0,1999.0,4.6,11,9,8,2,1,7,12,58.3,5,5,2,3,10,21,7,1,DF,20-24,Defender,Croatia,Europe
361,Bilal Brahimi,ALG,Nice,Ligue 1,2021,21.0,2000.0,4.2,1,1,0,1,0,0,2,0.0,2,1,0,1,2,3,1,0,MF,20-24,Midfielder,Algeria,Africa
362,Bilal Brahimi,ALG,Angers,Ligue 1,2021,21.0,2000.0,3.8,1,1,0,1,0,0,3,0.0,3,0,0,0,1,2,1,0,FW,20-24,Forward,Algeria,Africa
363,Martin Braithwaite,DEN,Barcelona,La Liga,2021,30.0,1991.0,2.6,1,1,0,0,1,0,0,,0,2,0,2,1,2,1,0,FW,30-34,Forward,Denmark,Europe
364,Julian Brandt,GER,Dortmund,Bundesliga,2021,25.0,1996.0,23.1,37,19,13,20,4,17,54,31.5,37,19,2,17,24,61,14,1,"MF,FW",25-29,Midfielder,Germany,Europe
365,Jarrad Branthwaite,ENG,Everton,Premier League,2021,19.0,2002.0,4.3,4,1,3,1,0,3,8,37.5,5,3,2,1,1,5,20,0,DF,Under 20,Defender,England,Europe
367,Lilian Brassier,FRA,Brest,Ligue 1,2021,21.0,1999.0,25.1,40,24,23,13,4,10,21,47.6,11,31,21,10,32,72,86,0,DF,20-24,Defender,France,Europe
368,Claudio Bravo,CHI,Betis,La Liga,2021,38.0,1983.0,16.2,0,0,0,0,0,0,0,,0,0,0,0,0,0,6,2,GK,35-39,Goalkeeper,Chile,South America
370,Fabian Bredlow,GER,Stuttgart,Bundesliga,2021,26.0,1995.0,4.0,0,0,0,0,0,0,0,,0,0,0,0,0,0,1,0,GK,25-29,Goalkeeper,Germany,Europe
371,Josip Brekalo,CRO,Torino,Serie A,2021,23.0,1998.0,25.4,9,5,5,1,3,3,21,14.3,18,16,1,15,4,13,7,1,MF,20-24,Midfielder,Croatia,Europe
372,Josip Brekalo,CRO,Wolfsburg,Bundesliga,2021,23.0,1998.0,0.2,0,0,0,0,0,0,0,,0,0,0,0,0,0,0,0,FW,20-24,Forward,Croatia,Europe
373,Gleison Bremer,BRA,Torino,Serie A,2021,24.0,1997.0,32.1,49,24,27,22,0,18,28,64.3,10,54,23,31,105,154,137,0,DF,20-24,Defender,Brazil,South America
374,Jimmy Briand,FRA,Bordeaux,Ligue 1,2021,35.0,1985.0,2.5,2,0,2,0,0,0,2,0.0,2,0,0,0,1,3,2,0,"FW,MF",35-39,Forward,France,Europe
375,Yan Brice Eteki,CMR,Granada,La Liga,2021,23.0,1997.0,3.8,6,3,3,2,1,3,7,42.9,4,7,3,4,4,10,6,1,MF,20-24,Midfielder,Cameroon,Africa
376,Brian Brobbey,NED,RB Leipzig,Bundesliga,2021,19.0,2002.0,1.5,1,0,0,1,0,1,1,100.0,0,1,0,1,0,1,0,0,"FW,MF",Under 20,Forward,Netherlands,Europe
377,Armando Broja,ALB,Southampton,Premier League,2021,19.0,2001.0,21.9,12,5,2,7,3,2,9,22.2,7,17,1,16,3,15,11,0,FW,Under 20,Forward,Albania,Europe
378,Dylan Bronn,TUN,Metz,Ligue 1,2021,26.0,1995.0,28.3,47,29,33,13,1,20,31,64.5,11,32,19,13,40,87,78,1,DF,25-29,Defender,Tunisia,Africa
379,John Brooks,USA,Wolfsburg,Bundesliga,2021,28.0,1993.0,29.1,47,25,25,18,4,36,60,60.0,24,33,19,14,41,88,125,1,DF,25-29,Defender,United States,North America
380,Daniel Brosinski,GER,Mainz 05,Bundesliga,2021,33.0,1988.0,4.3,2,1,1,1,0,1,1,100.0,0,6,0,6,3,5,9,0,DF,30-34,Defender,Germany,Europe
381,Josh Brownhill,ENG,Burnley,Premier League,2021,25.0,1995.0,32.8,73,37,25,42,6,21,53,39.6,32,37,12,25,68,141,42,1,MF,25-29,Midfielder,England,Europe
382,Marcelo Brozović,CRO,Inter,Serie A,2021,28.0,1992.0,32.6,77,45,34,35,8,34,68,50.0,34,28,10,18,37,114,36,2,MF,25-29,Midfielder,Croatia,Europe
383,Cédric Brunner,SUI,Arminia,Bundesliga,2021,27.0,1994.0,24.3,51,35,29,20,2,25,49,51.0,24,27,10,17,43,94,84,0,DF,25-29,Defender,Switzerland,Europe
384,Lewis Brunt,ENG,Leicester City,Premier League,2021,20.0,2000.0,0.3,0,0,0,0,0,0,0,,0,1,0,1,0,0,0,0,MF,20-24,Midfielder,England,Europe
385,Jacob Bruun Larsen,DEN,Hoffenheim,Bundesliga,2021,22.0,1998.0,9.0,2,1,1,1,0,0,5,0.0,5,14,3,11,5,7,5,2,"FW,MF",20-24,Forward,Denmark,Europe
386,Ante Budimir,CRO,Osasuna,La Liga,2021,30.0,1991.0,19.3,24,10,3,15,6,6,19,31.6,13,22,4,18,3,27,16,0,FW,30-34,Forward,Croatia,Europe
387,Emi Buendía,ARG,Aston Villa,Premier League,2021,24.0,1996.0,21.1,38,18,16,13,9,21,51,41.2,30,21,3,18,9,47,11,0,"MF,FW",20-24,Midfielder,Argentina,South America
388,Osman Bukari,GHA,Nantes,Ligue 1,2021,22.0,1998.0,11.2,18,8,7,6,5,8,22,36.4,14,8,0,8,8,26,1,0,"FW,MF",20-24,Forward,Ghana,Africa
390,Alessandro Buongiorno,ITA,Torino,Serie A,2021,22.0,1999.0,13.1,20,9,9,8,3,9,13,69.2,4,12,6,6,31,51,44,0,DF,20-24,Defender,Italy,Europe
391,Sascha Burchert,GER,Greuther Fürth,Bundesliga,2021,31.0,1989.0,14.0,1,1,1,0,0,1,2,50.0,1,0,0,0,0,1,11,1,GK,30-34,Goalkeeper,Germany,Europe
392,Delano Burgzorg,SUR,Mainz 05,Bundesliga,2021,22.0,1998.0,0.3,1,1,1,0,0,0,1,0.0,1,0,0,0,0,1,0,0,MF,20-24,Midfielder,Suriname,South America
393,Jonathan Burkardt,GER,Mainz 05,Bundesliga,2021,21.0,2000.0,29.0,17,8,0,10,7,6,25,24.0,19,31,5,26,8,25,16,0,"FW,MF",20-24,Forward,Germany,Europe
394,Roman Bürki,SUI,Dortmund,Bundesliga,2021,30.0,1990.0,1.0,0,0,0,0,0,0,0,,0,0,0,0,0,0,0,0,GK,30-34,Goalkeeper,Switzerland,Europe
395,Dan Burn,ENG,Newcastle Utd,Premier League,2021,29.0,1992.0,16.0,16,11,11,4,1,7,11,63.6,4,22,14,8,20,36,101,0,DF,25-29,Defender,England,Europe
396,Dan Burn,ENG,Brighton,Premier League,2021,29.0,1992.0,11.4,22,12,13,8,1,6,15,40.0,9,14,10,4,24,46,51,0,DF,25-29,Defender,England,Europe
397,Maxime Busi,BEL,Reims,Ligue 1,2021,21.0,1999.0,14.4,26,15,20,5,1,19,36,52.8,17,19,5,14,17,43,28,0,DF,20-24,Defender,Belgium,Europe
398,Gianluca Busio,USA,Venezia,Serie A,2021,19.0,2002.0,21.7,53,28,27,20,6,28,63,44.4,35,45,13,32,21,74,30,1,MF,Under 20,Midfielder,United States,North America
401,Jack Butland,ENG,Crystal Palace,Premier League,2021,28.0,1993.0,8.5,0,0,0,0,0,0,0,,0,0,0,0,0,0,1,0,GK,25-29,Goalkeeper,England,Europe
404,Sam Byram,ENG,Norwich City,Premier League,2021,27.0,1993.0,11.4,24,15,17,6,1,19,27,70.4,8,21,11,10,22,46,48,0,DF,25-29,Defender,England,Europe
405,Erick Cabaco,URU,Getafe,La Liga,2021,26.0,1995.0,4.5,2,1,1,1,0,2,5,40.0,3,5,2,3,4,6,10,0,DF,25-29,Defender,Uruguay,South America
406,Willy Caballero,ARG,Southampton,Premier League,2021,39.0,1981.0,2.0,0,0,0,0,0,0,0,,0,0,0,0,0,0,2,1,GK,35-39,Goalkeeper,Argentina,South America
407,Rémy Cabella,FRA,Montpellier,Ligue 1,2021,31.0,1990.0,3.5,15,7,4,8,3,5,15,33.3,10,7,0,7,5,20,1,0,"MF,FW",30-34,Midfielder,France,Europe
408,Jimmy Cabot,FRA,Angers,Ligue 1,2021,27.0,1994.0,22.3,81,44,59,15,7,47,83,56.6,36,29,0,29,32,113,30,0,DF,25-29,Defender,France,Europe
409,Arthur Cabral,BRA,Fiorentina,Serie A,2021,23.0,1998.0,8.3,9,5,2,5,2,4,7,57.1,3,4,1,3,1,10,8,0,FW,20-24,Forward,Brazil,South America
410,Jovane Cabral,CPV,Lazio,Serie A,2021,23.0,1998.0,2.1,2,1,1,0,1,0,0,,0,1,1,0,1,3,1,0,FW,20-24,Forward,Cape Verde,Africa
411,Leandro Cabrera,URU,Espanyol,La Liga,2021,30.0,1991.0,37.0,37,24,27,10,0,21,34,61.8,13,32,23,9,44,81,222,2,DF,30-34,Defender,Uruguay,South America
412,Liberato Cacace,NZL,Empoli,Serie A,2021,20.0,2000.0,5.2,15,6,8,4,3,8,8,100.0,0,7,2,5,8,23,9,0,DF,20-24,Defender,New Zealand,Oceania
413,Martín Cáceres,URU,Cagliari,Serie A,2021,34.0,1987.0,9.2,13,7,5,5,3,4,12,33.3,8,12,3,9,14,27,21,0,DF,30-34,Defender,Uruguay,South America
414,Martín Cáceres,URU,Levante,La Liga,2021,34.0,1987.0,7.4,2,2,2,0,0,1,5,20.0,4,2,2,0,11,13,16,1,DF,30-34,Defender,Uruguay,South America
415,Anthony Caci,FRA,Strasbourg,Ligue 1,2021,24.0,1997.0,26.6,65,34,35,24,6,33,55,60.0,22,22,3,19,33,98,49,1,DF,20-24,Defender,France,Europe
416,Mathieu Cafaro,FRA,Reims,Ligue 1,2021,24.0,1997.0,2.1,4,2,3,1,0,0,7,0.0,7,2,0,2,3,7,1,0,"MF,FW",20-24,Midfielder,France,Europe
417,Yannick Cahuzac,FRA,Lens,Ligue 1,2021,36.0,1985.0,6.9,5,2,2,3,0,0,5,0.0,5,8,2,6,9,14,12,0,MF,35-39,Midfielder,France,Europe
418,Felipe Caicedo,ECU,Genoa,Serie A,2021,32.0,1988.0,3.2,3,3,0,2,1,0,1,0.0,1,1,0,1,0,3,4,0,FW,30-34,Forward,Ecuador,South America
419,Felipe Caicedo,ECU,Inter,Serie A,2021,32.0,1988.0,0.3,0,0,0,0,0,0,0,,0,1,0,1,0,0,0,0,"FW,DF",30-34,Forward,Ecuador,South America
420,Moisés Caicedo,ECU,Brighton,Premier League,2021,19.0,2001.0,7.3,16,10,7,7,2,5,12,41.7,7,18,4,14,10,26,7,0,MF,Under 20,Midfielder,Ecuador,South America
421,Marc-Aurèle Caillard,FRA,Metz,Ligue 1,2021,27.0,1994.0,17.1,0,0,0,0,0,0,2,0.0,2,0,0,0,2,2,9,1,GK,25-29,Goalkeeper,France,Europe
422,Jens Cajuste,SWE,Reims,Ligue 1,2021,21.0,1999.0,4.0,10,6,6,2,2,6,17,35.3,11,7,2,5,5,15,6,0,"MF,FW",20-24,Midfielder,Sweden,Europe
424,Davide Calabria,ITA,Milan,Serie A,2021,24.0,1996.0,23.5,62,37,31,23,8,37,72,51.4,35,25,5,20,23,85,40,1,DF,20-24,Defender,Italy,Europe
425,Riccardo Calafiori,ITA,Genoa,Serie A,2021,19.0,2002.0,0.9,1,0,0,0,1,1,2,50.0,1,2,1,1,2,3,4,0,DF,Under 20,Defender,Italy,Europe
426,Riccardo Calafiori,ITA,Roma,Serie A,2021,19.0,2002.0,1.9,5,4,2,2,1,1,5,20.0,4,3,0,3,3,8,1,0,DF,Under 20,Defender,Italy,Europe
427,Mattia Caldara,ITA,Venezia,Serie A,2021,27.0,1994.0,30.0,48,28,30,15,3,20,34,58.8,14,49,37,12,62,110,147,1,DF,25-29,Defender,Italy,Europe
430,Duje Ćaleta-Car,CRO,Marseille,Ligue 1,2021,24.0,1996.0,22.9,21,8,15,6,0,11,14,78.6,3,11,7,4,24,45,55,2,DF,20-24,Defender,Croatia,Europe
431,Hakan Çalhanoğlu,TUR,Inter,Serie A,2021,27.0,1994.0,27.6,41,23,16,19,6,11,40,27.5,29,29,5,24,25,66,12,0,MF,25-29,Midfielder,Turkey,Asia
432,Daniel Caligiuri,ITA,Augsburg,Bundesliga,2021,33.0,1988.0,22.3,46,30,17,26,3,27,72,37.5,45,36,5,31,18,64,33,0,"DF,MF",30-34,Defender,Italy,Europe
434,Lucas Calodat,FRA,Saint-Étienne,Ligue 1,2021,19.0,2002.0,0.0,0,0,0,0,0,0,0,,0,0,0,0,0,0,0,0,DF,Under 20,Defender,France,Europe
435,Dominic Calvert-Lewin,ENG,Everton,Premier League,2021,24.0,1997.0,14.3,11,8,1,6,4,3,8,37.5,5,5,2,3,3,14,12,0,FW,20-24,Forward,England,Europe
436,Mahdi Camara,FRA,Saint-Étienne,Ligue 1,2021,23.0,1998.0,34.1,101,57,39,50,12,39,70,55.7,31,44,8,36,57,158,35,1,"MF,DF",20-24,Midfielder,France,Europe
437,Mamadou Camara,MLI,Troyes,Ligue 1,2021,20.0,2001.0,0.4,1,1,1,0,0,0,0,,0,0,0,0,0,1,0,0,FW,20-24,Forward,Mali,Africa
437,Mamadou Camara,MLI,Troyes,Ligue 1,2021,20.0,2001.0,0.4,1,1,1,0,0,0,0,,0,0,0,0,0,1,0,0,FW,20-24,Forward,Mali,Africa
437,Mamadou Camara,MLI,Troyes,Ligue 1,2021,20.0,2001.0,0.4,1,1,1,0,0,0,0,,0,0,0,0,0,1,0,0,FW,20-24,Forward,Mali,Africa
437,Mamadou Camara,MLI,Troyes,Ligue 1,2021,20.0,2001.0,0.4,1,1,1,0,0,0,0,,0,0,0,0,0,1,0,0,FW,20-24,Forward,Mali,Africa
439,Eduardo Camavinga,FRA,Real Madrid,La Liga,2021,18.0,2002.0,13.7,52,35,22,20,10,20,38,52.6,18,20,2,18,17,69,14,1,MF,Under 20,Midfielder,France,Europe
440,Eduardo Camavinga,FRA,Rennes,Ligue 1,2021,18.0,2002.0,1.6,4,1,2,1,1,2,5,40.0,3,1,1,0,1,5,3,0,MF,Under 20,Midfielder,France,Europe
441,Andrea Cambiaso,ITA,Genoa,Serie A,2021,21.0,2000.0,19.9,46,20,28,14,4,18,32,56.3,14,33,8,25,23,69,37,1,DF,20-24,Defender,Italy,Europe
443,Chem Campbell,WAL,Wolves,Premier League,2021,18.0,2002.0,0.1,1,1,0,1,0,0,0,,0,0,0,0,0,1,0,0,MF,Under 20,Midfielder,Wales,Europe
444,Emre Can,GER,Dortmund,Bundesliga,2021,27.0,1994.0,18.8,36,22,20,16,0,15,30,50.0,15,26,10,16,36,72,40,2,"DF,MF",25-29,Defender,Germany,Europe
446,Matteo Cancellieri,ITA,Hellas Verona,Serie A,2021,19.0,2002.0,2.5,4,4,2,2,0,0,5,0.0,5,2,0,2,1,5,0,0,"MF,DF",Under 20,Midfielder,Italy,Europe
447,João Cancelo,POR,Manchester City,Premier League,2021,27.0,1994.0,35.9,83,54,33,35,15,46,91,50.5,45,25,3,22,59,142,45,1,DF,25-29,Defender,Portugal,Europe
448,Fali Candé,GNB,Metz,Ligue 1,2021,23.0,1998.0,10.8,30,18,13,15,2,13,31,41.9,18,11,2,9,6,36,21,0,DF,20-24,Defender,Guinea-Bissau,Africa
449,Antonio Candreva,ITA,Sampdoria,Serie A,2021,34.0,1987.0,34.7,27,16,9,11,7,19,55,34.5,36,23,2,21,33,60,19,0,"MF,FW",30-34,Midfielder,Italy,Europe
452,Todd Cantwell,ENG,Norwich City,Premier League,2021,23.0,1998.0,4.9,15,13,8,6,1,6,17,35.3,11,2,0,2,3,18,2,0,"FW,MF",20-24,Forward,England,Europe
454,Pierrick Capelle,FRA,Angers,Ligue 1,2021,34.0,1987.0,13.3,36,24,16,17,3,18,52,34.6,34,12,1,11,16,52,20,0,"MF,DF",30-34,Midfielder,France,Europe
455,Leonardo Capezzi,ITA,Salernitana,Serie A,2021,26.0,1995.0,1.9,3,1,0,3,0,1,4,25.0,3,8,4,4,0,3,2,0,MF,25-29,Midfielder,Italy,Europe
456,Étienne Capoue,FRA,Villarreal,La Liga,2021,33.0,1988.0,25.4,44,26,18,23,3,15,28,53.6,13,17,5,12,35,79,51,0,MF,30-34,Midfielder,France,Europe
457,Gianluca Caprari,ITA,Hellas Verona,Serie A,2021,28.0,1993.0,30.4,43,25,10,22,11,17,51,33.3,34,32,0,32,4,47,7,0,"MF,FW",25-29,Midfielder,Italy,Europe
458,Francesco Caputo,ITA,Sampdoria,Serie A,2021,33.0,1987.0,31.0,5,2,1,3,1,1,6,16.7,5,5,0,5,2,7,10,0,FW,30-34,Forward,Italy,Europe
459,Francesco Caputo,ITA,Sassuolo,Serie A,2021,33.0,1987.0,1.7,0,0,0,0,0,0,0,,0,0,0,0,0,0,0,0,FW,30-34,Forward,Italy,Europe
460,Maxence Caqueret,FRA,Lyon,Ligue 1,2021,21.0,2000.0,25.9,73,40,29,36,8,30,80,37.5,50,38,10,28,43,116,26,2,MF,20-24,Midfielder,France,Europe
461,Andrea Carboni,ITA,Cagliari,Serie A,2021,20.0,2001.0,24.6,53,24,33,16,4,19,42,45.2,23,42,15,27,27,80,87,0,DF,20-24,Defender,Italy,Europe
464,Irvin Cardona,FRA,Brest,Ligue 1,2021,23.0,1997.0,14.8,13,7,5,4,4,3,16,18.8,13,10,0,10,5,18,17,0,"FW,MF",20-24,Forward,France,Europe
465,Igor Carioca,BRA,Lorient,Ligue 1,2021,24.0,1996.0,17.5,27,16,16,8,3,15,43,34.9,28,17,2,15,25,52,28,0,DF,20-24,Defender,Brazil,South America
467,Diego Carlos,BRA,Sevilla,La Liga,2021,28.0,1993.0,32.9,35,24,20,13,2,16,24,66.7,8,48,33,15,24,59,120,5,DF,25-29,Defender,Brazil,South America
469,Yannick Carrasco,BEL,Atlético Madrid,La Liga,2021,27.0,1993.0,28.7,34,19,16,12,6,19,44,43.2,25,26,5,21,19,53,12,2,"FW,MF",25-29,Forward,Belgium,Europe
470,Guido Carrillo,ARG,Elche,La Liga,2021,30.0,1991.0,13.0,7,4,2,4,1,3,13,23.1,10,9,2,7,1,8,27,0,FW,30-34,Forward,Argentina,South America
472,William Carvalho,POR,Betis,La Liga,2021,29.0,1992.0,20.1,49,33,20,25,4,15,40,37.5,25,18,7,11,16,65,20,0,MF,25-29,Midfielder,Portugal,Europe
473,Nicolò Casale,ITA,Hellas Verona,Serie A,2021,23.0,1998.0,28.7,46,30,25,19,2,21,37,56.8,16,31,12,19,49,95,95,0,DF,20-24,Defender,Italy,Europe
474,Casemiro,BRA,Real Madrid,La Liga,2021,29.0,1992.0,28.5,79,51,45,30,4,30,67,44.8,37,65,19,46,38,117,65,3,MF,25-29,Midfielder,Brazil,South America
477,Moreto Cassamã,GNB,Reims,Ligue 1,2021,23.0,1998.0,8.9,12,6,7,4,1,3,19,15.8,16,10,5,5,9,21,5,0,MF,20-24,Midfielder,Guinea-Bissau,Africa
478,Francesco Cassata,ITA,Genoa,Serie A,2021,24.0,1997.0,0.1,0,0,0,0,0,0,0,,0,0,0,0,0,0,0,0,MF,20-24,Midfielder,Italy,Europe
479,Timothy Castagne,BEL,Leicester City,Premier League,2021,25.0,1995.0,23.6,67,31,38,22,7,27,43,62.8,16,28,9,19,29,96,54,1,DF,25-29,Defender,Belgium,Europe
480,Koen Casteels,BEL,Wolfsburg,Bundesliga,2021,29.0,1992.0,28.0,0,0,0,0,0,0,1,0.0,1,0,0,0,0,0,9,2,GK,25-29,Goalkeeper,Belgium,Europe
481,Jean-Charles Castelletto,CMR,Nantes,Ligue 1,2021,26.0,1995.0,27.9,45,24,27,17,1,25,35,71.4,10,38,27,11,30,75,73,0,DF,25-29,Defender,Cameroon,Africa
483,Gonzalo Castro,GER,Arminia,Bundesliga,2021,34.0,1987.0,4.8,8,3,4,4,0,1,5,20.0,4,3,0,3,3,11,3,0,"MF,FW",30-34,Midfielder,Germany,Europe
485,Gaetano Castrovilli,ITA,Fiorentina,Serie A,2021,24.0,1997.0,15.5,25,17,15,6,4,12,23,52.2,11,18,4,14,11,36,6,0,MF,20-24,Midfielder,Italy,Europe
486,Danilo Cataldi,ITA,Lazio,Serie A,2021,26.0,1994.0,19.0,36,17,15,17,4,12,38,31.6,26,24,12,12,17,53,19,1,MF,25-29,Midfielder,Italy,Europe
489,Edinson Cavani,URU,Manchester Utd,Premier League,2021,34.0,1987.0,8.5,4,1,0,3,1,2,8,25.0,6,6,0,6,2,6,8,0,FW,30-34,Forward,Uruguay,South America
491,Pietro Ceccaroni,ITA,Venezia,Serie A,2021,25.0,1995.0,34.7,55,31,33,18,4,25,36,69.4,11,45,32,13,30,85,143,0,DF,25-29,Defender,Italy,Europe
492,Federico Ceccherini,ITA,Hellas Verona,Serie A,2021,29.0,1992.0,26.2,32,16,19,10,3,19,33,57.6,14,13,8,5,50,82,76,1,DF,25-29,Defender,Italy,Europe
494,Zeki Çelik,TUR,Lille,Ligue 1,2021,24.0,1997.0,30.0,64,37,43,17,4,36,63,57.1,27,32,9,23,43,107,62,2,DF,20-24,Defender,Turkey,Asia
495,Fabien Centonze,FRA,Metz,Ligue 1,2021,25.0,1996.0,17.6,33,21,22,9,2,13,32,40.6,19,37,8,29,32,65,51,0,DF,25-29,Defender,France,Europe
496,Luca Ceppitelli,ITA,Cagliari,Serie A,2021,31.0,1989.0,16.1,23,12,13,10,0,16,27,59.3,11,21,14,7,25,48,54,0,DF,30-34,Defender,Italy,Europe
497,Franco Cervi,ARG,Celta Vigo,La Liga,2021,27.0,1994.0,20.0,73,41,35,22,16,33,77,42.9,44,38,2,36,21,94,19,0,MF,25-29,Midfielder,Argentina,South America
498,Damir Ceter,COL,Cagliari,Serie A,2021,23.0,1997.0,0.1,0,0,0,0,0,0,0,,0,0,0,0,0,0,0,0,FW,20-24,Forward,Colombia,South America
499,Julian Chabot,GER,Sampdoria,Serie A,2021,23.0,1998.0,5.4,12,10,8,4,0,8,10,80.0,2,7,4,3,9,21,28,1,DF,20-24,Defender,Germany,Europe
500,Julian Chabot,GER,Köln,Bundesliga,2021,23.0,1998.0,2.3,8,3,4,4,0,2,5,40.0,3,4,2,2,3,11,5,1,DF,20-24,Defender,Germany,Europe
501,El Chadaille Bitshiabu,FRA,Paris S-G,Ligue 1,2021,16.0,2005.0,0.1,0,0,0,0,0,0,0,,0,0,0,0,0,0,2,0,DF,Under 20,Defender,France,Europe
502,Nassim Chadli,FRA,Troyes,Ligue 1,2021,20.0,2001.0,1.1,5,3,3,0,2,2,4,50.0,2,1,0,1,0,5,0,0,"MF,DF",20-24,Midfielder,France,Europe
503,Kayky Chagas,BRA,Manchester City,Premier League,2021,18.0,2003.0,0.1,0,0,0,0,0,0,0,,0,0,0,0,0,0,0,0,FW,Under 20,Forward,Brazil,South America
504,Mehdi Chahiri,MAR,Strasbourg,Ligue 1,2021,25.0,1996.0,0.2,1,1,1,0,0,1,1,100.0,0,0,0,0,0,1,0,0,DF,25-29,Defender,Morocco,Africa
505,Trevoh Chalobah,ENG,Chelsea,Premier League,2021,22.0,1999.0,16.1,40,27,22,18,0,24,31,77.4,7,16,6,10,19,59,43,2,DF,20-24,Defender,England,Europe
506,Calum Chambers,ENG,Arsenal,Premier League,2021,26.0,1995.0,1.9,5,3,3,1,1,3,4,75.0,1,6,3,3,0,5,10,0,DF,25-29,Defender,England,Europe
507,Calum Chambers,ENG,Aston Villa,Premier League,2021,26.0,1995.0,9.2,16,8,10,6,0,4,6,66.7,2,14,8,6,5,21,42,0,DF,25-29,Defender,England,Europe
508,Dylan Chambost,FRA,Troyes,Ligue 1,2021,23.0,1997.0,8.4,16,11,6,9,1,4,25,16.0,21,9,2,7,8,24,4,0,"MF,FW",20-24,Midfielder,France,Europe
509,Timothy Chandler,USA,Eint Frankfurt,Bundesliga,2021,31.0,1990.0,13.5,18,12,10,8,0,11,24,45.8,13,10,3,7,19,37,28,1,DF,30-34,Defender,United States,North America
511,Brendan Chardonnet,FRA,Brest,Ligue 1,2021,26.0,1994.0,29.8,44,25,32,11,1,29,40,72.5,11,42,29,13,55,99,141,0,DF,25-29,Defender,France,Europe
512,Xavier Chavalerin,FRA,Troyes,Ligue 1,2021,30.0,1991.0,30.2,49,26,19,25,5,12,55,21.8,43,32,5,27,39,88,36,0,MF,30-34,Midfielder,France,Europe
513,Xavier Chavalerin,FRA,Reims,Ligue 1,2021,30.0,1991.0,2.4,4,4,2,1,1,1,3,33.3,2,2,0,2,5,9,2,1,MF,30-34,Midfielder,France,Europe
514,Justin Che,USA,Hoffenheim,Bundesliga,2021,17.0,2003.0,0.5,2,0,1,0,1,1,2,50.0,1,0,0,0,1,3,0,0,"FW,DF",Under 20,Forward,United States,North America
516,Rayan Cherki,FRA,Lyon,Ligue 1,2021,17.0,2003.0,4.9,6,2,1,3,2,4,9,44.4,5,2,0,2,1,7,0,0,"FW,MF",Under 20,Forward,France,Europe
517,Denis Cheryshev,RUS,Valencia,La Liga,2021,30.0,1990.0,6.3,14,5,6,1,7,6,15,40.0,9,9,1,8,9,23,9,0,"MF,FW",30-34,Midfielder,Russia,Europe
518,Daniel Chesters,ENG,West Ham,Premier League,2021,19.0,2002.0,0.0,0,0,0,0,0,0,0,,0,0,0,0,0,0,0,0,MF,Under 20,Midfielder,England,Europe
519,Giorgio Chiellini,ITA,Juventus,Serie A,2021,36.0,1984.0,15.0,22,13,17,4,1,7,13,53.8,6,24,18,6,22,44,59,0,DF,35-39,Defender,Italy,Europe
520,Federico Chiesa,ITA,Juventus,Serie A,2021,23.0,1997.0,9.6,26,19,9,9,8,12,26,46.2,14,7,0,7,4,30,3,0,"MF,FW",20-24,Midfielder,Italy,Europe
521,Ben Chilwell,ENG,Chelsea,Premier League,2021,24.0,1996.0,6.0,8,3,2,6,0,2,5,40.0,3,7,0,7,4,12,14,1,DF,20-24,Defender,England,Europe
522,Chiquinho,POR,Wolves,Premier League,2021,21.0,2000.0,2.3,9,6,4,5,0,4,5,80.0,1,5,0,5,2,11,1,0,"DF,FW",20-24,Defender,Portugal,Europe
522,Chiquinho,POR,Wolves,Premier League,2021,21.0,2000.0,2.3,9,6,4,5,0,4,5,80.0,1,5,0,5,2,11,1,0,"DF,FW",20-24,Defender,Portugal,Europe
522,Chiquinho,POR,Wolves,Premier League,2021,21.0,2000.0,2.3,9,6,4,5,0,4,5,80.0,1,5,0,5,2,11,1,0,"DF,FW",20-24,Defender,Portugal,Europe
522,Chiquinho,POR,Wolves,Premier League,2021,21.0,2000.0,2.3,9,6,4,5,0,4,5,80.0,1,5,0,5,2,11,1,0,"DF,FW",20-24,Defender,Portugal,Europe
523,Vlad Chiricheș,ROU,Sassuolo,Serie A,2021,31.0,1989.0,25.6,28,15,19,9,0,10,21,47.6,11,34,21,13,41,69,71,4,DF,30-34,Defender,Romania,Europe
525,Joris Chotard,FRA,Montpellier,Ligue 1,2021,19.0,2001.0,32.6,59,30,33,23,3,36,78,46.2,42,27,15,12,42,101,56,0,MF,Under 20,Midfielder,France,Europe
526,Hamza Choudhury,ENG,Leicester City,Premier League,2021,23.0,1997.0,3.2,9,3,4,4,1,3,5,60.0,2,0,0,0,12,21,10,0,"DF,MF",20-24,Defender,England,Europe
527,Andreas Christensen,DEN,Chelsea,Premier League,2021,25.0,1996.0,16.6,14,8,9,4,1,4,7,57.1,3,14,6,8,29,43,57,1,DF,25-29,Defender,Denmark,Europe
528,Max Christiansen,GER,Greuther Fürth,Bundesliga,2021,24.0,1996.0,22.8,46,25,19,22,5,18,43,41.9,25,52,16,36,68,114,56,0,MF,20-24,Midfielder,Germany,Europe
529,Carney Chukwuemeka,ENG,Aston Villa,Premier League,2021,17.0,2003.0,3.3,7,1,2,5,0,3,5,60.0,2,3,0,3,1,8,2,1,"MF,FW",Under 20,Midfielder,England,Europe
530,Samuel Chukwueze,NGA,Villarreal,La Liga,2021,22.0,1999.0,14.8,13,9,6,5,2,3,6,50.0,3,7,0,7,5,18,4,0,"MF,FW",20-24,Midfielder,Nigeria,Africa
532,Riccardo Ciervo,ITA,Sampdoria,Serie A,2021,19.0,2002.0,2.5,8,3,4,3,1,2,6,33.3,4,1,0,1,2,10,2,0,"MF,DF",Under 20,Midfielder,Italy,Europe
533,Jasper Cillessen,NED,Valencia,La Liga,2021,32.0,1989.0,16.2,0,0,0,0,0,0,1,0.0,1,0,0,0,1,1,6,0,GK,30-34,Goalkeeper,Netherlands,Europe
534,Pathé Ciss,SEN,Rayo Vallecano,La Liga,2021,27.0,1994.0,12.2,31,15,20,8,3,12,26,46.2,14,16,6,10,30,61,27,0,MF,25-29,Midfielder,Senegal,Africa
535,Moustapha Cissé,GUI,Atalanta,Serie A,2021,17.0,2003.0,0.4,1,0,0,1,0,0,3,0.0,3,0,0,0,0,1,0,0,FW,Under 20,Forward,Guinea,Africa
536,Giorgio Cittadini,ITA,Atalanta,Serie A,2021,19.0,2002.0,0.0,0,0,0,0,0,0,0,,0,0,0,0,1,1,0,0,DF,Under 20,Defender,Italy,Europe
537,Ciaran Clark,IRL,Newcastle Utd,Premier League,2021,31.0,1989.0,11.3,13,10,4,7,2,9,14,64.3,5,14,11,3,13,26,43,1,DF,30-34,Defender,Republic of Ireland,Europe
538,Alexis Claude-Maurice,FRA,Nice,Ligue 1,2021,23.0,1998.0,2.3,2,0,1,0,1,1,4,25.0,3,7,0,7,3,5,1,0,MF,20-24,Midfielder,France,Europe
539,Jonathan Clauss,FRA,Lens,Ligue 1,2021,28.0,1992.0,33.8,63,34,33,20,10,22,55,40.0,33,43,1,42,73,136,51,0,DF,25-29,Defender,France,Europe
541,Tom Cleverley,ENG,Watford,Premier League,2021,31.0,1989.0,18.0,37,20,19,17,1,18,33,54.5,15,23,6,17,18,55,19,3,MF,30-34,Midfielder,England,Europe
542,Nathaniel Clyne,ENG,Crystal Palace,Premier League,2021,30.0,1991.0,15.0,21,10,11,9,1,10,20,50.0,10,7,2,5,15,36,32,0,DF,30-34,Defender,England,Europe
543,Conor Coady,ENG,Wolves,Premier League,2021,28.0,1993.0,37.3,31,14,23,7,1,16,28,57.1,12,46,40,6,28,59,140,0,DF,25-29,Defender,England,Europe
544,Marcus Coco,FRA,Nantes,Ligue 1,2021,25.0,1996.0,10.3,34,14,17,11,6,8,18,44.4,10,11,1,10,10,44,15,0,"MF,FW",25-29,Midfielder,France,Europe
546,Séamus Coleman,IRL,Everton,Premier League,2021,32.0,1988.0,29.5,61,36,35,16,10,33,51,64.7,18,30,11,19,32,93,80,2,DF,30-34,Defender,Republic of Ireland,Europe
548,Ebrima Colley,GAM,Spezia,Serie A,2021,21.0,2000.0,4.4,6,1,3,2,1,1,7,14.3,6,8,0,8,3,9,2,0,"FW,MF",20-24,Forward,Gambia,Africa
549,Omar Colley,GAM,Sampdoria,Serie A,2021,28.0,1992.0,30.5,47,36,32,14,1,22,32,68.8,10,31,19,12,80,127,135,2,DF,25-29,Defender,Gambia,Africa
550,Nathan Collins,IRL,Burnley,Premier League,2021,20.0,2001.0,18.6,37,15,27,8,2,17,27,63.0,10,38,25,13,24,61,83,2,DF,20-24,Defender,Republic of Ireland,Europe
551,Kingsley Coman,FRA,Bayern Munich,Bundesliga,2021,25.0,1996.0,15.1,14,8,1,9,4,5,16,31.3,11,14,0,14,8,22,5,0,"FW,DF",25-29,Forward,France,Europe
552,Eray Cömert,SUI,Valencia,La Liga,2021,23.0,1998.0,4.5,5,3,4,1,0,3,6,50.0,3,3,2,1,2,7,6,0,DF,20-24,Defender,Switzerland,Europe
555,Aaron Connolly,IRL,Brighton,Premier League,2021,21.0,2000.0,1.7,0,0,0,0,0,0,1,0.0,1,2,0,2,0,0,0,0,"FW,MF",20-24,Forward,Republic of Ireland,Europe
556,Andrea Consigli,ITA,Sassuolo,Serie A,2021,34.0,1987.0,36.9,0,0,0,0,0,0,2,0.0,2,0,0,0,0,0,23,3,GK,30-34,Goalkeeper,Italy,Europe
557,Abdu Conté,POR,Troyes,Ligue 1,2021,23.0,1998.0,15.0,22,12,16,5,1,12,24,50.0,12,12,2,10,4,26,10,0,DF,20-24,Defender,Portugal,Europe
558,Andrea Conti,ITA,Sampdoria,Serie A,2021,27.0,1994.0,2.6,4,2,2,1,1,3,6,50.0,3,4,0,4,7,11,4,0,"DF,MF",25-29,Defender,Italy,Europe
559,Andrea Conti,ITA,Milan,Serie A,2021,27.0,1994.0,0.1,0,0,0,0,0,0,0,,0,0,0,0,0,0,0,0,DF,25-29,Defender,Italy,Europe
560,Liam Cooper,SCO,Leeds United,Premier League,2021,29.0,1991.0,20.2,41,23,27,13,1,23,33,69.7,10,29,18,11,43,84,72,2,DF,25-29,Defender,Scotland,Europe
561,Lucas Copado,GER,Bayern Munich,Bundesliga,2021,17.0,2004.0,0.2,1,0,1,0,0,1,1,100.0,0,0,0,0,0,1,0,0,FW,Under 20,Forward,Germany,Europe
562,Diego Coppola,ITA,Hellas Verona,Serie A,2021,17.0,2003.0,2.8,8,4,4,4,0,3,3,100.0,0,5,1,4,4,12,5,0,DF,Under 20,Defender,Italy,Europe
563,Francis Coquelin,FRA,Villarreal,La Liga,2021,30.0,1991.0,9.2,26,17,9,11,6,11,20,55.0,9,15,5,10,19,45,11,0,MF,30-34,Midfielder,France,Europe
564,Sébastien Corchia,FRA,Nantes,Ligue 1,2021,30.0,1990.0,14.7,33,20,17,11,5,24,42,57.1,18,24,3,21,13,46,36,0,DF,30-34,Defender,France,Europe
565,Sergio Córdova,VEN,Augsburg,Bundesliga,2021,23.0,1997.0,3.6,4,3,2,2,0,1,2,50.0,1,4,0,4,0,4,4,0,"FW,MF",20-24,Forward,Venezuela,South America
566,Jack Cork,ENG,Burnley,Premier League,2021,32.0,1989.0,18.6,20,6,6,11,3,7,20,35.0,13,17,4,13,17,37,29,1,MF,30-34,Midfielder,England,Europe
567,Maxwel Cornet,CIV,Burnley,Premier League,2021,24.0,1996.0,19.6,16,9,7,5,4,7,15,46.7,8,13,4,9,10,26,14,0,"FW,MF",20-24,Forward,Ivory Coast,Africa
568,Maxwel Cornet,CIV,Lyon,Ligue 1,2021,24.0,1996.0,0.7,3,1,1,0,2,3,4,75.0,1,0,0,0,1,4,1,0,DF,20-24,Defender,Ivory Coast,Africa
569,Jesús Corona,MEX,Sevilla,La Liga,2021,28.0,1993.0,12.9,12,7,7,5,0,3,6,50.0,3,4,0,4,8,20,6,0,"FW,DF",25-29,Forward,Mexico,North America
570,Ángel Correa,ARG,Atlético Madrid,La Liga,2021,26.0,1995.0,20.6,16,8,5,10,1,7,29,24.1,22,25,2,23,10,26,4,0,"FW,MF",25-29,Forward,Argentina,South America
571,Joaquín Correa,ARG,Inter,Serie A,2021,26.0,1994.0,11.4,11,5,2,6,3,1,13,7.7,12,8,1,7,3,14,2,0,FW,25-29,Forward,Argentina,South America
572,Thierry Correia,POR,Valencia,La Liga,2021,22.0,1999.0,15.7,35,23,26,6,3,14,29,48.3,15,20,5,15,19,54,27,0,DF,20-24,Defender,Portugal,Europe
573,Danny da Costa,GER,Eint Frankfurt,Bundesliga,2021,28.0,1993.0,8.1,15,4,6,7,2,6,18,33.3,12,14,1,13,11,26,18,1,"DF,MF",25-29,Defender,Germany,Europe
574,David Costa,POR,Lens,Ligue 1,2021,20.0,2001.0,16.3,22,12,9,6,7,11,26,42.3,15,12,0,12,13,35,5,0,"MF,FW",20-24,Midfielder,Portugal,Europe
575,Hélder Costa,ANG,Leeds United,Premier League,2021,27.0,1994.0,0.2,0,0,0,0,0,0,0,,0,1,0,1,0,0,0,0,MF,25-29,Midfielder,Angola,Africa
576,Hélder Costa,ANG,Valencia,La Liga,2021,27.0,1994.0,12.4,27,16,11,9,7,14,41,34.1,27,12,1,11,3,30,9,0,"MF,FW",25-29,Midfielder,Angola,Africa
578,Benoît Costil,FRA,Bordeaux,Ligue 1,2021,34.0,1987.0,25.0,1,0,1,0,0,1,2,50.0,1,0,0,0,0,1,6,3,GK,30-34,Goalkeeper,France,Europe
580,Kalifa Coulibaly,MLI,Nantes,Ligue 1,2021,29.0,1991.0,9.4,5,1,1,1,3,0,4,0.0,4,2,2,0,0,5,11,0,FW,25-29,Forward,Mali,Africa
581,Lassana Coulibaly,MLI,Salernitana,Serie A,2021,25.0,1996.0,25.9,58,32,29,26,3,24,62,38.7,38,40,13,27,22,80,27,0,MF,25-29,Midfielder,Mali,Africa
582,Mamadou Coulibaly,SEN,Salernitana,Serie A,2021,22.0,1999.0,9.0,15,12,8,5,2,7,20,35.0,13,9,0,9,11,26,9,0,MF,20-24,Midfielder,Senegal,Africa
582,Mamadou Coulibaly,SEN,Salernitana,Serie A,2021,22.0,1999.0,9.0,15,12,8,5,2,7,20,35.0,13,9,0,9,11,26,9,0,MF,20-24,Midfielder,Senegal,Africa
582,Mamadou Coulibaly,SEN,Salernitana,Serie A,2021,22.0,1999.0,9.0,15,12,8,5,2,7,20,35.0,13,9,0,9,11,26,9,0,MF,20-24,Midfielder,Senegal,Africa
582,Mamadou Coulibaly,SEN,Salernitana,Serie A,2021,22.0,1999.0,9.0,15,12,8,5,2,7,20,35.0,13,9,0,9,11,26,9,0,MF,20-24,Midfielder,Senegal,Africa
583,Tanguy Coulibaly,FRA,Stuttgart,Bundesliga,2021,20.0,2001.0,12.0,27,15,14,11,2,9,19,47.4,10,14,2,12,4,31,10,0,"FW,MF",20-24,Forward,France,Europe
584,Thibaut Courtois,BEL,Real Madrid,La Liga,2021,29.0,1992.0,36.0,1,0,1,0,0,1,2,50.0,1,0,0,0,0,1,9,1,GK,25-29,Goalkeeper,Belgium,Europe
585,Philippe Coutinho,BRA,Aston Villa,Premier League,2021,29.0,1992.0,14.8,17,12,4,11,2,6,21,28.6,15,11,1,10,7,24,4,0,"MF,FW",25-29,Midfielder,Brazil,South America
586,Philippe Coutinho,BRA,Barcelona,La Liga,2021,29.0,1992.0,5.6,6,3,3,3,0,3,11,27.3,8,3,0,3,4,10,3,0,"MF,FW",25-29,Midfielder,Brazil,South America
587,Nicolas Cozza,FRA,Montpellier,Ligue 1,2021,22.0,1999.0,30.8,80,47,50,23,7,35,65,53.8,30,35,19,16,38,118,82,1,DF,20-24,Defender,France,Europe
588,Alessio Cragno,ITA,Cagliari,Serie A,2021,27.0,1994.0,35.0,3,3,2,1,0,3,3,100.0,0,0,0,0,1,4,14,1,GK,25-29,Goalkeeper,Italy,Europe
589,Aaron Cresswell,ENG,West Ham,Premier League,2021,31.0,1989.0,30.3,28,18,18,6,4,13,25,52.0,12,31,18,13,35,63,66,0,DF,30-34,Defender,England,Europe
590,Charlie Cresswell,ENG,Leeds United,Premier League,2021,18.0,2002.0,1.6,5,2,1,4,0,3,3,100.0,0,1,1,0,2,7,6,0,DF,Under 20,Defender,England,Europe
591,Domenico Criscito,ITA,Genoa,Serie A,2021,34.0,1986.0,18.0,37,21,19,14,4,16,25,64.0,9,22,12,10,39,76,57,0,DF,30-34,Defender,Italy,Europe
592,Bryan Cristante,ITA,Roma,Serie A,2021,26.0,1995.0,29.8,79,39,31,39,9,37,69,53.6,32,31,5,26,40,119,45,0,MF,25-29,Midfielder,Italy,Europe
594,Enzo Crivelli,FRA,Saint-Étienne,Ligue 1,2021,26.0,1995.0,1.1,1,0,0,0,1,0,0,,0,0,0,0,0,1,1,0,"FW,MF",25-29,Forward,France,Europe
596,Giovanni Crociata,ITA,Empoli,Serie A,2021,23.0,1997.0,0.2,0,0,0,0,0,0,1,0.0,1,0,0,0,0,0,0,0,FW,20-24,Forward,Italy,Europe
598,Juan Cuadrado,COL,Juventus,Serie A,2021,33.0,1988.0,27.6,48,23,30,13,5,30,55,54.5,25,23,5,18,29,77,34,0,"DF,MF",30-34,Defender,Colombia,South America
599,Cucho,COL,Watford,Premier League,2021,22.0,1999.0,12.7,13,5,5,5,3,5,27,18.5,22,13,1,12,5,18,9,0,"FW,MF",20-24,Forward,Colombia,South America
603,Mickaël Cuisance,FRA,Venezia,Serie A,2021,21.0,1999.0,10.2,23,9,7,12,4,10,28,35.7,18,14,0,14,12,35,5,0,MF,20-24,Midfielder,France,Europe
604,Mickaël Cuisance,FRA,Bayern Munich,Bundesliga,2021,21.0,1999.0,0.1,1,1,0,1,0,0,0,,0,0,0,0,0,1,0,0,MF,20-24,Midfielder,France,Europe
605,Luke Cundle,ENG,Wolves,Premier League,2021,19.0,2002.0,2.0,4,3,0,4,0,1,1,100.0,0,0,0,0,1,5,1,0,MF,Under 20,Midfielder,England,Europe
606,Matheus Cunha,BRA,Atlético Madrid,La Liga,2021,22.0,1999.0,11.8,19,12,3,11,5,5,20,25.0,15,18,2,16,6,25,9,0,FW,20-24,Forward,Brazil,South America
607,Matheus Cunha,BRA,Hertha BSC,Bundesliga,2021,22.0,1999.0,0.7,0,0,0,0,0,0,0,,0,0,0,0,0,0,0,0,FW,20-24,Forward,Brazil,South America
608,Patrick Cutrone,ITA,Empoli,Serie A,2021,23.0,1998.0,15.6,5,2,0,3,2,1,9,11.1,8,11,1,10,5,10,1,0,FW,20-24,Forward,Italy,Europe
609,Wylan Cyprien,FRA,Nantes,Ligue 1,2021,26.0,1995.0,16.6,33,17,12,18,3,13,32,40.6,19,16,6,10,10,43,14,2,MF,25-29,Midfielder,France,Europe
610,Rafael Czichos,GER,Köln,Bundesliga,2021,31.0,1990.0,15.6,29,18,18,9,2,14,28,50.0,14,23,13,10,19,48,53,2,DF,30-34,Defender,Germany,Europe
611,Lennart-Marten Czyborra,GER,Arminia,Bundesliga,2021,22.0,1999.0,1.5,0,0,0,0,0,0,2,0.0,2,0,0,0,3,3,3,1,DF,20-24,Defender,Germany,Europe
612,Danilo D'Ambrosio,ITA,Inter,Serie A,2021,32.0,1988.0,11.1,30,15,21,8,1,11,22,50.0,11,21,10,11,8,38,20,0,DF,30-34,Defender,Italy,Europe
613,Lucas Da Cunha,FRA,Nice,Ligue 1,2021,20.0,2001.0,4.4,13,7,2,7,4,6,11,54.5,5,2,0,2,1,14,2,0,MF,20-24,Midfielder,France,Europe
614,Lucas Da Cunha,FRA,Clermont Foot,Ligue 1,2021,20.0,2001.0,9.3,17,11,5,8,4,9,18,50.0,9,13,0,13,1,18,3,0,"FW,MF",20-24,Forward,France,Europe
615,Damien Da Silva,FRA,Lyon,Ligue 1,2021,33.0,1988.0,12.5,13,9,7,5,1,5,9,55.6,4,15,10,5,22,35,53,1,DF,30-34,Defender,France,Europe
616,Moanes Dabbur,ISR,Hoffenheim,Bundesliga,2021,29.0,1992.0,14.6,18,10,3,5,10,4,17,23.5,13,10,0,10,5,23,4,0,"FW,MF",25-29,Forward,Israel,Asia
617,Colin Dagba,FRA,Paris S-G,Ligue 1,2021,22.0,1998.0,1.8,4,2,2,2,0,3,6,50.0,3,4,2,2,2,6,1,0,DF,20-24,Defender,France,Europe
618,Finn Dahmen,GER,Mainz 05,Bundesliga,2021,23.0,1998.0,2.0,0,0,0,0,0,0,0,,0,0,0,0,0,0,2,0,GK,20-24,Goalkeeper,Germany,Europe
619,Mahmoud Dahoud,GER,Dortmund,Bundesliga,2021,25.0,1996.0,18.4,42,19,10,24,8,20,46,43.5,26,18,3,15,17,59,16,0,MF,25-29,Midfielder,Germany,Europe
620,Patson Daka,ZAM,Leicester City,Premier League,2021,22.0,1998.0,12.9,15,10,2,8,5,2,19,10.5,17,7,0,7,2,17,8,0,FW,20-24,Forward,Zambia,Africa
622,Diogo Dalot,POR,Manchester Utd,Premier League,2021,22.0,1999.0,20.0,55,41,35,12,8,31,57,54.4,26,24,13,11,29,84,59,0,DF,20-24,Defender,Portugal,Europe
623,Mikkel Damsgaard,DEN,Sampdoria,Serie A,2021,21.0,2000.0,6.4,27,13,12,11,4,20,36,55.6,16,16,1,15,7,34,7,0,"MF,FW",20-24,Midfielder,Denmark,Europe
624,Flavius Daniliuc,AUT,Nice,Ligue 1,2021,20.0,2001.0,14.4,46,31,26,17,3,34,43,79.1,9,13,7,6,14,60,34,1,DF,20-24,Defender,Austria,Europe
625,Danilo,BRA,Juventus,Serie A,2021,30.0,1991.0,21.0,37,26,20,13,4,18,28,64.3,10,21,12,9,32,69,53,1,"DF,MF",30-34,Defender,Brazil,South America
625,Danilo,BRA,Juventus,Serie A,2021,30.0,1991.0,21.0,37,26,20,13,4,18,28,64.3,10,21,12,9,32,69,53,1,"DF,MF",30-34,Defender,Brazil,South America
625,Danilo,BRA,Juventus,Serie A,2021,30.0,1991.0,21.0,37,26,20,13,4,18,28,64.3,10,21,12,9,32,69,53,1,"DF,MF",30-34,Defender,Brazil,South America
625,Danilo,BRA,Juventus,Serie A,2021,30.0,1991.0,21.0,37,26,20,13,4,18,28,64.3,10,21,12,9,32,69,53,1,"DF,MF",30-34,Defender,Brazil,South America
625,Danilo,BRA,Juventus,Serie A,2021,30.0,1991.0,21.0,37,26,20,13,4,18,28,64.3,10,21,12,9,32,69,53,1,"DF,MF",30-34,Defender,Brazil,South America
625,Danilo,BRA,Juventus,Serie A,2021,30.0,1991.0,21.0,37,26,20,13,4,18,28,64.3,10,21,12,9,32,69,53,1,"DF,MF",30-34,Defender,Brazil,South America
625,Danilo,BRA,Juventus,Serie A,2021,30.0,1991.0,21.0,37,26,20,13,4,18,28,64.3,10,21,12,9,32,69,53,1,"DF,MF",30-34,Defender,Brazil,South America
625,Danilo,BRA,Juventus,Serie A,2021,30.0,1991.0,21.0,37,26,20,13,4,18,28,64.3,10,21,12,9,32,69,53,1,"DF,MF",30-34,Defender,Brazil,South America
625,Danilo,BRA,Juventus,Serie A,2021,30.0,1991.0,21.0,37,26,20,13,4,18,28,64.3,10,21,12,9,32,69,53,1,"DF,MF",30-34,Defender,Brazil,South America
625,Danilo,BRA,Juventus,Serie A,2021,30.0,1991.0,21.0,37,26,20,13,4,18,28,64.3,10,21,12,9,32,69,53,1,"DF,MF",30-34,Defender,Brazil,South America
625,Danilo,BRA,Juventus,Serie A,2021,30.0,1991.0,21.0,37,26,20,13,4,18,28,64.3,10,21,12,9,32,69,53,1,"DF,MF",30-34,Defender,Brazil,South America
625,Danilo,BRA,Juventus,Serie A,2021,30.0,1991.0,21.0,37,26,20,13,4,18,28,64.3,10,21,12,9,32,69,53,1,"DF,MF",30-34,Defender,Brazil,South America
625,Danilo,BRA,Juventus,Serie A,2021,30.0,1991.0,21.0,37,26,20,13,4,18,28,64.3,10,21,12,9,32,69,53,1,"DF,MF",30-34,Defender,Brazil,South America
625,Danilo,BRA,Juventus,Serie A,2021,30.0,1991.0,21.0,37,26,20,13,4,18,28,64.3,10,21,12,9,32,69,53,1,"DF,MF",30-34,Defender,Brazil,South America
625,Danilo,BRA,Juventus,Serie A,2021,30.0,1991.0,21.0,37,26,20,13,4,18,28,64.3,10,21,12,9,32,69,53,1,"DF,MF",30-34,Defender,Brazil,South America
625,Danilo,BRA,Juventus,Serie A,2021,30.0,1991.0,21.0,37,26,20,13,4,18,28,64.3,10,21,12,9,32,69,53,1,"DF,MF",30-34,Defender,Brazil,South America
625,Danilo,BRA,Juventus,Serie A,2021,30.0,1991.0,21.0,37,26,20,13,4,18,28,64.3,10,21,12,9,32,69,53,1,"DF,MF",30-34,Defender,Brazil,South America
625,Danilo,BRA,Juventus,Serie A,2021,30.0,1991.0,21.0,37,26,20,13,4,18,28,64.3,10,21,12,9,32,69,53,1,"DF,MF",30-34,Defender,Brazil,South America
625,Danilo,BRA,Juventus,Serie A,2021,30.0,1991.0,21.0,37,26,20,13,4,18,28,64.3,10,21,12,9,32,69,53,1,"DF,MF",30-34,Defender,Brazil,South America
625,Danilo,BRA,Juventus,Serie A,2021,30.0,1991.0,21.0,37,26,20,13,4,18,28,64.3,10,21,12,9,32,69,53,1,"DF,MF",30-34,Defender,Brazil,South America
625,Danilo,BRA,Juventus,Serie A,2021,30.0,1991.0,21.0,37,26,20,13,4,18,28,64.3,10,21,12,9,32,69,53,1,"DF,MF",30-34,Defender,Brazil,South America
625,Danilo,BRA,Juventus,Serie A,2021,30.0,1991.0,21.0,37,26,20,13,4,18,28,64.3,10,21,12,9,32,69,53,1,"DF,MF",30-34,Defender,Brazil,South America
625,Danilo,BRA,Juventus,Serie A,2021,30.0,1991.0,21.0,37,26,20,13,4,18,28,64.3,10,21,12,9,32,69,53,1,"DF,MF",30-34,Defender,Brazil,South America
625,Danilo,BRA,Juventus,Serie A,2021,30.0,1991.0,21.0,37,26,20,13,4,18,28,64.3,10,21,12,9,32,69,53,1,"DF,MF",30-34,Defender,Brazil,South America
625,Danilo,BRA,Juventus,Serie A,2021,30.0,1991.0,21.0,37,26,20,13,4,18,28,64.3,10,21,12,9,32,69,53,1,"DF,MF",30-34,Defender,Brazil,South America
625,Danilo,BRA,Juventus,Serie A,2021,30.0,1991.0,21.0,37,26,20,13,4,18,28,64.3,10,21,12,9,32,69,53,1,"DF,MF",30-34,Defender,Brazil,South America
625,Danilo,BRA,Juventus,Serie A,2021,30.0,1991.0,21.0,37,26,20,13,4,18,28,64.3,10,21,12,9,32,69,53,1,"DF,MF",30-34,Defender,Brazil,South America
625,Danilo,BRA,Juventus,Serie A,2021,30.0,1991.0,21.0,37,26,20,13,4,18,28,64.3,10,21,12,9,32,69,53,1,"DF,MF",30-34,Defender,Brazil,South America
625,Danilo,BRA,Juventus,Serie A,2021,30.0,1991.0,21.0,37,26,20,13,4,18,28,64.3,10,21,12,9,32,69,53,1,"DF,MF",30-34,Defender,Brazil,South America
625,Danilo,BRA,Juventus,Serie A,2021,30.0,1991.0,21.0,37,26,20,13,4,18,28,64.3,10,21,12,9,32,69,53,1,"DF,MF",30-34,Defender,Brazil,South America
625,Danilo,BRA,Juventus,Serie A,2021,30.0,1991.0,21.0,37,26,20,13,4,18,28,64.3,10,21,12,9,32,69,53,1,"DF,MF",30-34,Defender,Brazil,South America
625,Danilo,BRA,Juventus,Serie A,2021,30.0,1991.0,21.0,37,26,20,13,4,18,28,64.3,10,21,12,9,32,69,53,1,"DF,MF",30-34,Defender,Brazil,South America
625,Danilo,BRA,Juventus,Serie A,2021,30.0,1991.0,21.0,37,26,20,13,4,18,28,64.3,10,21,12,9,32,69,53,1,"DF,MF",30-34,Defender,Brazil,South America
625,Danilo,BRA,Juventus,Serie A,2021,30.0,1991.0,21.0,37,26,20,13,4,18,28,64.3,10,21,12,9,32,69,53,1,"DF,MF",30-34,Defender,Brazil,South America
625,Danilo,BRA,Juventus,Serie A,2021,30.0,1991.0,21.0,37,26,20,13,4,18,28,64.3,10,21,12,9,32,69,53,1,"DF,MF",30-34,Defender,Brazil,South America
625,Danilo,BRA,Juventus,Serie A,2021,30.0,1991.0,21.0,37,26,20,13,4,18,28,64.3,10,21,12,9,32,69,53,1,"DF,MF",30-34,Defender,Brazil,South America
625,Danilo,BRA,Juventus,Serie A,2021,30.0,1991.0,21.0,37,26,20,13,4,18,28,64.3,10,21,12,9,32,69,53,1,"DF,MF",30-34,Defender,Brazil,South America
625,Danilo,BRA,Juventus,Serie A,2021,30.0,1991.0,21.0,37,26,20,13,4,18,28,64.3,10,21,12,9,32,69,53,1,"DF,MF",30-34,Defender,Brazil,South America
625,Danilo,BRA,Juventus,Serie A,2021,30.0,1991.0,21.0,37,26,20,13,4,18,28,64.3,10,21,12,9,32,69,53,1,"DF,MF",30-34,Defender,Brazil,South America
625,Danilo,BRA,Juventus,Serie A,2021,30.0,1991.0,21.0,37,26,20,13,4,18,28,64.3,10,21,12,9,32,69,53,1,"DF,MF",30-34,Defender,Brazil,South America
625,Danilo,BRA,Juventus,Serie A,2021,30.0,1991.0,21.0,37,26,20,13,4,18,28,64.3,10,21,12,9,32,69,53,1,"DF,MF",30-34,Defender,Brazil,South America
625,Danilo,BRA,Juventus,Serie A,2021,30.0,1991.0,21.0,37,26,20,13,4,18,28,64.3,10,21,12,9,32,69,53,1,"DF,MF",30-34,Defender,Brazil,South America
625,Danilo,BRA,Juventus,Serie A,2021,30.0,1991.0,21.0,37,26,20,13,4,18,28,64.3,10,21,12,9,32,69,53,1,"DF,MF",30-34,Defender,Brazil,South America
625,Danilo,BRA,Juventus,Serie A,2021,30.0,1991.0,21.0,37,26,20,13,4,18,28,64.3,10,21,12,9,32,69,53,1,"DF,MF",30-34,Defender,Brazil,South America
625,Danilo,BRA,Juventus,Serie A,2021,30.0,1991.0,21.0,37,26,20,13,4,18,28,64.3,10,21,12,9,32,69,53,1,"DF,MF",30-34,Defender,Brazil,South America
625,Danilo,BRA,Juventus,Serie A,2021,30.0,1991.0,21.0,37,26,20,13,4,18,28,64.3,10,21,12,9,32,69,53,1,"DF,MF",30-34,Defender,Brazil,South America
625,Danilo,BRA,Juventus,Serie A,2021,30.0,1991.0,21.0,37,26,20,13,4,18,28,64.3,10,21,12,9,32,69,53,1,"DF,MF",30-34,Defender,Brazil,South America
625,Danilo,BRA,Juventus,Serie A,2021,30.0,1991.0,21.0,37,26,20,13,4,18,28,64.3,10,21,12,9,32,69,53,1,"DF,MF",30-34,Defender,Brazil,South America
625,Danilo,BRA,Juventus,Serie A,2021,30.0,1991.0,21.0,37,26,20,13,4,18,28,64.3,10,21,12,9,32,69,53,1,"DF,MF",30-34,Defender,Brazil,South America
626,Arnaut Danjuma,NED,Villarreal,La Liga,2021,24.0,1997.0,16.4,7,6,3,0,4,2,4,50.0,2,5,0,5,2,9,3,0,FW,20-24,Forward,Netherlands,Europe
627,Kevin Danso,AUT,Lens,Ligue 1,2021,22.0,1998.0,31.0,41,29,29,12,0,23,34,67.6,11,38,25,13,40,81,111,0,DF,20-24,Defender,Austria,Europe
628,Dante,BRA,Nice,Ligue 1,2021,37.0,1983.0,31.9,42,29,30,12,0,23,33,69.7,10,43,27,16,49,91,96,1,DF,35-39,Defender,Brazil,South America
629,Ebrima Darboe,GAM,Roma,Serie A,2021,20.0,2001.0,0.7,1,1,0,1,0,0,0,,0,0,0,0,1,2,0,1,MF,20-24,Midfielder,Gambia,Africa
630,Márton Dárdai,HUN,Hertha BSC,Bundesliga,2021,19.0,2002.0,8.4,10,4,8,2,0,8,18,44.4,10,16,6,10,20,30,33,2,DF,Under 20,Defender,Hungary,Europe
633,Karl Darlow,WAL,Newcastle Utd,Premier League,2021,30.0,1990.0,8.0,0,0,0,0,0,0,0,,0,0,0,0,0,0,5,1,GK,30-34,Goalkeeper,Wales,Europe
634,Matteo Darmian,ITA,Inter,Serie A,2021,31.0,1989.0,16.7,32,16,17,9,6,16,41,39.0,25,16,1,15,19,51,25,0,DF,30-34,Defender,Italy,Europe
635,Josh Dasilva,ENG,Brentford,Premier League,2021,22.0,1998.0,2.9,2,1,0,1,1,1,2,50.0,1,3,0,3,1,3,7,0,"MF,FW",20-24,Midfielder,England,Europe
636,Jonathan David,CAN,Lille,Ligue 1,2021,21.0,2000.0,31.2,24,9,7,11,6,9,30,30.0,21,14,4,10,5,29,15,0,FW,20-24,Forward,Canada,North America
637,Alphonso Davies,CAN,Bayern Munich,Bundesliga,2021,20.0,2000.0,19.3,34,17,17,8,9,13,31,41.9,18,27,1,26,23,57,26,1,DF,20-24,Defender,Canada,North America
638,Ben Davies,WAL,Tottenham,Premier League,2021,28.0,1993.0,28.2,36,21,20,12,4,13,26,50.0,13,32,19,13,30,66,75,1,DF,25-29,Defender,Wales,Europe
638,Ben Davies,WAL,Tottenham,Premier League,2021,28.0,1993.0,28.2,36,21,20,12,4,13,26,50.0,13,32,19,13,30,66,75,1,DF,25-29,Defender,Wales,Europe
638,Ben Davies,WAL,Tottenham,Premier League,2021,28.0,1993.0,28.2,36,21,20,12,4,13,26,50.0,13,32,19,13,30,66,75,1,DF,25-29,Defender,Wales,Europe
638,Ben Davies,WAL,Tottenham,Premier League,2021,28.0,1993.0,28.2,36,21,20,12,4,13,26,50.0,13,32,19,13,30,66,75,1,DF,25-29,Defender,Wales,Europe
639,Tom Davies,ENG,Everton,Premier League,2021,23.0,1998.0,2.6,3,1,1,1,1,2,5,40.0,3,2,1,1,2,5,9,0,MF,20-24,Midfielder,England,Europe
639,Tom Davies,ENG,Everton,Premier League,2021,23.0,1998.0,2.6,3,1,1,1,1,2,5,40.0,3,2,1,1,2,5,9,0,MF,20-24,Midfielder,England,Europe
639,Tom Davies,ENG,Everton,Premier League,2021,23.0,1998.0,2.6,3,1,1,1,1,2,5,40.0,3,2,1,1,2,5,9,0,MF,20-24,Midfielder,England,Europe
639,Tom Davies,ENG,Everton,Premier League,2021,23.0,1998.0,2.6,3,1,1,1,1,2,5,40.0,3,2,1,1,2,5,9,0,MF,20-24,Midfielder,England,Europe
640,Keinan Davis,ENG,Aston Villa,Premier League,2021,23.0,1998.0,0.1,0,0,0,0,0,0,0,,0,0,0,0,0,0,0,0,FW,20-24,Forward,England,Europe
642,Craig Dawson,ENG,West Ham,Premier League,2021,31.0,1990.0,30.6,29,17,20,8,1,14,25,56.0,11,59,52,7,29,58,139,0,DF,30-34,Defender,England,Europe
643,Kevin De Bruyne,BEL,Manchester City,Premier League,2021,30.0,1991.0,24.5,32,16,4,15,13,12,37,32.4,25,32,2,30,6,38,16,0,MF,30-34,Midfielder,Belgium,Europe
644,Konrad De La Fuente,USA,Marseille,Ligue 1,2021,20.0,2001.0,8.7,11,7,8,2,1,7,11,63.6,4,5,0,5,2,13,4,0,"FW,MF",20-24,Forward,United States,North America
645,Sebastien De Maio,FRA,Udinese,Serie A,2021,34.0,1987.0,2.0,5,1,4,1,0,1,9,11.1,8,6,5,1,1,6,9,0,DF,30-34,Defender,France,Europe
646,Tommaso De Nipoti,ITA,Atalanta,Serie A,2021,18.0,2003.0,0.1,0,0,0,0,0,0,0,,0,0,0,0,0,0,0,0,FW,Under 20,Forward,Italy,Europe
647,Rodrigo De Paul,ARG,Atlético Madrid,La Liga,2021,27.0,1994.0,23.9,55,30,22,25,8,30,60,50.0,30,24,3,21,21,76,17,2,MF,25-29,Midfielder,Argentina,South America
648,Mattia De Sciglio,ITA,Juventus,Serie A,2021,28.0,1992.0,13.0,24,12,7,9,8,11,24,45.8,13,10,0,10,10,34,30,0,DF,25-29,Defender,Italy,Europe
649,Lorenzo De Silvestri,ITA,Bologna,Serie A,2021,33.0,1988.0,25.5,23,14,13,8,2,9,31,29.0,22,25,7,18,26,49,52,0,DF,30-34,Defender,Italy,Europe
650,Saulo Decarli,SUI,Bochum,Bundesliga,2021,29.0,1992.0,0.1,0,0,0,0,0,0,0,,0,0,0,0,0,0,0,0,DF,25-29,Defender,Switzerland,Europe
651,Troy Deeney,ENG,Watford,Premier League,2021,33.0,1988.0,0.3,0,0,0,0,0,0,1,0.0,1,0,0,0,0,0,2,0,FW,30-34,Forward,England,Europe
653,Alessandro Deiola,ITA,Cagliari,Serie A,2021,25.0,1995.0,23.7,47,22,15,25,7,23,58,39.7,35,28,10,18,26,73,45,0,MF,25-29,Midfielder,Italy,Europe
654,Romain Del Castillo,FRA,Rennes,Ligue 1,2021,25.0,1996.0,0.3,2,1,0,1,1,2,2,100.0,0,0,0,0,1,3,0,0,"MF,FW",25-29,Midfielder,France,Europe
655,Romain Del Castillo,FRA,Brest,Ligue 1,2021,25.0,1996.0,10.8,27,16,3,17,7,12,31,38.7,19,12,0,12,7,34,3,0,"MF,FW",25-29,Midfielder,France,Europe
656,Thomas Delaine,FRA,Metz,Ligue 1,2021,29.0,1992.0,25.7,48,35,34,12,2,22,42,52.4,20,20,7,13,27,75,31,0,DF,25-29,Defender,France,Europe
657,Thomas Delaney,DEN,Sevilla,La Liga,2021,29.0,1991.0,17.2,41,24,17,21,3,16,30,53.3,14,19,10,9,13,54,35,0,MF,25-29,Midfielder,Denmark,Europe
658,Thomas Delaney,DEN,Dortmund,Bundesliga,2021,29.0,1991.0,0.2,0,0,0,0,0,0,0,,0,0,0,0,0,0,0,0,MF,25-29,Midfielder,Denmark,Europe
659,Liam Delap,ENG,Manchester City,Premier League,2021,18.0,2003.0,0.1,0,0,0,0,0,0,0,,0,0,0,0,0,0,0,0,FW,Under 20,Forward,England,Europe
660,Sacha Delaye,FRA,Montpellier,Ligue 1,2021,19.0,2002.0,2.8,8,6,3,2,3,2,8,25.0,6,1,0,1,1,9,1,1,"MF,FW",Under 20,Midfielder,France,Europe
661,Filippo Delli Carri,ITA,Salernitana,Serie A,2021,22.0,1999.0,3.7,6,4,4,2,0,5,14,35.7,9,6,2,4,4,10,14,0,DF,20-24,Defender,Italy,Europe
662,Andy Delort,ALG,Nice,Ligue 1,2021,29.0,1991.0,27.2,15,9,3,5,7,7,12,58.3,5,13,4,9,9,24,14,0,FW,25-29,Forward,Algeria,Africa
663,Andy Delort,ALG,Montpellier,Ligue 1,2021,29.0,1991.0,3.0,2,0,0,1,1,0,1,0.0,1,1,0,1,0,2,4,0,FW,25-29,Forward,Algeria,Africa
664,Fabian Delph,ENG,Everton,Premier League,2021,31.0,1989.0,7.4,18,15,10,7,1,8,21,38.1,13,12,5,7,14,32,10,0,MF,30-34,Midfielder,England,Europe
665,Moussa Dembélé,FRA,Lyon,Ligue 1,2021,25.0,1996.0,24.5,18,9,5,5,8,6,15,40.0,9,13,0,13,8,26,30,1,FW,25-29,Forward,France,Europe
666,Ousmane Dembélé,FRA,Barcelona,La Liga,2021,24.0,1997.0,15.7,24,16,6,10,8,7,23,30.4,16,8,0,8,8,32,3,0,FW,20-24,Forward,France,Europe
667,Yusuf Demir,AUT,Barcelona,La Liga,2021,18.0,2003.0,2.1,3,1,1,1,1,2,5,40.0,3,1,0,1,2,5,1,0,FW,Under 20,Forward,Austria,Europe
668,Merih Demiral,TUR,Atalanta,Serie A,2021,23.0,1998.0,21.3,31,17,18,12,1,15,28,53.6,13,26,14,12,58,89,68,1,DF,20-24,Defender,Turkey,Asia
669,Kerem Demirbay,GER,Leverkusen,Bundesliga,2021,28.0,1993.0,22.8,52,31,19,30,3,16,41,39.0,25,32,9,23,33,85,21,0,MF,25-29,Midfielder,Germany,Europe
670,Ermedin Demirović,BIH,Freiburg,Bundesliga,2021,23.0,1998.0,9.7,12,6,4,4,4,1,10,10.0,9,14,1,13,1,13,7,0,FW,20-24,Forward,Bosnia and Herzegovina,Europe
671,Diego Demme,GER,Napoli,Serie A,2021,29.0,1991.0,7.7,21,12,4,13,4,10,21,47.6,11,11,2,9,9,30,2,0,MF,25-29,Midfielder,Germany,Europe
672,Jason Denayer,BEL,Lyon,Ligue 1,2021,26.0,1995.0,11.1,11,4,8,3,0,6,7,85.7,1,8,7,1,16,27,52,0,DF,25-29,Defender,Belgium,Europe
673,Leander Dendoncker,BEL,Wolves,Premier League,2021,26.0,1995.0,21.7,42,17,25,14,3,22,50,44.0,28,37,10,27,9,51,38,1,MF,25-29,Midfielder,Belgium,Europe
674,Emmanuel Dennis,NGA,Watford,Premier League,2021,23.0,1997.0,28.7,51,35,20,22,9,17,52,32.7,35,36,2,34,15,66,13,0,"FW,MF",20-24,Forward,Nigeria,Africa
675,Fabio Depaoli,ITA,Hellas Verona,Serie A,2021,24.0,1997.0,7.8,12,7,6,4,2,1,7,14.3,6,9,2,7,8,20,14,0,DF,20-24,Defender,Italy,Europe
676,Fabio Depaoli,ITA,Sampdoria,Serie A,2021,24.0,1997.0,1.2,3,1,1,2,0,0,2,0.0,2,2,1,1,1,4,2,0,"MF,DF",20-24,Midfielder,Italy,Europe
677,Mike van der Hoorn,NED,Arminia,Bundesliga,2021,28.0,1992.0,0.2,1,0,1,0,0,0,0,,0,0,0,0,1,2,2,0,DF,25-29,Defender,Netherlands,Europe
678,Arthur Desmas,FRA,Clermont Foot,Ligue 1,2021,27.0,1994.0,14.5,0,0,0,0,0,0,3,0.0,3,0,0,0,0,0,1,3,GK,25-29,Goalkeeper,France,Europe
679,Sergiño Dest,USA,Barcelona,La Liga,2021,20.0,2000.0,16.8,32,15,21,10,1,13,18,72.2,5,22,4,18,2,34,18,0,"DF,FW",20-24,Defender,United States,North America
680,Mattia Destro,ITA,Genoa,Serie A,2021,30.0,1991.0,19.4,9,4,1,4,4,1,6,16.7,5,14,1,13,2,11,16,0,FW,30-34,Forward,Italy,Europe
682,Kiernan Dewsbury-Hall,ENG,Leicester City,Premier League,2021,22.0,1998.0,23.4,39,24,20,14,5,19,40,47.5,21,37,8,29,21,60,26,1,MF,20-24,Midfielder,England,Europe
683,Jacopo Dezi,ITA,Venezia,Serie A,2021,29.0,1992.0,0.2,0,0,0,0,0,0,1,0.0,1,0,0,0,1,1,0,0,MF,25-29,Midfielder,Italy,Europe
684,Samuel Di Carmine,ITA,Hellas Verona,Serie A,2021,32.0,1988.0,0.4,0,0,0,0,0,0,0,,0,0,0,0,0,0,0,0,FW,30-34,Forward,Italy,Europe
685,Federico Di Francesco,ITA,Empoli,Serie A,2021,27.0,1994.0,15.2,16,5,2,8,6,9,23,39.1,14,17,1,16,9,25,11,0,"FW,MF",25-29,Forward,Italy,Europe
686,Giovanni Di Lorenzo,ITA,Napoli,Serie A,2021,27.0,1993.0,31.9,58,36,30,20,8,33,58,56.9,25,28,10,18,38,96,46,1,DF,25-29,Defender,Italy,Europe
687,Ángel Di María,ARG,Paris S-G,Ligue 1,2021,33.0,1988.0,18.3,29,18,6,13,10,14,37,37.8,23,17,0,17,6,35,3,0,FW,30-34,Forward,Argentina,South America
688,Francesco Di Mariano,ITA,Venezia,Serie A,2021,25.0,1996.0,0.7,1,1,0,1,0,0,0,,0,2,1,1,0,1,0,0,FW,25-29,Forward,Italy,Europe
689,Francesco Di Tacchio,ITA,Salernitana,Serie A,2021,31.0,1990.0,13.9,17,7,5,10,2,9,25,36.0,16,16,8,8,22,39,25,0,MF,30-34,Midfielder,Italy,Europe
690,Boulaye Dia,SEN,Villarreal,La Liga,2021,24.0,1996.0,14.1,8,6,3,4,1,2,5,40.0,3,6,1,5,5,13,4,0,FW,20-24,Forward,Senegal,Africa
691,Moussa Diaby,FRA,Leverkusen,Bundesliga,2021,22.0,1999.0,30.7,20,11,8,9,3,5,38,13.2,33,11,0,11,8,28,2,0,"FW,MF",20-24,Forward,France,Europe
692,Yadaly Diaby,GUI,Clermont Foot,Ligue 1,2021,20.0,2000.0,0.7,0,0,0,0,0,0,1,0.0,1,0,0,0,2,2,2,0,"FW,MF",20-24,Forward,Guinea,Africa
693,Mouctar Diakhaby,GUI,Valencia,La Liga,2021,24.0,1996.0,21.6,35,24,18,15,2,13,23,56.5,10,29,17,12,30,65,87,3,DF,20-24,Defender,Guinea,Africa
694,Ibrahim Diakité,GUI,Reims,Ligue 1,2021,17.0,2003.0,0.0,0,0,0,0,0,0,1,0.0,1,0,0,0,0,0,0,0,MF,Under 20,Midfielder,Guinea,Africa
695,Abdou Diallo,SEN,Paris S-G,Ligue 1,2021,25.0,1996.0,9.7,22,14,10,9,3,8,14,57.1,6,6,2,4,10,32,19,1,DF,25-29,Defender,Senegal,Africa
696,Habib Diallo,SEN,Strasbourg,Ligue 1,2021,26.0,1995.0,17.1,9,5,0,8,1,0,8,0.0,8,13,4,9,4,13,11,0,FW,25-29,Forward,Senegal,Africa
697,Ibrahima Diallo,FRA,Southampton,Premier League,2021,22.0,1999.0,11.4,22,11,10,9,3,10,24,41.7,14,7,0,7,9,31,10,0,MF,20-24,Midfielder,France,Europe
697,Ibrahima Diallo,FRA,Southampton,Premier League,2021,22.0,1999.0,11.4,22,11,10,9,3,10,24,41.7,14,7,0,7,9,31,10,0,MF,20-24,Midfielder,France,Europe
697,Ibrahima Diallo,FRA,Southampton,Premier League,2021,22.0,1999.0,11.4,22,11,10,9,3,10,24,41.7,14,7,0,7,9,31,10,0,MF,20-24,Midfielder,France,Europe
697,Ibrahima Diallo,FRA,Southampton,Premier League,2021,22.0,1999.0,11.4,22,11,10,9,3,10,24,41.7,14,7,0,7,9,31,10,0,MF,20-24,Midfielder,France,Europe
697,Ibrahima Diallo,FRA,Southampton,Premier League,2021,22.0,1999.0,11.4,22,11,10,9,3,10,24,41.7,14,7,0,7,9,31,10,0,MF,20-24,Midfielder,France,Europe
697,Ibrahima Diallo,FRA,Southampton,Premier League,2021,22.0,1999.0,11.4,22,11,10,9,3,10,24,41.7,14,7,0,7,9,31,10,0,MF,20-24,Midfielder,France,Europe
697,Ibrahima Diallo,FRA,Southampton,Premier League,2021,22.0,1999.0,11.4,22,11,10,9,3,10,24,41.7,14,7,0,7,9,31,10,0,MF,20-24,Midfielder,France,Europe
697,Ibrahima Diallo,FRA,Southampton,Premier League,2021,22.0,1999.0,11.4,22,11,10,9,3,10,24,41.7,14,7,0,7,9,31,10,0,MF,20-24,Midfielder,France,Europe
697,Ibrahima Diallo,FRA,Southampton,Premier League,2021,22.0,1999.0,11.4,22,11,10,9,3,10,24,41.7,14,7,0,7,9,31,10,0,MF,20-24,Midfielder,France,Europe
698,Habib Diarra,SEN,Strasbourg,Ligue 1,2021,17.0,2004.0,1.2,2,1,1,1,0,1,1,100.0,0,0,0,0,0,2,0,0,MF,Under 20,Midfielder,Senegal,Africa
699,Stéphane Diarra,FRA,Lorient,Ligue 1,2021,22.0,1998.0,5.8,11,9,7,3,1,5,10,50.0,5,4,0,4,7,18,1,0,"MF,FW",20-24,Midfielder,France,Europe
700,Rúben Dias,POR,Manchester City,Premier League,2021,24.0,1997.0,26.7,26,19,11,12,3,8,15,53.3,7,19,13,6,23,49,66,0,DF,20-24,Defender,Portugal,Europe
701,Krépin Diatta,SEN,Monaco,Ligue 1,2021,22.0,1999.0,3.2,3,2,1,0,2,1,3,33.3,2,2,0,2,1,4,0,0,"MF,DF",20-24,Midfielder,Senegal,Africa
702,Amadou Diawara,GUI,Roma,Serie A,2021,24.0,1997.0,1.9,7,2,5,2,0,1,3,33.3,2,2,0,2,0,7,1,0,MF,20-24,Midfielder,Guinea,Africa
703,Brahim Díaz,MAR,Milan,Serie A,2021,21.0,1999.0,20.6,23,17,3,11,9,8,22,36.4,14,11,0,11,8,31,4,0,MF,20-24,Midfielder,Morocco,Africa
705,Luis Díaz,COL,Liverpool,Premier League,2021,24.0,1997.0,10.6,9,7,3,5,1,2,8,25.0,6,7,0,7,4,13,2,0,FW,20-24,Forward,Colombia,South America
707,Daniel Didavi,GER,Stuttgart,Bundesliga,2021,31.0,1990.0,3.1,6,2,0,4,2,4,7,57.1,3,4,1,3,1,7,1,0,"MF,FW",30-34,Midfielder,Germany,Europe
708,Bamba Dieng,SEN,Marseille,Ligue 1,2021,21.0,2000.0,10.8,17,11,5,5,7,4,14,28.6,10,7,0,7,5,22,8,0,FW,20-24,Forward,Senegal,Africa
709,Eric Dier,ENG,Tottenham,Premier League,2021,27.0,1994.0,34.1,15,9,6,8,1,7,14,50.0,7,37,32,5,27,42,142,1,DF,25-29,Defender,England,Europe
710,Elhadji Dieye,SEN,Saint-Étienne,Ligue 1,2021,19.0,2002.0,0.4,3,2,2,1,0,0,1,0.0,1,2,0,2,1,4,0,0,"FW,MF",Under 20,Forward,Senegal,Africa
711,Lucas Digne,FRA,Aston Villa,Premier League,2021,28.0,1993.0,14.1,13,10,8,3,2,9,19,47.4,10,15,8,7,23,36,40,0,DF,25-29,Defender,France,Europe
712,Lucas Digne,FRA,Everton,Premier League,2021,28.0,1993.0,13.0,33,19,26,4,3,21,28,75.0,7,16,5,11,14,47,30,0,DF,25-29,Defender,France,Europe
713,Mitchell Dijks,NED,Bologna,Serie A,2021,28.0,1993.0,7.7,15,6,6,6,3,5,12,41.7,7,11,2,9,3,18,10,1,"DF,FW",25-29,Defender,Netherlands,Europe
714,Javairô Dilrosun,NED,Bordeaux,Ligue 1,2021,23.0,1998.0,19.2,13,4,2,8,3,7,24,29.2,17,14,1,13,11,24,5,0,"MF,FW",20-24,Midfielder,Netherlands,Europe
715,Javairô Dilrosun,NED,Hertha BSC,Bundesliga,2021,23.0,1998.0,1.5,3,1,1,2,0,1,1,100.0,0,1,0,1,0,3,0,0,FW,20-24,Forward,Netherlands,Europe
716,Federico Dimarco,ITA,Inter,Serie A,2021,23.0,1997.0,15.9,28,15,10,15,3,13,24,54.2,11,6,1,5,19,47,19,0,DF,20-24,Defender,Italy,Europe
717,Landry Dimata,BEL,Espanyol,La Liga,2021,23.0,1997.0,6.0,2,2,1,1,0,1,4,25.0,3,0,0,0,1,3,7,0,"FW,MF",20-24,Forward,Belgium,Europe
718,Stole Dimitrievski,MKD,Rayo Vallecano,La Liga,2021,27.0,1993.0,30.8,0,0,0,0,0,0,0,,0,0,0,0,1,1,14,3,GK,25-29,Goalkeeper,North Macedonia,Europe
719,Junior Dina Ebimbe,FRA,Paris S-G,Ligue 1,2021,20.0,2000.0,3.5,9,4,3,4,2,2,3,66.7,1,5,3,2,2,11,1,0,MF,20-24,Midfielder,France,Europe
720,Tristan Dingomé,CMR,Troyes,Ligue 1,2021,30.0,1991.0,12.0,23,11,10,12,1,10,18,55.6,8,7,1,6,9,32,3,0,"MF,FW",30-34,Midfielder,Cameroon,Africa
721,Sinaly Diomande,CIV,Lyon,Ligue 1,2021,20.0,2001.0,6.4,6,3,4,2,0,5,6,83.3,1,6,6,0,12,18,26,0,DF,20-24,Defender,Ivory Coast,Africa
722,Issa Diop,FRA,West Ham,Premier League,2021,24.0,1997.0,10.7,10,8,5,5,0,4,11,36.4,7,14,13,1,7,17,44,0,DF,20-24,Defender,France,Europe
723,Sofiane Diop,FRA,Monaco,Ligue 1,2021,21.0,2000.0,21.6,38,20,12,19,7,15,47,31.9,32,10,0,10,23,61,4,0,"MF,FW",20-24,Midfielder,France,Europe
724,Andy Diouf,FRA,Rennes,Ligue 1,2021,18.0,2003.0,0.2,1,1,1,0,0,1,1,100.0,0,1,0,1,0,1,0,0,MF,Under 20,Midfielder,France,Europe
725,Assane Dioussé,SEN,Saint-Étienne,Ligue 1,2021,23.0,1997.0,0.3,1,1,1,0,0,1,1,100.0,0,0,0,0,0,1,0,0,MF,20-24,Midfielder,Senegal,Africa
726,Axel Disasi,FRA,Monaco,Ligue 1,2021,23.0,1998.0,30.2,42,27,20,21,1,23,39,59.0,16,40,30,10,26,68,75,0,DF,20-24,Defender,France,Europe
727,Filippo Distefano,ITA,Fiorentina,Serie A,2021,17.0,2003.0,0.0,0,0,0,0,0,0,0,,0,0,0,0,0,0,0,0,FW,Under 20,Forward,Italy,Europe
728,Matías Dituro,ARG,Celta Vigo,La Liga,2021,34.0,1987.0,38.0,0,0,0,0,0,0,0,,0,0,0,0,0,0,10,5,GK,30-34,Goalkeeper,Argentina,South America
729,Tiago Djaló,POR,Lille,Ligue 1,2021,21.0,2000.0,25.9,60,39,39,19,2,26,39,66.7,13,26,10,16,24,84,71,0,DF,20-24,Defender,Portugal,Europe
731,Moussa Djenepo,MLI,Southampton,Premier League,2021,23.0,1998.0,5.1,9,3,3,5,1,3,11,27.3,8,6,1,5,2,11,6,1,MF,20-24,Midfielder,Mali,Africa
732,Koffi Djidji,CIV,Torino,Serie A,2021,28.0,1992.0,19.3,48,29,21,23,4,14,18,77.8,4,20,9,11,34,82,60,0,DF,25-29,Defender,Ivory Coast,Africa
733,Alexander Djiku,GHA,Strasbourg,Ligue 1,2021,26.0,1994.0,29.9,50,37,33,13,4,18,35,51.4,17,30,13,17,61,111,90,2,DF,25-29,Defender,Ghana,Africa
734,Bryan Djile Nokoué,CMR,Saint-Étienne,Ligue 1,2021,19.0,2002.0,0.6,3,3,1,2,0,2,2,100.0,0,1,0,1,1,4,2,0,"DF,MF",Under 20,Defender,Cameroon,Africa
735,Berat Djimsiti,ALB,Atalanta,Serie A,2021,28.0,1993.0,25.1,43,24,21,20,2,29,46,63.0,17,21,11,10,31,74,56,0,DF,25-29,Defender,Albania,Europe
736,Ouparine Djoco,GNB,Clermont Foot,Ligue 1,2021,23.0,1998.0,23.5,0,0,0,0,0,0,0,,0,0,0,0,1,1,14,2,GK,20-24,Goalkeeper,Guinea-Bissau,Africa
737,Naïs Djouahra,FRA,Real Sociedad,La Liga,2021,21.0,1999.0,2.4,7,3,2,2,3,4,8,50.0,4,3,0,3,2,9,2,0,"FW,MF",20-24,Forward,France,Europe
739,Lewis Dobbin,ENG,Everton,Premier League,2021,18.0,2003.0,0.4,2,1,0,1,1,1,2,50.0,1,0,0,0,0,2,0,0,"FW,MF",Under 20,Forward,England,Europe
740,Matt Doherty,IRL,Tottenham,Premier League,2021,29.0,1992.0,9.7,18,12,5,11,2,8,14,57.1,6,11,2,9,13,31,20,0,DF,25-29,Defender,Republic of Ireland,Europe
741,Jeremy Doku,BEL,Rennes,Ligue 1,2021,19.0,2002.0,5.2,10,5,3,5,2,3,6,50.0,3,4,0,4,3,13,0,0,"FW,MF",Under 20,Forward,Belgium,Europe
742,Kasper Dolberg,DEN,Nice,Ligue 1,2021,23.0,1997.0,16.6,9,4,4,3,2,3,9,33.3,6,15,1,14,6,15,17,0,FW,20-24,Forward,Denmark,Europe
744,Brandon Domingues,FRA,Troyes,Ligue 1,2021,21.0,2000.0,2.6,6,2,2,4,0,2,3,66.7,1,3,0,3,3,9,0,0,"MF,FW",20-24,Midfielder,France,Europe
747,Nicolás Domínguez,ARG,Bologna,Serie A,2021,23.0,1998.0,22.4,76,45,36,32,8,32,76,42.1,44,38,9,29,32,108,34,1,MF,20-24,Midfielder,Argentina,South America
749,Lee Dongjun,KOR,Hertha BSC,Bundesliga,2021,24.0,1997.0,1.3,2,1,0,2,0,1,3,33.3,2,2,0,2,2,4,1,0,"MF,FW",20-24,Midfielder,South Korea,Asia
750,Anastasios Donis,GRE,Reims,Ligue 1,2021,24.0,1996.0,4.1,8,7,4,2,2,2,6,33.3,4,3,0,3,0,8,1,0,"FW,MF",20-24,Forward,Greece,Europe
751,Gianluigi Donnarumma,ITA,Paris S-G,Ligue 1,2021,22.0,1999.0,17.0,0,0,0,0,0,0,0,,0,0,0,0,0,0,9,2,GK,20-24,Goalkeeper,Italy,Europe
752,Niklas Dorsch,GER,Augsburg,Bundesliga,2021,23.0,1998.0,25.8,76,47,47,23,6,30,60,50.0,30,34,12,22,35,111,36,3,MF,20-24,Midfielder,Germany,Europe
753,Jodel Dossou,BEN,Clermont Foot,Ligue 1,2021,29.0,1992.0,22.3,36,17,15,14,7,15,43,34.9,28,14,0,14,5,41,7,0,FW,25-29,Forward,Benin,Africa
754,Lohann Doucet,FRA,Nantes,Ligue 1,2021,18.0,2002.0,0.1,0,0,0,0,0,0,0,,0,0,0,0,1,1,0,0,"MF,DF",Under 20,Midfielder,France,Europe
755,Abdoulaye Doucouré,MLI,Everton,Premier League,2021,28.0,1993.0,28.2,75,43,30,37,8,32,71,45.1,39,33,8,25,28,103,32,0,MF,25-29,Midfielder,Mali,Africa
756,Cheick Doucouré,MLI,Lens,Ligue 1,2021,21.0,2000.0,32.7,75,43,34,34,7,35,79,44.3,44,30,7,23,68,143,24,0,MF,20-24,Midfielder,Mali,Africa
757,Fodé Doucouré,MLI,Reims,Ligue 1,2021,20.0,2001.0,1.7,12,9,9,3,0,9,11,81.8,2,1,0,1,4,16,6,0,"DF,FW",20-24,Defender,Mali,Africa
758,Ismaël Doukouré,FRA,Strasbourg,Ligue 1,2021,18.0,2003.0,0.2,0,0,0,0,0,0,0,,0,0,0,0,0,0,1,0,DF,Under 20,Defender,France,Europe
759,Kamory Doumbia,MLI,Reims,Ligue 1,2021,18.0,2003.0,3.9,8,2,2,5,1,5,13,38.5,8,9,3,6,3,11,3,0,"MF,FW",Under 20,Midfielder,Mali,Africa
760,Moussa Doumbia,MLI,Reims,Ligue 1,2021,26.0,1994.0,1.0,0,0,0,0,0,0,1,0.0,1,0,0,0,0,0,0,0,FW,25-29,Forward,Mali,Africa
761,Souleyman Doumbia,CIV,Angers,Ligue 1,2021,24.0,1996.0,24.7,30,20,16,9,5,13,27,48.1,14,25,4,21,39,69,51,0,"DF,FW",20-24,Defender,Ivory Coast,Africa
762,Kieran Dowell,ENG,Norwich City,Premier League,2021,23.0,1997.0,10.1,18,7,8,7,3,9,32,28.1,23,10,1,9,7,25,4,0,"FW,MF",20-24,Forward,England,Europe
764,Radu Drăgușin,ROU,Sampdoria,Serie A,2021,19.0,2002.0,6.9,4,3,2,2,0,2,6,33.3,4,8,4,4,10,14,33,0,DF,Under 20,Defender,Romania,Europe
765,Radu Drăgușin,ROU,Salernitana,Serie A,2021,19.0,2002.0,5.4,5,4,2,3,0,4,10,40.0,6,7,3,4,13,18,17,0,DF,Under 20,Defender,Romania,Europe
766,Cody Drameh,ENG,Leeds United,Premier League,2021,19.0,2001.0,1.4,4,2,3,1,0,1,3,33.3,2,0,0,0,1,5,4,0,"DF,MF",Under 20,Defender,England,Europe
767,Julian Draxler,GER,Paris S-G,Ligue 1,2021,27.0,1993.0,6.1,3,2,0,3,0,0,4,0.0,4,3,0,3,5,8,3,0,"FW,MF",25-29,Forward,Germany,Europe
768,Matthieu Dreyer,FRA,Lorient,Ligue 1,2021,32.0,1989.0,16.0,1,1,1,0,0,1,1,100.0,0,0,0,0,0,1,9,0,GK,30-34,Goalkeeper,France,Europe
769,Domingos Duarte,POR,Granada,La Liga,2021,26.0,1995.0,18.7,18,14,9,9,0,6,11,54.5,5,27,20,7,22,40,82,0,DF,25-29,Defender,Portugal,Europe
770,Óscar Duarte,CRC,Levante,La Liga,2021,32.0,1989.0,19.7,18,8,12,6,0,8,23,34.8,15,18,9,9,24,42,102,0,DF,30-34,Defender,Costa Rica,North America
772,Leo Dubois,FRA,Lyon,Ligue 1,2021,26.0,1994.0,19.4,43,27,22,14,7,27,46,58.7,19,27,3,24,22,65,35,1,DF,25-29,Defender,France,Europe
773,Martin Dúbravka,SVK,Newcastle Utd,Premier League,2021,32.0,1989.0,26.0,1,1,1,0,0,0,1,0.0,1,0,0,0,0,1,8,2,GK,30-34,Goalkeeper,Slovakia,Europe
774,Ondrej Duda,SVK,Köln,Bundesliga,2021,26.0,1994.0,17.9,23,16,4,12,7,6,23,26.1,17,14,2,12,17,40,9,0,"MF,FW",25-29,Midfielder,Slovakia,Europe
775,Jeremy Dudziak,TUN,Greuther Fürth,Bundesliga,2021,25.0,1995.0,12.6,17,6,5,8,4,3,14,21.4,11,8,0,8,10,27,4,0,"MF,FW",25-29,Midfielder,Tunisia,Africa
776,Shane Duffy,IRL,Brighton,Premier League,2021,29.0,1992.0,16.0,15,12,12,3,0,8,14,57.1,6,24,18,6,16,31,76,1,DF,25-29,Defender,Republic of Ireland,Europe
778,Denzel Dumfries,NED,Inter,Serie A,2021,25.0,1996.0,22.5,32,12,9,14,9,16,32,50.0,16,15,6,9,9,41,26,0,DF,25-29,Defender,Netherlands,Europe
779,Paul Dummett,WAL,Newcastle Utd,Premier League,2021,29.0,1991.0,2.2,7,3,3,4,0,5,8,62.5,3,5,0,5,3,10,5,0,DF,25-29,Defender,Wales,Europe
780,Alfred Duncan,GHA,Fiorentina,Serie A,2021,28.0,1993.0,21.5,34,19,13,16,5,11,32,34.4,21,32,3,29,10,44,7,0,MF,25-29,Midfielder,Ghana,Africa
781,Lewis Dunk,ENG,Brighton,Premier League,2021,29.0,1991.0,28.6,10,8,5,5,0,5,11,45.5,6,32,28,4,27,37,113,3,DF,25-29,Defender,England,Europe
782,Erik Durm,GER,Eint Frankfurt,Bundesliga,2021,29.0,1992.0,5.3,13,7,6,5,2,10,13,76.9,3,8,1,7,10,23,7,0,DF,25-29,Defender,Germany,Europe
785,Jean-Kevin Duverne,HAI,Brest,Ligue 1,2021,24.0,1997.0,33.4,71,44,43,21,7,42,90,46.7,48,40,5,35,53,124,92,0,DF,20-24,Defender,Haiti,North America
786,Paulo Dybala,ARG,Juventus,Serie A,2021,27.0,1993.0,22.9,30,13,7,14,9,8,35,22.9,27,19,0,19,9,39,4,3,"FW,MF",25-29,Forward,Argentina,South America
787,Edin Džeko,BIH,Inter,Serie A,2021,35.0,1986.0,27.4,14,8,7,4,3,8,25,32.0,17,22,5,17,4,18,35,0,FW,35-39,Forward,Bosnia and Herzegovina,Europe
788,Enzo Ebosse,CMR,Angers,Ligue 1,2021,22.0,1999.0,21.0,25,14,19,6,0,11,19,57.9,8,19,9,10,15,40,42,0,DF,20-24,Defender,Cameroon,Africa
789,Tyronne Ebuehi,NGA,Venezia,Serie A,2021,25.0,1995.0,12.6,28,12,16,8,4,10,18,55.6,8,13,3,10,16,44,38,1,DF,25-29,Defender,Nigeria,Africa
790,Ederson,BRA,Manchester City,Premier League,2021,27.0,1993.0,37.0,2,1,2,0,0,0,2,0.0,2,0,0,0,0,2,12,0,GK,25-29,Goalkeeper,Brazil,South America
790,Ederson,BRA,Manchester City,Premier League,2021,27.0,1993.0,37.0,2,1,2,0,0,0,2,0.0,2,0,0,0,0,2,12,0,GK,25-29,Goalkeeper,Brazil,South America
790,Ederson,BRA,Manchester City,Premier League,2021,27.0,1993.0,37.0,2,1,2,0,0,0,2,0.0,2,0,0,0,0,2,12,0,GK,25-29,Goalkeeper,Brazil,South America
790,Ederson,BRA,Manchester City,Premier League,2021,27.0,1993.0,37.0,2,1,2,0,0,0,2,0.0,2,0,0,0,0,2,12,0,GK,25-29,Goalkeeper,Brazil,South America
791,Éderson,BRA,Salernitana,Serie A,2021,22.0,1999.0,12.7,29,18,11,14,4,14,26,53.8,12,11,2,9,19,48,8,0,MF,20-24,Midfielder,Brazil,South America
792,Odsonne Édouard,FRA,Crystal Palace,Premier League,2021,23.0,1998.0,17.4,16,10,2,7,7,7,21,33.3,14,20,5,15,0,16,18,0,FW,20-24,Forward,France,Europe
793,CJ Egan-Riley,ENG,Manchester City,Premier League,2021,18.0,2003.0,0.0,1,1,1,0,0,1,1,100.0,0,0,0,0,0,1,0,0,DF,Under 20,Defender,England,Europe
794,Maximilian Eggestein,GER,Freiburg,Bundesliga,2021,24.0,1996.0,24.4,48,28,17,25,6,22,50,44.0,28,35,11,24,30,78,32,1,MF,20-24,Midfielder,Germany,Europe
795,Lilian Egloff,GER,Stuttgart,Bundesliga,2021,18.0,2002.0,0.3,1,0,0,1,0,0,0,,0,1,0,1,0,1,0,0,"MF,DF",Under 20,Midfielder,Germany,Europe
796,Kingsley Ehizibue,NED,Köln,Bundesliga,2021,26.0,1995.0,7.6,32,18,27,5,0,15,24,62.5,9,13,4,9,9,41,26,0,DF,25-29,Defender,Netherlands,Europe
797,Julian Eitschberger,GER,Hertha BSC,Bundesliga,2021,17.0,2004.0,0.5,0,0,0,0,0,0,1,0.0,1,1,1,0,2,2,2,0,DF,Under 20,Defender,Germany,Europe
798,Albin Ekdal,SWE,Sampdoria,Serie A,2021,32.0,1989.0,18.2,43,28,17,21,5,26,56,46.4,30,27,7,20,29,72,25,0,MF,30-34,Midfielder,Sweden,Europe
799,Hugo Ekitike,FRA,Reims,Ligue 1,2021,19.0,2002.0,14.1,18,10,8,6,4,4,11,36.4,7,9,2,7,6,24,15,0,FW,Under 20,Forward,France,Europe
800,Jurgen Ekkelenkamp,NED,Hertha BSC,Bundesliga,2021,21.0,2000.0,8.0,8,3,2,6,0,2,7,28.6,5,9,2,7,4,12,5,0,"MF,FW",20-24,Midfielder,Netherlands,Europe
801,Caleb Ekuban,GHA,Genoa,Serie A,2021,27.0,1994.0,19.1,19,12,2,12,5,7,23,30.4,16,19,5,14,9,28,6,0,"FW,MF",25-29,Forward,Ghana,Africa
802,Anthony Elanga,SWE,Manchester Utd,Premier League,2021,19.0,2002.0,13.5,26,20,12,12,2,15,29,51.7,14,17,1,16,9,35,7,0,FW,Under 20,Forward,Sweden,Europe
804,Harvey Elliott,ENG,Liverpool,Premier League,2021,18.0,2003.0,3.8,3,0,1,1,1,0,6,0.0,6,8,1,7,4,7,2,0,MF,Under 20,Midfielder,England,Europe
805,Elif Elmas,MKD,Napoli,Serie A,2021,21.0,1999.0,18.0,25,15,10,10,5,12,28,42.9,16,13,2,11,8,33,17,0,"FW,MF",20-24,Forward,North Macedonia,Europe
806,Mohamed Elneny,EGY,Arsenal,Premier League,2021,29.0,1992.0,9.0,16,8,10,5,1,7,12,58.3,5,7,1,6,14,30,13,0,MF,25-29,Midfielder,Egypt,Africa
808,Nico Elvedi,SUI,Gladbach,Bundesliga,2021,24.0,1996.0,27.0,40,24,23,17,0,22,36,61.1,14,33,22,11,34,74,83,1,DF,20-24,Defender,Switzerland,Europe
811,Breel Embolo,SUI,Gladbach,Bundesliga,2021,24.0,1997.0,24.1,16,11,1,12,3,3,8,37.5,5,14,2,12,6,22,7,0,FW,20-24,Forward,Switzerland,Europe
812,Emerson,BRA,Tottenham,Premier League,2021,22.0,1999.0,25.4,72,47,50,16,6,36,67,53.7,31,25,2,23,22,94,92,1,"DF,MF",20-24,Defender,Brazil,South America
813,Emerson,BRA,Barcelona,La Liga,2021,22.0,1999.0,1.0,3,3,2,1,0,1,2,50.0,1,1,0,1,2,5,1,0,DF,20-24,Defender,Brazil,South America
814,Renaud Emond,BEL,Nantes,Ligue 1,2021,29.0,1991.0,2.1,1,0,0,1,0,0,4,0.0,4,2,1,1,0,1,1,0,"FW,MF",25-29,Forward,Belgium,Europe
815,Youssef En-Nesyri,MAR,Sevilla,La Liga,2021,24.0,1997.0,14.2,10,5,5,2,3,4,11,36.4,7,9,1,8,4,14,18,0,FW,20-24,Forward,Morocco,Africa
816,Keita Endo,JPN,Union Berlin,Bundesliga,2021,23.0,1997.0,0.6,1,1,1,0,0,0,0,,0,1,0,1,0,1,0,0,MF,20-24,Midfielder,Japan,Asia
817,Wataru Endo,JPN,Stuttgart,Bundesliga,2021,28.0,1993.0,32.2,73,41,34,34,5,31,72,43.1,41,43,12,31,30,103,64,0,MF,25-29,Midfielder,Japan,Asia
818,Christian Eriksen,DEN,Brentford,Premier League,2021,29.0,1992.0,10.4,13,6,4,5,4,8,17,47.1,9,9,1,8,9,22,14,0,MF,25-29,Midfielder,Denmark,Europe
819,Martin Erlic,CRO,Spezia,Serie A,2021,23.0,1998.0,28.6,28,16,18,10,0,10,18,55.6,8,54,39,15,28,56,122,1,DF,20-24,Defender,Croatia,Europe
820,Gonzalo Escalante,ARG,Lazio,Serie A,2021,28.0,1993.0,0.1,1,0,1,0,0,1,1,100.0,0,2,1,1,1,2,0,0,MF,25-29,Midfielder,Argentina,South America
821,Gonzalo Escalante,ARG,Alavés,La Liga,2021,28.0,1993.0,14.4,30,14,9,20,1,13,34,38.2,21,27,2,25,21,51,28,0,MF,25-29,Midfielder,Argentina,South America
824,Alfonso Espino,URU,Cádiz,La Liga,2021,29.0,1992.0,37.0,107,63,58,39,10,44,112,39.3,68,45,10,35,54,161,87,1,DF,25-29,Defender,Uruguay,South America
825,Michael Esser,GER,Bochum,Bundesliga,2021,33.0,1987.0,3.0,0,0,0,0,0,0,1,0.0,1,0,0,0,0,0,2,0,GK,30-34,Goalkeeper,Germany,Europe
827,Maxime Estève,FRA,Montpellier,Ligue 1,2021,19.0,2002.0,20.6,27,18,22,4,1,15,27,55.6,12,31,24,7,22,49,69,1,DF,Under 20,Defender,France,Europe
828,Pervis Estupiñán,ECU,Villarreal,La Liga,2021,23.0,1998.0,17.5,36,22,20,11,5,17,24,70.8,7,13,5,8,25,61,29,2,DF,20-24,Defender,Ecuador,South America
829,Oghenekaro Etebo,NGA,Watford,Premier League,2021,25.0,1995.0,4.5,11,8,7,4,0,3,8,37.5,5,3,1,2,5,16,5,0,MF,25-29,Midfielder,Nigeria,Africa
831,Eberechi Eze,ENG,Crystal Palace,Premier League,2021,23.0,1998.0,6.7,10,6,5,2,3,6,11,54.5,5,4,1,3,5,15,1,0,"MF,FW",20-24,Midfielder,England,Europe
832,Abde Ezzalzouli,MAR,Barcelona,La Liga,2021,19.0,2001.0,6.4,17,9,9,5,3,5,8,62.5,3,3,0,3,9,26,0,0,FW,Under 20,Forward,Morocco,Africa
834,Fabinho,BRA,Liverpool,Premier League,2021,27.0,1993.0,25.7,46,25,17,23,6,24,70,34.3,46,33,10,23,39,85,25,1,MF,25-29,Midfielder,Brazil,South America
834,Fabinho,BRA,Liverpool,Premier League,2021,27.0,1993.0,25.7,46,25,17,23,6,24,70,34.3,46,33,10,23,39,85,25,1,MF,25-29,Midfielder,Brazil,South America
834,Fabinho,BRA,Liverpool,Premier League,2021,27.0,1993.0,25.7,46,25,17,23,6,24,70,34.3,46,33,10,23,39,85,25,1,MF,25-29,Midfielder,Brazil,South America
834,Fabinho,BRA,Liverpool,Premier League,2021,27.0,1993.0,25.7,46,25,17,23,6,24,70,34.3,46,33,10,23,39,85,25,1,MF,25-29,Midfielder,Brazil,South America
834,Fabinho,BRA,Liverpool,Premier League,2021,27.0,1993.0,25.7,46,25,17,23,6,24,70,34.3,46,33,10,23,39,85,25,1,MF,25-29,Midfielder,Brazil,South America
834,Fabinho,BRA,Liverpool,Premier League,2021,27.0,1993.0,25.7,46,25,17,23,6,24,70,34.3,46,33,10,23,39,85,25,1,MF,25-29,Midfielder,Brazil,South America
834,Fabinho,BRA,Liverpool,Premier League,2021,27.0,1993.0,25.7,46,25,17,23,6,24,70,34.3,46,33,10,23,39,85,25,1,MF,25-29,Midfielder,Brazil,South America
834,Fabinho,BRA,Liverpool,Premier League,2021,27.0,1993.0,25.7,46,25,17,23,6,24,70,34.3,46,33,10,23,39,85,25,1,MF,25-29,Midfielder,Brazil,South America
834,Fabinho,BRA,Liverpool,Premier League,2021,27.0,1993.0,25.7,46,25,17,23,6,24,70,34.3,46,33,10,23,39,85,25,1,MF,25-29,Midfielder,Brazil,South America
834,Fabinho,BRA,Liverpool,Premier League,2021,27.0,1993.0,25.7,46,25,17,23,6,24,70,34.3,46,33,10,23,39,85,25,1,MF,25-29,Midfielder,Brazil,South America
834,Fabinho,BRA,Liverpool,Premier League,2021,27.0,1993.0,25.7,46,25,17,23,6,24,70,34.3,46,33,10,23,39,85,25,1,MF,25-29,Midfielder,Brazil,South America
834,Fabinho,BRA,Liverpool,Premier League,2021,27.0,1993.0,25.7,46,25,17,23,6,24,70,34.3,46,33,10,23,39,85,25,1,MF,25-29,Midfielder,Brazil,South America
834,Fabinho,BRA,Liverpool,Premier League,2021,27.0,1993.0,25.7,46,25,17,23,6,24,70,34.3,46,33,10,23,39,85,25,1,MF,25-29,Midfielder,Brazil,South America
834,Fabinho,BRA,Liverpool,Premier League,2021,27.0,1993.0,25.7,46,25,17,23,6,24,70,34.3,46,33,10,23,39,85,25,1,MF,25-29,Midfielder,Brazil,South America
834,Fabinho,BRA,Liverpool,Premier League,2021,27.0,1993.0,25.7,46,25,17,23,6,24,70,34.3,46,33,10,23,39,85,25,1,MF,25-29,Midfielder,Brazil,South America
834,Fabinho,BRA,Liverpool,Premier League,2021,27.0,1993.0,25.7,46,25,17,23,6,24,70,34.3,46,33,10,23,39,85,25,1,MF,25-29,Midfielder,Brazil,South America
834,Fabinho,BRA,Liverpool,Premier League,2021,27.0,1993.0,25.7,46,25,17,23,6,24,70,34.3,46,33,10,23,39,85,25,1,MF,25-29,Midfielder,Brazil,South America
834,Fabinho,BRA,Liverpool,Premier League,2021,27.0,1993.0,25.7,46,25,17,23,6,24,70,34.3,46,33,10,23,39,85,25,1,MF,25-29,Midfielder,Brazil,South America
834,Fabinho,BRA,Liverpool,Premier League,2021,27.0,1993.0,25.7,46,25,17,23,6,24,70,34.3,46,33,10,23,39,85,25,1,MF,25-29,Midfielder,Brazil,South America
834,Fabinho,BRA,Liverpool,Premier League,2021,27.0,1993.0,25.7,46,25,17,23,6,24,70,34.3,46,33,10,23,39,85,25,1,MF,25-29,Midfielder,Brazil,South America
834,Fabinho,BRA,Liverpool,Premier League,2021,27.0,1993.0,25.7,46,25,17,23,6,24,70,34.3,46,33,10,23,39,85,25,1,MF,25-29,Midfielder,Brazil,South America
834,Fabinho,BRA,Liverpool,Premier League,2021,27.0,1993.0,25.7,46,25,17,23,6,24,70,34.3,46,33,10,23,39,85,25,1,MF,25-29,Midfielder,Brazil,South America
834,Fabinho,BRA,Liverpool,Premier League,2021,27.0,1993.0,25.7,46,25,17,23,6,24,70,34.3,46,33,10,23,39,85,25,1,MF,25-29,Midfielder,Brazil,South America
834,Fabinho,BRA,Liverpool,Premier League,2021,27.0,1993.0,25.7,46,25,17,23,6,24,70,34.3,46,33,10,23,39,85,25,1,MF,25-29,Midfielder,Brazil,South America
834,Fabinho,BRA,Liverpool,Premier League,2021,27.0,1993.0,25.7,46,25,17,23,6,24,70,34.3,46,33,10,23,39,85,25,1,MF,25-29,Midfielder,Brazil,South America
835,Fábio,BRA,Nantes,Ligue 1,2021,31.0,1990.0,18.5,61,40,31,23,7,36,74,48.6,38,29,7,22,35,96,31,1,DF,30-34,Defender,Brazil,South America
837,Wout Faes,BEL,Reims,Ligue 1,2021,23.0,1998.0,37.0,40,24,30,9,1,25,33,75.8,8,47,37,10,53,93,169,2,DF,20-24,Defender,Belgium,Europe
838,Wahid Faghir,DEN,Stuttgart,Bundesliga,2021,18.0,2003.0,1.4,0,0,0,0,0,0,1,0.0,1,2,0,2,0,0,0,0,FW,Under 20,Forward,Denmark,Europe
839,Romain Faivre,FRA,Lyon,Ligue 1,2021,23.0,1998.0,9.9,10,4,2,6,2,4,13,30.8,9,4,0,4,3,13,2,0,"FW,MF",20-24,Forward,France,Europe
840,Romain Faivre,FRA,Brest,Ligue 1,2021,23.0,1998.0,19.9,30,18,12,13,5,12,30,40.0,18,11,0,11,13,43,10,0,MF,20-24,Midfielder,France,Europe
841,Radamel Falcao,COL,Rayo Vallecano,La Liga,2021,35.0,1986.0,9.3,2,1,0,1,1,1,4,25.0,3,4,1,3,2,4,11,0,FW,35-39,Forward,Colombia,South America
842,Diego Falcinelli,ITA,Bologna,Serie A,2021,30.0,1991.0,0.7,2,2,2,0,0,0,0,,0,0,0,0,1,3,1,0,FW,30-34,Forward,Italy,Europe
843,Wladimiro Falcone,ITA,Sampdoria,Serie A,2021,26.0,1995.0,9.5,0,0,0,0,0,0,0,,0,0,0,0,1,1,5,0,GK,25-29,Goalkeeper,Italy,Europe
845,Paolo Faragò,ITA,Cagliari,Serie A,2021,28.0,1993.0,0.2,1,1,1,0,0,0,0,,0,2,0,2,0,1,0,0,MF,25-29,Midfielder,Italy,Europe
846,Omar Faraj,PLE,Levante,La Liga,2021,19.0,2002.0,0.0,1,0,1,0,0,1,1,100.0,0,0,0,0,0,1,0,0,FW,Under 20,Forward,Palestine,Asia
847,Davide Faraoni,ITA,Hellas Verona,Serie A,2021,29.0,1991.0,28.6,62,40,38,21,3,29,62,46.8,33,38,5,33,23,85,62,1,DF,25-29,Defender,Italy,Europe
848,Mohamed Fares,ALG,Genoa,Serie A,2021,25.0,1996.0,6.5,4,2,1,3,0,0,4,0.0,4,8,3,5,8,12,11,0,"DF,FW",25-29,Defender,Algeria,Africa
849,Diego Farias,BRA,Cagliari,Serie A,2021,31.0,1990.0,0.7,1,1,0,1,0,1,3,33.3,2,0,0,0,0,1,0,0,"MF,FW",30-34,Midfielder,Brazil,South America
850,Wuilker Faríñez,VEN,Lens,Ligue 1,2021,23.0,1998.0,12.3,0,0,0,0,0,0,0,,0,0,0,0,0,0,4,0,GK,20-24,Goalkeeper,Venezuela,South America
851,Ömer Faruk Beyaz,TUR,Stuttgart,Bundesliga,2021,17.0,2003.0,0.8,4,3,1,3,0,1,5,20.0,4,0,0,0,2,6,0,0,"DF,MF",Under 20,Defender,Turkey,Asia
852,Noah Fatar,FRA,Angers,Ligue 1,2021,19.0,2002.0,0.1,1,0,0,0,1,0,1,0.0,1,0,0,0,1,2,0,0,"DF,MF",Under 20,Defender,France,Europe
854,Julien Faussurier,FRA,Brest,Ligue 1,2021,34.0,1987.0,5.4,10,6,3,3,4,6,13,46.2,7,12,1,11,5,15,6,0,"MF,DF",30-34,Midfielder,France,Europe
855,Andrea Favilli,ITA,Genoa,Serie A,2021,24.0,1997.0,0.4,1,1,0,0,1,0,0,,0,0,0,0,0,1,2,0,FW,20-24,Forward,Italy,Europe
856,Federico Fazio,ARG,Salernitana,Serie A,2021,34.0,1987.0,15.9,17,11,10,6,1,9,12,75.0,3,21,16,5,27,44,67,1,DF,30-34,Defender,Argentina,South America
858,Peter Federico,DOM,Real Madrid,La Liga,2021,19.0,2002.0,0.3,0,0,0,0,0,0,0,,0,0,0,0,1,1,0,0,"MF,DF",Under 20,Midfielder,Dominican Republic,North America
859,Adrian Fein,GER,Greuther Fürth,Bundesliga,2021,22.0,1999.0,0.4,0,0,0,0,0,0,1,0.0,1,0,0,0,2,2,0,0,MF,20-24,Midfielder,Germany,Europe
860,Nabil Fekir,FRA,Betis,La Liga,2021,28.0,1993.0,31.0,43,29,5,25,13,7,36,19.4,29,14,0,14,7,50,7,0,MF,25-29,Midfielder,France,Europe
861,Felipe,BRA,Atlético Madrid,La Liga,2021,32.0,1989.0,16.7,20,15,11,8,1,8,18,44.4,10,17,11,6,28,48,77,0,DF,30-34,Defender,Brazil,South America
861,Felipe,BRA,Atlético Madrid,La Liga,2021,32.0,1989.0,16.7,20,15,11,8,1,8,18,44.4,10,17,11,6,28,48,77,0,DF,30-34,Defender,Brazil,South America
861,Felipe,BRA,Atlético Madrid,La Liga,2021,32.0,1989.0,16.7,20,15,11,8,1,8,18,44.4,10,17,11,6,28,48,77,0,DF,30-34,Defender,Brazil,South America
861,Felipe,BRA,Atlético Madrid,La Liga,2021,32.0,1989.0,16.7,20,15,11,8,1,8,18,44.4,10,17,11,6,28,48,77,0,DF,30-34,Defender,Brazil,South America
862,Luiz Felipe,ITA,Lazio,Serie A,2021,24.0,1997.0,27.7,41,23,21,16,4,20,34,58.8,14,40,33,7,33,74,102,1,DF,20-24,Defender,Italy,Europe
862,Luiz Felipe,ITA,Lazio,Serie A,2021,24.0,1997.0,27.7,41,23,21,16,4,20,34,58.8,14,40,33,7,33,74,102,1,DF,20-24,Defender,Italy,Europe
862,Luiz Felipe,ITA,Lazio,Serie A,2021,24.0,1997.0,27.7,41,23,21,16,4,20,34,58.8,14,40,33,7,33,74,102,1,DF,20-24,Defender,Italy,Europe
862,Luiz Felipe,ITA,Lazio,Serie A,2021,24.0,1997.0,27.7,41,23,21,16,4,20,34,58.8,14,40,33,7,33,74,102,1,DF,20-24,Defender,Italy,Europe
863,João Félix,POR,Atlético Madrid,La Liga,2021,21.0,1999.0,14.0,5,2,1,4,0,1,5,20.0,4,4,1,3,7,12,8,0,"FW,MF",20-24,Forward,Portugal,Europe
864,Ohis Felix Uduokhai,GER,Augsburg,Bundesliga,2021,23.0,1997.0,8.7,9,6,6,3,0,6,11,54.5,5,13,8,5,9,18,33,0,DF,20-24,Defender,Germany,Europe
866,Evan Ferguson,IRL,Brighton,Premier League,2021,16.0,2004.0,0.3,0,0,0,0,0,0,0,,0,0,0,0,0,0,0,0,MF,Under 20,Midfielder,Republic of Ireland,Europe
867,Nathan Ferguson,ENG,Crystal Palace,Premier League,2021,20.0,2000.0,0.1,0,0,0,0,0,0,0,,0,0,0,0,0,0,0,0,DF,20-24,Defender,England,Europe
868,Bruno Fernandes,POR,Manchester Utd,Premier League,2021,26.0,1994.0,34.6,54,28,26,22,6,26,91,28.6,65,36,0,36,17,71,42,2,MF,25-29,Midfielder,Portugal,Europe
869,Edimilson Fernandes,SUI,Arminia,Bundesliga,2021,25.0,1996.0,3.1,2,0,1,1,0,1,4,25.0,3,2,2,0,2,4,6,0,"MF,FW",25-29,Midfielder,Switzerland,Europe
873,Federico Fernández,ARG,Newcastle Utd,Premier League,2021,32.0,1989.0,5.8,3,0,3,0,0,2,5,40.0,3,10,10,0,4,7,28,0,DF,30-34,Defender,Argentina,South America
874,Fernandinho,BRA,Manchester City,Premier League,2021,36.0,1985.0,10.7,21,10,7,10,4,9,27,33.3,18,8,2,6,8,29,13,1,"MF,DF",35-39,Midfielder,Brazil,South America
874,Fernandinho,BRA,Manchester City,Premier League,2021,36.0,1985.0,10.7,21,10,7,10,4,9,27,33.3,18,8,2,6,8,29,13,1,"MF,DF",35-39,Midfielder,Brazil,South America
874,Fernandinho,BRA,Manchester City,Premier League,2021,36.0,1985.0,10.7,21,10,7,10,4,9,27,33.3,18,8,2,6,8,29,13,1,"MF,DF",35-39,Midfielder,Brazil,South America
874,Fernandinho,BRA,Manchester City,Premier League,2021,36.0,1985.0,10.7,21,10,7,10,4,9,27,33.3,18,8,2,6,8,29,13,1,"MF,DF",35-39,Midfielder,Brazil,South America
874,Fernandinho,BRA,Manchester City,Premier League,2021,36.0,1985.0,10.7,21,10,7,10,4,9,27,33.3,18,8,2,6,8,29,13,1,"MF,DF",35-39,Midfielder,Brazil,South America
874,Fernandinho,BRA,Manchester City,Premier League,2021,36.0,1985.0,10.7,21,10,7,10,4,9,27,33.3,18,8,2,6,8,29,13,1,"MF,DF",35-39,Midfielder,Brazil,South America
874,Fernandinho,BRA,Manchester City,Premier League,2021,36.0,1985.0,10.7,21,10,7,10,4,9,27,33.3,18,8,2,6,8,29,13,1,"MF,DF",35-39,Midfielder,Brazil,South America
874,Fernandinho,BRA,Manchester City,Premier League,2021,36.0,1985.0,10.7,21,10,7,10,4,9,27,33.3,18,8,2,6,8,29,13,1,"MF,DF",35-39,Midfielder,Brazil,South America
874,Fernandinho,BRA,Manchester City,Premier League,2021,36.0,1985.0,10.7,21,10,7,10,4,9,27,33.3,18,8,2,6,8,29,13,1,"MF,DF",35-39,Midfielder,Brazil,South America
874,Fernandinho,BRA,Manchester City,Premier League,2021,36.0,1985.0,10.7,21,10,7,10,4,9,27,33.3,18,8,2,6,8,29,13,1,"MF,DF",35-39,Midfielder,Brazil,South America
874,Fernandinho,BRA,Manchester City,Premier League,2021,36.0,1985.0,10.7,21,10,7,10,4,9,27,33.3,18,8,2,6,8,29,13,1,"MF,DF",35-39,Midfielder,Brazil,South America
874,Fernandinho,BRA,Manchester City,Premier League,2021,36.0,1985.0,10.7,21,10,7,10,4,9,27,33.3,18,8,2,6,8,29,13,1,"MF,DF",35-39,Midfielder,Brazil,South America
874,Fernandinho,BRA,Manchester City,Premier League,2021,36.0,1985.0,10.7,21,10,7,10,4,9,27,33.3,18,8,2,6,8,29,13,1,"MF,DF",35-39,Midfielder,Brazil,South America
874,Fernandinho,BRA,Manchester City,Premier League,2021,36.0,1985.0,10.7,21,10,7,10,4,9,27,33.3,18,8,2,6,8,29,13,1,"MF,DF",35-39,Midfielder,Brazil,South America
874,Fernandinho,BRA,Manchester City,Premier League,2021,36.0,1985.0,10.7,21,10,7,10,4,9,27,33.3,18,8,2,6,8,29,13,1,"MF,DF",35-39,Midfielder,Brazil,South America
874,Fernandinho,BRA,Manchester City,Premier League,2021,36.0,1985.0,10.7,21,10,7,10,4,9,27,33.3,18,8,2,6,8,29,13,1,"MF,DF",35-39,Midfielder,Brazil,South America
875,Fernando,BRA,Sevilla,La Liga,2021,34.0,1987.0,20.6,24,17,14,9,1,12,33,36.4,21,21,13,8,29,53,32,2,"MF,DF",30-34,Midfielder,Brazil,South America
875,Fernando,BRA,Sevilla,La Liga,2021,34.0,1987.0,20.6,24,17,14,9,1,12,33,36.4,21,21,13,8,29,53,32,2,"MF,DF",30-34,Midfielder,Brazil,South America
875,Fernando,BRA,Sevilla,La Liga,2021,34.0,1987.0,20.6,24,17,14,9,1,12,33,36.4,21,21,13,8,29,53,32,2,"MF,DF",30-34,Midfielder,Brazil,South America
875,Fernando,BRA,Sevilla,La Liga,2021,34.0,1987.0,20.6,24,17,14,9,1,12,33,36.4,21,21,13,8,29,53,32,2,"MF,DF",30-34,Midfielder,Brazil,South America
875,Fernando,BRA,Sevilla,La Liga,2021,34.0,1987.0,20.6,24,17,14,9,1,12,33,36.4,21,21,13,8,29,53,32,2,"MF,DF",30-34,Midfielder,Brazil,South America
875,Fernando,BRA,Sevilla,La Liga,2021,34.0,1987.0,20.6,24,17,14,9,1,12,33,36.4,21,21,13,8,29,53,32,2,"MF,DF",30-34,Midfielder,Brazil,South America
875,Fernando,BRA,Sevilla,La Liga,2021,34.0,1987.0,20.6,24,17,14,9,1,12,33,36.4,21,21,13,8,29,53,32,2,"MF,DF",30-34,Midfielder,Brazil,South America
875,Fernando,BRA,Sevilla,La Liga,2021,34.0,1987.0,20.6,24,17,14,9,1,12,33,36.4,21,21,13,8,29,53,32,2,"MF,DF",30-34,Midfielder,Brazil,South America
875,Fernando,BRA,Sevilla,La Liga,2021,34.0,1987.0,20.6,24,17,14,9,1,12,33,36.4,21,21,13,8,29,53,32,2,"MF,DF",30-34,Midfielder,Brazil,South America
875,Fernando,BRA,Sevilla,La Liga,2021,34.0,1987.0,20.6,24,17,14,9,1,12,33,36.4,21,21,13,8,29,53,32,2,"MF,DF",30-34,Midfielder,Brazil,South America
875,Fernando,BRA,Sevilla,La Liga,2021,34.0,1987.0,20.6,24,17,14,9,1,12,33,36.4,21,21,13,8,29,53,32,2,"MF,DF",30-34,Midfielder,Brazil,South America
875,Fernando,BRA,Sevilla,La Liga,2021,34.0,1987.0,20.6,24,17,14,9,1,12,33,36.4,21,21,13,8,29,53,32,2,"MF,DF",30-34,Midfielder,Brazil,South America
875,Fernando,BRA,Sevilla,La Liga,2021,34.0,1987.0,20.6,24,17,14,9,1,12,33,36.4,21,21,13,8,29,53,32,2,"MF,DF",30-34,Midfielder,Brazil,South America
875,Fernando,BRA,Sevilla,La Liga,2021,34.0,1987.0,20.6,24,17,14,9,1,12,33,36.4,21,21,13,8,29,53,32,2,"MF,DF",30-34,Midfielder,Brazil,South America
875,Fernando,BRA,Sevilla,La Liga,2021,34.0,1987.0,20.6,24,17,14,9,1,12,33,36.4,21,21,13,8,29,53,32,2,"MF,DF",30-34,Midfielder,Brazil,South America
875,Fernando,BRA,Sevilla,La Liga,2021,34.0,1987.0,20.6,24,17,14,9,1,12,33,36.4,21,21,13,8,29,53,32,2,"MF,DF",30-34,Midfielder,Brazil,South America
876,Alex Ferrari,ITA,Sampdoria,Serie A,2021,27.0,1994.0,18.3,40,22,28,9,3,19,33,57.6,14,31,22,9,39,79,63,1,DF,25-29,Defender,Italy,Europe
878,Jordan Ferri,FRA,Montpellier,Ligue 1,2021,29.0,1992.0,32.3,55,35,28,23,4,29,87,33.3,58,21,5,16,30,85,35,0,MF,25-29,Midfielder,France,Europe
879,Riccardo Fiamozzi,ITA,Empoli,Serie A,2021,28.0,1993.0,6.9,7,5,2,2,3,2,4,50.0,2,6,5,1,7,14,12,0,DF,25-29,Defender,Italy,Europe
882,Alfreð Finnbogason,ISL,Augsburg,Bundesliga,2021,32.0,1989.0,3.2,3,1,0,2,1,2,4,50.0,2,5,1,4,2,5,8,0,FW,30-34,Forward,Iceland,Europe
883,Luca Fiordilino,ITA,Venezia,Serie A,2021,25.0,1996.0,7.3,21,13,11,6,4,13,27,48.1,14,14,4,10,11,32,12,0,MF,25-29,Midfielder,Italy,Europe
884,Vincenzo Fiorillo,ITA,Salernitana,Serie A,2021,31.0,1990.0,1.0,0,0,0,0,0,0,0,,0,0,0,0,0,0,1,0,GK,30-34,Goalkeeper,Italy,Europe
885,Roberto Firmino,BRA,Liverpool,Premier League,2021,29.0,1991.0,11.0,23,14,5,8,10,3,16,18.8,13,20,0,20,4,27,3,0,FW,25-29,Forward,Brazil,South America
886,Junior Firpo,DOM,Leeds United,Premier League,2021,24.0,1996.0,19.0,61,29,30,26,5,31,59,52.5,28,22,6,16,24,85,37,0,"DF,MF",20-24,Defender,Dominican Republic,North America
887,Mark Flekken,NED,Freiburg,Bundesliga,2021,28.0,1993.0,32.0,0,0,0,0,0,0,2,0.0,2,1,0,1,2,2,10,1,GK,25-29,Goalkeeper,Netherlands,Europe
888,Ashley Fletcher,ENG,Watford,Premier League,2021,25.0,1995.0,0.3,2,1,1,1,0,1,1,100.0,0,1,1,0,0,2,0,0,FW,25-29,Forward,England,Europe
889,Alexis Flips,FRA,Reims,Ligue 1,2021,21.0,2000.0,11.7,37,21,21,9,7,22,45,48.9,23,21,0,21,24,61,17,0,"MF,DF",20-24,Midfielder,France,Europe
890,Alessandro Florenzi,ITA,Milan,Serie A,2021,30.0,1991.0,12.8,28,14,14,7,7,14,32,43.8,18,9,2,7,27,55,10,1,"DF,FW",30-34,Defender,Italy,Europe
891,Phil Foden,ENG,Manchester City,Premier League,2021,21.0,2000.0,23.6,16,8,10,4,2,7,17,41.2,10,9,0,9,11,27,5,0,FW,20-24,Forward,England,Europe
892,Mamadou Fofana,MLI,Metz,Ligue 1,2021,23.0,1998.0,0.4,1,1,0,1,0,1,2,50.0,1,2,1,1,1,2,2,0,DF,20-24,Defender,Mali,Africa
893,Seko Fofana,CIV,Lens,Ligue 1,2021,26.0,1995.0,37.3,27,19,11,13,3,12,58,20.7,46,24,2,22,26,53,17,1,MF,25-29,Midfielder,Ivory Coast,Africa
894,Wesley Fofana,FRA,Leicester City,Premier League,2021,20.0,2000.0,7.0,12,8,11,1,0,7,11,63.6,4,5,2,3,12,24,26,1,DF,20-24,Defender,France,Europe
895,Youssouf Fofana,FRA,Monaco,Ligue 1,2021,22.0,1999.0,24.3,69,43,19,41,9,29,56,51.8,27,29,7,22,32,101,22,2,MF,20-24,Midfielder,France,Europe
896,Thomas Foket,BEL,Reims,Ligue 1,2021,26.0,1994.0,24.8,28,19,12,13,3,18,40,45.0,22,26,4,22,33,61,35,0,"DF,FW",25-29,Defender,Belgium,Europe
897,Thomas Fontaine,MAD,Lorient,Ligue 1,2021,30.0,1991.0,1.9,2,0,1,0,1,0,1,0.0,1,3,3,0,2,4,4,0,DF,30-34,Defender,Madagascar,Africa
899,José Fonte,POR,Lille,Ligue 1,2021,37.0,1983.0,38.0,23,12,14,7,2,11,25,44.0,14,39,32,7,44,67,159,1,DF,35-39,Defender,Portugal,Europe
900,Fernando Forestieri,ITA,Udinese,Serie A,2021,31.0,1990.0,0.6,0,0,0,0,0,0,1,0.0,1,1,0,1,0,0,1,0,"FW,MF",30-34,Forward,Italy,Europe
902,Emil Forsberg,SWE,RB Leipzig,Bundesliga,2021,29.0,1991.0,19.0,21,12,2,11,8,7,22,31.8,15,18,0,18,2,23,2,1,MF,25-29,Midfielder,Sweden,Europe
903,Adam Forshaw,ENG,Leeds United,Premier League,2021,29.0,1991.0,17.0,53,23,21,27,5,21,54,38.9,33,17,1,16,19,72,12,2,MF,25-29,Midfielder,England,Europe
904,Marcus Forss,FIN,Brentford,Premier League,2021,22.0,1999.0,2.3,3,3,0,2,1,2,4,50.0,2,5,0,5,1,4,0,0,"FW,MF",20-24,Forward,Finland,Europe
905,Fraser Forster,ENG,Southampton,Premier League,2021,33.0,1988.0,19.0,1,0,1,0,0,0,1,0.0,1,0,0,0,0,1,23,2,GK,30-34,Goalkeeper,England,Europe
906,Philipp Förster,GER,Stuttgart,Bundesliga,2021,26.0,1995.0,10.7,20,13,4,12,4,11,26,42.3,15,12,1,11,3,23,2,0,"MF,FW",25-29,Midfielder,Germany,Europe
907,Francesco Forte,ITA,Venezia,Serie A,2021,28.0,1993.0,4.7,3,2,0,2,1,2,5,40.0,3,1,0,1,0,3,2,0,FW,25-29,Forward,Italy,Europe
907,Francesco Forte,ITA,Venezia,Serie A,2021,28.0,1993.0,4.7,3,2,0,2,1,2,5,40.0,3,1,0,1,0,3,2,0,FW,25-29,Forward,Italy,Europe
907,Francesco Forte,ITA,Venezia,Serie A,2021,28.0,1993.0,4.7,3,2,0,2,1,2,5,40.0,3,1,0,1,0,3,2,0,FW,25-29,Forward,Italy,Europe
907,Francesco Forte,ITA,Venezia,Serie A,2021,28.0,1993.0,4.7,3,2,0,2,1,2,5,40.0,3,1,0,1,0,3,2,0,FW,25-29,Forward,Italy,Europe
908,Steven Fortes,CPV,Lens,Ligue 1,2021,29.0,1992.0,1.0,2,0,2,0,0,1,2,50.0,1,2,1,1,0,2,4,0,DF,25-29,Defender,Cape Verde,Africa
909,Ben Foster,ENG,Watford,Premier League,2021,38.0,1983.0,26.0,0,0,0,0,0,0,3,0.0,3,0,0,0,0,0,9,4,GK,35-39,Goalkeeper,England,Europe
910,Tariqe Fosu,GHA,Brentford,Premier League,2021,25.0,1995.0,0.2,0,0,0,0,0,0,0,,0,1,0,1,0,0,0,0,DF,25-29,Defender,Ghana,Africa
911,Timothy Fosu-Mensah,NED,Leverkusen,Bundesliga,2021,23.0,1998.0,1.6,5,3,3,1,1,4,4,100.0,0,1,0,1,2,7,2,0,DF,20-24,Defender,Netherlands,Europe
912,Dimitri Foulquier,FRA,Granada,La Liga,2021,28.0,1993.0,2.0,0,0,0,0,0,0,1,0.0,1,2,1,1,1,1,2,0,DF,25-29,Defender,France,Europe
913,Dimitri Foulquier,FRA,Valencia,La Liga,2021,28.0,1993.0,26.0,36,17,17,15,4,21,34,61.8,13,19,3,16,29,65,49,0,DF,25-29,Defender,France,Europe
914,Juan Foyth,ARG,Villarreal,La Liga,2021,23.0,1998.0,21.4,69,49,35,28,6,35,47,74.5,12,29,7,22,20,89,50,0,DF,20-24,Defender,Argentina,South America
915,Gianluca Frabotta,ITA,Hellas Verona,Serie A,2021,22.0,1999.0,0.2,0,0,0,0,0,0,1,0.0,1,1,0,1,1,1,0,0,"DF,MF",20-24,Defender,Italy,Europe
916,Raphael Framberger,GER,Augsburg,Bundesliga,2021,25.0,1995.0,9.4,26,19,12,10,4,13,27,48.1,14,8,2,6,9,35,25,0,DF,25-29,Defender,Germany,Europe
919,Fransérgio,BRA,Bordeaux,Ligue 1,2021,30.0,1990.0,14.0,24,10,8,12,4,12,43,27.9,31,18,6,12,23,47,23,0,MF,30-34,Midfielder,Brazil,South America
920,Ryan Fraser,SCO,Newcastle Utd,Premier League,2021,27.0,1994.0,16.3,10,3,5,3,2,5,13,38.5,8,11,1,10,11,21,11,0,"FW,MF",25-29,Forward,Scotland,Europe
921,Davide Frattesi,ITA,Sassuolo,Serie A,2021,21.0,1999.0,31.7,46,16,26,18,2,26,52,50.0,26,44,12,32,29,75,62,1,MF,20-24,Midfielder,Italy,Europe
922,Fred,BRA,Manchester Utd,Premier League,2021,28.0,1993.0,22.5,63,27,32,24,7,22,79,27.8,57,38,11,27,32,95,24,0,MF,25-29,Midfielder,Brazil,South America
923,Ryan Fredericks,ENG,West Ham,Premier League,2021,28.0,1992.0,3.4,2,2,2,0,0,0,1,0.0,1,2,1,1,4,6,6,0,DF,25-29,Defender,England,Europe
924,Morten Frendrup,DEN,Genoa,Serie A,2021,20.0,2001.0,7.7,40,24,19,13,8,13,29,44.8,16,19,2,17,17,57,7,1,"DF,MF",20-24,Defender,Denmark,Europe
925,Remo Freuler,SUI,Atalanta,Serie A,2021,29.0,1992.0,26.3,69,39,22,33,14,30,70,42.9,40,48,8,40,35,104,26,1,MF,25-29,Midfielder,Switzerland,Europe
926,Marvin Friedrich,GER,Gladbach,Bundesliga,2021,25.0,1995.0,6.7,14,8,10,4,0,9,11,81.8,2,5,3,2,5,19,26,0,DF,25-29,Defender,Germany,Europe
927,Marvin Friedrich,GER,Union Berlin,Bundesliga,2021,25.0,1995.0,13.0,17,5,14,3,0,10,16,62.5,6,13,7,6,23,40,47,0,DF,25-29,Defender,Germany,Europe
928,Jeremie Frimpong,NED,Leverkusen,Bundesliga,2021,20.0,2000.0,22.8,32,18,19,12,1,12,23,52.2,11,24,6,18,17,49,40,2,DF,20-24,Defender,Netherlands,Europe
929,Christian Früchtl,GER,Bayern Munich,Bundesliga,2021,21.0,2000.0,0.1,0,0,0,0,0,0,0,,0,0,0,0,0,0,0,0,GK,20-24,Goalkeeper,Germany,Europe
932,Chris Führich,GER,Stuttgart,Bundesliga,2021,23.0,1998.0,19.0,28,16,10,10,8,18,39,46.2,21,31,2,29,8,36,9,0,"FW,MF",20-24,Forward,Germany,Europe
933,Angelo Fulgini,FRA,Angers,Ligue 1,2021,24.0,1996.0,32.5,35,25,8,18,9,14,44,31.8,30,21,5,16,22,57,5,1,"MF,FW",20-24,Midfielder,France,Europe
934,Marius Funk,GER,Greuther Fürth,Bundesliga,2021,25.0,1996.0,8.0,0,0,0,0,0,0,0,,0,0,0,0,0,0,8,1,GK,25-29,Goalkeeper,Germany,Europe
935,Stephan Fürstner,GER,Mainz 05,Bundesliga,2021,33.0,1987.0,0.1,0,0,0,0,0,0,2,0.0,2,0,0,0,0,0,1,0,MF,30-34,Midfielder,Germany,Europe
936,Matteo Gabbia,ITA,Milan,Serie A,2021,21.0,1999.0,6.0,4,3,1,3,0,0,4,0.0,4,2,2,0,8,12,12,0,DF,20-24,Defender,Italy,Europe
937,Manolo Gabbiadini,ITA,Sampdoria,Serie A,2021,29.0,1991.0,12.7,6,4,3,2,1,1,7,14.3,6,5,2,3,3,9,10,0,"FW,MF",25-29,Forward,Italy,Europe
939,Gianluca Gaetano,ITA,Napoli,Serie A,2021,21.0,2000.0,0.2,1,1,1,0,0,1,2,50.0,1,0,0,0,2,3,0,0,MF,20-24,Midfielder,Italy,Europe
940,Luca Gagliano,ITA,Cagliari,Serie A,2021,21.0,2000.0,0.1,0,0,0,0,0,0,0,,0,1,0,1,0,0,1,0,"FW,DF",20-24,Forward,Italy,Europe
941,Roberto Gagliardini,ITA,Inter,Serie A,2021,27.0,1994.0,7.2,12,6,7,4,1,1,13,7.7,12,14,5,9,9,21,7,0,MF,25-29,Midfielder,Italy,Europe
942,Riccardo Gagliolo,SWE,Salernitana,Serie A,2021,31.0,1990.0,12.6,23,12,16,4,3,16,27,59.3,11,15,8,7,28,51,52,0,DF,30-34,Defender,Sweden,Europe
945,Nicolas Galazzi,ITA,Venezia,Serie A,2021,20.0,2000.0,0.2,2,1,1,0,1,0,1,0.0,1,0,0,0,0,2,0,0,MF,20-24,Midfielder,Italy,Europe
946,Pablo Galdames Millán,CHI,Genoa,Serie A,2021,24.0,1996.0,11.4,28,12,6,16,6,12,35,34.3,23,16,2,14,8,36,9,1,MF,20-24,Midfielder,Chile,South America
947,Thiago Galhardo,BRA,Celta Vigo,La Liga,2021,32.0,1989.0,12.8,12,6,3,3,6,2,12,16.7,10,15,2,13,6,18,9,0,"FW,MF",30-34,Forward,Brazil,South America
948,Conor Gallagher,ENG,Crystal Palace,Premier League,2021,21.0,2000.0,31.6,69,38,35,20,14,21,69,30.4,48,58,9,49,29,98,26,0,MF,20-24,Midfielder,England,Europe
949,Gauthier Gallon,FRA,Troyes,Ligue 1,2021,28.0,1993.0,31.0,3,0,3,0,0,1,1,100.0,0,0,0,0,2,5,12,1,GK,25-29,Goalkeeper,France,Europe
950,Cristian Gamboa,CRC,Bochum,Bundesliga,2021,31.0,1989.0,19.1,59,36,40,16,3,30,61,49.2,31,22,7,15,32,91,35,1,DF,30-34,Defender,Costa Rica,North America
951,Kévin Gameiro,FRA,Strasbourg,Ligue 1,2021,34.0,1987.0,26.5,19,10,5,9,5,6,18,33.3,12,22,1,21,6,25,1,0,FW,30-34,Forward,France,Europe
952,Idrissa Gana Gueye,SEN,Paris S-G,Ligue 1,2021,31.0,1989.0,18.2,60,36,24,24,12,18,44,40.9,26,23,4,19,24,84,13,0,MF,30-34,Midfielder,Senegal,Africa
953,Ignatius Ganago,CMR,Lens,Ligue 1,2021,22.0,1999.0,11.4,3,2,1,2,0,2,6,33.3,4,4,0,4,2,5,3,0,FW,20-24,Forward,Cameroon,Africa
954,Silvère Ganvoula M'Boussy,CGO,Bochum,Bundesliga,2021,25.0,1996.0,1.7,0,0,0,0,0,0,1,0.0,1,0,0,0,0,0,1,0,FW,25-29,Forward,Congo,Africa
966,Alejandro Garnacho,ARG,Manchester Utd,Premier League,2021,17.0,2004.0,0.1,0,0,0,0,0,0,1,0.0,1,0,0,0,0,0,0,0,"FW,MF",Under 20,Forward,Argentina,South America
968,Djeidi Gassama,FRA,Paris S-G,Ligue 1,2021,17.0,2003.0,0.0,0,0,0,0,0,0,0,,0,1,1,0,0,0,0,0,FW,Under 20,Forward,France,Europe
969,Johan Gastien,FRA,Clermont Foot,Ligue 1,2021,33.0,1988.0,30.5,56,34,26,25,5,27,74,36.5,47,45,11,34,53,109,49,1,MF,30-34,Midfielder,France,Europe
971,Dwight Gayle,ENG,Newcastle Utd,Premier League,2021,30.0,1990.0,0.4,1,0,0,1,0,0,1,0.0,1,0,0,0,1,2,0,0,"FW,DF",30-34,Forward,England,Europe
972,Jean-Philippe Gbamin,CIV,Everton,Premier League,2021,25.0,1995.0,0.7,1,1,1,0,0,0,2,0.0,2,0,0,0,1,2,1,0,MF,25-29,Midfielder,Ivory Coast,Africa
974,Linus Gechter,GER,Hertha BSC,Bundesliga,2021,17.0,2004.0,8.0,15,8,13,2,0,7,14,50.0,7,12,7,5,11,26,29,0,DF,Under 20,Defender,Germany,Europe
975,Dennis Geiger,GER,Hoffenheim,Bundesliga,2021,23.0,1998.0,15.3,34,23,9,20,5,17,30,56.7,13,15,1,14,14,48,7,1,MF,20-24,Midfielder,Germany,Europe
976,Joe Gelhardt,ENG,Leeds United,Premier League,2021,19.0,2002.0,8.3,4,3,1,0,3,2,10,20.0,8,9,0,9,0,4,3,0,"FW,MF",Under 20,Forward,England,Europe
977,Luca Gemello,ITA,Torino,Serie A,2021,21.0,2000.0,1.0,0,0,0,0,0,0,0,,0,0,0,0,0,0,0,0,GK,20-24,Goalkeeper,Italy,Europe
978,Yannick Gerhardt,GER,Wolfsburg,Bundesliga,2021,27.0,1994.0,17.5,42,20,18,17,7,22,36,61.1,14,24,1,23,25,67,25,1,"MF,DF",25-29,Midfielder,Germany,Europe
979,Valère Germain,FRA,Montpellier,Ligue 1,2021,31.0,1990.0,21.9,23,14,6,11,6,8,31,25.8,23,13,1,12,9,32,27,0,FW,30-34,Forward,France,Europe
980,Gerson,BRA,Marseille,Ligue 1,2021,24.0,1997.0,28.3,42,17,16,20,6,8,35,22.9,27,26,4,22,16,58,16,2,"MF,FW",20-24,Midfielder,Brazil,South America
981,Willem Geubbels,FRA,Nantes,Ligue 1,2021,19.0,2001.0,6.0,8,5,4,2,2,5,12,41.7,7,5,0,5,6,14,5,0,"FW,MF",Under 20,Forward,France,Europe
982,Hamadi Al Ghaddioui,MAR,Stuttgart,Bundesliga,2021,30.0,1990.0,5.5,5,4,2,1,2,0,4,0.0,4,3,1,2,0,5,4,0,FW,30-34,Forward,Morocco,Africa
984,Anwar El Ghazi,NED,Aston Villa,Premier League,2021,26.0,1995.0,4.3,4,4,2,2,0,2,7,28.6,5,6,0,6,1,5,2,0,"FW,MF",25-29,Forward,Netherlands,Europe
985,Anwar El Ghazi,NED,Everton,Premier League,2021,26.0,1995.0,0.1,1,1,1,0,0,1,1,100.0,0,3,0,3,0,1,0,0,"FW,MF",25-29,Forward,Netherlands,Europe
986,Lamine Ghezali,FRA,Saint-Étienne,Ligue 1,2021,22.0,1999.0,0.0,0,0,0,0,0,0,0,,0,1,0,1,0,0,0,0,DF,20-24,Defender,France,Europe
987,Paolo Ghiglione,ITA,Genoa,Serie A,2021,24.0,1997.0,6.7,17,12,8,6,3,9,14,64.3,5,11,5,6,10,27,12,1,DF,20-24,Defender,Italy,Europe
988,Saman Ghoddos,IRN,Brentford,Premier League,2021,27.0,1993.0,6.0,17,10,8,6,3,9,15,60.0,6,2,0,2,3,20,16,0,"MF,DF",25-29,Midfielder,Iran,Asia
989,Faouzi Ghoulam,ALG,Napoli,Serie A,2021,30.0,1991.0,3.7,3,1,1,2,0,0,3,0.0,3,2,1,1,3,6,10,0,DF,30-34,Defender,Algeria,Africa
990,Dimitris Giannoulis,GRE,Norwich City,Premier League,2021,25.0,1995.0,13.0,36,21,17,17,2,24,36,66.7,12,22,6,16,19,55,41,1,DF,25-29,Defender,Greece,Europe
991,Morgan Gibbs-White,ENG,Wolves,Premier League,2021,21.0,2000.0,0.1,0,0,0,0,0,0,0,,0,1,0,1,0,0,0,0,"DF,FW",20-24,Defender,England,Europe
992,Ben Gibson,ENG,Norwich City,Premier League,2021,28.0,1993.0,27.7,23,16,17,6,0,7,12,58.3,5,36,30,6,27,50,139,2,DF,25-29,Defender,England,Europe
993,Niko Gießelmann,GER,Union Berlin,Bundesliga,2021,29.0,1991.0,23.1,24,17,10,11,3,15,38,39.5,23,26,4,22,18,42,29,1,"DF,FW",25-29,Defender,Germany,Europe
999,Billy Gilmour,SCO,Norwich City,Premier League,2021,20.0,2001.0,20.6,41,21,16,21,4,14,52,26.9,38,21,4,17,17,58,29,0,MF,20-24,Midfielder,Scotland,Europe
1000,Daniel Ginczek,GER,Wolfsburg,Bundesliga,2021,30.0,1991.0,0.1,0,0,0,0,0,0,0,,0,0,0,0,0,0,0,0,"MF,FW",30-34,Midfielder,Germany,Europe
1001,Matthias Ginter,GER,Gladbach,Bundesliga,2021,27.0,1994.0,26.2,36,22,20,13,3,27,40,67.5,13,21,10,11,33,69,76,0,DF,25-29,Defender,Germany,Europe
1002,Nicholas Gioacchini,USA,Montpellier,Ligue 1,2021,21.0,2000.0,5.5,7,5,3,2,2,4,10,40.0,6,8,0,8,4,11,5,0,"FW,MF",20-24,Forward,United States,North America
1003,Sebastian Giovinco,ITA,Sampdoria,Serie A,2021,34.0,1987.0,0.4,0,0,0,0,0,0,1,0.0,1,0,0,0,0,0,0,0,MF,30-34,Midfielder,Italy,Europe
1004,Jimmy Giraudon,FRA,Troyes,Ligue 1,2021,29.0,1992.0,18.0,14,6,10,4,0,7,22,31.8,15,24,14,10,37,51,68,1,DF,25-29,Defender,France,Europe
1005,Andrei Girotto,BRA,Nantes,Ligue 1,2021,29.0,1992.0,35.0,85,52,49,32,4,52,103,50.5,51,67,33,34,69,154,143,0,"DF,MF",25-29,Defender,Brazil,South America
1006,Olivier Giroud,FRA,Milan,Serie A,2021,34.0,1986.0,21.0,15,11,4,6,5,3,17,17.6,14,13,4,9,3,18,19,0,FW,30-34,Forward,France,Europe
1007,Jamie Gittens,ENG,Dortmund,Bundesliga,2021,16.0,2004.0,1.5,3,2,0,2,1,2,5,40.0,3,4,1,3,1,4,1,0,FW,Under 20,Forward,England,Europe
1008,Serge Gnabry,GER,Bayern Munich,Bundesliga,2021,26.0,1995.0,24.3,47,31,16,20,11,22,57,38.6,35,26,0,26,14,61,3,0,"FW,DF",25-29,Forward,Germany,Europe
1009,Ben Godfrey,ENG,Everton,Premier League,2021,23.0,1998.0,22.5,47,32,29,14,4,24,39,61.5,15,41,19,22,15,62,100,2,DF,20-24,Defender,England,Europe
1010,Diego Godín,URU,Cagliari,Serie A,2021,35.0,1986.0,9.1,18,7,13,3,2,10,15,66.7,5,7,5,2,13,31,46,0,DF,35-39,Defender,Uruguay,South America
1011,Edoardo Goldaniga,ITA,Cagliari,Serie A,2021,27.0,1993.0,10.4,12,5,7,5,0,4,11,36.4,7,8,5,3,22,34,23,0,DF,25-29,Defender,Italy,Europe
1012,Edoardo Goldaniga,ITA,Sassuolo,Serie A,2021,27.0,1993.0,0.0,0,0,0,0,0,0,0,,0,0,0,0,0,0,0,0,"DF,MF",25-29,Defender,Italy,Europe
1013,Aleksandr Golovin,RUS,Monaco,Ligue 1,2021,25.0,1996.0,16.7,40,22,10,18,12,18,41,43.9,23,26,1,25,12,52,8,0,"FW,MF",25-29,Forward,Russia,Europe
1014,André Gomes,POR,Everton,Premier League,2021,28.0,1993.0,6.9,16,4,6,6,4,8,32,25.0,24,8,2,6,1,17,7,1,MF,25-29,Midfielder,Portugal,Europe
1014,André Gomes,POR,Everton,Premier League,2021,28.0,1993.0,6.9,16,4,6,6,4,8,32,25.0,24,8,2,6,1,17,7,1,MF,25-29,Midfielder,Portugal,Europe
1014,André Gomes,POR,Everton,Premier League,2021,28.0,1993.0,6.9,16,4,6,6,4,8,32,25.0,24,8,2,6,1,17,7,1,MF,25-29,Midfielder,Portugal,Europe
1014,André Gomes,POR,Everton,Premier League,2021,28.0,1993.0,6.9,16,4,6,6,4,8,32,25.0,24,8,2,6,1,17,7,1,MF,25-29,Midfielder,Portugal,Europe
1015,Angel Gomes,ENG,Lille,Ligue 1,2021,20.0,2000.0,10.6,23,13,6,12,5,10,15,66.7,5,4,0,4,3,26,4,0,"MF,FW",20-24,Midfielder,England,Europe
1016,Toti Gomes,POR,Wolves,Premier League,2021,22.0,1999.0,4.0,11,7,10,1,0,7,9,77.8,2,6,3,3,8,19,15,0,DF,20-24,Defender,Portugal,Europe
1018,Joe Gomez,ENG,Liverpool,Premier League,2021,24.0,1997.0,3.7,10,6,5,2,3,5,9,55.6,4,4,1,3,5,15,6,0,DF,20-24,Defender,England,Europe
1019,Maxi Gómez,URU,Valencia,La Liga,2021,24.0,1996.0,21.7,5,3,1,2,2,5,8,62.5,3,5,1,4,3,8,22,0,FW,20-24,Forward,Uruguay,South America
1021,Papu Gómez,ARG,Sevilla,La Liga,2021,33.0,1988.0,19.8,19,11,9,5,5,9,35,25.7,26,15,2,13,7,26,12,2,"FW,MF",30-34,Forward,Argentina,South America
1024,Alfred Gomis,SEN,Rennes,Ligue 1,2021,27.0,1993.0,25.0,1,0,1,0,0,1,2,50.0,1,0,0,0,1,2,8,2,GK,25-29,Goalkeeper,Senegal,Africa
1025,Maxime Gonalons,FRA,Granada,La Liga,2021,32.0,1989.0,17.2,43,28,17,22,4,14,39,35.9,25,33,10,23,18,61,29,0,MF,30-34,Midfielder,France,Europe
1026,Vagner Gonçalves,CPV,Metz,Ligue 1,2021,25.0,1996.0,1.0,2,1,0,2,0,1,1,100.0,0,0,0,0,1,3,0,0,FW,25-29,Forward,Cape Verde,Africa
1027,Cedric Gondo,CIV,Salernitana,Serie A,2021,24.0,1996.0,7.8,5,2,2,2,1,2,5,40.0,3,2,0,2,3,8,2,0,FW,20-24,Forward,Ivory Coast,Africa
1031,Giovanni González,URU,Mallorca,La Liga,2021,26.0,1994.0,4.1,9,3,4,4,1,3,5,60.0,2,7,2,5,4,13,14,0,DF,25-29,Defender,Uruguay,South America
1032,Nicolás González,ARG,Fiorentina,Serie A,2021,23.0,1998.0,26.2,21,16,6,8,7,9,28,32.1,19,26,2,24,21,42,4,1,FW,20-24,Forward,Argentina,South America
1035,Charlie Goode,ENG,Brentford,Premier League,2021,25.0,1995.0,5.0,7,5,5,2,0,4,4,100.0,0,4,2,2,2,9,8,0,DF,25-29,Defender,England,Europe
1036,Anthony Gordon,ENG,Everton,Premier League,2021,20.0,2001.0,25.4,54,32,20,30,4,21,59,35.6,38,49,3,46,22,76,17,0,"MF,FW",20-24,Midfielder,England,Europe
1037,Kaide Gordon,ENG,Liverpool,Premier League,2021,16.0,2004.0,0.1,1,0,0,0,1,0,0,,0,0,0,0,0,1,0,0,FW,Under 20,Forward,England,Europe
1038,Leon Goretzka,GER,Bayern Munich,Bundesliga,2021,26.0,1995.0,15.5,25,15,12,9,4,11,26,42.3,15,11,1,10,17,42,23,2,MF,25-29,Midfielder,Germany,Europe
1041,Robin Gosens,GER,Atalanta,Serie A,2021,27.0,1994.0,5.1,7,3,3,4,0,4,8,50.0,4,4,0,4,9,16,1,0,DF,25-29,Defender,Germany,Europe
1042,Robin Gosens,GER,Inter,Serie A,2021,27.0,1994.0,1.9,3,1,1,2,0,0,0,,0,5,2,3,3,6,3,0,DF,25-29,Defender,Germany,Europe
1043,Dan Gosling,ENG,Watford,Premier League,2021,31.0,1990.0,1.8,2,1,1,1,0,2,6,33.3,4,2,0,2,0,2,3,0,MF,30-34,Midfielder,England,Europe
1044,Amine Gouiri,ALG,Nice,Ligue 1,2021,21.0,2000.0,30.6,22,13,2,13,7,10,32,31.3,22,22,5,17,11,33,17,1,"FW,MF",20-24,Forward,Algeria,Africa
1045,Lucas Gourna-Douath,FRA,Saint-Étienne,Ligue 1,2021,17.0,2003.0,20.0,45,26,22,18,5,21,36,58.3,15,22,3,19,13,58,9,2,MF,Under 20,Midfielder,France,Europe
1046,Jeffrey Gouweleeuw,NED,Augsburg,Bundesliga,2021,30.0,1991.0,28.6,50,27,33,17,0,22,36,61.1,14,35,18,17,49,99,116,0,DF,30-34,Defender,Netherlands,Europe
1047,Jonathan Gradit,FRA,Lens,Ligue 1,2021,28.0,1992.0,34.1,60,28,24,28,8,25,45,55.6,20,39,27,12,65,125,106,0,DF,25-29,Defender,France,Europe
1048,Jens Grahl,GER,Eint Frankfurt,Bundesliga,2021,32.0,1988.0,1.0,0,0,0,0,0,0,0,,0,0,0,0,0,0,1,0,GK,30-34,Goalkeeper,Germany,Europe
1049,Alberto Grassi,ITA,Cagliari,Serie A,2021,26.0,1995.0,24.2,47,26,13,30,4,16,38,42.1,22,27,9,18,63,110,33,1,MF,25-29,Midfielder,Italy,Europe
1052,Demarai Gray,JAM,Everton,Premier League,2021,25.0,1996.0,26.0,30,19,13,10,7,10,22,45.5,12,30,2,28,15,45,21,1,"MF,FW",25-29,Midfielder,Jamaica,North America
1053,Adrian Grbić,AUT,Lorient,Ligue 1,2021,24.0,1996.0,5.8,2,1,0,2,0,2,6,33.3,4,3,1,2,0,2,7,0,"FW,MF",20-24,Forward,Austria,Europe
1054,Ivo Grbić,CRO,Lille,Ligue 1,2021,25.0,1996.0,21.0,0,0,0,0,0,0,0,,0,0,0,0,0,0,14,1,GK,25-29,Goalkeeper,Croatia,Europe
1055,Jack Grealish,ENG,Manchester City,Premier League,2021,25.0,1995.0,21.3,18,17,4,10,4,5,13,38.5,8,11,1,10,8,26,7,0,FW,25-29,Forward,England,Europe
1056,Etienne Green,ENG,Saint-Étienne,Ligue 1,2021,21.0,2000.0,13.3,1,1,1,0,0,0,0,,0,0,0,0,1,2,9,0,GK,20-24,Goalkeeper,England,Europe
1057,Julian Green,USA,Greuther Fürth,Bundesliga,2021,26.0,1995.0,11.7,9,5,0,8,1,2,8,25.0,6,10,2,8,7,16,10,0,MF,25-29,Midfielder,United States,North America
1058,Mason Greenwood,ENG,Manchester Utd,Premier League,2021,19.0,2001.0,14.1,15,9,9,1,5,3,9,33.3,6,5,0,5,1,16,6,0,"FW,MF",Under 20,Forward,England,Europe
1059,Sam Greenwood,ENG,Leeds United,Premier League,2021,19.0,2002.0,2.6,8,5,0,5,3,4,7,57.1,3,3,0,3,2,10,1,0,"MF,FW",Under 20,Midfielder,England,Europe
1060,Michael Gregoritsch,AUT,Augsburg,Bundesliga,2021,27.0,1994.0,15.5,19,8,4,10,5,2,15,13.3,13,18,2,16,6,25,29,0,"FW,MF",25-29,Forward,Austria,Europe
1061,Dominik Greif,SVK,Mallorca,La Liga,2021,24.0,1997.0,1.0,0,0,0,0,0,0,0,,0,0,0,0,0,0,0,0,GK,20-24,Goalkeeper,Slovakia,Europe
1062,Clément Grenier,FRA,Mallorca,La Liga,2021,30.0,1991.0,0.7,0,0,0,0,0,0,0,,0,1,1,0,0,0,1,0,MF,30-34,Midfielder,France,Europe
1063,Sebastian Griesbeck,GER,Greuther Fürth,Bundesliga,2021,30.0,1990.0,27.1,60,31,38,19,3,39,62,62.9,23,38,13,25,43,103,100,1,"DF,MF",30-34,Defender,Germany,Europe
1064,Sebastian Griesbeck,GER,Union Berlin,Bundesliga,2021,30.0,1990.0,0.1,1,1,0,1,0,1,1,100.0,0,0,0,0,0,1,0,0,MF,30-34,Midfielder,Germany,Europe
1065,Antoine Griezmann,FRA,Barcelona,La Liga,2021,30.0,1991.0,2.9,13,5,3,10,0,2,6,33.3,4,4,0,4,3,16,5,0,FW,30-34,Forward,France,Europe
1066,Antoine Griezmann,FRA,Atlético Madrid,La Liga,2021,30.0,1991.0,18.8,30,14,11,15,4,12,32,37.5,20,18,1,17,7,37,18,0,"FW,MF",30-34,Forward,France,Europe
1067,Vincenzo Grifo,ITA,Freiburg,Bundesliga,2021,28.0,1993.0,30.8,27,15,9,13,5,9,26,34.6,17,12,2,10,13,40,28,0,"MF,FW",25-29,Midfielder,Italy,Europe
1068,Lennart Grill,GER,Leverkusen,Bundesliga,2021,22.0,1999.0,1.0,0,0,0,0,0,0,0,,0,0,0,0,0,0,0,0,GK,20-24,Goalkeeper,Germany,Europe
1069,Florian Grillitsch,AUT,Hoffenheim,Bundesliga,2021,25.0,1995.0,16.6,37,19,15,21,1,17,31,54.8,14,18,7,11,29,66,36,1,"DF,MF",25-29,Defender,Austria,Europe
1070,Pascal Groß,GER,Brighton,Premier League,2021,30.0,1991.0,22.6,28,15,15,11,2,12,33,36.4,21,34,8,26,18,46,23,0,"MF,DF",30-34,Midfielder,Germany,Europe
1071,Carlos Gruezo,ECU,Augsburg,Bundesliga,2021,26.0,1995.0,10.8,22,11,10,10,2,8,21,38.1,13,11,2,9,9,31,15,0,MF,25-29,Midfielder,Ecuador,South America
1073,Andrés Guardado,MEX,Betis,La Liga,2021,34.0,1986.0,15.5,30,13,12,17,1,13,34,38.2,21,18,4,14,21,51,29,1,MF,30-34,Midfielder,Mexico,North America
1076,Gabriel Gudmundsson,SWE,Lille,Ligue 1,2021,22.0,1999.0,14.9,43,31,24,16,3,17,35,48.6,18,15,3,12,20,63,13,0,"DF,MF",20-24,Defender,Sweden,Europe
1077,Noah Guede-Nadje,FRA,Angers,Ligue 1,2021,17.0,2003.0,0.0,0,0,0,0,0,0,0,,0,0,0,0,0,0,0,0,MF,Under 20,Midfielder,France,Europe
1078,Gonçalo Guedes,POR,Valencia,La Liga,2021,24.0,1996.0,29.0,21,14,6,7,8,2,22,9.1,20,14,0,14,9,30,1,0,"FW,MF",20-24,Forward,Portugal,Europe
1079,Marc Guéhi,ENG,Crystal Palace,Premier League,2021,21.0,2000.0,35.8,35,17,24,10,1,15,16,93.8,1,34,26,8,30,65,127,0,DF,20-24,Defender,England,Europe
1080,Mattéo Guendouzi,FRA,Marseille,Ligue 1,2021,22.0,1999.0,35.0,45,30,10,26,9,13,47,27.7,34,15,1,14,16,61,18,0,MF,20-24,Midfielder,France,Europe
1081,Yanis Guermouche,FRA,Montpellier,Ligue 1,2021,20.0,2001.0,0.1,2,1,0,1,1,1,1,100.0,0,0,0,0,0,2,0,0,"MF,FW",20-24,Midfielder,France,Europe
1082,Raphaël Guerreiro,POR,Dortmund,Bundesliga,2021,27.0,1993.0,19.9,35,19,19,12,4,16,31,51.6,15,18,2,16,25,60,14,1,DF,25-29,Defender,Portugal,Europe
1083,Evann Guessand,CIV,Nice,Ligue 1,2021,20.0,2001.0,4.9,9,8,2,5,2,3,8,37.5,5,4,0,4,0,9,1,0,FW,20-24,Forward,Ivory Coast,Africa
1085,Lamine Gueye,SEN,Metz,Ligue 1,2021,23.0,1998.0,6.2,5,5,1,1,3,3,7,42.9,4,4,0,4,6,11,1,0,"FW,MF",20-24,Forward,Senegal,Africa
1086,Pape Gueye,SEN,Marseille,Ligue 1,2021,22.0,1999.0,17.0,38,19,15,22,1,16,31,51.6,15,15,3,12,24,62,16,0,MF,20-24,Midfielder,Senegal,Africa
1087,John Guidetti,SWE,Alavés,La Liga,2021,29.0,1992.0,3.1,2,1,0,0,2,0,1,0.0,1,1,0,1,0,2,0,0,"FW,MF",25-29,Forward,Sweden,Europe
1088,Josuha Guilavogui,FRA,Bordeaux,Ligue 1,2021,30.0,1990.0,14.8,39,16,18,17,4,14,29,48.3,15,16,8,8,36,75,23,0,"MF,DF",30-34,Midfielder,France,Europe
1089,Josuha Guilavogui,FRA,Wolfsburg,Bundesliga,2021,30.0,1990.0,10.5,23,14,13,9,1,7,18,38.9,11,11,6,5,25,48,42,0,"MF,DF",30-34,Midfielder,France,Europe
1090,Frederic Guilbert,FRA,Strasbourg,Ligue 1,2021,26.0,1994.0,28.0,69,39,33,24,12,32,62,51.6,30,37,11,26,55,124,39,0,DF,25-29,Defender,France,Europe
1092,Bruno Guimarães,BRA,Newcastle Utd,Premier League,2021,23.0,1997.0,11.5,44,23,18,22,4,21,38,55.3,17,25,6,19,9,53,13,0,MF,20-24,Midfielder,Brazil,South America
1093,Bruno Guimarães,BRA,Lyon,Ligue 1,2021,23.0,1997.0,18.2,50,31,20,25,5,23,59,39.0,36,21,4,17,21,71,11,1,MF,20-24,Midfielder,Brazil,South America
1094,Serhou Guirassy,GUI,Rennes,Ligue 1,2021,25.0,1996.0,11.3,4,2,1,2,1,1,7,14.3,6,4,0,4,1,5,8,0,FW,25-29,Forward,Guinea,Africa
1095,Péter Gulácsi,HUN,RB Leipzig,Bundesliga,2021,31.0,1990.0,33.0,0,0,0,0,0,0,0,,0,0,0,0,1,1,15,1,GK,30-34,Goalkeeper,Hungary,Europe
1096,Manuel Gulde,GER,Freiburg,Bundesliga,2021,30.0,1991.0,13.6,18,10,14,3,1,8,11,72.7,3,16,8,8,17,35,37,0,DF,30-34,Defender,Germany,Europe
1099,İlkay Gündoğan,GER,Manchester City,Premier League,2021,30.0,1990.0,20.6,23,9,10,12,1,12,31,38.7,19,11,1,10,15,38,10,0,MF,30-34,Midfielder,Germany,Europe
1100,Angus Gunn,SCO,Norwich City,Premier League,2021,25.0,1996.0,9.0,0,0,0,0,0,0,0,,0,0,0,0,0,0,11,0,GK,25-29,Goalkeeper,Scotland,Europe
1101,Christian Günter,GER,Freiburg,Bundesliga,2021,28.0,1993.0,34.0,34,20,16,15,3,18,50,36.0,32,23,6,17,17,51,49,2,"DF,MF",25-29,Defender,Germany,Europe
1102,Koray Günter,GER,Hellas Verona,Serie A,2021,26.0,1994.0,26.8,32,18,19,11,2,16,32,50.0,16,27,21,6,69,101,110,1,DF,25-29,Defender,Germany,Europe
1103,Lasse Günther,GER,Augsburg,Bundesliga,2021,18.0,2003.0,1.8,8,5,4,3,1,5,9,55.6,4,0,0,0,2,10,2,0,DF,Under 20,Defender,Germany,Europe
1105,Malo Gusto,FRA,Lyon,Ligue 1,2021,18.0,2003.0,20.9,55,35,29,21,5,24,40,60.0,16,21,6,15,33,88,41,1,DF,Under 20,Defender,France,Europe
1107,Marcos Mauro López Gutiérrez,ARG,Cádiz,La Liga,2021,30.0,1991.0,1.5,1,0,0,1,0,0,2,0.0,2,2,1,1,1,2,9,0,DF,30-34,Defender,Argentina,South America
1109,Albert Guðmundsson,ISL,Genoa,Serie A,2021,24.0,1997.0,6.7,5,3,2,1,2,3,8,37.5,5,2,0,2,5,10,4,0,"FW,MF",20-24,Forward,Iceland,Europe
1110,Joško Gvardiol,CRO,RB Leipzig,Bundesliga,2021,19.0,2002.0,26.8,47,31,28,17,2,22,39,56.4,17,30,11,19,51,98,62,2,DF,Under 20,Defender,Croatia,Europe
1111,Emmanuel Gyasi,GHA,Spezia,Serie A,2021,27.0,1994.0,33.7,47,30,31,9,7,21,41,51.2,20,22,4,18,16,63,43,1,"FW,MF",25-29,Forward,Ghana,Africa
1112,Norbert Gyömbér,SVK,Salernitana,Serie A,2021,29.0,1992.0,28.5,53,32,40,11,2,33,50,66.0,17,38,24,14,44,97,126,1,DF,25-29,Defender,Slovakia,Europe
1114,Nicolas Haas,SUI,Empoli,Serie A,2021,25.0,1996.0,11.1,35,22,15,10,10,17,39,43.6,22,24,4,20,9,44,17,1,MF,25-29,Midfielder,Switzerland,Europe
1115,Janik Haberer,GER,Freiburg,Bundesliga,2021,27.0,1994.0,9.1,14,8,5,6,3,7,19,36.8,12,11,4,7,16,30,11,0,MF,25-29,Midfielder,Germany,Europe
1116,Alexander Hack,GER,Mainz 05,Bundesliga,2021,27.0,1993.0,23.0,52,26,35,17,0,29,46,63.0,17,31,14,17,51,103,95,1,DF,25-29,Defender,Germany,Europe
1117,Robin Hack,GER,Arminia,Bundesliga,2021,22.0,1998.0,15.2,14,8,6,5,3,3,21,14.3,18,18,1,17,5,19,4,0,"FW,MF",20-24,Forward,Germany,Europe
1118,Munir El Haddadi,MAR,Sevilla,La Liga,2021,25.0,1995.0,5.3,8,4,1,6,1,2,8,25.0,6,7,1,6,5,13,2,0,"FW,MF",25-29,Forward,Morocco,Africa
1119,André Hahn,GER,Augsburg,Bundesliga,2021,30.0,1990.0,23.3,36,20,9,15,12,17,50,34.0,33,38,5,33,15,51,43,0,"MF,FW",30-34,Midfielder,Germany,Europe
1120,Amadou Haidara,MLI,RB Leipzig,Bundesliga,2021,23.0,1998.0,14.7,30,14,11,19,0,17,37,45.9,20,22,6,16,16,46,8,1,MF,20-24,Midfielder,Mali,Africa
1121,Massadio Haïdara,MLI,Lens,Ligue 1,2021,28.0,1992.0,12.0,28,21,18,7,3,15,24,62.5,9,18,4,14,22,50,31,0,DF,25-29,Defender,Mali,Africa
1122,Oualid El Hajjam,MAR,Troyes,Ligue 1,2021,30.0,1991.0,11.9,22,11,12,6,4,15,23,65.2,8,12,6,6,22,44,28,0,DF,30-34,Defender,Morocco,Africa
1123,Achraf Hakimi,MAR,Paris S-G,Ligue 1,2021,22.0,1998.0,27.5,74,51,38,27,9,40,72,55.6,32,26,5,21,28,102,23,2,DF,20-24,Defender,Morocco,Africa
1124,Marcel Halstenberg,GER,RB Leipzig,Bundesliga,2021,29.0,1991.0,5.6,10,7,6,4,0,6,11,54.5,5,6,0,6,7,17,11,0,DF,25-29,Defender,Germany,Europe
1125,Pierre-Yves Hamel,FRA,Lorient,Ligue 1,2021,27.0,1994.0,0.3,0,0,0,0,0,0,1,0.0,1,0,0,0,2,2,0,0,"FW,MF",25-29,Forward,France,Europe
1126,Pierre-Yves Hamel,FRA,Clermont Foot,Ligue 1,2021,27.0,1994.0,5.8,11,6,0,5,6,5,6,83.3,1,2,1,1,0,11,0,0,FW,25-29,Forward,France,Europe
1127,Romain Hamouma,FRA,Saint-Étienne,Ligue 1,2021,34.0,1987.0,9.8,10,7,1,5,4,2,13,15.4,11,8,0,8,4,14,1,0,"FW,MF",30-34,Forward,France,Europe
1129,Grant Hanley,SCO,Norwich City,Premier League,2021,29.0,1991.0,32.2,44,25,28,14,2,18,35,51.4,17,56,45,11,56,100,176,2,DF,25-29,Defender,Scotland,Europe
1130,Ridgeciano Haps,SUR,Venezia,Serie A,2021,28.0,1993.0,22.8,36,20,26,4,6,11,21,52.4,10,34,12,22,29,65,57,1,DF,25-29,Defender,Suriname,South America
1131,Genki Haraguchi,JPN,Union Berlin,Bundesliga,2021,30.0,1991.0,19.5,37,20,12,22,3,15,48,31.3,33,25,3,22,26,63,15,0,MF,30-34,Midfielder,Japan,Asia
1132,Amine Harit,MAR,Marseille,Ligue 1,2021,24.0,1997.0,12.9,18,11,9,9,0,9,17,52.9,8,10,0,10,4,22,2,0,"FW,MF",20-24,Forward,Morocco,Africa
1133,Varazdat Haroyan,ARM,Cádiz,La Liga,2021,28.0,1992.0,16.0,31,21,20,10,1,19,29,65.5,10,22,12,10,15,46,62,0,DF,25-29,Defender,Armenia,Asia
1134,Jack Harrison,ENG,Leeds United,Premier League,2021,24.0,1996.0,29.3,57,37,22,22,13,31,76,40.8,45,35,1,34,21,78,19,0,"FW,MF",20-24,Forward,England,Europe
1135,Abdou Harroui,NED,Sassuolo,Serie A,2021,23.0,1998.0,5.0,11,4,4,7,0,8,11,72.7,3,14,0,14,4,15,5,0,MF,20-24,Midfielder,Netherlands,Europe
1136,Luis Hartwig,GER,Bochum,Bundesliga,2021,18.0,2002.0,0.0,0,0,0,0,0,0,0,,0,0,0,0,0,0,0,0,FW,Under 20,Forward,Germany,Europe
1137,Makoto Hasebe,JPN,Eint Frankfurt,Bundesliga,2021,37.0,1984.0,13.2,27,12,15,11,1,13,29,44.8,16,24,8,16,22,49,36,0,DF,35-39,Defender,Japan,Asia
1138,Hans Hateboer,NED,Atalanta,Serie A,2021,27.0,1994.0,15.4,22,14,10,8,4,11,26,42.3,15,11,1,10,7,29,20,0,"DF,MF",25-29,Defender,Netherlands,Europe
1139,Kortney Hause,ENG,Aston Villa,Premier League,2021,26.0,1995.0,4.4,3,3,2,0,1,3,4,75.0,1,8,5,3,6,9,13,0,DF,25-29,Defender,England,Europe
1140,Kai Havertz,GER,Chelsea,Premier League,2021,22.0,1999.0,20.1,17,8,5,7,5,4,14,28.6,10,28,1,27,4,21,32,1,"FW,MF",20-24,Forward,Germany,Europe
1141,Isaac Hayden,ENG,Newcastle Utd,Premier League,2021,26.0,1995.0,11.1,28,14,11,14,3,12,29,41.4,17,17,8,9,14,42,24,0,"MF,DF",25-29,Midfielder,England,Europe
1142,Eden Hazard,BEL,Real Madrid,La Liga,2021,30.0,1991.0,8.0,6,3,3,2,1,3,7,42.9,4,3,0,3,2,8,0,0,"FW,MF",30-34,Forward,Belgium,Europe
1143,Thorgan Hazard,BEL,Dortmund,Bundesliga,2021,28.0,1993.0,14.9,23,13,8,10,5,15,40,37.5,25,23,1,22,6,29,4,0,"FW,DF",25-29,Forward,Belgium,Europe
1144,Jonas Hector,GER,Köln,Bundesliga,2021,31.0,1990.0,28.4,76,39,36,26,14,29,74,39.2,45,59,8,51,50,126,68,1,DF,30-34,Defender,Germany,Europe
1145,Hwang Hee-chan,KOR,Wolves,Premier League,2021,25.0,1996.0,20.2,27,13,9,16,2,14,44,31.8,30,10,0,10,13,40,7,1,"FW,MF",25-29,Forward,South Korea,Asia
1146,Hwang Hee-chan,KOR,RB Leipzig,Bundesliga,2021,25.0,1996.0,0.5,0,0,0,0,0,0,0,,0,0,0,0,1,1,0,0,FW,25-29,Forward,South Korea,Asia
1147,Silvan Hefti,SUI,Genoa,Serie A,2021,23.0,1997.0,14.3,50,30,23,22,5,32,58,55.2,26,20,4,16,20,70,34,1,DF,20-24,Defender,Switzerland,Europe
1148,Dominique Heintz,GER,Union Berlin,Bundesliga,2021,27.0,1993.0,5.2,8,5,5,3,0,3,6,50.0,3,7,4,3,7,15,14,0,DF,25-29,Defender,Germany,Europe
1149,Dominique Heintz,GER,Freiburg,Bundesliga,2021,27.0,1993.0,0.3,0,0,0,0,0,0,0,,0,0,0,0,1,1,0,0,DF,25-29,Defender,Germany,Europe
1150,Jordan Henderson,ENG,Liverpool,Premier League,2021,31.0,1990.0,28.9,36,20,9,25,2,17,44,38.6,27,25,1,24,23,59,14,0,MF,30-34,Midfielder,England,Europe
1151,Liam Henderson,SCO,Empoli,Serie A,2021,25.0,1996.0,22.4,22,13,7,8,7,9,31,29.0,22,14,4,10,9,31,13,0,MF,25-29,Midfielder,Scotland,Europe
1152,Jeff Hendrick,IRL,Newcastle Utd,Premier League,2021,29.0,1992.0,0.8,1,1,0,1,0,1,1,100.0,0,0,0,0,0,1,1,0,MF,25-29,Midfielder,Republic of Ireland,Europe
1153,Wayne Hennessey,WAL,Burnley,Premier League,2021,34.0,1987.0,2.0,0,0,0,0,0,0,0,,0,0,0,0,1,1,0,1,GK,30-34,Goalkeeper,Wales,Europe
1154,Benjamin Henrichs,GER,RB Leipzig,Bundesliga,2021,24.0,1997.0,12.7,30,21,18,6,6,12,22,54.5,10,16,1,15,19,49,14,0,DF,20-24,Defender,Germany,Europe
1155,Henrique,BRA,Lyon,Ligue 1,2021,27.0,1994.0,12.3,13,7,10,1,2,5,16,31.3,11,13,1,12,22,35,14,0,DF,25-29,Defender,Brazil,South America
1155,Henrique,BRA,Lyon,Ligue 1,2021,27.0,1994.0,12.3,13,7,10,1,2,5,16,31.3,11,13,1,12,22,35,14,0,DF,25-29,Defender,Brazil,South America
1155,Henrique,BRA,Lyon,Ligue 1,2021,27.0,1994.0,12.3,13,7,10,1,2,5,16,31.3,11,13,1,12,22,35,14,0,DF,25-29,Defender,Brazil,South America
1155,Henrique,BRA,Lyon,Ligue 1,2021,27.0,1994.0,12.3,13,7,10,1,2,5,16,31.3,11,13,1,12,22,35,14,0,DF,25-29,Defender,Brazil,South America
1155,Henrique,BRA,Lyon,Ligue 1,2021,27.0,1994.0,12.3,13,7,10,1,2,5,16,31.3,11,13,1,12,22,35,14,0,DF,25-29,Defender,Brazil,South America
1155,Henrique,BRA,Lyon,Ligue 1,2021,27.0,1994.0,12.3,13,7,10,1,2,5,16,31.3,11,13,1,12,22,35,14,0,DF,25-29,Defender,Brazil,South America
1155,Henrique,BRA,Lyon,Ligue 1,2021,27.0,1994.0,12.3,13,7,10,1,2,5,16,31.3,11,13,1,12,22,35,14,0,DF,25-29,Defender,Brazil,South America
1155,Henrique,BRA,Lyon,Ligue 1,2021,27.0,1994.0,12.3,13,7,10,1,2,5,16,31.3,11,13,1,12,22,35,14,0,DF,25-29,Defender,Brazil,South America
1155,Henrique,BRA,Lyon,Ligue 1,2021,27.0,1994.0,12.3,13,7,10,1,2,5,16,31.3,11,13,1,12,22,35,14,0,DF,25-29,Defender,Brazil,South America
1155,Henrique,BRA,Lyon,Ligue 1,2021,27.0,1994.0,12.3,13,7,10,1,2,5,16,31.3,11,13,1,12,22,35,14,0,DF,25-29,Defender,Brazil,South America
1155,Henrique,BRA,Lyon,Ligue 1,2021,27.0,1994.0,12.3,13,7,10,1,2,5,16,31.3,11,13,1,12,22,35,14,0,DF,25-29,Defender,Brazil,South America
1155,Henrique,BRA,Lyon,Ligue 1,2021,27.0,1994.0,12.3,13,7,10,1,2,5,16,31.3,11,13,1,12,22,35,14,0,DF,25-29,Defender,Brazil,South America
1155,Henrique,BRA,Lyon,Ligue 1,2021,27.0,1994.0,12.3,13,7,10,1,2,5,16,31.3,11,13,1,12,22,35,14,0,DF,25-29,Defender,Brazil,South America
1155,Henrique,BRA,Lyon,Ligue 1,2021,27.0,1994.0,12.3,13,7,10,1,2,5,16,31.3,11,13,1,12,22,35,14,0,DF,25-29,Defender,Brazil,South America
1155,Henrique,BRA,Lyon,Ligue 1,2021,27.0,1994.0,12.3,13,7,10,1,2,5,16,31.3,11,13,1,12,22,35,14,0,DF,25-29,Defender,Brazil,South America
1155,Henrique,BRA,Lyon,Ligue 1,2021,27.0,1994.0,12.3,13,7,10,1,2,5,16,31.3,11,13,1,12,22,35,14,0,DF,25-29,Defender,Brazil,South America
1156,Dalbert Henrique,BRA,Cagliari,Serie A,2021,27.0,1993.0,23.1,43,23,23,16,4,11,35,31.4,24,28,5,23,24,67,34,0,"DF,MF",25-29,Defender,Brazil,South America
1157,Luis Henrique,BRA,Marseille,Ligue 1,2021,19.0,2001.0,7.8,4,3,2,1,1,2,5,40.0,3,2,0,2,5,9,1,0,"FW,MF",Under 20,Forward,Brazil,South America
1157,Luis Henrique,BRA,Marseille,Ligue 1,2021,19.0,2001.0,7.8,4,3,2,1,1,2,5,40.0,3,2,0,2,5,9,1,0,"FW,MF",Under 20,Forward,Brazil,South America
1157,Luis Henrique,BRA,Marseille,Ligue 1,2021,19.0,2001.0,7.8,4,3,2,1,1,2,5,40.0,3,2,0,2,5,9,1,0,"FW,MF",Under 20,Forward,Brazil,South America
1157,Luis Henrique,BRA,Marseille,Ligue 1,2021,19.0,2001.0,7.8,4,3,2,1,1,2,5,40.0,3,2,0,2,5,9,1,0,"FW,MF",Under 20,Forward,Brazil,South America
1158,Matheus Henrique,BRA,Sassuolo,Serie A,2021,23.0,1997.0,12.0,10,3,6,3,1,6,24,25.0,18,14,2,12,7,17,12,1,MF,20-24,Midfielder,Brazil,South America
1159,Rico Henry,ENG,Brentford,Premier League,2021,24.0,1997.0,30.8,28,20,18,8,2,12,34,35.3,22,31,10,21,26,54,76,1,DF,20-24,Defender,England,Europe
1160,Thomas Henry,FRA,Venezia,Serie A,2021,26.0,1994.0,23.5,9,4,2,3,4,5,13,38.5,8,11,5,6,2,11,25,0,FW,25-29,Forward,France,Europe
1162,Jérôme Hergault,FRA,Lorient,Ligue 1,2021,35.0,1986.0,3.9,3,1,1,2,0,2,5,40.0,3,4,1,3,4,7,7,0,DF,35-39,Defender,France,Europe
1166,Lucas Hernández,FRA,Bayern Munich,Bundesliga,2021,25.0,1996.0,22.6,50,31,20,24,6,26,42,61.9,16,22,11,11,28,78,54,1,DF,25-29,Defender,France,Europe
1169,Theo Hernández,FRA,Milan,Serie A,2021,23.0,1997.0,30.1,53,35,34,14,5,29,40,72.5,11,16,3,13,23,76,29,3,DF,20-24,Defender,France,Europe
1170,Hernani,BRA,Genoa,Serie A,2021,27.0,1994.0,7.6,20,10,8,9,3,13,32,40.6,19,17,4,13,13,33,5,1,"MF,FW",25-29,Midfielder,Brazil,South America
1172,Héctor Herrera,MEX,Atlético Madrid,La Liga,2021,31.0,1990.0,9.5,16,8,11,4,1,7,20,35.0,13,13,2,11,12,28,16,0,MF,30-34,Midfielder,Mexico,North America
1174,Yangel Herrera,VEN,Espanyol,La Liga,2021,23.0,1998.0,18.3,41,31,19,19,3,18,39,46.2,21,27,5,22,19,60,33,1,MF,20-24,Midfielder,Venezuela,South America
1175,Patrick Herrmann,GER,Gladbach,Bundesliga,2021,30.0,1991.0,8.4,15,7,5,6,4,9,24,37.5,15,10,1,9,6,21,8,0,"DF,FW",30-34,Defender,Germany,Europe
1176,Son Heung-min,KOR,Tottenham,Premier League,2021,29.0,1992.0,33.4,15,6,5,7,3,5,23,21.7,18,27,6,21,13,28,8,0,"MF,FW",25-29,Midfielder,South Korea,Asia
1177,Daan Heymans,BEL,Venezia,Serie A,2021,22.0,1999.0,2.8,3,1,1,2,0,1,5,20.0,4,7,3,4,4,7,3,0,"MF,FW",20-24,Midfielder,Belgium,Europe
1178,Aaron Hickey,SCO,Bologna,Serie A,2021,19.0,2002.0,31.3,46,29,24,15,7,20,30,66.7,10,36,13,23,29,75,44,0,DF,Under 20,Defender,Scotland,Europe
1179,Piero Hincapié,ECU,Leverkusen,Bundesliga,2021,19.0,2002.0,19.5,33,23,23,8,2,19,25,76.0,6,34,15,19,33,66,56,2,DF,Under 20,Defender,Ecuador,South America
1180,Martin Hinteregger,AUT,Eint Frankfurt,Bundesliga,2021,28.0,1992.0,24.7,45,28,28,16,1,28,43,65.1,15,36,16,20,42,87,78,3,DF,25-29,Defender,Austria,Europe
1181,Marwin Hitz,SUI,Dortmund,Bundesliga,2021,33.0,1987.0,4.5,0,0,0,0,0,0,0,,0,0,0,0,0,0,2,0,GK,30-34,Goalkeeper,Switzerland,Europe
1182,Ki-Jana Hoever,NED,Wolves,Premier League,2021,19.0,2002.0,3.4,10,6,5,5,0,7,12,58.3,5,6,0,6,6,16,8,0,"DF,MF",Under 20,Defender,Netherlands,Europe
1183,Nicolas Höfler,GER,Freiburg,Bundesliga,2021,31.0,1990.0,28.9,73,42,37,29,7,28,62,45.2,34,50,21,29,46,119,42,0,MF,30-34,Midfielder,Germany,Europe
1184,Jonas Hofmann,GER,Gladbach,Bundesliga,2021,29.0,1992.0,23.1,30,20,6,17,7,17,42,40.5,25,23,0,23,12,42,10,0,"MF,FW",25-29,Midfielder,Germany,Europe
1184,Jonas Hofmann,GER,Gladbach,Bundesliga,2021,29.0,1992.0,23.1,30,20,6,17,7,17,42,40.5,25,23,0,23,12,42,10,0,"MF,FW",25-29,Midfielder,Germany,Europe
1184,Jonas Hofmann,GER,Gladbach,Bundesliga,2021,29.0,1992.0,23.1,30,20,6,17,7,17,42,40.5,25,23,0,23,12,42,10,0,"MF,FW",25-29,Midfielder,Germany,Europe
1184,Jonas Hofmann,GER,Gladbach,Bundesliga,2021,29.0,1992.0,23.1,30,20,6,17,7,17,42,40.5,25,23,0,23,12,42,10,0,"MF,FW",25-29,Midfielder,Germany,Europe
1185,Rob Holding,ENG,Arsenal,Premier League,2021,25.0,1995.0,9.4,13,9,11,1,1,5,6,83.3,1,23,18,5,10,23,42,1,DF,25-29,Defender,England,Europe
1186,Lucas Höler,GER,Freiburg,Bundesliga,2021,27.0,1994.0,28.7,41,25,10,17,14,13,28,46.4,15,25,4,21,17,58,39,2,FW,25-29,Forward,Germany,Europe
1187,Mason Holgate,ENG,Everton,Premier League,2021,24.0,1996.0,23.7,35,18,26,9,0,11,26,42.3,15,25,17,8,26,61,95,1,DF,20-24,Defender,England,Europe
1188,Gerrit Holtmann,PHI,Bochum,Bundesliga,2021,26.0,1995.0,20.4,15,9,5,3,7,6,22,27.3,16,26,2,24,8,23,6,0,"FW,MF",25-29,Forward,Philippines,Asia
1189,Martin Hongla,CMR,Hellas Verona,Serie A,2021,23.0,1998.0,7.2,14,8,5,6,3,4,8,50.0,4,6,2,4,4,18,16,1,MF,20-24,Midfielder,Cameroon,Africa
1190,Franck Honorat,FRA,Brest,Ligue 1,2021,24.0,1996.0,32.2,54,38,25,13,16,27,47,57.4,20,24,2,22,15,69,25,0,"FW,MF",20-24,Forward,France,Europe
1191,Justin Hoogma,NED,Greuther Fürth,Bundesliga,2021,23.0,1998.0,3.0,6,5,4,2,0,4,6,66.7,2,5,5,0,4,10,4,0,DF,20-24,Defender,Netherlands,Europe
1192,Sydney van Hooijdonk,NED,Bologna,Serie A,2021,21.0,2000.0,0.4,0,0,0,0,0,0,1,0.0,1,1,0,1,0,0,0,0,"FW,MF",20-24,Forward,Netherlands,Europe
1193,Matthew Hoppe,USA,Mallorca,La Liga,2021,20.0,2001.0,1.5,1,0,0,0,1,0,3,0.0,3,0,0,0,0,1,0,0,"FW,MF",20-24,Forward,United States,North America
1194,Jannes Horn,GER,Köln,Bundesliga,2021,24.0,1997.0,5.3,6,4,4,2,0,4,8,50.0,4,1,1,0,3,9,9,0,DF,20-24,Defender,Germany,Europe
1195,Timo Horn,GER,Köln,Bundesliga,2021,28.0,1993.0,13.0,0,0,0,0,0,0,1,0.0,1,0,0,0,0,0,5,0,GK,25-29,Goalkeeper,Germany,Europe
1196,Fraser Hornby,SCO,Reims,Ligue 1,2021,21.0,1999.0,3.9,3,1,1,2,0,0,2,0.0,2,3,0,3,4,7,5,0,"FW,MF",20-24,Forward,Scotland,Europe
1197,Cédric Hountondji,BEN,Clermont Foot,Ligue 1,2021,27.0,1994.0,22.6,33,17,20,12,1,16,24,66.7,8,23,12,11,34,67,76,0,DF,25-29,Defender,Benin,Africa
1198,Lukáš Hrádecký,FIN,Leverkusen,Bundesliga,2021,31.0,1989.0,32.0,1,1,1,0,0,1,1,100.0,0,0,0,0,0,1,10,1,GK,30-34,Goalkeeper,Finland,Europe
1199,Branimir Hrgota,SWE,Greuther Fürth,Bundesliga,2021,28.0,1993.0,30.9,46,29,10,31,5,21,72,29.2,51,27,1,26,11,57,3,1,FW,25-29,Forward,Sweden,Europe
1200,Petko Hristov,BUL,Spezia,Serie A,2021,22.0,1999.0,13.9,17,10,11,6,0,10,16,62.5,6,29,23,6,19,36,47,0,DF,20-24,Defender,Bulgaria,Europe
1201,Ajdin Hrustic,AUS,Eint Frankfurt,Bundesliga,2021,25.0,1996.0,10.7,16,11,5,7,4,11,32,34.4,21,18,1,17,10,26,7,0,MF,25-29,Midfielder,Australia,Oceania
1202,Timo Hübers,GER,Köln,Bundesliga,2021,25.0,1996.0,19.3,45,27,28,17,0,27,45,60.0,18,31,19,12,52,97,95,0,DF,25-29,Defender,Germany,Europe
1203,Benjamin Hübner,GER,Hoffenheim,Bundesliga,2021,32.0,1989.0,4.2,9,5,0,7,2,3,5,60.0,2,2,2,0,9,18,7,0,DF,30-34,Defender,Germany,Europe
1204,Callum Hudson-Odoi,ENG,Chelsea,Premier League,2021,20.0,2000.0,10.7,14,10,5,6,3,8,23,34.8,15,8,0,8,2,16,6,1,"MF,FW",20-24,Midfielder,England,Europe
1205,Will Hughes,ENG,Crystal Palace,Premier League,2021,26.0,1995.0,11.7,29,14,10,16,3,7,16,43.8,9,13,7,6,8,37,10,0,MF,25-29,Midfielder,England,Europe
1206,Mats Hummels,GER,Dortmund,Bundesliga,2021,32.0,1988.0,19.6,34,22,20,13,1,20,36,55.6,16,18,13,5,32,66,66,1,DF,30-34,Defender,Germany,Europe
1207,Elseid Hysaj,ALB,Lazio,Serie A,2021,27.0,1994.0,22.5,46,30,25,17,4,29,45,64.4,16,18,6,12,24,70,34,1,DF,25-29,Defender,Albania,Europe
1208,Suk Hyun-jun,KOR,Troyes,Ligue 1,2021,30.0,1991.0,1.7,0,0,0,0,0,0,0,,0,2,0,2,0,0,2,0,"FW,MF",30-34,Forward,South Korea,Asia
1209,Pierre Højbjerg,DEN,Tottenham,Premier League,2021,25.0,1995.0,35.5,78,45,31,38,9,38,85,44.7,47,61,13,48,48,126,54,0,MF,25-29,Midfielder,Denmark,Europe
1210,Iago,BRA,Augsburg,Bundesliga,2021,24.0,1997.0,24.2,49,29,25,19,5,15,34,44.1,19,28,6,22,27,76,62,0,DF,20-24,Defender,Brazil,South America
1212,Roger Ibanez,BRA,Roma,Serie A,2021,22.0,1998.0,32.1,54,32,31,19,4,26,43,60.5,17,26,7,19,62,116,104,2,DF,20-24,Defender,Brazil,South America
1214,Zlatan Ibrahimović,SWE,Milan,Serie A,2021,39.0,1981.0,11.3,0,0,0,0,0,0,2,0.0,2,2,1,1,3,3,9,0,FW,35-39,Forward,Sweden,Europe
1215,Mauro Icardi,ARG,Paris S-G,Ligue 1,2021,28.0,1993.0,11.4,5,3,1,3,1,3,7,42.9,4,3,0,3,5,10,12,0,FW,25-29,Forward,Argentina,South America
1216,Adam Idah,IRL,Norwich City,Premier League,2021,20.0,2001.0,6.9,9,6,2,5,2,2,3,66.7,1,4,2,2,3,12,7,0,"FW,MF",20-24,Forward,Republic of Ireland,Europe
1217,Oussama Idrissi,MAR,Sevilla,La Liga,2021,25.0,1996.0,1.4,1,0,0,1,0,0,1,0.0,1,1,0,1,1,2,1,0,"MF,FW",25-29,Midfielder,Morocco,Africa
1218,Oussama Idrissi,MAR,Cádiz,La Liga,2021,25.0,1996.0,10.0,8,4,3,4,1,4,15,26.7,11,8,0,8,3,11,5,0,MF,25-29,Midfielder,Morocco,Africa
1221,Jonathan Iglesias,URU,Clermont Foot,Ligue 1,2021,32.0,1988.0,6.4,18,11,6,10,2,10,18,55.6,8,8,2,6,5,23,2,1,MF,30-34,Midfielder,Uruguay,South America
1222,Juan Ignacio Ramírez,URU,Saint-Étienne,Ligue 1,2021,24.0,1997.0,1.4,2,1,0,1,1,0,0,,0,0,0,0,0,2,0,0,FW,20-24,Forward,Uruguay,South America
1223,Igor,BRA,Fiorentina,Serie A,2021,23.0,1998.0,24.9,53,31,34,16,3,30,40,75.0,10,37,19,18,31,84,46,4,DF,20-24,Defender,Brazil,South America
1223,Igor,BRA,Fiorentina,Serie A,2021,23.0,1998.0,24.9,53,31,34,16,3,30,40,75.0,10,37,19,18,31,84,46,4,DF,20-24,Defender,Brazil,South America
1223,Igor,BRA,Fiorentina,Serie A,2021,23.0,1998.0,24.9,53,31,34,16,3,30,40,75.0,10,37,19,18,31,84,46,4,DF,20-24,Defender,Brazil,South America
1223,Igor,BRA,Fiorentina,Serie A,2021,23.0,1998.0,24.9,53,31,34,16,3,30,40,75.0,10,37,19,18,31,84,46,4,DF,20-24,Defender,Brazil,South America
1224,Kelechi Iheanacho,NGA,Leicester City,Premier League,2021,24.0,1996.0,14.0,10,7,2,5,3,3,14,21.4,11,19,0,19,4,14,10,0,FW,20-24,Forward,Nigeria,Africa
1225,Danylo Ihnatenko,UKR,Bordeaux,Ligue 1,2021,24.0,1997.0,7.7,17,9,8,7,2,10,24,41.7,14,9,2,7,6,23,17,1,MF,20-24,Midfielder,Ukraine,Europe
1226,Jonathan Ikone,FRA,Fiorentina,Serie A,2021,23.0,1998.0,7.2,7,3,2,3,2,3,10,30.0,7,10,2,8,1,8,2,0,FW,20-24,Forward,France,Europe
1227,Jonathan Ikone,FRA,Lille,Ligue 1,2021,23.0,1998.0,11.8,11,3,6,4,1,4,11,36.4,7,13,1,12,5,16,4,0,"MF,FW",20-24,Midfielder,France,Europe
1231,Stefan Ilsanker,AUT,Eint Frankfurt,Bundesliga,2021,32.0,1989.0,3.0,14,8,7,6,1,5,10,50.0,5,6,2,4,6,20,15,1,"DF,MF",30-34,Defender,Austria,Europe
1232,Ciro Immobile,ITA,Lazio,Serie A,2021,31.0,1990.0,30.1,10,5,4,4,2,1,15,6.7,14,7,1,6,3,13,16,0,FW,30-34,Forward,Italy,Europe
1233,Burak İnce,TUR,Arminia,Bundesliga,2021,17.0,2004.0,1.5,1,1,1,0,0,1,2,50.0,1,1,0,1,0,1,0,0,FW,Under 20,Forward,Turkey,Asia
1234,Danny Ings,ENG,Aston Villa,Premier League,2021,29.0,1992.0,21.1,23,16,2,16,5,13,37,35.1,24,31,2,29,6,29,22,0,FW,25-29,Forward,England,Europe
1235,Marcus Ingvartsen,DEN,Union Berlin,Bundesliga,2021,25.0,1996.0,1.4,0,0,0,0,0,0,2,0.0,2,0,0,0,2,2,1,0,MF,25-29,Midfielder,Denmark,Europe
1236,Marcus Ingvartsen,DEN,Mainz 05,Bundesliga,2021,25.0,1996.0,7.6,3,2,2,0,1,3,9,33.3,6,6,0,6,6,9,7,1,"FW,MF",25-29,Forward,Denmark,Europe
1237,Bonke Innocent,NGA,Lorient,Ligue 1,2021,25.0,1996.0,9.7,27,16,10,16,1,11,26,42.3,15,11,3,8,16,43,14,0,MF,25-29,Midfielder,Nigeria,Africa
1238,Lorenzo Insigne,ITA,Napoli,Serie A,2021,30.0,1991.0,25.4,23,14,8,12,3,8,44,18.2,36,30,1,29,20,43,3,1,FW,30-34,Forward,Italy,Europe
1239,Nikita Iosifov,RUS,Villarreal,La Liga,2021,20.0,2001.0,0.0,0,0,0,0,0,0,0,,0,0,0,0,0,0,0,0,MF,20-24,Midfielder,Russia,Europe
1240,Tim Iroegbunam,ENG,Aston Villa,Premier League,2021,18.0,2003.0,1.0,5,4,2,3,0,1,1,100.0,0,0,0,0,2,7,1,0,MF,Under 20,Midfielder,England,Europe
1241,Alexander Isak,SWE,Real Sociedad,La Liga,2021,21.0,1999.0,23.8,7,4,1,3,3,2,12,16.7,10,14,2,12,3,10,10,0,FW,20-24,Forward,Sweden,Europe
1243,Wilson Isidor,FRA,Monaco,Ligue 1,2021,20.0,2000.0,0.6,0,0,0,0,0,0,4,0.0,4,1,0,1,0,0,0,0,"FW,MF",20-24,Forward,France,Europe
1244,Ardian Ismajli,ALB,Empoli,Serie A,2021,24.0,1996.0,14.1,13,9,8,4,1,5,14,35.7,9,21,11,10,24,37,80,0,DF,20-24,Defender,Albania,Europe
1245,Hiroki Ito,JPN,Stuttgart,Bundesliga,2021,22.0,1999.0,26.1,43,31,21,19,3,25,43,58.1,18,40,19,21,53,96,95,0,DF,20-24,Defender,Japan,Asia
1246,Cedric Itten,SUI,Greuther Fürth,Bundesliga,2021,24.0,1996.0,7.1,5,2,1,2,2,1,6,16.7,5,3,0,3,2,7,4,0,FW,20-24,Forward,Switzerland,Europe
1247,Gian-Luca Itter,GER,Greuther Fürth,Bundesliga,2021,22.0,1999.0,16.2,44,26,30,11,3,21,38,55.3,17,24,9,15,13,57,51,0,DF,20-24,Defender,Germany,Europe
1248,Alex Iwobi,NGA,Everton,Premier League,2021,25.0,1996.0,22.6,40,19,23,12,5,21,52,40.4,31,39,3,36,20,60,25,2,"MF,DF",25-29,Midfielder,Nigeria,Africa
1249,Armando Izzo,ITA,Torino,Serie A,2021,29.0,1992.0,5.8,16,9,14,2,0,9,11,81.8,2,5,4,1,17,33,21,0,DF,25-29,Defender,Italy,Europe
1250,Nicolas Jackson,SEN,Villarreal,La Liga,2021,20.0,2001.0,1.8,2,0,1,0,1,0,0,,0,0,0,0,1,3,1,0,"FW,MF",20-24,Forward,Senegal,Africa
1251,Lee Jae-sung,KOR,Mainz 05,Bundesliga,2021,28.0,1992.0,16.0,30,12,8,14,8,6,27,22.2,21,20,2,18,18,48,18,0,"MF,FW",25-29,Midfielder,South Korea,Asia
1252,Paul Jaeckel,GER,Union Berlin,Bundesliga,2021,23.0,1998.0,22.7,51,29,27,24,0,29,51,56.9,22,34,10,24,57,108,81,0,DF,20-24,Defender,Germany,Europe
1253,Mato Jajalo,BIH,Udinese,Serie A,2021,33.0,1988.0,7.0,24,14,14,7,3,11,23,47.8,12,7,0,7,11,35,5,0,MF,30-34,Midfielder,Bosnia and Herzegovina,Europe
1254,Kristijan Jakić,CRO,Eint Frankfurt,Bundesliga,2021,24.0,1997.0,20.9,37,22,10,21,6,15,62,24.2,47,33,3,30,21,58,25,1,MF,20-24,Midfielder,Croatia,Europe
1255,Ismail Jakobs,SEN,Monaco,Ligue 1,2021,21.0,1999.0,13.4,32,16,14,15,3,16,35,45.7,19,16,1,15,17,49,31,0,"DF,FW",20-24,Defender,Senegal,Africa
1256,Marin Jakoliš,CRO,Angers,Ligue 1,2021,24.0,1996.0,2.5,2,1,0,1,1,0,6,0.0,6,0,0,0,1,3,0,0,FW,20-24,Forward,Croatia,Europe
1257,Abdel Jalil Medioub,ALG,Bordeaux,Ligue 1,2021,23.0,1997.0,6.9,9,5,5,3,1,3,4,75.0,1,8,4,4,12,21,34,0,DF,20-24,Defender,Algeria,Africa
1258,Daniel James,WAL,Manchester Utd,Premier League,2021,23.0,1997.0,1.4,2,1,0,2,0,0,0,,0,2,0,2,0,2,1,0,FW,20-24,Forward,Wales,Europe
1259,Daniel James,WAL,Leeds United,Premier League,2021,23.0,1997.0,26.3,24,14,8,8,8,10,23,43.5,13,18,1,17,8,32,12,0,"FW,MF",20-24,Forward,Wales,Europe
1260,Reece James,ENG,Chelsea,Premier League,2021,21.0,1999.0,20.7,33,25,14,18,1,9,22,40.9,13,20,2,18,17,50,22,0,DF,20-24,Defender,England,Europe
1260,Reece James,ENG,Chelsea,Premier League,2021,21.0,1999.0,20.7,33,25,14,18,1,9,22,40.9,13,20,2,18,17,50,22,0,DF,20-24,Defender,England,Europe
1260,Reece James,ENG,Chelsea,Premier League,2021,21.0,1999.0,20.7,33,25,14,18,1,9,22,40.9,13,20,2,18,17,50,22,0,DF,20-24,Defender,England,Europe
1260,Reece James,ENG,Chelsea,Premier League,2021,21.0,1999.0,20.7,33,25,14,18,1,9,22,40.9,13,20,2,18,17,50,22,0,DF,20-24,Defender,England,Europe
1261,Vitaly Janelt,GER,Brentford,Premier League,2021,23.0,1998.0,25.5,61,32,26,27,8,27,53,50.9,26,23,7,16,28,89,35,0,MF,20-24,Midfielder,Germany,Europe
1263,Pontus Jansson,SWE,Brentford,Premier League,2021,30.0,1991.0,36.9,40,21,32,8,0,22,34,64.7,12,37,27,10,52,92,187,0,DF,30-34,Defender,Sweden,Europe
1264,Tony Jantschke,GER,Gladbach,Bundesliga,2021,31.0,1990.0,2.5,6,5,2,4,0,3,6,50.0,3,3,2,1,5,11,8,0,DF,30-34,Defender,Germany,Europe
1265,Adnan Januzaj,BEL,Real Sociedad,La Liga,2021,26.0,1995.0,18.1,17,11,5,8,4,9,24,37.5,15,15,3,12,12,29,15,0,"FW,MF",25-29,Forward,Belgium,Europe
1266,Léo Jardim,BRA,Lille,Ligue 1,2021,26.0,1995.0,17.0,0,0,0,0,0,0,0,,0,0,0,0,1,1,10,0,GK,25-29,Goalkeeper,Brazil,South America
1271,Luis Javier Suárez,COL,Granada,La Liga,2021,23.0,1997.0,31.6,26,14,9,9,8,8,27,29.6,19,25,3,22,6,32,23,0,FW,20-24,Forward,Colombia,South America
1272,Corentin Jean,FRA,Lens,Ligue 1,2021,26.0,1995.0,2.8,9,6,4,4,1,3,6,50.0,3,5,0,5,1,10,0,0,"FW,MF",25-29,Forward,France,Europe
1273,Jemerson,BRA,Metz,Ligue 1,2021,28.0,1992.0,13.4,37,25,30,7,0,18,26,69.2,8,23,8,15,25,62,33,1,DF,25-29,Defender,Brazil,South America
1274,Fredrik Jensen,FIN,Augsburg,Bundesliga,2021,23.0,1997.0,4.6,5,4,1,3,1,4,7,57.1,3,5,1,4,2,7,4,0,"MF,FW",20-24,Midfielder,Finland,Europe
1275,Mathias Jensen,DEN,Brentford,Premier League,2021,25.0,1996.0,17.8,33,18,12,16,5,22,63,34.9,41,32,3,29,22,55,13,0,MF,25-29,Midfielder,Denmark,Europe
1276,Moritz Jenz,GER,Lorient,Ligue 1,2021,22.0,1999.0,15.3,26,12,18,6,2,11,24,45.8,13,19,11,8,28,54,55,0,DF,20-24,Defender,Germany,Europe
1277,Gabriel Jesus,BRA,Manchester City,Premier League,2021,24.0,1997.0,20.9,18,12,2,4,12,6,26,23.1,20,18,0,18,15,33,8,0,FW,20-24,Forward,Brazil,South America
1278,Juan Jesus,BRA,Napoli,Serie A,2021,30.0,1991.0,14.2,25,17,14,11,0,12,18,66.7,6,21,16,5,9,34,34,0,DF,30-34,Defender,Brazil,South America
1280,Raúl Jiménez,MEX,Wolves,Premier League,2021,30.0,1991.0,29.2,29,14,6,16,7,6,30,20.0,24,31,5,26,13,42,26,0,FW,30-34,Forward,Mexico,North America
1281,João Pedro,BRA,Watford,Premier League,2021,19.0,2001.0,18.3,20,14,7,8,5,6,23,26.1,17,23,3,20,15,35,17,0,"FW,MF",Under 20,Forward,Brazil,South America
1281,João Pedro,BRA,Watford,Premier League,2021,19.0,2001.0,18.3,20,14,7,8,5,6,23,26.1,17,23,3,20,15,35,17,0,"FW,MF",Under 20,Forward,Brazil,South America
1281,João Pedro,BRA,Watford,Premier League,2021,19.0,2001.0,18.3,20,14,7,8,5,6,23,26.1,17,23,3,20,15,35,17,0,"FW,MF",Under 20,Forward,Brazil,South America
1281,João Pedro,BRA,Watford,Premier League,2021,19.0,2001.0,18.3,20,14,7,8,5,6,23,26.1,17,23,3,20,15,35,17,0,"FW,MF",Under 20,Forward,Brazil,South America
1281,João Pedro,BRA,Watford,Premier League,2021,19.0,2001.0,18.3,20,14,7,8,5,6,23,26.1,17,23,3,20,15,35,17,0,"FW,MF",Under 20,Forward,Brazil,South America
1281,João Pedro,BRA,Watford,Premier League,2021,19.0,2001.0,18.3,20,14,7,8,5,6,23,26.1,17,23,3,20,15,35,17,0,"FW,MF",Under 20,Forward,Brazil,South America
1281,João Pedro,BRA,Watford,Premier League,2021,19.0,2001.0,18.3,20,14,7,8,5,6,23,26.1,17,23,3,20,15,35,17,0,"FW,MF",Under 20,Forward,Brazil,South America
1281,João Pedro,BRA,Watford,Premier League,2021,19.0,2001.0,18.3,20,14,7,8,5,6,23,26.1,17,23,3,20,15,35,17,0,"FW,MF",Under 20,Forward,Brazil,South America
1281,João Pedro,BRA,Watford,Premier League,2021,19.0,2001.0,18.3,20,14,7,8,5,6,23,26.1,17,23,3,20,15,35,17,0,"FW,MF",Under 20,Forward,Brazil,South America
1281,João Pedro,BRA,Watford,Premier League,2021,19.0,2001.0,18.3,20,14,7,8,5,6,23,26.1,17,23,3,20,15,35,17,0,"FW,MF",Under 20,Forward,Brazil,South America
1281,João Pedro,BRA,Watford,Premier League,2021,19.0,2001.0,18.3,20,14,7,8,5,6,23,26.1,17,23,3,20,15,35,17,0,"FW,MF",Under 20,Forward,Brazil,South America
1281,João Pedro,BRA,Watford,Premier League,2021,19.0,2001.0,18.3,20,14,7,8,5,6,23,26.1,17,23,3,20,15,35,17,0,"FW,MF",Under 20,Forward,Brazil,South America
1281,João Pedro,BRA,Watford,Premier League,2021,19.0,2001.0,18.3,20,14,7,8,5,6,23,26.1,17,23,3,20,15,35,17,0,"FW,MF",Under 20,Forward,Brazil,South America
1281,João Pedro,BRA,Watford,Premier League,2021,19.0,2001.0,18.3,20,14,7,8,5,6,23,26.1,17,23,3,20,15,35,17,0,"FW,MF",Under 20,Forward,Brazil,South America
1281,João Pedro,BRA,Watford,Premier League,2021,19.0,2001.0,18.3,20,14,7,8,5,6,23,26.1,17,23,3,20,15,35,17,0,"FW,MF",Under 20,Forward,Brazil,South America
1281,João Pedro,BRA,Watford,Premier League,2021,19.0,2001.0,18.3,20,14,7,8,5,6,23,26.1,17,23,3,20,15,35,17,0,"FW,MF",Under 20,Forward,Brazil,South America
1281,João Pedro,BRA,Watford,Premier League,2021,19.0,2001.0,18.3,20,14,7,8,5,6,23,26.1,17,23,3,20,15,35,17,0,"FW,MF",Under 20,Forward,Brazil,South America
1281,João Pedro,BRA,Watford,Premier League,2021,19.0,2001.0,18.3,20,14,7,8,5,6,23,26.1,17,23,3,20,15,35,17,0,"FW,MF",Under 20,Forward,Brazil,South America
1281,João Pedro,BRA,Watford,Premier League,2021,19.0,2001.0,18.3,20,14,7,8,5,6,23,26.1,17,23,3,20,15,35,17,0,"FW,MF",Under 20,Forward,Brazil,South America
1281,João Pedro,BRA,Watford,Premier League,2021,19.0,2001.0,18.3,20,14,7,8,5,6,23,26.1,17,23,3,20,15,35,17,0,"FW,MF",Under 20,Forward,Brazil,South America
1281,João Pedro,BRA,Watford,Premier League,2021,19.0,2001.0,18.3,20,14,7,8,5,6,23,26.1,17,23,3,20,15,35,17,0,"FW,MF",Under 20,Forward,Brazil,South America
1281,João Pedro,BRA,Watford,Premier League,2021,19.0,2001.0,18.3,20,14,7,8,5,6,23,26.1,17,23,3,20,15,35,17,0,"FW,MF",Under 20,Forward,Brazil,South America
1281,João Pedro,BRA,Watford,Premier League,2021,19.0,2001.0,18.3,20,14,7,8,5,6,23,26.1,17,23,3,20,15,35,17,0,"FW,MF",Under 20,Forward,Brazil,South America
1281,João Pedro,BRA,Watford,Premier League,2021,19.0,2001.0,18.3,20,14,7,8,5,6,23,26.1,17,23,3,20,15,35,17,0,"FW,MF",Under 20,Forward,Brazil,South America
1281,João Pedro,BRA,Watford,Premier League,2021,19.0,2001.0,18.3,20,14,7,8,5,6,23,26.1,17,23,3,20,15,35,17,0,"FW,MF",Under 20,Forward,Brazil,South America
1281,João Pedro,BRA,Watford,Premier League,2021,19.0,2001.0,18.3,20,14,7,8,5,6,23,26.1,17,23,3,20,15,35,17,0,"FW,MF",Under 20,Forward,Brazil,South America
1281,João Pedro,BRA,Watford,Premier League,2021,19.0,2001.0,18.3,20,14,7,8,5,6,23,26.1,17,23,3,20,15,35,17,0,"FW,MF",Under 20,Forward,Brazil,South America
1281,João Pedro,BRA,Watford,Premier League,2021,19.0,2001.0,18.3,20,14,7,8,5,6,23,26.1,17,23,3,20,15,35,17,0,"FW,MF",Under 20,Forward,Brazil,South America
1281,João Pedro,BRA,Watford,Premier League,2021,19.0,2001.0,18.3,20,14,7,8,5,6,23,26.1,17,23,3,20,15,35,17,0,"FW,MF",Under 20,Forward,Brazil,South America
1281,João Pedro,BRA,Watford,Premier League,2021,19.0,2001.0,18.3,20,14,7,8,5,6,23,26.1,17,23,3,20,15,35,17,0,"FW,MF",Under 20,Forward,Brazil,South America
1281,João Pedro,BRA,Watford,Premier League,2021,19.0,2001.0,18.3,20,14,7,8,5,6,23,26.1,17,23,3,20,15,35,17,0,"FW,MF",Under 20,Forward,Brazil,South America
1281,João Pedro,BRA,Watford,Premier League,2021,19.0,2001.0,18.3,20,14,7,8,5,6,23,26.1,17,23,3,20,15,35,17,0,"FW,MF",Under 20,Forward,Brazil,South America
1281,João Pedro,BRA,Watford,Premier League,2021,19.0,2001.0,18.3,20,14,7,8,5,6,23,26.1,17,23,3,20,15,35,17,0,"FW,MF",Under 20,Forward,Brazil,South America
1281,João Pedro,BRA,Watford,Premier League,2021,19.0,2001.0,18.3,20,14,7,8,5,6,23,26.1,17,23,3,20,15,35,17,0,"FW,MF",Under 20,Forward,Brazil,South America
1281,João Pedro,BRA,Watford,Premier League,2021,19.0,2001.0,18.3,20,14,7,8,5,6,23,26.1,17,23,3,20,15,35,17,0,"FW,MF",Under 20,Forward,Brazil,South America
1281,João Pedro,BRA,Watford,Premier League,2021,19.0,2001.0,18.3,20,14,7,8,5,6,23,26.1,17,23,3,20,15,35,17,0,"FW,MF",Under 20,Forward,Brazil,South America
1281,João Pedro,BRA,Watford,Premier League,2021,19.0,2001.0,18.3,20,14,7,8,5,6,23,26.1,17,23,3,20,15,35,17,0,"FW,MF",Under 20,Forward,Brazil,South America
1281,João Pedro,BRA,Watford,Premier League,2021,19.0,2001.0,18.3,20,14,7,8,5,6,23,26.1,17,23,3,20,15,35,17,0,"FW,MF",Under 20,Forward,Brazil,South America
1281,João Pedro,BRA,Watford,Premier League,2021,19.0,2001.0,18.3,20,14,7,8,5,6,23,26.1,17,23,3,20,15,35,17,0,"FW,MF",Under 20,Forward,Brazil,South America
1281,João Pedro,BRA,Watford,Premier League,2021,19.0,2001.0,18.3,20,14,7,8,5,6,23,26.1,17,23,3,20,15,35,17,0,"FW,MF",Under 20,Forward,Brazil,South America
1281,João Pedro,BRA,Watford,Premier League,2021,19.0,2001.0,18.3,20,14,7,8,5,6,23,26.1,17,23,3,20,15,35,17,0,"FW,MF",Under 20,Forward,Brazil,South America
1281,João Pedro,BRA,Watford,Premier League,2021,19.0,2001.0,18.3,20,14,7,8,5,6,23,26.1,17,23,3,20,15,35,17,0,"FW,MF",Under 20,Forward,Brazil,South America
1281,João Pedro,BRA,Watford,Premier League,2021,19.0,2001.0,18.3,20,14,7,8,5,6,23,26.1,17,23,3,20,15,35,17,0,"FW,MF",Under 20,Forward,Brazil,South America
1281,João Pedro,BRA,Watford,Premier League,2021,19.0,2001.0,18.3,20,14,7,8,5,6,23,26.1,17,23,3,20,15,35,17,0,"FW,MF",Under 20,Forward,Brazil,South America
1281,João Pedro,BRA,Watford,Premier League,2021,19.0,2001.0,18.3,20,14,7,8,5,6,23,26.1,17,23,3,20,15,35,17,0,"FW,MF",Under 20,Forward,Brazil,South America
1281,João Pedro,BRA,Watford,Premier League,2021,19.0,2001.0,18.3,20,14,7,8,5,6,23,26.1,17,23,3,20,15,35,17,0,"FW,MF",Under 20,Forward,Brazil,South America
1281,João Pedro,BRA,Watford,Premier League,2021,19.0,2001.0,18.3,20,14,7,8,5,6,23,26.1,17,23,3,20,15,35,17,0,"FW,MF",Under 20,Forward,Brazil,South America
1281,João Pedro,BRA,Watford,Premier League,2021,19.0,2001.0,18.3,20,14,7,8,5,6,23,26.1,17,23,3,20,15,35,17,0,"FW,MF",Under 20,Forward,Brazil,South America
1281,João Pedro,BRA,Watford,Premier League,2021,19.0,2001.0,18.3,20,14,7,8,5,6,23,26.1,17,23,3,20,15,35,17,0,"FW,MF",Under 20,Forward,Brazil,South America
1281,João Pedro,BRA,Watford,Premier League,2021,19.0,2001.0,18.3,20,14,7,8,5,6,23,26.1,17,23,3,20,15,35,17,0,"FW,MF",Under 20,Forward,Brazil,South America
1281,João Pedro,BRA,Watford,Premier League,2021,19.0,2001.0,18.3,20,14,7,8,5,6,23,26.1,17,23,3,20,15,35,17,0,"FW,MF",Under 20,Forward,Brazil,South America
1281,João Pedro,BRA,Watford,Premier League,2021,19.0,2001.0,18.3,20,14,7,8,5,6,23,26.1,17,23,3,20,15,35,17,0,"FW,MF",Under 20,Forward,Brazil,South America
1281,João Pedro,BRA,Watford,Premier League,2021,19.0,2001.0,18.3,20,14,7,8,5,6,23,26.1,17,23,3,20,15,35,17,0,"FW,MF",Under 20,Forward,Brazil,South America
1281,João Pedro,BRA,Watford,Premier League,2021,19.0,2001.0,18.3,20,14,7,8,5,6,23,26.1,17,23,3,20,15,35,17,0,"FW,MF",Under 20,Forward,Brazil,South America
1281,João Pedro,BRA,Watford,Premier League,2021,19.0,2001.0,18.3,20,14,7,8,5,6,23,26.1,17,23,3,20,15,35,17,0,"FW,MF",Under 20,Forward,Brazil,South America
1281,João Pedro,BRA,Watford,Premier League,2021,19.0,2001.0,18.3,20,14,7,8,5,6,23,26.1,17,23,3,20,15,35,17,0,"FW,MF",Under 20,Forward,Brazil,South America
1281,João Pedro,BRA,Watford,Premier League,2021,19.0,2001.0,18.3,20,14,7,8,5,6,23,26.1,17,23,3,20,15,35,17,0,"FW,MF",Under 20,Forward,Brazil,South America
1281,João Pedro,BRA,Watford,Premier League,2021,19.0,2001.0,18.3,20,14,7,8,5,6,23,26.1,17,23,3,20,15,35,17,0,"FW,MF",Under 20,Forward,Brazil,South America
1281,João Pedro,BRA,Watford,Premier League,2021,19.0,2001.0,18.3,20,14,7,8,5,6,23,26.1,17,23,3,20,15,35,17,0,"FW,MF",Under 20,Forward,Brazil,South America
1281,João Pedro,BRA,Watford,Premier League,2021,19.0,2001.0,18.3,20,14,7,8,5,6,23,26.1,17,23,3,20,15,35,17,0,"FW,MF",Under 20,Forward,Brazil,South America
1281,João Pedro,BRA,Watford,Premier League,2021,19.0,2001.0,18.3,20,14,7,8,5,6,23,26.1,17,23,3,20,15,35,17,0,"FW,MF",Under 20,Forward,Brazil,South America
1281,João Pedro,BRA,Watford,Premier League,2021,19.0,2001.0,18.3,20,14,7,8,5,6,23,26.1,17,23,3,20,15,35,17,0,"FW,MF",Under 20,Forward,Brazil,South America
1281,João Pedro,BRA,Watford,Premier League,2021,19.0,2001.0,18.3,20,14,7,8,5,6,23,26.1,17,23,3,20,15,35,17,0,"FW,MF",Under 20,Forward,Brazil,South America
1281,João Pedro,BRA,Watford,Premier League,2021,19.0,2001.0,18.3,20,14,7,8,5,6,23,26.1,17,23,3,20,15,35,17,0,"FW,MF",Under 20,Forward,Brazil,South America
1281,João Pedro,BRA,Watford,Premier League,2021,19.0,2001.0,18.3,20,14,7,8,5,6,23,26.1,17,23,3,20,15,35,17,0,"FW,MF",Under 20,Forward,Brazil,South America
1281,João Pedro,BRA,Watford,Premier League,2021,19.0,2001.0,18.3,20,14,7,8,5,6,23,26.1,17,23,3,20,15,35,17,0,"FW,MF",Under 20,Forward,Brazil,South America
1281,João Pedro,BRA,Watford,Premier League,2021,19.0,2001.0,18.3,20,14,7,8,5,6,23,26.1,17,23,3,20,15,35,17,0,"FW,MF",Under 20,Forward,Brazil,South America
1281,João Pedro,BRA,Watford,Premier League,2021,19.0,2001.0,18.3,20,14,7,8,5,6,23,26.1,17,23,3,20,15,35,17,0,"FW,MF",Under 20,Forward,Brazil,South America
1281,João Pedro,BRA,Watford,Premier League,2021,19.0,2001.0,18.3,20,14,7,8,5,6,23,26.1,17,23,3,20,15,35,17,0,"FW,MF",Under 20,Forward,Brazil,South America
1281,João Pedro,BRA,Watford,Premier League,2021,19.0,2001.0,18.3,20,14,7,8,5,6,23,26.1,17,23,3,20,15,35,17,0,"FW,MF",Under 20,Forward,Brazil,South America
1281,João Pedro,BRA,Watford,Premier League,2021,19.0,2001.0,18.3,20,14,7,8,5,6,23,26.1,17,23,3,20,15,35,17,0,"FW,MF",Under 20,Forward,Brazil,South America
1281,João Pedro,BRA,Watford,Premier League,2021,19.0,2001.0,18.3,20,14,7,8,5,6,23,26.1,17,23,3,20,15,35,17,0,"FW,MF",Under 20,Forward,Brazil,South America
1281,João Pedro,BRA,Watford,Premier League,2021,19.0,2001.0,18.3,20,14,7,8,5,6,23,26.1,17,23,3,20,15,35,17,0,"FW,MF",Under 20,Forward,Brazil,South America
1281,João Pedro,BRA,Watford,Premier League,2021,19.0,2001.0,18.3,20,14,7,8,5,6,23,26.1,17,23,3,20,15,35,17,0,"FW,MF",Under 20,Forward,Brazil,South America
1281,João Pedro,BRA,Watford,Premier League,2021,19.0,2001.0,18.3,20,14,7,8,5,6,23,26.1,17,23,3,20,15,35,17,0,"FW,MF",Under 20,Forward,Brazil,South America
1281,João Pedro,BRA,Watford,Premier League,2021,19.0,2001.0,18.3,20,14,7,8,5,6,23,26.1,17,23,3,20,15,35,17,0,"FW,MF",Under 20,Forward,Brazil,South America
1281,João Pedro,BRA,Watford,Premier League,2021,19.0,2001.0,18.3,20,14,7,8,5,6,23,26.1,17,23,3,20,15,35,17,0,"FW,MF",Under 20,Forward,Brazil,South America
1281,João Pedro,BRA,Watford,Premier League,2021,19.0,2001.0,18.3,20,14,7,8,5,6,23,26.1,17,23,3,20,15,35,17,0,"FW,MF",Under 20,Forward,Brazil,South America
1281,João Pedro,BRA,Watford,Premier League,2021,19.0,2001.0,18.3,20,14,7,8,5,6,23,26.1,17,23,3,20,15,35,17,0,"FW,MF",Under 20,Forward,Brazil,South America
1281,João Pedro,BRA,Watford,Premier League,2021,19.0,2001.0,18.3,20,14,7,8,5,6,23,26.1,17,23,3,20,15,35,17,0,"FW,MF",Under 20,Forward,Brazil,South America
1281,João Pedro,BRA,Watford,Premier League,2021,19.0,2001.0,18.3,20,14,7,8,5,6,23,26.1,17,23,3,20,15,35,17,0,"FW,MF",Under 20,Forward,Brazil,South America
1283,Joelinton,BRA,Newcastle Utd,Premier League,2021,24.0,1996.0,28.4,72,38,30,33,9,26,61,42.6,35,46,11,35,34,106,50,2,"MF,FW",20-24,Midfielder,Brazil,South America
1285,Marco John,GER,Hoffenheim,Bundesliga,2021,19.0,2002.0,0.5,0,0,0,0,0,0,1,0.0,1,1,0,1,1,1,1,0,DF,Under 20,Defender,Germany,Europe
1287,Ben Johnson,ENG,West Ham,Premier League,2021,21.0,2000.0,15.5,33,16,15,15,3,21,28,75.0,7,16,8,8,22,55,55,0,DF,20-24,Defender,England,Europe
1288,Curtis Jones,ENG,Liverpool,Premier League,2021,20.0,2001.0,9.5,11,9,3,6,2,1,10,10.0,9,4,0,4,6,17,4,0,MF,20-24,Midfielder,England,Europe
1289,Phil Jones,ENG,Manchester Utd,Premier League,2021,29.0,1992.0,1.8,5,5,3,1,1,2,3,66.7,1,4,4,0,3,8,8,0,DF,25-29,Defender,England,Europe
1290,Frenkie de Jong,NED,Barcelona,La Liga,2021,24.0,1997.0,27.5,35,19,12,18,5,12,23,52.2,11,19,5,14,20,55,16,0,MF,20-24,Midfielder,Netherlands,Europe
1291,Luuk de Jong,NED,Barcelona,La Liga,2021,30.0,1990.0,7.3,9,7,1,5,3,1,2,50.0,1,4,0,4,0,9,12,0,FW,30-34,Forward,Netherlands,Europe
1293,Kaio Jorge,BRA,Juventus,Serie A,2021,19.0,2002.0,1.3,2,1,0,2,0,1,3,33.3,2,1,0,1,0,2,2,0,"MF,FW",Under 20,Midfielder,Brazil,South America
1294,Jorginho,ITA,Chelsea,Premier League,2021,29.0,1991.0,25.3,64,33,27,31,6,29,83,34.9,54,27,4,23,36,100,21,1,MF,25-29,Midfielder,Italy,Europe
1294,Jorginho,ITA,Chelsea,Premier League,2021,29.0,1991.0,25.3,64,33,27,31,6,29,83,34.9,54,27,4,23,36,100,21,1,MF,25-29,Midfielder,Italy,Europe
1294,Jorginho,ITA,Chelsea,Premier League,2021,29.0,1991.0,25.3,64,33,27,31,6,29,83,34.9,54,27,4,23,36,100,21,1,MF,25-29,Midfielder,Italy,Europe
1294,Jorginho,ITA,Chelsea,Premier League,2021,29.0,1991.0,25.3,64,33,27,31,6,29,83,34.9,54,27,4,23,36,100,21,1,MF,25-29,Midfielder,Italy,Europe
1294,Jorginho,ITA,Chelsea,Premier League,2021,29.0,1991.0,25.3,64,33,27,31,6,29,83,34.9,54,27,4,23,36,100,21,1,MF,25-29,Midfielder,Italy,Europe
1294,Jorginho,ITA,Chelsea,Premier League,2021,29.0,1991.0,25.3,64,33,27,31,6,29,83,34.9,54,27,4,23,36,100,21,1,MF,25-29,Midfielder,Italy,Europe
1294,Jorginho,ITA,Chelsea,Premier League,2021,29.0,1991.0,25.3,64,33,27,31,6,29,83,34.9,54,27,4,23,36,100,21,1,MF,25-29,Midfielder,Italy,Europe
1294,Jorginho,ITA,Chelsea,Premier League,2021,29.0,1991.0,25.3,64,33,27,31,6,29,83,34.9,54,27,4,23,36,100,21,1,MF,25-29,Midfielder,Italy,Europe
1294,Jorginho,ITA,Chelsea,Premier League,2021,29.0,1991.0,25.3,64,33,27,31,6,29,83,34.9,54,27,4,23,36,100,21,1,MF,25-29,Midfielder,Italy,Europe
1294,Jorginho,ITA,Chelsea,Premier League,2021,29.0,1991.0,25.3,64,33,27,31,6,29,83,34.9,54,27,4,23,36,100,21,1,MF,25-29,Midfielder,Italy,Europe
1294,Jorginho,ITA,Chelsea,Premier League,2021,29.0,1991.0,25.3,64,33,27,31,6,29,83,34.9,54,27,4,23,36,100,21,1,MF,25-29,Midfielder,Italy,Europe
1294,Jorginho,ITA,Chelsea,Premier League,2021,29.0,1991.0,25.3,64,33,27,31,6,29,83,34.9,54,27,4,23,36,100,21,1,MF,25-29,Midfielder,Italy,Europe
1294,Jorginho,ITA,Chelsea,Premier League,2021,29.0,1991.0,25.3,64,33,27,31,6,29,83,34.9,54,27,4,23,36,100,21,1,MF,25-29,Midfielder,Italy,Europe
1294,Jorginho,ITA,Chelsea,Premier League,2021,29.0,1991.0,25.3,64,33,27,31,6,29,83,34.9,54,27,4,23,36,100,21,1,MF,25-29,Midfielder,Italy,Europe
1294,Jorginho,ITA,Chelsea,Premier League,2021,29.0,1991.0,25.3,64,33,27,31,6,29,83,34.9,54,27,4,23,36,100,21,1,MF,25-29,Midfielder,Italy,Europe
1294,Jorginho,ITA,Chelsea,Premier League,2021,29.0,1991.0,25.3,64,33,27,31,6,29,83,34.9,54,27,4,23,36,100,21,1,MF,25-29,Midfielder,Italy,Europe
1296,Willian José,BRA,Betis,La Liga,2021,29.0,1991.0,17.8,15,13,2,10,3,2,8,25.0,6,10,2,8,3,18,16,0,FW,25-29,Forward,Brazil,South America
1299,Lenny Joseph,FRA,Metz,Ligue 1,2021,20.0,2000.0,1.7,2,1,1,1,0,0,0,,0,3,0,3,0,2,0,0,"FW,MF",20-24,Forward,France,Europe
1300,Diogo Jota,POR,Liverpool,Premier League,2021,24.0,1996.0,26.3,39,18,12,18,9,13,55,23.6,42,19,2,17,6,45,6,0,FW,20-24,Forward,Portugal,Europe
1301,Stevan Jovetić,MNE,Hertha BSC,Bundesliga,2021,31.0,1989.0,11.3,5,2,0,2,3,1,6,16.7,5,3,0,3,1,6,6,0,"FW,MF",30-34,Forward,Montenegro,Europe
1304,José Juan Macías,MEX,Getafe,La Liga,2021,21.0,1999.0,2.2,1,0,0,0,1,0,1,0.0,1,1,0,1,1,2,0,0,"FW,MF",20-24,Forward,Mexico,North America
1306,Gideon Jung,GER,Greuther Fürth,Bundesliga,2021,26.0,1994.0,1.6,3,1,1,2,0,2,4,50.0,2,1,1,0,2,5,5,0,DF,25-29,Defender,Germany,Europe
1307,Flavio Junior Bianchi,ITA,Genoa,Serie A,2021,21.0,2000.0,3.5,2,2,1,0,1,0,2,0.0,2,0,0,0,0,2,0,0,"FW,MF",20-24,Forward,Italy,Europe
1308,Lago Junior,CIV,Mallorca,La Liga,2021,30.0,1990.0,2.0,3,2,3,0,0,3,5,60.0,2,0,0,0,2,5,2,0,"FW,MF",30-34,Forward,Ivory Coast,Africa
1309,Hamed Junior Traorè,CIV,Sassuolo,Serie A,2021,21.0,2000.0,19.7,32,18,8,14,10,10,46,21.7,36,22,2,20,12,44,6,1,"FW,MF",20-24,Forward,Ivory Coast,Africa
1310,Vinicius Júnior,BRA,Real Madrid,La Liga,2021,21.0,2000.0,29.9,46,24,23,19,4,15,50,30.0,35,25,0,25,6,52,6,0,FW,20-24,Forward,Brazil,South America
1311,James Justin,ENG,Leicester City,Premier League,2021,23.0,1998.0,11.1,22,13,11,8,3,7,15,46.7,8,16,4,12,17,39,34,0,DF,20-24,Defender,England,Europe
1313,Jens Jønsson,DEN,Cádiz,La Liga,2021,28.0,1993.0,14.5,40,29,22,17,1,17,35,48.6,18,17,7,10,34,74,32,0,MF,25-29,Midfielder,Denmark,Europe
1314,Mathias Jørgensen,DEN,Brentford,Premier League,2021,31.0,1990.0,5.8,10,4,3,5,2,7,10,70.0,3,6,1,5,10,20,13,0,DF,30-34,Defender,Denmark,Europe
1315,Ozan Kabak,TUR,Norwich City,Premier League,2021,21.0,2000.0,10.2,10,5,4,6,0,5,9,55.6,4,19,11,8,16,26,26,0,DF,20-24,Defender,Turkey,Asia
1316,Christian Kabasele,BEL,Watford,Premier League,2021,30.0,1991.0,13.3,11,5,10,1,0,7,10,70.0,3,20,16,4,14,25,67,1,DF,30-34,Defender,Belgium,Europe
1317,Issa Kaboré,BFA,Troyes,Ligue 1,2021,20.0,2001.0,25.0,45,22,22,14,9,20,38,52.6,18,27,2,25,20,65,38,1,"DF,MF",20-24,Defender,Burkina Faso,Africa
1318,Anton Kade,GER,Hertha BSC,Bundesliga,2021,17.0,2004.0,0.9,4,2,3,1,0,2,8,25.0,6,3,0,3,3,7,1,0,"FW,MF",Under 20,Forward,Germany,Europe
1320,Tino Kadewere,ZIM,Lyon,Ligue 1,2021,25.0,1996.0,5.6,7,5,2,2,3,4,13,30.8,9,7,0,7,4,11,1,1,FW,25-29,Forward,Zimbabwe,Africa
1321,Florian Kainz,AUT,Köln,Bundesliga,2021,28.0,1992.0,25.8,41,26,9,25,7,23,51,45.1,28,27,3,24,32,73,24,0,"MF,FW",25-29,Midfielder,Austria,Europe
1322,Gaël Kakuta,COD,Lens,Ligue 1,2021,30.0,1991.0,18.6,22,14,2,13,7,4,20,20.0,16,10,0,10,4,26,3,0,"MF,FW",30-34,Midfielder,DR Congo,Africa
1323,Sasa Kalajdzic,AUT,Stuttgart,Bundesliga,2021,24.0,1997.0,13.6,10,6,2,5,3,3,11,27.3,8,5,0,5,2,12,14,0,FW,20-24,Forward,Austria,Europe
1324,Arnaud Kalimuendo,FRA,Lens,Ligue 1,2021,19.0,2002.0,23.9,9,8,1,3,5,2,7,28.6,5,6,1,5,8,17,0,0,FW,Under 20,Forward,France,Europe
1325,Arnaud Kalimuendo,FRA,Paris S-G,Ligue 1,2021,19.0,2002.0,0.1,0,0,0,0,0,0,0,,0,0,0,0,0,0,0,0,FW,Under 20,Forward,France,Europe
1326,Nikola Kalinić,CRO,Hellas Verona,Serie A,2021,33.0,1988.0,4.5,2,0,0,1,1,1,2,50.0,1,2,0,2,0,2,2,0,FW,30-34,Forward,Croatia,Europe
1327,Yayah Kallon,SLE,Genoa,Serie A,2021,20.0,2001.0,7.1,15,11,5,6,4,3,11,27.3,8,7,1,6,1,16,5,0,"FW,MF",20-24,Forward,Sierra Leone,Africa
1328,Samuel Kalu,NGA,Watford,Premier League,2021,23.0,1997.0,2.5,2,2,0,2,0,1,1,100.0,0,2,0,2,3,5,3,0,FW,20-24,Forward,Nigeria,Africa
1329,Samuel Kalu,NGA,Bordeaux,Ligue 1,2021,23.0,1997.0,3.6,8,5,3,4,1,2,5,40.0,3,2,0,2,3,11,1,0,"FW,MF",20-24,Forward,Nigeria,Africa
1330,Pierre Kalulu,FRA,Milan,Serie A,2021,21.0,2000.0,21.6,61,36,36,21,4,17,22,77.3,5,36,15,21,26,87,54,0,DF,20-24,Defender,France,Europe
1331,Daichi Kamada,JPN,Eint Frankfurt,Bundesliga,2021,24.0,1996.0,23.8,40,21,7,26,7,11,40,27.5,29,18,0,18,8,48,10,0,MF,20-24,Midfielder,Japan,Asia
1332,Boubacar Kamara,FRA,Marseille,Ligue 1,2021,21.0,1999.0,30.9,68,38,27,36,5,26,47,55.3,21,29,10,19,46,114,44,1,"MF,DF",20-24,Midfielder,France,Europe
1333,Hassane Kamara,CIV,Watford,Premier League,2021,27.0,1994.0,18.0,53,34,31,16,6,27,43,62.8,16,20,4,16,69,122,67,0,DF,25-29,Defender,Ivory Coast,Africa
1334,Hassane Kamara,CIV,Nice,Ligue 1,2021,27.0,1994.0,6.0,13,10,4,6,3,5,8,62.5,3,10,2,8,9,22,4,0,"MF,DF",25-29,Midfielder,Ivory Coast,Africa
1337,Jean-Armel Kana-Biyik,CMR,Metz,Ligue 1,2021,32.0,1989.0,7.4,10,6,8,2,0,4,9,44.4,5,11,4,7,16,26,22,1,DF,30-34,Defender,Cameroon,Africa
1338,Nordine Kandil,FRA,Strasbourg,Ligue 1,2021,19.0,2001.0,1.0,2,1,2,0,0,1,1,100.0,0,1,1,0,0,2,0,0,"MF,FW",Under 20,Midfielder,France,Europe
1339,Harry Kane,ENG,Tottenham,Premier League,2021,28.0,1993.0,35.9,15,5,2,10,3,7,18,38.9,11,26,8,18,3,18,39,0,FW,25-29,Forward,England,Europe
1340,Lee Kang-in,KOR,Mallorca,La Liga,2021,20.0,2001.0,15.7,13,6,2,9,2,5,29,17.2,24,11,1,10,5,18,7,0,"MF,FW",20-24,Midfielder,South Korea,Asia
1341,N'Golo Kanté,FRA,Chelsea,Premier League,2021,30.0,1991.0,19.7,59,31,20,27,12,25,40,62.5,15,37,2,35,31,90,8,0,MF,30-34,Midfielder,France,Europe
1342,Stefanos Kapino,GRE,Arminia,Bundesliga,2021,27.0,1994.0,1.0,0,0,0,0,0,0,0,,0,0,0,0,0,0,0,0,GK,25-29,Goalkeeper,Greece,Europe
1344,Rick Karsdorp,NED,Roma,Serie A,2021,26.0,1995.0,32.0,53,38,33,13,7,28,50,56.0,22,22,5,17,34,87,26,1,"DF,FW",25-29,Defender,Netherlands,Europe
1345,Denso Kasius,NED,Bologna,Serie A,2021,18.0,2002.0,2.0,9,7,5,3,1,2,5,40.0,3,4,0,4,3,12,4,0,"DF,FW",Under 20,Defender,Netherlands,Europe
1346,Grigoris Kastanos,CYP,Salernitana,Serie A,2021,23.0,1998.0,15.0,30,19,9,19,2,7,23,30.4,16,21,5,16,22,52,8,0,"MF,FW",20-24,Midfielder,Cyprus,Asia
1347,Silas Katompa,COD,Stuttgart,Bundesliga,2021,22.0,1998.0,3.1,5,4,4,0,1,3,7,42.9,4,5,0,5,2,7,1,0,"FW,MF",20-24,Forward,DR Congo,Africa
1348,Noah Katterbach,GER,Köln,Bundesliga,2021,20.0,2001.0,0.2,1,1,1,0,0,1,1,100.0,0,0,0,0,0,1,1,0,DF,20-24,Defender,Germany,Europe
1349,Eiji Kawashima,JPN,Strasbourg,Ligue 1,2021,38.0,1983.0,1.0,0,0,0,0,0,0,0,,0,0,0,0,0,0,0,0,GK,35-39,Goalkeeper,Japan,Asia
1350,Edo Kayembe,COD,Watford,Premier League,2021,23.0,1998.0,8.9,21,13,11,9,1,8,16,50.0,8,6,1,5,9,30,13,0,MF,20-24,Midfielder,DR Congo,Africa
1351,Moise Kean,ITA,Everton,Premier League,2021,21.0,2000.0,0.0,0,0,0,0,0,0,0,,0,0,0,0,0,0,0,0,FW,20-24,Forward,Italy,Europe
1352,Moise Kean,ITA,Juventus,Serie A,2021,21.0,2000.0,12.2,9,4,2,5,2,6,16,37.5,10,5,0,5,3,12,8,1,FW,20-24,Forward,Italy,Europe
1353,Michael Keane,ENG,Everton,Premier League,2021,28.0,1993.0,31.0,46,25,32,13,1,28,45,62.2,17,33,28,5,62,108,128,2,DF,25-29,Defender,England,Europe
1354,Ilan Kebbal,ALG,Reims,Ligue 1,2021,23.0,1998.0,19.7,31,15,13,10,8,12,44,27.3,32,16,0,16,13,44,3,0,"MF,FW",20-24,Midfielder,Algeria,Africa
1355,Wajdi Kechrida,TUN,Salernitana,Serie A,2021,25.0,1995.0,10.6,9,6,6,3,0,8,13,61.5,5,10,2,8,8,17,15,0,"DF,MF",25-29,Defender,Tunisia,Africa
1356,Thilo Kehrer,GER,Paris S-G,Ligue 1,2021,24.0,1996.0,16.8,21,14,9,11,1,9,21,42.9,12,19,11,8,24,45,29,0,DF,20-24,Defender,Germany,Europe
1357,Habib Keita,MLI,Lyon,Ligue 1,2021,19.0,2002.0,0.1,0,0,0,0,0,0,0,,0,0,0,0,0,0,0,0,"MF,FW",Under 20,Midfielder,Mali,Africa
1358,Naby Keïta,GUI,Liverpool,Premier League,2021,26.0,1995.0,13.0,46,23,17,19,10,26,42,61.9,16,33,2,31,14,60,8,0,MF,25-29,Midfielder,Guinea,Africa
1359,Yannik Keitel,GER,Freiburg,Bundesliga,2021,21.0,2000.0,5.6,11,4,5,4,2,5,15,33.3,10,7,1,6,1,12,8,0,MF,20-24,Midfielder,Germany,Europe
1360,Caoimhín Kelleher,IRL,Liverpool,Premier League,2021,22.0,1998.0,2.0,1,1,1,0,0,1,1,100.0,0,0,0,0,0,1,1,0,GK,20-24,Goalkeeper,Republic of Ireland,Europe
1361,Marc-Oliver Kempf,GER,Hertha BSC,Bundesliga,2021,26.0,1995.0,11.7,10,9,9,1,0,5,14,35.7,9,14,7,7,25,35,49,1,DF,25-29,Defender,Germany,Europe
1362,Marc-Oliver Kempf,GER,Stuttgart,Bundesliga,2021,26.0,1995.0,9.3,13,8,7,4,2,3,10,30.0,7,16,14,2,16,29,26,2,DF,25-29,Defender,Germany,Europe
1363,Kenedy,BRA,Chelsea,Premier League,2021,25.0,1996.0,0.6,5,2,1,2,2,2,3,66.7,1,0,0,0,0,5,0,0,DF,25-29,Defender,Brazil,South America
1364,Jonjoe Kenny,ENG,Everton,Premier League,2021,24.0,1997.0,11.3,17,7,11,6,0,13,21,61.9,8,8,1,7,20,37,31,0,DF,20-24,Defender,England,Europe
1365,Dimitrios Keramitsis,GRE,Roma,Serie A,2021,17.0,2004.0,0.0,0,0,0,0,0,0,0,,0,0,0,0,0,0,0,0,MF,Under 20,Midfielder,Greece,Europe
1366,Franck Kessié,CIV,Milan,Serie A,2021,24.0,1996.0,25.6,41,23,12,24,5,17,26,65.4,9,39,10,29,23,64,22,0,MF,20-24,Midfielder,Ivory Coast,Africa
1367,Saîf-Eddine Khaoui,TUN,Clermont Foot,Ligue 1,2021,26.0,1995.0,10.3,19,10,5,10,4,9,18,50.0,9,9,0,9,14,33,5,0,"MF,FW",25-29,Midfielder,Tunisia,Africa
1368,Wahbi Khazri,TUN,Saint-Étienne,Ligue 1,2021,30.0,1991.0,24.7,33,18,7,17,9,9,34,26.5,25,21,0,21,12,45,7,0,"FW,MF",30-34,Forward,Tunisia,Africa
1369,Rani Khedira,GER,Union Berlin,Bundesliga,2021,27.0,1994.0,30.6,75,38,25,42,8,32,66,48.5,34,21,8,13,50,125,27,1,MF,25-29,Midfielder,Germany,Europe
1371,Luca Kilian,GER,Mainz 05,Bundesliga,2021,21.0,1999.0,0.0,0,0,0,0,0,0,0,,0,0,0,0,0,0,0,0,FW,20-24,Forward,Germany,Europe
1372,Luca Kilian,GER,Köln,Bundesliga,2021,21.0,1999.0,25.3,42,24,30,9,3,21,41,51.2,20,31,13,18,46,88,109,3,DF,20-24,Defender,Germany,Europe
1373,Max Kilman,ENG,Wolves,Premier League,2021,24.0,1997.0,29.9,50,26,38,10,2,24,37,64.9,13,36,21,15,45,95,113,3,DF,20-24,Defender,England,Europe
1374,Joshua Kimmich,GER,Bayern Munich,Bundesliga,2021,26.0,1995.0,27.5,39,20,14,17,8,18,58,31.0,40,34,8,26,52,91,29,1,MF,25-29,Midfielder,Germany,Europe
1375,Presnel Kimpembe,FRA,Paris S-G,Ligue 1,2021,25.0,1995.0,28.6,34,19,18,15,1,14,23,60.9,9,20,14,6,38,72,73,1,DF,25-29,Defender,France,Europe
1378,Sofian Kiyine,MAR,Venezia,Serie A,2021,23.0,1997.0,13.8,24,14,9,11,4,12,32,37.5,20,15,1,14,10,34,9,0,"MF,FW",20-24,Midfielder,Morocco,Africa
1379,Simon Kjær,DEN,Milan,Serie A,2021,32.0,1989.0,8.9,20,12,9,8,3,6,12,50.0,6,17,13,4,9,29,39,0,DF,30-34,Defender,Denmark,Europe
1381,Philipp Klement,GER,Stuttgart,Bundesliga,2021,28.0,1992.0,3.8,7,3,1,4,2,3,3,100.0,0,6,1,5,1,8,0,0,MF,25-29,Midfielder,Germany,Europe
1384,Mateo Klimowicz,GER,Stuttgart,Bundesliga,2021,21.0,2000.0,6.7,13,6,6,7,0,5,16,31.3,11,2,0,2,4,17,3,0,"MF,FW",20-24,Midfielder,Germany,Europe
1385,Fabian Klos,GER,Arminia,Bundesliga,2021,33.0,1987.0,15.8,7,5,0,5,2,2,10,20.0,8,17,4,13,0,7,31,0,FW,30-34,Forward,Germany,Europe
1386,Lukas Klostermann,GER,RB Leipzig,Bundesliga,2021,25.0,1996.0,18.3,29,16,11,15,3,13,19,68.4,6,16,3,13,26,55,58,0,DF,25-29,Defender,Germany,Europe
1387,Justin Kluivert,NED,Nice,Ligue 1,2021,22.0,1999.0,20.8,19,9,6,12,1,5,21,23.8,16,13,1,12,14,33,6,0,MF,20-24,Midfielder,Netherlands,Europe
1388,Lukas Klünter,GER,Hertha BSC,Bundesliga,2021,25.0,1996.0,2.2,1,1,1,0,0,1,5,20.0,4,1,0,1,2,3,2,0,DF,25-29,Defender,Germany,Europe
1389,Ansgar Knauff,GER,Dortmund,Bundesliga,2021,19.0,2002.0,1.3,3,1,1,1,1,0,4,0.0,4,2,0,2,0,3,4,0,"FW,MF",Under 20,Forward,Germany,Europe
1390,Ansgar Knauff,GER,Eint Frankfurt,Bundesliga,2021,19.0,2002.0,8.4,18,14,8,5,5,8,15,53.3,7,11,1,10,8,26,6,0,"DF,MF",Under 20,Defender,Germany,Europe
1391,Robin Knoche,GER,Union Berlin,Bundesliga,2021,29.0,1992.0,33.0,50,24,38,12,0,30,53,56.6,23,45,26,19,49,99,151,1,DF,25-29,Defender,Germany,Europe
1392,Gregor Kobel,SUI,Dortmund,Bundesliga,2021,23.0,1997.0,28.5,0,0,0,0,0,0,2,0.0,2,0,0,0,1,1,20,0,GK,20-24,Goalkeeper,Switzerland,Europe
1393,Robin Koch,GER,Leeds United,Premier League,2021,25.0,1996.0,17.5,21,13,9,10,2,9,34,26.5,25,26,10,16,20,41,44,0,"MF,DF",25-29,Midfielder,Germany,Europe
1394,Samuel Koeberlé,FRA,Reims,Ligue 1,2021,16.0,2004.0,0.0,0,0,0,0,0,0,0,,0,0,0,0,0,0,0,0,FW,Under 20,Forward,France,Europe
1395,Philippe Koffi,CIV,Reims,Ligue 1,2021,19.0,2002.0,4.2,4,0,0,3,1,0,2,0.0,2,2,1,1,3,7,3,0,FW,Under 20,Forward,Ivory Coast,Africa
1396,Dominik Kohr,GER,Mainz 05,Bundesliga,2021,27.0,1994.0,17.9,40,20,18,19,3,16,42,38.1,26,21,2,19,35,75,22,0,MF,25-29,Midfielder,Germany,Europe
1397,Koba Koindredi,FRA,Valencia,La Liga,2021,19.0,2001.0,2.0,4,3,2,1,1,2,6,33.3,4,3,0,3,4,8,5,0,MF,Under 20,Midfielder,France,Europe
1399,Aleksandr Kokorin,RUS,Fiorentina,Serie A,2021,30.0,1991.0,0.6,1,1,1,0,0,0,0,,0,1,0,1,0,1,0,0,"FW,MF",30-34,Forward,Russia,Europe
1401,Sead Kolašinac,BIH,Arsenal,Premier League,2021,28.0,1993.0,1.0,0,0,0,0,0,0,0,,0,0,0,0,4,4,1,0,DF,25-29,Defender,Bosnia and Herzegovina,Europe
1402,Sead Kolašinac,BIH,Marseille,Ligue 1,2021,28.0,1993.0,4.9,7,6,2,3,2,5,8,62.5,3,4,0,4,0,7,7,1,DF,25-29,Defender,Bosnia and Herzegovina,Europe
1403,Luca Koleosho,ITA,Espanyol,La Liga,2021,16.0,2004.0,0.0,0,0,0,0,0,0,0,,0,0,0,0,0,0,0,0,FW,Under 20,Forward,Italy,Europe
1404,Randal Kolo Muani,FRA,Nantes,Ligue 1,2021,22.0,1998.0,32.8,28,14,7,10,11,10,25,40.0,15,14,3,11,6,34,31,0,"FW,MF",20-24,Forward,France,Europe
1405,Timothée Kolodziejczak,FRA,Saint-Étienne,Ligue 1,2021,29.0,1991.0,28.5,43,24,22,14,7,20,36,55.6,16,29,7,22,60,103,72,1,DF,25-29,Defender,France,Europe
1406,Ghislain Konan,CIV,Reims,Ligue 1,2021,25.0,1995.0,26.9,35,19,19,15,1,16,30,53.3,14,35,8,27,28,63,45,0,DF,25-29,Defender,Ivory Coast,Africa
1407,Ibrahima Konaté,FRA,Liverpool,Premier League,2021,22.0,1999.0,11.0,16,10,9,6,1,7,10,70.0,3,13,9,4,16,32,37,1,DF,20-24,Defender,France,Europe
1408,Geoffrey Kondogbia,CTA,Atlético Madrid,La Liga,2021,28.0,1993.0,20.9,74,44,25,40,9,21,49,42.9,28,16,5,11,44,118,24,0,"MF,DF",25-29,Midfielder,Central African Republic,Africa
1409,Ibrahima Koné,MLI,Lorient,Ligue 1,2021,22.0,1999.0,8.1,7,4,0,3,4,2,3,66.7,1,8,3,5,1,8,3,0,FW,20-24,Forward,Mali,Africa
1410,Manu Koné,FRA,Gladbach,Bundesliga,2021,20.0,2001.0,24.3,60,37,29,28,3,25,42,59.5,17,27,4,23,34,94,12,0,MF,20-24,Midfielder,France,Europe
1411,Youssouf Koné,MLI,Troyes,Ligue 1,2021,26.0,1995.0,10.9,30,18,21,8,1,19,30,63.3,11,8,3,5,10,40,25,0,DF,25-29,Defender,Mali,Africa
1412,Ezri Konsa,ENG,Aston Villa,Premier League,2021,23.0,1997.0,27.5,25,15,13,11,1,10,13,76.9,3,31,22,9,15,40,86,2,DF,20-24,Defender,England,Europe
1413,Teun Koopmeiners,NED,Atalanta,Serie A,2021,23.0,1998.0,23.6,40,24,10,19,11,22,54,40.7,32,31,2,29,15,55,19,0,MF,20-24,Midfielder,Netherlands,Europe
1414,Laurent Koscielny,FRA,Bordeaux,Ligue 1,2021,35.0,1985.0,10.4,14,9,10,3,1,8,13,61.5,5,17,12,5,12,26,39,0,DF,35-39,Defender,France,Europe
1415,Odilon Kossounou,CIV,Leverkusen,Bundesliga,2021,20.0,2001.0,19.9,23,17,16,6,1,15,25,60.0,10,36,14,22,26,49,66,0,DF,20-24,Defender,Ivory Coast,Africa
1417,Rominigue Kouamé,MLI,Troyes,Ligue 1,2021,24.0,1996.0,33.0,47,22,24,20,3,19,58,32.8,39,33,5,28,46,93,22,2,MF,20-24,Midfielder,Mali,Africa
1418,Kalidou Koulibaly,SEN,Napoli,Serie A,2021,30.0,1991.0,26.7,39,23,31,6,2,25,38,65.8,13,41,25,16,29,68,90,1,DF,30-34,Defender,Senegal,Africa
1419,Jules Koundé,FRA,Sevilla,La Liga,2021,22.0,1998.0,30.4,40,17,27,10,3,18,28,64.3,10,33,18,15,21,61,101,2,DF,20-24,Defender,France,Europe
1420,Christos Kourfalidis,GRE,Cagliari,Serie A,2021,18.0,2002.0,0.2,0,0,0,0,0,0,1,0.0,1,1,0,1,0,0,0,0,"MF,FW",Under 20,Midfielder,Greece,Europe
1421,Boubakar Kouyaté,MLI,Metz,Ligue 1,2021,24.0,1997.0,29.6,84,50,56,28,0,48,77,62.3,29,63,33,30,79,163,217,3,DF,20-24,Defender,Mali,Africa
1422,Cheikhou Kouyaté,SEN,Crystal Palace,Premier League,2021,31.0,1989.0,21.9,52,38,28,22,2,18,39,46.2,21,40,14,26,38,90,39,0,MF,30-34,Midfielder,Senegal,Africa
1423,Mateo Kovačić,CRO,Chelsea,Premier League,2021,27.0,1994.0,17.3,51,31,14,26,11,17,35,48.6,18,19,4,15,7,58,9,1,MF,25-29,Midfielder,Croatia,Europe
1424,Viktor Kovalenko,UKR,Spezia,Serie A,2021,25.0,1996.0,14.7,16,10,7,8,1,9,21,42.9,12,16,3,13,13,29,8,0,MF,25-29,Midfielder,Ukraine,Europe
1425,Emil Krafth,SWE,Newcastle Utd,Premier League,2021,26.0,1994.0,18.2,37,16,25,11,1,27,36,75.0,9,16,10,6,25,62,56,0,DF,25-29,Defender,Sweden,Europe
1427,Andrej Kramarić,CRO,Hoffenheim,Bundesliga,2021,30.0,1991.0,30.1,8,4,1,5,2,7,17,41.2,10,10,0,10,9,17,7,1,"FW,MF",30-34,Forward,Croatia,Europe
1428,Christoph Kramer,GER,Gladbach,Bundesliga,2021,30.0,1991.0,8.3,28,11,15,10,3,12,28,42.9,16,18,5,13,12,40,9,0,MF,30-34,Midfielder,Germany,Europe
1429,Jean-Philippe Krasso,CIV,Saint-Étienne,Ligue 1,2021,24.0,1997.0,5.0,7,5,0,5,2,2,10,20.0,8,7,1,6,0,7,1,0,FW,20-24,Forward,Ivory Coast,Africa
1431,Toni Kroos,GER,Real Madrid,La Liga,2021,31.0,1990.0,23.4,34,26,13,17,4,14,36,38.9,22,16,3,13,12,46,13,1,MF,30-34,Midfielder,Germany,Europe
1432,Florian Krüger,GER,Arminia,Bundesliga,2021,22.0,1999.0,12.5,3,1,0,3,0,2,10,20.0,8,12,1,11,2,5,13,0,"FW,MF",20-24,Forward,Germany,Europe
1433,Tim Krul,NED,Norwich City,Premier League,2021,33.0,1988.0,29.0,1,1,1,0,0,1,4,25.0,3,0,0,0,0,1,10,4,GK,30-34,Goalkeeper,Netherlands,Europe
1434,Rade Krunić,BIH,Milan,Serie A,2021,27.0,1993.0,15.7,33,18,16,14,3,15,31,48.4,16,19,2,17,16,49,17,0,"MF,FW",25-29,Midfielder,Bosnia and Herzegovina,Europe
1435,Max Kruse,GER,Wolfsburg,Bundesliga,2021,33.0,1988.0,12.5,9,3,4,4,1,5,12,41.7,7,2,0,2,3,12,4,0,"MF,FW",30-34,Midfielder,Germany,Europe
1436,Max Kruse,GER,Union Berlin,Bundesliga,2021,33.0,1988.0,14.1,4,1,0,3,1,2,16,12.5,14,12,0,12,3,7,2,0,"FW,MF",30-34,Forward,Germany,Europe
1437,Lukas Kübler,GER,Freiburg,Bundesliga,2021,28.0,1992.0,25.9,62,35,38,16,8,28,49,57.1,21,24,8,16,44,106,70,0,"DF,MF",25-29,Defender,Germany,Europe
1438,Takefusa Kubo,JPN,Mallorca,La Liga,2021,20.0,2001.0,17.8,31,19,12,14,5,10,24,41.7,14,24,3,21,8,39,4,0,"FW,MF",20-24,Forward,Japan,Asia
1439,Juraj Kucka,SVK,Watford,Premier League,2021,34.0,1987.0,21.3,59,39,32,25,2,27,73,37.0,46,30,9,21,27,86,46,2,MF,30-34,Midfielder,Slovakia,Europe
1440,Mykola Kukharevych,UKR,Troyes,Ligue 1,2021,20.0,2001.0,0.2,0,0,0,0,0,0,0,,0,0,0,0,0,0,0,0,FW,20-24,Forward,Ukraine,Europe
1441,Dejan Kulusevski,SWE,Tottenham,Premier League,2021,21.0,2000.0,14.0,19,13,7,10,2,5,23,21.7,18,14,0,14,13,32,3,0,"MF,FW",20-24,Midfielder,Sweden,Europe
1442,Dejan Kulusevski,SWE,Juventus,Serie A,2021,21.0,2000.0,8.6,15,12,9,6,0,8,21,38.1,13,14,0,14,5,20,5,0,"FW,MF",20-24,Forward,Sweden,Europe
1443,Marash Kumbulla,ALB,Roma,Serie A,2021,21.0,2000.0,11.4,21,13,13,7,1,8,15,53.3,7,17,8,9,16,37,26,0,DF,20-24,Defender,Albania,Europe
1444,Fabian Kunze,GER,Arminia,Bundesliga,2021,23.0,1998.0,14.0,35,21,14,20,1,15,32,46.9,17,17,2,15,19,54,27,1,MF,20-24,Midfielder,Germany,Europe
1445,Enock Kwateng,FRA,Bordeaux,Ligue 1,2021,24.0,1997.0,22.2,54,35,31,19,4,33,72,45.8,39,17,4,13,43,97,48,1,DF,20-24,Defender,France,Europe
1446,Grejohn Kyei,FRA,Clermont Foot,Ligue 1,2021,25.0,1995.0,4.4,3,2,1,1,1,0,6,0.0,6,6,0,6,0,3,1,0,FW,25-29,Forward,France,Europe
1447,Giorgos Kyriakopoulos,GRE,Sassuolo,Serie A,2021,25.0,1996.0,21.9,30,14,19,7,4,19,38,50.0,19,32,9,23,11,41,52,0,"DF,FW",25-29,Defender,Greece,Europe
1448,Andrea La Mantia,ITA,Empoli,Serie A,2021,30.0,1991.0,5.4,2,0,0,0,2,1,2,50.0,1,3,1,2,1,3,6,0,"FW,MF",30-34,Forward,Italy,Europe
1449,Gaëtan Laborde,FRA,Montpellier,Ligue 1,2021,27.0,1994.0,3.8,2,2,1,1,0,2,4,50.0,2,3,0,3,5,7,5,0,FW,25-29,Forward,France,Europe
1450,Gaëtan Laborde,FRA,Rennes,Ligue 1,2021,27.0,1994.0,30.3,19,7,5,8,6,3,22,13.6,19,29,3,26,8,27,16,0,FW,25-29,Forward,France,Europe
1451,Alexandre Lacazette,FRA,Arsenal,Premier League,2021,30.0,1991.0,19.8,27,10,8,13,6,7,21,33.3,14,12,1,11,5,32,6,0,FW,30-34,Forward,France,Europe
1452,Tom Lacoux,FRA,Bordeaux,Ligue 1,2021,19.0,2002.0,10.1,18,13,11,5,2,9,24,37.5,15,14,4,10,9,27,20,1,"DF,MF",Under 20,Defender,France,Europe
1453,Lenny Lacroix,FRA,Metz,Ligue 1,2021,18.0,2003.0,2.2,9,7,8,1,0,5,8,62.5,3,5,1,4,10,19,5,0,DF,Under 20,Defender,France,Europe
1454,Maxence Lacroix,FRA,Wolfsburg,Bundesliga,2021,21.0,2000.0,27.7,59,33,41,16,2,29,40,72.5,11,35,16,19,60,119,144,0,DF,20-24,Defender,France,Europe
1455,Alban Lafont,FRA,Nantes,Ligue 1,2021,22.0,1999.0,38.0,3,3,3,0,0,3,8,37.5,5,1,0,1,1,4,25,2,GK,20-24,Goalkeeper,France,Europe
1457,Konrad Laimer,AUT,RB Leipzig,Bundesliga,2021,24.0,1997.0,13.8,38,24,11,22,5,24,53,45.3,29,29,3,26,4,42,9,0,MF,20-24,Midfielder,Austria,Europe
1458,Stefan Lainer,AUT,Gladbach,Bundesliga,2021,28.0,1992.0,16.3,19,11,9,7,3,12,28,42.9,16,24,5,19,14,33,31,0,DF,25-29,Defender,Austria,Europe
1459,Diego Lainez,MEX,Betis,La Liga,2021,21.0,2000.0,1.6,1,1,0,1,0,0,3,0.0,3,3,0,3,1,2,0,0,FW,20-24,Forward,Mexico,North America
1460,Adam Lallana,ENG,Brighton,Premier League,2021,33.0,1988.0,17.3,34,17,14,14,6,12,41,29.3,29,16,6,10,16,50,13,1,MF,30-34,Midfielder,England,Europe
1461,Vassilis Lambropoulos,GRE,Bochum,Bundesliga,2021,31.0,1990.0,13.0,18,12,13,3,2,11,25,44.0,14,21,10,11,17,35,56,0,DF,30-34,Defender,Greece,Europe
1462,Érik Lamela,ARG,Sevilla,La Liga,2021,29.0,1992.0,11.3,31,18,12,14,5,10,29,34.5,19,11,0,11,5,36,3,0,"FW,MF",25-29,Forward,Argentina,South America
1463,Mohamed Lamine Bayo,GUI,Clermont Foot,Ligue 1,2021,23.0,1998.0,26.8,12,5,4,3,5,3,24,12.5,21,7,1,6,7,19,14,0,FW,20-24,Forward,Guinea,Africa
1464,Didier Lamkel Zé,CMR,Metz,Ligue 1,2021,24.0,1996.0,6.7,3,1,1,0,2,1,3,33.3,2,3,1,2,1,4,7,0,FW,20-24,Forward,Cameroon,Africa
1465,Sam Lammers,NED,Atalanta,Serie A,2021,24.0,1997.0,0.4,1,0,0,0,1,0,0,,0,0,0,0,0,1,0,0,"FW,MF",20-24,Forward,Netherlands,Europe
1466,Sam Lammers,NED,Eint Frankfurt,Bundesliga,2021,24.0,1997.0,5.7,4,4,0,2,2,2,6,33.3,4,9,2,7,2,6,4,0,"FW,MF",20-24,Forward,Netherlands,Europe
1467,Tariq Lamptey,GHA,Brighton,Premier League,2021,20.0,2000.0,17.3,36,25,14,17,5,15,25,60.0,10,13,3,10,21,57,23,0,"DF,FW",20-24,Defender,Ghana,Africa
1468,Manuel Lanzini,ARG,West Ham,Premier League,2021,28.0,1993.0,19.8,28,15,10,11,7,10,35,28.6,25,16,0,16,19,47,10,0,"MF,FW",25-29,Midfielder,Argentina,South America
1470,Julien Laporte,FRA,Lorient,Ligue 1,2021,27.0,1993.0,32.1,63,45,35,26,2,32,64,50.0,32,37,22,15,54,117,174,0,DF,25-29,Defender,France,Europe
1471,Yasser Larouci,ALG,Troyes,Ligue 1,2021,20.0,2001.0,3.8,6,5,2,4,0,3,3,100.0,0,1,0,1,7,13,5,0,DF,20-24,Defender,Algeria,Africa
1472,Kevin Lasagna,ITA,Hellas Verona,Serie A,2021,28.0,1992.0,13.2,13,7,4,5,4,4,15,26.7,11,16,0,16,3,16,7,0,"MF,FW",25-29,Midfielder,Italy,Europe
1473,Jamaal Lascelles,ENG,Newcastle Utd,Premier League,2021,27.0,1993.0,22.9,15,7,9,5,1,4,12,33.3,8,38,28,10,22,37,121,1,DF,25-29,Defender,England,Europe
1474,Bryan Lasme,FRA,Arminia,Bundesliga,2021,22.0,1998.0,9.7,6,6,1,2,3,0,3,0.0,3,7,0,7,1,7,9,0,FW,20-24,Forward,France,Europe
1475,Paul Lasne,FRA,Brest,Ligue 1,2021,32.0,1989.0,9.4,26,12,6,16,4,8,18,44.4,10,11,2,9,24,50,10,0,MF,30-34,Midfielder,France,Europe
1478,Armand Lauriente,FRA,Lorient,Ligue 1,2021,22.0,1998.0,27.5,33,18,9,16,8,11,30,36.7,19,27,2,25,15,48,3,0,"FW,MF",20-24,Forward,France,Europe
1480,Manuel Lazzari,ITA,Lazio,Serie A,2021,27.0,1993.0,18.5,28,14,13,15,0,16,26,61.5,10,10,2,8,12,40,16,1,DF,25-29,Defender,Italy,Europe
1481,Théo Le Bris,FRA,Lorient,Ligue 1,2021,18.0,2002.0,0.7,2,1,1,1,0,1,2,50.0,1,2,0,2,0,2,1,0,MF,Under 20,Midfielder,France,Europe
1482,Jérémy Le Douaron,FRA,Brest,Ligue 1,2021,23.0,1998.0,16.1,11,5,4,4,3,1,17,5.9,16,15,0,15,4,15,14,0,"FW,MF",20-24,Forward,France,Europe
1483,Enzo Le Fée,FRA,Lorient,Ligue 1,2021,21.0,2000.0,24.4,70,44,25,36,9,41,90,45.6,49,25,1,24,29,99,18,0,"MF,FW",20-24,Midfielder,France,Europe
1484,Vincent Le Goff,FRA,Lorient,Ligue 1,2021,31.0,1989.0,34.0,61,38,38,19,4,37,62,59.7,25,18,3,15,37,98,50,0,DF,30-34,Defender,France,Europe
1485,Maxime Le Marchand,FRA,Strasbourg,Ligue 1,2021,31.0,1989.0,9.6,17,8,16,1,0,8,10,80.0,2,9,5,4,14,31,32,0,DF,30-34,Defender,France,Europe
1487,Patrick Leal,USA,Venezia,Serie A,2021,18.0,2003.0,0.0,0,0,0,0,0,0,1,0.0,1,0,0,0,0,0,0,0,FW,Under 20,Forward,United States,North America
1488,Rafael Leão,POR,Milan,Serie A,2021,22.0,1999.0,28.9,17,7,3,9,5,10,20,50.0,10,12,1,11,12,29,8,0,FW,20-24,Forward,Portugal,Europe
1489,Jean-Louis Leca,FRA,Lens,Ligue 1,2021,35.0,1985.0,25.7,0,0,0,0,0,0,0,,0,1,0,1,1,1,11,1,GK,35-39,Goalkeeper,France,Europe
1490,Jeremías Ledesma,ARG,Cádiz,La Liga,2021,28.0,1993.0,38.0,3,1,3,0,0,3,4,75.0,1,0,0,0,1,4,21,4,GK,25-29,Goalkeeper,Argentina,South America
1491,Pierre Lees-Melou,FRA,Norwich City,Premier League,2021,28.0,1993.0,25.2,58,36,23,29,6,25,92,27.2,67,37,11,26,25,83,23,0,MF,25-29,Midfielder,France,Europe
1492,Wu Lei,CHN,Espanyol,La Liga,2021,29.0,1991.0,5.3,3,2,1,2,0,3,8,37.5,5,4,0,4,4,7,3,0,"FW,MF",25-29,Forward,China,Asia
1493,Maxim Leitsch,GER,Bochum,Bundesliga,2021,23.0,1998.0,17.1,18,10,9,7,2,10,15,66.7,5,31,19,12,31,49,74,1,DF,20-24,Defender,Germany,Europe
1494,Lucas Leiva,BRA,Lazio,Serie A,2021,34.0,1987.0,18.9,55,30,26,25,4,15,53,28.3,38,27,10,17,28,83,37,0,MF,30-34,Midfielder,Brazil,South America
1495,Florian Lejeune,FRA,Alavés,La Liga,2021,30.0,1991.0,30.0,33,24,22,10,1,12,20,60.0,8,30,19,11,31,64,158,0,DF,30-34,Defender,France,Europe
1497,Thomas Lemar,FRA,Atlético Madrid,La Liga,2021,25.0,1995.0,16.0,24,14,9,12,3,8,23,34.8,15,18,0,18,8,32,11,0,MF,25-29,Midfielder,France,Europe
1498,Félix Lemaréchal,FRA,Monaco,Ligue 1,2021,17.0,2003.0,0.1,0,0,0,0,0,0,1,0.0,1,0,0,0,0,0,0,0,MF,Under 20,Midfielder,France,Europe
1499,Mario Lemina,GAB,Nice,Ligue 1,2021,27.0,1993.0,21.9,62,35,25,33,4,28,38,73.7,10,32,9,23,48,110,37,0,MF,25-29,Midfielder,Gabon,Africa
1500,Fabien Lemoine,FRA,Lorient,Ligue 1,2021,34.0,1987.0,12.4,35,22,20,14,1,17,41,41.5,24,21,4,17,14,49,24,1,MF,30-34,Midfielder,France,Europe
1501,Tim Lemperle,GER,Köln,Bundesliga,2021,19.0,2002.0,1.7,4,1,2,1,1,1,3,33.3,2,1,0,1,2,6,2,0,"FW,MF",Under 20,Forward,Germany,Europe
1503,Clément Lenglet,FRA,Barcelona,La Liga,2021,26.0,1995.0,9.2,20,11,11,7,2,8,13,61.5,5,7,3,4,13,33,21,0,DF,25-29,Defender,France,Europe
1504,Aaron Lennon,ENG,Burnley,Premier League,2021,34.0,1987.0,17.2,33,17,10,13,10,10,34,29.4,24,26,4,22,9,42,14,0,"MF,FW",30-34,Midfielder,England,Europe
1505,Bernd Leno,GER,Arsenal,Premier League,2021,29.0,1992.0,4.0,1,1,1,0,0,1,1,100.0,0,0,0,0,0,1,1,0,GK,25-29,Goalkeeper,Germany,Europe
1506,Christopher Lenz,GER,Eint Frankfurt,Bundesliga,2021,26.0,1994.0,7.4,29,15,22,6,1,12,21,57.1,9,9,4,5,7,36,21,0,DF,25-29,Defender,Germany,Europe
1507,Léo Leroy,FRA,Montpellier,Ligue 1,2021,21.0,2000.0,7.0,31,21,17,11,3,12,34,35.3,22,20,4,16,8,39,8,0,MF,20-24,Midfielder,France,Europe
1508,Alexandre Letellier,FRA,Paris S-G,Ligue 1,2021,30.0,1990.0,0.1,0,0,0,0,0,0,0,,0,0,0,0,0,0,0,0,GK,30-34,Goalkeeper,France,Europe
1510,Jamie Leweling,GER,Greuther Fürth,Bundesliga,2021,20.0,2001.0,21.8,13,8,3,7,3,3,16,18.8,13,9,0,9,13,26,5,0,"FW,MF",20-24,Forward,Germany,Europe
1512,Luca Lezzerini,ITA,Venezia,Serie A,2021,26.0,1995.0,5.5,0,0,0,0,0,0,0,,0,1,0,1,0,0,0,0,GK,25-29,Goalkeeper,Italy,Europe
1513,Ben Lhassine Kone,CIV,Torino,Serie A,2021,21.0,2000.0,0.9,3,3,1,2,0,1,2,50.0,1,0,0,0,1,4,1,0,MF,20-24,Midfielder,Ivory Coast,Africa
1514,Yanis Lhery,FRA,Saint-Étienne,Ligue 1,2021,18.0,2003.0,0.8,0,0,0,0,0,0,0,,0,4,0,4,0,0,0,0,"FW,MF",Under 20,Forward,France,Europe
1515,Dimitri Liénard,FRA,Strasbourg,Ligue 1,2021,33.0,1988.0,22.7,71,43,40,21,10,46,77,59.7,31,12,0,12,21,92,28,0,"DF,MF",30-34,Defender,France,Europe
1516,Philipp Lienhart,AUT,Freiburg,Bundesliga,2021,25.0,1996.0,31.9,24,13,17,6,1,13,24,54.2,11,33,23,10,50,74,158,1,DF,25-29,Defender,Austria,Europe
1517,Matthijs de Ligt,NED,Juventus,Serie A,2021,21.0,1999.0,29.7,34,19,21,13,0,15,18,83.3,3,31,21,10,26,60,103,0,DF,20-24,Defender,Netherlands,Europe
1518,Isaac Lihadji,FRA,Lille,Ligue 1,2021,19.0,2002.0,2.6,3,3,1,1,1,1,5,20.0,4,1,0,1,2,5,0,0,"MF,FW",Under 20,Midfielder,France,Europe
1519,Anderson Lima,BRA,Lazio,Serie A,2021,21.0,1999.0,0.7,2,0,1,1,0,0,2,0.0,2,1,0,1,2,4,1,0,MF,20-24,Midfielder,Brazil,South America
1520,Andreas Linde,SWE,Greuther Fürth,Bundesliga,2021,28.0,1993.0,12.0,0,0,0,0,0,0,0,,0,0,0,0,1,1,1,1,GK,25-29,Goalkeeper,Sweden,Europe
1521,Victor Lindelöf,SWE,Manchester Utd,Premier League,2021,27.0,1994.0,26.2,16,11,9,7,0,9,14,64.3,5,26,17,9,25,41,96,0,DF,25-29,Defender,Sweden,Europe
1522,Jesper Lindstrøm,DEN,Eint Frankfurt,Bundesliga,2021,21.0,2000.0,22.0,28,13,6,13,9,12,36,33.3,24,30,0,30,24,52,11,1,"MF,FW",20-24,Midfielder,Denmark,Europe
1524,Jesse Lingard,ENG,Manchester Utd,Premier League,2021,28.0,1992.0,4.1,9,7,4,3,2,2,6,33.3,4,4,0,4,0,9,1,0,"FW,MF",25-29,Forward,England,Europe
1526,Valentino Livramento,ENG,Southampton,Premier League,2021,18.0,2002.0,24.5,54,28,30,18,6,27,45,60.0,18,23,9,14,47,101,50,1,DF,Under 20,Defender,England,Europe
1527,Dejan Ljubicic,AUT,Köln,Bundesliga,2021,23.0,1997.0,21.9,33,19,12,13,8,13,49,26.5,36,19,1,18,15,48,11,0,"MF,FW",20-24,Midfielder,Austria,Europe
1531,Hugo Lloris,FRA,Tottenham,Premier League,2021,34.0,1986.0,38.0,1,1,1,0,0,1,2,50.0,1,0,0,0,1,2,24,3,GK,30-34,Goalkeeper,France,Europe
1532,Giovani Lo Celso,ARG,Tottenham,Premier League,2021,25.0,1996.0,2.6,8,4,4,2,2,4,10,40.0,6,6,1,5,1,9,0,1,"MF,FW",25-29,Midfielder,Argentina,South America
1533,Giovani Lo Celso,ARG,Villarreal,La Liga,2021,25.0,1996.0,11.0,22,12,8,10,4,9,22,40.9,13,4,0,4,5,27,3,0,"FW,MF",25-29,Forward,Argentina,South America
1535,Stanislav Lobotka,SVK,Napoli,Serie A,2021,26.0,1994.0,18.7,39,24,16,20,3,14,36,38.9,22,9,1,8,12,51,13,1,MF,25-29,Midfielder,Slovakia,Europe
1536,Jürgen Locadia,CUW,Brighton,Premier League,2021,27.0,1993.0,0.3,0,0,0,0,0,0,0,,0,0,0,0,0,0,0,0,"MF,FW",25-29,Midfielder,Curaçao,Europe
1537,Jürgen Locadia,CUW,Bochum,Bundesliga,2021,27.0,1993.0,4.9,4,2,1,0,3,1,1,100.0,0,1,0,1,1,5,2,0,"FW,MF",25-29,Forward,Curaçao,Europe
1538,Manuel Locatelli,ITA,Juventus,Serie A,2021,23.0,1998.0,24.0,44,25,21,16,7,21,47,44.7,26,43,21,22,22,66,33,0,MF,20-24,Midfielder,Italy,Europe
1539,Bradley Locko,FRA,Reims,Ligue 1,2021,19.0,2002.0,11.2,28,19,13,11,4,14,24,58.3,10,20,8,12,14,42,15,0,"MF,DF",Under 20,Midfielder,France,Europe
1540,Renan Lodi,BRA,Atlético Madrid,La Liga,2021,23.0,1998.0,13.1,31,18,14,13,4,11,27,40.7,16,22,4,18,13,44,19,1,DF,20-24,Defender,Brazil,South America
1541,Ruben Loftus-Cheek,ENG,Chelsea,Premier League,2021,25.0,1996.0,15.5,29,10,16,11,2,10,19,52.6,9,15,6,9,11,40,17,0,"MF,DF",25-29,Midfielder,England,Europe
1542,Kevin Long,IRL,Burnley,Premier League,2021,30.0,1990.0,4.6,3,2,1,2,0,1,2,50.0,1,4,1,3,1,4,20,0,DF,30-34,Defender,Republic of Ireland,Europe
1543,Shane Long,IRL,Southampton,Premier League,2021,34.0,1987.0,3.4,9,5,2,4,3,1,1,100.0,0,4,0,4,0,9,2,0,FW,30-34,Forward,Republic of Ireland,Europe
1544,Sean Longstaff,ENG,Newcastle Utd,Premier League,2021,23.0,1997.0,16.3,54,34,18,31,5,24,65,36.9,41,18,6,12,9,63,18,0,MF,20-24,Midfielder,England,Europe
1545,Ademola Lookman,NGA,Leicester City,Premier League,2021,23.0,1997.0,16.1,32,14,10,13,9,10,28,35.7,18,19,1,18,10,42,4,0,"FW,MF",20-24,Forward,Nigeria,Africa
1546,Anthony Lopes,POR,Lyon,Ligue 1,2021,30.0,1990.0,33.1,0,0,0,0,0,0,0,,0,0,0,0,3,3,12,3,GK,30-34,Goalkeeper,Portugal,Europe
1550,Maxime Lopez,FRA,Sassuolo,Serie A,2021,23.0,1997.0,32.6,69,36,40,27,2,35,87,40.2,52,33,7,26,42,111,38,1,MF,20-24,Midfielder,France,Europe
1553,Dion Lopy,SEN,Reims,Ligue 1,2021,19.0,2002.0,18.2,53,29,22,24,7,21,53,39.6,32,20,4,16,22,75,17,0,MF,Under 20,Midfielder,Senegal,Africa
1554,Samuel Loric,FRA,Lorient,Ligue 1,2021,21.0,2000.0,3.0,7,5,2,3,2,5,8,62.5,3,2,0,2,5,12,9,0,DF,20-24,Defender,France,Europe
1555,Anthony Losilla,FRA,Bochum,Bundesliga,2021,35.0,1986.0,32.6,65,39,29,30,6,34,69,49.3,35,32,9,23,70,135,53,1,MF,35-39,Midfielder,France,Europe
1556,Jonas Lössl,DEN,Brentford,Premier League,2021,32.0,1989.0,2.0,0,0,0,0,0,0,0,,0,0,0,0,0,0,1,0,GK,30-34,Goalkeeper,Denmark,Europe
1558,Jordan Lotomba,SUI,Nice,Ligue 1,2021,22.0,1998.0,19.8,33,17,21,9,3,16,30,53.3,14,17,4,13,12,45,28,0,DF,20-24,Defender,Switzerland,Europe
1559,Johaneko Louisjean,FRA,Bordeaux,Ligue 1,2021,17.0,2004.0,0.1,0,0,0,0,0,0,0,,0,0,0,0,0,0,0,0,DF,Under 20,Defender,France,Europe
1560,Mamadou Loum,SEN,Alavés,La Liga,2021,24.0,1996.0,25.7,49,22,26,22,1,17,45,37.8,28,30,11,19,37,86,68,1,MF,20-24,Midfielder,Senegal,Africa
1561,Imran Louza,MAR,Watford,Premier League,2021,22.0,1999.0,15.7,41,21,18,20,3,16,38,42.1,22,28,6,22,42,83,20,1,MF,20-24,Midfielder,Morocco,Africa
1562,Matteo Lovato,ITA,Atalanta,Serie A,2021,21.0,2000.0,3.4,5,4,4,1,0,0,1,0.0,1,4,2,2,7,12,8,0,DF,20-24,Defender,Italy,Europe
1563,Matteo Lovato,ITA,Cagliari,Serie A,2021,21.0,2000.0,13.8,23,15,13,10,0,8,20,40.0,12,21,10,11,28,51,43,0,DF,20-24,Defender,Italy,Europe
1564,Eduard Löwen,GER,Bochum,Bundesliga,2021,24.0,1997.0,15.7,28,22,12,11,5,10,43,23.3,33,17,2,15,9,37,15,1,MF,20-24,Midfielder,Germany,Europe
1565,Matthew Lowton,ENG,Burnley,Premier League,2021,32.0,1989.0,19.7,38,24,20,10,8,20,37,54.1,17,25,11,14,26,64,68,0,DF,30-34,Defender,England,Europe
1567,Hirving Lozano,MEX,Napoli,Serie A,2021,26.0,1995.0,17.9,28,20,12,11,5,8,30,26.7,22,24,0,24,9,37,9,0,FW,25-29,Forward,Mexico,North America
1568,Jean Lucas,BRA,Monaco,Ligue 1,2021,23.0,1998.0,16.1,43,25,14,24,5,17,40,42.5,23,15,5,10,13,56,4,1,MF,20-24,Midfielder,Brazil,South America
1569,Anderson Lucoqui,ANG,Mainz 05,Bundesliga,2021,24.0,1997.0,8.3,22,10,11,6,5,11,22,50.0,11,15,3,12,11,33,10,0,DF,20-24,Defender,Angola,Africa
1570,Florentino Luís,POR,Getafe,La Liga,2021,21.0,1999.0,11.0,42,25,22,17,3,17,35,48.6,18,21,2,19,21,63,11,1,MF,20-24,Midfielder,Portugal,Europe
1573,José Luis Palomino,ARG,Atalanta,Serie A,2021,31.0,1990.0,29.7,78,40,42,33,3,32,50,64.0,18,43,21,22,100,178,80,2,DF,30-34,Defender,Argentina,South America
1575,Douglas Luiz,BRA,Aston Villa,Premier League,2021,23.0,1998.0,30.2,59,39,30,24,5,21,72,29.2,51,30,7,23,34,93,28,1,MF,20-24,Midfielder,Brazil,South America
1576,Romelu Lukaku,BEL,Chelsea,Premier League,2021,28.0,1993.0,17.7,2,1,0,1,1,1,5,20.0,4,11,1,10,0,2,20,0,FW,25-29,Forward,Belgium,Europe
1577,Castello Lukeba,FRA,Lyon,Ligue 1,2021,18.0,2002.0,23.3,34,19,27,7,0,15,23,65.2,8,18,9,9,38,72,64,2,DF,Under 20,Defender,France,Europe
1578,Dodi Lukebakio,BEL,Hertha BSC,Bundesliga,2021,23.0,1997.0,2.0,2,1,2,0,0,1,3,33.3,2,2,0,2,2,4,0,0,FW,20-24,Forward,Belgium,Europe
1579,Dodi Lukebakio,BEL,Wolfsburg,Bundesliga,2021,23.0,1997.0,9.8,7,4,3,2,2,1,10,10.0,9,5,0,5,13,20,4,0,"FW,MF",20-24,Forward,Belgium,Europe
1581,Levi Lumeka,ENG,Troyes,Ligue 1,2021,22.0,1998.0,0.7,0,0,0,0,0,0,2,0.0,2,0,0,0,0,0,2,0,"DF,FW",20-24,Defender,England,Europe
1582,Andriy Lunin,UKR,Real Madrid,La Liga,2021,22.0,1999.0,2.0,0,0,0,0,0,0,0,,0,0,0,0,0,0,2,0,GK,20-24,Goalkeeper,Ukraine,Europe
1583,Andrey Lunyov,RUS,Leverkusen,Bundesliga,2021,29.0,1991.0,1.0,0,0,0,0,0,0,0,,0,0,0,0,0,0,0,0,GK,25-29,Goalkeeper,Russia,Europe
1584,Sebastiano Luperto,ITA,Empoli,Serie A,2021,24.0,1996.0,21.8,29,17,17,10,2,10,20,50.0,10,32,26,6,45,74,132,0,DF,20-24,Defender,Italy,Europe
1585,Andreas Luthe,GER,Union Berlin,Bundesliga,2021,34.0,1987.0,27.0,0,0,0,0,0,0,1,0.0,1,0,0,0,0,0,11,4,GK,30-34,Goalkeeper,Germany,Europe
1586,Lyanco,BRA,Southampton,Premier League,2021,24.0,1997.0,10.1,18,15,11,7,0,10,18,55.6,8,18,13,5,13,31,50,1,DF,20-24,Defender,Brazil,South America
1587,Charalambos Lykogiannis,GRE,Cagliari,Serie A,2021,27.0,1993.0,20.2,19,12,16,1,2,11,20,55.0,9,18,8,10,31,50,73,0,"DF,FW",25-29,Defender,Greece,Europe
1588,Yannis M'Bemba,GAB,Nantes,Ligue 1,2021,20.0,2001.0,0.1,0,0,0,0,0,0,0,,0,0,0,0,0,0,1,0,"DF,FW",20-24,Defender,Gabon,Africa
1589,Alexis Mac Allister,ARG,Brighton,Premier League,2021,22.0,1998.0,23.6,65,40,23,30,12,29,68,42.6,39,37,7,30,13,78,22,0,"MF,FW",20-24,Midfielder,Argentina,South America
1590,Deiver Machado,COL,Lens,Ligue 1,2021,27.0,1993.0,5.8,16,14,11,1,4,12,14,85.7,2,9,1,8,3,19,12,1,"DF,MF",25-29,Defender,Colombia,South America
1591,Darwin Machís,VEN,Granada,La Liga,2021,28.0,1993.0,15.3,23,13,11,8,4,9,23,39.1,14,10,0,10,15,38,17,0,"MF,FW",25-29,Midfielder,Venezuela,South America
1592,Yvann Macon,FRA,Saint-Étienne,Ligue 1,2021,22.0,1998.0,17.0,41,22,24,14,3,16,42,38.1,26,18,4,14,18,59,27,0,DF,20-24,Defender,France,Europe
1593,James Maddison,ENG,Leicester City,Premier League,2021,24.0,1996.0,27.3,40,20,8,24,8,14,46,30.4,32,18,3,15,11,51,12,0,"MF,FW",20-24,Midfielder,England,Europe
1594,Niki Mäenpää,FIN,Venezia,Serie A,2021,36.0,1985.0,16.5,0,0,0,0,0,0,0,,0,0,0,0,0,0,8,2,GK,35-39,Goalkeeper,Finland,Europe
1596,Louis Mafouta,CTA,Metz,Ligue 1,2021,27.0,1994.0,5.8,0,0,0,0,0,0,5,0.0,5,1,0,1,0,0,4,0,FW,25-29,Forward,Central African Republic,Africa
1597,Gabriel Magalhães,BRA,Arsenal,Premier League,2021,23.0,1997.0,34.0,50,30,36,12,2,30,41,73.2,11,34,26,8,13,63,112,4,DF,20-24,Defender,Brazil,South America
1598,Giulio Maggiore,ITA,Spezia,Serie A,2021,23.0,1998.0,31.3,58,32,20,32,6,31,77,40.3,46,30,5,25,29,87,33,0,MF,20-24,Midfielder,Italy,Europe
1599,Matej Maglica,CRO,Stuttgart,Bundesliga,2021,22.0,1998.0,0.1,0,0,0,0,0,0,1,0.0,1,0,0,0,0,0,0,0,MF,20-24,Midfielder,Croatia,Europe
1600,Francesco Magnanelli,ITA,Sassuolo,Serie A,2021,36.0,1984.0,3.0,5,4,4,1,0,1,9,11.1,8,3,1,2,1,6,3,0,MF,35-39,Midfielder,Italy,Europe
1601,Giangiacomo Magnani,ITA,Hellas Verona,Serie A,2021,25.0,1995.0,5.9,10,7,5,5,0,8,16,50.0,8,5,3,2,10,20,46,0,DF,25-29,Defender,Italy,Europe
1602,Giangiacomo Magnani,ITA,Sampdoria,Serie A,2021,25.0,1995.0,2.7,4,2,4,0,0,1,1,100.0,0,2,2,0,7,11,12,0,DF,25-29,Defender,Italy,Europe
1603,Hugo Magnetti,FRA,Brest,Ligue 1,2021,23.0,1998.0,16.3,50,34,27,20,3,22,50,44.0,28,14,3,11,25,75,13,0,MF,20-24,Midfielder,France,Europe
1604,Yohann Magnin,FRA,Clermont Foot,Ligue 1,2021,24.0,1997.0,19.1,53,31,22,26,5,24,42,57.1,18,17,7,10,20,73,36,0,"MF,DF",20-24,Midfielder,France,Europe
1605,Harry Maguire,ENG,Manchester Utd,Premier League,2021,28.0,1993.0,27.9,34,21,22,8,4,19,31,61.3,12,36,29,7,32,66,101,3,DF,25-29,Defender,England,Europe
1606,Riyad Mahrez,ALG,Manchester City,Premier League,2021,30.0,1991.0,16.6,11,3,5,4,2,5,19,26.3,14,15,1,14,6,17,6,0,FW,30-34,Forward,Algeria,Africa
1607,Arne Maier,GER,Augsburg,Bundesliga,2021,22.0,1999.0,20.7,20,13,6,10,4,8,26,30.8,18,18,1,17,15,35,13,0,MF,20-24,Midfielder,Germany,Europe
1608,Habib Maïga,CIV,Metz,Ligue 1,2021,25.0,1996.0,14.1,47,28,29,13,5,24,48,50.0,24,20,7,13,14,61,18,0,MF,25-29,Midfielder,Ivory Coast,Africa
1609,Mike Maignan,FRA,Milan,Serie A,2021,26.0,1995.0,32.0,2,1,2,0,0,2,2,100.0,0,0,0,0,1,3,4,2,GK,25-29,Goalkeeper,France,Europe
1610,Ainsley Maitland-Niles,ENG,Arsenal,Premier League,2021,23.0,1997.0,3.0,8,4,5,3,0,2,4,50.0,2,2,0,2,4,12,4,0,MF,20-24,Midfielder,England,Europe
1611,Ainsley Maitland-Niles,ENG,Roma,Serie A,2021,23.0,1997.0,5.4,8,6,5,0,3,5,14,35.7,9,7,0,7,6,14,7,0,DF,20-24,Defender,England,Europe
1612,Josh Maja,NGA,Bordeaux,Ligue 1,2021,22.0,1998.0,0.1,0,0,0,0,0,0,0,,0,1,0,1,0,0,0,0,FW,20-24,Forward,Nigeria,Africa
1613,Abdul Majeed Waris,GHA,Strasbourg,Ligue 1,2021,29.0,1991.0,3.6,5,3,2,3,0,5,10,50.0,5,2,0,2,0,5,1,0,"FW,MF",25-29,Forward,Ghana,Africa
1614,Lovro Majer,CRO,Rennes,Ligue 1,2021,23.0,1998.0,20.4,32,21,9,14,9,11,42,26.2,31,26,2,24,11,43,9,0,"MF,FW",20-24,Midfielder,Croatia,Europe
1615,Jean-Victor Makengo,FRA,Udinese,Serie A,2021,23.0,1998.0,26.1,30,21,7,17,6,15,29,51.7,14,26,6,20,19,49,17,0,MF,20-24,Midfielder,France,Europe
1616,Béni Makouana,CGO,Montpellier,Ligue 1,2021,18.0,2002.0,3.6,2,2,0,0,2,0,1,0.0,1,1,0,1,3,5,2,0,"FW,MF",Under 20,Forward,Congo,Africa
1619,Kévin Malcuit,MAR,Napoli,Serie A,2021,30.0,1991.0,3.2,4,2,4,0,0,2,2,100.0,0,3,0,3,8,12,6,0,"DF,MF",30-34,Defender,Morocco,Africa
1620,Daniel Maldini,ITA,Milan,Serie A,2021,19.0,2001.0,1.6,8,3,4,3,1,2,6,33.3,4,4,0,4,1,9,0,0,MF,Under 20,Midfielder,Italy,Europe
1621,Youssef Maleh,MAR,Fiorentina,Serie A,2021,22.0,1998.0,11.3,27,16,8,13,6,12,25,48.0,13,14,1,13,6,33,2,0,MF,20-24,Midfielder,Morocco,Africa
1622,Donyell Malen,NED,Dortmund,Bundesliga,2021,22.0,1999.0,18.7,13,10,4,5,4,7,13,53.8,6,10,0,10,10,23,11,0,FW,20-24,Forward,Netherlands,Europe
1623,Ruslan Malinovskyi,UKR,Atalanta,Serie A,2021,28.0,1993.0,17.7,18,10,3,10,5,5,19,26.3,14,27,3,24,5,23,1,0,"MF,FW",25-29,Midfielder,Ukraine,Europe
1625,Lennard Maloney,USA,Dortmund,Bundesliga,2021,21.0,1999.0,0.1,1,0,1,0,0,1,1,100.0,0,0,0,0,0,1,0,0,DF,20-24,Defender,United States,North America
1627,Giorgi Mamardashvili,GEO,Valencia,La Liga,2021,20.0,2000.0,18.0,0,0,0,0,0,0,0,,0,0,0,0,0,0,6,1,GK,20-24,Goalkeeper,Georgia,Asia
1628,Rey Manaj,ALB,Spezia,Serie A,2021,24.0,1997.0,19.6,19,12,3,11,5,6,26,23.1,20,16,0,16,4,23,13,0,FW,20-24,Forward,Albania,Europe
1629,Hianga Mananga Mbock,FRA,Brest,Ligue 1,2021,21.0,1999.0,8.9,18,12,8,7,3,9,21,42.9,12,5,2,3,5,23,6,0,MF,20-24,Midfielder,France,Europe
1630,Vincent Manceau,FRA,Angers,Ligue 1,2021,32.0,1989.0,26.2,32,19,18,13,1,14,37,37.8,23,23,6,17,32,64,72,0,DF,30-34,Defender,France,Europe
1631,Gianluca Mancini,ITA,Roma,Serie A,2021,25.0,1996.0,32.0,41,25,22,18,1,18,33,54.5,15,38,19,19,39,80,69,0,DF,25-29,Defender,Italy,Europe
1632,Leonardo Mancuso,ITA,Empoli,Serie A,2021,29.0,1992.0,4.7,1,1,0,1,0,0,6,0.0,6,2,0,2,1,2,2,0,FW,25-29,Forward,Italy,Europe
1633,Steve Mandanda,FRA,Marseille,Ligue 1,2021,36.0,1985.0,9.0,0,0,0,0,0,0,1,0.0,1,1,0,1,1,1,4,1,GK,35-39,Goalkeeper,France,Europe
1634,Reinildo Mandava,MOZ,Atlético Madrid,La Liga,2021,27.0,1994.0,14.4,45,25,30,14,1,22,30,73.3,8,18,9,9,21,66,38,0,DF,25-29,Defender,Mozambique,Africa
1635,Reinildo Mandava,MOZ,Lille,Ligue 1,2021,27.0,1994.0,16.9,43,23,29,11,3,32,51,62.7,19,13,4,9,37,80,55,0,DF,25-29,Defender,Mozambique,Africa
1636,Aïssa Mandi,ALG,Villarreal,La Liga,2021,29.0,1991.0,15.3,11,5,2,8,1,3,6,50.0,3,17,14,3,13,24,49,3,DF,25-29,Defender,Algeria,Africa
1637,Rolando Mandragora,ITA,Torino,Serie A,2021,24.0,1997.0,14.7,21,10,3,16,2,12,21,57.1,9,18,4,14,10,31,13,0,MF,20-24,Midfielder,Italy,Europe
1638,Anthony Mandrea,ALG,Angers,Ligue 1,2021,24.0,1996.0,10.0,0,0,0,0,0,0,0,,0,0,0,0,0,0,9,0,GK,20-24,Goalkeeper,Algeria,Africa
1639,Sadio Mané,SEN,Liverpool,Premier League,2021,29.0,1992.0,31.3,33,20,7,14,12,8,26,30.8,18,30,1,29,8,41,15,0,FW,25-29,Forward,Senegal,Africa
1640,Eliaquim Mangala,FRA,Saint-Étienne,Ligue 1,2021,30.0,1991.0,13.1,17,12,12,5,0,8,12,66.7,4,11,8,3,17,34,61,1,DF,30-34,Defender,France,Europe
1641,Orel Mangala,BEL,Stuttgart,Bundesliga,2021,23.0,1998.0,20.6,17,10,5,7,5,11,22,50.0,11,11,4,7,12,29,19,1,MF,20-24,Midfielder,Belgium,Europe
1642,Thomas Mangani,FRA,Angers,Ligue 1,2021,34.0,1987.0,24.4,58,30,23,34,1,31,68,45.6,37,38,11,27,36,94,29,0,MF,30-34,Midfielder,France,Europe
1643,Ricardo Mangas,POR,Bordeaux,Ligue 1,2021,23.0,1998.0,26.1,35,22,22,8,5,26,41,63.4,15,18,4,14,25,60,47,3,DF,20-24,Defender,Portugal,Europe
1644,Kostas Manolas,GRE,Napoli,Serie A,2021,30.0,1991.0,3.5,2,2,1,1,0,2,3,66.7,1,2,1,1,4,6,10,1,DF,30-34,Defender,Greece,Europe
1648,Sekou Mara,FRA,Bordeaux,Ligue 1,2021,19.0,2002.0,10.1,8,4,1,1,6,1,8,12.5,7,7,0,7,2,10,6,0,"FW,MF",Under 20,Forward,France,Europe
1650,Fernando Marçal,BRA,Wolves,Premier League,2021,32.0,1989.0,16.1,42,22,27,14,1,21,37,56.8,16,25,4,21,28,70,52,0,"MF,DF",30-34,Midfielder,Brazil,South America
1651,Marcelo,BRA,Real Madrid,La Liga,2021,33.0,1988.0,5.8,8,4,2,3,3,5,10,50.0,5,7,2,5,1,9,11,0,DF,30-34,Defender,Brazil,South America
1651,Marcelo,BRA,Real Madrid,La Liga,2021,33.0,1988.0,5.8,8,4,2,3,3,5,10,50.0,5,7,2,5,1,9,11,0,DF,30-34,Defender,Brazil,South America
1651,Marcelo,BRA,Real Madrid,La Liga,2021,33.0,1988.0,5.8,8,4,2,3,3,5,10,50.0,5,7,2,5,1,9,11,0,DF,30-34,Defender,Brazil,South America
1651,Marcelo,BRA,Real Madrid,La Liga,2021,33.0,1988.0,5.8,8,4,2,3,3,5,10,50.0,5,7,2,5,1,9,11,0,DF,30-34,Defender,Brazil,South America
1651,Marcelo,BRA,Real Madrid,La Liga,2021,33.0,1988.0,5.8,8,4,2,3,3,5,10,50.0,5,7,2,5,1,9,11,0,DF,30-34,Defender,Brazil,South America
1651,Marcelo,BRA,Real Madrid,La Liga,2021,33.0,1988.0,5.8,8,4,2,3,3,5,10,50.0,5,7,2,5,1,9,11,0,DF,30-34,Defender,Brazil,South America
1651,Marcelo,BRA,Real Madrid,La Liga,2021,33.0,1988.0,5.8,8,4,2,3,3,5,10,50.0,5,7,2,5,1,9,11,0,DF,30-34,Defender,Brazil,South America
1651,Marcelo,BRA,Real Madrid,La Liga,2021,33.0,1988.0,5.8,8,4,2,3,3,5,10,50.0,5,7,2,5,1,9,11,0,DF,30-34,Defender,Brazil,South America
1651,Marcelo,BRA,Real Madrid,La Liga,2021,33.0,1988.0,5.8,8,4,2,3,3,5,10,50.0,5,7,2,5,1,9,11,0,DF,30-34,Defender,Brazil,South America
1652,Marcelo,BRA,Bordeaux,Ligue 1,2021,34.0,1987.0,10.0,9,5,7,2,0,4,6,66.7,2,4,3,1,13,22,46,1,DF,30-34,Defender,Brazil,South America
1652,Marcelo,BRA,Bordeaux,Ligue 1,2021,34.0,1987.0,10.0,9,5,7,2,0,4,6,66.7,2,4,3,1,13,22,46,1,DF,30-34,Defender,Brazil,South America
1652,Marcelo,BRA,Bordeaux,Ligue 1,2021,34.0,1987.0,10.0,9,5,7,2,0,4,6,66.7,2,4,3,1,13,22,46,1,DF,30-34,Defender,Brazil,South America
1652,Marcelo,BRA,Bordeaux,Ligue 1,2021,34.0,1987.0,10.0,9,5,7,2,0,4,6,66.7,2,4,3,1,13,22,46,1,DF,30-34,Defender,Brazil,South America
1652,Marcelo,BRA,Bordeaux,Ligue 1,2021,34.0,1987.0,10.0,9,5,7,2,0,4,6,66.7,2,4,3,1,13,22,46,1,DF,30-34,Defender,Brazil,South America
1652,Marcelo,BRA,Bordeaux,Ligue 1,2021,34.0,1987.0,10.0,9,5,7,2,0,4,6,66.7,2,4,3,1,13,22,46,1,DF,30-34,Defender,Brazil,South America
1652,Marcelo,BRA,Bordeaux,Ligue 1,2021,34.0,1987.0,10.0,9,5,7,2,0,4,6,66.7,2,4,3,1,13,22,46,1,DF,30-34,Defender,Brazil,South America
1652,Marcelo,BRA,Bordeaux,Ligue 1,2021,34.0,1987.0,10.0,9,5,7,2,0,4,6,66.7,2,4,3,1,13,22,46,1,DF,30-34,Defender,Brazil,South America
1652,Marcelo,BRA,Bordeaux,Ligue 1,2021,34.0,1987.0,10.0,9,5,7,2,0,4,6,66.7,2,4,3,1,13,22,46,1,DF,30-34,Defender,Brazil,South America
1653,Marcelo,BRA,Lyon,Ligue 1,2021,34.0,1987.0,2.0,4,3,0,4,0,4,6,66.7,2,3,2,1,4,8,10,0,DF,30-34,Defender,Brazil,South America
1653,Marcelo,BRA,Lyon,Ligue 1,2021,34.0,1987.0,2.0,4,3,0,4,0,4,6,66.7,2,3,2,1,4,8,10,0,DF,30-34,Defender,Brazil,South America
1653,Marcelo,BRA,Lyon,Ligue 1,2021,34.0,1987.0,2.0,4,3,0,4,0,4,6,66.7,2,3,2,1,4,8,10,0,DF,30-34,Defender,Brazil,South America
1653,Marcelo,BRA,Lyon,Ligue 1,2021,34.0,1987.0,2.0,4,3,0,4,0,4,6,66.7,2,3,2,1,4,8,10,0,DF,30-34,Defender,Brazil,South America
1653,Marcelo,BRA,Lyon,Ligue 1,2021,34.0,1987.0,2.0,4,3,0,4,0,4,6,66.7,2,3,2,1,4,8,10,0,DF,30-34,Defender,Brazil,South America
1653,Marcelo,BRA,Lyon,Ligue 1,2021,34.0,1987.0,2.0,4,3,0,4,0,4,6,66.7,2,3,2,1,4,8,10,0,DF,30-34,Defender,Brazil,South America
1653,Marcelo,BRA,Lyon,Ligue 1,2021,34.0,1987.0,2.0,4,3,0,4,0,4,6,66.7,2,3,2,1,4,8,10,0,DF,30-34,Defender,Brazil,South America
1653,Marcelo,BRA,Lyon,Ligue 1,2021,34.0,1987.0,2.0,4,3,0,4,0,4,6,66.7,2,3,2,1,4,8,10,0,DF,30-34,Defender,Brazil,South America
1653,Marcelo,BRA,Lyon,Ligue 1,2021,34.0,1987.0,2.0,4,3,0,4,0,4,6,66.7,2,3,2,1,4,8,10,0,DF,30-34,Defender,Brazil,South America
1654,Solly March,ENG,Brighton,Premier League,2021,27.0,1994.0,19.4,30,17,11,9,10,7,22,31.8,15,22,3,19,17,47,25,0,"DF,FW",25-29,Defender,England,Europe
1655,Riccardo Marchizza,ITA,Empoli,Serie A,2021,23.0,1998.0,15.0,21,15,11,8,2,11,16,68.8,5,15,6,9,10,31,24,0,DF,20-24,Defender,Italy,Europe
1656,Gian Marco Ferrari,ITA,Sassuolo,Serie A,2021,29.0,1992.0,34.7,16,11,10,6,0,10,23,43.5,13,37,27,10,43,59,114,2,DF,25-29,Defender,Italy,Europe
1657,Iván Marcone,ARG,Elche,La Liga,2021,31.0,1990.0,9.0,24,14,17,6,1,12,24,50.0,12,8,3,5,12,36,13,0,MF,30-34,Midfielder,Argentina,South America
1659,Davide Marfella,ITA,Napoli,Serie A,2021,21.0,1999.0,0.1,0,0,0,0,0,0,0,,0,0,0,0,0,0,0,0,GK,20-24,Goalkeeper,Italy,Europe
1663,José María Giménez,URU,Atlético Madrid,La Liga,2021,26.0,1995.0,22.7,18,12,12,6,0,8,16,50.0,8,25,19,6,25,43,96,1,DF,25-29,Defender,Uruguay,South America
1664,Mariano,DOM,Real Madrid,La Liga,2021,27.0,1993.0,3.8,2,0,2,0,0,0,0,,0,2,0,2,1,3,3,0,FW,25-29,Forward,Dominican Republic,North America
1665,Răzvan Marin,ROU,Cagliari,Serie A,2021,25.0,1996.0,31.3,42,21,16,22,4,24,54,44.4,30,23,5,18,10,52,17,1,MF,25-29,Midfielder,Romania,Europe
1666,Guillermo Maripán,CHI,Monaco,Ligue 1,2021,27.0,1994.0,20.4,36,24,27,9,0,20,40,50.0,20,21,14,7,25,61,66,1,DF,25-29,Defender,Chile,South America
1668,Omar Marmoush,EGY,Wolfsburg,Bundesliga,2021,22.0,1999.0,0.3,0,0,0,0,0,0,0,,0,0,0,0,0,0,0,0,FW,20-24,Forward,Egypt,Africa
1669,Omar Marmoush,EGY,Stuttgart,Bundesliga,2021,22.0,1999.0,17.5,26,17,6,14,6,4,20,20.0,16,9,1,8,7,33,6,0,FW,20-24,Forward,Egypt,Africa
1670,Marquinhos,BRA,Paris S-G,Ligue 1,2021,27.0,1994.0,31.8,37,14,25,11,1,20,35,57.1,15,35,19,16,16,53,102,0,DF,25-29,Defender,Brazil,South America
1670,Marquinhos,BRA,Paris S-G,Ligue 1,2021,27.0,1994.0,31.8,37,14,25,11,1,20,35,57.1,15,35,19,16,16,53,102,0,DF,25-29,Defender,Brazil,South America
1670,Marquinhos,BRA,Paris S-G,Ligue 1,2021,27.0,1994.0,31.8,37,14,25,11,1,20,35,57.1,15,35,19,16,16,53,102,0,DF,25-29,Defender,Brazil,South America
1670,Marquinhos,BRA,Paris S-G,Ligue 1,2021,27.0,1994.0,31.8,37,14,25,11,1,20,35,57.1,15,35,19,16,16,53,102,0,DF,25-29,Defender,Brazil,South America
1670,Marquinhos,BRA,Paris S-G,Ligue 1,2021,27.0,1994.0,31.8,37,14,25,11,1,20,35,57.1,15,35,19,16,16,53,102,0,DF,25-29,Defender,Brazil,South America
1670,Marquinhos,BRA,Paris S-G,Ligue 1,2021,27.0,1994.0,31.8,37,14,25,11,1,20,35,57.1,15,35,19,16,16,53,102,0,DF,25-29,Defender,Brazil,South America
1670,Marquinhos,BRA,Paris S-G,Ligue 1,2021,27.0,1994.0,31.8,37,14,25,11,1,20,35,57.1,15,35,19,16,16,53,102,0,DF,25-29,Defender,Brazil,South America
1670,Marquinhos,BRA,Paris S-G,Ligue 1,2021,27.0,1994.0,31.8,37,14,25,11,1,20,35,57.1,15,35,19,16,16,53,102,0,DF,25-29,Defender,Brazil,South America
1670,Marquinhos,BRA,Paris S-G,Ligue 1,2021,27.0,1994.0,31.8,37,14,25,11,1,20,35,57.1,15,35,19,16,16,53,102,0,DF,25-29,Defender,Brazil,South America
1672,Anthony Martial,FRA,Manchester Utd,Premier League,2021,25.0,1995.0,2.4,0,0,0,0,0,0,1,0.0,1,1,0,1,0,0,1,0,FW,25-29,Forward,France,Europe
1673,Anthony Martial,FRA,Sevilla,La Liga,2021,25.0,1995.0,5.4,2,1,0,0,2,2,6,33.3,4,4,0,4,0,2,3,0,"FW,MF",25-29,Forward,France,Europe
1680,Jonas Martin,FRA,Rennes,Ligue 1,2021,31.0,1990.0,23.4,35,20,12,21,2,19,53,35.8,34,17,3,14,22,57,28,1,MF,30-34,Midfielder,France,Europe
1681,Gabriel Martinelli,BRA,Arsenal,Premier League,2021,20.0,2001.0,20.7,27,19,7,14,6,10,29,34.5,19,26,1,25,20,47,15,0,"FW,MF",20-24,Forward,Brazil,South America
1682,Emiliano Martínez,ARG,Aston Villa,Premier League,2021,28.0,1992.0,36.0,1,1,1,0,0,1,3,33.3,2,0,0,0,0,1,6,1,GK,25-29,Goalkeeper,Argentina,South America
1682,Emiliano Martínez,ARG,Aston Villa,Premier League,2021,28.0,1992.0,36.0,1,1,1,0,0,1,3,33.3,2,0,0,0,0,1,6,1,GK,25-29,Goalkeeper,Argentina,South America
1682,Emiliano Martínez,ARG,Aston Villa,Premier League,2021,28.0,1992.0,36.0,1,1,1,0,0,1,3,33.3,2,0,0,0,0,1,6,1,GK,25-29,Goalkeeper,Argentina,South America
1682,Emiliano Martínez,ARG,Aston Villa,Premier League,2021,28.0,1992.0,36.0,1,1,1,0,0,1,3,33.3,2,0,0,0,0,1,6,1,GK,25-29,Goalkeeper,Argentina,South America
1686,Lautaro Martínez,ARG,Inter,Serie A,2021,23.0,1997.0,25.4,20,10,3,10,7,6,11,54.5,5,21,1,20,18,38,6,0,FW,20-24,Forward,Argentina,South America
1688,Lucas Martínez Quarta,ARG,Fiorentina,Serie A,2021,25.0,1996.0,15.9,36,25,23,11,2,21,34,61.8,13,22,9,13,19,55,46,0,DF,25-29,Defender,Argentina,South America
1689,Gelson Martins,POR,Monaco,Ligue 1,2021,26.0,1995.0,21.2,42,27,10,26,6,21,59,35.6,38,26,1,25,17,59,4,0,"MF,FW",25-29,Midfielder,Portugal,Europe
1690,Adam Marušić,MNE,Lazio,Serie A,2021,28.0,1992.0,30.2,30,18,16,12,2,13,32,40.6,19,19,8,11,41,71,71,0,DF,25-29,Defender,Montenegro,Europe
1691,Omar Mascarell,EQG,Elche,La Liga,2021,28.0,1993.0,27.7,46,26,16,23,7,24,60,40.0,36,42,14,28,48,94,52,2,MF,25-29,Midfielder,Equatorial Guinea,Africa
1692,Andrea Masiello,ITA,Genoa,Serie A,2021,35.0,1986.0,5.7,5,3,4,1,0,4,7,57.1,3,8,4,4,11,16,20,1,DF,35-39,Defender,Italy,Europe
1693,Adam Masina,MAR,Watford,Premier League,2021,27.0,1994.0,12.0,24,13,11,10,3,12,29,41.4,17,18,6,12,18,42,45,0,DF,25-29,Defender,Morocco,Africa
1695,Roberto Massimo,GER,Stuttgart,Bundesliga,2021,20.0,2000.0,9.7,14,5,6,7,1,4,16,25.0,12,9,0,9,3,17,6,0,"DF,FW",20-24,Defender,Germany,Europe
1696,Arthur Masuaku,COD,West Ham,Premier League,2021,27.0,1993.0,7.2,31,23,19,11,1,14,23,60.9,9,9,1,8,9,40,17,0,"DF,FW",25-29,Defender,DR Congo,Africa
1699,Pape Matar Sarr,SEN,Metz,Ligue 1,2021,18.0,2002.0,23.7,45,26,21,23,1,18,39,46.2,21,33,3,30,29,74,22,0,MF,Under 20,Midfielder,Senegal,Africa
1700,Eliot Matazo,BEL,Monaco,Ligue 1,2021,19.0,2002.0,8.8,8,7,4,4,0,2,11,18.2,9,11,3,8,13,21,9,0,MF,Under 20,Midfielder,Belgium,Europe
1702,Jean-Philippe Mateta,FRA,Crystal Palace,Premier League,2021,24.0,1997.0,12.7,8,4,2,5,1,3,18,16.7,15,11,3,8,4,12,13,0,FW,20-24,Forward,France,Europe
1704,Joël Matip,CMR,Liverpool,Premier League,2021,29.0,1991.0,31.0,47,34,23,19,5,20,31,64.5,11,26,14,12,44,91,93,1,DF,25-29,Defender,Cameroon,Africa
1705,Chrislain Matsima,FRA,Monaco,Ligue 1,2021,19.0,2002.0,1.5,3,2,1,2,0,2,7,28.6,5,3,3,0,1,4,6,1,DF,Under 20,Defender,France,Europe
1706,Azor Matusiwa,NED,Reims,Ligue 1,2021,23.0,1998.0,27.4,58,32,28,26,4,26,55,47.3,29,49,19,30,62,120,43,0,MF,20-24,Midfielder,Netherlands,Europe
1707,Neal Maupay,FRA,Brighton,Premier League,2021,24.0,1996.0,25.3,17,10,2,6,9,4,18,22.2,14,21,2,19,2,19,2,0,FW,20-24,Forward,France,Europe
1708,Stephy Mavididi,ENG,Montpellier,Ligue 1,2021,23.0,1998.0,25.5,24,13,11,7,6,14,39,35.9,25,23,2,21,8,32,11,0,"FW,MF",20-24,Forward,England,Europe
1709,Konstantinos Mavropanos,GRE,Stuttgart,Bundesliga,2021,23.0,1997.0,30.1,57,39,35,21,1,30,51,58.8,21,46,23,23,69,126,174,2,DF,20-24,Defender,Greece,Europe
1710,Eric Maxim Choupo-Moting,CMR,Bayern Munich,Bundesliga,2021,32.0,1989.0,4.2,10,9,3,6,1,3,10,30.0,7,1,0,1,5,15,2,0,"FW,MF",30-34,Forward,Cameroon,Africa
1711,Luís Maximiano,POR,Granada,La Liga,2021,22.0,1999.0,34.8,3,1,3,0,0,3,6,50.0,3,0,0,0,1,4,16,2,GK,20-24,Goalkeeper,Portugal,Europe
1714,Derek Mazou-Sacko,FRA,Troyes,Ligue 1,2021,16.0,2004.0,0.0,1,0,0,0,1,1,1,100.0,0,0,0,0,0,1,1,0,"FW,DF",Under 20,Forward,France,Europe
1715,Pasquale Mazzocchi,ITA,Venezia,Serie A,2021,26.0,1995.0,13.8,18,8,11,4,3,10,26,38.5,16,11,8,3,21,39,31,1,DF,25-29,Defender,Italy,Europe
1716,Pasquale Mazzocchi,ITA,Salernitana,Serie A,2021,26.0,1995.0,14.1,28,19,15,11,2,14,34,41.2,20,5,0,5,11,39,31,0,DF,25-29,Defender,Italy,Europe
1717,Kevin Mbabu,SUI,Wolfsburg,Bundesliga,2021,26.0,1995.0,15.5,31,20,21,5,5,12,23,52.2,11,25,8,17,35,66,35,0,DF,25-29,Defender,Switzerland,Europe
1718,Kylian Mbappé,FRA,Paris S-G,Ligue 1,2021,22.0,1998.0,33.6,11,8,1,4,6,7,13,53.8,6,6,0,6,5,16,13,0,FW,20-24,Forward,France,Europe
1719,Ibrahima Mbaye,SEN,Bologna,Serie A,2021,26.0,1994.0,1.2,1,1,1,0,0,1,2,50.0,1,1,1,0,1,2,6,0,DF,25-29,Defender,Senegal,Africa
1720,Amadou Mbengue,SEN,Metz,Ligue 1,2021,19.0,2002.0,6.8,19,10,10,9,0,11,22,50.0,11,7,2,5,10,29,19,0,"DF,MF",Under 20,Defender,Senegal,Africa
1721,Bryan Mbeumo,CMR,Brentford,Premier League,2021,21.0,1999.0,32.3,28,16,1,12,15,6,20,30.0,14,21,6,15,11,39,20,0,FW,20-24,Forward,Cameroon,Africa
1722,Jason Mbock,FRA,Angers,Ligue 1,2021,21.0,1999.0,0.2,0,0,0,0,0,0,0,,0,0,0,0,0,0,0,0,FW,20-24,Forward,France,Europe
1724,Moustapha Mbow,SEN,Reims,Ligue 1,2021,21.0,2000.0,1.0,6,6,3,2,1,3,3,100.0,0,0,0,0,1,7,6,0,DF,20-24,Defender,Senegal,Africa
1725,Nathanael Mbuku,COD,Reims,Ligue 1,2021,19.0,2002.0,15.8,14,13,4,7,3,2,8,25.0,6,14,0,14,11,25,4,0,"FW,MF",Under 20,Forward,DR Congo,Africa
1726,James McArthur,SCO,Crystal Palace,Premier League,2021,33.0,1987.0,16.0,33,23,13,19,1,16,44,36.4,28,23,9,14,30,63,27,0,MF,30-34,Midfielder,Scotland,Europe
1727,James Mcatee,ENG,Manchester City,Premier League,2021,18.0,2002.0,0.2,0,0,0,0,0,0,2,0.0,2,0,0,0,0,0,0,0,"MF,FW",Under 20,Midfielder,England,Europe
1728,Kasey McAteer,IRL,Leicester City,Premier League,2021,19.0,2001.0,0.0,0,0,0,0,0,0,0,,0,0,0,0,0,0,0,0,FW,Under 20,Forward,Republic of Ireland,Europe
1729,Liam McCarron,SCO,Leeds United,Premier League,2021,20.0,2001.0,0.1,0,0,0,0,0,0,0,,0,1,0,1,0,0,0,0,FW,20-24,Forward,Scotland,Europe
1730,Alex McCarthy,ENG,Southampton,Premier League,2021,31.0,1989.0,17.0,0,0,0,0,0,0,0,,0,0,0,0,0,0,4,0,GK,30-34,Goalkeeper,England,Europe
1731,John McGinn,SCO,Aston Villa,Premier League,2021,26.0,1994.0,34.3,106,64,35,55,16,54,104,51.9,50,53,6,47,35,141,34,0,MF,25-29,Midfielder,Scotland,Europe
1732,Weston McKennie,USA,Juventus,Serie A,2021,22.0,1998.0,15.2,20,11,11,7,2,8,26,30.8,18,17,8,9,23,43,20,0,MF,20-24,Midfielder,United States,North America
1733,Stuart McKinstry,SCO,Leeds United,Premier League,2021,18.0,2002.0,0.0,0,0,0,0,0,0,0,,0,0,0,0,0,0,0,0,MF,Under 20,Midfielder,Scotland,Europe
1734,Kenny McLean,SCO,Norwich City,Premier League,2021,29.0,1992.0,30.1,42,22,18,20,4,17,59,28.8,42,29,7,22,34,76,54,0,MF,25-29,Midfielder,Scotland,Europe
1735,Dwight McNeil,ENG,Burnley,Premier League,2021,21.0,1999.0,34.5,78,49,27,38,13,33,73,45.2,40,64,11,53,35,113,31,1,MF,20-24,Midfielder,England,Europe
1736,Scott McTominay,SCO,Manchester Utd,Premier League,2021,24.0,1996.0,26.5,65,33,32,24,9,30,61,49.2,31,45,10,35,31,96,60,1,MF,20-24,Midfielder,Scotland,Europe
1737,Gary Medel,CHI,Bologna,Serie A,2021,33.0,1987.0,31.4,39,23,27,11,1,16,36,44.4,20,30,21,9,44,83,112,0,DF,30-34,Defender,Chile,South America
1738,Facundo Medina,ARG,Lens,Ligue 1,2021,22.0,1999.0,28.8,61,42,34,23,4,38,62,61.3,24,24,8,16,37,98,78,3,DF,20-24,Defender,Argentina,South America
1739,Nathan de Medina,BEL,Arminia,Bundesliga,2021,23.0,1997.0,8.6,17,10,11,6,0,6,10,60.0,4,14,3,11,10,27,28,0,DF,20-24,Defender,Belgium,Europe
1740,Ben Mee,ENG,Burnley,Premier League,2021,31.0,1989.0,20.4,26,12,16,7,3,12,19,63.2,7,28,22,6,24,50,94,1,DF,30-34,Defender,England,Europe
1741,Admir Mehmedi,SUI,Wolfsburg,Bundesliga,2021,30.0,1991.0,0.0,0,0,0,0,0,0,0,,0,0,0,0,0,0,0,0,DF,30-34,Defender,Switzerland,Europe
1742,Hannibal Mejbri,TUN,Manchester Utd,Premier League,2021,18.0,2003.0,0.8,2,1,1,1,0,1,1,100.0,0,0,0,0,0,2,0,0,FW,Under 20,Forward,Tunisia,Africa
1743,Farid El Melali,ALG,Angers,Ligue 1,2021,24.0,1997.0,0.2,0,0,0,0,0,0,1,0.0,1,1,0,1,0,0,1,0,FW,20-24,Forward,Algeria,Africa
1744,Filippo Melegoni,ITA,Genoa,Serie A,2021,22.0,1999.0,10.9,20,12,5,8,7,8,16,50.0,8,10,1,9,11,31,8,1,"MF,FW",20-24,Midfielder,Italy,Europe
1748,Arthur Melo,BRA,Juventus,Serie A,2021,24.0,1996.0,10.7,25,12,10,14,1,13,24,54.2,11,11,2,9,7,32,8,1,MF,20-24,Midfielder,Brazil,South America
1749,Memphis,NED,Barcelona,La Liga,2021,27.0,1994.0,20.6,10,4,2,4,4,3,13,23.1,10,9,1,8,3,13,4,0,FW,25-29,Forward,Netherlands,Europe
1750,Houboulang Mendes,GNB,Lorient,Ligue 1,2021,23.0,1998.0,35.8,58,28,37,18,3,40,57,70.2,17,41,21,20,41,99,128,4,DF,20-24,Defender,Guinea-Bissau,Africa
1751,Nuno Mendes,POR,Paris S-G,Ligue 1,2021,19.0,2002.0,18.4,48,29,23,18,7,25,47,53.2,22,27,5,22,21,69,17,1,DF,Under 20,Defender,Portugal,Europe
1752,Pedro Mendes,POR,Montpellier,Ligue 1,2021,30.0,1990.0,0.2,1,1,1,0,0,0,0,,0,1,1,0,0,1,2,0,DF,30-34,Defender,Portugal,Europe
1752,Pedro Mendes,POR,Montpellier,Ligue 1,2021,30.0,1990.0,0.2,1,1,1,0,0,0,0,,0,1,1,0,0,1,2,0,DF,30-34,Defender,Portugal,Europe
1752,Pedro Mendes,POR,Montpellier,Ligue 1,2021,30.0,1990.0,0.2,1,1,1,0,0,0,0,,0,1,1,0,0,1,2,0,DF,30-34,Defender,Portugal,Europe
1752,Pedro Mendes,POR,Montpellier,Ligue 1,2021,30.0,1990.0,0.2,1,1,1,0,0,0,0,,0,1,1,0,0,1,2,0,DF,30-34,Defender,Portugal,Europe
1752,Pedro Mendes,POR,Montpellier,Ligue 1,2021,30.0,1990.0,0.2,1,1,1,0,0,0,0,,0,1,1,0,0,1,2,0,DF,30-34,Defender,Portugal,Europe
1752,Pedro Mendes,POR,Montpellier,Ligue 1,2021,30.0,1990.0,0.2,1,1,1,0,0,0,0,,0,1,1,0,0,1,2,0,DF,30-34,Defender,Portugal,Europe
1752,Pedro Mendes,POR,Montpellier,Ligue 1,2021,30.0,1990.0,0.2,1,1,1,0,0,0,0,,0,1,1,0,0,1,2,0,DF,30-34,Defender,Portugal,Europe
1752,Pedro Mendes,POR,Montpellier,Ligue 1,2021,30.0,1990.0,0.2,1,1,1,0,0,0,0,,0,1,1,0,0,1,2,0,DF,30-34,Defender,Portugal,Europe
1752,Pedro Mendes,POR,Montpellier,Ligue 1,2021,30.0,1990.0,0.2,1,1,1,0,0,0,0,,0,1,1,0,0,1,2,0,DF,30-34,Defender,Portugal,Europe
1753,Thiago Mendes,BRA,Lyon,Ligue 1,2021,29.0,1992.0,20.7,36,22,18,16,2,12,30,40.0,18,24,5,19,34,70,56,1,"MF,DF",25-29,Midfielder,Brazil,South America
1757,Arial Mendy,SEN,Clermont Foot,Ligue 1,2021,26.0,1994.0,8.8,6,4,4,2,0,2,11,18.2,9,6,1,5,7,13,17,0,"DF,FW",25-29,Defender,Senegal,Africa
1758,Batista Mendy,FRA,Angers,Ligue 1,2021,21.0,2000.0,26.8,49,28,21,22,6,23,45,51.1,22,37,6,31,34,83,40,0,"MF,DF",20-24,Midfielder,France,Europe
1759,Benjamin Mendy,FRA,Manchester City,Premier League,2021,27.0,1994.0,0.9,2,2,1,1,0,2,6,33.3,4,0,0,0,0,2,0,0,DF,25-29,Defender,France,Europe
1760,Edouard Mendy,SEN,Chelsea,Premier League,2021,29.0,1992.0,34.0,1,0,1,0,0,1,3,33.3,2,0,0,0,0,1,13,4,GK,25-29,Goalkeeper,Senegal,Africa
1761,Ferland Mendy,FRA,Real Madrid,La Liga,2021,26.0,1995.0,19.3,24,14,11,10,3,8,14,57.1,6,8,2,6,18,42,27,3,DF,25-29,Defender,France,Europe
1762,Nampalys Mendy,SEN,Leicester City,Premier League,2021,29.0,1992.0,11.5,12,6,8,4,0,6,17,35.3,11,7,4,3,11,23,11,1,MF,25-29,Midfielder,Senegal,Africa
1763,Gideon Mensah,GHA,Bordeaux,Ligue 1,2021,23.0,1998.0,13.4,37,24,19,12,6,18,38,47.4,20,11,2,9,16,53,21,0,DF,20-24,Defender,Ghana,Africa
1765,Alex Meret,ITA,Napoli,Serie A,2021,24.0,1997.0,6.9,0,0,0,0,0,0,0,,0,0,0,0,0,0,3,1,GK,20-24,Goalkeeper,Italy,Europe
1768,Quentin Merlin,FRA,Nantes,Ligue 1,2021,19.0,2002.0,21.4,45,28,19,20,6,26,49,53.1,23,25,4,21,27,72,29,2,"DF,MF",Under 20,Defender,France,Europe
1770,Yıldırım Mert Çetin,TUR,Hellas Verona,Serie A,2021,24.0,1997.0,0.5,1,0,1,0,0,1,1,100.0,0,0,0,0,0,1,2,0,MF,20-24,Midfielder,Turkey,Asia
1771,Dries Mertens,BEL,Napoli,Serie A,2021,34.0,1987.0,15.4,16,7,1,11,4,3,16,18.8,13,8,2,6,9,25,2,0,"FW,MF",30-34,Forward,Belgium,Europe
1772,Illan Meslier,FRA,Leeds United,Premier League,2021,21.0,2000.0,37.6,1,1,1,0,0,1,1,100.0,0,0,0,0,0,1,27,1,GK,20-24,Goalkeeper,France,Europe
1773,Lionel Messi,ARG,Paris S-G,Ligue 1,2021,34.0,1987.0,23.9,10,3,1,5,4,3,13,23.1,10,5,0,5,4,14,0,0,"FW,MF",30-34,Forward,Argentina,South America
1774,Junior Messias,BRA,Milan,Serie A,2021,30.0,1991.0,15.9,34,18,11,14,9,15,34,44.1,19,11,1,10,17,51,17,0,"FW,MF",30-34,Forward,Brazil,South America
1775,Thomas Meunier,BEL,Dortmund,Bundesliga,2021,29.0,1991.0,15.6,29,19,13,12,4,16,33,48.5,17,10,2,8,12,41,25,1,DF,25-29,Defender,Belgium,Europe
1776,Mexer,MOZ,Bordeaux,Ligue 1,2021,32.0,1988.0,13.6,14,10,11,3,0,11,17,64.7,6,12,7,5,21,35,60,2,DF,30-34,Defender,Mozambique,Africa
1777,Marco Meyerhöfer,GER,Greuther Fürth,Bundesliga,2021,25.0,1995.0,25.3,53,35,22,22,9,24,37,64.9,13,38,19,19,47,100,64,1,DF,25-29,Defender,Germany,Europe
1778,Matt Miazga,USA,Alavés,La Liga,2021,26.0,1995.0,9.3,7,7,3,4,0,2,7,28.6,5,14,12,2,11,18,55,1,DF,25-29,Defender,United States,North America
1779,Kingsley Michael,NGA,Bologna,Serie A,2021,21.0,1999.0,0.8,4,1,2,2,0,1,2,50.0,1,2,1,1,1,5,1,1,MF,20-24,Midfielder,Nigeria,Africa
1780,Sven Michel,GER,Union Berlin,Bundesliga,2021,31.0,1990.0,3.8,10,6,5,3,2,2,8,25.0,6,3,0,3,1,11,1,0,FW,30-34,Forward,Germany,Europe
1781,Edouard Michut,FRA,Paris S-G,Ligue 1,2021,18.0,2003.0,0.8,0,0,0,0,0,0,2,0.0,2,2,0,2,1,1,2,0,MF,Under 20,Midfielder,France,Europe
1783,Valentin Mihaila,ROU,Atalanta,Serie A,2021,21.0,2000.0,0.8,1,1,0,1,0,0,1,0.0,1,2,0,2,0,1,0,0,"MF,FW",20-24,Midfielder,Romania,Europe
1784,Mikael,BRA,Salernitana,Serie A,2021,22.0,1999.0,1.0,1,1,0,1,0,0,0,,0,0,0,0,0,1,1,0,"FW,MF",20-24,Forward,Brazil,South America
1785,Hilmir Mikaelsson,ISL,Venezia,Serie A,2021,17.0,2004.0,0.2,2,0,0,1,1,0,0,,0,0,0,0,0,2,0,0,FW,Under 20,Forward,Iceland,Europe
1786,Georges Mikautadze,GEO,Metz,Ligue 1,2021,20.0,2000.0,0.0,0,0,0,0,0,0,0,,0,0,0,0,0,0,0,0,FW,20-24,Forward,Georgia,Asia
1787,William Mikelbrencis,FRA,Metz,Ligue 1,2021,17.0,2004.0,6.8,11,5,6,4,1,6,9,66.7,3,6,3,3,5,16,9,0,DF,Under 20,Defender,France,Europe
1792,Éder Militão,BRA,Real Madrid,La Liga,2021,23.0,1998.0,33.7,50,32,30,12,8,20,39,51.3,19,42,20,22,52,102,107,3,DF,20-24,Defender,Brazil,South America
1796,Enzo Millot,FRA,Stuttgart,Bundesliga,2021,19.0,2002.0,0.6,2,0,0,2,0,0,1,0.0,1,0,0,0,1,3,1,0,MF,Under 20,Midfielder,France,Europe
1797,James Milner,ENG,Liverpool,Premier League,2021,35.0,1986.0,9.5,28,16,12,11,5,12,29,41.4,17,19,5,14,17,45,20,0,"MF,DF",35-39,Midfielder,England,Europe
1799,Yerry Mina,COL,Everton,Premier League,2021,26.0,1994.0,9.4,12,10,12,0,0,10,13,76.9,3,13,9,4,11,23,38,1,DF,25-29,Defender,Colombia,South America
1800,Takumi Minamino,JPN,Liverpool,Premier League,2021,26.0,1995.0,2.1,3,2,1,1,1,2,8,25.0,6,2,0,2,1,4,2,0,"FW,MF",25-29,Forward,Japan,Asia
1801,Tyrone Mings,ENG,Aston Villa,Premier League,2021,28.0,1993.0,35.4,23,12,17,3,3,14,22,63.6,8,47,30,17,46,69,153,2,DF,25-29,Defender,England,Europe
1805,Aleksei Miranchuk,RUS,Atalanta,Serie A,2021,25.0,1995.0,8.6,11,7,3,7,1,4,12,33.3,8,3,0,3,1,12,7,0,"MF,FW",25-29,Midfielder,Russia,Europe
1807,Fabio Miretti,ITA,Juventus,Serie A,2021,17.0,2003.0,3.6,4,2,2,2,0,2,9,22.2,7,3,1,2,2,6,3,0,MF,Under 20,Midfielder,Italy,Europe
1808,Tyrick Mitchell,ENG,Crystal Palace,Premier League,2021,21.0,1999.0,34.5,104,57,67,26,11,46,67,68.7,21,47,5,42,41,145,101,0,DF,20-24,Defender,England,Europe
1810,Maximilian Mittelstädt,GER,Hertha BSC,Bundesliga,2021,24.0,1997.0,16.6,52,33,30,12,10,26,50,52.0,24,28,5,23,46,98,37,0,"DF,FW",20-24,Defender,Germany,Europe
1811,Henrikh Mkhitaryan,ARM,Roma,Serie A,2021,32.0,1989.0,27.7,45,29,11,27,7,17,52,32.7,35,33,2,31,22,67,33,0,"MF,FW",30-34,Midfielder,Armenia,Asia
1813,Anthony Modeste,FRA,Köln,Bundesliga,2021,33.0,1988.0,29.0,10,6,4,5,1,3,18,16.7,15,11,2,9,4,14,29,0,FW,30-34,Forward,France,Europe
1814,Marco Modolo,ITA,Venezia,Serie A,2021,32.0,1989.0,4.4,6,3,4,2,0,2,5,40.0,3,6,6,0,4,10,26,0,DF,30-34,Defender,Italy,Europe
1815,Luka Modrić,CRO,Real Madrid,La Liga,2021,35.0,1985.0,22.6,18,10,8,7,3,6,27,22.2,21,10,4,6,20,38,9,0,MF,35-39,Midfielder,Croatia,Europe
1816,Terem Moffi,NGA,Lorient,Ligue 1,2021,22.0,1999.0,30.1,17,10,3,12,2,9,32,28.1,23,11,2,9,4,21,22,0,FW,20-24,Forward,Nigeria,Africa
1817,Kevin Möhwald,GER,Union Berlin,Bundesliga,2021,28.0,1993.0,3.9,7,1,3,3,1,1,7,14.3,6,3,0,3,3,10,6,0,MF,25-29,Midfielder,Germany,Europe
1818,Dion Moise Sahi,CIV,Strasbourg,Ligue 1,2021,19.0,2001.0,1.4,0,0,0,0,0,0,0,,0,1,0,1,1,1,1,0,"FW,MF",Under 20,Forward,Ivory Coast,Africa
1819,Johan Mojica,COL,Elche,La Liga,2021,28.0,1992.0,31.7,46,25,34,7,5,23,31,74.2,8,22,3,19,25,71,61,3,DF,25-29,Defender,Colombia,South America
1820,Clinton Mola,ENG,Stuttgart,Bundesliga,2021,20.0,2001.0,1.3,3,1,2,1,0,2,4,50.0,2,5,5,0,3,6,2,0,DF,20-24,Defender,England,Europe
1822,Nahuel Molina,ARG,Udinese,Serie A,2021,23.0,1998.0,29.3,41,24,17,21,3,16,48,33.3,32,24,3,21,22,63,44,2,DF,20-24,Defender,Argentina,South America
1823,Cristian Molinaro,ITA,Venezia,Serie A,2021,38.0,1983.0,6.1,12,9,10,2,0,5,7,71.4,2,7,2,5,6,18,20,0,DF,35-39,Defender,Italy,Europe
1824,Florent Mollet,FRA,Montpellier,Ligue 1,2021,29.0,1991.0,29.2,31,22,14,12,5,14,57,24.6,43,27,4,23,24,55,13,0,"FW,MF",25-29,Forward,France,Europe
1827,Thomas Monconduit,FRA,Lorient,Ligue 1,2021,30.0,1991.0,25.0,41,25,19,17,5,20,57,35.1,37,21,10,11,22,63,51,1,MF,30-34,Midfielder,France,Europe
1828,Gonzalo Montiel,ARG,Sevilla,La Liga,2021,24.0,1997.0,11.8,15,4,8,5,2,12,24,50.0,12,8,2,6,10,25,22,0,DF,20-24,Defender,Argentina,South America
1829,Lorenzo Montipò,ITA,Hellas Verona,Serie A,2021,25.0,1996.0,34.0,0,0,0,0,0,0,0,,0,0,0,0,1,1,16,3,GK,25-29,Goalkeeper,Italy,Europe
1832,Wesley Moraes,BRA,Aston Villa,Premier League,2021,24.0,1996.0,0.0,0,0,0,0,0,0,0,,0,0,0,0,0,0,0,0,FW,20-24,Forward,Brazil,South America
1836,Jérémy Morel,MAD,Lorient,Ligue 1,2021,37.0,1984.0,6.7,13,9,8,4,1,6,6,100.0,0,9,7,2,7,20,31,0,DF,35-39,Defender,Madagascar,Africa
1841,Ilaix Moriba,GUI,Valencia,La Liga,2021,18.0,2003.0,9.1,26,18,10,13,3,14,35,40.0,21,15,0,15,12,38,14,0,MF,Under 20,Midfielder,Guinea,Africa
1842,Ilaix Moriba,GUI,RB Leipzig,Bundesliga,2021,18.0,2003.0,0.4,0,0,0,0,0,0,4,0.0,4,2,0,2,1,1,0,0,MF,Under 20,Midfielder,Guinea,Africa
1847,Tyler Morton,ENG,Liverpool,Premier League,2021,18.0,2002.0,0.7,0,0,0,0,0,0,2,0.0,2,0,0,0,3,3,0,0,MF,Under 20,Midfielder,England,Europe
1849,Lebo Mothiba,RSA,Troyes,Ligue 1,2021,25.0,1996.0,5.8,8,4,4,3,1,2,5,40.0,3,3,0,3,2,10,0,0,"FW,MF",25-29,Forward,South Africa,Africa
1850,Lebo Mothiba,RSA,Strasbourg,Ligue 1,2021,25.0,1996.0,0.0,0,0,0,0,0,0,0,,0,0,0,0,0,0,0,0,FW,25-29,Forward,South Africa,Africa
1851,Andrei Motoc,MDA,Salernitana,Serie A,2021,19.0,2002.0,1.0,1,1,0,1,0,0,0,,0,2,2,0,2,3,1,0,DF,Under 20,Defender,Moldova,Europe
1852,Baptiste Mouazan,FRA,Lorient,Ligue 1,2021,19.0,2001.0,1.1,4,3,2,2,0,1,3,33.3,2,3,0,3,1,5,1,0,MF,Under 20,Midfielder,France,Europe
1853,Aimen Moueffek,FRA,Saint-Étienne,Ligue 1,2021,20.0,2001.0,4.8,7,4,2,3,2,2,8,25.0,6,3,0,3,2,9,4,0,MF,20-24,Midfielder,France,Europe
1854,Youssoufa Moukoko,GER,Dortmund,Bundesliga,2021,16.0,2004.0,2.5,1,0,0,1,0,0,1,0.0,1,5,0,5,3,4,0,0,"FW,MF",Under 20,Forward,Germany,Europe
1855,Harold Moukoudi,CMR,Saint-Étienne,Ligue 1,2021,23.0,1997.0,18.5,25,12,17,8,0,14,25,56.0,11,27,14,13,35,60,48,0,DF,20-24,Defender,Cameroon,Africa
1856,Jessy Moulin,FRA,Troyes,Ligue 1,2021,35.0,1986.0,7.0,0,0,0,0,0,0,0,,0,0,0,0,1,1,7,0,GK,35-39,Goalkeeper,France,Europe
1857,Steve Mounié,BEN,Brest,Ligue 1,2021,26.0,1994.0,25.7,17,6,3,12,2,4,27,14.8,23,13,1,12,6,23,12,0,FW,25-29,Forward,Benin,Africa
1858,Mason Mount,ENG,Chelsea,Premier League,2021,22.0,1999.0,26.3,41,16,10,17,14,10,34,29.4,24,18,1,17,13,54,12,0,MF,20-24,Midfielder,England,Europe
1859,Lucas Moura,BRA,Tottenham,Premier League,2021,28.0,1992.0,19.7,25,10,7,14,4,8,35,22.9,27,19,0,19,18,43,19,0,"FW,MF",25-29,Forward,Brazil,South America
1860,Lys Mousset,FRA,Salernitana,Serie A,2021,25.0,1996.0,1.8,1,0,0,1,0,0,0,,0,2,0,2,0,1,0,0,"MF,FW",25-29,Midfielder,France,Europe
1861,João Moutinho,POR,Wolves,Premier League,2021,34.0,1986.0,33.0,74,39,34,27,13,30,106,28.3,76,48,8,40,34,108,36,2,MF,30-34,Midfielder,Portugal,Europe
1861,João Moutinho,POR,Wolves,Premier League,2021,34.0,1986.0,33.0,74,39,34,27,13,30,106,28.3,76,48,8,40,34,108,36,2,MF,30-34,Midfielder,Portugal,Europe
1861,João Moutinho,POR,Wolves,Premier League,2021,34.0,1986.0,33.0,74,39,34,27,13,30,106,28.3,76,48,8,40,34,108,36,2,MF,30-34,Midfielder,Portugal,Europe
1861,João Moutinho,POR,Wolves,Premier League,2021,34.0,1986.0,33.0,74,39,34,27,13,30,106,28.3,76,48,8,40,34,108,36,2,MF,30-34,Midfielder,Portugal,Europe
1862,Samuel Moutoussamy,COD,Nantes,Ligue 1,2021,24.0,1996.0,16.8,48,32,20,20,8,23,62,37.1,39,14,2,12,17,65,16,0,MF,20-24,Midfielder,DR Congo,Africa
1864,Samuel Mráz,SVK,Spezia,Serie A,2021,24.0,1997.0,0.6,0,0,0,0,0,0,0,,0,1,0,1,0,0,0,0,FW,20-24,Forward,Slovakia,Europe
1865,Nordi Mukiele,FRA,RB Leipzig,Bundesliga,2021,23.0,1997.0,20.5,35,22,23,9,3,14,27,51.9,13,31,5,26,31,66,44,2,"DF,FW",20-24,Defender,France,Europe
1866,Mert Müldür,TUR,Sassuolo,Serie A,2021,22.0,1999.0,22.7,52,35,43,7,2,27,49,55.1,22,25,6,19,24,76,44,1,DF,20-24,Defender,Turkey,Asia
1867,Florian Müller,GER,Stuttgart,Bundesliga,2021,23.0,1997.0,30.0,0,0,0,0,0,0,1,0.0,1,1,0,1,0,0,13,2,GK,20-24,Goalkeeper,Germany,Europe
1868,Thomas Müller,GER,Bayern Munich,Bundesliga,2021,31.0,1989.0,28.4,35,20,7,16,12,16,54,29.6,38,32,1,31,15,50,12,0,MF,30-34,Midfielder,Germany,Europe
1869,Bali Mumba,ENG,Norwich City,Premier League,2021,19.0,2001.0,0.5,1,1,1,0,0,0,0,,0,0,0,0,0,1,5,0,DF,Under 20,Defender,England,Europe
1870,Marshall Munetsi,ZIM,Reims,Ligue 1,2021,25.0,1996.0,20.9,34,17,21,11,2,17,39,43.6,22,39,13,26,43,77,72,2,"MF,DF",25-29,Midfielder,Zimbabwe,Africa
1873,Luis Muriel,COL,Atalanta,Serie A,2021,30.0,1991.0,17.1,15,4,2,7,6,3,19,15.8,16,12,0,12,4,19,5,0,"FW,MF",30-34,Forward,Colombia,South America
1874,Jeison Murillo,COL,Celta Vigo,La Liga,2021,29.0,1992.0,12.4,15,10,13,2,0,9,13,69.2,4,11,8,3,17,32,37,0,DF,25-29,Defender,Colombia,South America
1877,Jacob Murphy,ENG,Newcastle Utd,Premier League,2021,26.0,1995.0,16.4,49,26,34,11,4,26,41,63.4,15,20,2,18,23,72,17,0,"FW,DF",25-29,Forward,England,Europe
1878,Nicola Murru,ITA,Sampdoria,Serie A,2021,26.0,1994.0,10.9,22,17,10,11,1,8,13,61.5,5,17,3,14,7,29,20,1,DF,25-29,Defender,Italy,Europe
1879,Yunus Musah,USA,Valencia,La Liga,2021,18.0,2002.0,14.0,23,13,8,8,7,6,20,30.0,14,19,1,18,14,37,11,0,"MF,FW",Under 20,Midfielder,United States,North America
1880,Torben Müsel,GER,Gladbach,Bundesliga,2021,22.0,1999.0,0.1,0,0,0,0,0,0,0,,0,0,0,0,0,0,0,0,MF,20-24,Midfielder,Germany,Europe
1881,Jamal Musiala,GER,Bayern Munich,Bundesliga,2021,18.0,2003.0,16.3,40,26,11,16,13,15,36,41.7,21,25,0,25,19,59,2,1,"MF,FW",Under 20,Midfielder,Germany,Europe
1882,Juan Musso,ARG,Atalanta,Serie A,2021,27.0,1994.0,32.6,1,1,1,0,0,0,0,,0,0,0,0,0,1,17,1,GK,25-29,Goalkeeper,Argentina,South America
1883,Shkodran Mustafi,GER,Levante,La Liga,2021,29.0,1992.0,7.3,9,6,6,3,0,5,9,55.6,4,6,3,3,15,24,40,0,DF,25-29,Defender,Germany,Europe
1884,Junior Mwanga,FRA,Bordeaux,Ligue 1,2021,18.0,2003.0,1.0,5,2,4,1,0,3,3,100.0,0,1,0,1,0,5,1,0,DF,Under 20,Defender,France,Europe
1885,Enock Mwepu,ZAM,Brighton,Premier League,2021,23.0,1998.0,11.1,22,12,10,10,2,5,27,18.5,22,20,2,18,12,34,19,0,MF,20-24,Midfielder,Zambia,Africa
1886,Vitaliy Mykolenko,UKR,Everton,Premier League,2021,22.0,1999.0,11.7,25,15,15,7,3,12,21,57.1,9,15,2,13,16,41,37,0,DF,20-24,Defender,Ukraine,Europe
1887,Joakim Mæhle,DEN,Atalanta,Serie A,2021,24.0,1997.0,16.3,21,11,6,9,6,12,27,44.4,15,18,2,16,14,35,13,0,"DF,MF",20-24,Defender,Denmark,Europe
1888,Obite N'Dicka,CIV,Eint Frankfurt,Bundesliga,2021,21.0,1999.0,31.7,60,34,29,27,4,44,59,74.6,15,46,20,26,48,108,137,0,DF,20-24,Defender,Ivory Coast,Africa
1889,Kévin N'Doram,FRA,Metz,Ligue 1,2021,25.0,1996.0,13.7,10,8,3,5,2,3,20,15.0,17,24,5,19,19,29,21,0,MF,25-29,Midfielder,France,Europe
1890,Eric N'Jo,FRA,Troyes,Ligue 1,2021,17.0,2004.0,1.1,0,0,0,0,0,0,1,0.0,1,1,1,0,2,2,1,0,DF,Under 20,Defender,France,Europe
1891,Vital N'Simba,COD,Clermont Foot,Ligue 1,2021,28.0,1993.0,31.0,66,45,38,23,5,36,63,57.1,27,28,7,21,29,95,30,0,DF,25-29,Defender,DR Congo,Africa
1893,Mickael Nade,FRA,Saint-Étienne,Ligue 1,2021,22.0,1999.0,28.5,57,35,37,18,2,23,38,60.5,15,29,15,14,60,117,84,0,DF,20-24,Defender,France,Europe
1894,Marvelous Nakamba,ZIM,Aston Villa,Premier League,2021,27.0,1994.0,10.0,32,19,18,14,0,12,34,35.3,22,14,4,10,12,44,17,1,MF,25-29,Midfielder,Zimbabwe,Africa
1895,Nahitan Nández,URU,Cagliari,Serie A,2021,25.0,1995.0,16.9,39,21,16,15,8,18,33,54.5,15,16,1,15,9,48,15,1,"MF,DF",25-29,Midfielder,Uruguay,South America
1896,Nani,POR,Venezia,Serie A,2021,34.0,1986.0,3.2,2,1,1,1,0,0,1,0.0,1,1,0,1,2,4,0,1,"MF,FW",30-34,Midfielder,Portugal,Europe
1897,Paul Nardi,FRA,Lorient,Ligue 1,2021,27.0,1994.0,22.0,1,0,1,0,0,1,2,50.0,1,0,0,0,0,1,10,2,GK,25-29,Goalkeeper,France,Europe
1898,Nikolas Nartey,DEN,Stuttgart,Bundesliga,2021,21.0,2000.0,4.5,6,3,0,5,1,3,9,33.3,6,4,2,2,7,13,5,0,"MF,DF",20-24,Midfielder,Denmark,Europe
1903,Keylor Navas,CRC,Paris S-G,Ligue 1,2021,34.0,1986.0,20.6,0,0,0,0,0,0,0,,0,0,0,0,0,0,5,1,GK,30-34,Goalkeeper,Costa Rica,North America
1904,Papa Ndiaga Yade,MTN,Metz,Ligue 1,2021,21.0,2000.0,7.7,15,10,8,7,0,8,18,44.4,10,4,1,3,10,25,9,0,"DF,FW",20-24,Defender,Mauritania,Africa
1905,Wilfred Ndidi,NGA,Leicester City,Premier League,2021,24.0,1996.0,18.0,60,32,32,27,1,22,55,40.0,33,36,8,28,42,102,54,1,"MF,DF",20-24,Midfielder,Nigeria,Africa
1906,Tanguy Ndombele,FRA,Tottenham,Premier League,2021,24.0,1996.0,5.4,10,7,3,5,2,1,8,12.5,7,5,0,5,1,11,1,0,MF,20-24,Midfielder,France,Europe
1907,Tanguy Ndombele,FRA,Lyon,Ligue 1,2021,24.0,1996.0,7.8,25,14,5,17,3,12,19,63.2,7,8,3,5,3,28,6,2,MF,20-24,Midfielder,France,Europe
1908,Dan Ndoye,SUI,Nice,Ligue 1,2021,20.0,2000.0,2.3,0,0,0,0,0,0,2,0.0,2,4,0,4,0,0,0,0,"FW,MF",20-24,Forward,Switzerland,Europe
1909,Paul Nebel,GER,Mainz 05,Bundesliga,2021,18.0,2002.0,2.5,5,3,3,1,1,2,3,66.7,1,0,0,0,0,5,1,0,"MF,FW",Under 20,Midfielder,Germany,Europe
1911,Reiss Nelson,ENG,Arsenal,Premier League,2021,21.0,1999.0,0.2,1,0,0,0,1,0,1,0.0,1,1,0,1,0,1,0,0,FW,20-24,Forward,England,Europe
1912,David Nemeth,AUT,Mainz 05,Bundesliga,2021,20.0,2001.0,3.5,3,2,2,1,0,1,3,33.3,2,5,1,4,6,9,11,1,DF,20-24,Defender,Austria,Europe
1913,Ilija Nestorovski,MKD,Udinese,Serie A,2021,31.0,1990.0,2.1,0,0,0,0,0,0,3,0.0,3,0,0,0,0,0,4,0,FW,30-34,Forward,North Macedonia,Europe
1914,Neto,BRA,Barcelona,La Liga,2021,32.0,1989.0,3.0,0,0,0,0,0,0,0,,0,0,0,0,0,0,2,1,GK,30-34,Goalkeeper,Brazil,South America
1914,Neto,BRA,Barcelona,La Liga,2021,32.0,1989.0,3.0,0,0,0,0,0,0,0,,0,0,0,0,0,0,2,1,GK,30-34,Goalkeeper,Brazil,South America
1914,Neto,BRA,Barcelona,La Liga,2021,32.0,1989.0,3.0,0,0,0,0,0,0,0,,0,0,0,0,0,0,2,1,GK,30-34,Goalkeeper,Brazil,South America
1914,Neto,BRA,Barcelona,La Liga,2021,32.0,1989.0,3.0,0,0,0,0,0,0,0,,0,0,0,0,0,0,2,1,GK,30-34,Goalkeeper,Brazil,South America
1914,Neto,BRA,Barcelona,La Liga,2021,32.0,1989.0,3.0,0,0,0,0,0,0,0,,0,0,0,0,0,0,2,1,GK,30-34,Goalkeeper,Brazil,South America
1914,Neto,BRA,Barcelona,La Liga,2021,32.0,1989.0,3.0,0,0,0,0,0,0,0,,0,0,0,0,0,0,2,1,GK,30-34,Goalkeeper,Brazil,South America
1914,Neto,BRA,Barcelona,La Liga,2021,32.0,1989.0,3.0,0,0,0,0,0,0,0,,0,0,0,0,0,0,2,1,GK,30-34,Goalkeeper,Brazil,South America
1914,Neto,BRA,Barcelona,La Liga,2021,32.0,1989.0,3.0,0,0,0,0,0,0,0,,0,0,0,0,0,0,2,1,GK,30-34,Goalkeeper,Brazil,South America
1914,Neto,BRA,Barcelona,La Liga,2021,32.0,1989.0,3.0,0,0,0,0,0,0,0,,0,0,0,0,0,0,2,1,GK,30-34,Goalkeeper,Brazil,South America
1915,Pedro Neto,POR,Wolves,Premier League,2021,21.0,2000.0,5.2,4,4,2,0,2,0,9,0.0,9,0,0,0,6,10,1,0,"FW,MF",20-24,Forward,Portugal,Europe
1916,Luca Netz,GER,Gladbach,Bundesliga,2021,18.0,2003.0,15.5,24,11,12,10,2,11,40,27.5,29,24,4,20,13,37,33,1,"DF,FW",Under 20,Defender,Germany,Europe
1917,Manuel Neuer,GER,Bayern Munich,Bundesliga,2021,35.0,1986.0,27.9,2,1,2,0,0,1,2,50.0,1,0,0,0,0,2,7,1,GK,35-39,Goalkeeper,Germany,Europe
1918,Florian Neuhaus,GER,Gladbach,Bundesliga,2021,24.0,1997.0,23.6,55,28,24,26,5,27,64,42.2,37,38,6,32,31,86,19,4,MF,20-24,Midfielder,Germany,Europe
1920,Rúben Neves,POR,Wolves,Premier League,2021,24.0,1997.0,29.6,68,37,23,41,4,24,87,27.6,63,39,5,34,41,109,49,3,MF,20-24,Midfielder,Portugal,Europe
1921,Neymar,BRA,Paris S-G,Ligue 1,2021,29.0,1992.0,20.6,29,19,5,12,12,12,36,33.3,24,9,1,8,4,33,2,1,"FW,MF",25-29,Forward,Brazil,South America
1922,Yvan Neyou,CMR,Saint-Étienne,Ligue 1,2021,24.0,1997.0,10.4,29,13,14,12,3,9,27,33.3,18,8,3,5,23,52,13,0,MF,20-24,Midfielder,Cameroon,Africa
1923,Jeremy Ngakia,ENG,Watford,Premier League,2021,20.0,2000.0,10.0,31,18,23,5,3,11,26,42.3,15,11,4,7,12,43,32,0,DF,20-24,Defender,England,Europe
1924,Jessic Ngankam,GER,Greuther Fürth,Bundesliga,2021,21.0,2000.0,3.8,3,1,1,1,1,1,2,50.0,1,3,0,3,0,3,1,0,FW,20-24,Forward,Germany,Europe
1925,Opa Nguette,SEN,Metz,Ligue 1,2021,27.0,1994.0,11.6,21,14,9,6,6,5,14,35.7,9,13,3,10,2,23,9,0,"FW,MF",25-29,Forward,Senegal,Africa
1926,Aurélien Nguiamba,FRA,Spezia,Serie A,2021,22.0,1999.0,0.6,3,2,1,2,0,2,3,66.7,1,2,1,1,0,3,1,0,MF,20-24,Midfielder,France,Europe
1927,Sikou Niakaté,MLI,Metz,Ligue 1,2021,22.0,1999.0,7.3,8,7,8,0,0,4,11,36.4,7,5,3,2,27,35,34,0,DF,20-24,Defender,Mali,Africa
1928,Moussa Niakhate,SEN,Mainz 05,Bundesliga,2021,25.0,1996.0,28.5,40,23,25,13,2,20,33,60.6,13,37,11,26,50,90,69,1,DF,25-29,Defender,Senegal,Africa
1929,Ibrahima Niane,SEN,Metz,Ligue 1,2021,22.0,1999.0,17.6,1,1,0,1,0,0,5,0.0,5,6,1,5,3,4,16,0,FW,20-24,Forward,Senegal,Africa
1930,M'Baye Niang,SEN,Bordeaux,Ligue 1,2021,26.0,1994.0,8.6,4,0,0,2,2,0,4,0.0,4,9,1,8,1,5,4,0,FW,25-29,Forward,Senegal,Africa
1931,Tanguy Nianzou,FRA,Bayern Munich,Bundesliga,2021,19.0,2002.0,6.5,11,7,7,3,1,7,11,63.6,4,7,2,5,7,18,17,0,DF,Under 20,Defender,France,Europe
1932,Cheikh Niasse,SEN,Lille,Ligue 1,2021,21.0,2000.0,0.5,2,2,0,2,0,2,3,66.7,1,1,1,0,1,3,2,0,"FW,MF",20-24,Forward,Senegal,Africa
1933,Florian Niederlechner,GER,Augsburg,Bundesliga,2021,30.0,1990.0,12.9,6,5,1,3,2,4,13,30.8,9,9,0,9,4,10,7,0,FW,30-34,Forward,Germany,Europe
1937,Dimitris Nikolaou,GRE,Spezia,Serie A,2021,22.0,1998.0,36.0,39,26,29,7,3,22,34,64.7,12,48,24,24,49,88,132,1,DF,20-24,Defender,Greece,Europe
1938,Joakim Nilsson,SWE,Arminia,Bundesliga,2021,27.0,1994.0,30.4,37,19,24,13,0,20,26,76.9,6,36,23,13,56,93,143,1,DF,25-29,Defender,Sweden,Europe
1939,Casimir Ninga,CHA,Angers,Ligue 1,2021,28.0,1993.0,4.5,5,1,1,4,0,2,5,40.0,3,2,0,2,1,6,0,0,FW,25-29,Forward,Chad,Africa
1941,Eddie Nketiah,ENG,Arsenal,Premier League,2021,22.0,1999.0,9.3,9,4,1,4,4,1,4,25.0,3,9,2,7,4,13,5,0,FW,20-24,Forward,England,Europe
1942,Nicolas Nkoulou,CMR,Watford,Premier League,2021,31.0,1990.0,1.9,1,0,0,1,0,0,0,,0,2,1,1,2,3,8,0,DF,30-34,Defender,Cameroon,Africa
1943,Christopher Nkunku,FRA,RB Leipzig,Bundesliga,2021,23.0,1997.0,30.3,23,10,10,11,2,9,35,25.7,26,23,2,21,15,38,15,0,"FW,MF",20-24,Forward,France,Europe
1944,Felix Nmecha,GER,Wolfsburg,Bundesliga,2021,20.0,2000.0,3.6,3,1,1,1,1,0,2,0.0,2,2,0,2,7,10,6,0,"MF,FW",20-24,Midfielder,Germany,Europe
1945,Lukas Nmecha,GER,Wolfsburg,Bundesliga,2021,22.0,1998.0,18.1,12,5,5,5,2,5,19,26.3,14,9,1,8,4,16,10,0,"FW,MF",20-24,Forward,Germany,Europe
1946,Mark Noble,ENG,West Ham,Premier League,2021,34.0,1987.0,3.7,8,2,7,1,0,5,11,45.5,6,4,1,3,4,12,2,1,MF,30-34,Midfielder,England,Europe
1949,Arnaud Nordin,FRA,Saint-Étienne,Ligue 1,2021,23.0,1998.0,20.8,21,11,8,8,5,8,22,36.4,14,19,0,19,6,27,8,0,"FW,MF",20-24,Forward,France,Europe
1952,Connor Noß,IRL,Gladbach,Bundesliga,2021,20.0,2001.0,0.6,1,0,0,1,0,0,1,0.0,1,1,1,0,0,1,0,0,MF,20-24,Midfielder,Republic of Ireland,Europe
1954,Soma Novothny,HUN,Bochum,Bundesliga,2021,27.0,1994.0,0.9,1,1,1,0,0,0,1,0.0,1,1,0,1,0,1,2,0,"FW,MF",25-29,Forward,Hungary,Europe
1955,Jean-Pierre Nsame,CMR,Venezia,Serie A,2021,28.0,1993.0,2.7,1,1,0,0,1,0,0,,0,0,0,0,0,1,1,0,FW,25-29,Forward,Cameroon,Africa
1956,Randy Nteka,ANG,Rayo Vallecano,La Liga,2021,23.0,1997.0,16.2,24,13,9,11,4,8,19,42.1,11,21,1,20,8,32,12,0,"FW,MF",20-24,Forward,Angola,Africa
1957,Alexander Nübel,GER,Monaco,Ligue 1,2021,24.0,1996.0,38.0,0,0,0,0,0,0,1,0.0,1,0,0,0,0,0,11,1,GK,20-24,Goalkeeper,Germany,Europe
1958,Kasim Nuhu,GHA,Hoffenheim,Bundesliga,2021,26.0,1995.0,0.1,0,0,0,0,0,0,1,0.0,1,0,0,0,0,0,1,0,DF,25-29,Defender,Ghana,Africa
1960,Hans Nunoo Sarpei,GHA,Greuther Fürth,Bundesliga,2021,22.0,1998.0,7.1,16,11,9,7,0,10,14,71.4,4,8,5,3,14,30,21,0,"DF,MF",20-24,Defender,Ghana,Africa
1961,Bram Nuytinck,NED,Udinese,Serie A,2021,31.0,1990.0,22.6,38,24,24,13,1,15,34,44.1,19,42,31,11,22,60,101,0,DF,30-34,Defender,Netherlands,Europe
1962,Simeon Nwankwo,NGA,Salernitana,Serie A,2021,29.0,1992.0,9.4,5,5,0,4,1,4,10,40.0,6,8,3,5,3,8,10,0,FW,25-29,Forward,Nigeria,Africa
1963,Gerzino Nyamsi,FRA,Strasbourg,Ligue 1,2021,24.0,1997.0,33.2,35,21,24,9,2,20,27,74.1,7,25,16,9,25,60,90,1,DF,20-24,Defender,France,Europe
1964,Allan Nyom,CMR,Getafe,La Liga,2021,33.0,1988.0,2.7,3,1,2,1,0,2,2,100.0,0,2,1,1,2,5,7,0,DF,30-34,Defender,Cameroon,Africa
1965,M'Bala Nzola,ANG,Spezia,Serie A,2021,24.0,1996.0,11.9,2,2,0,0,2,1,6,16.7,5,8,0,8,0,2,13,0,FW,20-24,Forward,Angola,Africa
1966,Christian Nørgaard,DEN,Brentford,Premier League,2021,27.0,1994.0,33.9,109,60,42,58,9,52,101,51.5,49,48,9,39,64,173,58,1,MF,25-29,Midfielder,Denmark,Europe
1967,Adam Obert,SVK,Cagliari,Serie A,2021,18.0,2002.0,3.0,8,5,6,2,0,5,6,83.3,1,6,4,2,4,12,11,0,"DF,MF",Under 20,Defender,Slovakia,Europe
1968,Joel Obi,NGA,Salernitana,Serie A,2021,30.0,1991.0,12.7,23,14,5,14,4,5,12,41.7,7,17,6,11,10,33,7,0,"MF,DF",30-34,Midfielder,Nigeria,Africa
1970,Lucas Ocampos,ARG,Sevilla,La Liga,2021,27.0,1994.0,23.6,45,24,23,18,4,23,55,41.8,32,35,1,34,9,54,24,1,FW,25-29,Forward,Argentina,South America
1971,Bastian Oczipka,GER,Union Berlin,Bundesliga,2021,32.0,1989.0,10.4,24,15,15,7,2,10,13,76.9,3,10,2,8,12,36,21,0,DF,30-34,Defender,Germany,Europe
1972,Brian Oddei,ITA,Sassuolo,Serie A,2021,18.0,2002.0,0.1,0,0,0,0,0,0,0,,0,0,0,0,0,0,0,0,FW,Under 20,Forward,Italy,Europe
1974,Angelo Ogbonna,ITA,West Ham,Premier League,2021,33.0,1988.0,10.2,7,4,5,2,0,3,7,42.9,4,5,4,1,11,18,29,0,DF,30-34,Defender,Italy,Europe
1975,Florent Ogier,FRA,Clermont Foot,Ligue 1,2021,32.0,1989.0,27.0,31,17,18,12,1,17,31,54.8,14,41,27,14,37,68,89,0,DF,30-34,Defender,France,Europe
1976,Stefano Okaka,ITA,Udinese,Serie A,2021,31.0,1989.0,0.2,0,0,0,0,0,0,0,,0,2,0,2,0,0,1,0,FW,30-34,Forward,Italy,Europe
1977,David Okereke,NGA,Venezia,Serie A,2021,23.0,1997.0,22.8,16,10,4,9,3,3,20,15.0,17,19,3,16,10,26,20,0,"FW,MF",20-24,Forward,Nigeria,Africa
1978,Masaya Okugawa,JPN,Arminia,Bundesliga,2021,25.0,1996.0,28.1,46,25,18,22,6,12,37,32.4,25,29,1,28,20,66,13,0,"MF,FW",25-29,Midfielder,Japan,Asia
1979,Lucas Olaza,URU,Elche,La Liga,2021,27.0,1994.0,3.3,5,3,3,1,1,1,1,100.0,0,5,1,4,4,9,6,0,DF,25-29,Defender,Uruguay,South America
1981,Mathias Olesen,LUX,Köln,Bundesliga,2021,20.0,2001.0,0.2,0,0,0,0,0,0,0,,0,0,0,0,1,1,0,0,"MF,FW",20-24,Midfielder,Luxembourg,Europe
1982,Michael Olise,FRA,Crystal Palace,Premier League,2021,19.0,2001.0,12.7,22,18,8,11,3,7,24,29.2,17,17,0,17,6,28,6,0,"FW,MF",Under 20,Forward,France,Europe
1983,Christian Oliva,URU,Cagliari,Serie A,2021,25.0,1996.0,0.5,2,2,2,0,0,1,4,25.0,3,0,0,0,0,2,0,0,MF,25-29,Midfielder,Uruguay,South America
1985,Sérgio Oliveira,POR,Roma,Serie A,2021,29.0,1992.0,9.9,27,14,11,14,2,15,30,50.0,15,13,0,13,10,37,7,0,MF,25-29,Midfielder,Portugal,Europe
1986,Mathías Olivera,URU,Getafe,La Liga,2021,23.0,1997.0,31.1,79,47,39,34,6,40,69,58.0,29,45,4,41,55,134,67,1,DF,20-24,Defender,Uruguay,South America
1988,Robin Olsen,SWE,Aston Villa,Premier League,2021,31.0,1990.0,1.0,0,0,0,0,0,0,0,,0,0,0,0,0,0,0,0,GK,30-34,Goalkeeper,Sweden,Europe
1990,Jonas Omlin,SUI,Montpellier,Ligue 1,2021,27.0,1994.0,28.7,2,1,2,0,0,2,3,66.7,1,0,0,0,0,2,12,3,GK,25-29,Goalkeeper,Switzerland,Europe
1991,Andrew Omobamidele,IRL,Norwich City,Premier League,2021,19.0,2002.0,4.2,8,6,5,3,0,5,11,45.5,6,8,8,0,5,13,13,0,DF,Under 20,Defender,Republic of Ireland,Europe
1992,Amadou Onana,BEL,Lille,Ligue 1,2021,19.0,2001.0,15.1,48,31,17,27,4,18,25,72.0,7,10,3,7,30,78,19,0,MF,Under 20,Midfielder,Belgium,Europe
1993,Jean Onana,CMR,Bordeaux,Ligue 1,2021,21.0,2000.0,20.4,70,49,33,33,4,35,86,40.7,51,37,5,32,36,106,23,1,MF,20-24,Midfielder,Cameroon,Africa
1994,Karim Onisiwo,AUT,Mainz 05,Bundesliga,2021,29.0,1992.0,26.2,18,10,4,6,8,7,22,31.8,15,27,2,25,7,25,8,0,FW,25-29,Forward,Austria,Europe
1996,Tyler Onyango,ENG,Everton,Premier League,2021,18.0,2003.0,0.3,0,0,0,0,0,0,0,,0,0,0,0,0,0,1,0,MF,Under 20,Midfielder,England,Europe
1997,Frank Onyeka,NGA,Brentford,Premier League,2021,23.0,1998.0,11.6,25,17,13,9,3,8,27,29.6,19,16,2,14,14,39,13,0,MF,20-24,Midfielder,Nigeria,Africa
1998,Willi Orban,HUN,RB Leipzig,Bundesliga,2021,28.0,1992.0,29.4,32,22,20,11,1,13,25,52.0,12,40,24,16,44,76,123,2,DF,25-29,Defender,Hungary,Europe
1999,Divock Origi,BEL,Liverpool,Premier League,2021,26.0,1995.0,1.5,0,0,0,0,0,0,2,0.0,2,1,0,1,1,1,2,0,FW,25-29,Forward,Belgium,Europe
2000,Riccardo Orsolini,ITA,Bologna,Serie A,2021,24.0,1997.0,19.8,21,13,9,11,1,13,29,44.8,16,9,4,5,5,26,14,0,"FW,MF",20-24,Forward,Italy,Europe
2001,Stefan Ortega,GER,Arminia,Bundesliga,2021,28.0,1992.0,33.0,1,0,1,0,0,1,2,50.0,1,2,0,2,0,1,5,1,GK,25-29,Goalkeeper,Germany,Europe
2003,Victor Osimhen,NGA,Napoli,Serie A,2021,22.0,1998.0,22.0,10,5,1,2,7,2,6,33.3,4,16,3,13,3,13,17,0,FW,20-24,Forward,Nigeria,Africa
2004,Milutin Osmajić,MNE,Cádiz,La Liga,2021,22.0,1999.0,2.9,1,1,0,1,0,0,0,,0,0,0,0,1,2,3,0,"FW,MF",20-24,Forward,Montenegro,Europe
2005,David Ospina,COL,Napoli,Serie A,2021,32.0,1988.0,31.0,0,0,0,0,0,0,0,,0,0,0,0,1,1,11,1,GK,30-34,Goalkeeper,Colombia,South America
2006,Patrick Osterhage,GER,Bochum,Bundesliga,2021,21.0,2000.0,6.7,9,6,3,5,1,3,7,42.9,4,7,1,6,11,20,8,0,MF,20-24,Midfielder,Germany,Europe
2008,Otávio,BRA,Bordeaux,Ligue 1,2021,27.0,1994.0,12.7,36,23,13,21,2,16,39,41.0,23,9,3,6,18,54,11,0,MF,25-29,Midfielder,Brazil,South America
2008,Otávio,BRA,Bordeaux,Ligue 1,2021,27.0,1994.0,12.7,36,23,13,21,2,16,39,41.0,23,9,3,6,18,54,11,0,MF,25-29,Midfielder,Brazil,South America
2008,Otávio,BRA,Bordeaux,Ligue 1,2021,27.0,1994.0,12.7,36,23,13,21,2,16,39,41.0,23,9,3,6,18,54,11,0,MF,25-29,Midfielder,Brazil,South America
2008,Otávio,BRA,Bordeaux,Ligue 1,2021,27.0,1994.0,12.7,36,23,13,21,2,16,39,41.0,23,9,3,6,18,54,11,0,MF,25-29,Midfielder,Brazil,South America
2008,Otávio,BRA,Bordeaux,Ligue 1,2021,27.0,1994.0,12.7,36,23,13,21,2,16,39,41.0,23,9,3,6,18,54,11,0,MF,25-29,Midfielder,Brazil,South America
2008,Otávio,BRA,Bordeaux,Ligue 1,2021,27.0,1994.0,12.7,36,23,13,21,2,16,39,41.0,23,9,3,6,18,54,11,0,MF,25-29,Midfielder,Brazil,South America
2008,Otávio,BRA,Bordeaux,Ligue 1,2021,27.0,1994.0,12.7,36,23,13,21,2,16,39,41.0,23,9,3,6,18,54,11,0,MF,25-29,Midfielder,Brazil,South America
2008,Otávio,BRA,Bordeaux,Ligue 1,2021,27.0,1994.0,12.7,36,23,13,21,2,16,39,41.0,23,9,3,6,18,54,11,0,MF,25-29,Midfielder,Brazil,South America
2008,Otávio,BRA,Bordeaux,Ligue 1,2021,27.0,1994.0,12.7,36,23,13,21,2,16,39,41.0,23,9,3,6,18,54,11,0,MF,25-29,Midfielder,Brazil,South America
2009,Paulo Otávio,BRA,Wolfsburg,Bundesliga,2021,26.0,1994.0,4.0,14,10,7,4,3,8,15,53.3,7,11,6,5,4,18,9,0,"DF,MF",25-29,Defender,Brazil,South America
2010,Dango Ouattara,BFA,Lorient,Ligue 1,2021,19.0,2002.0,9.0,21,15,9,11,1,11,23,47.8,12,10,1,9,14,35,15,1,"MF,FW",Under 20,Midfielder,Burkina Faso,Africa
2011,Remi Oudin,FRA,Bordeaux,Ligue 1,2021,24.0,1996.0,19.3,34,18,19,13,2,18,32,56.3,14,14,3,11,27,61,21,0,"MF,FW",20-24,Midfielder,France,Europe
2012,Alexandre Oukidja,ALG,Metz,Ligue 1,2021,33.0,1988.0,20.8,0,0,0,0,0,0,1,0.0,1,1,0,1,1,1,17,2,GK,30-34,Goalkeeper,Algeria,Africa
2013,Azzedine Ounahi,MAR,Angers,Ligue 1,2021,21.0,2000.0,18.1,39,22,16,22,1,11,40,27.5,29,19,1,18,26,65,13,0,MF,20-24,Midfielder,Morocco,Africa
2014,Adam Ounas,ALG,Napoli,Serie A,2021,24.0,1996.0,3.6,6,1,0,3,3,3,7,42.9,4,3,0,3,2,8,3,0,"MF,FW",20-24,Midfielder,Algeria,Africa
2015,Jesús Owono,EQG,Alavés,La Liga,2021,20.0,2001.0,1.0,0,0,0,0,0,0,0,,0,0,0,0,0,0,1,0,GK,20-24,Goalkeeper,Equatorial Guinea,Africa
2016,Reece Oxford,ENG,Augsburg,Bundesliga,2021,22.0,1998.0,29.9,27,14,16,9,2,15,31,48.4,16,42,33,9,72,99,172,1,DF,20-24,Defender,England,Europe
2017,Alex Oxlade-Chamberlain,ENG,Liverpool,Premier League,2021,27.0,1993.0,8.7,15,11,2,8,5,3,14,21.4,11,12,2,10,6,21,5,0,"MF,FW",25-29,Midfielder,England,Europe
2019,Ambroise Oyongo,CMR,Montpellier,Ligue 1,2021,30.0,1991.0,7.3,13,4,7,4,2,9,15,60.0,6,5,1,4,6,19,17,0,DF,30-34,Defender,Cameroon,Africa
2020,Salih Özcan,TUR,Köln,Bundesliga,2021,23.0,1998.0,25.7,42,30,14,23,5,22,51,43.1,29,37,5,32,51,93,35,1,MF,20-24,Midfielder,Turkey,Asia
2021,Levin Öztunalı,GER,Union Berlin,Bundesliga,2021,25.0,1996.0,6.4,14,11,6,5,3,7,17,41.2,10,3,0,3,4,18,12,0,MF,25-29,Midfielder,Germany,Europe
2024,Gonçalo Paciência,POR,Eint Frankfurt,Bundesliga,2021,26.0,1994.0,5.7,4,2,2,1,1,1,3,33.3,2,2,0,2,1,5,4,0,FW,25-29,Forward,Portugal,Europe
2025,Daniele Padelli,ITA,Udinese,Serie A,2021,35.0,1985.0,3.0,0,0,0,0,0,0,0,,0,0,0,0,0,0,2,1,GK,35-39,Goalkeeper,Italy,Europe
2026,Simone Pafundi,ITA,Udinese,Serie A,2021,15.0,2006.0,0.3,0,0,0,0,0,0,1,0.0,1,0,0,0,0,0,0,0,FW,Under 20,Forward,Italy,Europe
2027,Vincent Pajot,FRA,Metz,Ligue 1,2021,30.0,1990.0,25.7,86,56,35,47,4,20,46,43.5,26,33,6,27,51,137,38,0,MF,30-34,Midfielder,France,Europe
2028,Exequiel Palacios,ARG,Leverkusen,Bundesliga,2021,22.0,1998.0,12.2,30,19,12,14,4,15,38,39.5,23,20,1,19,28,58,11,2,MF,20-24,Midfielder,Argentina,South America
2029,Helibelton Palacios,COL,Elche,La Liga,2021,28.0,1993.0,21.5,69,38,56,10,3,37,55,67.3,18,21,8,13,18,87,61,0,DF,25-29,Defender,Colombia,South America
2031,Nicolas Pallois,FRA,Nantes,Ligue 1,2021,33.0,1987.0,27.2,51,33,40,11,0,34,59,57.6,25,40,19,21,53,104,116,1,DF,30-34,Defender,France,Europe
2032,Cole Palmer,ENG,Manchester City,Premier League,2021,19.0,2002.0,1.4,2,1,1,1,0,0,2,0.0,2,3,0,3,1,3,0,0,"FW,MF",Under 20,Forward,England,Europe
2033,Erik Palmer-Brown,USA,Troyes,Ligue 1,2021,24.0,1997.0,19.3,37,22,29,8,0,20,26,76.9,6,26,18,8,34,71,87,1,DF,20-24,Defender,United States,North America
2034,Emerson Palmieri,ITA,Chelsea,Premier League,2021,26.0,1994.0,0.1,0,0,0,0,0,0,0,,0,0,0,0,0,0,0,0,DF,25-29,Defender,Italy,Europe
2035,Emerson Palmieri,ITA,Lyon,Ligue 1,2021,26.0,1994.0,25.2,46,25,16,22,8,22,34,64.7,12,23,8,15,27,73,66,0,DF,25-29,Defender,Italy,Europe
2037,Goran Pandev,MKD,Genoa,Serie A,2021,38.0,1983.0,9.4,2,0,1,0,1,0,9,0.0,9,3,1,2,2,4,0,0,"FW,MF",35-39,Forward,North Macedonia,Europe
2038,Ivor Pandur,CRO,Hellas Verona,Serie A,2021,21.0,2000.0,3.0,0,0,0,0,0,0,0,,0,0,0,0,0,0,2,0,GK,20-24,Goalkeeper,Croatia,Europe
2040,Antonios Papadopoulos,GER,Dortmund,Bundesliga,2021,21.0,1999.0,0.2,0,0,0,0,0,0,0,,0,1,0,1,0,0,0,0,"DF,MF",20-24,Defender,Germany,Europe
2041,Merveille Papela,GER,Mainz 05,Bundesliga,2021,20.0,2001.0,0.9,3,2,2,1,0,2,3,66.7,1,2,0,2,2,5,0,0,MF,20-24,Midfielder,Germany,Europe
2042,Lucas Paquetá,BRA,Lyon,Ligue 1,2021,23.0,1997.0,30.0,68,38,24,26,18,17,51,33.3,34,43,5,38,9,77,22,0,"MF,FW",20-24,Midfielder,Brazil,South America
2044,Kevin Paredes,USA,Wolfsburg,Bundesliga,2021,18.0,2003.0,0.2,1,0,0,0,1,0,0,,0,1,0,1,0,1,0,0,"FW,DF",Under 20,Forward,United States,North America
2045,Leandro Paredes,ARG,Paris S-G,Ligue 1,2021,27.0,1994.0,9.3,23,13,9,11,3,12,24,50.0,12,10,6,4,10,33,5,2,MF,25-29,Midfielder,Argentina,South America
2047,Fabiano Parisi,ITA,Empoli,Serie A,2021,20.0,2000.0,16.4,35,19,25,5,5,13,31,41.9,18,30,10,20,22,57,42,0,DF,20-24,Defender,Italy,Europe
22,Martin Agirregabiria,ESP,Alavés,La Liga,2021,25.0,1996.0,18.0,34,22,17,11,6,18,37,48.6,19,20,3,17,25,59,38,0,DF,25-29,Defender,Spain,Europe
23,Julen Agirrezabala,ESP,Athletic Club,La Liga,2021,20.0,2000.0,4.0,0,0,0,0,0,0,0,,0,0,0,0,0,0,2,0,GK,20-24,Goalkeeper,Spain,Europe
29,Álvaro Aguirre,ESP,Rayo Vallecano,La Liga,2021,21.0,2000.0,0.1,0,0,0,0,0,0,0,,0,0,0,0,0,0,0,0,FW,20-24,Forward,Spain,Europe
36,Kristoffer Ajer,NOR,Brentford,Premier League,2021,23.0,1998.0,22.2,29,18,21,6,2,13,21,61.9,8,19,11,8,26,55,74,0,DF,20-24,Defender,Norway,Europe
51,Jordi Alba,ESP,Barcelona,La Liga,2021,32.0,1989.0,29.4,47,34,12,26,9,27,47,57.4,20,26,6,20,33,80,41,1,DF,30-34,Defender,Spain,Europe
53,Luis Alberto,ESP,Lazio,Serie A,2021,28.0,1992.0,26.1,29,17,8,11,10,8,52,15.4,44,32,4,28,13,42,7,0,MF,25-29,Midfielder,Spain,Europe
54,Raúl Albiol,ESP,Villarreal,La Liga,2021,35.0,1985.0,27.4,26,15,20,5,1,14,18,77.8,4,24,15,9,21,47,126,1,DF,35-39,Defender,Spain,Europe
56,Paco Alcácer,ESP,Villarreal,La Liga,2021,27.0,1993.0,8.7,9,3,2,4,3,1,5,20.0,4,7,0,7,6,15,1,0,FW,25-29,Forward,Spain,Europe
57,Thiago Alcántara,ESP,Liverpool,Premier League,2021,30.0,1991.0,17.0,48,29,14,24,10,10,42,23.8,32,22,2,20,26,74,13,2,MF,30-34,Midfielder,Spain,Europe
58,Rubén Alcaraz,ESP,Cádiz,La Liga,2021,30.0,1991.0,12.3,41,20,14,24,3,22,45,48.9,23,10,2,8,13,54,14,0,MF,30-34,Midfielder,Spain,Europe
60,Iván Alejo,ESP,Cádiz,La Liga,2021,26.0,1995.0,11.8,33,15,21,10,2,15,44,34.1,29,12,0,12,8,41,17,0,"MF,FW",25-29,Midfielder,Spain,Europe
62,Carles Aleñá,ESP,Getafe,La Liga,2021,23.0,1998.0,25.8,27,19,11,13,3,9,48,18.8,39,21,2,19,15,42,16,0,MF,20-24,Midfielder,Spain,Europe
71,Marcos Alonso,ESP,Chelsea,Premier League,2021,30.0,1990.0,24.1,41,29,20,12,9,17,36,47.2,19,29,5,24,43,84,53,0,DF,30-34,Defender,Spain,Europe
73,Hugo Álvarez,ESP,Celta Vigo,La Liga,2021,18.0,2003.0,0.1,1,0,1,0,0,0,0,,0,0,0,0,0,1,1,0,FW,Under 20,Forward,Spain,Europe
74,Yeray Álvarez,ESP,Athletic Club,La Liga,2021,26.0,1995.0,20.7,24,14,15,8,1,10,18,55.6,8,21,16,5,45,69,97,0,DF,25-29,Defender,Spain,Europe
95,Fredrik André Bjørkan,NOR,Hertha BSC,Bundesliga,2021,22.0,1998.0,3.9,12,10,7,4,1,7,9,77.8,2,6,2,4,6,18,8,0,DF,20-24,Defender,Norway,Europe
98,José Ángel,ESP,Osasuna,La Liga,2021,31.0,1989.0,12.0,20,13,9,9,2,9,14,64.3,5,6,1,5,10,30,21,0,DF,30-34,Defender,Spain,Europe
99,Angeliño,ESP,RB Leipzig,Bundesliga,2021,24.0,1997.0,25.5,28,21,14,13,1,14,30,46.7,16,24,3,21,29,57,40,0,DF,20-24,Defender,Spain,Europe
104,Josep Antoni Gayá,ESP,Mallorca,La Liga,2021,21.0,2000.0,0.6,0,0,0,0,0,0,0,,0,1,0,1,1,1,3,1,DF,20-24,Defender,Spain,Europe
117,Jesús Areso,ESP,Osasuna,La Liga,2021,22.0,1999.0,2.1,3,3,2,1,0,0,2,0.0,2,0,0,0,0,3,2,1,DF,20-24,Defender,Spain,Europe
124,Kepa Arrizabalaga,ESP,Chelsea,Premier League,2021,26.0,1994.0,4.0,0,0,0,0,0,0,0,,0,0,0,0,0,0,4,0,GK,25-29,Goalkeeper,Spain,Europe
129,Sergio Asenjo,ESP,Villarreal,La Liga,2021,32.0,1989.0,6.0,0,0,0,0,0,0,1,0.0,1,0,0,0,1,1,6,0,GK,30-34,Goalkeeper,Spain,Europe
130,Alejandro Asensio,ESP,Rayo Vallecano,La Liga,2021,20.0,2000.0,0.1,0,0,0,0,0,0,0,,0,0,0,0,0,0,0,0,FW,20-24,Forward,Spain,Europe
131,Marco Asensio,ESP,Real Madrid,La Liga,2021,25.0,1996.0,19.2,12,8,6,4,2,4,18,22.2,14,8,1,7,12,24,6,1,"FW,MF",25-29,Forward,Spain,Europe
133,Kristoffer Askildsen,NOR,Sampdoria,Serie A,2021,20.0,2001.0,8.4,18,6,7,11,0,9,19,47.4,10,14,7,7,15,33,15,0,MF,20-24,Midfielder,Norway,Europe
136,Iago Aspas,ESP,Celta Vigo,La Liga,2021,33.0,1987.0,34.3,14,7,1,5,8,4,24,16.7,20,23,2,21,11,25,19,0,FW,30-34,Forward,Spain,Europe
137,Lorenz Assignon,TOG,Rennes,Ligue 1,2021,21.0,2000.0,6.8,15,10,11,3,1,5,9,55.6,4,3,1,2,11,26,19,0,DF,20-24,Defender,Togo,Africa
155,César Azpilicueta,ESP,Chelsea,Premier League,2021,31.0,1989.0,23.0,51,28,18,27,6,16,35,45.7,19,32,9,23,23,74,65,1,DF,30-34,Defender,Spain,Europe
161,Édgar Badía,ESP,Elche,La Liga,2021,29.0,1992.0,24.0,0,0,0,0,0,0,0,,0,0,0,0,0,0,16,2,GK,25-29,Goalkeeper,Spain,Europe
164,Miguel Baeza,ESP,Celta Vigo,La Liga,2021,21.0,2000.0,0.0,0,0,0,0,0,0,0,,0,0,0,0,0,0,0,0,DF,20-24,Defender,Spain,Europe
180,Alejandro Balde,ESP,Barcelona,La Liga,2021,17.0,2003.0,2.1,2,1,1,0,1,0,0,,0,2,2,0,1,3,1,0,"DF,FW",Under 20,Defender,Spain,Europe
184,Mikel Balenziaga,ESP,Athletic Club,La Liga,2021,33.0,1988.0,22.5,33,24,15,15,3,25,43,58.1,18,27,4,23,21,54,79,0,DF,30-34,Defender,Spain,Europe
196,Antonín Barák,CZE,Hellas Verona,Serie A,2021,26.0,1994.0,26.0,18,8,9,8,1,5,17,29.4,12,32,5,27,6,24,26,0,"MF,FW",25-29,Midfielder,Czech Republic,Europe
197,Barbero,ESP,Osasuna,La Liga,2021,22.0,1998.0,0.2,0,0,0,0,0,0,0,,0,0,0,0,0,0,1,0,"FW,MF",20-24,Forward,Spain,Europe
199,Barcia,ESP,Granada,La Liga,2021,20.0,2000.0,0.8,0,0,0,0,0,0,0,,0,1,1,0,1,1,0,1,DF,20-24,Defender,Spain,Europe
206,Kike Barja,ESP,Osasuna,La Liga,2021,24.0,1997.0,9.6,15,11,4,7,4,8,22,36.4,14,10,1,9,9,24,4,0,"MF,FW",20-24,Midfielder,Spain,Europe
211,Antonio Barragán,ESP,Elche,La Liga,2021,34.0,1987.0,11.3,21,14,13,7,1,11,17,64.7,6,5,3,2,17,38,34,0,DF,30-34,Defender,Spain,Europe
213,Ander Barrenetxea,ESP,Real Sociedad,La Liga,2021,19.0,2001.0,6.1,15,10,9,6,0,8,18,44.4,10,7,0,7,2,17,2,0,"FW,MF",Under 20,Forward,Spain,Europe
217,Marc Bartra,ESP,Betis,La Liga,2021,30.0,1991.0,22.1,39,14,18,17,4,19,35,54.3,16,39,22,17,33,72,105,1,DF,30-34,Defender,Spain,Europe
223,Álvaro Bastida,ESP,Cádiz,La Liga,2021,17.0,2004.0,2.2,7,4,2,4,1,4,5,80.0,1,1,0,1,3,10,1,0,MF,Under 20,Midfielder,Spain,Europe
233,Jon Bautista,ESP,Real Sociedad,La Liga,2021,26.0,1995.0,0.5,3,0,0,3,0,0,1,0.0,1,1,0,1,1,4,1,0,MF,25-29,Midfielder,Spain,Europe
237,Ihlas Bebou,TOG,Hoffenheim,Bundesliga,2021,27.0,1994.0,23.2,22,14,5,12,5,7,21,33.3,14,20,3,17,12,34,25,0,"FW,DF",25-29,Forward,Togo,Africa
241,Jan Bednarek,POL,Southampton,Premier League,2021,25.0,1996.0,29.2,32,15,18,13,1,19,33,57.6,14,48,27,21,72,104,141,0,DF,25-29,Defender,Poland,Europe
248,Vid Belec,SVN,Salernitana,Serie A,2021,31.0,1990.0,21.5,0,0,0,0,0,0,0,,0,0,0,0,0,0,9,1,GK,30-34,Goalkeeper,Slovenia,Europe
256,Héctor Bellerín,ESP,Betis,La Liga,2021,26.0,1995.0,22.0,52,32,29,20,3,31,44,70.5,13,11,2,9,23,75,57,1,DF,25-29,Defender,Spain,Europe
261,Fran Beltrán,ESP,Celta Vigo,La Liga,2021,22.0,1999.0,28.9,56,41,27,23,6,28,68,41.2,40,29,5,24,32,88,39,0,MF,20-24,Midfielder,Spain,Europe
271,Iker Benito,ESP,Osasuna,La Liga,2021,18.0,2002.0,1.3,2,1,1,0,1,0,1,0.0,1,2,0,2,0,2,2,0,"FW,MF",Under 20,Forward,Spain,Europe
273,Pedro Benito,ESP,Cádiz,La Liga,2021,21.0,2000.0,0.3,0,0,0,0,0,0,1,0.0,1,0,0,0,0,0,0,0,FW,20-24,Forward,Spain,Europe
286,Yuri Berchiche,ESP,Athletic Club,La Liga,2021,31.0,1990.0,11.3,25,11,10,11,4,7,14,50.0,7,19,6,13,13,38,25,0,DF,30-34,Defender,Spain,Europe
287,Álex Berenguer,ESP,Athletic Club,La Liga,2021,26.0,1995.0,24.1,45,26,23,14,8,11,51,21.6,40,40,2,38,16,61,20,0,MF,25-29,Midfielder,Spain,Europe
288,Bartosz Bereszyński,POL,Sampdoria,Serie A,2021,29.0,1992.0,32.7,64,38,34,25,5,37,80,46.3,43,38,12,26,42,106,73,1,DF,25-29,Defender,Poland,Europe
290,Patrick Berg,NOR,Lens,Ligue 1,2021,23.0,1997.0,3.4,14,6,6,8,0,0,4,0.0,4,2,1,1,4,18,3,0,MF,20-24,Midfielder,Norway,Europe
298,Juan Bernat,ESP,Paris S-G,Ligue 1,2021,28.0,1993.0,10.6,24,14,10,10,4,13,18,72.2,5,8,0,8,8,32,16,0,"DF,MF",25-29,Defender,Spain,Europe
307,Bartosz Białek,POL,Wolfsburg,Bundesliga,2021,19.0,2001.0,2.0,0,0,0,0,0,0,1,0.0,1,1,0,1,0,0,2,0,"FW,DF",Under 20,Forward,Poland,Europe
310,Pedro Bigas,ESP,Elche,La Liga,2021,30.0,1990.0,17.2,24,10,16,8,0,9,20,45.0,11,21,16,5,18,42,77,1,DF,30-34,Defender,Spain,Europe
321,Antonio Blanco,ESP,Real Madrid,La Liga,2021,21.0,2000.0,0.3,2,0,1,1,0,0,0,,0,1,1,0,1,3,0,0,MF,20-24,Midfielder,Spain,Europe
333,Emil Bohinen,NOR,Salernitana,Serie A,2021,22.0,1999.0,7.8,15,9,4,9,2,10,20,50.0,10,17,3,14,12,27,14,0,MF,20-24,Midfielder,Norway,Europe
352,Ismaël Boura,COM,Lens,Ligue 1,2021,20.0,2000.0,1.1,2,2,1,1,0,0,0,,0,1,1,0,2,4,5,0,DF,20-24,Defender,Comoros,Africa
366,Darko Brašanac,SRB,Osasuna,La Liga,2021,29.0,1992.0,26.7,35,22,19,14,2,14,40,35.0,26,25,8,17,25,60,15,0,MF,25-29,Midfielder,Serbia,Europe
369,Iker Bravo,ESP,Leverkusen,Bundesliga,2021,16.0,2005.0,0.1,1,1,0,1,0,0,0,,0,0,0,0,0,1,0,0,FW,Under 20,Forward,Spain,Europe
389,Aleksander Buksa,POL,Genoa,Serie A,2021,18.0,2003.0,0.7,0,0,0,0,0,0,1,0.0,1,0,0,0,0,0,1,0,FW,Under 20,Forward,Poland,Europe
399,Oriol Busquets,ESP,Clermont Foot,Ligue 1,2021,22.0,1999.0,2.2,3,3,0,3,0,2,6,33.3,4,7,4,3,1,4,2,0,MF,20-24,Midfielder,Spain,Europe
400,Sergio Busquets,ESP,Barcelona,La Liga,2021,33.0,1988.0,35.5,93,49,31,48,14,46,83,55.4,37,44,8,36,45,138,31,0,MF,30-34,Midfielder,Spain,Europe
402,Adrián Butzke,ESP,Granada,La Liga,2021,22.0,1999.0,0.0,0,0,0,0,0,0,0,,0,0,0,0,0,0,0,0,FW,20-24,Forward,Spain,Europe
403,Marcin Bułka,POL,Nice,Ligue 1,2021,21.0,1999.0,1.0,0,0,0,0,0,0,0,,0,0,0,0,0,0,0,0,GK,20-24,Goalkeeper,Poland,Europe
423,Cala,ESP,Cádiz,La Liga,2021,31.0,1989.0,10.5,9,4,9,0,0,8,17,47.1,9,12,6,6,12,21,56,0,DF,30-34,Defender,Spain,Europe
428,Calderón,ESP,Betis,La Liga,2021,21.0,2000.0,0.7,2,0,1,0,1,1,3,33.3,2,0,0,0,0,2,2,0,DF,20-24,Defender,Spain,Europe
429,Fernando Calero,ESP,Espanyol,La Liga,2021,25.0,1995.0,12.1,17,10,12,5,0,8,13,61.5,5,7,2,5,16,33,63,1,DF,25-29,Defender,Spain,Europe
433,José Callejón,ESP,Fiorentina,Serie A,2021,34.0,1987.0,14.4,15,6,6,6,3,13,31,41.9,18,6,0,6,3,18,1,1,FW,30-34,Forward,Spain,Europe
438,Víctor Camarasa,ESP,Betis,La Liga,2021,27.0,1994.0,1.2,2,1,1,1,0,0,1,0.0,1,2,1,1,2,4,2,0,"MF,FW",25-29,Midfielder,Spain,Europe
442,José Campaña,ESP,Levante,La Liga,2021,28.0,1993.0,15.8,27,16,13,10,4,12,32,37.5,20,13,2,11,21,48,19,1,MF,25-29,Midfielder,Spain,Europe
445,Sergio Canales,ESP,Betis,La Liga,2021,30.0,1991.0,31.0,24,14,8,12,4,10,35,28.6,25,16,1,15,10,34,12,0,"FW,MF",30-34,Forward,Spain,Europe
450,Sergi Canós,ESP,Brentford,Premier League,2021,24.0,1997.0,23.1,56,25,32,15,9,33,60,55.0,27,32,3,29,22,78,38,0,"DF,FW",20-24,Defender,Spain,Europe
451,Álex Cantero,ESP,Levante,La Liga,2021,21.0,2000.0,6.8,6,4,2,3,1,1,8,12.5,7,2,0,2,1,7,0,0,"FW,MF",20-24,Forward,Spain,Europe
453,Ander Capa,ESP,Athletic Club,La Liga,2021,29.0,1992.0,0.0,0,0,0,0,0,0,0,,0,0,0,0,0,0,0,0,DF,25-29,Defender,Spain,Europe
462,Isaac Carcelen,ESP,Cádiz,La Liga,2021,28.0,1993.0,17.2,43,29,29,12,2,28,56,50.0,28,25,6,19,34,77,42,0,"DF,MF",25-29,Defender,Spain,Europe
463,Cárdenas,ESP,Levante,La Liga,2021,24.0,1997.0,24.0,1,1,1,0,0,0,3,0.0,3,0,0,0,1,2,19,0,GK,20-24,Goalkeeper,Spain,Europe
466,Carlo,ESP,Villarreal,La Liga,2021,20.0,2001.0,0.1,0,0,0,0,0,0,0,,0,0,0,0,0,0,0,0,MF,20-24,Midfielder,Spain,Europe
468,Carmona,ESP,Sevilla,La Liga,2021,19.0,2002.0,0.3,0,0,0,0,0,0,0,,0,0,0,0,1,1,0,0,DF,Under 20,Defender,Spain,Europe
471,Dani Carvajal,ESP,Real Madrid,La Liga,2021,29.0,1992.0,17.2,43,28,21,15,7,15,26,57.7,11,22,8,14,20,63,38,2,DF,25-29,Defender,Spain,Europe
475,Matty Cash,POL,Aston Villa,Premier League,2021,23.0,1997.0,37.5,89,50,52,34,3,47,78,60.3,31,54,16,38,49,138,100,2,DF,20-24,Defender,Poland,Europe
476,Kiko Casilla,ESP,Elche,La Liga,2021,34.0,1986.0,14.0,0,0,0,0,0,0,1,0.0,1,0,0,0,1,1,2,2,GK,30-34,Goalkeeper,Spain,Europe
482,Samu Castillejo,ESP,Milan,Serie A,2021,26.0,1995.0,1.4,4,2,0,2,2,1,8,12.5,7,4,1,3,2,6,1,0,"FW,MF",25-29,Forward,Spain,Europe
484,Jonny Castro,ESP,Wolves,Premier League,2021,27.0,1994.0,11.4,25,15,13,11,1,11,20,55.0,9,14,3,11,13,38,11,0,DF,25-29,Defender,Spain,Europe
487,Catena,ESP,Rayo Vallecano,La Liga,2021,26.0,1994.0,36.0,39,23,24,15,0,25,42,59.5,17,26,19,7,30,69,168,3,DF,25-29,Defender,Spain,Europe
488,Craig Cathcart,NIR,Watford,Premier League,2021,32.0,1989.0,26.6,32,15,25,6,1,16,30,53.3,14,39,29,10,28,60,132,3,DF,30-34,Defender,Northern Ireland,Europe
490,Dani Ceballos,ESP,Real Madrid,La Liga,2021,24.0,1996.0,3.1,7,5,4,3,0,1,5,20.0,4,8,2,6,4,11,2,0,MF,20-24,Midfielder,Spain,Europe
493,Emil Ceide,NOR,Sassuolo,Serie A,2021,19.0,2001.0,0.6,1,1,0,1,0,1,2,50.0,1,1,0,1,0,1,0,0,"FW,MF",Under 20,Forward,Norway,Europe
510,Chapela,ESP,Cádiz,La Liga,2021,22.0,1999.0,4.4,4,2,1,0,3,2,4,50.0,2,6,1,5,4,8,5,0,"MF,FW",20-24,Midfielder,Spain,Europe
515,Chema,ESP,Getafe,La Liga,2021,29.0,1992.0,0.5,0,0,0,0,0,0,1,0.0,1,0,0,0,0,0,0,0,MF,25-29,Midfielder,Spain,Europe
524,Pedro Chirivella,ESP,Nantes,Ligue 1,2021,24.0,1997.0,29.3,49,31,14,26,9,25,70,35.7,45,23,2,21,37,86,11,0,MF,20-24,Midfielder,Spain,Europe
531,Víctor Chust,ESP,Cádiz,La Liga,2021,21.0,2000.0,20.3,19,10,14,4,1,11,17,64.7,6,20,8,12,16,35,87,0,DF,20-24,Defender,Spain,Europe
540,Carlos Clerc,ESP,Levante,La Liga,2021,29.0,1992.0,16.8,35,17,21,10,4,7,19,36.8,12,8,3,5,26,61,32,1,DF,25-29,Defender,Spain,Europe
545,Coke,ESP,Levante,La Liga,2021,34.0,1987.0,1.3,3,2,1,1,1,3,4,75.0,1,1,0,1,2,5,7,0,DF,30-34,Defender,Spain,Europe
547,Álex Collado,ESP,Granada,La Liga,2021,22.0,1999.0,11.3,27,12,6,16,5,12,31,38.7,19,28,2,26,6,33,11,0,"MF,FW",20-24,Midfielder,Spain,Europe
553,Santi Comesaña,ESP,Rayo Vallecano,La Liga,2021,24.0,1996.0,29.8,87,56,45,33,9,40,104,38.5,64,46,6,40,33,120,30,0,MF,20-24,Midfielder,Spain,Europe
554,Diego Conde,ESP,Getafe,La Liga,2021,22.0,1998.0,0.1,0,0,0,0,0,0,0,,0,0,0,0,0,0,0,0,GK,20-24,Goalkeeper,Spain,Europe
577,Jaume Costa,ESP,Mallorca,La Liga,2021,33.0,1988.0,20.3,35,26,23,7,5,23,31,74.2,8,22,7,15,23,58,55,0,DF,30-34,Defender,Spain,Europe
579,Vladimír Coufal,CZE,West Ham,Premier League,2021,28.0,1992.0,24.5,45,25,24,14,7,18,36,50.0,18,31,9,22,22,67,64,1,DF,25-29,Defender,Czech Republic,Europe
593,Cristo,ESP,Real Sociedad,La Liga,2021,21.0,2000.0,0.2,0,0,0,0,0,0,0,,0,0,0,0,0,0,0,0,DF,20-24,Defender,Spain,Europe
595,Domen Črnigoj,SVN,Venezia,Serie A,2021,25.0,1995.0,20.9,21,13,7,11,3,11,29,37.9,18,27,8,19,24,45,42,0,MF,25-29,Midfielder,Slovenia,Europe
597,Juan Cruz Armada,ESP,Osasuna,La Liga,2021,29.0,1992.0,21.5,28,21,15,12,1,8,16,50.0,8,15,12,3,16,44,58,1,DF,25-29,Defender,Spain,Europe
600,Marc Cucurella,ESP,Brighton,Premier League,2021,23.0,1998.0,34.3,93,62,43,32,18,44,71,62.0,27,42,14,28,30,123,74,0,DF,20-24,Defender,Spain,Europe
601,Marc Cucurella,ESP,Getafe,La Liga,2021,23.0,1998.0,0.3,0,0,0,0,0,0,0,,0,0,0,0,0,0,0,0,"MF,DF",20-24,Midfielder,Spain,Europe
602,Jorge Cuenca,ESP,Getafe,La Liga,2021,21.0,1999.0,29.8,46,32,30,15,1,21,28,75.0,7,29,14,15,39,85,155,0,DF,20-24,Defender,Spain,Europe
621,Stuart Dallas,NIR,Leeds United,Premier League,2021,30.0,1991.0,32.4,93,55,58,31,4,56,105,53.3,49,45,14,31,57,150,63,2,"DF,MF",30-34,Defender,Northern Ireland,Europe
631,Sergi Darder,ESP,Espanyol,La Liga,2021,27.0,1993.0,34.7,45,22,16,19,10,18,54,33.3,36,16,1,15,26,71,32,1,MF,25-29,Midfielder,Spain,Europe
632,Vladimír Darida,CZE,Hertha BSC,Bundesliga,2021,30.0,1990.0,19.8,32,18,15,13,4,13,32,40.6,19,22,3,19,20,52,17,2,MF,30-34,Midfielder,Czech Republic,Europe
641,Paweł Dawidowicz,POL,Hellas Verona,Serie A,2021,26.0,1995.0,13.3,30,18,16,10,4,16,25,64.0,9,14,11,3,21,51,53,0,DF,25-29,Defender,Poland,Europe
681,Gerard Deulofeu,ESP,Udinese,Serie A,2021,27.0,1994.0,29.1,11,6,2,3,6,7,29,24.1,22,14,0,14,9,20,4,0,"FW,MF",25-29,Forward,Spain,Europe
704,Javier Díaz,ESP,Sevilla,La Liga,2021,24.0,1997.0,1.0,0,0,0,0,0,0,0,,0,0,0,0,0,0,0,0,GK,20-24,Goalkeeper,Spain,Europe
706,Víctor Díaz,ESP,Granada,La Liga,2021,33.0,1988.0,16.7,23,15,14,9,0,12,25,48.0,13,19,11,8,17,40,71,1,DF,30-34,Defender,Spain,Europe
730,Djené,TOG,Getafe,La Liga,2021,29.0,1991.0,34.6,44,26,24,16,4,23,34,67.6,11,24,5,19,59,103,109,2,DF,25-29,Defender,Togo,Africa
738,Marko Dmitrović,SRB,Sevilla,La Liga,2021,29.0,1992.0,6.0,0,0,0,0,0,0,0,,0,0,0,0,0,0,3,1,GK,25-29,Goalkeeper,Serbia,Europe
743,Jaume Doménech,ESP,Valencia,La Liga,2021,30.0,1990.0,3.8,0,0,0,0,0,0,0,,0,0,0,0,0,0,3,1,GK,30-34,Goalkeeper,Spain,Europe
745,Carlos Dominguez,ESP,Celta Vigo,La Liga,2021,20.0,2001.0,3.8,4,1,4,0,0,4,6,66.7,2,2,1,1,4,8,21,0,DF,20-24,Defender,Spain,Europe
746,Mario Dominguez,ESP,Valencia,La Liga,2021,17.0,2004.0,0.3,0,0,0,0,0,0,0,,0,0,0,0,0,0,1,0,FW,Under 20,Forward,Spain,Europe
748,John Donald,ESP,Elche,La Liga,2021,20.0,2000.0,2.0,7,4,4,2,1,5,8,62.5,3,5,3,2,3,10,3,0,DF,20-24,Defender,Spain,Europe
763,Bartłomiej Drągowski,POL,Fiorentina,Serie A,2021,23.0,1997.0,6.2,0,0,0,0,0,0,0,,0,0,0,0,1,1,5,2,GK,20-24,Goalkeeper,Poland,Europe
771,Rubén Duarte,ESP,Alavés,La Liga,2021,25.0,1995.0,29.1,76,47,43,27,6,43,85,50.6,42,40,6,34,57,133,82,0,DF,25-29,Defender,Spain,Europe
777,Unai Dufur,ESP,Osasuna,La Liga,2021,22.0,1999.0,1.0,0,0,0,0,0,0,0,,0,1,0,1,4,4,4,0,DF,20-24,Defender,Spain,Europe
783,Hugo Duro,ESP,Getafe,La Liga,2021,21.0,1999.0,0.1,0,0,0,0,0,0,0,,0,0,0,0,0,0,0,0,"DF,MF",20-24,Defender,Spain,Europe
784,Hugo Duro,ESP,Valencia,La Liga,2021,21.0,1999.0,20.4,25,19,11,13,1,15,38,39.5,23,24,2,22,4,29,20,1,"FW,MF",20-24,Forward,Spain,Europe
803,Alberth Elis,HON,Bordeaux,Ligue 1,2021,25.0,1996.0,15.7,19,10,5,5,9,11,25,44.0,14,9,0,9,7,26,10,0,"FW,MF",25-29,Forward,Honduras,North America
807,Aritz Elustondo,ESP,Real Sociedad,La Liga,2021,27.0,1994.0,23.4,21,14,16,5,0,10,20,50.0,10,19,13,6,29,50,86,0,DF,25-29,Defender,Spain,Europe
809,Mohamed Elyounoussi,NOR,Southampton,Premier League,2021,26.0,1994.0,22.7,36,17,14,15,7,11,39,28.2,28,23,2,21,12,48,28,0,"MF,FW",25-29,Midfielder,Norway,Europe
810,Adri Embarba,ESP,Espanyol,La Liga,2021,29.0,1992.0,22.1,44,29,22,15,7,26,69,37.7,43,35,3,32,19,63,30,0,"FW,MF",25-29,Forward,Spain,Europe
822,Aarón Escandell,ESP,Granada,La Liga,2021,25.0,1995.0,3.2,0,0,0,0,0,0,1,0.0,1,0,0,0,0,0,4,0,GK,25-29,Goalkeeper,Spain,Europe
823,Sergio Escudero,ESP,Granada,La Liga,2021,31.0,1989.0,15.9,46,24,25,17,4,26,54,48.1,28,18,3,15,26,72,35,0,"DF,MF",30-34,Defender,Spain,Europe
826,Estanis,ESP,Barcelona,La Liga,2021,17.0,2003.0,0.1,1,1,0,1,0,1,1,100.0,0,0,0,0,0,1,0,0,FW,Under 20,Forward,Spain,Europe
830,Jonny Evans,NIR,Leicester City,Premier League,2021,33.0,1988.0,15.0,24,14,14,8,2,14,22,63.6,8,17,13,4,20,44,59,0,DF,30-34,Defender,Northern Ireland,Europe
833,Łukasz Fabiański,POL,West Ham,Premier League,2021,36.0,1985.0,37.0,0,0,0,0,0,0,0,,0,0,0,0,0,0,11,0,GK,35-39,Goalkeeper,Poland,Europe
836,Cesc Fàbregas,ESP,Monaco,Ligue 1,2021,34.0,1987.0,0.4,1,0,0,1,0,1,1,100.0,0,0,0,0,1,2,0,0,MF,30-34,Midfielder,Spain,Europe
844,Fali,ESP,Cádiz,La Liga,2021,27.0,1993.0,20.0,32,19,24,8,0,17,32,53.1,15,26,16,10,24,56,82,0,"DF,MF",25-29,Defender,Spain,Europe
853,Ansu Fati,ESP,Barcelona,La Liga,2021,18.0,2002.0,3.7,3,2,0,2,1,1,1,100.0,0,4,0,4,1,4,0,0,FW,Under 20,Forward,Spain,Europe
857,Aleix Febas,ESP,Mallorca,La Liga,2021,25.0,1996.0,1.3,4,1,0,4,0,2,4,50.0,2,0,0,0,0,4,0,0,MF,25-29,Midfielder,Spain,Europe
865,Kiko Femenía,ESP,Watford,Premier League,2021,30.0,1991.0,23.8,35,22,23,10,2,21,37,56.8,16,24,8,16,37,72,51,0,DF,30-34,Defender,Spain,Europe
870,Aitor Fernández,ESP,Levante,La Liga,2021,30.0,1991.0,13.0,2,1,2,0,0,2,2,100.0,0,0,0,0,0,2,7,0,GK,30-34,Goalkeeper,Spain,Europe
870,Aitor Fernández,ESP,Levante,La Liga,2021,30.0,1991.0,13.0,2,1,2,0,0,2,2,100.0,0,0,0,0,0,2,7,0,GK,30-34,Goalkeeper,Spain,Europe
870,Aitor Fernández,ESP,Levante,La Liga,2021,30.0,1991.0,13.0,2,1,2,0,0,2,2,100.0,0,0,0,0,0,2,7,0,GK,30-34,Goalkeeper,Spain,Europe
870,Aitor Fernández,ESP,Levante,La Liga,2021,30.0,1991.0,13.0,2,1,2,0,0,2,2,100.0,0,0,0,0,0,2,7,0,GK,30-34,Goalkeeper,Spain,Europe
871,Álex Fernández,ESP,Cádiz,La Liga,2021,28.0,1992.0,22.8,47,31,22,17,8,21,61,34.4,40,30,7,23,30,77,31,0,MF,25-29,Midfielder,Spain,Europe
872,Álvaro Fernández,ESP,Brentford,Premier League,2021,23.0,1998.0,12.0,0,0,0,0,0,0,0,,0,0,0,0,0,0,5,2,GK,20-24,Goalkeeper,Spain,Europe
872,Álvaro Fernández,ESP,Brentford,Premier League,2021,23.0,1998.0,12.0,0,0,0,0,0,0,0,,0,0,0,0,0,0,5,2,GK,20-24,Goalkeeper,Spain,Europe
872,Álvaro Fernández,ESP,Brentford,Premier League,2021,23.0,1998.0,12.0,0,0,0,0,0,0,0,,0,0,0,0,0,0,5,2,GK,20-24,Goalkeeper,Spain,Europe
872,Álvaro Fernández,ESP,Brentford,Premier League,2021,23.0,1998.0,12.0,0,0,0,0,0,0,0,,0,0,0,0,0,0,5,2,GK,20-24,Goalkeeper,Spain,Europe
877,Salvador Ferrer,ESP,Spezia,Serie A,2021,23.0,1998.0,16.6,32,18,15,9,8,12,25,48.0,13,24,12,12,18,50,46,0,"DF,MF",20-24,Defender,Spain,Europe
880,Fidel,ESP,Elche,La Liga,2021,31.0,1989.0,25.1,44,23,18,17,9,14,57,24.6,43,9,1,8,7,51,20,0,MF,30-34,Midfielder,Spain,Europe
881,Karol Fila,POL,Strasbourg,Ligue 1,2021,23.0,1998.0,6.2,10,8,5,4,1,4,8,50.0,4,7,2,5,4,14,6,0,DF,20-24,Defender,Poland,Europe
898,José Fontán,ESP,Celta Vigo,La Liga,2021,21.0,2000.0,3.1,5,3,3,2,0,1,5,20.0,4,3,1,2,10,15,10,0,DF,20-24,Defender,Spain,Europe
901,Pablo Fornals,ESP,West Ham,Premier League,2021,25.0,1996.0,31.1,54,28,21,21,12,22,84,26.2,62,49,2,47,27,81,16,1,"FW,MF",25-29,Forward,Spain,Europe
917,Przemysław Frankowski,POL,Lens,Ligue 1,2021,26.0,1995.0,27.2,57,39,22,27,8,36,74,48.6,38,27,0,27,28,85,52,0,DF,25-29,Defender,Poland,Europe
918,Enric Franquesa,ESP,Levante,La Liga,2021,24.0,1997.0,6.9,5,3,4,0,1,0,1,0.0,1,4,0,4,7,12,11,0,"DF,FW",20-24,Defender,Spain,Europe
930,Jorge de Frutos,ESP,Levante,La Liga,2021,24.0,1997.0,19.6,33,15,14,11,8,10,51,19.6,41,11,1,10,12,45,13,0,"MF,FW",20-24,Midfielder,Spain,Europe
931,Leo Fuhr Hjelde,NOR,Leeds United,Premier League,2021,17.0,2003.0,1.7,5,4,3,2,0,3,3,100.0,0,3,3,0,4,9,7,0,"MF,DF",Under 20,Midfielder,Norway,Europe
938,Mijat Gaćinović,SRB,Hoffenheim,Bundesliga,2021,26.0,1995.0,1.2,3,3,1,1,1,3,3,100.0,0,1,0,1,1,4,2,0,"FW,MF",25-29,Forward,Serbia,Europe
943,Javi Galán,ESP,Celta Vigo,La Liga,2021,26.0,1994.0,36.6,108,66,60,37,11,42,99,42.4,57,48,8,40,45,153,52,0,DF,25-29,Defender,Spain,Europe
944,Iñigo Ruiz de Galarreta,ESP,Mallorca,La Liga,2021,27.0,1993.0,15.3,40,21,14,21,5,14,30,46.7,16,16,2,14,20,60,21,0,MF,25-29,Midfielder,Spain,Europe
955,Álvaro García,ESP,Rayo Vallecano,La Liga,2021,28.0,1992.0,33.3,42,23,15,18,9,8,35,22.9,27,27,3,24,42,84,24,0,"FW,MF",25-29,Forward,Spain,Europe
955,Álvaro García,ESP,Rayo Vallecano,La Liga,2021,28.0,1992.0,33.3,42,23,15,18,9,8,35,22.9,27,27,3,24,42,84,24,0,"FW,MF",25-29,Forward,Spain,Europe
955,Álvaro García,ESP,Rayo Vallecano,La Liga,2021,28.0,1992.0,33.3,42,23,15,18,9,8,35,22.9,27,27,3,24,42,84,24,0,"FW,MF",25-29,Forward,Spain,Europe
955,Álvaro García,ESP,Rayo Vallecano,La Liga,2021,28.0,1992.0,33.3,42,23,15,18,9,8,35,22.9,27,27,3,24,42,84,24,0,"FW,MF",25-29,Forward,Spain,Europe
955,Álvaro García,ESP,Rayo Vallecano,La Liga,2021,28.0,1992.0,33.3,42,23,15,18,9,8,35,22.9,27,27,3,24,42,84,24,0,"FW,MF",25-29,Forward,Spain,Europe
955,Álvaro García,ESP,Rayo Vallecano,La Liga,2021,28.0,1992.0,33.3,42,23,15,18,9,8,35,22.9,27,27,3,24,42,84,24,0,"FW,MF",25-29,Forward,Spain,Europe
955,Álvaro García,ESP,Rayo Vallecano,La Liga,2021,28.0,1992.0,33.3,42,23,15,18,9,8,35,22.9,27,27,3,24,42,84,24,0,"FW,MF",25-29,Forward,Spain,Europe
955,Álvaro García,ESP,Rayo Vallecano,La Liga,2021,28.0,1992.0,33.3,42,23,15,18,9,8,35,22.9,27,27,3,24,42,84,24,0,"FW,MF",25-29,Forward,Spain,Europe
955,Álvaro García,ESP,Rayo Vallecano,La Liga,2021,28.0,1992.0,33.3,42,23,15,18,9,8,35,22.9,27,27,3,24,42,84,24,0,"FW,MF",25-29,Forward,Spain,Europe
955,Álvaro García,ESP,Rayo Vallecano,La Liga,2021,28.0,1992.0,33.3,42,23,15,18,9,8,35,22.9,27,27,3,24,42,84,24,0,"FW,MF",25-29,Forward,Spain,Europe
955,Álvaro García,ESP,Rayo Vallecano,La Liga,2021,28.0,1992.0,33.3,42,23,15,18,9,8,35,22.9,27,27,3,24,42,84,24,0,"FW,MF",25-29,Forward,Spain,Europe
955,Álvaro García,ESP,Rayo Vallecano,La Liga,2021,28.0,1992.0,33.3,42,23,15,18,9,8,35,22.9,27,27,3,24,42,84,24,0,"FW,MF",25-29,Forward,Spain,Europe
955,Álvaro García,ESP,Rayo Vallecano,La Liga,2021,28.0,1992.0,33.3,42,23,15,18,9,8,35,22.9,27,27,3,24,42,84,24,0,"FW,MF",25-29,Forward,Spain,Europe
955,Álvaro García,ESP,Rayo Vallecano,La Liga,2021,28.0,1992.0,33.3,42,23,15,18,9,8,35,22.9,27,27,3,24,42,84,24,0,"FW,MF",25-29,Forward,Spain,Europe
955,Álvaro García,ESP,Rayo Vallecano,La Liga,2021,28.0,1992.0,33.3,42,23,15,18,9,8,35,22.9,27,27,3,24,42,84,24,0,"FW,MF",25-29,Forward,Spain,Europe
955,Álvaro García,ESP,Rayo Vallecano,La Liga,2021,28.0,1992.0,33.3,42,23,15,18,9,8,35,22.9,27,27,3,24,42,84,24,0,"FW,MF",25-29,Forward,Spain,Europe
956,Dani García,ESP,Athletic Club,La Liga,2021,31.0,1990.0,24.2,36,22,15,17,4,14,47,29.8,33,27,10,17,24,60,41,1,MF,30-34,Midfielder,Spain,Europe
957,David García,ESP,Osasuna,La Liga,2021,27.0,1994.0,34.5,28,14,15,11,2,12,22,54.5,10,27,21,6,52,80,168,0,DF,25-29,Defender,Spain,Europe
957,David García,ESP,Osasuna,La Liga,2021,27.0,1994.0,34.5,28,14,15,11,2,12,22,54.5,10,27,21,6,52,80,168,0,DF,25-29,Defender,Spain,Europe
957,David García,ESP,Osasuna,La Liga,2021,27.0,1994.0,34.5,28,14,15,11,2,12,22,54.5,10,27,21,6,52,80,168,0,DF,25-29,Defender,Spain,Europe
957,David García,ESP,Osasuna,La Liga,2021,27.0,1994.0,34.5,28,14,15,11,2,12,22,54.5,10,27,21,6,52,80,168,0,DF,25-29,Defender,Spain,Europe
958,Eric García,ESP,Barcelona,La Liga,2021,20.0,2001.0,22.7,27,18,13,13,1,11,26,42.3,15,22,12,10,44,71,53,3,DF,20-24,Defender,Spain,Europe
959,Fran Garcia,ESP,Rayo Vallecano,La Liga,2021,21.0,1999.0,33.6,60,35,44,12,4,39,73,53.4,34,34,8,26,45,105,53,0,DF,20-24,Defender,Spain,Europe
960,Joan García,ESP,Espanyol,La Liga,2021,20.0,2001.0,1.2,0,0,0,0,0,0,0,,0,0,0,0,1,1,1,2,GK,20-24,Goalkeeper,Spain,Europe
961,Manu García,ESP,Alavés,La Liga,2021,23.0,1998.0,12.0,18,9,6,9,3,9,27,33.3,18,8,2,6,13,31,4,0,MF,20-24,Midfielder,Spain,Europe
961,Manu García,ESP,Alavés,La Liga,2021,23.0,1998.0,12.0,18,9,6,9,3,9,27,33.3,18,8,2,6,13,31,4,0,MF,20-24,Midfielder,Spain,Europe
961,Manu García,ESP,Alavés,La Liga,2021,23.0,1998.0,12.0,18,9,6,9,3,9,27,33.3,18,8,2,6,13,31,4,0,MF,20-24,Midfielder,Spain,Europe
961,Manu García,ESP,Alavés,La Liga,2021,23.0,1998.0,12.0,18,9,6,9,3,9,27,33.3,18,8,2,6,13,31,4,0,MF,20-24,Midfielder,Spain,Europe
962,Raúl García,ESP,Athletic Club,La Liga,2021,35.0,1986.0,20.0,27,17,6,11,10,8,36,22.2,28,30,4,26,9,36,21,0,FW,35-39,Forward,Spain,Europe
962,Raúl García,ESP,Athletic Club,La Liga,2021,35.0,1986.0,20.0,27,17,6,11,10,8,36,22.2,28,30,4,26,9,36,21,0,FW,35-39,Forward,Spain,Europe
962,Raúl García,ESP,Athletic Club,La Liga,2021,35.0,1986.0,20.0,27,17,6,11,10,8,36,22.2,28,30,4,26,9,36,21,0,FW,35-39,Forward,Spain,Europe
962,Raúl García,ESP,Athletic Club,La Liga,2021,35.0,1986.0,20.0,27,17,6,11,10,8,36,22.2,28,30,4,26,9,36,21,0,FW,35-39,Forward,Spain,Europe
963,Rubén García,ESP,Osasuna,La Liga,2021,28.0,1993.0,26.4,43,26,12,23,8,16,49,32.7,33,31,4,27,24,67,16,0,"MF,FW",25-29,Midfielder,Spain,Europe
963,Rubén García,ESP,Osasuna,La Liga,2021,28.0,1993.0,26.4,43,26,12,23,8,16,49,32.7,33,31,4,27,24,67,16,0,"MF,FW",25-29,Midfielder,Spain,Europe
963,Rubén García,ESP,Osasuna,La Liga,2021,28.0,1993.0,26.4,43,26,12,23,8,16,49,32.7,33,31,4,27,24,67,16,0,"MF,FW",25-29,Midfielder,Spain,Europe
963,Rubén García,ESP,Osasuna,La Liga,2021,28.0,1993.0,26.4,43,26,12,23,8,16,49,32.7,33,31,4,27,24,67,16,0,"MF,FW",25-29,Midfielder,Spain,Europe
964,Saúl García,ESP,Alavés,La Liga,2021,26.0,1994.0,0.0,1,1,1,0,0,0,0,,0,0,0,0,0,1,0,0,MF,25-29,Midfielder,Spain,Europe
965,Unai García,ESP,Osasuna,La Liga,2021,29.0,1992.0,15.6,21,12,14,6,1,14,17,82.4,3,19,11,8,22,43,78,0,DF,25-29,Defender,Spain,Europe
967,Mario Gaspar,ESP,Villarreal,La Liga,2021,30.0,1990.0,6.9,10,4,2,5,3,6,10,60.0,4,6,3,3,6,16,15,0,DF,30-34,Defender,Spain,Europe
970,Gavi,ESP,Barcelona,La Liga,2021,16.0,2004.0,25.7,38,18,13,18,7,9,33,27.3,24,36,0,36,25,63,13,0,"MF,FW",Under 20,Midfielder,Spain,Europe
973,David de Gea,ESP,Manchester Utd,Premier League,2021,30.0,1990.0,38.0,0,0,0,0,0,0,0,,0,0,0,0,0,0,11,2,GK,30-34,Goalkeeper,Spain,Europe
983,Ismaël Gharbi,ESP,Paris S-G,Ligue 1,2021,17.0,2004.0,0.0,0,0,0,0,0,0,0,,0,0,0,0,0,0,0,0,FW,Under 20,Forward,Spain,Europe
994,Rafał Gikiewicz,POL,Augsburg,Bundesliga,2021,33.0,1987.0,34.0,2,0,2,0,0,2,7,28.6,5,0,0,0,3,5,11,5,GK,30-34,Goalkeeper,Poland,Europe
995,Bryan Gil,ESP,Tottenham,Premier League,2021,20.0,2001.0,1.0,3,0,1,0,2,1,2,50.0,1,2,0,2,0,3,0,0,"FW,MF",20-24,Forward,Spain,Europe
996,Bryan Gil,ESP,Valencia,La Liga,2021,20.0,2001.0,8.4,13,8,6,3,4,2,13,15.4,11,13,0,13,1,14,4,0,"MF,FW",20-24,Midfielder,Spain,Europe
997,Óscar Gil,ESP,Espanyol,La Liga,2021,24.0,1997.0,18.8,52,35,27,20,5,25,46,54.3,21,33,9,24,19,71,33,2,DF,20-24,Defender,Spain,Europe
997,Óscar Gil,ESP,Espanyol,La Liga,2021,24.0,1997.0,18.8,52,35,27,20,5,25,46,54.3,21,33,9,24,19,71,33,2,DF,20-24,Defender,Spain,Europe
997,Óscar Gil,ESP,Espanyol,La Liga,2021,24.0,1997.0,18.8,52,35,27,20,5,25,46,54.3,21,33,9,24,19,71,33,2,DF,20-24,Defender,Spain,Europe
997,Óscar Gil,ESP,Espanyol,La Liga,2021,24.0,1997.0,18.8,52,35,27,20,5,25,46,54.3,21,33,9,24,19,71,33,2,DF,20-24,Defender,Spain,Europe
998,Mario Gila,ESP,Real Madrid,La Liga,2021,20.0,2000.0,0.3,1,0,1,0,0,0,1,0.0,1,0,0,0,1,2,1,0,DF,20-24,Defender,Spain,Europe
1017,Dani Gómez,ESP,Levante,La Liga,2021,23.0,1998.0,11.8,7,4,3,2,2,4,12,33.3,8,3,0,3,3,10,5,0,FW,20-24,Forward,Spain,Europe
1020,Moi Gómez,ESP,Villarreal,La Liga,2021,27.0,1994.0,14.3,15,7,8,3,4,5,17,29.4,12,5,0,5,6,21,6,0,"MF,FW",25-29,Midfielder,Spain,Europe
1022,Sergi Gómez,ESP,Espanyol,La Liga,2021,29.0,1992.0,30.2,33,24,29,3,1,18,27,66.7,9,33,23,10,40,73,125,2,DF,25-29,Defender,Spain,Europe
1023,Victor Gomez,ESP,Espanyol,La Liga,2021,21.0,2000.0,0.0,0,0,0,0,0,0,0,,0,0,0,0,0,0,0,0,DF,20-24,Defender,Spain,Europe
1028,Álvaro González,ESP,Marseille,Ligue 1,2021,31.0,1990.0,5.0,1,1,1,0,0,1,1,100.0,0,0,0,0,1,2,9,0,DF,30-34,Defender,Spain,Europe
1028,Álvaro González,ESP,Marseille,Ligue 1,2021,31.0,1990.0,5.0,1,1,1,0,0,1,1,100.0,0,0,0,0,1,2,9,0,DF,30-34,Defender,Spain,Europe
1028,Álvaro González,ESP,Marseille,Ligue 1,2021,31.0,1990.0,5.0,1,1,1,0,0,1,1,100.0,0,0,0,0,1,2,9,0,DF,30-34,Defender,Spain,Europe
1028,Álvaro González,ESP,Marseille,Ligue 1,2021,31.0,1990.0,5.0,1,1,1,0,0,1,1,100.0,0,0,0,0,1,2,9,0,DF,30-34,Defender,Spain,Europe
1029,Diego González,ESP,Elche,La Liga,2021,26.0,1995.0,19.9,25,16,18,7,0,9,16,56.3,7,21,13,8,19,44,87,0,DF,25-29,Defender,Spain,Europe
1029,Diego González,ESP,Elche,La Liga,2021,26.0,1995.0,19.9,25,16,18,7,0,9,16,56.3,7,21,13,8,19,44,87,0,DF,25-29,Defender,Spain,Europe
1029,Diego González,ESP,Elche,La Liga,2021,26.0,1995.0,19.9,25,16,18,7,0,9,16,56.3,7,21,13,8,19,44,87,0,DF,25-29,Defender,Spain,Europe
1029,Diego González,ESP,Elche,La Liga,2021,26.0,1995.0,19.9,25,16,18,7,0,9,16,56.3,7,21,13,8,19,44,87,0,DF,25-29,Defender,Spain,Europe
1030,Édgar González,ESP,Betis,La Liga,2021,24.0,1997.0,16.3,25,19,15,8,2,17,24,70.8,7,17,11,6,23,48,82,0,DF,20-24,Defender,Spain,Europe
1033,Nicolás González,ESP,Barcelona,La Liga,2021,19.0,2002.0,12.4,31,20,5,23,3,11,27,40.7,16,12,0,12,6,37,12,0,MF,Under 20,Midfielder,Spain,Europe
1034,Roberto González,ESP,Betis,La Liga,2021,20.0,2001.0,1.5,5,4,3,2,0,4,6,66.7,2,5,0,5,1,6,1,0,"FW,MF",20-24,Forward,Spain,Europe
1039,Gori,ESP,Espanyol,La Liga,2021,19.0,2002.0,0.1,0,0,0,0,0,0,0,,0,2,0,2,0,0,0,0,MF,Under 20,Midfielder,Spain,Europe
1040,Andoni Gorosabel,ESP,Real Sociedad,La Liga,2021,24.0,1996.0,25.4,47,31,32,9,6,25,47,53.2,22,16,3,13,18,65,49,0,DF,20-24,Defender,Spain,Europe
1050,Jaume Grau,ESP,Osasuna,La Liga,2021,24.0,1997.0,0.0,1,1,1,0,0,0,1,0.0,1,0,0,0,0,1,0,0,MF,20-24,Midfielder,Spain,Europe
1072,Vicente Guaita,ESP,Crystal Palace,Premier League,2021,34.0,1987.0,29.5,1,0,1,0,0,1,1,100.0,0,0,0,0,1,2,8,1,GK,30-34,Goalkeeper,Spain,Europe
1074,Sergi Guardiola,ESP,Rayo Vallecano,La Liga,2021,30.0,1991.0,19.0,10,9,3,5,2,1,21,4.8,20,14,2,12,4,14,17,0,FW,30-34,Forward,Spain,Europe
1075,Nemanja Gudelj,SRB,Sevilla,La Liga,2021,29.0,1991.0,11.6,16,7,10,4,2,5,8,62.5,3,14,9,5,22,38,37,0,"DF,MF",25-29,Defender,Serbia,Europe
1084,Ander Guevara,ESP,Real Sociedad,La Liga,2021,24.0,1997.0,9.6,18,13,6,10,2,10,17,58.8,7,12,6,6,12,30,8,0,MF,20-24,Midfielder,Spain,Europe
1091,Hugo Guillamón,ESP,Valencia,La Liga,2021,21.0,2000.0,26.2,43,27,20,16,7,18,44,40.9,26,26,10,16,30,73,53,1,"MF,DF",20-24,Midfielder,Spain,Europe
1097,Gerard Gumbau,ESP,Elche,La Liga,2021,26.0,1994.0,21.0,46,19,22,19,5,22,51,43.1,29,18,4,14,23,69,25,0,MF,25-29,Midfielder,Spain,Europe
1098,Robert Gumny,POL,Augsburg,Bundesliga,2021,23.0,1998.0,25.2,48,29,25,20,3,25,43,58.1,18,24,7,17,28,76,57,3,DF,20-24,Defender,Poland,Europe
1104,Jon Guridi,ESP,Real Sociedad,La Liga,2021,26.0,1995.0,2.3,5,3,2,3,0,1,4,25.0,3,3,1,2,3,8,4,0,MF,25-29,Midfielder,Spain,Europe
1106,Raúl Guti,ESP,Elche,La Liga,2021,24.0,1996.0,18.1,25,15,7,14,4,10,30,33.3,20,9,3,6,25,50,7,0,MF,20-24,Midfielder,Spain,Europe
1108,Miguel Gutiérrez,ESP,Real Madrid,La Liga,2021,20.0,2001.0,2.9,7,5,5,0,2,3,5,60.0,2,0,0,0,2,9,2,0,DF,20-24,Defender,Spain,Europe
1113,Erling Haaland,NOR,Dortmund,Bundesliga,2021,21.0,2000.0,21.2,2,1,0,1,1,0,1,0.0,1,8,1,7,1,3,31,0,FW,20-24,Forward,Norway,Europe
1128,Samir Handanović,SVN,Inter,Serie A,2021,37.0,1984.0,37.0,1,0,1,0,0,1,2,50.0,1,1,0,1,0,1,6,3,GK,35-39,Goalkeeper,Slovenia,Europe
1163,Kike Hermoso,ESP,Betis,La Liga,2021,21.0,1999.0,1.0,2,1,2,0,0,2,2,100.0,0,2,1,1,0,2,5,1,DF,20-24,Defender,Spain,Europe
1164,Mario Hermoso,ESP,Atlético Madrid,La Liga,2021,26.0,1995.0,20.7,30,15,23,4,3,20,38,52.6,18,18,3,15,29,59,49,2,DF,25-29,Defender,Spain,Europe
1165,Aridane Hernández,ESP,Osasuna,La Liga,2021,32.0,1989.0,12.9,12,9,10,2,0,3,13,23.1,10,11,9,2,20,32,71,0,DF,30-34,Defender,Spain,Europe
1167,Luis Hernández,ESP,Cádiz,La Liga,2021,32.0,1989.0,15.2,9,5,9,0,0,5,8,62.5,3,5,3,2,16,25,34,0,DF,30-34,Defender,Spain,Europe
1168,Mario Hernández,ESP,Rayo Vallecano,La Liga,2021,22.0,1999.0,4.4,10,4,7,3,0,5,9,55.6,4,1,0,1,4,14,7,0,"DF,FW",20-24,Defender,Spain,Europe
1171,Ander Herrera,ESP,Paris S-G,Ligue 1,2021,31.0,1989.0,12.1,29,17,7,16,6,14,39,35.9,25,22,8,14,14,43,8,0,MF,30-34,Midfielder,Spain,Europe
1173,Sergio Herrera,ESP,Osasuna,La Liga,2021,28.0,1993.0,36.0,3,2,3,0,0,3,6,50.0,3,1,0,1,1,4,18,0,GK,25-29,Goalkeeper,Spain,Europe
1211,Robert Ibáñez,ESP,Osasuna,La Liga,2021,28.0,1993.0,1.0,3,3,2,0,1,1,2,50.0,1,1,0,1,1,4,1,0,"MF,FW",25-29,Midfielder,Spain,Europe
1213,Vicente Iborra,ESP,Villarreal,La Liga,2021,33.0,1988.0,11.5,19,10,9,7,3,12,24,50.0,12,11,5,6,11,30,27,1,MF,30-34,Midfielder,Spain,Europe
1219,Iglesias,ESP,Getafe,La Liga,2021,23.0,1998.0,8.0,19,10,11,8,0,7,17,41.2,10,8,2,6,10,29,28,0,DF,20-24,Defender,Spain,Europe
1220,Borja Iglesias,ESP,Betis,La Liga,2021,28.0,1993.0,17.5,6,4,1,2,3,0,8,0.0,8,11,1,10,4,10,7,0,FW,25-29,Forward,Spain,Europe
1228,Ivan Ilić,SRB,Hellas Verona,Serie A,2021,20.0,2001.0,28.1,39,18,16,19,4,20,54,37.0,34,34,12,22,22,61,55,0,MF,20-24,Midfielder,Serbia,Europe
1229,Josip Iličić,SVN,Atalanta,Serie A,2021,33.0,1988.0,9.3,7,7,3,2,2,4,17,23.5,13,6,1,5,3,10,1,0,"MF,FW",30-34,Midfielder,Slovenia,Europe
1230,Asier Illarramendi,ESP,Real Sociedad,La Liga,2021,31.0,1990.0,4.2,9,5,5,3,1,1,10,10.0,9,5,1,4,4,13,12,0,MF,30-34,Midfielder,Spain,Europe
1242,Isco,ESP,Real Madrid,La Liga,2021,29.0,1992.0,3.7,9,5,4,4,1,5,12,41.7,7,1,0,1,2,11,1,0,"MF,FW",25-29,Midfielder,Spain,Europe
1262,Jakub Jankto,CZE,Getafe,La Liga,2021,25.0,1996.0,6.5,11,7,5,5,1,10,17,58.8,7,4,0,4,4,15,7,0,"DF,MF",25-29,Defender,Czech Republic,Europe
1267,Paweł Jaroszyński,POL,Salernitana,Serie A,2021,26.0,1994.0,5.7,10,5,7,3,0,5,7,71.4,2,4,0,4,10,20,19,0,DF,25-29,Defender,Poland,Europe
1268,Jason,ESP,Alavés,La Liga,2021,27.0,1994.0,7.5,11,7,6,4,1,7,20,35.0,13,7,0,7,7,18,5,0,"MF,FW",25-29,Midfielder,Spain,Europe
1269,Jason,ESP,Valencia,La Liga,2021,27.0,1994.0,0.8,4,1,2,1,1,0,1,0.0,1,2,0,2,1,5,1,0,"MF,DF",25-29,Midfielder,Spain,Europe
1270,Dennis Jastrzembski,POL,Hertha BSC,Bundesliga,2021,21.0,2000.0,2.5,2,1,1,1,0,2,8,25.0,6,1,0,1,5,7,3,0,"DF,FW",20-24,Defender,Poland,Europe
1279,Álvaro Jiménez,ESP,Cádiz,La Liga,2021,26.0,1995.0,2.6,6,3,3,2,1,4,7,57.1,3,3,0,3,3,9,0,0,"MF,FW",25-29,Midfielder,Spain,Europe
1282,Joaquín,ESP,Betis,La Liga,2021,40.0,1981.0,5.2,6,2,4,2,0,3,8,37.5,5,5,2,3,3,9,10,0,"FW,MF",Over 40,Forward,Spain,Europe
1284,Jofre,ESP,Espanyol,La Liga,2021,20.0,2001.0,0.2,1,1,0,0,1,1,1,100.0,0,0,0,0,0,1,0,0,"MF,DF",20-24,Midfielder,Spain,Europe
1286,Dennis Johnsen,NOR,Venezia,Serie A,2021,23.0,1998.0,16.1,14,10,8,4,2,6,18,33.3,12,14,1,13,5,19,3,0,"FW,MF",20-24,Forward,Norway,Europe
1292,Joan Jordán,ESP,Sevilla,La Liga,2021,27.0,1994.0,27.9,61,30,22,31,8,28,65,43.1,37,27,6,21,30,91,18,1,MF,25-29,Midfielder,Spain,Europe
1295,Josan,ESP,Elche,La Liga,2021,31.0,1989.0,13.5,36,22,23,9,4,26,44,59.1,18,11,4,7,10,46,21,0,"DF,MF",30-34,Defender,Spain,Europe
1297,Joselu,ESP,Alavés,La Liga,2021,31.0,1990.0,34.7,16,11,1,9,6,7,25,28.0,18,21,4,17,7,23,45,0,FW,30-34,Forward,Spain,Europe
1298,Josema,ESP,Elche,La Liga,2021,25.0,1996.0,2.0,3,2,1,1,1,0,2,0.0,2,1,1,0,0,3,11,0,DF,25-29,Defender,Spain,Europe
1302,Luka Jović,SRB,Real Madrid,La Liga,2021,23.0,1997.0,4.1,1,1,0,1,0,0,1,0.0,1,3,0,3,1,2,4,0,FW,20-24,Forward,Serbia,Europe
1303,Miguel Juan Llambrich,ESP,Espanyol,La Liga,2021,25.0,1996.0,0.8,2,2,1,1,0,0,0,,0,1,0,1,0,2,5,0,DF,25-29,Defender,Spain,Europe
1305,Juanmi,ESP,Betis,La Liga,2021,28.0,1993.0,23.7,39,25,11,19,9,19,49,38.8,30,24,1,23,9,48,10,1,FW,25-29,Forward,Spain,Europe
1312,Ferran Jutglà,ESP,Barcelona,La Liga,2021,22.0,1999.0,3.3,2,1,0,1,1,0,1,0.0,1,2,0,2,1,3,1,0,FW,20-24,Forward,Spain,Europe
1319,Pavel Kadeřábek,CZE,Hoffenheim,Bundesliga,2021,29.0,1992.0,13.3,11,10,6,3,2,5,16,31.3,11,18,6,12,13,24,22,0,"DF,MF",25-29,Defender,Czech Republic,Europe
1335,Dimitrije Kamenović,SRB,Lazio,Serie A,2021,21.0,2000.0,0.5,1,1,1,0,0,1,1,100.0,0,0,0,0,2,3,1,0,DF,20-24,Defender,Serbia,Europe
1336,Kevin Kampl,SVN,RB Leipzig,Bundesliga,2021,30.0,1990.0,21.1,41,19,16,20,5,10,42,23.8,32,24,5,19,24,65,17,0,MF,30-34,Midfielder,Slovenia,Europe
1370,Kiké,ESP,Osasuna,La Liga,2021,31.0,1989.0,20.7,11,7,3,4,4,3,23,13.0,20,10,1,9,3,14,12,0,FW,30-34,Forward,Spain,Europe
1376,Joshua King,NOR,Watford,Premier League,2021,29.0,1992.0,25.0,19,15,7,6,6,4,17,23.5,13,15,4,11,8,27,31,0,FW,25-29,Forward,Norway,Europe
1377,Jakub Kiwior,POL,Spezia,Serie A,2021,21.0,2000.0,21.8,50,27,25,19,6,26,57,45.6,31,38,15,23,40,90,53,0,MF,20-24,Midfielder,Poland,Europe
1380,Kristoffer Klaesson,NOR,Leeds United,Premier League,2021,20.0,2000.0,0.4,0,0,0,0,0,0,0,,0,0,0,0,0,0,0,0,GK,20-24,Goalkeeper,Norway,Europe
1382,Mateusz Klich,POL,Leeds United,Premier League,2021,31.0,1990.0,23.0,47,25,18,23,6,25,66,37.9,41,22,4,18,11,58,20,0,MF,30-34,Midfielder,Poland,Europe
1383,Thibault Klidje,TOG,Bordeaux,Ligue 1,2021,20.0,2001.0,1.0,0,0,0,0,0,0,1,0.0,1,1,1,0,2,2,0,0,"MF,FW",20-24,Midfielder,Togo,Africa
1398,Koke,ESP,Atlético Madrid,La Liga,2021,29.0,1992.0,27.9,55,30,19,29,7,26,63,41.3,37,21,5,16,24,79,31,1,MF,25-29,Midfielder,Spain,Europe
1400,Aleksandar Kolarov,SRB,Inter,Serie A,2021,35.0,1985.0,0.5,1,1,1,0,0,1,1,100.0,0,0,0,0,1,2,2,0,DF,35-39,Defender,Serbia,Europe
1416,Filip Kostić,SRB,Eint Frankfurt,Bundesliga,2021,28.0,1992.0,28.0,44,17,26,9,9,20,53,37.7,33,24,1,23,15,59,24,0,"DF,FW",25-29,Defender,Serbia,Europe
1426,Alex Král,CZE,West Ham,Premier League,2021,23.0,1998.0,0.0,0,0,0,0,0,0,0,,0,0,0,0,0,0,0,0,MF,20-24,Midfielder,Czech Republic,Europe
1430,Julian Kristoffersen,NOR,Salernitana,Serie A,2021,24.0,1997.0,0.1,0,0,0,0,0,0,0,,0,0,0,0,0,0,0,0,FW,20-24,Forward,Norway,Europe
1456,Víctor Laguardia,ESP,Alavés,La Liga,2021,31.0,1989.0,33.8,29,16,21,8,0,19,30,63.3,11,36,24,12,27,56,151,1,DF,30-34,Defender,Spain,Europe
1469,Aymeric Laporte,ESP,Manchester City,Premier League,2021,27.0,1994.0,31.4,33,15,22,10,1,14,20,70.0,6,15,10,5,20,53,64,2,DF,25-29,Defender,Spain,Europe
1476,Juanmi Latasa,ESP,Real Madrid,La Liga,2021,20.0,2001.0,0.1,0,0,0,0,0,0,0,,0,0,0,0,0,0,0,0,FW,20-24,Forward,Spain,Europe
1477,Toni Lato,ESP,Valencia,La Liga,2021,23.0,1997.0,6.6,17,12,12,3,2,9,16,56.3,7,6,0,6,8,25,14,0,DF,20-24,Defender,Spain,Europe
1479,Darko Lazović,SRB,Hellas Verona,Serie A,2021,30.0,1990.0,30.7,36,23,20,8,8,21,39,53.8,18,28,4,24,19,55,49,1,DF,30-34,Defender,Serbia,Europe
1486,Robin Le Normand,ESP,Real Sociedad,La Liga,2021,24.0,1996.0,37.0,49,32,36,8,5,28,36,77.8,8,34,22,12,48,97,125,0,DF,20-24,Defender,Spain,Europe
1496,Iñigo Lekue,ESP,Athletic Club,La Liga,2021,28.0,1993.0,21.4,32,23,16,12,4,22,44,50.0,22,37,12,25,23,55,63,0,DF,25-29,Defender,Spain,Europe
1502,Ruben Lendinez,ESP,Valencia,La Liga,2021,18.0,2003.0,1.5,3,3,1,2,0,3,8,37.5,5,4,0,4,2,5,6,0,DF,Under 20,Defender,Spain,Europe
1509,Robert Lewandowski,POL,Bayern Munich,Bundesliga,2021,32.0,1988.0,32.7,10,3,0,6,4,5,17,29.4,12,17,2,15,6,16,8,0,FW,30-34,Forward,Poland,Europe
1511,Jamal Lewis,NIR,Newcastle Utd,Premier League,2021,23.0,1998.0,2.9,8,6,6,1,1,3,4,75.0,1,3,2,1,3,11,8,0,DF,20-24,Defender,Northern Ireland,Europe
1523,Karol Linetty,POL,Torino,Serie A,2021,26.0,1995.0,10.0,14,8,3,4,7,6,18,33.3,12,8,0,8,3,17,2,0,"MF,FW",25-29,Midfielder,Poland,Europe
1525,Pol Lirola,ESP,Marseille,Ligue 1,2021,23.0,1997.0,19.7,28,16,15,9,4,13,28,46.4,15,15,0,15,13,41,22,0,"DF,FW",20-24,Defender,Spain,Europe
1528,Javier Llabrés,ESP,Mallorca,La Liga,2021,18.0,2002.0,1.5,2,1,0,1,1,1,2,50.0,1,1,0,1,0,2,0,0,"FW,MF",Under 20,Forward,Spain,Europe
1529,Diego Llorente,ESP,Leeds United,Premier League,2021,27.0,1993.0,26.0,53,31,32,19,2,33,47,70.2,14,35,17,18,40,93,77,2,DF,25-29,Defender,Spain,Europe
1529,Diego Llorente,ESP,Leeds United,Premier League,2021,27.0,1993.0,26.0,53,31,32,19,2,33,47,70.2,14,35,17,18,40,93,77,2,DF,25-29,Defender,Spain,Europe
1529,Diego Llorente,ESP,Leeds United,Premier League,2021,27.0,1993.0,26.0,53,31,32,19,2,33,47,70.2,14,35,17,18,40,93,77,2,DF,25-29,Defender,Spain,Europe
1529,Diego Llorente,ESP,Leeds United,Premier League,2021,27.0,1993.0,26.0,53,31,32,19,2,33,47,70.2,14,35,17,18,40,93,77,2,DF,25-29,Defender,Spain,Europe
1530,Marcos Llorente,ESP,Atlético Madrid,La Liga,2021,26.0,1995.0,27.2,51,23,25,22,4,28,43,65.1,15,33,10,23,27,78,44,0,"MF,DF",25-29,Midfielder,Spain,Europe
1534,Julen Lobete,ESP,Real Sociedad,La Liga,2021,20.0,2000.0,3.2,4,3,3,0,1,1,2,50.0,1,6,1,5,1,5,1,0,"FW,MF",20-24,Forward,Spain,Europe
1547,David López,ESP,Espanyol,La Liga,2021,31.0,1989.0,8.3,18,13,9,8,1,9,16,56.3,7,10,8,2,10,28,25,2,"MF,DF",30-34,Midfielder,Spain,Europe
1547,David López,ESP,Espanyol,La Liga,2021,31.0,1989.0,8.3,18,13,9,8,1,9,16,56.3,7,10,8,2,10,28,25,2,"MF,DF",30-34,Midfielder,Spain,Europe
1547,David López,ESP,Espanyol,La Liga,2021,31.0,1989.0,8.3,18,13,9,8,1,9,16,56.3,7,10,8,2,10,28,25,2,"MF,DF",30-34,Midfielder,Spain,Europe
1547,David López,ESP,Espanyol,La Liga,2021,31.0,1989.0,8.3,18,13,9,8,1,9,16,56.3,7,10,8,2,10,28,25,2,"MF,DF",30-34,Midfielder,Spain,Europe
1548,Diego López,ESP,Espanyol,La Liga,2021,39.0,1981.0,35.3,0,0,0,0,0,0,2,0.0,2,0,0,0,1,1,21,1,GK,35-39,Goalkeeper,Spain,Europe
1548,Diego López,ESP,Espanyol,La Liga,2021,39.0,1981.0,35.3,0,0,0,0,0,0,2,0.0,2,0,0,0,1,1,21,1,GK,35-39,Goalkeeper,Spain,Europe
1548,Diego López,ESP,Espanyol,La Liga,2021,39.0,1981.0,35.3,0,0,0,0,0,0,2,0.0,2,0,0,0,1,1,21,1,GK,35-39,Goalkeeper,Spain,Europe
1548,Diego López,ESP,Espanyol,La Liga,2021,39.0,1981.0,35.3,0,0,0,0,0,0,2,0.0,2,0,0,0,1,1,21,1,GK,35-39,Goalkeeper,Spain,Europe
1548,Diego López,ESP,Espanyol,La Liga,2021,39.0,1981.0,35.3,0,0,0,0,0,0,2,0.0,2,0,0,0,1,1,21,1,GK,35-39,Goalkeeper,Spain,Europe
1548,Diego López,ESP,Espanyol,La Liga,2021,39.0,1981.0,35.3,0,0,0,0,0,0,2,0.0,2,0,0,0,1,1,21,1,GK,35-39,Goalkeeper,Spain,Europe
1548,Diego López,ESP,Espanyol,La Liga,2021,39.0,1981.0,35.3,0,0,0,0,0,0,2,0.0,2,0,0,0,1,1,21,1,GK,35-39,Goalkeeper,Spain,Europe
1548,Diego López,ESP,Espanyol,La Liga,2021,39.0,1981.0,35.3,0,0,0,0,0,0,2,0.0,2,0,0,0,1,1,21,1,GK,35-39,Goalkeeper,Spain,Europe
1548,Diego López,ESP,Espanyol,La Liga,2021,39.0,1981.0,35.3,0,0,0,0,0,0,2,0.0,2,0,0,0,1,1,21,1,GK,35-39,Goalkeeper,Spain,Europe
1549,Javi López,ESP,Alavés,La Liga,2021,19.0,2002.0,5.1,8,6,6,2,0,4,6,66.7,2,7,1,6,4,12,15,0,DF,Under 20,Defender,Spain,Europe
1549,Javi López,ESP,Alavés,La Liga,2021,19.0,2002.0,5.1,8,6,6,2,0,4,6,66.7,2,7,1,6,4,12,15,0,DF,Under 20,Defender,Spain,Europe
1549,Javi López,ESP,Alavés,La Liga,2021,19.0,2002.0,5.1,8,6,6,2,0,4,6,66.7,2,7,1,6,4,12,15,0,DF,Under 20,Defender,Spain,Europe
1549,Javi López,ESP,Alavés,La Liga,2021,19.0,2002.0,5.1,8,6,6,2,0,4,6,66.7,2,7,1,6,4,12,15,0,DF,Under 20,Defender,Spain,Europe
1551,Pau López,ESP,Marseille,Ligue 1,2021,26.0,1994.0,29.0,0,0,0,0,0,0,1,0.0,1,0,0,0,0,0,12,1,GK,25-29,Goalkeeper,Spain,Europe
1552,Unai López,ESP,Rayo Vallecano,La Liga,2021,25.0,1995.0,12.9,19,9,6,10,3,10,33,30.3,23,7,0,7,10,29,8,1,MF,25-29,Midfielder,Spain,Europe
1557,Marcel Lotka,POL,Hertha BSC,Bundesliga,2021,20.0,2001.0,9.8,1,0,1,0,0,1,1,100.0,0,0,0,0,1,2,3,3,GK,20-24,Goalkeeper,Poland,Europe
1566,Anthony Lozano,HON,Cádiz,La Liga,2021,28.0,1993.0,18.6,8,4,2,3,3,5,18,27.8,13,16,2,14,2,10,7,0,"FW,MF",25-29,Forward,Honduras,North America
1571,José Luis Gayà,ESP,Valencia,La Liga,2021,26.0,1995.0,20.8,35,21,24,10,1,16,34,47.1,18,17,3,14,19,54,37,0,DF,25-29,Defender,Spain,Europe
1572,José Luis Morales,ESP,Levante,La Liga,2021,34.0,1987.0,30.2,27,17,6,9,12,12,42,28.6,30,29,0,29,4,31,7,0,"FW,MF",30-34,Forward,Spain,Europe
1574,Luismi,ESP,Sevilla,La Liga,2021,20.0,2001.0,0.1,0,0,0,0,0,0,0,,0,0,0,0,0,0,0,0,"FW,MF",20-24,Forward,Spain,Europe
1580,Saša Lukić,SRB,Torino,Serie A,2021,24.0,1996.0,33.1,51,34,17,27,7,19,43,44.2,24,34,6,28,24,75,41,0,MF,20-24,Midfielder,Serbia,Europe
1595,Pablo Maffeo,ESP,Mallorca,La Liga,2021,24.0,1997.0,32.7,84,47,48,28,8,38,69,55.1,31,30,13,17,46,130,74,0,DF,20-24,Defender,Spain,Europe
1617,Nemanja Maksimović,SRB,Getafe,La Liga,2021,26.0,1995.0,32.6,56,32,24,26,6,18,49,36.7,31,42,13,29,71,127,41,0,MF,25-29,Midfielder,Serbia,Europe
1618,Nikola Maksimović,SRB,Genoa,Serie A,2021,29.0,1991.0,12.4,14,6,10,4,0,7,9,77.8,2,17,11,6,12,26,61,1,DF,25-29,Defender,Serbia,Europe
1624,Hugo Mallo,ESP,Celta Vigo,La Liga,2021,30.0,1991.0,20.3,45,25,24,19,2,16,31,51.6,15,23,9,14,20,65,53,0,DF,30-34,Defender,Spain,Europe
1645,Javier Manquillo,ESP,Newcastle Utd,Premier League,2021,27.0,1994.0,14.0,39,29,28,10,1,21,36,58.3,15,15,6,9,10,49,32,0,DF,25-29,Defender,Spain,Europe
1646,Myziane Maolida,COM,Nice,Ligue 1,2021,22.0,1999.0,0.4,1,0,0,1,0,0,0,,0,1,0,1,0,1,0,0,MF,20-24,Midfielder,Comoros,Africa
1647,Myziane Maolida,COM,Hertha BSC,Bundesliga,2021,22.0,1999.0,8.6,7,4,5,1,1,3,9,33.3,6,5,0,5,1,8,6,0,"FW,MF",20-24,Forward,Comoros,Africa
1649,Nikola Maraš,SRB,Rayo Vallecano,La Liga,2021,25.0,1995.0,11.6,13,9,12,1,0,9,15,60.0,6,17,13,4,15,28,51,0,DF,25-29,Defender,Serbia,Europe
1658,Óscar de Marcos,ESP,Athletic Club,La Liga,2021,32.0,1989.0,18.7,50,37,24,19,7,28,43,65.1,15,20,3,17,19,69,27,0,DF,30-34,Defender,Spain,Europe
1660,José Mari,ESP,Cádiz,La Liga,2021,33.0,1987.0,4.3,14,7,3,10,1,7,8,87.5,1,4,1,3,7,21,2,0,MF,30-34,Midfielder,Spain,Europe
1661,Pablo Marí,ESP,Arsenal,Premier League,2021,27.0,1993.0,2.0,5,3,1,3,1,3,6,50.0,3,5,4,1,3,8,10,0,DF,25-29,Defender,Spain,Europe
1662,Pablo Marí,ESP,Udinese,Serie A,2021,27.0,1993.0,14.9,16,8,8,6,2,8,16,50.0,8,18,12,6,21,37,72,0,DF,25-29,Defender,Spain,Europe
1667,Mika Màrmol,ESP,Barcelona,La Liga,2021,19.0,2002.0,0.0,0,0,0,0,0,0,0,,0,0,0,0,0,0,0,0,DF,Under 20,Defender,Spain,Europe
1671,Roger Martí,ESP,Levante,La Liga,2021,30.0,1991.0,23.5,23,14,3,13,7,8,30,26.7,22,14,0,14,2,25,8,0,FW,30-34,Forward,Spain,Europe
1674,Martín,ESP,Cádiz,La Liga,2021,22.0,1999.0,1.3,2,2,0,2,0,0,0,,0,1,0,1,1,3,3,0,MF,20-24,Midfielder,Spain,Europe
1675,Aarón Martín,ESP,Mainz 05,Bundesliga,2021,24.0,1997.0,25.5,54,33,32,18,4,24,55,43.6,31,24,4,20,20,74,35,0,DF,20-24,Defender,Spain,Europe
1676,Ander Martin,ESP,Real Sociedad,La Liga,2021,20.0,2000.0,1.0,1,0,0,1,0,1,1,100.0,0,0,0,0,3,4,1,0,"FW,MF",20-24,Forward,Spain,Europe
1677,Andrés Martín,ESP,Rayo Vallecano,La Liga,2021,22.0,1999.0,2.1,0,0,0,0,0,0,1,0.0,1,1,0,1,0,0,0,0,"FW,MF",20-24,Forward,Spain,Europe
1678,Carlos Martín,ESP,Atlético Madrid,La Liga,2021,19.0,2002.0,0.1,0,0,0,0,0,0,0,,0,0,0,0,0,0,1,0,DF,Under 20,Defender,Spain,Europe
1679,Iván Martín,ESP,Alavés,La Liga,2021,22.0,1999.0,1.8,1,1,1,0,0,0,1,0.0,1,2,0,2,1,2,1,0,"MF,FW",20-24,Midfielder,Spain,Europe
1683,Iñigo Martínez,ESP,Athletic Club,La Liga,2021,30.0,1991.0,26.0,28,13,18,7,3,14,23,60.9,9,22,10,12,39,67,143,0,DF,30-34,Defender,Spain,Europe
1684,Javi Martínez,ESP,Osasuna,La Liga,2021,21.0,1999.0,9.8,21,14,8,11,2,10,29,34.5,19,6,0,6,9,30,10,0,"MF,FW",20-24,Midfielder,Spain,Europe
1684,Javi Martínez,ESP,Osasuna,La Liga,2021,21.0,1999.0,9.8,21,14,8,11,2,10,29,34.5,19,6,0,6,9,30,10,0,"MF,FW",20-24,Midfielder,Spain,Europe
1684,Javi Martínez,ESP,Osasuna,La Liga,2021,21.0,1999.0,9.8,21,14,8,11,2,10,29,34.5,19,6,0,6,9,30,10,0,"MF,FW",20-24,Midfielder,Spain,Europe
1684,Javi Martínez,ESP,Osasuna,La Liga,2021,21.0,1999.0,9.8,21,14,8,11,2,10,29,34.5,19,6,0,6,9,30,10,0,"MF,FW",20-24,Midfielder,Spain,Europe
1685,Josep Martinez,ESP,RB Leipzig,Bundesliga,2021,23.0,1998.0,1.0,0,0,0,0,0,0,0,,0,0,0,0,0,0,0,0,GK,20-24,Goalkeeper,Spain,Europe
1687,Pablo Martínez,ESP,Levante,La Liga,2021,23.0,1998.0,7.3,15,8,7,8,0,4,13,30.8,9,6,3,3,15,30,5,0,MF,20-24,Midfielder,Spain,Europe
1687,Pablo Martínez,ESP,Levante,La Liga,2021,23.0,1998.0,7.3,15,8,7,8,0,4,13,30.8,9,6,3,3,15,30,5,0,MF,20-24,Midfielder,Spain,Europe
1687,Pablo Martínez,ESP,Levante,La Liga,2021,23.0,1998.0,7.3,15,8,7,8,0,4,13,30.8,9,6,3,3,15,30,5,0,MF,20-24,Midfielder,Spain,Europe
1687,Pablo Martínez,ESP,Levante,La Liga,2021,23.0,1998.0,7.3,15,8,7,8,0,4,13,30.8,9,6,3,3,15,30,5,0,MF,20-24,Midfielder,Spain,Europe
1694,Erhan Mašović,SRB,Bochum,Bundesliga,2021,22.0,1998.0,17.2,35,20,21,13,1,21,33,63.6,12,28,19,9,34,69,64,1,DF,20-24,Defender,Serbia,Europe
1697,Jaime Mata,ESP,Getafe,La Liga,2021,32.0,1988.0,7.5,7,5,3,1,3,1,9,11.1,8,4,1,3,1,8,5,0,FW,30-34,Forward,Spain,Europe
1698,Juan Mata,ESP,Manchester Utd,Premier League,2021,33.0,1988.0,2.6,6,4,2,3,1,3,5,60.0,2,1,0,1,1,7,1,0,MF,30-34,Midfielder,Spain,Europe
1701,Aleš Matějů,CZE,Venezia,Serie A,2021,25.0,1996.0,8.1,16,12,10,5,1,13,29,44.8,16,10,6,4,9,25,15,0,DF,25-29,Defender,Czech Republic,Europe
1703,Nemanja Matić,SRB,Manchester Utd,Premier League,2021,32.0,1988.0,15.4,31,18,19,11,1,15,31,48.4,16,21,6,15,31,62,21,3,MF,30-34,Midfielder,Serbia,Europe
1712,Borja Mayoral,ESP,Roma,Serie A,2021,24.0,1997.0,1.1,0,0,0,0,0,0,0,,0,0,0,0,0,0,0,0,"FW,DF",20-24,Forward,Spain,Europe
1713,Borja Mayoral,ESP,Getafe,La Liga,2021,24.0,1997.0,11.6,7,5,2,3,2,1,2,50.0,1,10,4,6,4,11,3,0,FW,20-24,Forward,Spain,Europe
1723,Jordi Mboula,ESP,Mallorca,La Liga,2021,22.0,1999.0,4.8,8,2,3,3,2,5,9,55.6,4,7,1,6,3,11,3,0,FW,20-24,Forward,Spain,Europe
1745,Óscar Melendo,ESP,Espanyol,La Liga,2021,23.0,1997.0,11.0,11,5,4,4,3,3,13,23.1,10,4,1,3,1,12,10,0,"MF,FW",20-24,Midfielder,Spain,Europe
1746,Gonzalo Melero,ESP,Levante,La Liga,2021,27.0,1994.0,18.8,29,16,10,15,4,16,36,44.4,20,21,8,13,7,36,22,0,MF,25-29,Midfielder,Spain,Europe
1747,Birger Meling,NOR,Rennes,Ligue 1,2021,26.0,1994.0,20.3,43,27,25,11,7,23,31,74.2,8,23,7,16,22,65,40,0,DF,25-29,Defender,Norway,Europe
1754,Tomás Mendes,ESP,Alavés,La Liga,2021,16.0,2004.0,0.1,0,0,0,0,0,0,0,,0,0,0,0,0,0,1,0,MF,Under 20,Midfielder,Spain,Europe
1755,Brais Méndez,ESP,Celta Vigo,La Liga,2021,24.0,1997.0,33.6,68,35,24,35,9,26,87,29.9,61,52,6,46,37,105,30,0,MF,20-24,Midfielder,Spain,Europe
1756,Édgar Méndez,ESP,Alavés,La Liga,2021,31.0,1990.0,17.9,25,14,11,10,4,11,34,32.4,23,16,0,16,4,29,17,0,"FW,MF",30-34,Forward,Spain,Europe
1764,Jorge Meré,ESP,Köln,Bundesliga,2021,24.0,1997.0,5.4,9,6,3,6,0,4,7,57.1,3,6,4,2,10,19,19,0,DF,20-24,Defender,Spain,Europe
1766,Fran Mérida,ESP,Espanyol,La Liga,2021,31.0,1990.0,3.0,7,3,5,2,0,4,10,40.0,6,1,0,1,6,13,1,0,MF,30-34,Midfielder,Spain,Europe
1767,Mikel Merino,ESP,Real Sociedad,La Liga,2021,25.0,1996.0,32.1,71,38,21,40,10,26,67,38.8,41,50,10,40,21,92,56,2,MF,25-29,Midfielder,Spain,Europe
1769,Martín Merquelanz,ESP,Rayo Vallecano,La Liga,2021,26.0,1995.0,1.9,2,1,2,0,0,2,6,33.3,4,2,0,2,0,2,1,0,"FW,MF",25-29,Forward,Spain,Europe
1782,Miguel,ESP,Alavés,La Liga,2021,21.0,1999.0,9.2,7,3,1,5,1,2,15,13.3,13,6,0,6,1,8,7,0,"FW,MF",20-24,Forward,Spain,Europe
1788,Nikola Milenković,SRB,Fiorentina,Serie A,2021,23.0,1997.0,32.5,54,32,31,20,3,29,34,85.3,5,30,15,15,39,93,94,0,DF,20-24,Defender,Serbia,Europe
1789,Arkadiusz Milik,POL,Marseille,Ligue 1,2021,27.0,1994.0,15.7,9,2,0,5,4,4,18,22.2,14,9,1,8,3,12,10,1,FW,25-29,Forward,Poland,Europe
1790,Sergej Milinković-Savić,SRB,Lazio,Serie A,2021,26.0,1995.0,34.4,67,44,20,32,15,29,67,43.3,38,50,9,41,34,101,43,1,MF,25-29,Midfielder,Serbia,Europe
1791,Vanja Milinković-Savić,SRB,Torino,Serie A,2021,24.0,1997.0,27.0,0,0,0,0,0,0,1,0.0,1,0,0,0,0,0,7,2,GK,20-24,Goalkeeper,Serbia,Europe
1793,Luka Milivojević,SRB,Crystal Palace,Premier League,2021,30.0,1991.0,8.6,18,9,9,6,3,10,16,62.5,6,6,1,5,11,29,15,0,MF,30-34,Midfielder,Serbia,Europe
1794,Luis Milla,ESP,Granada,La Liga,2021,26.0,1994.0,30.8,59,29,25,30,4,25,64,39.1,39,28,4,24,25,84,34,0,MF,25-29,Midfielder,Spain,Europe
1795,Pere Milla,ESP,Elche,La Liga,2021,28.0,1992.0,18.3,20,15,14,5,1,8,44,18.2,36,21,1,20,5,25,21,0,"MF,FW",25-29,Midfielder,Spain,Europe
1798,Santi Mina,ESP,Celta Vigo,La Liga,2021,25.0,1995.0,26.3,27,17,8,15,4,5,32,15.6,27,28,2,26,6,33,22,0,FW,25-29,Forward,Spain,Europe
1802,Óscar Mingueza,ESP,Barcelona,La Liga,2021,22.0,1999.0,9.9,25,11,12,11,2,16,23,69.6,7,5,0,5,9,34,22,1,DF,20-24,Defender,Spain,Europe
1803,Rafa Mir,ESP,Sevilla,La Liga,2021,24.0,1997.0,20.1,4,3,1,1,2,0,11,0.0,11,4,3,1,0,4,17,0,FW,20-24,Forward,Spain,Europe
1804,Jorge Miramón,ESP,Levante,La Liga,2021,32.0,1989.0,22.0,36,19,16,12,8,15,44,34.1,29,15,3,12,35,71,58,0,DF,30-34,Defender,Spain,Europe
1806,Juan Miranda,ESP,Betis,La Liga,2021,21.0,2000.0,8.7,21,11,16,4,1,12,22,54.5,10,10,4,6,15,36,22,0,DF,20-24,Defender,Spain,Europe
1809,Stefan Mitrović,SRB,Getafe,La Liga,2021,31.0,1990.0,29.6,16,8,12,4,0,8,13,61.5,5,28,18,10,22,38,114,1,DF,30-34,Defender,Serbia,Europe
1812,Jakub Moder,POL,Brighton,Premier League,2021,22.0,1999.0,18.9,42,25,18,17,7,23,42,54.8,19,25,2,23,10,52,22,1,MF,20-24,Midfielder,Poland,Europe
1821,Jorge Molina,ESP,Granada,La Liga,2021,39.0,1982.0,21.8,4,2,2,1,1,2,18,11.1,16,13,2,11,6,10,11,0,FW,35-39,Forward,Spain,Europe
1825,Jon Moncayola,ESP,Osasuna,La Liga,2021,23.0,1998.0,32.4,40,20,18,18,4,17,44,38.6,27,26,9,17,20,60,43,0,MF,20-24,Midfielder,Spain,Europe
1826,Monchu,ESP,Granada,La Liga,2021,21.0,1999.0,7.4,15,6,5,9,1,5,10,50.0,5,8,3,5,4,19,4,0,MF,20-24,Midfielder,Spain,Europe
1830,Ángel Montoro,ESP,Granada,La Liga,2021,33.0,1988.0,14.8,26,13,16,7,3,17,27,63.0,10,11,1,10,11,37,29,1,MF,30-34,Midfielder,Spain,Europe
1831,Martín Montoya,ESP,Betis,La Liga,2021,30.0,1991.0,5.8,20,12,11,7,2,15,26,57.7,11,6,0,6,11,31,20,0,DF,30-34,Defender,Spain,Europe
1833,Álvaro Morata,ESP,Juventus,Serie A,2021,28.0,1992.0,25.6,18,9,4,9,5,8,31,25.8,23,26,1,25,5,23,24,0,FW,25-29,Forward,Spain,Europe
1834,Jan Morávek,CZE,Augsburg,Bundesliga,2021,31.0,1989.0,5.2,11,6,3,7,1,6,18,33.3,12,11,2,9,6,17,8,0,MF,30-34,Midfielder,Czech Republic,Europe
1835,Jon Morcillo,ESP,Athletic Club,La Liga,2021,22.0,1998.0,0.6,3,0,1,2,0,3,4,75.0,1,1,0,1,0,3,0,0,"MF,FW",20-24,Midfielder,Spain,Europe
1837,Alberto Moreno,ESP,Villarreal,La Liga,2021,29.0,1992.0,13.6,13,7,5,7,1,5,18,27.8,13,13,1,12,27,40,15,0,"MF,DF",25-29,Midfielder,Spain,Europe
1837,Alberto Moreno,ESP,Villarreal,La Liga,2021,29.0,1992.0,13.6,13,7,5,7,1,5,18,27.8,13,13,1,12,27,40,15,0,"MF,DF",25-29,Midfielder,Spain,Europe
1837,Alberto Moreno,ESP,Villarreal,La Liga,2021,29.0,1992.0,13.6,13,7,5,7,1,5,18,27.8,13,13,1,12,27,40,15,0,"MF,DF",25-29,Midfielder,Spain,Europe
1837,Alberto Moreno,ESP,Villarreal,La Liga,2021,29.0,1992.0,13.6,13,7,5,7,1,5,18,27.8,13,13,1,12,27,40,15,0,"MF,DF",25-29,Midfielder,Spain,Europe
1838,Álex Moreno,ESP,Betis,La Liga,2021,28.0,1993.0,26.7,76,40,53,15,8,33,60,55.0,27,28,6,22,34,110,82,1,DF,25-29,Defender,Spain,Europe
1839,Gerard Moreno,ESP,Villarreal,La Liga,2021,29.0,1992.0,13.2,5,2,2,2,1,1,7,14.3,6,6,1,5,6,11,14,0,FW,25-29,Forward,Spain,Europe
1840,Tete Morente,ESP,Elche,La Liga,2021,24.0,1996.0,18.1,21,14,13,7,1,7,28,25.0,21,30,1,29,12,33,12,0,MF,20-24,Midfielder,Spain,Europe
1843,Manu Morlanes,ESP,Espanyol,La Liga,2021,22.0,1999.0,12.7,36,15,16,17,3,18,43,41.9,25,24,5,19,13,49,17,0,MF,20-24,Midfielder,Spain,Europe
1844,Raúl Moro,ESP,Lazio,Serie A,2021,18.0,2002.0,2.2,3,3,0,2,1,1,5,20.0,4,2,0,2,0,3,0,0,FW,Under 20,Forward,Spain,Europe
1845,Loren Morón,ESP,Espanyol,La Liga,2021,27.0,1993.0,6.3,6,4,1,3,2,0,12,0.0,12,11,1,10,2,8,9,0,"FW,MF",25-29,Forward,Spain,Europe
1846,Loren Morón,ESP,Betis,La Liga,2021,27.0,1993.0,0.0,1,1,1,0,0,1,1,100.0,0,0,0,0,0,1,0,0,FW,25-29,Forward,Spain,Europe
1848,Cristhian Mosquera,ESP,Valencia,La Liga,2021,17.0,2004.0,2.4,4,2,3,0,1,3,6,50.0,3,1,0,1,3,7,1,1,DF,Under 20,Defender,Spain,Europe
1863,Toni Moya,ESP,Alavés,La Liga,2021,23.0,1998.0,15.4,23,10,7,13,3,13,43,30.2,30,18,5,13,20,43,18,0,MF,20-24,Midfielder,Spain,Europe
1871,Iker Muniain,ESP,Athletic Club,La Liga,2021,28.0,1992.0,30.9,32,10,8,19,5,12,40,30.0,28,20,1,19,17,49,8,1,MF,25-29,Midfielder,Spain,Europe
1872,Aihen Muñoz,ESP,Real Sociedad,La Liga,2021,23.0,1997.0,14.9,28,17,14,13,1,18,29,62.1,11,11,1,10,17,45,34,0,DF,20-24,Defender,Spain,Europe
1892,Nacho,ESP,Real Madrid,La Liga,2021,31.0,1990.0,17.3,18,14,9,9,0,12,22,54.5,10,22,15,7,34,52,50,0,DF,30-34,Defender,Spain,Europe
1899,Matija Nastasić,SRB,Fiorentina,Serie A,2021,28.0,1993.0,2.4,1,1,1,0,0,1,1,100.0,0,1,1,0,5,6,11,0,DF,25-29,Defender,Serbia,Europe
1900,Roberto Navarro,ESP,Real Sociedad,La Liga,2021,19.0,2002.0,2.2,5,3,1,1,3,3,5,60.0,2,2,0,2,2,7,2,0,"MF,FW",Under 20,Midfielder,Spain,Europe
1901,Ximo Navarro,ESP,Alavés,La Liga,2021,31.0,1990.0,15.0,28,19,21,6,1,13,27,48.1,14,11,5,6,22,50,56,2,DF,30-34,Defender,Spain,Europe
1901,Ximo Navarro,ESP,Alavés,La Liga,2021,31.0,1990.0,15.0,28,19,21,6,1,13,27,48.1,14,11,5,6,22,50,56,2,DF,30-34,Defender,Spain,Europe
1901,Ximo Navarro,ESP,Alavés,La Liga,2021,31.0,1990.0,15.0,28,19,21,6,1,13,27,48.1,14,11,5,6,22,50,56,2,DF,30-34,Defender,Spain,Europe
1901,Ximo Navarro,ESP,Alavés,La Liga,2021,31.0,1990.0,15.0,28,19,21,6,1,13,27,48.1,14,11,5,6,22,50,56,2,DF,30-34,Defender,Spain,Europe
1902,Jesús Navas,ESP,Sevilla,La Liga,2021,35.0,1985.0,19.8,18,13,11,5,2,9,17,52.9,8,15,2,13,17,35,26,1,DF,35-39,Defender,Spain,Europe
1910,Álvaro Negredo,ESP,Cádiz,La Liga,2021,35.0,1985.0,24.0,5,3,1,4,0,3,6,50.0,3,11,5,6,2,7,23,0,FW,35-39,Forward,Spain,Europe
1919,Carlos Neva,ESP,Granada,La Liga,2021,25.0,1996.0,23.4,31,19,24,7,0,16,28,57.1,12,27,9,18,32,63,81,0,DF,25-29,Defender,Spain,Europe
1934,Håvard Nielsen,NOR,Greuther Fürth,Bundesliga,2021,28.0,1993.0,15.2,17,12,5,11,1,8,21,38.1,13,18,1,17,7,24,22,0,"MF,FW",25-29,Midfielder,Norway,Europe
1935,Saúl Ñíguez,ESP,Chelsea,Premier League,2021,26.0,1994.0,5.3,20,9,11,9,0,9,16,56.3,7,14,3,11,7,27,10,1,"DF,MF",25-29,Defender,Spain,Europe
1936,Saúl Ñíguez,ESP,Atlético Madrid,La Liga,2021,26.0,1994.0,2.2,7,2,0,6,1,3,4,75.0,1,7,1,6,0,7,3,0,"FW,MF",25-29,Forward,Spain,Europe
1940,Fernando Niño,ESP,Mallorca,La Liga,2021,20.0,2000.0,9.8,10,4,3,2,5,2,12,16.7,10,9,2,7,3,13,15,0,FW,20-24,Forward,Spain,Europe
1947,Peru Nolaskoain,ESP,Athletic Club,La Liga,2021,22.0,1998.0,0.0,0,0,0,0,0,0,0,,0,0,0,0,0,0,0,0,DF,20-24,Defender,Spain,Europe
1948,Nolito,ESP,Celta Vigo,La Liga,2021,34.0,1986.0,15.4,25,15,14,7,4,13,47,27.7,34,20,1,19,9,34,5,0,MF,30-34,Midfielder,Spain,Europe
1950,Håvard Nordtveit,NOR,Hoffenheim,Bundesliga,2021,31.0,1990.0,3.4,7,6,2,4,1,4,4,100.0,0,2,1,1,10,17,11,0,DF,30-34,Defender,Norway,Europe
1951,Mathias Normann,NOR,Norwich City,Premier League,2021,25.0,1996.0,18.3,34,21,19,14,1,17,46,37.0,29,17,8,9,19,53,43,1,MF,25-29,Midfielder,Norway,Europe
1953,Hugo Novoa,ESP,RB Leipzig,Bundesliga,2021,18.0,2003.0,1.5,4,4,2,0,2,2,7,28.6,5,2,0,2,1,5,0,0,"MF,FW",Under 20,Midfielder,Spain,Europe
1959,Unai Núñez,ESP,Athletic Club,La Liga,2021,24.0,1997.0,6.9,4,4,2,2,0,3,6,50.0,3,9,8,1,8,12,26,2,DF,20-24,Defender,Spain,Europe
1969,Jan Oblak,SVN,Atlético Madrid,La Liga,2021,28.0,1993.0,38.0,0,0,0,0,0,0,0,,0,0,0,0,1,1,10,4,GK,25-29,Goalkeeper,Slovenia,Europe
1973,Álvaro Odriozola,ESP,Fiorentina,Serie A,2021,25.0,1995.0,19.3,25,15,12,6,7,15,32,46.9,17,17,6,11,8,33,25,2,DF,25-29,Defender,Spain,Europe
1980,Oier Olazábal,ESP,Espanyol,La Liga,2021,31.0,1989.0,1.5,0,0,0,0,0,0,0,,0,0,0,0,0,0,0,0,GK,30-34,Goalkeeper,Spain,Europe
1984,Brian Oliván,ESP,Mallorca,La Liga,2021,27.0,1994.0,24.3,33,20,22,9,2,12,23,52.2,11,17,7,10,28,61,63,0,DF,25-29,Defender,Spain,Europe
1987,Dani Olmo,ESP,RB Leipzig,Bundesliga,2021,23.0,1998.0,8.3,14,6,5,7,2,5,18,27.8,13,5,1,4,4,18,1,0,"MF,FW",20-24,Midfielder,Spain,Europe
1989,Warmed Omari,COM,Rennes,Ligue 1,2021,21.0,2000.0,31.1,33,17,22,10,1,15,23,65.2,8,20,13,7,31,64,94,5,DF,20-24,Defender,Comoros,Africa
1995,Javier Ontiveros,ESP,Osasuna,La Liga,2021,23.0,1997.0,0.4,0,0,0,0,0,0,2,0.0,2,0,0,0,1,1,0,1,"FW,MF",20-24,Forward,Spain,Europe
2002,Pedro Ortiz,ESP,Sevilla,La Liga,2021,20.0,2000.0,0.1,0,0,0,0,0,0,0,,0,0,0,0,0,0,1,0,MF,20-24,Midfielder,Spain,Europe
2007,Tomáš Ostrák,CZE,Köln,Bundesliga,2021,21.0,2000.0,0.3,1,0,0,0,1,1,3,33.3,2,0,0,0,1,2,0,0,"MF,FW",20-24,Midfielder,Czech Republic,Europe
2018,Mikel Oyarzabal,ESP,Real Sociedad,La Liga,2021,24.0,1997.0,18.6,18,10,7,7,4,7,21,33.3,14,18,2,16,10,28,16,1,"FW,MF",20-24,Forward,Spain,Europe
2022,Fernando Pacheco,ESP,Alavés,La Liga,2021,29.0,1992.0,33.9,2,1,2,0,0,2,2,100.0,0,0,0,0,0,2,18,1,GK,25-29,Goalkeeper,Spain,Europe
2022,Fernando Pacheco,ESP,Alavés,La Liga,2021,29.0,1992.0,33.9,2,1,2,0,0,2,2,100.0,0,0,0,0,0,2,18,1,GK,25-29,Goalkeeper,Spain,Europe
2022,Fernando Pacheco,ESP,Alavés,La Liga,2021,29.0,1992.0,33.9,2,1,2,0,0,2,2,100.0,0,0,0,0,0,2,18,1,GK,25-29,Goalkeeper,Spain,Europe
2022,Fernando Pacheco,ESP,Alavés,La Liga,2021,29.0,1992.0,33.9,2,1,2,0,0,2,2,100.0,0,0,0,0,0,2,18,1,GK,25-29,Goalkeeper,Spain,Europe
2023,Jon Pacheco,ESP,Real Sociedad,La Liga,2021,20.0,2001.0,4.2,6,4,4,2,0,3,3,100.0,0,6,4,2,6,12,18,0,DF,20-24,Defender,Spain,Europe
2030,Isaac Palazón Camacho,ESP,Rayo Vallecano,La Liga,2021,26.0,1994.0,25.4,42,28,20,19,3,18,59,30.5,41,31,3,28,13,55,22,0,"FW,MF",25-29,Forward,Spain,Europe
2036,Martin Palumbo,NOR,Juventus,Serie A,2021,19.0,2002.0,0.1,0,0,0,0,0,0,1,0.0,1,0,0,0,0,0,0,0,FW,Under 20,Forward,Norway,Europe
2039,Miloš Pantović,SRB,Bochum,Bundesliga,2021,25.0,1996.0,17.0,19,10,8,7,4,6,25,24.0,19,26,4,22,18,37,14,0,"MF,FW",25-29,Midfielder,Serbia,Europe
2043,Rubén Pardo,ESP,Bordeaux,Ligue 1,2021,28.0,1992.0,0.1,0,0,0,0,0,0,0,,0,0,0,0,0,0,0,0,MF,25-29,Midfielder,Spain,Europe
2046,Daniel Parejo,ESP,Villarreal,La Liga,2021,32.0,1989.0,30.0,43,29,15,15,13,20,52,38.5,32,32,7,25,29,72,19,1,MF,30-34,Midfielder,Spain,Europe
2048,Raúl Parra,ESP,Cádiz,La Liga,2021,21.0,1999.0,1.0,2,1,2,0,0,1,3,33.3,2,0,0,0,0,2,5,0,DF,20-24,Defender,Spain,Europe
2049,Thomas Partey,GHA,Arsenal,Premier League,2021,28.0,1993.0,22.5,43,29,22,17,4,18,44,40.9,26,22,4,18,23,66,35,2,MF,25-29,Midfielder,Ghana,Africa
2050,Mario Pašalić,CRO,Atalanta,Serie A,2021,26.0,1995.0,22.2,27,12,8,13,6,12,30,40.0,18,27,6,21,20,47,14,0,"MF,FW",25-29,Midfielder,Croatia,Europe
2051,Felix Passlack,GER,Dortmund,Bundesliga,2021,23.0,1998.0,5.2,13,9,8,4,1,6,12,50.0,6,5,1,4,4,17,7,0,DF,20-24,Defender,Germany,Europe
2052,Javier Pastore,ARG,Elche,La Liga,2021,32.0,1989.0,5.8,7,3,3,2,2,3,12,25.0,9,5,1,4,4,11,2,0,"MF,FW",30-34,Midfielder,Argentina,South America
2054,Rui Patrício,POR,Roma,Serie A,2021,33.0,1988.0,38.0,0,0,0,0,0,0,0,,0,1,0,1,0,0,10,3,GK,30-34,Goalkeeper,Portugal,Europe
2055,Paulinho,BRA,Leverkusen,Bundesliga,2021,21.0,2000.0,13.5,22,13,6,13,3,13,27,48.1,14,14,1,13,6,28,7,0,"FW,MF",20-24,Forward,Brazil,South America
2055,Paulinho,BRA,Leverkusen,Bundesliga,2021,21.0,2000.0,13.5,22,13,6,13,3,13,27,48.1,14,14,1,13,6,28,7,0,"FW,MF",20-24,Forward,Brazil,South America
2055,Paulinho,BRA,Leverkusen,Bundesliga,2021,21.0,2000.0,13.5,22,13,6,13,3,13,27,48.1,14,14,1,13,6,28,7,0,"FW,MF",20-24,Forward,Brazil,South America
2055,Paulinho,BRA,Leverkusen,Bundesliga,2021,21.0,2000.0,13.5,22,13,6,13,3,13,27,48.1,14,14,1,13,6,28,7,0,"FW,MF",20-24,Forward,Brazil,South America
2055,Paulinho,BRA,Leverkusen,Bundesliga,2021,21.0,2000.0,13.5,22,13,6,13,3,13,27,48.1,14,14,1,13,6,28,7,0,"FW,MF",20-24,Forward,Brazil,South America
2055,Paulinho,BRA,Leverkusen,Bundesliga,2021,21.0,2000.0,13.5,22,13,6,13,3,13,27,48.1,14,14,1,13,6,28,7,0,"FW,MF",20-24,Forward,Brazil,South America
2055,Paulinho,BRA,Leverkusen,Bundesliga,2021,21.0,2000.0,13.5,22,13,6,13,3,13,27,48.1,14,14,1,13,6,28,7,0,"FW,MF",20-24,Forward,Brazil,South America
2055,Paulinho,BRA,Leverkusen,Bundesliga,2021,21.0,2000.0,13.5,22,13,6,13,3,13,27,48.1,14,14,1,13,6,28,7,0,"FW,MF",20-24,Forward,Brazil,South America
2055,Paulinho,BRA,Leverkusen,Bundesliga,2021,21.0,2000.0,13.5,22,13,6,13,3,13,27,48.1,14,14,1,13,6,28,7,0,"FW,MF",20-24,Forward,Brazil,South America
2055,Paulinho,BRA,Leverkusen,Bundesliga,2021,21.0,2000.0,13.5,22,13,6,13,3,13,27,48.1,14,14,1,13,6,28,7,0,"FW,MF",20-24,Forward,Brazil,South America
2055,Paulinho,BRA,Leverkusen,Bundesliga,2021,21.0,2000.0,13.5,22,13,6,13,3,13,27,48.1,14,14,1,13,6,28,7,0,"FW,MF",20-24,Forward,Brazil,South America
2055,Paulinho,BRA,Leverkusen,Bundesliga,2021,21.0,2000.0,13.5,22,13,6,13,3,13,27,48.1,14,14,1,13,6,28,7,0,"FW,MF",20-24,Forward,Brazil,South America
2055,Paulinho,BRA,Leverkusen,Bundesliga,2021,21.0,2000.0,13.5,22,13,6,13,3,13,27,48.1,14,14,1,13,6,28,7,0,"FW,MF",20-24,Forward,Brazil,South America
2055,Paulinho,BRA,Leverkusen,Bundesliga,2021,21.0,2000.0,13.5,22,13,6,13,3,13,27,48.1,14,14,1,13,6,28,7,0,"FW,MF",20-24,Forward,Brazil,South America
2055,Paulinho,BRA,Leverkusen,Bundesliga,2021,21.0,2000.0,13.5,22,13,6,13,3,13,27,48.1,14,14,1,13,6,28,7,0,"FW,MF",20-24,Forward,Brazil,South America
2055,Paulinho,BRA,Leverkusen,Bundesliga,2021,21.0,2000.0,13.5,22,13,6,13,3,13,27,48.1,14,14,1,13,6,28,7,0,"FW,MF",20-24,Forward,Brazil,South America
2055,Paulinho,BRA,Leverkusen,Bundesliga,2021,21.0,2000.0,13.5,22,13,6,13,3,13,27,48.1,14,14,1,13,6,28,7,0,"FW,MF",20-24,Forward,Brazil,South America
2055,Paulinho,BRA,Leverkusen,Bundesliga,2021,21.0,2000.0,13.5,22,13,6,13,3,13,27,48.1,14,14,1,13,6,28,7,0,"FW,MF",20-24,Forward,Brazil,South America
2055,Paulinho,BRA,Leverkusen,Bundesliga,2021,21.0,2000.0,13.5,22,13,6,13,3,13,27,48.1,14,14,1,13,6,28,7,0,"FW,MF",20-24,Forward,Brazil,South America
2055,Paulinho,BRA,Leverkusen,Bundesliga,2021,21.0,2000.0,13.5,22,13,6,13,3,13,27,48.1,14,14,1,13,6,28,7,0,"FW,MF",20-24,Forward,Brazil,South America
2055,Paulinho,BRA,Leverkusen,Bundesliga,2021,21.0,2000.0,13.5,22,13,6,13,3,13,27,48.1,14,14,1,13,6,28,7,0,"FW,MF",20-24,Forward,Brazil,South America
2055,Paulinho,BRA,Leverkusen,Bundesliga,2021,21.0,2000.0,13.5,22,13,6,13,3,13,27,48.1,14,14,1,13,6,28,7,0,"FW,MF",20-24,Forward,Brazil,South America
2055,Paulinho,BRA,Leverkusen,Bundesliga,2021,21.0,2000.0,13.5,22,13,6,13,3,13,27,48.1,14,14,1,13,6,28,7,0,"FW,MF",20-24,Forward,Brazil,South America
2055,Paulinho,BRA,Leverkusen,Bundesliga,2021,21.0,2000.0,13.5,22,13,6,13,3,13,27,48.1,14,14,1,13,6,28,7,0,"FW,MF",20-24,Forward,Brazil,South America
2055,Paulinho,BRA,Leverkusen,Bundesliga,2021,21.0,2000.0,13.5,22,13,6,13,3,13,27,48.1,14,14,1,13,6,28,7,0,"FW,MF",20-24,Forward,Brazil,South America
2055,Paulinho,BRA,Leverkusen,Bundesliga,2021,21.0,2000.0,13.5,22,13,6,13,3,13,27,48.1,14,14,1,13,6,28,7,0,"FW,MF",20-24,Forward,Brazil,South America
2055,Paulinho,BRA,Leverkusen,Bundesliga,2021,21.0,2000.0,13.5,22,13,6,13,3,13,27,48.1,14,14,1,13,6,28,7,0,"FW,MF",20-24,Forward,Brazil,South America
2055,Paulinho,BRA,Leverkusen,Bundesliga,2021,21.0,2000.0,13.5,22,13,6,13,3,13,27,48.1,14,14,1,13,6,28,7,0,"FW,MF",20-24,Forward,Brazil,South America
2055,Paulinho,BRA,Leverkusen,Bundesliga,2021,21.0,2000.0,13.5,22,13,6,13,3,13,27,48.1,14,14,1,13,6,28,7,0,"FW,MF",20-24,Forward,Brazil,South America
2055,Paulinho,BRA,Leverkusen,Bundesliga,2021,21.0,2000.0,13.5,22,13,6,13,3,13,27,48.1,14,14,1,13,6,28,7,0,"FW,MF",20-24,Forward,Brazil,South America
2055,Paulinho,BRA,Leverkusen,Bundesliga,2021,21.0,2000.0,13.5,22,13,6,13,3,13,27,48.1,14,14,1,13,6,28,7,0,"FW,MF",20-24,Forward,Brazil,South America
2055,Paulinho,BRA,Leverkusen,Bundesliga,2021,21.0,2000.0,13.5,22,13,6,13,3,13,27,48.1,14,14,1,13,6,28,7,0,"FW,MF",20-24,Forward,Brazil,South America
2055,Paulinho,BRA,Leverkusen,Bundesliga,2021,21.0,2000.0,13.5,22,13,6,13,3,13,27,48.1,14,14,1,13,6,28,7,0,"FW,MF",20-24,Forward,Brazil,South America
2055,Paulinho,BRA,Leverkusen,Bundesliga,2021,21.0,2000.0,13.5,22,13,6,13,3,13,27,48.1,14,14,1,13,6,28,7,0,"FW,MF",20-24,Forward,Brazil,South America
2055,Paulinho,BRA,Leverkusen,Bundesliga,2021,21.0,2000.0,13.5,22,13,6,13,3,13,27,48.1,14,14,1,13,6,28,7,0,"FW,MF",20-24,Forward,Brazil,South America
2055,Paulinho,BRA,Leverkusen,Bundesliga,2021,21.0,2000.0,13.5,22,13,6,13,3,13,27,48.1,14,14,1,13,6,28,7,0,"FW,MF",20-24,Forward,Brazil,South America
2055,Paulinho,BRA,Leverkusen,Bundesliga,2021,21.0,2000.0,13.5,22,13,6,13,3,13,27,48.1,14,14,1,13,6,28,7,0,"FW,MF",20-24,Forward,Brazil,South America
2055,Paulinho,BRA,Leverkusen,Bundesliga,2021,21.0,2000.0,13.5,22,13,6,13,3,13,27,48.1,14,14,1,13,6,28,7,0,"FW,MF",20-24,Forward,Brazil,South America
2055,Paulinho,BRA,Leverkusen,Bundesliga,2021,21.0,2000.0,13.5,22,13,6,13,3,13,27,48.1,14,14,1,13,6,28,7,0,"FW,MF",20-24,Forward,Brazil,South America
2055,Paulinho,BRA,Leverkusen,Bundesliga,2021,21.0,2000.0,13.5,22,13,6,13,3,13,27,48.1,14,14,1,13,6,28,7,0,"FW,MF",20-24,Forward,Brazil,South America
2055,Paulinho,BRA,Leverkusen,Bundesliga,2021,21.0,2000.0,13.5,22,13,6,13,3,13,27,48.1,14,14,1,13,6,28,7,0,"FW,MF",20-24,Forward,Brazil,South America
2055,Paulinho,BRA,Leverkusen,Bundesliga,2021,21.0,2000.0,13.5,22,13,6,13,3,13,27,48.1,14,14,1,13,6,28,7,0,"FW,MF",20-24,Forward,Brazil,South America
2055,Paulinho,BRA,Leverkusen,Bundesliga,2021,21.0,2000.0,13.5,22,13,6,13,3,13,27,48.1,14,14,1,13,6,28,7,0,"FW,MF",20-24,Forward,Brazil,South America
2055,Paulinho,BRA,Leverkusen,Bundesliga,2021,21.0,2000.0,13.5,22,13,6,13,3,13,27,48.1,14,14,1,13,6,28,7,0,"FW,MF",20-24,Forward,Brazil,South America
2055,Paulinho,BRA,Leverkusen,Bundesliga,2021,21.0,2000.0,13.5,22,13,6,13,3,13,27,48.1,14,14,1,13,6,28,7,0,"FW,MF",20-24,Forward,Brazil,South America
2055,Paulinho,BRA,Leverkusen,Bundesliga,2021,21.0,2000.0,13.5,22,13,6,13,3,13,27,48.1,14,14,1,13,6,28,7,0,"FW,MF",20-24,Forward,Brazil,South America
2055,Paulinho,BRA,Leverkusen,Bundesliga,2021,21.0,2000.0,13.5,22,13,6,13,3,13,27,48.1,14,14,1,13,6,28,7,0,"FW,MF",20-24,Forward,Brazil,South America
2055,Paulinho,BRA,Leverkusen,Bundesliga,2021,21.0,2000.0,13.5,22,13,6,13,3,13,27,48.1,14,14,1,13,6,28,7,0,"FW,MF",20-24,Forward,Brazil,South America
2055,Paulinho,BRA,Leverkusen,Bundesliga,2021,21.0,2000.0,13.5,22,13,6,13,3,13,27,48.1,14,14,1,13,6,28,7,0,"FW,MF",20-24,Forward,Brazil,South America
2055,Paulinho,BRA,Leverkusen,Bundesliga,2021,21.0,2000.0,13.5,22,13,6,13,3,13,27,48.1,14,14,1,13,6,28,7,0,"FW,MF",20-24,Forward,Brazil,South America
2055,Paulinho,BRA,Leverkusen,Bundesliga,2021,21.0,2000.0,13.5,22,13,6,13,3,13,27,48.1,14,14,1,13,6,28,7,0,"FW,MF",20-24,Forward,Brazil,South America
2055,Paulinho,BRA,Leverkusen,Bundesliga,2021,21.0,2000.0,13.5,22,13,6,13,3,13,27,48.1,14,14,1,13,6,28,7,0,"FW,MF",20-24,Forward,Brazil,South America
2055,Paulinho,BRA,Leverkusen,Bundesliga,2021,21.0,2000.0,13.5,22,13,6,13,3,13,27,48.1,14,14,1,13,6,28,7,0,"FW,MF",20-24,Forward,Brazil,South America
2055,Paulinho,BRA,Leverkusen,Bundesliga,2021,21.0,2000.0,13.5,22,13,6,13,3,13,27,48.1,14,14,1,13,6,28,7,0,"FW,MF",20-24,Forward,Brazil,South America
2055,Paulinho,BRA,Leverkusen,Bundesliga,2021,21.0,2000.0,13.5,22,13,6,13,3,13,27,48.1,14,14,1,13,6,28,7,0,"FW,MF",20-24,Forward,Brazil,South America
2055,Paulinho,BRA,Leverkusen,Bundesliga,2021,21.0,2000.0,13.5,22,13,6,13,3,13,27,48.1,14,14,1,13,6,28,7,0,"FW,MF",20-24,Forward,Brazil,South America
2055,Paulinho,BRA,Leverkusen,Bundesliga,2021,21.0,2000.0,13.5,22,13,6,13,3,13,27,48.1,14,14,1,13,6,28,7,0,"FW,MF",20-24,Forward,Brazil,South America
2055,Paulinho,BRA,Leverkusen,Bundesliga,2021,21.0,2000.0,13.5,22,13,6,13,3,13,27,48.1,14,14,1,13,6,28,7,0,"FW,MF",20-24,Forward,Brazil,South America
2055,Paulinho,BRA,Leverkusen,Bundesliga,2021,21.0,2000.0,13.5,22,13,6,13,3,13,27,48.1,14,14,1,13,6,28,7,0,"FW,MF",20-24,Forward,Brazil,South America
2055,Paulinho,BRA,Leverkusen,Bundesliga,2021,21.0,2000.0,13.5,22,13,6,13,3,13,27,48.1,14,14,1,13,6,28,7,0,"FW,MF",20-24,Forward,Brazil,South America
2055,Paulinho,BRA,Leverkusen,Bundesliga,2021,21.0,2000.0,13.5,22,13,6,13,3,13,27,48.1,14,14,1,13,6,28,7,0,"FW,MF",20-24,Forward,Brazil,South America
2055,Paulinho,BRA,Leverkusen,Bundesliga,2021,21.0,2000.0,13.5,22,13,6,13,3,13,27,48.1,14,14,1,13,6,28,7,0,"FW,MF",20-24,Forward,Brazil,South America
2055,Paulinho,BRA,Leverkusen,Bundesliga,2021,21.0,2000.0,13.5,22,13,6,13,3,13,27,48.1,14,14,1,13,6,28,7,0,"FW,MF",20-24,Forward,Brazil,South America
2055,Paulinho,BRA,Leverkusen,Bundesliga,2021,21.0,2000.0,13.5,22,13,6,13,3,13,27,48.1,14,14,1,13,6,28,7,0,"FW,MF",20-24,Forward,Brazil,South America
2055,Paulinho,BRA,Leverkusen,Bundesliga,2021,21.0,2000.0,13.5,22,13,6,13,3,13,27,48.1,14,14,1,13,6,28,7,0,"FW,MF",20-24,Forward,Brazil,South America
2055,Paulinho,BRA,Leverkusen,Bundesliga,2021,21.0,2000.0,13.5,22,13,6,13,3,13,27,48.1,14,14,1,13,6,28,7,0,"FW,MF",20-24,Forward,Brazil,South America
2055,Paulinho,BRA,Leverkusen,Bundesliga,2021,21.0,2000.0,13.5,22,13,6,13,3,13,27,48.1,14,14,1,13,6,28,7,0,"FW,MF",20-24,Forward,Brazil,South America
2055,Paulinho,BRA,Leverkusen,Bundesliga,2021,21.0,2000.0,13.5,22,13,6,13,3,13,27,48.1,14,14,1,13,6,28,7,0,"FW,MF",20-24,Forward,Brazil,South America
2055,Paulinho,BRA,Leverkusen,Bundesliga,2021,21.0,2000.0,13.5,22,13,6,13,3,13,27,48.1,14,14,1,13,6,28,7,0,"FW,MF",20-24,Forward,Brazil,South America
2055,Paulinho,BRA,Leverkusen,Bundesliga,2021,21.0,2000.0,13.5,22,13,6,13,3,13,27,48.1,14,14,1,13,6,28,7,0,"FW,MF",20-24,Forward,Brazil,South America
2055,Paulinho,BRA,Leverkusen,Bundesliga,2021,21.0,2000.0,13.5,22,13,6,13,3,13,27,48.1,14,14,1,13,6,28,7,0,"FW,MF",20-24,Forward,Brazil,South America
2055,Paulinho,BRA,Leverkusen,Bundesliga,2021,21.0,2000.0,13.5,22,13,6,13,3,13,27,48.1,14,14,1,13,6,28,7,0,"FW,MF",20-24,Forward,Brazil,South America
2055,Paulinho,BRA,Leverkusen,Bundesliga,2021,21.0,2000.0,13.5,22,13,6,13,3,13,27,48.1,14,14,1,13,6,28,7,0,"FW,MF",20-24,Forward,Brazil,South America
2055,Paulinho,BRA,Leverkusen,Bundesliga,2021,21.0,2000.0,13.5,22,13,6,13,3,13,27,48.1,14,14,1,13,6,28,7,0,"FW,MF",20-24,Forward,Brazil,South America
2055,Paulinho,BRA,Leverkusen,Bundesliga,2021,21.0,2000.0,13.5,22,13,6,13,3,13,27,48.1,14,14,1,13,6,28,7,0,"FW,MF",20-24,Forward,Brazil,South America
2055,Paulinho,BRA,Leverkusen,Bundesliga,2021,21.0,2000.0,13.5,22,13,6,13,3,13,27,48.1,14,14,1,13,6,28,7,0,"FW,MF",20-24,Forward,Brazil,South America
2055,Paulinho,BRA,Leverkusen,Bundesliga,2021,21.0,2000.0,13.5,22,13,6,13,3,13,27,48.1,14,14,1,13,6,28,7,0,"FW,MF",20-24,Forward,Brazil,South America
2055,Paulinho,BRA,Leverkusen,Bundesliga,2021,21.0,2000.0,13.5,22,13,6,13,3,13,27,48.1,14,14,1,13,6,28,7,0,"FW,MF",20-24,Forward,Brazil,South America
2055,Paulinho,BRA,Leverkusen,Bundesliga,2021,21.0,2000.0,13.5,22,13,6,13,3,13,27,48.1,14,14,1,13,6,28,7,0,"FW,MF",20-24,Forward,Brazil,South America
2055,Paulinho,BRA,Leverkusen,Bundesliga,2021,21.0,2000.0,13.5,22,13,6,13,3,13,27,48.1,14,14,1,13,6,28,7,0,"FW,MF",20-24,Forward,Brazil,South America
2055,Paulinho,BRA,Leverkusen,Bundesliga,2021,21.0,2000.0,13.5,22,13,6,13,3,13,27,48.1,14,14,1,13,6,28,7,0,"FW,MF",20-24,Forward,Brazil,South America
2055,Paulinho,BRA,Leverkusen,Bundesliga,2021,21.0,2000.0,13.5,22,13,6,13,3,13,27,48.1,14,14,1,13,6,28,7,0,"FW,MF",20-24,Forward,Brazil,South America
2055,Paulinho,BRA,Leverkusen,Bundesliga,2021,21.0,2000.0,13.5,22,13,6,13,3,13,27,48.1,14,14,1,13,6,28,7,0,"FW,MF",20-24,Forward,Brazil,South America
2055,Paulinho,BRA,Leverkusen,Bundesliga,2021,21.0,2000.0,13.5,22,13,6,13,3,13,27,48.1,14,14,1,13,6,28,7,0,"FW,MF",20-24,Forward,Brazil,South America
2055,Paulinho,BRA,Leverkusen,Bundesliga,2021,21.0,2000.0,13.5,22,13,6,13,3,13,27,48.1,14,14,1,13,6,28,7,0,"FW,MF",20-24,Forward,Brazil,South America
2055,Paulinho,BRA,Leverkusen,Bundesliga,2021,21.0,2000.0,13.5,22,13,6,13,3,13,27,48.1,14,14,1,13,6,28,7,0,"FW,MF",20-24,Forward,Brazil,South America
2055,Paulinho,BRA,Leverkusen,Bundesliga,2021,21.0,2000.0,13.5,22,13,6,13,3,13,27,48.1,14,14,1,13,6,28,7,0,"FW,MF",20-24,Forward,Brazil,South America
2055,Paulinho,BRA,Leverkusen,Bundesliga,2021,21.0,2000.0,13.5,22,13,6,13,3,13,27,48.1,14,14,1,13,6,28,7,0,"FW,MF",20-24,Forward,Brazil,South America
2055,Paulinho,BRA,Leverkusen,Bundesliga,2021,21.0,2000.0,13.5,22,13,6,13,3,13,27,48.1,14,14,1,13,6,28,7,0,"FW,MF",20-24,Forward,Brazil,South America
2055,Paulinho,BRA,Leverkusen,Bundesliga,2021,21.0,2000.0,13.5,22,13,6,13,3,13,27,48.1,14,14,1,13,6,28,7,0,"FW,MF",20-24,Forward,Brazil,South America
2055,Paulinho,BRA,Leverkusen,Bundesliga,2021,21.0,2000.0,13.5,22,13,6,13,3,13,27,48.1,14,14,1,13,6,28,7,0,"FW,MF",20-24,Forward,Brazil,South America
2055,Paulinho,BRA,Leverkusen,Bundesliga,2021,21.0,2000.0,13.5,22,13,6,13,3,13,27,48.1,14,14,1,13,6,28,7,0,"FW,MF",20-24,Forward,Brazil,South America
2055,Paulinho,BRA,Leverkusen,Bundesliga,2021,21.0,2000.0,13.5,22,13,6,13,3,13,27,48.1,14,14,1,13,6,28,7,0,"FW,MF",20-24,Forward,Brazil,South America
2055,Paulinho,BRA,Leverkusen,Bundesliga,2021,21.0,2000.0,13.5,22,13,6,13,3,13,27,48.1,14,14,1,13,6,28,7,0,"FW,MF",20-24,Forward,Brazil,South America
2055,Paulinho,BRA,Leverkusen,Bundesliga,2021,21.0,2000.0,13.5,22,13,6,13,3,13,27,48.1,14,14,1,13,6,28,7,0,"FW,MF",20-24,Forward,Brazil,South America
2055,Paulinho,BRA,Leverkusen,Bundesliga,2021,21.0,2000.0,13.5,22,13,6,13,3,13,27,48.1,14,14,1,13,6,28,7,0,"FW,MF",20-24,Forward,Brazil,South America
2055,Paulinho,BRA,Leverkusen,Bundesliga,2021,21.0,2000.0,13.5,22,13,6,13,3,13,27,48.1,14,14,1,13,6,28,7,0,"FW,MF",20-24,Forward,Brazil,South America
2055,Paulinho,BRA,Leverkusen,Bundesliga,2021,21.0,2000.0,13.5,22,13,6,13,3,13,27,48.1,14,14,1,13,6,28,7,0,"FW,MF",20-24,Forward,Brazil,South America
2055,Paulinho,BRA,Leverkusen,Bundesliga,2021,21.0,2000.0,13.5,22,13,6,13,3,13,27,48.1,14,14,1,13,6,28,7,0,"FW,MF",20-24,Forward,Brazil,South America
2055,Paulinho,BRA,Leverkusen,Bundesliga,2021,21.0,2000.0,13.5,22,13,6,13,3,13,27,48.1,14,14,1,13,6,28,7,0,"FW,MF",20-24,Forward,Brazil,South America
2055,Paulinho,BRA,Leverkusen,Bundesliga,2021,21.0,2000.0,13.5,22,13,6,13,3,13,27,48.1,14,14,1,13,6,28,7,0,"FW,MF",20-24,Forward,Brazil,South America
2055,Paulinho,BRA,Leverkusen,Bundesliga,2021,21.0,2000.0,13.5,22,13,6,13,3,13,27,48.1,14,14,1,13,6,28,7,0,"FW,MF",20-24,Forward,Brazil,South America
2055,Paulinho,BRA,Leverkusen,Bundesliga,2021,21.0,2000.0,13.5,22,13,6,13,3,13,27,48.1,14,14,1,13,6,28,7,0,"FW,MF",20-24,Forward,Brazil,South America
2055,Paulinho,BRA,Leverkusen,Bundesliga,2021,21.0,2000.0,13.5,22,13,6,13,3,13,27,48.1,14,14,1,13,6,28,7,0,"FW,MF",20-24,Forward,Brazil,South America
2055,Paulinho,BRA,Leverkusen,Bundesliga,2021,21.0,2000.0,13.5,22,13,6,13,3,13,27,48.1,14,14,1,13,6,28,7,0,"FW,MF",20-24,Forward,Brazil,South America
2055,Paulinho,BRA,Leverkusen,Bundesliga,2021,21.0,2000.0,13.5,22,13,6,13,3,13,27,48.1,14,14,1,13,6,28,7,0,"FW,MF",20-24,Forward,Brazil,South America
2055,Paulinho,BRA,Leverkusen,Bundesliga,2021,21.0,2000.0,13.5,22,13,6,13,3,13,27,48.1,14,14,1,13,6,28,7,0,"FW,MF",20-24,Forward,Brazil,South America
2055,Paulinho,BRA,Leverkusen,Bundesliga,2021,21.0,2000.0,13.5,22,13,6,13,3,13,27,48.1,14,14,1,13,6,28,7,0,"FW,MF",20-24,Forward,Brazil,South America
2055,Paulinho,BRA,Leverkusen,Bundesliga,2021,21.0,2000.0,13.5,22,13,6,13,3,13,27,48.1,14,14,1,13,6,28,7,0,"FW,MF",20-24,Forward,Brazil,South America
2055,Paulinho,BRA,Leverkusen,Bundesliga,2021,21.0,2000.0,13.5,22,13,6,13,3,13,27,48.1,14,14,1,13,6,28,7,0,"FW,MF",20-24,Forward,Brazil,South America
2055,Paulinho,BRA,Leverkusen,Bundesliga,2021,21.0,2000.0,13.5,22,13,6,13,3,13,27,48.1,14,14,1,13,6,28,7,0,"FW,MF",20-24,Forward,Brazil,South America
2055,Paulinho,BRA,Leverkusen,Bundesliga,2021,21.0,2000.0,13.5,22,13,6,13,3,13,27,48.1,14,14,1,13,6,28,7,0,"FW,MF",20-24,Forward,Brazil,South America
2055,Paulinho,BRA,Leverkusen,Bundesliga,2021,21.0,2000.0,13.5,22,13,6,13,3,13,27,48.1,14,14,1,13,6,28,7,0,"FW,MF",20-24,Forward,Brazil,South America
2055,Paulinho,BRA,Leverkusen,Bundesliga,2021,21.0,2000.0,13.5,22,13,6,13,3,13,27,48.1,14,14,1,13,6,28,7,0,"FW,MF",20-24,Forward,Brazil,South America
2055,Paulinho,BRA,Leverkusen,Bundesliga,2021,21.0,2000.0,13.5,22,13,6,13,3,13,27,48.1,14,14,1,13,6,28,7,0,"FW,MF",20-24,Forward,Brazil,South America
2055,Paulinho,BRA,Leverkusen,Bundesliga,2021,21.0,2000.0,13.5,22,13,6,13,3,13,27,48.1,14,14,1,13,6,28,7,0,"FW,MF",20-24,Forward,Brazil,South America
2055,Paulinho,BRA,Leverkusen,Bundesliga,2021,21.0,2000.0,13.5,22,13,6,13,3,13,27,48.1,14,14,1,13,6,28,7,0,"FW,MF",20-24,Forward,Brazil,South America
2055,Paulinho,BRA,Leverkusen,Bundesliga,2021,21.0,2000.0,13.5,22,13,6,13,3,13,27,48.1,14,14,1,13,6,28,7,0,"FW,MF",20-24,Forward,Brazil,South America
2055,Paulinho,BRA,Leverkusen,Bundesliga,2021,21.0,2000.0,13.5,22,13,6,13,3,13,27,48.1,14,14,1,13,6,28,7,0,"FW,MF",20-24,Forward,Brazil,South America
2055,Paulinho,BRA,Leverkusen,Bundesliga,2021,21.0,2000.0,13.5,22,13,6,13,3,13,27,48.1,14,14,1,13,6,28,7,0,"FW,MF",20-24,Forward,Brazil,South America
2055,Paulinho,BRA,Leverkusen,Bundesliga,2021,21.0,2000.0,13.5,22,13,6,13,3,13,27,48.1,14,14,1,13,6,28,7,0,"FW,MF",20-24,Forward,Brazil,South America
2055,Paulinho,BRA,Leverkusen,Bundesliga,2021,21.0,2000.0,13.5,22,13,6,13,3,13,27,48.1,14,14,1,13,6,28,7,0,"FW,MF",20-24,Forward,Brazil,South America
2055,Paulinho,BRA,Leverkusen,Bundesliga,2021,21.0,2000.0,13.5,22,13,6,13,3,13,27,48.1,14,14,1,13,6,28,7,0,"FW,MF",20-24,Forward,Brazil,South America
2055,Paulinho,BRA,Leverkusen,Bundesliga,2021,21.0,2000.0,13.5,22,13,6,13,3,13,27,48.1,14,14,1,13,6,28,7,0,"FW,MF",20-24,Forward,Brazil,South America
2055,Paulinho,BRA,Leverkusen,Bundesliga,2021,21.0,2000.0,13.5,22,13,6,13,3,13,27,48.1,14,14,1,13,6,28,7,0,"FW,MF",20-24,Forward,Brazil,South America
2055,Paulinho,BRA,Leverkusen,Bundesliga,2021,21.0,2000.0,13.5,22,13,6,13,3,13,27,48.1,14,14,1,13,6,28,7,0,"FW,MF",20-24,Forward,Brazil,South America
2055,Paulinho,BRA,Leverkusen,Bundesliga,2021,21.0,2000.0,13.5,22,13,6,13,3,13,27,48.1,14,14,1,13,6,28,7,0,"FW,MF",20-24,Forward,Brazil,South America
2055,Paulinho,BRA,Leverkusen,Bundesliga,2021,21.0,2000.0,13.5,22,13,6,13,3,13,27,48.1,14,14,1,13,6,28,7,0,"FW,MF",20-24,Forward,Brazil,South America
2055,Paulinho,BRA,Leverkusen,Bundesliga,2021,21.0,2000.0,13.5,22,13,6,13,3,13,27,48.1,14,14,1,13,6,28,7,0,"FW,MF",20-24,Forward,Brazil,South America
2055,Paulinho,BRA,Leverkusen,Bundesliga,2021,21.0,2000.0,13.5,22,13,6,13,3,13,27,48.1,14,14,1,13,6,28,7,0,"FW,MF",20-24,Forward,Brazil,South America
2055,Paulinho,BRA,Leverkusen,Bundesliga,2021,21.0,2000.0,13.5,22,13,6,13,3,13,27,48.1,14,14,1,13,6,28,7,0,"FW,MF",20-24,Forward,Brazil,South America
2055,Paulinho,BRA,Leverkusen,Bundesliga,2021,21.0,2000.0,13.5,22,13,6,13,3,13,27,48.1,14,14,1,13,6,28,7,0,"FW,MF",20-24,Forward,Brazil,South America
2055,Paulinho,BRA,Leverkusen,Bundesliga,2021,21.0,2000.0,13.5,22,13,6,13,3,13,27,48.1,14,14,1,13,6,28,7,0,"FW,MF",20-24,Forward,Brazil,South America
2055,Paulinho,BRA,Leverkusen,Bundesliga,2021,21.0,2000.0,13.5,22,13,6,13,3,13,27,48.1,14,14,1,13,6,28,7,0,"FW,MF",20-24,Forward,Brazil,South America
2055,Paulinho,BRA,Leverkusen,Bundesliga,2021,21.0,2000.0,13.5,22,13,6,13,3,13,27,48.1,14,14,1,13,6,28,7,0,"FW,MF",20-24,Forward,Brazil,South America
2055,Paulinho,BRA,Leverkusen,Bundesliga,2021,21.0,2000.0,13.5,22,13,6,13,3,13,27,48.1,14,14,1,13,6,28,7,0,"FW,MF",20-24,Forward,Brazil,South America
2055,Paulinho,BRA,Leverkusen,Bundesliga,2021,21.0,2000.0,13.5,22,13,6,13,3,13,27,48.1,14,14,1,13,6,28,7,0,"FW,MF",20-24,Forward,Brazil,South America
2055,Paulinho,BRA,Leverkusen,Bundesliga,2021,21.0,2000.0,13.5,22,13,6,13,3,13,27,48.1,14,14,1,13,6,28,7,0,"FW,MF",20-24,Forward,Brazil,South America
2055,Paulinho,BRA,Leverkusen,Bundesliga,2021,21.0,2000.0,13.5,22,13,6,13,3,13,27,48.1,14,14,1,13,6,28,7,0,"FW,MF",20-24,Forward,Brazil,South America
2055,Paulinho,BRA,Leverkusen,Bundesliga,2021,21.0,2000.0,13.5,22,13,6,13,3,13,27,48.1,14,14,1,13,6,28,7,0,"FW,MF",20-24,Forward,Brazil,South America
2055,Paulinho,BRA,Leverkusen,Bundesliga,2021,21.0,2000.0,13.5,22,13,6,13,3,13,27,48.1,14,14,1,13,6,28,7,0,"FW,MF",20-24,Forward,Brazil,South America
2055,Paulinho,BRA,Leverkusen,Bundesliga,2021,21.0,2000.0,13.5,22,13,6,13,3,13,27,48.1,14,14,1,13,6,28,7,0,"FW,MF",20-24,Forward,Brazil,South America
2055,Paulinho,BRA,Leverkusen,Bundesliga,2021,21.0,2000.0,13.5,22,13,6,13,3,13,27,48.1,14,14,1,13,6,28,7,0,"FW,MF",20-24,Forward,Brazil,South America
2055,Paulinho,BRA,Leverkusen,Bundesliga,2021,21.0,2000.0,13.5,22,13,6,13,3,13,27,48.1,14,14,1,13,6,28,7,0,"FW,MF",20-24,Forward,Brazil,South America
2055,Paulinho,BRA,Leverkusen,Bundesliga,2021,21.0,2000.0,13.5,22,13,6,13,3,13,27,48.1,14,14,1,13,6,28,7,0,"FW,MF",20-24,Forward,Brazil,South America
2055,Paulinho,BRA,Leverkusen,Bundesliga,2021,21.0,2000.0,13.5,22,13,6,13,3,13,27,48.1,14,14,1,13,6,28,7,0,"FW,MF",20-24,Forward,Brazil,South America
2055,Paulinho,BRA,Leverkusen,Bundesliga,2021,21.0,2000.0,13.5,22,13,6,13,3,13,27,48.1,14,14,1,13,6,28,7,0,"FW,MF",20-24,Forward,Brazil,South America
2055,Paulinho,BRA,Leverkusen,Bundesliga,2021,21.0,2000.0,13.5,22,13,6,13,3,13,27,48.1,14,14,1,13,6,28,7,0,"FW,MF",20-24,Forward,Brazil,South America
2055,Paulinho,BRA,Leverkusen,Bundesliga,2021,21.0,2000.0,13.5,22,13,6,13,3,13,27,48.1,14,14,1,13,6,28,7,0,"FW,MF",20-24,Forward,Brazil,South America
2055,Paulinho,BRA,Leverkusen,Bundesliga,2021,21.0,2000.0,13.5,22,13,6,13,3,13,27,48.1,14,14,1,13,6,28,7,0,"FW,MF",20-24,Forward,Brazil,South America
2055,Paulinho,BRA,Leverkusen,Bundesliga,2021,21.0,2000.0,13.5,22,13,6,13,3,13,27,48.1,14,14,1,13,6,28,7,0,"FW,MF",20-24,Forward,Brazil,South America
2055,Paulinho,BRA,Leverkusen,Bundesliga,2021,21.0,2000.0,13.5,22,13,6,13,3,13,27,48.1,14,14,1,13,6,28,7,0,"FW,MF",20-24,Forward,Brazil,South America
2055,Paulinho,BRA,Leverkusen,Bundesliga,2021,21.0,2000.0,13.5,22,13,6,13,3,13,27,48.1,14,14,1,13,6,28,7,0,"FW,MF",20-24,Forward,Brazil,South America
2055,Paulinho,BRA,Leverkusen,Bundesliga,2021,21.0,2000.0,13.5,22,13,6,13,3,13,27,48.1,14,14,1,13,6,28,7,0,"FW,MF",20-24,Forward,Brazil,South America
2055,Paulinho,BRA,Leverkusen,Bundesliga,2021,21.0,2000.0,13.5,22,13,6,13,3,13,27,48.1,14,14,1,13,6,28,7,0,"FW,MF",20-24,Forward,Brazil,South America
2055,Paulinho,BRA,Leverkusen,Bundesliga,2021,21.0,2000.0,13.5,22,13,6,13,3,13,27,48.1,14,14,1,13,6,28,7,0,"FW,MF",20-24,Forward,Brazil,South America
2055,Paulinho,BRA,Leverkusen,Bundesliga,2021,21.0,2000.0,13.5,22,13,6,13,3,13,27,48.1,14,14,1,13,6,28,7,0,"FW,MF",20-24,Forward,Brazil,South America
2055,Paulinho,BRA,Leverkusen,Bundesliga,2021,21.0,2000.0,13.5,22,13,6,13,3,13,27,48.1,14,14,1,13,6,28,7,0,"FW,MF",20-24,Forward,Brazil,South America
2055,Paulinho,BRA,Leverkusen,Bundesliga,2021,21.0,2000.0,13.5,22,13,6,13,3,13,27,48.1,14,14,1,13,6,28,7,0,"FW,MF",20-24,Forward,Brazil,South America
2055,Paulinho,BRA,Leverkusen,Bundesliga,2021,21.0,2000.0,13.5,22,13,6,13,3,13,27,48.1,14,14,1,13,6,28,7,0,"FW,MF",20-24,Forward,Brazil,South America
2055,Paulinho,BRA,Leverkusen,Bundesliga,2021,21.0,2000.0,13.5,22,13,6,13,3,13,27,48.1,14,14,1,13,6,28,7,0,"FW,MF",20-24,Forward,Brazil,South America
2055,Paulinho,BRA,Leverkusen,Bundesliga,2021,21.0,2000.0,13.5,22,13,6,13,3,13,27,48.1,14,14,1,13,6,28,7,0,"FW,MF",20-24,Forward,Brazil,South America
2055,Paulinho,BRA,Leverkusen,Bundesliga,2021,21.0,2000.0,13.5,22,13,6,13,3,13,27,48.1,14,14,1,13,6,28,7,0,"FW,MF",20-24,Forward,Brazil,South America
2055,Paulinho,BRA,Leverkusen,Bundesliga,2021,21.0,2000.0,13.5,22,13,6,13,3,13,27,48.1,14,14,1,13,6,28,7,0,"FW,MF",20-24,Forward,Brazil,South America
2055,Paulinho,BRA,Leverkusen,Bundesliga,2021,21.0,2000.0,13.5,22,13,6,13,3,13,27,48.1,14,14,1,13,6,28,7,0,"FW,MF",20-24,Forward,Brazil,South America
2055,Paulinho,BRA,Leverkusen,Bundesliga,2021,21.0,2000.0,13.5,22,13,6,13,3,13,27,48.1,14,14,1,13,6,28,7,0,"FW,MF",20-24,Forward,Brazil,South America
2055,Paulinho,BRA,Leverkusen,Bundesliga,2021,21.0,2000.0,13.5,22,13,6,13,3,13,27,48.1,14,14,1,13,6,28,7,0,"FW,MF",20-24,Forward,Brazil,South America
2055,Paulinho,BRA,Leverkusen,Bundesliga,2021,21.0,2000.0,13.5,22,13,6,13,3,13,27,48.1,14,14,1,13,6,28,7,0,"FW,MF",20-24,Forward,Brazil,South America
2055,Paulinho,BRA,Leverkusen,Bundesliga,2021,21.0,2000.0,13.5,22,13,6,13,3,13,27,48.1,14,14,1,13,6,28,7,0,"FW,MF",20-24,Forward,Brazil,South America
2056,Gabriel Paulista,BRA,Valencia,La Liga,2021,30.0,1990.0,17.7,21,12,16,5,0,14,20,70.0,6,18,12,6,39,60,88,0,DF,30-34,Defender,Brazil,South America
2057,Benjamin Pavard,FRA,Bayern Munich,Bundesliga,2021,25.0,1996.0,23.1,35,20,21,13,1,19,29,65.5,10,28,16,12,36,71,50,1,DF,25-29,Defender,France,Europe
2059,Leonardo Pavoletti,ITA,Cagliari,Serie A,2021,32.0,1988.0,16.9,10,6,2,5,3,3,9,33.3,6,9,5,4,2,12,12,0,FW,30-34,Forward,Italy,Europe
2060,Dimitri Payet,FRA,Marseille,Ligue 1,2021,34.0,1987.0,28.8,16,8,4,10,2,7,31,22.6,24,9,0,9,9,25,3,0,"FW,MF",30-34,Forward,France,Europe
2061,Mads Pedersen,DEN,Augsburg,Bundesliga,2021,24.0,1996.0,15.5,28,21,8,15,5,12,27,44.4,15,13,4,9,15,43,30,0,"MF,DF",20-24,Midfielder,Denmark,Europe
2061,Mads Pedersen,DEN,Augsburg,Bundesliga,2021,24.0,1996.0,15.5,28,21,8,15,5,12,27,44.4,15,13,4,9,15,43,30,0,"MF,DF",20-24,Midfielder,Denmark,Europe
2061,Mads Pedersen,DEN,Augsburg,Bundesliga,2021,24.0,1996.0,15.5,28,21,8,15,5,12,27,44.4,15,13,4,9,15,43,30,0,"MF,DF",20-24,Midfielder,Denmark,Europe
2061,Mads Pedersen,DEN,Augsburg,Bundesliga,2021,24.0,1996.0,15.5,28,21,8,15,5,12,27,44.4,15,13,4,9,15,43,30,0,"MF,DF",20-24,Midfielder,Denmark,Europe
2065,João Pedro,ITA,Cagliari,Serie A,2021,29.0,1992.0,36.9,15,12,2,8,5,4,18,22.2,14,23,5,18,8,23,18,1,FW,25-29,Forward,Italy,Europe
2065,João Pedro,ITA,Cagliari,Serie A,2021,29.0,1992.0,36.9,15,12,2,8,5,4,18,22.2,14,23,5,18,8,23,18,1,FW,25-29,Forward,Italy,Europe
2065,João Pedro,ITA,Cagliari,Serie A,2021,29.0,1992.0,36.9,15,12,2,8,5,4,18,22.2,14,23,5,18,8,23,18,1,FW,25-29,Forward,Italy,Europe
2065,João Pedro,ITA,Cagliari,Serie A,2021,29.0,1992.0,36.9,15,12,2,8,5,4,18,22.2,14,23,5,18,8,23,18,1,FW,25-29,Forward,Italy,Europe
2065,João Pedro,ITA,Cagliari,Serie A,2021,29.0,1992.0,36.9,15,12,2,8,5,4,18,22.2,14,23,5,18,8,23,18,1,FW,25-29,Forward,Italy,Europe
2065,João Pedro,ITA,Cagliari,Serie A,2021,29.0,1992.0,36.9,15,12,2,8,5,4,18,22.2,14,23,5,18,8,23,18,1,FW,25-29,Forward,Italy,Europe
2065,João Pedro,ITA,Cagliari,Serie A,2021,29.0,1992.0,36.9,15,12,2,8,5,4,18,22.2,14,23,5,18,8,23,18,1,FW,25-29,Forward,Italy,Europe
2065,João Pedro,ITA,Cagliari,Serie A,2021,29.0,1992.0,36.9,15,12,2,8,5,4,18,22.2,14,23,5,18,8,23,18,1,FW,25-29,Forward,Italy,Europe
2065,João Pedro,ITA,Cagliari,Serie A,2021,29.0,1992.0,36.9,15,12,2,8,5,4,18,22.2,14,23,5,18,8,23,18,1,FW,25-29,Forward,Italy,Europe
2065,João Pedro,ITA,Cagliari,Serie A,2021,29.0,1992.0,36.9,15,12,2,8,5,4,18,22.2,14,23,5,18,8,23,18,1,FW,25-29,Forward,Italy,Europe
2065,João Pedro,ITA,Cagliari,Serie A,2021,29.0,1992.0,36.9,15,12,2,8,5,4,18,22.2,14,23,5,18,8,23,18,1,FW,25-29,Forward,Italy,Europe
2065,João Pedro,ITA,Cagliari,Serie A,2021,29.0,1992.0,36.9,15,12,2,8,5,4,18,22.2,14,23,5,18,8,23,18,1,FW,25-29,Forward,Italy,Europe
2065,João Pedro,ITA,Cagliari,Serie A,2021,29.0,1992.0,36.9,15,12,2,8,5,4,18,22.2,14,23,5,18,8,23,18,1,FW,25-29,Forward,Italy,Europe
2065,João Pedro,ITA,Cagliari,Serie A,2021,29.0,1992.0,36.9,15,12,2,8,5,4,18,22.2,14,23,5,18,8,23,18,1,FW,25-29,Forward,Italy,Europe
2065,João Pedro,ITA,Cagliari,Serie A,2021,29.0,1992.0,36.9,15,12,2,8,5,4,18,22.2,14,23,5,18,8,23,18,1,FW,25-29,Forward,Italy,Europe
2065,João Pedro,ITA,Cagliari,Serie A,2021,29.0,1992.0,36.9,15,12,2,8,5,4,18,22.2,14,23,5,18,8,23,18,1,FW,25-29,Forward,Italy,Europe
2065,João Pedro,ITA,Cagliari,Serie A,2021,29.0,1992.0,36.9,15,12,2,8,5,4,18,22.2,14,23,5,18,8,23,18,1,FW,25-29,Forward,Italy,Europe
2065,João Pedro,ITA,Cagliari,Serie A,2021,29.0,1992.0,36.9,15,12,2,8,5,4,18,22.2,14,23,5,18,8,23,18,1,FW,25-29,Forward,Italy,Europe
2065,João Pedro,ITA,Cagliari,Serie A,2021,29.0,1992.0,36.9,15,12,2,8,5,4,18,22.2,14,23,5,18,8,23,18,1,FW,25-29,Forward,Italy,Europe
2065,João Pedro,ITA,Cagliari,Serie A,2021,29.0,1992.0,36.9,15,12,2,8,5,4,18,22.2,14,23,5,18,8,23,18,1,FW,25-29,Forward,Italy,Europe
2065,João Pedro,ITA,Cagliari,Serie A,2021,29.0,1992.0,36.9,15,12,2,8,5,4,18,22.2,14,23,5,18,8,23,18,1,FW,25-29,Forward,Italy,Europe
2065,João Pedro,ITA,Cagliari,Serie A,2021,29.0,1992.0,36.9,15,12,2,8,5,4,18,22.2,14,23,5,18,8,23,18,1,FW,25-29,Forward,Italy,Europe
2065,João Pedro,ITA,Cagliari,Serie A,2021,29.0,1992.0,36.9,15,12,2,8,5,4,18,22.2,14,23,5,18,8,23,18,1,FW,25-29,Forward,Italy,Europe
2065,João Pedro,ITA,Cagliari,Serie A,2021,29.0,1992.0,36.9,15,12,2,8,5,4,18,22.2,14,23,5,18,8,23,18,1,FW,25-29,Forward,Italy,Europe
2065,João Pedro,ITA,Cagliari,Serie A,2021,29.0,1992.0,36.9,15,12,2,8,5,4,18,22.2,14,23,5,18,8,23,18,1,FW,25-29,Forward,Italy,Europe
2065,João Pedro,ITA,Cagliari,Serie A,2021,29.0,1992.0,36.9,15,12,2,8,5,4,18,22.2,14,23,5,18,8,23,18,1,FW,25-29,Forward,Italy,Europe
2065,João Pedro,ITA,Cagliari,Serie A,2021,29.0,1992.0,36.9,15,12,2,8,5,4,18,22.2,14,23,5,18,8,23,18,1,FW,25-29,Forward,Italy,Europe
2065,João Pedro,ITA,Cagliari,Serie A,2021,29.0,1992.0,36.9,15,12,2,8,5,4,18,22.2,14,23,5,18,8,23,18,1,FW,25-29,Forward,Italy,Europe
2065,João Pedro,ITA,Cagliari,Serie A,2021,29.0,1992.0,36.9,15,12,2,8,5,4,18,22.2,14,23,5,18,8,23,18,1,FW,25-29,Forward,Italy,Europe
2065,João Pedro,ITA,Cagliari,Serie A,2021,29.0,1992.0,36.9,15,12,2,8,5,4,18,22.2,14,23,5,18,8,23,18,1,FW,25-29,Forward,Italy,Europe
2065,João Pedro,ITA,Cagliari,Serie A,2021,29.0,1992.0,36.9,15,12,2,8,5,4,18,22.2,14,23,5,18,8,23,18,1,FW,25-29,Forward,Italy,Europe
2065,João Pedro,ITA,Cagliari,Serie A,2021,29.0,1992.0,36.9,15,12,2,8,5,4,18,22.2,14,23,5,18,8,23,18,1,FW,25-29,Forward,Italy,Europe
2065,João Pedro,ITA,Cagliari,Serie A,2021,29.0,1992.0,36.9,15,12,2,8,5,4,18,22.2,14,23,5,18,8,23,18,1,FW,25-29,Forward,Italy,Europe
2065,João Pedro,ITA,Cagliari,Serie A,2021,29.0,1992.0,36.9,15,12,2,8,5,4,18,22.2,14,23,5,18,8,23,18,1,FW,25-29,Forward,Italy,Europe
2065,João Pedro,ITA,Cagliari,Serie A,2021,29.0,1992.0,36.9,15,12,2,8,5,4,18,22.2,14,23,5,18,8,23,18,1,FW,25-29,Forward,Italy,Europe
2065,João Pedro,ITA,Cagliari,Serie A,2021,29.0,1992.0,36.9,15,12,2,8,5,4,18,22.2,14,23,5,18,8,23,18,1,FW,25-29,Forward,Italy,Europe
2065,João Pedro,ITA,Cagliari,Serie A,2021,29.0,1992.0,36.9,15,12,2,8,5,4,18,22.2,14,23,5,18,8,23,18,1,FW,25-29,Forward,Italy,Europe
2065,João Pedro,ITA,Cagliari,Serie A,2021,29.0,1992.0,36.9,15,12,2,8,5,4,18,22.2,14,23,5,18,8,23,18,1,FW,25-29,Forward,Italy,Europe
2065,João Pedro,ITA,Cagliari,Serie A,2021,29.0,1992.0,36.9,15,12,2,8,5,4,18,22.2,14,23,5,18,8,23,18,1,FW,25-29,Forward,Italy,Europe
2065,João Pedro,ITA,Cagliari,Serie A,2021,29.0,1992.0,36.9,15,12,2,8,5,4,18,22.2,14,23,5,18,8,23,18,1,FW,25-29,Forward,Italy,Europe
2065,João Pedro,ITA,Cagliari,Serie A,2021,29.0,1992.0,36.9,15,12,2,8,5,4,18,22.2,14,23,5,18,8,23,18,1,FW,25-29,Forward,Italy,Europe
2065,João Pedro,ITA,Cagliari,Serie A,2021,29.0,1992.0,36.9,15,12,2,8,5,4,18,22.2,14,23,5,18,8,23,18,1,FW,25-29,Forward,Italy,Europe
2065,João Pedro,ITA,Cagliari,Serie A,2021,29.0,1992.0,36.9,15,12,2,8,5,4,18,22.2,14,23,5,18,8,23,18,1,FW,25-29,Forward,Italy,Europe
2065,João Pedro,ITA,Cagliari,Serie A,2021,29.0,1992.0,36.9,15,12,2,8,5,4,18,22.2,14,23,5,18,8,23,18,1,FW,25-29,Forward,Italy,Europe
2065,João Pedro,ITA,Cagliari,Serie A,2021,29.0,1992.0,36.9,15,12,2,8,5,4,18,22.2,14,23,5,18,8,23,18,1,FW,25-29,Forward,Italy,Europe
2065,João Pedro,ITA,Cagliari,Serie A,2021,29.0,1992.0,36.9,15,12,2,8,5,4,18,22.2,14,23,5,18,8,23,18,1,FW,25-29,Forward,Italy,Europe
2065,João Pedro,ITA,Cagliari,Serie A,2021,29.0,1992.0,36.9,15,12,2,8,5,4,18,22.2,14,23,5,18,8,23,18,1,FW,25-29,Forward,Italy,Europe
2065,João Pedro,ITA,Cagliari,Serie A,2021,29.0,1992.0,36.9,15,12,2,8,5,4,18,22.2,14,23,5,18,8,23,18,1,FW,25-29,Forward,Italy,Europe
2065,João Pedro,ITA,Cagliari,Serie A,2021,29.0,1992.0,36.9,15,12,2,8,5,4,18,22.2,14,23,5,18,8,23,18,1,FW,25-29,Forward,Italy,Europe
2065,João Pedro,ITA,Cagliari,Serie A,2021,29.0,1992.0,36.9,15,12,2,8,5,4,18,22.2,14,23,5,18,8,23,18,1,FW,25-29,Forward,Italy,Europe
2065,João Pedro,ITA,Cagliari,Serie A,2021,29.0,1992.0,36.9,15,12,2,8,5,4,18,22.2,14,23,5,18,8,23,18,1,FW,25-29,Forward,Italy,Europe
2065,João Pedro,ITA,Cagliari,Serie A,2021,29.0,1992.0,36.9,15,12,2,8,5,4,18,22.2,14,23,5,18,8,23,18,1,FW,25-29,Forward,Italy,Europe
2065,João Pedro,ITA,Cagliari,Serie A,2021,29.0,1992.0,36.9,15,12,2,8,5,4,18,22.2,14,23,5,18,8,23,18,1,FW,25-29,Forward,Italy,Europe
2065,João Pedro,ITA,Cagliari,Serie A,2021,29.0,1992.0,36.9,15,12,2,8,5,4,18,22.2,14,23,5,18,8,23,18,1,FW,25-29,Forward,Italy,Europe
2065,João Pedro,ITA,Cagliari,Serie A,2021,29.0,1992.0,36.9,15,12,2,8,5,4,18,22.2,14,23,5,18,8,23,18,1,FW,25-29,Forward,Italy,Europe
2065,João Pedro,ITA,Cagliari,Serie A,2021,29.0,1992.0,36.9,15,12,2,8,5,4,18,22.2,14,23,5,18,8,23,18,1,FW,25-29,Forward,Italy,Europe
2065,João Pedro,ITA,Cagliari,Serie A,2021,29.0,1992.0,36.9,15,12,2,8,5,4,18,22.2,14,23,5,18,8,23,18,1,FW,25-29,Forward,Italy,Europe
2065,João Pedro,ITA,Cagliari,Serie A,2021,29.0,1992.0,36.9,15,12,2,8,5,4,18,22.2,14,23,5,18,8,23,18,1,FW,25-29,Forward,Italy,Europe
2065,João Pedro,ITA,Cagliari,Serie A,2021,29.0,1992.0,36.9,15,12,2,8,5,4,18,22.2,14,23,5,18,8,23,18,1,FW,25-29,Forward,Italy,Europe
2065,João Pedro,ITA,Cagliari,Serie A,2021,29.0,1992.0,36.9,15,12,2,8,5,4,18,22.2,14,23,5,18,8,23,18,1,FW,25-29,Forward,Italy,Europe
2065,João Pedro,ITA,Cagliari,Serie A,2021,29.0,1992.0,36.9,15,12,2,8,5,4,18,22.2,14,23,5,18,8,23,18,1,FW,25-29,Forward,Italy,Europe
2065,João Pedro,ITA,Cagliari,Serie A,2021,29.0,1992.0,36.9,15,12,2,8,5,4,18,22.2,14,23,5,18,8,23,18,1,FW,25-29,Forward,Italy,Europe
2065,João Pedro,ITA,Cagliari,Serie A,2021,29.0,1992.0,36.9,15,12,2,8,5,4,18,22.2,14,23,5,18,8,23,18,1,FW,25-29,Forward,Italy,Europe
2065,João Pedro,ITA,Cagliari,Serie A,2021,29.0,1992.0,36.9,15,12,2,8,5,4,18,22.2,14,23,5,18,8,23,18,1,FW,25-29,Forward,Italy,Europe
2065,João Pedro,ITA,Cagliari,Serie A,2021,29.0,1992.0,36.9,15,12,2,8,5,4,18,22.2,14,23,5,18,8,23,18,1,FW,25-29,Forward,Italy,Europe
2065,João Pedro,ITA,Cagliari,Serie A,2021,29.0,1992.0,36.9,15,12,2,8,5,4,18,22.2,14,23,5,18,8,23,18,1,FW,25-29,Forward,Italy,Europe
2065,João Pedro,ITA,Cagliari,Serie A,2021,29.0,1992.0,36.9,15,12,2,8,5,4,18,22.2,14,23,5,18,8,23,18,1,FW,25-29,Forward,Italy,Europe
2065,João Pedro,ITA,Cagliari,Serie A,2021,29.0,1992.0,36.9,15,12,2,8,5,4,18,22.2,14,23,5,18,8,23,18,1,FW,25-29,Forward,Italy,Europe
2065,João Pedro,ITA,Cagliari,Serie A,2021,29.0,1992.0,36.9,15,12,2,8,5,4,18,22.2,14,23,5,18,8,23,18,1,FW,25-29,Forward,Italy,Europe
2065,João Pedro,ITA,Cagliari,Serie A,2021,29.0,1992.0,36.9,15,12,2,8,5,4,18,22.2,14,23,5,18,8,23,18,1,FW,25-29,Forward,Italy,Europe
2065,João Pedro,ITA,Cagliari,Serie A,2021,29.0,1992.0,36.9,15,12,2,8,5,4,18,22.2,14,23,5,18,8,23,18,1,FW,25-29,Forward,Italy,Europe
2065,João Pedro,ITA,Cagliari,Serie A,2021,29.0,1992.0,36.9,15,12,2,8,5,4,18,22.2,14,23,5,18,8,23,18,1,FW,25-29,Forward,Italy,Europe
2065,João Pedro,ITA,Cagliari,Serie A,2021,29.0,1992.0,36.9,15,12,2,8,5,4,18,22.2,14,23,5,18,8,23,18,1,FW,25-29,Forward,Italy,Europe
2065,João Pedro,ITA,Cagliari,Serie A,2021,29.0,1992.0,36.9,15,12,2,8,5,4,18,22.2,14,23,5,18,8,23,18,1,FW,25-29,Forward,Italy,Europe
2065,João Pedro,ITA,Cagliari,Serie A,2021,29.0,1992.0,36.9,15,12,2,8,5,4,18,22.2,14,23,5,18,8,23,18,1,FW,25-29,Forward,Italy,Europe
2065,João Pedro,ITA,Cagliari,Serie A,2021,29.0,1992.0,36.9,15,12,2,8,5,4,18,22.2,14,23,5,18,8,23,18,1,FW,25-29,Forward,Italy,Europe
2065,João Pedro,ITA,Cagliari,Serie A,2021,29.0,1992.0,36.9,15,12,2,8,5,4,18,22.2,14,23,5,18,8,23,18,1,FW,25-29,Forward,Italy,Europe
2065,João Pedro,ITA,Cagliari,Serie A,2021,29.0,1992.0,36.9,15,12,2,8,5,4,18,22.2,14,23,5,18,8,23,18,1,FW,25-29,Forward,Italy,Europe
2065,João Pedro,ITA,Cagliari,Serie A,2021,29.0,1992.0,36.9,15,12,2,8,5,4,18,22.2,14,23,5,18,8,23,18,1,FW,25-29,Forward,Italy,Europe
2065,João Pedro,ITA,Cagliari,Serie A,2021,29.0,1992.0,36.9,15,12,2,8,5,4,18,22.2,14,23,5,18,8,23,18,1,FW,25-29,Forward,Italy,Europe
2065,João Pedro,ITA,Cagliari,Serie A,2021,29.0,1992.0,36.9,15,12,2,8,5,4,18,22.2,14,23,5,18,8,23,18,1,FW,25-29,Forward,Italy,Europe
2067,Gianluca Pegolo,ITA,Sassuolo,Serie A,2021,40.0,1981.0,1.0,0,0,0,0,0,0,0,,0,0,0,0,0,0,0,1,GK,Over 40,Goalkeeper,Italy,Europe
2068,Peter Pekarík,SVK,Hertha BSC,Bundesliga,2021,34.0,1986.0,24.8,45,29,33,11,1,32,46,69.6,14,28,10,18,29,74,58,0,DF,30-34,Defender,Slovakia,Europe
2069,Pietro Pellegri,ITA,Torino,Serie A,2021,20.0,2001.0,2.4,1,1,0,1,0,0,4,0.0,4,0,0,0,0,1,5,0,FW,20-24,Forward,Italy,Europe
2070,Pietro Pellegri,ITA,Milan,Serie A,2021,20.0,2001.0,1.5,2,2,0,1,1,0,1,0.0,1,0,0,0,0,2,1,0,FW,20-24,Forward,Italy,Europe
2071,Lorenzo Pellegrini,ITA,Roma,Serie A,2021,25.0,1996.0,25.4,35,14,10,17,8,16,60,26.7,44,29,1,28,27,62,20,0,MF,25-29,Midfielder,Italy,Europe
2072,Luca Pellegrini,ITA,Juventus,Serie A,2021,22.0,1999.0,12.3,23,10,13,5,5,12,19,63.2,7,9,1,8,5,28,23,0,DF,20-24,Defender,Italy,Europe
2073,Facundo Pellistri,URU,Alavés,La Liga,2021,19.0,2001.0,7.5,9,5,4,3,2,1,10,10.0,9,13,2,11,6,15,7,0,"MF,FW",Under 20,Midfielder,Uruguay,South America
2074,Federico Peluso,ITA,Sassuolo,Serie A,2021,37.0,1984.0,0.1,1,1,0,1,0,1,1,100.0,0,0,0,0,0,1,0,0,DF,35-39,Defender,Italy,Europe
2075,Timothee Pembele,FRA,Bordeaux,Ligue 1,2021,18.0,2002.0,15.7,20,8,8,10,2,10,29,34.5,19,12,3,9,16,36,24,0,DF,Under 20,Defender,France,Europe
2077,Philipp Pentke,GER,Hoffenheim,Bundesliga,2021,36.0,1985.0,1.0,0,0,0,0,0,0,0,,0,0,0,0,0,0,0,0,GK,35-39,Goalkeeper,Germany,Europe
2078,Nicolas Pépé,CIV,Arsenal,Premier League,2021,26.0,1995.0,7.7,8,5,3,5,0,3,9,33.3,6,9,1,8,8,16,2,0,"FW,MF",25-29,Forward,Ivory Coast,Africa
2079,Ricardo Pepi,USA,Augsburg,Bundesliga,2021,18.0,2003.0,5.3,4,2,1,3,0,1,8,12.5,7,7,0,7,3,7,8,0,"FW,MF",Under 20,Forward,United States,North America
2081,Brayann Pereira,FRA,Lens,Ligue 1,2021,18.0,2003.0,0.2,1,1,1,0,0,1,1,100.0,0,0,0,0,0,1,1,0,"DF,MF",Under 20,Defender,France,Europe
2082,Danilo Pereira,POR,Paris S-G,Ligue 1,2021,29.0,1991.0,22.6,33,17,10,20,3,14,28,50.0,14,19,10,9,37,70,29,1,MF,25-29,Midfielder,Portugal,Europe
2083,Mathias Pereira Lage,POR,Angers,Ligue 1,2021,24.0,1996.0,11.6,21,7,10,7,4,8,30,26.7,22,18,7,11,21,42,22,0,DF,20-24,Defender,Portugal,Europe
2084,Ricardo Pereira,POR,Leicester City,Premier League,2021,27.0,1993.0,11.0,37,20,19,13,5,21,40,52.5,19,13,1,12,17,54,39,0,DF,25-29,Defender,Portugal,Europe
2085,Gastón Pereiro,URU,Cagliari,Serie A,2021,26.0,1995.0,10.8,13,5,7,4,2,5,18,27.8,13,12,1,11,1,14,8,0,"FW,MF",25-29,Forward,Uruguay,South America
2086,Luan Peres Petroni,BRA,Marseille,Ligue 1,2021,27.0,1994.0,29.8,65,35,33,25,7,36,52,69.2,16,26,12,14,43,108,64,1,DF,25-29,Defender,Brazil,South America
2087,Dor Peretz,ISR,Venezia,Serie A,2021,26.0,1995.0,6.5,27,18,8,16,3,13,25,52.0,12,8,4,4,8,35,11,0,MF,25-29,Midfielder,Israel,Asia
2088,Roberto Pereyra,ARG,Udinese,Serie A,2021,30.0,1991.0,19.9,18,12,7,6,5,7,23,30.4,16,26,5,21,12,30,11,0,"MF,FW",30-34,Midfielder,Argentina,South America
2096,Nehuén Pérez,ARG,Udinese,Serie A,2021,21.0,2000.0,18.8,44,21,21,21,2,16,25,64.0,9,27,9,18,21,65,47,0,DF,20-24,Defender,Argentina,South America
2097,Mattia Perin,ITA,Juventus,Serie A,2021,28.0,1992.0,4.5,0,0,0,0,0,0,0,,0,0,0,0,0,0,3,0,GK,25-29,Goalkeeper,Italy,Europe
2098,Ivan Perišić,CRO,Inter,Serie A,2021,32.0,1989.0,31.3,38,22,18,11,9,28,50,56.0,22,39,7,32,47,85,42,0,DF,30-34,Defender,Croatia,Europe
2099,Sonny Perkins,ENG,West Ham,Premier League,2021,17.0,2004.0,0.0,0,0,0,0,0,0,0,,0,0,0,0,0,0,0,0,MF,Under 20,Midfielder,England,Europe
2100,Diego Perotti,ARG,Salernitana,Serie A,2021,33.0,1988.0,3.2,11,5,7,1,3,4,13,30.8,9,1,0,1,2,13,6,0,"MF,FW",30-34,Midfielder,Argentina,South America
2101,Romain Perraud,FRA,Southampton,Premier League,2021,23.0,1997.0,18.0,34,22,18,14,2,16,29,55.2,13,24,6,18,17,51,42,0,DF,20-24,Defender,France,Europe
2102,Lucas Perrin,FRA,Strasbourg,Ligue 1,2021,22.0,1998.0,27.8,43,32,24,17,2,26,45,57.8,19,28,11,17,42,85,67,0,DF,20-24,Defender,France,Europe
2103,Mario Perrone,ITA,Salernitana,Serie A,2021,18.0,2003.0,0.2,0,0,0,0,0,0,0,,0,0,0,0,0,0,0,0,DF,Under 20,Defender,Italy,Europe
2104,Pavao Pervan,AUT,Wolfsburg,Bundesliga,2021,33.0,1987.0,6.0,0,0,0,0,0,0,0,,0,0,0,0,0,0,3,0,GK,30-34,Goalkeeper,Austria,Europe
2105,Matteo Pessina,ITA,Atalanta,Serie A,2021,24.0,1997.0,16.0,27,14,10,11,6,14,33,42.4,19,22,3,19,13,40,7,0,"MF,FW",20-24,Midfielder,Italy,Europe
2106,Andrea Petagna,ITA,Napoli,Serie A,2021,26.0,1995.0,6.5,3,3,0,3,0,1,4,25.0,3,1,0,1,0,3,5,0,FW,25-29,Forward,Italy,Europe
2107,Nils Petersen,GER,Freiburg,Bundesliga,2021,32.0,1988.0,6.4,5,3,2,3,0,1,13,7.7,12,7,0,7,2,7,17,0,FW,30-34,Forward,Germany,Europe
2108,Danijel Petković,MNE,Angers,Ligue 1,2021,28.0,1993.0,15.0,0,0,0,0,0,0,1,0.0,1,0,0,0,1,1,9,5,GK,25-29,Goalkeeper,Montenegro,Europe
2109,Léo Pétrot,FRA,Lorient,Ligue 1,2021,24.0,1997.0,20.2,31,17,23,8,0,21,29,72.4,8,33,17,16,22,53,86,0,DF,20-24,Defender,France,Europe
2113,Germán Pezzella,ARG,Betis,La Liga,2021,30.0,1991.0,22.1,21,9,16,5,0,16,29,55.2,13,29,18,11,39,60,106,0,DF,30-34,Defender,Argentina,South America
2114,Giuseppe Pezzella,ITA,Atalanta,Serie A,2021,23.0,1997.0,11.9,28,13,15,7,6,8,18,44.4,10,13,5,8,9,37,16,0,"DF,MF",20-24,Defender,Italy,Europe
2115,Immanuel Pherai,SUR,Dortmund,Bundesliga,2021,20.0,2001.0,0.0,0,0,0,0,0,0,0,,0,0,0,0,0,0,0,0,MF,20-24,Midfielder,Suriname,South America
2116,Maximilian Philipp,GER,Wolfsburg,Bundesliga,2021,27.0,1994.0,10.7,15,11,6,7,2,5,21,23.8,16,12,1,11,4,19,5,0,MF,25-29,Midfielder,Germany,Europe
2117,Romain Philippoteaux,FRA,Brest,Ligue 1,2021,33.0,1988.0,0.3,1,1,0,1,0,0,0,,0,0,0,0,0,1,0,0,MF,30-34,Midfielder,France,Europe
2118,Kalvin Phillips,ENG,Leeds United,Premier League,2021,25.0,1995.0,17.7,54,25,24,25,5,24,57,42.1,33,37,9,28,24,78,18,0,MF,25-29,Midfielder,England,Europe
2119,Jaden Philogene Bidace,ENG,Aston Villa,Premier League,2021,19.0,2002.0,0.1,0,0,0,0,0,0,0,,0,0,0,0,0,0,0,0,FW,Under 20,Forward,England,Europe
2120,Jérôme Phojo,FRA,Clermont Foot,Ligue 1,2021,28.0,1993.0,0.1,0,0,0,0,0,0,0,,0,0,0,0,0,0,1,0,DF,25-29,Defender,France,Europe
2123,Pablo Piatti,ARG,Elche,La Liga,2021,32.0,1989.0,3.5,9,4,5,3,1,3,8,37.5,5,5,1,4,2,11,3,0,"MF,FW",30-34,Midfielder,Argentina,South America
2124,Cristiano Piccini,ITA,Valencia,La Liga,2021,28.0,1992.0,3.6,14,8,9,5,0,5,7,71.4,2,3,2,1,1,15,11,0,DF,25-29,Defender,Italy,Europe
2125,Roberto Piccoli,ITA,Genoa,Serie A,2021,20.0,2001.0,2.4,1,1,0,1,0,0,0,,0,0,0,0,1,2,1,1,FW,20-24,Forward,Italy,Europe
2126,Roberto Piccoli,ITA,Atalanta,Serie A,2021,20.0,2001.0,2.2,2,0,0,0,2,0,2,0.0,2,1,0,1,0,2,0,0,FW,20-24,Forward,Italy,Europe
2127,Jordan Pickford,ENG,Everton,Premier League,2021,27.0,1994.0,35.0,1,1,1,0,0,0,1,0.0,1,1,0,1,1,2,14,1,GK,25-29,Goalkeeper,England,Europe
2128,Jérémy Pied,FRA,Lille,Ligue 1,2021,32.0,1989.0,0.1,0,0,0,0,0,0,0,,0,0,0,0,1,1,0,0,"DF,FW",30-34,Defender,France,Europe
2129,Amos Pieper,GER,Arminia,Bundesliga,2021,23.0,1998.0,26.4,58,29,38,19,1,32,51,62.7,19,37,23,14,50,108,132,1,DF,20-24,Defender,Germany,Europe
2130,Ronaël Pierre-Gabriel,FRA,Brest,Ligue 1,2021,23.0,1998.0,28.3,79,45,52,21,6,42,73,57.5,31,22,7,15,48,127,74,0,DF,20-24,Defender,France,Europe
2131,Erik Pieters,NED,Burnley,Premier League,2021,32.0,1988.0,8.1,28,15,15,11,2,17,28,60.7,11,18,7,11,10,38,38,0,DF,30-34,Defender,Netherlands,Europe
2133,Andrea Pinamonti,ITA,Empoli,Serie A,2021,22.0,1999.0,31.9,11,6,0,7,4,2,18,11.1,16,24,3,21,7,18,23,0,FW,20-24,Forward,Italy,Europe
2134,Orbelín Pineda,MEX,Celta Vigo,La Liga,2021,25.0,1996.0,1.1,4,1,4,0,0,1,2,50.0,1,0,0,0,0,4,1,0,"MF,FW",25-29,Midfielder,Mexico,North America
2135,Ethan Pinnock,JAM,Brentford,Premier League,2021,28.0,1993.0,29.9,51,35,37,12,2,25,38,65.8,13,30,11,19,44,95,154,1,DF,25-29,Defender,Jamaica,North America
2137,Carlo Pinsoglio,ITA,Juventus,Serie A,2021,31.0,1990.0,0.5,0,0,0,0,0,0,0,,0,0,0,0,0,0,0,0,GK,30-34,Goalkeeper,Italy,Europe
2138,Riccardo Pinzi,ITA,Udinese,Serie A,2021,17.0,2003.0,0.0,0,0,0,0,0,0,0,,0,0,0,0,0,0,0,0,FW,Under 20,Forward,Italy,Europe
2140,Marko Pjaca,CRO,Torino,Serie A,2021,26.0,1995.0,12.8,7,4,1,4,2,3,8,37.5,5,10,2,8,4,11,2,0,MF,25-29,Midfielder,Croatia,Europe
2141,Marvin Plattenhardt,GER,Hertha BSC,Bundesliga,2021,29.0,1992.0,18.2,25,11,18,6,1,15,27,55.6,12,18,3,15,17,42,52,0,DF,25-29,Defender,Germany,Europe
2142,Alassane Pléa,FRA,Gladbach,Bundesliga,2021,28.0,1993.0,23.0,18,14,6,9,3,7,20,35.0,13,9,1,8,4,22,9,0,"MF,FW",25-29,Midfielder,France,Europe
2143,Tommaso Pobega,ITA,Torino,Serie A,2021,22.0,1999.0,24.9,48,30,17,20,11,21,40,52.5,19,32,3,29,25,73,38,0,MF,20-24,Midfielder,Italy,Europe
2144,Daniel Podence,POR,Wolves,Premier League,2021,25.0,1995.0,16.5,18,11,10,5,3,4,17,23.5,13,8,1,7,10,28,1,0,"FW,MF",25-29,Forward,Portugal,Europe
2145,Suf Podgoreanu,ISR,Spezia,Serie A,2021,19.0,2002.0,1.3,2,0,1,1,0,1,4,25.0,3,2,0,2,1,3,3,0,FW,Under 20,Forward,Israel,Asia
2146,Paul Pogba,FRA,Manchester Utd,Premier League,2021,28.0,1993.0,15.0,13,9,5,7,1,6,28,21.4,22,11,0,11,13,26,16,0,"MF,FW",25-29,Midfielder,France,Europe
2147,Joel Pohjanpalo,FIN,Leverkusen,Bundesliga,2021,26.0,1994.0,0.1,0,0,0,0,0,0,0,,0,0,0,0,0,0,0,0,FW,25-29,Forward,Finland,Europe
2148,Matteo Politano,ITA,Napoli,Serie A,2021,27.0,1993.0,18.3,24,12,8,11,5,15,54,27.8,39,11,2,9,13,37,5,0,FW,25-29,Forward,Italy,Europe
2149,Julian Pollersbeck,GER,Lyon,Ligue 1,2021,26.0,1994.0,4.8,0,0,0,0,0,0,0,,0,0,0,0,1,1,1,0,GK,25-29,Goalkeeper,Germany,Europe
2150,Sebastian Polter,GER,Bochum,Bundesliga,2021,30.0,1991.0,26.0,9,3,1,4,4,2,11,18.2,9,15,5,10,2,11,24,0,FW,30-34,Forward,Germany,Europe
2151,Ezequiel Ponce,ARG,Elche,La Liga,2021,24.0,1997.0,7.4,5,4,1,3,1,3,10,30.0,7,5,0,5,1,6,7,0,FW,20-24,Forward,Argentina,South America
2152,Marin Pongračić,CRO,Dortmund,Bundesliga,2021,23.0,1997.0,9.2,17,10,13,4,0,6,10,60.0,4,11,5,6,17,34,32,2,DF,20-24,Defender,Croatia,Europe
2154,Nick Pope,ENG,Burnley,Premier League,2021,29.0,1992.0,36.0,0,0,0,0,0,0,2,0.0,2,0,0,0,2,2,30,3,GK,25-29,Goalkeeper,England,Europe
2155,Manolo Portanova,ITA,Genoa,Serie A,2021,21.0,2000.0,14.7,46,28,9,26,11,14,34,41.2,20,26,2,24,17,63,22,0,"FW,MF",20-24,Forward,Italy,Europe
2157,Stefan Posch,AUT,Hoffenheim,Bundesliga,2021,24.0,1997.0,24.4,48,30,20,26,2,22,39,56.4,17,43,18,25,28,76,71,2,DF,20-24,Defender,Austria,Europe
2159,Yussuf Poulsen,DEN,RB Leipzig,Bundesliga,2021,27.0,1994.0,12.0,13,4,3,6,4,3,13,23.1,10,13,0,13,3,16,9,0,"FW,MF",25-29,Forward,Denmark,Europe
2160,Gaëtan Poussin,FRA,Bordeaux,Ligue 1,2021,22.0,1999.0,13.0,1,1,1,0,0,1,1,100.0,0,0,0,0,0,1,15,1,GK,20-24,Goalkeeper,France,Europe
2163,Dennis Praet,BEL,Torino,Serie A,2021,27.0,1994.0,17.1,19,10,6,8,5,8,22,36.4,14,12,1,11,3,22,4,0,MF,25-29,Midfielder,Belgium,Europe
2166,Sanjin Prcić,BIH,Strasbourg,Ligue 1,2021,27.0,1993.0,24.3,47,28,14,27,6,14,29,48.3,15,18,3,15,47,94,19,0,MF,25-29,Midfielder,Bosnia and Herzegovina,Europe
2167,Nicolas de Préville,FRA,Metz,Ligue 1,2021,30.0,1991.0,21.9,17,8,7,8,2,3,19,15.8,16,12,4,8,5,22,11,0,"FW,MF",30-34,Forward,France,Europe
2169,Manuel Prietl,AUT,Arminia,Bundesliga,2021,29.0,1991.0,23.6,59,26,23,31,5,23,60,38.3,37,28,3,25,39,98,33,0,MF,25-29,Midfielder,Austria,Europe
2171,Grischa Prömel,GER,Union Berlin,Bundesliga,2021,26.0,1995.0,26.9,36,22,14,17,5,22,52,42.3,30,18,3,15,23,59,22,0,MF,25-29,Midfielder,Germany,Europe
2172,Nick Proschwitz,GER,Hoffenheim,Bundesliga,2021,34.0,1986.0,0.3,0,0,0,0,0,0,0,,0,0,0,0,0,0,0,0,FW,30-34,Forward,Germany,Europe
2173,Ivan Provedel,ITA,Spezia,Serie A,2021,27.0,1994.0,30.7,0,0,0,0,0,0,1,0.0,1,0,0,0,2,2,10,2,GK,25-29,Goalkeeper,Italy,Europe
2178,Teemu Pukki,FIN,Norwich City,Premier League,2021,31.0,1990.0,36.1,23,11,2,14,7,6,29,20.7,23,21,1,20,4,27,3,0,FW,30-34,Forward,Finland,Europe
2179,Erick Pulgar,CHI,Fiorentina,Serie A,2021,27.0,1994.0,3.8,6,6,4,2,0,4,9,44.4,5,5,1,4,5,11,2,1,MF,25-29,Midfielder,Chile,South America
2180,Christian Pulisic,USA,Chelsea,Premier League,2021,22.0,1998.0,14.3,10,7,6,3,1,3,17,17.6,14,12,0,12,5,15,10,0,"MF,FW",20-24,Midfielder,United States,North America
2181,Afimico Pululu,FRA,Greuther Fürth,Bundesliga,2021,22.0,1999.0,0.8,1,0,1,0,0,1,2,50.0,1,1,0,1,0,1,0,0,"FW,MF",20-24,Forward,France,Europe
2182,Ignacio Pussetto,ARG,Udinese,Serie A,2021,25.0,1995.0,13.4,17,9,2,9,6,2,10,20.0,8,18,2,16,4,21,13,0,"FW,MF",25-29,Forward,Argentina,South America
2183,Niklas Pyyhtiä,FIN,Bologna,Serie A,2021,17.0,2003.0,0.2,0,0,0,0,0,0,1,0.0,1,0,0,0,0,0,0,0,MF,Under 20,Midfielder,Finland,Europe
2185,Yacine Qasmi,MAR,Rayo Vallecano,La Liga,2021,30.0,1991.0,0.0,0,0,0,0,0,0,0,,0,0,0,0,0,0,0,0,FW,30-34,Forward,Morocco,Africa
2186,Fabio Quagliarella,ITA,Sampdoria,Serie A,2021,38.0,1983.0,18.5,6,2,2,2,2,2,15,13.3,13,14,1,13,3,9,12,0,FW,35-39,Forward,Italy,Europe
2190,Adrien Rabiot,FRA,Juventus,Serie A,2021,26.0,1995.0,25.4,64,43,32,24,8,15,34,44.1,19,34,8,26,20,84,41,1,MF,25-29,Midfielder,France,Europe
2195,Ionuț Radu,ROU,Inter,Serie A,2021,24.0,1997.0,1.0,0,0,0,0,0,0,0,,0,0,0,0,0,0,0,1,GK,20-24,Goalkeeper,Romania,Europe
2196,Ștefan Radu,ROU,Lazio,Serie A,2021,34.0,1986.0,6.2,9,6,3,6,0,5,9,55.6,4,7,2,5,5,14,15,0,DF,30-34,Defender,Romania,Europe
2198,Sidney Raebiger,GER,RB Leipzig,Bundesliga,2021,16.0,2005.0,0.0,0,0,0,0,0,0,0,,0,0,0,0,0,0,0,0,MF,Under 20,Midfielder,Germany,Europe
2199,Rafinha,BRA,Real Sociedad,La Liga,2021,28.0,1993.0,11.7,43,27,17,20,6,16,28,57.1,12,21,2,19,12,55,4,0,MF,25-29,Midfielder,Brazil,South America
2199,Rafinha,BRA,Real Sociedad,La Liga,2021,28.0,1993.0,11.7,43,27,17,20,6,16,28,57.1,12,21,2,19,12,55,4,0,MF,25-29,Midfielder,Brazil,South America
2199,Rafinha,BRA,Real Sociedad,La Liga,2021,28.0,1993.0,11.7,43,27,17,20,6,16,28,57.1,12,21,2,19,12,55,4,0,MF,25-29,Midfielder,Brazil,South America
2199,Rafinha,BRA,Real Sociedad,La Liga,2021,28.0,1993.0,11.7,43,27,17,20,6,16,28,57.1,12,21,2,19,12,55,4,0,MF,25-29,Midfielder,Brazil,South America
2199,Rafinha,BRA,Real Sociedad,La Liga,2021,28.0,1993.0,11.7,43,27,17,20,6,16,28,57.1,12,21,2,19,12,55,4,0,MF,25-29,Midfielder,Brazil,South America
2199,Rafinha,BRA,Real Sociedad,La Liga,2021,28.0,1993.0,11.7,43,27,17,20,6,16,28,57.1,12,21,2,19,12,55,4,0,MF,25-29,Midfielder,Brazil,South America
2199,Rafinha,BRA,Real Sociedad,La Liga,2021,28.0,1993.0,11.7,43,27,17,20,6,16,28,57.1,12,21,2,19,12,55,4,0,MF,25-29,Midfielder,Brazil,South America
2199,Rafinha,BRA,Real Sociedad,La Liga,2021,28.0,1993.0,11.7,43,27,17,20,6,16,28,57.1,12,21,2,19,12,55,4,0,MF,25-29,Midfielder,Brazil,South America
2199,Rafinha,BRA,Real Sociedad,La Liga,2021,28.0,1993.0,11.7,43,27,17,20,6,16,28,57.1,12,21,2,19,12,55,4,0,MF,25-29,Midfielder,Brazil,South America
2199,Rafinha,BRA,Real Sociedad,La Liga,2021,28.0,1993.0,11.7,43,27,17,20,6,16,28,57.1,12,21,2,19,12,55,4,0,MF,25-29,Midfielder,Brazil,South America
2199,Rafinha,BRA,Real Sociedad,La Liga,2021,28.0,1993.0,11.7,43,27,17,20,6,16,28,57.1,12,21,2,19,12,55,4,0,MF,25-29,Midfielder,Brazil,South America
2199,Rafinha,BRA,Real Sociedad,La Liga,2021,28.0,1993.0,11.7,43,27,17,20,6,16,28,57.1,12,21,2,19,12,55,4,0,MF,25-29,Midfielder,Brazil,South America
2199,Rafinha,BRA,Real Sociedad,La Liga,2021,28.0,1993.0,11.7,43,27,17,20,6,16,28,57.1,12,21,2,19,12,55,4,0,MF,25-29,Midfielder,Brazil,South America
2199,Rafinha,BRA,Real Sociedad,La Liga,2021,28.0,1993.0,11.7,43,27,17,20,6,16,28,57.1,12,21,2,19,12,55,4,0,MF,25-29,Midfielder,Brazil,South America
2199,Rafinha,BRA,Real Sociedad,La Liga,2021,28.0,1993.0,11.7,43,27,17,20,6,16,28,57.1,12,21,2,19,12,55,4,0,MF,25-29,Midfielder,Brazil,South America
2199,Rafinha,BRA,Real Sociedad,La Liga,2021,28.0,1993.0,11.7,43,27,17,20,6,16,28,57.1,12,21,2,19,12,55,4,0,MF,25-29,Midfielder,Brazil,South America
2200,Rafinha,BRA,Paris S-G,Ligue 1,2021,28.0,1993.0,2.4,14,8,3,9,2,7,11,63.6,4,3,0,3,4,18,0,0,"FW,MF",25-29,Forward,Brazil,South America
2200,Rafinha,BRA,Paris S-G,Ligue 1,2021,28.0,1993.0,2.4,14,8,3,9,2,7,11,63.6,4,3,0,3,4,18,0,0,"FW,MF",25-29,Forward,Brazil,South America
2200,Rafinha,BRA,Paris S-G,Ligue 1,2021,28.0,1993.0,2.4,14,8,3,9,2,7,11,63.6,4,3,0,3,4,18,0,0,"FW,MF",25-29,Forward,Brazil,South America
2200,Rafinha,BRA,Paris S-G,Ligue 1,2021,28.0,1993.0,2.4,14,8,3,9,2,7,11,63.6,4,3,0,3,4,18,0,0,"FW,MF",25-29,Forward,Brazil,South America
2200,Rafinha,BRA,Paris S-G,Ligue 1,2021,28.0,1993.0,2.4,14,8,3,9,2,7,11,63.6,4,3,0,3,4,18,0,0,"FW,MF",25-29,Forward,Brazil,South America
2200,Rafinha,BRA,Paris S-G,Ligue 1,2021,28.0,1993.0,2.4,14,8,3,9,2,7,11,63.6,4,3,0,3,4,18,0,0,"FW,MF",25-29,Forward,Brazil,South America
2200,Rafinha,BRA,Paris S-G,Ligue 1,2021,28.0,1993.0,2.4,14,8,3,9,2,7,11,63.6,4,3,0,3,4,18,0,0,"FW,MF",25-29,Forward,Brazil,South America
2200,Rafinha,BRA,Paris S-G,Ligue 1,2021,28.0,1993.0,2.4,14,8,3,9,2,7,11,63.6,4,3,0,3,4,18,0,0,"FW,MF",25-29,Forward,Brazil,South America
2200,Rafinha,BRA,Paris S-G,Ligue 1,2021,28.0,1993.0,2.4,14,8,3,9,2,7,11,63.6,4,3,0,3,4,18,0,0,"FW,MF",25-29,Forward,Brazil,South America
2200,Rafinha,BRA,Paris S-G,Ligue 1,2021,28.0,1993.0,2.4,14,8,3,9,2,7,11,63.6,4,3,0,3,4,18,0,0,"FW,MF",25-29,Forward,Brazil,South America
2200,Rafinha,BRA,Paris S-G,Ligue 1,2021,28.0,1993.0,2.4,14,8,3,9,2,7,11,63.6,4,3,0,3,4,18,0,0,"FW,MF",25-29,Forward,Brazil,South America
2200,Rafinha,BRA,Paris S-G,Ligue 1,2021,28.0,1993.0,2.4,14,8,3,9,2,7,11,63.6,4,3,0,3,4,18,0,0,"FW,MF",25-29,Forward,Brazil,South America
2200,Rafinha,BRA,Paris S-G,Ligue 1,2021,28.0,1993.0,2.4,14,8,3,9,2,7,11,63.6,4,3,0,3,4,18,0,0,"FW,MF",25-29,Forward,Brazil,South America
2200,Rafinha,BRA,Paris S-G,Ligue 1,2021,28.0,1993.0,2.4,14,8,3,9,2,7,11,63.6,4,3,0,3,4,18,0,0,"FW,MF",25-29,Forward,Brazil,South America
2200,Rafinha,BRA,Paris S-G,Ligue 1,2021,28.0,1993.0,2.4,14,8,3,9,2,7,11,63.6,4,3,0,3,4,18,0,0,"FW,MF",25-29,Forward,Brazil,South America
2200,Rafinha,BRA,Paris S-G,Ligue 1,2021,28.0,1993.0,2.4,14,8,3,9,2,7,11,63.6,4,3,0,3,4,18,0,0,"FW,MF",25-29,Forward,Brazil,South America
2202,Antonio Raimondo,ITA,Bologna,Serie A,2021,17.0,2004.0,0.8,0,0,0,0,0,0,1,0.0,1,1,0,1,0,0,1,0,FW,Under 20,Forward,Italy,Europe
2204,Jesurun Rak Sakyi,ENG,Crystal Palace,Premier League,2021,18.0,2002.0,0.9,0,0,0,0,0,0,1,0.0,1,3,0,3,1,1,0,0,"FW,MF",Under 20,Forward,England,Europe
2205,Ivan Rakitić,CRO,Sevilla,La Liga,2021,33.0,1988.0,24.2,40,22,12,23,5,13,40,32.5,27,31,8,23,23,63,35,0,MF,30-34,Midfielder,Croatia,Europe
2206,Diant Ramaj,GER,Eint Frankfurt,Bundesliga,2021,19.0,2001.0,1.0,0,0,0,0,0,0,0,,0,0,0,0,0,0,3,0,GK,Under 20,Goalkeeper,Germany,Europe
2208,Adil Rami,FRA,Troyes,Ligue 1,2021,35.0,1985.0,13.0,10,9,6,4,0,7,8,87.5,1,17,9,8,16,26,43,0,DF,35-39,Defender,France,Europe
2210,Guilherme Ramos,POR,Arminia,Bundesliga,2021,23.0,1997.0,10.1,25,15,17,8,0,12,19,63.2,7,21,8,13,27,52,52,0,DF,20-24,Defender,Portugal,Europe
2212,Aaron Ramsdale,ENG,Arsenal,Premier League,2021,23.0,1998.0,34.0,2,1,2,0,0,1,2,50.0,1,0,0,0,0,2,26,3,GK,20-24,Goalkeeper,England,Europe
2213,Aaron Ramsey,WAL,Juventus,Serie A,2021,30.0,1990.0,1.1,0,0,0,0,0,0,0,,0,0,0,0,1,1,0,0,MF,30-34,Midfielder,Wales,Europe
2213,Aaron Ramsey,WAL,Juventus,Serie A,2021,30.0,1990.0,1.1,0,0,0,0,0,0,0,,0,0,0,0,1,1,0,0,MF,30-34,Midfielder,Wales,Europe
2213,Aaron Ramsey,WAL,Juventus,Serie A,2021,30.0,1990.0,1.1,0,0,0,0,0,0,0,,0,0,0,0,1,1,0,0,MF,30-34,Midfielder,Wales,Europe
2213,Aaron Ramsey,WAL,Juventus,Serie A,2021,30.0,1990.0,1.1,0,0,0,0,0,0,0,,0,0,0,0,1,1,0,0,MF,30-34,Midfielder,Wales,Europe
2214,Jacob Ramsey,ENG,Aston Villa,Premier League,2021,20.0,2001.0,27.4,67,44,31,28,8,30,69,43.5,39,36,7,29,24,91,28,0,MF,20-24,Midfielder,England,Europe
2215,Luca Ranieri,ITA,Salernitana,Serie A,2021,22.0,1999.0,23.4,38,21,23,11,4,19,33,57.6,14,18,8,10,22,60,67,0,DF,20-24,Defender,Italy,Europe
2216,Andrea Ranocchia,ITA,Inter,Serie A,2021,33.0,1988.0,3.8,8,4,5,1,2,1,3,33.3,2,4,3,1,4,12,16,0,DF,30-34,Defender,Italy,Europe
2217,Raphinha,BRA,Leeds United,Premier League,2021,24.0,1996.0,32.4,51,29,25,14,12,22,71,31.0,49,43,0,43,29,80,28,1,"FW,MF",20-24,Forward,Brazil,South America
2218,Tobias Raschl,GER,Greuther Fürth,Bundesliga,2021,21.0,2000.0,6.6,12,9,4,8,0,5,7,71.4,2,10,1,9,3,15,1,0,MF,20-24,Midfielder,Germany,Europe
2220,Marcus Rashford,ENG,Manchester Utd,Premier League,2021,23.0,1997.0,13.7,6,5,1,4,1,2,13,15.4,11,10,1,9,5,11,5,1,"FW,MF",20-24,Forward,England,Europe
2222,Giacomo Raspadori,ITA,Sassuolo,Serie A,2021,21.0,2000.0,30.4,29,18,5,15,9,11,38,28.9,27,29,3,26,9,38,11,0,"MF,FW",20-24,Midfielder,Italy,Europe
2224,David Raum,GER,Hoffenheim,Bundesliga,2021,23.0,1998.0,30.6,52,29,30,10,12,30,64,46.9,34,38,5,33,27,79,39,1,"DF,FW",20-24,Defender,Germany,Europe
2225,Nicola Ravaglia,ITA,Sampdoria,Serie A,2021,32.0,1988.0,0.1,0,0,0,0,0,0,0,,0,0,0,0,0,0,0,0,GK,30-34,Goalkeeper,Italy,Europe
2227,Ante Rebić,CRO,Milan,Serie A,2021,27.0,1993.0,9.9,14,8,3,6,5,7,20,35.0,13,14,0,14,3,17,3,1,FW,25-29,Forward,Croatia,Europe
2230,Nathan Redmond,ENG,Southampton,Premier League,2021,27.0,1994.0,20.4,22,14,9,9,4,7,30,23.3,23,21,2,19,8,30,16,0,"MF,FW",25-29,Midfielder,England,Europe
2234,Jeff Reine-Adélaïde,FRA,Lyon,Ligue 1,2021,23.0,1998.0,2.2,5,3,4,1,0,4,5,80.0,1,2,0,2,0,5,0,1,"MF,DF",20-24,Midfielder,France,Europe
2235,Reinier,BRA,Dortmund,Bundesliga,2021,19.0,2002.0,1.8,5,3,4,0,1,1,1,100.0,0,3,0,3,0,5,0,0,"FW,MF",Under 20,Forward,Brazil,South America
2236,Karim Rekik,NED,Sevilla,La Liga,2021,26.0,1994.0,12.2,11,8,4,6,1,2,9,22.2,7,11,6,5,9,20,19,0,DF,25-29,Defender,Netherlands,Europe
2238,Panagiotis Retsos,GRE,Hellas Verona,Serie A,2021,22.0,1998.0,0.6,0,0,0,0,0,0,2,0.0,2,0,0,0,2,2,3,0,DF,20-24,Defender,Greece,Europe
2239,Panagiotis Retsos,GRE,Leverkusen,Bundesliga,2021,22.0,1998.0,0.4,0,0,0,0,0,0,0,,0,0,0,0,1,1,0,1,"DF,FW",20-24,Defender,Greece,Europe
2240,Marco Reus,GER,Dortmund,Bundesliga,2021,32.0,1989.0,27.8,45,30,13,21,11,16,42,38.1,26,23,6,17,12,57,41,1,"MF,FW",30-34,Midfielder,Germany,Europe
2242,Gio Reyna,USA,Dortmund,Bundesliga,2021,18.0,2002.0,4.9,7,4,2,4,1,3,9,33.3,6,6,0,6,1,8,3,0,MF,Under 20,Midfielder,United States,North America
2243,Bryan Reynolds,USA,Roma,Serie A,2021,20.0,2001.0,0.0,0,0,0,0,0,0,1,0.0,1,0,0,0,0,0,1,0,DF,20-24,Defender,United States,North America
2245,Tiago Ribeiro,POR,Monaco,Ligue 1,2021,19.0,2002.0,0.0,0,0,0,0,0,0,0,,0,0,0,0,0,0,0,0,FW,Under 20,Forward,Portugal,Europe
2246,Franck Ribéry,FRA,Salernitana,Serie A,2021,38.0,1983.0,15.8,17,10,6,6,5,8,13,61.5,5,12,0,12,3,20,1,0,"MF,FW",35-39,Midfielder,France,Europe
2247,Samuele Ricci,ITA,Torino,Serie A,2021,19.0,2001.0,8.0,8,4,4,2,2,2,5,40.0,3,7,1,6,14,22,9,0,MF,Under 20,Midfielder,Italy,Europe
2248,Samuele Ricci,ITA,Empoli,Serie A,2021,19.0,2001.0,17.0,33,19,17,13,3,20,34,58.8,14,24,5,19,31,64,18,0,MF,Under 20,Midfielder,Italy,Europe
2249,Declan Rice,ENG,West Ham,Premier League,2021,22.0,1999.0,35.3,80,42,45,32,3,38,71,53.5,33,45,21,24,63,143,52,1,MF,20-24,Midfielder,England,Europe
2250,Chris Richards,USA,Hoffenheim,Bundesliga,2021,21.0,2000.0,14.5,26,15,10,15,1,11,18,61.1,7,21,9,12,22,48,50,1,DF,20-24,Defender,United States,North America
2251,Chris Richards,USA,Bayern Munich,Bundesliga,2021,21.0,2000.0,0.0,0,0,0,0,0,0,0,,0,1,0,1,0,0,0,0,DF,20-24,Defender,United States,North America
2252,Omar Richards,ENG,Bayern Munich,Bundesliga,2021,23.0,1998.0,4.9,19,12,11,5,3,11,16,68.8,5,7,1,6,4,23,7,0,DF,20-24,Defender,England,Europe
2253,Taylor Richards,ENG,Brighton,Premier League,2021,20.0,2000.0,0.3,1,0,0,1,0,1,2,50.0,1,0,0,0,0,1,0,0,MF,20-24,Midfielder,England,Europe
2254,Richarlison,BRA,Everton,Premier League,2021,24.0,1997.0,28.0,40,23,18,15,7,15,31,48.4,16,42,4,38,12,52,34,0,FW,20-24,Forward,Brazil,South America
2255,Marco Richter,GER,Hertha BSC,Bundesliga,2021,23.0,1997.0,18.9,30,16,14,10,6,13,36,36.1,23,30,4,26,16,46,24,0,"FW,MF",20-24,Forward,Germany,Europe
2259,Jaïro Riedewald,NED,Crystal Palace,Premier League,2021,24.0,1996.0,1.3,1,1,0,1,0,1,2,50.0,1,1,0,1,1,2,2,0,MF,20-24,Midfielder,Netherlands,Europe
2260,Manuel Riemann,GER,Bochum,Bundesliga,2021,32.0,1988.0,31.0,1,0,1,0,0,1,4,25.0,3,0,0,0,1,2,12,3,GK,30-34,Goalkeeper,Germany,Europe
2261,Tomás Rincón,VEN,Torino,Serie A,2021,33.0,1988.0,1.8,2,2,2,0,0,0,3,0.0,3,3,1,2,2,4,4,0,MF,30-34,Midfielder,Venezuela,South America
2262,Tomás Rincón,VEN,Sampdoria,Serie A,2021,33.0,1988.0,13.0,22,13,9,10,3,13,34,38.2,21,15,2,13,18,40,11,0,MF,30-34,Midfielder,Venezuela,South America
2264,Renaud Ripart,FRA,Troyes,Ligue 1,2021,28.0,1993.0,21.0,38,21,18,15,5,18,50,36.0,32,21,1,20,19,57,21,1,"MF,FW",25-29,Midfielder,France,Europe
2266,Matt Ritchie,SCO,Newcastle Utd,Premier League,2021,31.0,1989.0,14.9,22,15,10,10,2,10,27,37.0,17,10,2,8,13,35,26,0,DF,30-34,Defender,Scotland,Europe
2267,Maxence Rivera,FRA,Saint-Étienne,Ligue 1,2021,19.0,2002.0,0.1,0,0,0,0,0,0,0,,0,0,0,0,0,0,0,0,FW,Under 20,Forward,France,Europe
2270,Connor Roberts,WAL,Burnley,Premier League,2021,25.0,1995.0,18.8,20,13,10,7,3,10,15,66.7,5,25,5,20,22,42,62,1,DF,25-29,Defender,Wales,Europe
2271,Patrick Roberts,ENG,Troyes,Ligue 1,2021,24.0,1997.0,0.2,0,0,0,0,0,0,0,,0,0,0,0,0,0,0,0,MF,20-24,Midfielder,England,Europe
2272,Tyler Roberts,WAL,Leeds United,Premier League,2021,22.0,1999.0,11.0,16,7,6,7,3,9,16,56.3,7,11,1,10,5,21,11,0,"MF,FW",20-24,Midfielder,Wales,Europe
2273,Andrew Robertson,SCO,Liverpool,Premier League,2021,27.0,1994.0,28.2,36,21,16,15,5,20,35,57.1,15,24,3,21,23,59,61,0,DF,25-29,Defender,Scotland,Europe
2276,Cimo Röcker,GER,Hertha BSC,Bundesliga,2021,27.0,1994.0,0.2,0,0,0,0,0,0,0,,0,0,0,0,2,2,0,0,DF,25-29,Defender,Germany,Europe
2277,Enzo Roco,CHI,Elche,La Liga,2021,28.0,1992.0,28.4,36,20,24,11,1,15,24,62.5,9,38,27,11,28,64,110,3,DF,25-29,Defender,Chile,South America
2279,Sebastian Rode,GER,Eint Frankfurt,Bundesliga,2021,30.0,1990.0,8.4,15,7,5,8,2,5,17,29.4,12,11,1,10,13,28,8,0,MF,30-34,Midfielder,Germany,Europe
2280,Joe Rodon,WAL,Tottenham,Premier League,2021,23.0,1997.0,1.0,0,0,0,0,0,0,0,,0,2,1,1,0,0,7,0,DF,20-24,Defender,Wales,Europe
2284,Gerson Rodrigues,LUX,Troyes,Ligue 1,2021,26.0,1995.0,9.4,12,9,2,6,4,1,17,5.9,16,8,1,7,0,12,2,0,"FW,MF",25-29,Forward,Luxembourg,Europe
2285,Kévin Rodrigues,POR,Rayo Vallecano,La Liga,2021,27.0,1994.0,4.8,15,11,8,7,0,6,10,60.0,4,10,1,9,7,22,6,0,"DF,FW",25-29,Defender,Portugal,Europe
2290,Guido Rodríguez,ARG,Betis,La Liga,2021,27.0,1994.0,28.1,97,53,46,45,6,54,98,55.1,44,55,12,43,31,128,56,0,MF,25-29,Midfielder,Argentina,South America
2291,Jay Rodriguez,ENG,Burnley,Premier League,2021,32.0,1989.0,15.4,20,12,8,8,4,4,14,28.6,10,19,1,18,4,24,12,0,FW,30-34,Forward,England,Europe
2292,Ricardo Rodríguez,SUI,Torino,Serie A,2021,28.0,1992.0,27.5,36,21,11,23,2,18,33,54.5,15,22,8,14,41,77,48,1,DF,25-29,Defender,Switzerland,Europe
2293,Rodrygo,BRA,Real Madrid,La Liga,2021,20.0,2001.0,16.9,18,14,7,4,7,3,18,16.7,15,21,0,21,11,29,3,0,FW,20-24,Forward,Brazil,South America
2294,Mads Roerslev,DEN,Brentford,Premier League,2021,22.0,1999.0,13.8,23,12,19,2,2,14,32,43.8,18,14,5,9,16,39,29,0,DF,20-24,Defender,Denmark,Europe
2295,Marko Rog,CRO,Cagliari,Serie A,2021,26.0,1995.0,3.5,5,3,1,2,2,1,8,12.5,7,6,1,5,1,6,3,0,MF,25-29,Midfielder,Croatia,Europe
2296,Rogério,BRA,Sassuolo,Serie A,2021,23.0,1998.0,19.2,21,13,12,5,4,15,22,68.2,7,20,8,12,18,39,42,1,DF,20-24,Defender,Brazil,South America
2296,Rogério,BRA,Sassuolo,Serie A,2021,23.0,1998.0,19.2,21,13,12,5,4,15,22,68.2,7,20,8,12,18,39,42,1,DF,20-24,Defender,Brazil,South America
2296,Rogério,BRA,Sassuolo,Serie A,2021,23.0,1998.0,19.2,21,13,12,5,4,15,22,68.2,7,20,8,12,18,39,42,1,DF,20-24,Defender,Brazil,South America
2296,Rogério,BRA,Sassuolo,Serie A,2021,23.0,1998.0,19.2,21,13,12,5,4,15,22,68.2,7,20,8,12,18,39,42,1,DF,20-24,Defender,Brazil,South America
2297,Alessio Romagnoli,ITA,Milan,Serie A,2021,26.0,1995.0,15.7,24,14,14,10,0,14,18,77.8,4,21,12,9,19,43,45,0,DF,25-29,Defender,Italy,Europe
2298,Simone Romagnoli,ITA,Empoli,Serie A,2021,31.0,1990.0,16.6,28,12,14,12,2,15,20,75.0,5,34,28,6,9,37,86,0,DF,30-34,Defender,Italy,Europe
2300,Cristian Romero,ARG,Tottenham,Premier League,2021,23.0,1998.0,20.5,62,39,39,21,2,22,34,64.7,12,46,21,25,33,95,74,1,DF,20-24,Defender,Argentina,South America
2302,Luka Romero,ARG,Lazio,Serie A,2021,16.0,2004.0,0.9,2,1,0,1,1,0,2,0.0,2,0,0,0,1,3,0,0,FW,Under 20,Forward,Argentina,South America
2303,Sergio Romero,ARG,Venezia,Serie A,2021,34.0,1987.0,16.0,2,2,2,0,0,2,2,100.0,0,0,0,0,1,3,10,0,GK,30-34,Goalkeeper,Argentina,South America
2305,Cristiano Ronaldo,POR,Manchester Utd,Premier League,2021,36.0,1985.0,27.3,8,6,1,5,2,2,6,33.3,4,8,0,8,2,10,29,0,FW,35-39,Forward,Portugal,Europe
2306,Cristiano Ronaldo,POR,Juventus,Serie A,2021,36.0,1985.0,0.3,1,0,0,1,0,1,1,100.0,0,0,0,0,0,1,0,0,FW,35-39,Forward,Portugal,Europe
2307,Salomón Rondón,VEN,Everton,Premier League,2021,31.0,1989.0,8.8,6,1,1,2,3,4,14,28.6,10,5,0,5,0,6,10,0,FW,30-34,Forward,Venezuela,South America
2308,Valentin Rongier,FRA,Marseille,Ligue 1,2021,26.0,1994.0,24.4,77,51,36,36,5,28,60,46.7,32,26,5,21,33,110,14,0,"MF,DF",25-29,Midfielder,France,Europe
2309,Marten de Roon,NED,Atalanta,Serie A,2021,30.0,1991.0,28.3,69,42,33,29,7,34,62,54.8,28,36,2,34,45,114,41,0,"MF,DF",30-34,Midfielder,Netherlands,Europe
2311,Pablo Rosario,NED,Nice,Ligue 1,2021,24.0,1997.0,30.3,59,37,18,32,9,26,66,39.4,40,33,7,26,38,97,43,0,MF,20-24,Midfielder,Netherlands,Europe
2312,Romario Rösch,GER,Mainz 05,Bundesliga,2021,22.0,1999.0,0.0,0,0,0,0,0,0,0,,0,0,0,0,0,0,0,0,MF,20-24,Midfielder,Germany,Europe
2313,Danny Rose,ENG,Watford,Premier League,2021,31.0,1990.0,7.7,16,10,11,4,1,10,24,41.7,14,8,5,3,14,30,11,1,DF,30-34,Defender,England,Europe
2314,Francesco Rossi,ITA,Atalanta,Serie A,2021,30.0,1991.0,0.4,0,0,0,0,0,0,0,,0,0,0,0,0,0,0,0,GK,30-34,Goalkeeper,Italy,Europe
2315,Tom Rothe,GER,Dortmund,Bundesliga,2021,16.0,2004.0,1.0,4,3,2,2,0,3,6,50.0,3,2,0,2,2,6,3,0,DF,Under 20,Defender,Germany,Europe
2316,Jérôme Roussillon,FRA,Wolfsburg,Bundesliga,2021,28.0,1993.0,19.7,14,9,8,6,0,10,16,62.5,6,24,5,19,14,28,34,2,DF,25-29,Defender,France,Europe
2317,Nicolò Rovella,ITA,Genoa,Serie A,2021,19.0,2001.0,16.3,37,26,16,14,7,15,40,37.5,25,21,1,20,20,57,20,0,MF,Under 20,Midfielder,Italy,Europe
2318,Jon Rowe,ENG,Norwich City,Premier League,2021,18.0,2003.0,2.5,3,2,2,1,0,2,3,66.7,1,7,0,7,3,6,1,0,"FW,MF",Under 20,Forward,England,Europe
2320,Ruan,BRA,Sassuolo,Serie A,2021,22.0,1999.0,2.4,7,4,7,0,0,3,4,75.0,1,6,5,1,2,9,24,1,DF,20-24,Defender,Brazil,South America
2322,John Ruddy,ENG,Wolves,Premier League,2021,34.0,1986.0,1.5,0,0,0,0,0,0,0,,0,0,0,0,0,0,3,0,GK,30-34,Goalkeeper,England,Europe
2323,Antonio Rüdiger,GER,Chelsea,Premier League,2021,28.0,1993.0,33.7,48,28,29,15,4,36,48,75.0,12,20,11,9,28,76,91,1,DF,25-29,Defender,Germany,Europe
2324,Sebastian Rudy,GER,Hoffenheim,Bundesliga,2021,31.0,1990.0,8.6,22,12,9,13,0,11,21,52.4,10,8,3,5,11,33,8,1,MF,30-34,Midfielder,Germany,Europe
2325,Daniele Rugani,ITA,Juventus,Serie A,2021,27.0,1994.0,9.8,8,5,4,4,0,4,7,57.1,3,9,4,5,11,19,47,0,DF,25-29,Defender,Italy,Europe
2326,Matteo Ruggeri,ITA,Salernitana,Serie A,2021,19.0,2002.0,7.5,8,4,5,2,1,7,10,70.0,3,6,1,5,2,10,25,0,DF,Under 20,Defender,Italy,Europe
2327,Mário Rui,POR,Napoli,Serie A,2021,30.0,1991.0,33.2,68,43,32,28,8,39,84,46.4,45,31,7,24,40,108,50,0,DF,30-34,Defender,Portugal,Europe
2332,Gerónimo Rulli,ARG,Villarreal,La Liga,2021,29.0,1992.0,32.0,0,0,0,0,0,0,4,0.0,4,0,0,0,1,1,15,5,GK,25-29,Goalkeeper,Argentina,South America
2333,Lukas Rupp,GER,Norwich City,Premier League,2021,30.0,1991.0,8.5,9,4,5,3,1,4,15,26.7,11,11,1,10,9,18,7,0,MF,30-34,Midfielder,Germany,Europe
2334,Alessandro Russo,ITA,Salernitana,Serie A,2021,17.0,2003.0,0.3,1,0,1,0,0,0,1,0.0,1,0,0,0,0,1,1,0,MF,Under 20,Midfielder,Italy,Europe
2334,Alessandro Russo,ITA,Salernitana,Serie A,2021,17.0,2003.0,0.3,1,0,1,0,0,0,1,0.0,1,0,0,0,0,1,1,0,MF,Under 20,Midfielder,Italy,Europe
2334,Alessandro Russo,ITA,Salernitana,Serie A,2021,17.0,2003.0,0.3,1,0,1,0,0,0,1,0.0,1,0,0,0,0,1,1,0,MF,Under 20,Midfielder,Italy,Europe
2334,Alessandro Russo,ITA,Salernitana,Serie A,2021,17.0,2003.0,0.3,1,0,1,0,0,0,1,0.0,1,0,0,0,0,1,1,0,MF,Under 20,Midfielder,Italy,Europe
2335,Franco Russo,ARG,Mallorca,La Liga,2021,26.0,1994.0,16.3,19,10,10,9,0,13,31,41.9,18,14,9,5,27,46,73,1,DF,25-29,Defender,Argentina,South America
2336,Georginio Rutter,FRA,Hoffenheim,Bundesliga,2021,19.0,2002.0,17.9,18,13,4,8,6,6,17,35.3,11,29,1,28,6,24,11,1,"FW,MF",Under 20,Forward,France,Europe
2337,Mathew Ryan,AUS,Real Sociedad,La Liga,2021,29.0,1992.0,3.0,0,0,0,0,0,0,0,,0,0,0,0,0,0,2,0,GK,25-29,Goalkeeper,Australia,Oceania
2339,Frederik Rønnow,DEN,Union Berlin,Bundesliga,2021,28.0,1992.0,7.0,0,0,0,0,0,0,0,,0,0,0,0,0,0,1,0,GK,25-29,Goalkeeper,Denmark,Europe
2340,José Sá,POR,Wolves,Premier League,2021,28.0,1993.0,36.5,2,1,2,0,0,2,4,50.0,2,0,0,0,2,4,19,5,GK,25-29,Goalkeeper,Portugal,Europe
2341,Roli Pereira de Sa,FRA,Nantes,Ligue 1,2021,24.0,1996.0,6.4,12,4,3,5,4,3,20,15.0,17,6,0,6,6,18,3,0,MF,20-24,Midfielder,France,Europe
2342,Youssouf Sabaly,SEN,Betis,La Liga,2021,28.0,1993.0,8.8,12,10,11,0,1,7,13,53.8,6,11,4,7,13,25,16,1,DF,25-29,Defender,Senegal,Africa
2343,Mathys Saban,FRA,Saint-Étienne,Ligue 1,2021,19.0,2002.0,0.8,4,2,2,2,0,1,1,100.0,0,1,0,1,0,4,0,0,"FW,MF",Under 20,Forward,France,Europe
2344,Stefano Sabelli,ITA,Genoa,Serie A,2021,28.0,1993.0,3.9,6,3,3,2,1,3,9,33.3,6,5,1,4,3,9,12,0,DF,25-29,Defender,Italy,Europe
2345,Abdelhamid Sabiri,MAR,Sampdoria,Serie A,2021,24.0,1996.0,9.9,34,18,10,15,9,7,25,28.0,18,10,2,8,7,41,3,0,"MF,FW",20-24,Midfielder,Morocco,Africa
2346,Marcel Sabitzer,AUT,RB Leipzig,Bundesliga,2021,27.0,1994.0,0.5,2,1,1,1,0,1,1,100.0,0,0,0,0,1,3,0,0,"MF,FW",25-29,Midfielder,Austria,Europe
2347,Marcel Sabitzer,AUT,Bayern Munich,Bundesliga,2021,27.0,1994.0,10.1,18,7,8,8,2,9,19,47.4,10,7,0,7,9,27,10,1,"MF,DF",25-29,Midfielder,Austria,Europe
2348,Falaye Sacko,MLI,Saint-Étienne,Ligue 1,2021,26.0,1995.0,7.4,15,10,14,1,0,13,16,81.3,3,11,7,4,4,19,18,2,DF,25-29,Defender,Mali,Africa
2349,Alexis Saelemaekers,BEL,Milan,Serie A,2021,22.0,1999.0,20.7,43,22,12,17,14,15,51,29.4,36,19,0,19,15,58,8,0,FW,20-24,Forward,Belgium,Europe
2351,Wesley Saïd,FRA,Lens,Ligue 1,2021,26.0,1995.0,7.3,10,5,1,8,1,1,9,11.1,8,4,0,4,2,12,0,0,"FW,MF",25-29,Forward,France,Europe
2352,Allan Saint-Maximin,FRA,Newcastle Utd,Premier League,2021,24.0,1997.0,31.2,13,8,6,4,3,3,17,17.6,14,13,2,11,11,24,3,0,"FW,MF",20-24,Forward,France,Europe
2353,Romain Saïss,MAR,Wolves,Premier League,2021,31.0,1990.0,30.1,40,27,28,11,1,19,33,57.6,14,41,21,20,58,98,158,2,DF,30-34,Defender,Morocco,Africa
2354,Bukayo Saka,ENG,Arsenal,Premier League,2021,19.0,2001.0,33.1,40,21,12,17,11,13,39,33.3,26,28,2,26,22,62,23,0,"FW,MF",Under 20,Forward,England,Europe
2355,Mamadou Sakho,FRA,Montpellier,Ligue 1,2021,31.0,1990.0,28.6,34,22,26,8,0,16,26,61.5,10,41,34,7,41,75,134,4,DF,30-34,Defender,France,Europe
2356,Bakary Sako,MLI,Saint-Étienne,Ligue 1,2021,33.0,1988.0,1.7,0,0,0,0,0,0,1,0.0,1,3,1,2,0,0,0,0,"FW,MF",30-34,Forward,Mali,Africa
2357,Jacopo Sala,ITA,Spezia,Serie A,2021,29.0,1991.0,9.8,22,11,10,10,2,13,30,43.3,17,6,0,6,14,36,11,0,MF,25-29,Midfielder,Italy,Europe
2358,Mohamed Salah,EGY,Liverpool,Premier League,2021,29.0,1992.0,30.7,17,8,5,9,3,6,19,31.6,13,7,1,6,6,23,5,0,FW,25-29,Forward,Egypt,Africa
2359,Eddie Salcedo,ITA,Spezia,Serie A,2021,19.0,2001.0,4.8,1,1,0,0,1,0,1,0.0,1,2,1,1,0,1,7,1,"MF,FW",Under 20,Midfielder,Italy,Europe
2360,William Saliba,FRA,Marseille,Ligue 1,2021,20.0,2001.0,36.0,54,32,36,16,2,27,35,77.1,8,24,16,8,48,102,85,0,DF,20-24,Defender,France,Europe
2361,Romain Salin,FRA,Rennes,Ligue 1,2021,37.0,1984.0,1.0,0,0,0,0,0,0,0,,0,0,0,0,0,0,0,0,GK,35-39,Goalkeeper,France,Europe
2362,Mohammed Salisu,GHA,Southampton,Premier League,2021,22.0,1999.0,33.0,80,47,54,22,4,40,65,61.5,25,49,26,23,78,158,158,4,DF,20-24,Defender,Ghana,Africa
2363,Roland Sallai,HUN,Freiburg,Bundesliga,2021,24.0,1997.0,17.2,22,16,8,11,3,7,23,30.4,16,12,0,12,11,33,12,0,"MF,FW",20-24,Midfielder,Hungary,Europe
2367,Diadie Samassékou,MLI,Hoffenheim,Bundesliga,2021,25.0,1996.0,18.4,41,26,14,21,6,21,44,47.7,23,27,11,16,28,69,26,0,MF,25-29,Midfielder,Mali,Africa
2368,Mama Samba Baldé,GNB,Troyes,Ligue 1,2021,25.0,1995.0,19.1,40,28,16,14,10,8,26,30.8,18,32,1,31,5,45,9,0,"MF,FW",25-29,Midfielder,Guinea-Bissau,Africa
2369,Albert Sambi Lokonga,BEL,Arsenal,Premier League,2021,21.0,1999.0,12.6,22,18,11,9,2,12,14,85.7,2,12,7,5,13,35,12,4,MF,20-24,Midfielder,Belgium,Europe
2370,Junior Sambia,FRA,Montpellier,Ligue 1,2021,24.0,1996.0,17.0,22,13,12,7,3,13,22,59.1,9,22,3,19,21,43,31,0,"DF,FW",20-24,Defender,France,Europe
2371,Luigi Samele,ITA,Sassuolo,Serie A,2021,19.0,2002.0,0.1,0,0,0,0,0,0,0,,0,0,0,0,0,0,1,0,FW,Under 20,Forward,Italy,Europe
2373,Antonio Sanabria,PAR,Torino,Serie A,2021,25.0,1996.0,20.0,3,2,0,1,2,1,4,25.0,3,11,4,7,2,5,10,0,FW,25-29,Forward,Paraguay,South America
2375,Renato Sanches,POR,Lille,Ligue 1,2021,23.0,1997.0,18.3,19,7,8,10,1,9,26,34.6,17,14,3,11,14,33,7,0,"MF,FW",20-24,Midfielder,Portugal,Europe
2376,Alexis Sánchez,CHI,Inter,Serie A,2021,32.0,1988.0,9.8,9,8,0,6,3,2,11,18.2,9,4,0,4,2,11,3,0,FW,30-34,Forward,Chile,South America
2378,Davinson Sánchez,COL,Tottenham,Premier League,2021,25.0,1996.0,18.1,41,22,25,14,2,19,28,67.9,9,24,16,8,30,71,54,3,DF,25-29,Defender,Colombia,South America
2382,Jadon Sancho,ENG,Manchester Utd,Premier League,2021,21.0,2000.0,21.1,14,8,9,4,1,8,22,36.4,14,19,0,19,15,29,5,3,"FW,MF",20-24,Forward,England,Europe
2383,Philippe Sandler,NED,Troyes,Ligue 1,2021,24.0,1997.0,0.8,0,0,0,0,0,0,0,,0,1,1,0,3,3,6,0,DF,20-24,Defender,Netherlands,Europe
2384,Alex Sandro,BRA,Juventus,Serie A,2021,30.0,1991.0,19.8,27,16,15,9,3,11,25,44.0,14,17,6,11,27,54,40,0,DF,30-34,Defender,Brazil,South America
2385,Leroy Sané,GER,Bayern Munich,Bundesliga,2021,25.0,1996.0,22.0,28,16,5,19,4,9,24,37.5,15,18,0,18,12,40,2,1,"FW,MF",25-29,Forward,Germany,Europe
2387,Mohamed Sankoh,NED,Stuttgart,Bundesliga,2021,17.0,2003.0,0.0,0,0,0,0,0,0,0,,0,0,0,0,0,0,0,0,FW,Under 20,Forward,Netherlands,Europe
2388,Morgan Sanson,FRA,Aston Villa,Premier League,2021,26.0,1994.0,4.0,12,8,7,2,3,3,7,42.9,4,13,0,13,10,22,2,1,MF,25-29,Midfielder,France,Europe
2389,Nicola Sansone,ITA,Bologna,Serie A,2021,29.0,1991.0,10.0,13,7,5,6,2,3,15,20.0,12,1,0,1,4,17,2,0,"FW,MF",25-29,Forward,Italy,Europe
2390,Baptiste Santamaria,FRA,Rennes,Ligue 1,2021,26.0,1995.0,28.0,52,27,15,31,6,24,44,54.5,20,33,12,21,33,85,42,0,"MF,DF",25-29,Midfielder,France,Europe
2391,Baptiste Santamaria,FRA,Freiburg,Bundesliga,2021,26.0,1995.0,0.2,0,0,0,0,0,0,1,0.0,1,0,0,0,1,1,1,0,MF,25-29,Midfielder,France,Europe
2392,Federico Santander,PAR,Bologna,Serie A,2021,30.0,1991.0,0.7,2,1,1,1,0,1,1,100.0,0,0,0,0,0,2,0,0,"FW,DF",30-34,Forward,Paraguay,South America
2394,Samir Santos,BRA,Watford,Premier League,2021,26.0,1994.0,18.6,24,11,18,6,0,8,19,42.1,11,21,11,10,43,67,85,3,DF,25-29,Defender,Brazil,South America
2395,Samir Santos,BRA,Udinese,Serie A,2021,26.0,1994.0,15.8,36,16,22,13,1,15,25,60.0,10,21,7,14,42,78,62,0,DF,25-29,Defender,Brazil,South America
2398,Riccardo Saponara,ITA,Fiorentina,Serie A,2021,29.0,1991.0,14.3,10,2,1,6,3,6,16,37.5,10,5,0,5,1,11,3,0,FW,25-29,Forward,Italy,Europe
2400,Marcelo Saracchi,URU,Levante,La Liga,2021,23.0,1998.0,2.1,8,5,6,1,1,2,4,50.0,2,3,0,3,4,12,7,1,DF,20-24,Defender,Uruguay,South America
2401,Josh Sargent,USA,Norwich City,Premier League,2021,21.0,2000.0,17.5,26,14,15,7,4,14,39,35.9,25,29,2,27,11,37,18,2,"FW,MF",20-24,Forward,United States,North America
2402,Jeremy Sarmiento,ECU,Brighton,Premier League,2021,19.0,2002.0,0.5,1,1,0,0,1,0,2,0.0,2,2,0,2,0,1,0,0,"FW,MF",Under 20,Forward,Ecuador,South America
2403,Bouna Sarr,SEN,Bayern Munich,Bundesliga,2021,29.0,1992.0,0.7,4,4,2,1,1,4,5,80.0,1,2,1,1,6,10,1,0,DF,25-29,Defender,Senegal,Africa
2404,Ismaila Sarr,SEN,Watford,Premier League,2021,23.0,1998.0,20.7,12,7,4,3,5,5,19,26.3,14,10,1,9,9,21,10,0,"FW,MF",20-24,Forward,Senegal,Africa
2405,Malang Sarr,FRA,Chelsea,Premier League,2021,22.0,1999.0,6.1,14,7,10,2,2,7,12,58.3,5,6,3,3,11,25,20,0,DF,20-24,Defender,France,Europe
2407,Giacomo Satalino,ITA,Sassuolo,Serie A,2021,22.0,1999.0,0.1,0,0,0,0,0,0,0,,0,0,0,0,0,0,0,0,GK,20-24,Goalkeeper,Italy,Europe
2408,Martin Satriano,URU,Inter,Serie A,2021,20.0,2001.0,0.4,1,0,0,0,1,1,1,100.0,0,0,0,0,0,1,0,0,"FW,MF",20-24,Forward,Uruguay,South America
2409,Martin Satriano,URU,Brest,Ligue 1,2021,20.0,2001.0,10.4,5,2,1,1,3,2,7,28.6,5,8,0,8,2,7,3,0,FW,20-24,Forward,Uruguay,South America
2410,Téji Savanier,FRA,Montpellier,Ligue 1,2021,29.0,1991.0,26.8,46,27,18,19,9,21,59,35.6,38,23,1,22,25,71,12,1,MF,25-29,Midfielder,France,Europe
2411,Esteban Saveljich,MNE,Rayo Vallecano,La Liga,2021,30.0,1991.0,18.9,18,11,11,7,0,9,15,60.0,6,20,12,8,16,34,69,0,DF,30-34,Defender,Montenegro,Europe
2412,Stefan Savić,MNE,Atlético Madrid,La Liga,2021,30.0,1991.0,27.1,46,20,25,20,1,29,43,67.4,14,19,12,7,37,83,102,1,DF,30-34,Defender,Montenegro,Europe
2413,Joe Scally,USA,Gladbach,Bundesliga,2021,18.0,2002.0,21.2,40,30,21,14,5,17,41,41.5,24,27,4,23,22,62,38,0,DF,Under 20,Defender,United States,North America
2414,Giorgio Scalvini,ITA,Atalanta,Serie A,2021,17.0,2003.0,8.5,22,11,13,8,1,9,19,47.4,10,12,1,11,22,44,16,0,"DF,MF",Under 20,Defender,Italy,Europe
2415,Gianluca Scamacca,ITA,Sassuolo,Serie A,2021,22.0,1999.0,23.8,19,14,2,5,12,5,21,23.8,16,16,1,15,5,24,22,1,FW,20-24,Forward,Italy,Europe
2416,Dane Scarlett,ENG,Tottenham,Premier League,2021,17.0,2004.0,0.0,0,0,0,0,0,0,0,,0,0,0,0,0,0,0,0,MF,Under 20,Midfielder,England,Europe
2417,Kevin Schade,GER,Freiburg,Bundesliga,2021,19.0,2001.0,9.2,9,7,6,2,1,3,10,30.0,7,15,3,12,3,12,16,0,"MF,FW",Under 20,Midfielder,Germany,Europe
2418,András Schäfer,HUN,Union Berlin,Bundesliga,2021,22.0,1999.0,2.7,4,1,3,1,0,0,5,0.0,5,7,1,6,2,6,4,0,MF,20-24,Midfielder,Hungary,Europe
2419,Fabian Schär,SUI,Newcastle Utd,Premier League,2021,29.0,1991.0,24.0,16,11,11,3,2,8,16,50.0,8,27,18,9,32,48,95,2,DF,25-29,Defender,Switzerland,Europe
2420,Louis Schaub,AUT,Köln,Bundesliga,2021,26.0,1994.0,7.3,16,10,7,7,2,11,20,55.0,9,17,3,14,3,19,3,0,"MF,FW",25-29,Midfielder,Austria,Europe
2421,Andrea Schiavone,ITA,Salernitana,Serie A,2021,28.0,1993.0,6.3,14,8,5,9,0,10,23,43.5,13,13,3,10,8,22,12,0,MF,25-29,Midfielder,Italy,Europe
2423,Kingsley Schindler,GHA,Köln,Bundesliga,2021,28.0,1993.0,3.9,1,0,0,0,1,1,5,20.0,4,5,1,4,5,6,5,0,"DF,FW",25-29,Defender,Ghana,Africa
2424,Xaver Schlager,AUT,Wolfsburg,Bundesliga,2021,23.0,1997.0,11.6,43,20,20,20,3,20,49,40.8,29,25,2,23,9,52,14,0,MF,20-24,Midfielder,Austria,Europe
2425,Keven Schlotterbeck,GER,Freiburg,Bundesliga,2021,24.0,1997.0,3.5,11,5,6,5,0,5,6,83.3,1,7,4,3,11,22,24,1,"DF,FW",20-24,Defender,Germany,Europe
2426,Nico Schlotterbeck,GER,Freiburg,Bundesliga,2021,21.0,1999.0,30.9,72,43,36,34,2,33,48,68.8,15,41,32,9,56,128,154,1,DF,20-24,Defender,Germany,Europe
2427,Jeffrey Schlupp,GHA,Crystal Palace,Premier League,2021,28.0,1992.0,20.6,46,25,16,23,7,24,50,48.0,26,39,9,30,18,64,32,0,"MF,FW",25-29,Midfielder,Ghana,Africa
2428,Kasper Schmeichel,DEN,Leicester City,Premier League,2021,34.0,1986.0,37.0,0,0,0,0,0,0,2,0.0,2,0,0,0,1,1,15,2,GK,30-34,Goalkeeper,Denmark,Europe
2429,Jonathan Schmid,FRA,Freiburg,Bundesliga,2021,31.0,1990.0,6.5,12,6,6,3,3,5,7,71.4,2,7,1,6,6,18,15,0,DF,30-34,Defender,France,Europe
2430,Benno Schmitz,GER,Köln,Bundesliga,2021,26.0,1994.0,26.9,57,37,21,27,9,42,86,48.8,44,44,8,36,39,96,39,0,DF,25-29,Defender,Germany,Europe
2431,David Schnegg,AUT,Venezia,Serie A,2021,22.0,1998.0,1.6,2,0,1,1,0,1,3,33.3,2,4,0,4,3,5,6,0,DF,20-24,Defender,Austria,Europe
2432,Morgan Schneiderlin,FRA,Nice,Ligue 1,2021,31.0,1989.0,7.2,21,12,9,11,1,6,13,46.2,7,8,2,6,20,41,18,0,MF,30-34,Midfielder,France,Europe
2433,Alessandro Schöpf,AUT,Arminia,Bundesliga,2021,27.0,1994.0,26.6,40,22,19,16,5,14,30,46.7,16,31,5,26,30,70,21,1,MF,25-29,Midfielder,Austria,Europe
2434,Jerdy Schouten,NED,Bologna,Serie A,2021,24.0,1997.0,15.5,25,17,10,12,3,9,22,40.9,13,22,5,17,33,58,29,1,MF,20-24,Midfielder,Netherlands,Europe
2435,Nico Schulz,GER,Dortmund,Bundesliga,2021,28.0,1993.0,9.3,21,12,9,7,5,9,21,42.9,12,8,1,7,11,32,8,0,DF,25-29,Defender,Germany,Europe
2436,Marvin Schwäbe,GER,Köln,Bundesliga,2021,26.0,1995.0,21.0,0,0,0,0,0,0,0,,0,0,0,0,0,0,8,1,GK,25-29,Goalkeeper,Germany,Europe
2437,Alexander Schwolow,GER,Hertha BSC,Bundesliga,2021,29.0,1992.0,24.2,0,0,0,0,0,0,1,0.0,1,0,0,0,2,2,18,3,GK,25-29,Goalkeeper,Germany,Europe
2439,Demba Seck,SEN,Torino,Serie A,2021,20.0,2001.0,1.6,2,1,0,2,0,0,0,,0,0,0,0,0,2,0,0,"MF,FW",20-24,Midfielder,Senegal,Africa
2441,Paul Seguin,GER,Greuther Fürth,Bundesliga,2021,26.0,1995.0,23.4,50,31,15,32,3,26,56,46.4,30,27,3,24,19,69,30,1,MF,25-29,Midfielder,Germany,Europe
2442,Alidu Seidu,GHA,Clermont Foot,Ligue 1,2021,21.0,2000.0,15.7,34,20,20,13,1,16,27,59.3,11,25,11,14,34,68,49,1,DF,20-24,Defender,Ghana,Africa
2443,Davie Selke,GER,Hertha BSC,Bundesliga,2021,26.0,1995.0,11.2,5,4,1,3,1,1,3,33.3,2,6,1,5,1,6,11,0,FW,25-29,Forward,Germany,Europe
2444,Matz Sels,BEL,Strasbourg,Ligue 1,2021,29.0,1992.0,37.0,1,1,1,0,0,0,0,,0,0,0,0,1,2,22,0,GK,25-29,Goalkeeper,Belgium,Europe
2445,Ken Sema,SWE,Watford,Premier League,2021,27.0,1993.0,9.5,16,6,11,4,1,9,20,45.0,11,10,0,10,5,21,11,0,"MF,FW",25-29,Midfielder,Sweden,Europe
2446,Nélson Semedo,POR,Wolves,Premier League,2021,27.0,1993.0,23.7,58,39,39,17,2,25,49,51.0,24,23,4,19,21,79,64,1,"MF,DF",25-29,Midfielder,Portugal,Europe
2447,Lion Semić,GER,Dortmund,Bundesliga,2021,17.0,2003.0,0.0,0,0,0,0,0,0,0,,0,0,0,0,0,0,0,0,DF,Under 20,Defender,Germany,Europe
2448,Adrian Šemper,CRO,Genoa,Serie A,2021,23.0,1998.0,1.0,0,0,0,0,0,0,0,,0,0,0,0,0,0,0,0,GK,20-24,Goalkeeper,Croatia,Europe
2449,Stefano Sensi,ITA,Sampdoria,Serie A,2021,25.0,1995.0,8.4,18,9,10,6,2,10,23,43.5,13,2,0,2,6,24,4,0,"MF,FW",25-29,Midfielder,Italy,Europe
2450,Stefano Sensi,ITA,Inter,Serie A,2021,25.0,1995.0,1.9,4,3,1,3,0,2,4,50.0,2,2,0,2,0,4,2,0,"MF,FW",25-29,Midfielder,Italy,Europe
2451,Luigi Sepe,ITA,Salernitana,Serie A,2021,30.0,1991.0,15.5,0,0,0,0,0,0,0,,0,0,0,0,1,1,3,0,GK,30-34,Goalkeeper,Italy,Europe
2452,Suat Serdar,GER,Hertha BSC,Bundesliga,2021,24.0,1997.0,24.6,64,30,24,29,11,25,55,45.5,30,32,3,29,20,84,14,0,"MF,FW",20-24,Midfielder,Germany,Europe
2453,Laurens Serpe,ITA,Genoa,Serie A,2021,20.0,2001.0,0.5,1,0,1,0,0,1,2,50.0,1,0,0,0,0,1,1,0,DF,20-24,Defender,Italy,Europe
2454,Janni Serra,GER,Arminia,Bundesliga,2021,23.0,1998.0,12.4,4,2,2,0,2,2,7,28.6,5,8,3,5,5,9,19,0,FW,20-24,Forward,Germany,Europe
2457,Zidan Sertdemir,DEN,Leverkusen,Bundesliga,2021,16.0,2005.0,0.2,2,2,2,0,0,0,0,,0,0,0,0,0,2,0,0,"MF,FW",Under 20,Midfielder,Denmark,Europe
2458,Ryan Sessegnon,ENG,Tottenham,Premier League,2021,21.0,2000.0,11.6,25,19,14,7,4,11,22,50.0,11,18,3,15,7,32,26,0,"DF,MF",20-24,Defender,England,Europe
2459,Nils Seufert,GER,Greuther Fürth,Bundesliga,2021,24.0,1997.0,1.1,3,2,1,1,1,0,1,0.0,1,0,0,0,0,3,0,0,MF,20-24,Midfielder,Germany,Europe
2461,Stephan El Shaarawy,ITA,Roma,Serie A,2021,28.0,1992.0,11.7,13,8,4,9,0,4,6,66.7,2,10,2,8,11,24,8,0,"FW,DF",25-29,Forward,Italy,Europe
2462,Jamie Shackleton,ENG,Leeds United,Premier League,2021,21.0,1999.0,7.9,27,16,19,7,1,13,25,52.0,12,11,7,4,8,35,12,1,"DF,MF",20-24,Defender,England,Europe
2463,Xherdan Shaqiri,SUI,Lyon,Ligue 1,2021,29.0,1991.0,7.5,7,3,0,5,2,2,10,20.0,8,2,0,2,2,9,2,0,"FW,MF",25-29,Forward,Switzerland,Europe
2464,Luke Shaw,ENG,Manchester Utd,Premier League,2021,26.0,1995.0,17.8,21,13,9,9,3,12,21,57.1,9,22,11,11,9,30,22,2,DF,25-29,Defender,England,Europe
2465,Jonjo Shelvey,ENG,Newcastle Utd,Premier League,2021,29.0,1992.0,22.0,30,17,12,18,0,14,34,41.2,20,22,7,15,22,52,20,2,MF,25-29,Midfielder,England,Europe
2466,Aimar Sher,SWE,Spezia,Serie A,2021,18.0,2002.0,0.5,2,1,1,1,0,0,1,0.0,1,1,0,1,3,5,1,0,MF,Under 20,Midfielder,Sweden,Europe
2467,Eldor Shomurodov,UZB,Roma,Serie A,2021,26.0,1995.0,8.7,5,4,0,4,1,1,10,10.0,9,8,0,8,2,7,5,0,"FW,MF",25-29,Forward,Uzbekistan,Asia
2468,Shola Shoretire,ENG,Manchester Utd,Premier League,2021,17.0,2004.0,0.2,0,0,0,0,0,0,0,,0,0,0,0,0,0,0,0,MF,Under 20,Midfielder,England,Europe
2469,Mahame Siby,MLI,Strasbourg,Ligue 1,2021,25.0,1996.0,0.2,0,0,0,0,0,0,0,,0,0,0,0,1,1,2,0,DF,25-29,Defender,Mali,Africa
2470,Aboubakar Sidibé,FRA,Clermont Foot,Ligue 1,2021,25.0,1996.0,0.1,0,0,0,0,0,0,0,,0,0,0,0,0,0,0,0,DF,25-29,Defender,France,Europe
2471,Alassane Sidibe,CIV,Atalanta,Serie A,2021,19.0,2002.0,0.1,1,1,1,0,0,0,0,,0,0,0,0,0,1,0,0,MF,Under 20,Midfielder,Ivory Coast,Africa
2472,Djibril Sidibé,FRA,Monaco,Ligue 1,2021,29.0,1992.0,10.5,24,13,13,8,3,9,24,37.5,15,10,1,9,16,40,13,0,DF,25-29,Defender,France,Europe
2473,Kaj Sierhuis,NED,Reims,Ligue 1,2021,23.0,1998.0,0.9,1,1,1,0,0,1,3,33.3,2,0,0,0,0,1,1,0,FW,20-24,Forward,Netherlands,Europe
2474,Francisco Sierralta,CHI,Watford,Premier League,2021,24.0,1997.0,4.7,7,3,7,0,0,5,8,62.5,3,7,2,5,6,13,35,0,DF,20-24,Defender,Chile,South America
2475,Arnór Sigurðsson,ISL,Venezia,Serie A,2021,22.0,1999.0,2.0,1,1,0,1,0,1,2,50.0,1,2,0,2,1,2,0,0,"FW,MF",20-24,Forward,Iceland,Europe
2476,Kiliann Sildillia,FRA,Freiburg,Bundesliga,2021,19.0,2002.0,1.9,7,3,3,4,0,3,6,50.0,3,1,0,1,2,9,7,1,"DF,MF",Under 20,Defender,France,Europe
2477,Adrien Silva,POR,Sampdoria,Serie A,2021,32.0,1989.0,12.0,24,12,14,5,5,9,33,27.3,24,15,5,10,23,47,23,0,MF,30-34,Midfielder,Portugal,Europe
2478,André Silva,POR,RB Leipzig,Bundesliga,2021,25.0,1995.0,23.1,13,9,2,3,8,4,13,30.8,9,20,2,18,2,15,15,0,FW,25-29,Forward,Portugal,Europe
2478,André Silva,POR,RB Leipzig,Bundesliga,2021,25.0,1995.0,23.1,13,9,2,3,8,4,13,30.8,9,20,2,18,2,15,15,0,FW,25-29,Forward,Portugal,Europe
2478,André Silva,POR,RB Leipzig,Bundesliga,2021,25.0,1995.0,23.1,13,9,2,3,8,4,13,30.8,9,20,2,18,2,15,15,0,FW,25-29,Forward,Portugal,Europe
2478,André Silva,POR,RB Leipzig,Bundesliga,2021,25.0,1995.0,23.1,13,9,2,3,8,4,13,30.8,9,20,2,18,2,15,15,0,FW,25-29,Forward,Portugal,Europe
2478,André Silva,POR,RB Leipzig,Bundesliga,2021,25.0,1995.0,23.1,13,9,2,3,8,4,13,30.8,9,20,2,18,2,15,15,0,FW,25-29,Forward,Portugal,Europe
2478,André Silva,POR,RB Leipzig,Bundesliga,2021,25.0,1995.0,23.1,13,9,2,3,8,4,13,30.8,9,20,2,18,2,15,15,0,FW,25-29,Forward,Portugal,Europe
2478,André Silva,POR,RB Leipzig,Bundesliga,2021,25.0,1995.0,23.1,13,9,2,3,8,4,13,30.8,9,20,2,18,2,15,15,0,FW,25-29,Forward,Portugal,Europe
2478,André Silva,POR,RB Leipzig,Bundesliga,2021,25.0,1995.0,23.1,13,9,2,3,8,4,13,30.8,9,20,2,18,2,15,15,0,FW,25-29,Forward,Portugal,Europe
2478,André Silva,POR,RB Leipzig,Bundesliga,2021,25.0,1995.0,23.1,13,9,2,3,8,4,13,30.8,9,20,2,18,2,15,15,0,FW,25-29,Forward,Portugal,Europe
2479,Bernardo Silva,POR,Manchester City,Premier League,2021,26.0,1994.0,31.7,57,29,19,19,19,31,67,46.3,36,24,2,22,20,77,19,0,"MF,FW",25-29,Midfielder,Portugal,Europe
2480,Caio Henrique Oliveira Silva,BRA,Monaco,Ligue 1,2021,24.0,1997.0,29.6,53,30,31,18,4,28,59,47.5,31,30,6,24,27,80,37,3,DF,20-24,Defender,Brazil,South America
2482,Fábio Silva,POR,Wolves,Premier League,2021,19.0,2002.0,6.4,3,2,0,2,1,0,8,0.0,8,2,0,2,1,4,1,0,FW,Under 20,Forward,Portugal,Europe
2483,Gabriel Silva,BRA,Saint-Étienne,Ligue 1,2021,30.0,1991.0,7.9,12,7,7,2,3,9,13,69.2,4,9,3,6,18,30,13,0,"DF,MF",30-34,Defender,Brazil,South America
2483,Gabriel Silva,BRA,Saint-Étienne,Ligue 1,2021,30.0,1991.0,7.9,12,7,7,2,3,9,13,69.2,4,9,3,6,18,30,13,0,"DF,MF",30-34,Defender,Brazil,South America
2483,Gabriel Silva,BRA,Saint-Étienne,Ligue 1,2021,30.0,1991.0,7.9,12,7,7,2,3,9,13,69.2,4,9,3,6,18,30,13,0,"DF,MF",30-34,Defender,Brazil,South America
2483,Gabriel Silva,BRA,Saint-Étienne,Ligue 1,2021,30.0,1991.0,7.9,12,7,7,2,3,9,13,69.2,4,9,3,6,18,30,13,0,"DF,MF",30-34,Defender,Brazil,South America
2484,Jonathan Silva,ARG,Getafe,La Liga,2021,27.0,1994.0,2.5,10,8,4,4,2,7,12,58.3,5,4,0,4,3,13,7,0,"DF,FW",25-29,Defender,Argentina,South America
2484,Jonathan Silva,ARG,Getafe,La Liga,2021,27.0,1994.0,2.5,10,8,4,4,2,7,12,58.3,5,4,0,4,3,13,7,0,"DF,FW",25-29,Defender,Argentina,South America
2484,Jonathan Silva,ARG,Getafe,La Liga,2021,27.0,1994.0,2.5,10,8,4,4,2,7,12,58.3,5,4,0,4,3,13,7,0,"DF,FW",25-29,Defender,Argentina,South America
2484,Jonathan Silva,ARG,Getafe,La Liga,2021,27.0,1994.0,2.5,10,8,4,4,2,7,12,58.3,5,4,0,4,3,13,7,0,"DF,FW",25-29,Defender,Argentina,South America
2485,Rui Silva,POR,Betis,La Liga,2021,27.0,1994.0,21.8,1,0,1,0,0,1,2,50.0,1,0,0,0,1,2,11,1,GK,25-29,Goalkeeper,Portugal,Europe
2485,Rui Silva,POR,Betis,La Liga,2021,27.0,1994.0,21.8,1,0,1,0,0,1,2,50.0,1,0,0,0,1,2,11,1,GK,25-29,Goalkeeper,Portugal,Europe
2485,Rui Silva,POR,Betis,La Liga,2021,27.0,1994.0,21.8,1,0,1,0,0,1,2,50.0,1,0,0,0,1,2,11,1,GK,25-29,Goalkeeper,Portugal,Europe
2485,Rui Silva,POR,Betis,La Liga,2021,27.0,1994.0,21.8,1,0,1,0,0,1,2,50.0,1,0,0,0,1,2,11,1,GK,25-29,Goalkeeper,Portugal,Europe
2486,Thiago Silva,BRA,Chelsea,Premier League,2021,36.0,1984.0,29.4,32,21,19,12,1,11,22,50.0,11,54,31,23,44,76,100,0,DF,35-39,Defender,Brazil,South America
2486,Thiago Silva,BRA,Chelsea,Premier League,2021,36.0,1984.0,29.4,32,21,19,12,1,11,22,50.0,11,54,31,23,44,76,100,0,DF,35-39,Defender,Brazil,South America
2486,Thiago Silva,BRA,Chelsea,Premier League,2021,36.0,1984.0,29.4,32,21,19,12,1,11,22,50.0,11,54,31,23,44,76,100,0,DF,35-39,Defender,Brazil,South America
2486,Thiago Silva,BRA,Chelsea,Premier League,2021,36.0,1984.0,29.4,32,21,19,12,1,11,22,50.0,11,54,31,23,44,76,100,0,DF,35-39,Defender,Brazil,South America
2487,Marco Silvestri,ITA,Udinese,Serie A,2021,30.0,1991.0,35.0,0,0,0,0,0,0,1,0.0,1,0,0,0,1,1,11,1,GK,30-34,Goalkeeper,Italy,Europe
2488,Mohamed Simakan,FRA,RB Leipzig,Bundesliga,2021,21.0,2000.0,22.3,48,27,25,21,2,27,41,65.9,14,22,11,11,40,88,46,1,DF,20-24,Defender,France,Europe
2489,Giovanni Simeone,ARG,Hellas Verona,Serie A,2021,26.0,1995.0,29.5,27,15,6,12,9,9,39,23.1,30,37,3,34,6,33,23,0,FW,25-29,Forward,Argentina,South America
2490,Giovanni Simeone,ARG,Cagliari,Serie A,2021,26.0,1995.0,0.1,0,0,0,0,0,0,0,,0,0,0,0,0,0,0,0,FW,25-29,Forward,Argentina,South America
2491,Giuliano Simeone,ARG,Atlético Madrid,La Liga,2021,18.0,2002.0,0.0,0,0,0,0,0,0,0,,0,0,0,0,0,0,0,0,MF,Under 20,Midfielder,Argentina,South America
2492,Ellis Simms,ENG,Everton,Premier League,2021,20.0,2001.0,0.7,0,0,0,0,0,0,0,,0,1,1,0,0,0,1,0,FW,20-24,Forward,England,Europe
2493,Moses Simon,NGA,Nantes,Ligue 1,2021,26.0,1995.0,25.9,17,11,6,5,6,11,23,47.8,12,14,3,11,12,29,5,0,"FW,MF",25-29,Forward,Nigeria,Africa
2495,Xavi Simons,NED,Paris S-G,Ligue 1,2021,18.0,2003.0,1.5,1,1,0,1,0,1,2,50.0,1,3,0,3,0,1,0,0,"MF,FW",Under 20,Midfielder,Netherlands,Europe
2496,Wilfried Singo,CIV,Torino,Serie A,2021,20.0,2000.0,29.0,55,35,24,24,7,24,34,70.6,10,26,6,20,23,78,47,0,DF,20-24,Defender,Ivory Coast,Africa
2497,Daley Sinkgraven,NED,Leverkusen,Bundesliga,2021,26.0,1995.0,3.9,6,2,4,0,2,3,7,42.9,4,3,1,2,3,9,6,0,DF,25-29,Defender,Netherlands,Europe
2498,Tobias Sippel,GER,Gladbach,Bundesliga,2021,33.0,1988.0,1.0,0,0,0,0,0,0,0,,0,0,0,0,0,0,0,0,GK,30-34,Goalkeeper,Germany,Europe
2499,Hugo Siquet,BEL,Freiburg,Bundesliga,2021,19.0,2002.0,0.2,0,0,0,0,0,0,0,,0,0,0,0,0,0,0,0,DF,Under 20,Defender,Belgium,Europe
2500,Salvatore Sirigu,ITA,Genoa,Serie A,2021,34.0,1987.0,37.0,1,1,1,0,0,1,2,50.0,1,0,0,0,0,1,19,2,GK,30-34,Goalkeeper,Italy,Europe
2501,Issouf Sissokho,MLI,Bordeaux,Ligue 1,2021,19.0,2002.0,4.8,17,8,2,13,2,8,17,47.1,9,8,1,7,7,24,0,0,MF,Under 20,Midfielder,Mali,Africa
2502,Ibrahima Sissoko,MLI,Strasbourg,Ligue 1,2021,23.0,1997.0,25.6,47,23,18,20,9,19,46,41.3,27,32,11,21,35,82,31,0,"MF,DF",20-24,Midfielder,Mali,Africa
2503,Moussa Sissoko,FRA,Watford,Premier League,2021,31.0,1989.0,35.8,53,27,27,20,6,28,42,66.7,14,42,13,29,30,83,64,0,MF,30-34,Midfielder,France,Europe
2504,Nelson Sissoko,FRA,Saint-Étienne,Ligue 1,2021,24.0,1997.0,0.5,2,0,2,0,0,1,1,100.0,0,0,0,0,0,2,2,0,DF,20-24,Defender,France,Europe
2505,Sambou Sissoko,FRA,Reims,Ligue 1,2021,22.0,1999.0,2.0,12,6,6,4,2,6,8,75.0,2,2,0,2,2,14,7,0,"MF,DF",20-24,Midfielder,France,Europe
2505,Sambou Sissoko,FRA,Reims,Ligue 1,2021,22.0,1999.0,2.0,12,6,6,4,2,6,8,75.0,2,2,0,2,2,14,7,0,"MF,DF",20-24,Midfielder,France,Europe
2505,Sambou Sissoko,FRA,Reims,Ligue 1,2021,22.0,1999.0,2.0,12,6,6,4,2,6,8,75.0,2,2,0,2,2,14,7,0,"MF,DF",20-24,Midfielder,France,Europe
2505,Sambou Sissoko,FRA,Reims,Ligue 1,2021,22.0,1999.0,2.0,12,6,6,4,2,6,8,75.0,2,2,0,2,2,14,7,0,"MF,DF",20-24,Midfielder,France,Europe
2507,Ellyes Skhiri,TUN,Köln,Bundesliga,2021,26.0,1995.0,20.2,55,33,25,26,4,22,41,53.7,19,41,7,34,37,92,35,1,MF,25-29,Midfielder,Tunisia,Africa
2508,Oliver Skipp,ENG,Tottenham,Premier League,2021,20.0,2000.0,15.0,33,19,14,18,1,15,31,48.4,16,19,7,12,12,45,10,1,MF,20-24,Midfielder,England,Europe
2511,Andreas Skov Olsen,DEN,Bologna,Serie A,2021,21.0,1999.0,8.3,12,10,4,4,4,5,11,45.5,6,9,1,8,3,15,11,0,"FW,DF",20-24,Forward,Denmark,Europe
2512,Robert Skov,DEN,Hoffenheim,Bundesliga,2021,25.0,1996.0,4.1,3,2,1,1,1,2,9,22.2,7,2,0,2,3,6,3,0,"FW,DF",25-29,Forward,Denmark,Europe
2513,Milan Škriniar,SVK,Inter,Serie A,2021,26.0,1995.0,35.0,47,27,26,17,4,24,42,57.1,18,36,25,11,25,72,90,1,DF,25-29,Defender,Slovakia,Europe
2514,Islam Slimani,ALG,Lyon,Ligue 1,2021,33.0,1988.0,6.4,3,2,0,1,2,1,6,16.7,5,4,0,4,2,5,5,0,FW,30-34,Forward,Algeria,Africa
2515,William Smallbone,IRL,Southampton,Premier League,2021,21.0,2000.0,1.5,4,4,2,2,0,1,3,33.3,2,4,0,4,2,6,0,0,"MF,FW",20-24,Midfielder,Republic of Ireland,Europe
2516,Chris Smalling,ENG,Roma,Serie A,2021,31.0,1989.0,23.2,36,23,28,8,0,18,25,72.0,7,32,24,8,26,62,92,1,DF,30-34,Defender,England,Europe
2517,Emile Smith Rowe,ENG,Arsenal,Premier League,2021,21.0,2000.0,21.3,14,7,7,7,0,4,20,20.0,16,18,1,17,15,29,10,1,"MF,FW",20-24,Midfielder,England,Europe
2518,Cédric Soares,POR,Arsenal,Premier League,2021,29.0,1991.0,16.5,38,26,23,9,6,16,25,64.0,9,18,7,11,16,54,31,1,DF,25-29,Defender,Portugal,Europe
2519,Danilo Soares,BRA,Bochum,Bundesliga,2021,29.0,1991.0,28.5,109,71,61,39,9,56,84,66.7,28,63,9,54,62,171,65,2,DF,25-29,Defender,Brazil,South America
2523,Augusto Solari,ARG,Celta Vigo,La Liga,2021,29.0,1992.0,7.9,24,12,9,12,3,12,32,37.5,20,14,4,10,7,31,10,1,"MF,DF",25-29,Midfielder,Argentina,South America
2526,Yann Sommer,SUI,Gladbach,Bundesliga,2021,32.0,1988.0,33.0,0,0,0,0,0,0,2,0.0,2,0,0,0,3,3,8,3,GK,30-34,Goalkeeper,Switzerland,Europe
2528,Brandon Soppy,FRA,Udinese,Serie A,2021,19.0,2002.0,8.6,20,9,8,10,2,11,16,68.8,5,10,2,8,5,25,9,1,"DF,MF",Under 20,Defender,France,Europe
2530,Roberto Soriano,ITA,Bologna,Serie A,2021,30.0,1991.0,29.1,57,30,27,22,8,17,56,30.4,39,37,3,34,22,79,32,0,MF,30-34,Midfielder,Italy,Europe
2532,Borna Sosa,CRO,Stuttgart,Bundesliga,2021,23.0,1998.0,27.8,22,12,14,5,3,12,26,46.2,14,30,3,27,26,48,61,0,"DF,FW",20-24,Defender,Croatia,Europe
2534,Florian Sotoca,FRA,Lens,Ligue 1,2021,30.0,1990.0,27.6,31,19,7,20,4,12,51,23.5,39,31,4,27,25,56,41,0,"FW,MF",30-34,Forward,France,Europe
2535,Riccardo Sottil,ITA,Fiorentina,Serie A,2021,22.0,1999.0,13.8,9,4,4,4,1,3,9,33.3,6,3,0,3,1,10,2,0,FW,20-24,Forward,Italy,Europe
2537,Matìas Soulé,ARG,Juventus,Serie A,2021,18.0,2003.0,0.1,0,0,0,0,0,0,1,0.0,1,0,0,0,0,0,0,0,FW,Under 20,Forward,Argentina,South America
2538,Sambou Soumano,SEN,Lorient,Ligue 1,2021,20.0,2001.0,5.0,4,1,1,2,1,2,2,100.0,0,3,0,3,1,5,7,0,"FW,MF",20-24,Forward,Senegal,Africa
2539,Adama Soumaoro,FRA,Bologna,Serie A,2021,29.0,1992.0,25.2,15,5,5,8,2,4,9,44.4,5,22,16,6,34,49,95,0,DF,25-29,Defender,France,Europe
2540,Boubakary Soumaré,FRA,Leicester City,Premier League,2021,22.0,1999.0,12.2,19,13,10,8,1,8,17,47.1,9,13,1,12,14,33,18,0,MF,20-24,Midfielder,France,Europe
2541,Arnaud Souquet,FRA,Montpellier,Ligue 1,2021,29.0,1992.0,25.9,56,35,30,17,9,32,65,49.2,33,21,7,14,34,90,60,1,DF,25-29,Defender,France,Europe
2542,Djibril Sow,SUI,Eint Frankfurt,Bundesliga,2021,24.0,1997.0,26.8,57,33,28,25,4,22,60,36.7,38,35,8,27,50,107,20,1,MF,20-24,Midfielder,Switzerland,Europe
2543,Saidou Sow,GUI,Saint-Étienne,Ligue 1,2021,19.0,2002.0,11.0,28,17,21,6,1,16,21,76.2,5,15,5,10,23,51,34,0,DF,Under 20,Defender,Guinea,Africa
2544,Çağlar Söyüncü,TUR,Leicester City,Premier League,2021,25.0,1996.0,27.7,47,30,32,12,3,26,42,61.9,16,44,27,17,32,79,115,1,DF,25-29,Defender,Turkey,Asia
2545,Leonardo Spinazzola,ITA,Roma,Serie A,2021,28.0,1993.0,1.4,0,0,0,0,0,0,1,0.0,1,4,1,3,0,0,3,0,DF,25-29,Defender,Italy,Europe
2546,Marco Sportiello,ITA,Atalanta,Serie A,2021,29.0,1992.0,5.0,0,0,0,0,0,0,0,,0,0,0,0,0,0,2,0,GK,25-29,Goalkeeper,Italy,Europe
2547,Tony Springett,IRL,Norwich City,Premier League,2021,18.0,2002.0,1.6,2,1,1,1,0,1,4,25.0,3,0,0,0,0,2,2,0,"MF,FW",Under 20,Midfielder,Republic of Ireland,Europe
2548,Jerry St. Juste,NED,Mainz 05,Bundesliga,2021,24.0,1996.0,6.7,13,9,7,6,0,7,8,87.5,1,7,3,4,14,27,14,0,DF,20-24,Defender,Netherlands,Europe
2549,Anton Stach,GER,Mainz 05,Bundesliga,2021,22.0,1998.0,20.7,28,19,14,13,1,15,38,39.5,23,24,5,19,51,79,25,0,MF,20-24,Midfielder,Germany,Europe
2550,Kostas Stafylidis,GRE,Bochum,Bundesliga,2021,27.0,1993.0,15.4,37,27,22,13,2,20,26,76.9,6,19,6,13,31,68,43,0,"DF,MF",25-29,Defender,Greece,Europe
2551,Luca Stanga,ITA,Milan,Serie A,2021,19.0,2002.0,0.0,1,0,0,1,0,0,0,,0,0,0,0,0,1,0,0,DF,Under 20,Defender,Italy,Europe
2552,Josip Stanišić,CRO,Bayern Munich,Bundesliga,2021,21.0,2000.0,7.2,21,10,7,12,2,12,18,66.7,6,7,0,7,11,32,10,2,DF,20-24,Defender,Croatia,Europe
2553,Niklas Stark,GER,Hertha BSC,Bundesliga,2021,26.0,1995.0,22.6,28,16,18,10,0,12,17,70.6,5,27,17,10,36,64,122,2,DF,25-29,Defender,Germany,Europe
2554,Jason Steele,ENG,Brighton,Premier League,2021,30.0,1990.0,1.0,0,0,0,0,0,0,0,,0,0,0,0,0,0,0,0,GK,30-34,Goalkeeper,England,Europe
2555,Jed Steer,ENG,Aston Villa,Premier League,2021,28.0,1992.0,1.0,0,0,0,0,0,0,0,,0,0,0,0,0,0,0,0,GK,25-29,Goalkeeper,England,Europe
2556,Renato Steffen,SUI,Wolfsburg,Bundesliga,2021,29.0,1991.0,10.7,20,16,10,10,0,9,16,56.3,7,7,0,7,13,33,14,0,"FW,MF",25-29,Forward,Switzerland,Europe
2557,Zack Steffen,USA,Manchester City,Premier League,2021,26.0,1995.0,1.0,0,0,0,0,0,0,0,,0,0,0,0,0,0,2,0,GK,25-29,Goalkeeper,United States,North America
2558,Calvin Stengs,NED,Nice,Ligue 1,2021,22.0,1998.0,11.9,16,7,6,9,1,7,20,35.0,13,10,0,10,8,24,6,0,MF,20-24,Midfielder,Netherlands,Europe
2559,Pascal Stenzel,GER,Stuttgart,Bundesliga,2021,25.0,1996.0,10.0,24,11,15,5,4,17,33,51.5,16,13,3,10,11,35,25,0,DF,25-29,Defender,Germany,Europe
2560,Dale Stephens,ENG,Burnley,Premier League,2021,32.0,1989.0,1.4,4,1,0,3,1,3,8,37.5,5,4,1,3,1,5,1,0,MF,30-34,Midfielder,England,Europe
2561,Jack Stephens,ENG,Southampton,Premier League,2021,27.0,1994.0,9.0,19,12,13,5,1,6,16,37.5,10,12,7,5,19,38,42,0,DF,25-29,Defender,England,Europe
2562,Raheem Sterling,ENG,Manchester City,Premier League,2021,26.0,1994.0,23.6,23,10,3,11,9,10,23,43.5,13,12,0,12,12,35,3,0,FW,25-29,Forward,England,Europe
2563,Finley Stevens,WAL,Brentford,Premier League,2021,18.0,2003.0,0.2,3,1,0,3,0,1,1,100.0,0,0,0,0,0,3,0,0,DF,Under 20,Defender,Wales,Europe
2564,Angelo Stiller,GER,Hoffenheim,Bundesliga,2021,20.0,2001.0,18.8,30,17,11,15,4,9,23,39.1,14,32,6,26,9,39,16,2,MF,20-24,Midfielder,Germany,Europe
2565,Lars Stindl,GER,Gladbach,Bundesliga,2021,32.0,1988.0,18.1,23,15,6,14,3,9,33,27.3,24,28,2,26,10,33,14,0,"MF,FW",30-34,Midfielder,Germany,Europe
2566,Riccardo Stivanello,ITA,Bologna,Serie A,2021,17.0,2004.0,0.5,1,1,1,0,0,1,1,100.0,0,2,2,0,0,1,6,0,DF,Under 20,Defender,Italy,Europe
2567,Kevin Stöger,AUT,Mainz 05,Bundesliga,2021,27.0,1993.0,4.7,10,5,5,5,0,4,10,40.0,6,6,0,6,5,15,1,1,MF,25-29,Midfielder,Austria,Europe
2569,John Stones,ENG,Manchester City,Premier League,2021,27.0,1994.0,12.4,5,3,3,2,0,2,3,66.7,1,3,3,0,11,16,27,1,DF,25-29,Defender,England,Europe
2570,Thomas Strakosha,ALB,Lazio,Serie A,2021,26.0,1995.0,23.0,0,0,0,0,0,0,0,,0,0,0,0,0,0,7,2,GK,25-29,Goalkeeper,Albania,Europe
2572,Dávid Strelec,SVK,Spezia,Serie A,2021,20.0,2001.0,5.6,4,4,1,2,1,2,9,22.2,7,8,1,7,2,6,1,0,"FW,MF",20-24,Forward,Slovakia,Europe
2573,Tobias Strobl,GER,Augsburg,Bundesliga,2021,31.0,1990.0,3.6,8,3,3,5,0,3,11,27.3,8,7,2,5,7,15,3,0,"MF,DF",30-34,Midfielder,Germany,Europe
2574,Kevin Strootman,NED,Cagliari,Serie A,2021,31.0,1990.0,7.1,8,4,2,4,2,5,12,41.7,7,11,2,9,10,18,15,0,MF,30-34,Midfielder,Netherlands,Europe
2575,Pascal Struijk,NED,Leeds United,Premier League,2021,21.0,1999.0,22.8,61,39,34,23,4,30,50,60.0,20,35,23,12,33,94,60,2,"DF,MF",20-24,Defender,Netherlands,Europe
2576,Jens Stryger Larsen,DEN,Udinese,Serie A,2021,30.0,1991.0,7.6,5,2,3,1,1,2,3,66.7,1,2,0,2,4,9,17,0,DF,30-34,Defender,Denmark,Europe
2578,Stefano Sturaro,ITA,Genoa,Serie A,2021,28.0,1993.0,19.6,43,26,16,16,11,22,48,45.8,26,25,1,24,15,58,29,2,MF,25-29,Midfielder,Italy,Europe
2579,Damián Suárez,URU,Getafe,La Liga,2021,33.0,1988.0,30.1,74,47,34,30,10,42,91,46.2,49,46,5,41,31,105,30,0,DF,30-34,Defender,Uruguay,South America
2581,Luis Suárez,URU,Atlético Madrid,La Liga,2021,34.0,1987.0,20.4,8,5,2,4,2,2,10,20.0,8,8,1,7,1,9,14,0,FW,30-34,Forward,Uruguay,South America
2581,Luis Suárez,URU,Atlético Madrid,La Liga,2021,34.0,1987.0,20.4,8,5,2,4,2,2,10,20.0,8,8,1,7,1,9,14,0,FW,30-34,Forward,Uruguay,South America
2581,Luis Suárez,URU,Atlético Madrid,La Liga,2021,34.0,1987.0,20.4,8,5,2,4,2,2,10,20.0,8,8,1,7,1,9,14,0,FW,30-34,Forward,Uruguay,South America
2581,Luis Suárez,URU,Atlético Madrid,La Liga,2021,34.0,1987.0,20.4,8,5,2,4,2,2,10,20.0,8,8,1,7,1,9,14,0,FW,30-34,Forward,Uruguay,South America
2583,Isaac Success,NGA,Udinese,Serie A,2021,25.0,1996.0,10.1,5,2,0,3,2,1,5,20.0,4,2,0,2,2,7,6,0,"FW,MF",25-29,Forward,Nigeria,Africa
2584,Niklas Süle,GER,Bayern Munich,Bundesliga,2021,25.0,1995.0,20.4,29,23,21,7,1,18,24,75.0,6,16,12,4,28,57,49,0,DF,25-29,Defender,Germany,Europe
2585,Kamaldeen Sulemana,GHA,Rennes,Ligue 1,2021,19.0,2002.0,11.3,23,12,7,9,7,10,17,58.8,7,10,1,9,4,27,5,0,"MF,FW",Under 20,Midfielder,Ghana,Africa
2586,Crysencio Summerville,NED,Leeds United,Premier League,2021,19.0,2001.0,1.4,5,3,1,1,3,2,3,66.7,1,2,0,2,2,7,0,0,"MF,FW",Under 20,Midfielder,Netherlands,Europe
2587,Vladyslav Supriaha,UKR,Sampdoria,Serie A,2021,21.0,2000.0,0.2,0,0,0,0,0,0,1,0.0,1,0,0,0,0,0,0,0,FW,20-24,Forward,Ukraine,Europe
2589,Bosko Sutalo,CRO,Hellas Verona,Serie A,2021,21.0,2000.0,10.2,20,13,11,6,3,8,16,50.0,8,10,5,5,17,37,39,0,DF,20-24,Defender,Croatia,Europe
2590,Mattias Svanberg,SWE,Bologna,Serie A,2021,22.0,1999.0,28.5,39,15,15,16,8,16,54,29.6,38,31,9,22,28,67,34,0,MF,20-24,Midfielder,Sweden,Europe
2591,Michael Svoboda,AUT,Venezia,Serie A,2021,22.0,1998.0,13.7,33,17,26,6,1,18,32,56.3,14,27,15,12,10,43,61,5,DF,20-24,Defender,Austria,Europe
2592,Abdoulaye Sylla,GUI,Nantes,Ligue 1,2021,21.0,2000.0,1.7,4,4,2,1,1,2,4,50.0,2,5,3,2,1,5,3,0,DF,20-24,Defender,Guinea,Africa
2593,Mamadou Sylla,SEN,Alavés,La Liga,2021,27.0,1994.0,4.4,2,2,0,1,1,0,1,0.0,1,0,0,0,1,3,5,0,"FW,MF",25-29,Forward,Senegal,Africa
2593,Mamadou Sylla,SEN,Alavés,La Liga,2021,27.0,1994.0,4.4,2,2,0,1,1,0,1,0.0,1,0,0,0,1,3,5,0,"FW,MF",25-29,Forward,Senegal,Africa
2593,Mamadou Sylla,SEN,Alavés,La Liga,2021,27.0,1994.0,4.4,2,2,0,1,1,0,1,0.0,1,0,0,0,1,3,5,0,"FW,MF",25-29,Forward,Senegal,Africa
2593,Mamadou Sylla,SEN,Alavés,La Liga,2021,27.0,1994.0,4.4,2,2,0,1,1,0,1,0.0,1,0,0,0,1,3,5,0,"FW,MF",25-29,Forward,Senegal,Africa
2594,Mamadou Sylla,SEN,Rayo Vallecano,La Liga,2021,27.0,1994.0,2.8,1,1,1,0,0,0,1,0.0,1,2,0,2,4,5,3,0,FW,25-29,Forward,Senegal,Africa
2594,Mamadou Sylla,SEN,Rayo Vallecano,La Liga,2021,27.0,1994.0,2.8,1,1,1,0,0,0,1,0.0,1,2,0,2,4,5,3,0,FW,25-29,Forward,Senegal,Africa
2594,Mamadou Sylla,SEN,Rayo Vallecano,La Liga,2021,27.0,1994.0,2.8,1,1,1,0,0,0,1,0.0,1,2,0,2,4,5,3,0,FW,25-29,Forward,Senegal,Africa
2594,Mamadou Sylla,SEN,Rayo Vallecano,La Liga,2021,27.0,1994.0,2.8,1,1,1,0,0,0,1,0.0,1,2,0,2,4,5,3,0,FW,25-29,Forward,Senegal,Africa
2595,Ádám Szalai,HUN,Mainz 05,Bundesliga,2021,33.0,1987.0,2.9,3,2,0,2,1,0,2,0.0,2,2,0,2,0,3,0,0,FW,30-34,Forward,Hungary,Europe
2597,Dominik Szoboszlai,HUN,RB Leipzig,Bundesliga,2021,20.0,2000.0,17.1,17,12,5,9,3,8,27,29.6,19,30,3,27,10,27,15,0,"MF,FW",20-24,Midfielder,Hungary,Europe
2598,Jakob Sørensen,DEN,Norwich City,Premier League,2021,23.0,1998.0,6.7,22,11,6,14,2,10,20,50.0,10,7,3,4,10,32,19,0,"MF,DF",20-24,Midfielder,Denmark,Europe
2601,Jonathan Tah,GER,Leverkusen,Bundesliga,2021,25.0,1996.0,32.0,25,18,19,5,1,17,33,51.5,16,31,20,11,43,68,156,0,DF,25-29,Defender,Germany,Europe
2602,Waniss Taibi,FRA,Angers,Ligue 1,2021,19.0,2002.0,1.5,8,7,4,4,0,2,4,50.0,2,0,0,0,1,9,1,0,"MF,FW",Under 20,Midfielder,France,Europe
2603,Flavien Tait,FRA,Rennes,Ligue 1,2021,28.0,1993.0,23.6,28,19,13,9,6,13,40,32.5,27,15,4,11,19,47,13,1,MF,25-29,Midfielder,France,Europe
2604,Adrien Tameze,CMR,Hellas Verona,Serie A,2021,27.0,1994.0,28.6,52,29,24,21,7,20,59,33.9,39,40,5,35,52,104,41,0,"MF,DF",25-29,Midfielder,Cameroon,Africa
2605,Japhet Tanganga,ENG,Tottenham,Premier League,2021,22.0,1999.0,8.2,14,8,7,6,1,9,19,47.4,10,13,5,8,9,23,31,0,DF,20-24,Defender,England,Europe
2606,Renato Tapia,PER,Celta Vigo,La Liga,2021,26.0,1995.0,15.7,50,31,15,31,4,20,50,40.0,30,21,5,16,28,78,43,0,MF,25-29,Midfielder,Peru,South America
2607,Edmond Tapsoba,BFA,Leverkusen,Bundesliga,2021,22.0,1999.0,20.2,35,17,24,10,1,20,32,62.5,12,27,15,12,29,64,72,1,DF,20-24,Defender,Burkina Faso,Africa
2608,Florian Tardieu,FRA,Troyes,Ligue 1,2021,29.0,1992.0,29.2,58,25,31,21,6,31,71,43.7,40,31,9,22,42,100,38,0,MF,25-29,Midfielder,France,Europe
2609,Matt Targett,ENG,Aston Villa,Premier League,2021,25.0,1995.0,15.9,34,18,28,5,1,24,45,53.3,21,16,9,7,23,57,35,0,DF,25-29,Defender,England,Europe
2610,Matt Targett,ENG,Newcastle Utd,Premier League,2021,25.0,1995.0,16.0,41,26,26,14,1,24,37,64.9,13,15,4,11,25,66,39,1,DF,25-29,Defender,England,Europe
2611,Oussama Targhalline,MAR,Marseille,Ligue 1,2021,19.0,2002.0,0.1,0,0,0,0,0,0,0,,0,0,0,0,0,0,0,0,FW,Under 20,Forward,Morocco,Africa
2612,James Tarkowski,ENG,Burnley,Premier League,2021,28.0,1992.0,34.5,65,45,47,17,1,33,47,70.2,14,75,61,14,48,113,186,4,DF,25-29,Defender,England,Europe
2613,Ciprian Tătărușanu,ROU,Milan,Serie A,2021,35.0,1986.0,6.0,0,0,0,0,0,0,1,0.0,1,0,0,0,0,0,2,1,GK,35-39,Goalkeeper,Romania,Europe
2614,Niklas Tauer,GER,Mainz 05,Bundesliga,2021,20.0,2001.0,5.4,16,9,9,7,0,9,14,64.3,5,6,2,4,9,25,14,0,"DF,MF",20-24,Defender,Germany,Europe
2615,Nuno Tavares,POR,Arsenal,Premier League,2021,21.0,2000.0,13.1,21,14,10,7,4,8,18,44.4,10,15,5,10,9,30,33,1,DF,20-24,Defender,Portugal,Europe
2616,Charlie Taylor,ENG,Burnley,Premier League,2021,27.0,1993.0,30.3,45,26,31,11,3,26,44,59.1,18,42,20,22,58,103,95,2,DF,25-29,Defender,England,Europe
2617,Loum Tchaouna,FRA,Rennes,Ligue 1,2021,17.0,2003.0,1.0,3,1,1,2,0,1,5,20.0,4,0,0,0,2,5,0,0,"FW,MF",Under 20,Forward,France,Europe
2618,Enzo Tchato,CMR,Montpellier,Ligue 1,2021,18.0,2002.0,0.1,0,0,0,0,0,0,0,,0,0,0,0,0,0,1,0,FW,Under 20,Forward,Cameroon,Africa
2619,Warren Tchimbembé,CGO,Metz,Ligue 1,2021,23.0,1998.0,2.3,1,1,0,1,0,0,1,0.0,1,2,1,1,2,3,2,0,MF,20-24,Midfielder,Congo,Africa
2620,Aurélien Tchouaméni,FRA,Monaco,Ligue 1,2021,21.0,2000.0,32.5,86,45,33,49,4,29,55,52.7,26,39,7,32,101,187,34,0,MF,20-24,Midfielder,France,Europe
2621,Mathys Tel,FRA,Rennes,Ligue 1,2021,16.0,2005.0,0.6,2,1,1,1,0,0,0,,0,0,0,0,1,3,2,0,"FW,MF",Under 20,Forward,France,Europe
2623,Nathan Tella,NGA,Southampton,Premier League,2021,22.0,1999.0,8.9,13,9,5,7,1,6,17,35.3,11,13,0,13,6,19,9,0,"MF,FW",20-24,Midfielder,Nigeria,Africa
2624,Alex Telles,BRA,Manchester Utd,Premier League,2021,28.0,1992.0,18.4,48,27,35,9,4,27,43,62.8,16,17,4,13,26,74,45,0,DF,25-29,Defender,Brazil,South America
2626,Nahuel Tenaglia,ARG,Alavés,La Liga,2021,25.0,1996.0,11.9,42,27,30,9,3,24,37,64.9,13,10,2,8,26,68,42,0,DF,25-29,Defender,Argentina,South America
2628,Marc-André ter Stegen,GER,Barcelona,La Liga,2021,29.0,1992.0,35.0,0,0,0,0,0,0,1,0.0,1,0,0,0,1,1,13,5,GK,25-29,Goalkeeper,Germany,Europe
2629,Filippo Terracciano,ITA,Hellas Verona,Serie A,2021,18.0,2003.0,0.1,0,0,0,0,0,0,0,,0,0,0,0,0,0,1,0,DF,Under 20,Defender,Italy,Europe
2630,Pietro Terracciano,ITA,Fiorentina,Serie A,2021,31.0,1990.0,31.8,0,0,0,0,0,0,4,0.0,4,0,0,0,2,2,20,1,GK,30-34,Goalkeeper,Italy,Europe
2631,Martin Terrier,FRA,Rennes,Ligue 1,2021,24.0,1997.0,30.9,55,33,22,16,17,25,43,58.1,18,29,3,26,18,73,17,0,"FW,MF",20-24,Forward,France,Europe
2633,Robert Tesche,GER,Bochum,Bundesliga,2021,34.0,1987.0,3.9,6,4,4,1,1,5,7,71.4,2,6,2,4,5,11,5,1,MF,30-34,Midfielder,Germany,Europe
2634,Tanner Tessmann,USA,Venezia,Serie A,2021,19.0,2001.0,7.6,11,5,4,6,1,5,14,35.7,9,19,9,10,5,16,22,0,MF,Under 20,Midfielder,United States,North America
2635,Tetê,BRA,Lyon,Ligue 1,2021,21.0,2000.0,6.5,10,5,4,5,1,3,13,23.1,10,4,0,4,3,13,1,0,"FW,MF",20-24,Forward,Brazil,South America
2636,Cedric Teuchert,GER,Union Berlin,Bundesliga,2021,24.0,1997.0,1.2,3,2,3,0,0,2,6,33.3,4,1,0,1,0,3,0,0,"MF,FW",20-24,Midfielder,Germany,Europe
2637,Arthur Theate,BEL,Bologna,Serie A,2021,21.0,2000.0,26.9,33,19,26,3,4,14,31,45.2,17,29,16,13,42,75,69,0,DF,20-24,Defender,Belgium,Europe
2638,Jan Thielmann,GER,Köln,Bundesliga,2021,19.0,2002.0,13.2,24,16,6,12,6,8,23,34.8,15,23,2,21,10,34,11,0,"MF,FW",Under 20,Midfielder,Germany,Europe
2639,Sada Thioub,SEN,Angers,Ligue 1,2021,26.0,1995.0,0.0,0,0,0,0,0,0,0,,0,0,0,0,0,0,0,0,FW,25-29,Forward,Senegal,Africa
2640,Sada Thioub,SEN,Saint-Étienne,Ligue 1,2021,26.0,1995.0,10.6,13,8,5,8,0,6,14,42.9,8,9,0,9,10,23,8,0,"DF,MF",25-29,Defender,Senegal,Africa
2641,Luke Thomas,ENG,Leicester City,Premier League,2021,20.0,2001.0,21.2,50,31,33,13,4,28,65,43.1,37,35,14,21,40,90,55,0,DF,20-24,Defender,England,Europe
2642,Romain Thomas,FRA,Angers,Ligue 1,2021,33.0,1988.0,28.5,49,37,28,21,0,30,57,52.6,27,35,19,16,44,93,126,0,DF,30-34,Defender,France,Europe
2643,Adrien Thomasson,FRA,Strasbourg,Ligue 1,2021,27.0,1993.0,26.5,64,31,18,27,19,30,93,32.3,63,56,4,52,29,93,16,1,MF,25-29,Midfielder,France,Europe
2644,Erik Thommy,GER,Stuttgart,Bundesliga,2021,26.0,1994.0,3.0,2,0,0,2,0,1,2,50.0,1,3,0,3,4,6,0,0,"FW,MF",25-29,Forward,Germany,Europe
2645,Dominic Thompson,ENG,Brentford,Premier League,2021,21.0,2000.0,1.6,1,0,1,0,0,0,1,0.0,1,2,2,0,2,3,3,0,DF,20-24,Defender,England,Europe
2647,Matheus Thuler,BRA,Montpellier,Ligue 1,2021,22.0,1999.0,9.5,21,12,17,4,0,8,15,53.3,7,9,7,2,9,30,30,0,DF,20-24,Defender,Brazil,South America
2648,Khéphren Thuram,FRA,Nice,Ligue 1,2021,20.0,2001.0,21.1,33,19,11,18,4,17,35,48.6,18,31,11,20,28,61,19,0,MF,20-24,Midfielder,France,Europe
2649,Marcus Thuram,FRA,Gladbach,Bundesliga,2021,23.0,1997.0,10.9,6,5,0,5,1,1,4,25.0,3,5,0,5,5,11,5,0,FW,20-24,Forward,France,Europe
2650,Alexis Tibidi,FRA,Stuttgart,Bundesliga,2021,17.0,2003.0,4.3,7,3,1,3,3,3,4,75.0,1,4,0,4,3,10,2,0,"MF,FW",Under 20,Midfielder,France,Europe
2651,Cheikh Tidiane Sabaly,SEN,Metz,Ligue 1,2021,22.0,1999.0,1.7,6,3,1,4,1,2,2,100.0,0,1,0,1,0,6,1,0,"FW,MF",20-24,Forward,Senegal,Africa
2652,Youri Tielemans,BEL,Leicester City,Premier League,2021,24.0,1997.0,29.2,74,38,23,45,6,42,100,42.0,58,47,13,34,21,95,41,3,MF,20-24,Midfielder,Belgium,Europe
2653,Kieran Tierney,SCO,Arsenal,Premier League,2021,24.0,1997.0,21.3,18,14,11,7,0,10,11,90.9,1,23,5,18,15,33,54,0,DF,20-24,Defender,Scotland,Europe
2654,Steffen Tigges,GER,Dortmund,Bundesliga,2021,23.0,1998.0,1.2,4,3,1,2,1,2,3,66.7,1,3,1,2,0,4,3,0,"FW,MF",20-24,Forward,Germany,Europe
2655,Malik Tillman,USA,Bayern Munich,Bundesliga,2021,19.0,2002.0,1.2,2,1,0,1,1,0,1,0.0,1,5,1,4,2,4,1,0,"FW,MF",Under 20,Forward,United States,North America
2656,Timmy Tillman,GER,Greuther Fürth,Bundesliga,2021,22.0,1999.0,22.3,43,26,17,18,8,19,42,45.2,23,33,4,29,12,55,26,0,MF,20-24,Midfielder,Germany,Europe
2658,Mircea Ţîrlea,ROU,Alavés,La Liga,2021,21.0,2000.0,0.2,0,0,0,0,0,0,0,,0,0,0,0,0,0,1,0,DF,20-24,Defender,Romania,Europe
2659,Jean-Clair Todibo,FRA,Nice,Ligue 1,2021,21.0,1999.0,34.6,59,37,43,15,1,39,60,65.0,21,45,21,24,51,110,130,2,DF,20-24,Defender,France,Europe
2660,Umut Tohumcu,GER,Hoffenheim,Bundesliga,2021,16.0,2004.0,0.1,0,0,0,0,0,0,0,,0,0,0,0,0,0,0,0,MF,Under 20,Midfielder,Germany,Europe
2661,Karl Toko Ekambi,CMR,Lyon,Ligue 1,2021,28.0,1992.0,25.5,13,7,4,6,3,4,21,19.0,17,26,0,26,20,33,5,0,FW,25-29,Forward,Cameroon,Africa
2662,Corentin Tolisso,FRA,Bayern Munich,Bundesliga,2021,26.0,1994.0,7.8,11,5,1,9,1,7,17,41.2,10,5,1,4,9,20,10,0,MF,25-29,Midfielder,France,Europe
2663,Jeremy Toljan,GER,Sassuolo,Serie A,2021,26.0,1994.0,15.5,18,10,12,4,2,13,20,65.0,7,12,5,7,12,30,41,0,DF,25-29,Defender,Germany,Europe
2664,Rafael Tolói,ITA,Atalanta,Serie A,2021,30.0,1990.0,16.0,38,15,12,15,11,24,39,61.5,15,23,11,12,26,64,35,0,DF,30-34,Defender,Italy,Europe
2666,Tiago Tomás,POR,Stuttgart,Bundesliga,2021,19.0,2002.0,11.9,8,4,0,7,1,0,6,0.0,6,3,0,3,4,12,1,0,FW,Under 20,Forward,Portugal,Europe
2667,Takehiro Tomiyasu,JPN,Arsenal,Premier League,2021,22.0,1998.0,18.7,35,17,19,13,3,21,32,65.6,11,22,3,19,24,59,64,2,DF,20-24,Defender,Japan,Asia
2668,Takehiro Tomiyasu,JPN,Bologna,Serie A,2021,22.0,1998.0,0.1,0,0,0,0,0,0,0,,0,1,0,1,1,1,0,0,DF,20-24,Defender,Japan,Asia
2669,James Tomkins,ENG,Crystal Palace,Premier League,2021,32.0,1989.0,6.1,8,3,6,2,0,6,8,75.0,2,8,8,0,4,12,18,0,DF,30-34,Defender,England,Europe
2670,Fikayo Tomori,ENG,Milan,Serie A,2021,23.0,1997.0,30.2,73,44,36,34,3,18,26,69.2,8,37,23,14,45,118,84,1,DF,20-24,Defender,England,Europe
2671,Sandro Tonali,ITA,Milan,Serie A,2021,21.0,2000.0,28.9,54,37,23,25,6,21,41,51.2,20,26,8,18,34,88,19,0,MF,20-24,Midfielder,Italy,Europe
2672,Lorenzo Tonelli,ITA,Empoli,Serie A,2021,31.0,1990.0,9.7,17,9,11,4,2,6,13,46.2,7,14,8,6,19,36,28,2,DF,30-34,Defender,Italy,Europe
2673,Ivan Toney,ENG,Brentford,Premier League,2021,25.0,1996.0,32.3,33,21,5,20,8,12,38,31.6,26,16,2,14,14,47,44,1,FW,25-29,Forward,England,Europe
2674,Ernesto Torregrossa,VEN,Sampdoria,Serie A,2021,29.0,1992.0,1.3,2,1,1,0,1,1,2,50.0,1,0,0,0,0,2,1,0,FW,25-29,Forward,Venezuela,South America
2675,Lucas Torreira,URU,Fiorentina,Serie A,2021,25.0,1996.0,24.4,37,29,13,21,3,18,40,45.0,22,18,1,17,26,63,18,0,MF,25-29,Midfielder,Uruguay,South America
2683,Jordan Torunarigha,GER,Hertha BSC,Bundesliga,2021,23.0,1997.0,5.4,4,1,1,3,0,4,5,80.0,1,4,2,2,17,21,30,0,DF,20-24,Defender,Germany,Europe
2684,Cenk Tosun,TUR,Everton,Premier League,2021,30.0,1991.0,0.1,0,0,0,0,0,0,0,,0,0,0,0,0,0,0,0,MF,30-34,Midfielder,Turkey,Asia
2685,Abdoulaye Touré,GUI,Genoa,Serie A,2021,27.0,1994.0,4.8,12,4,3,8,1,5,11,45.5,6,6,1,5,4,16,6,0,MF,25-29,Midfielder,Guinea,Africa
2685,Abdoulaye Touré,GUI,Genoa,Serie A,2021,27.0,1994.0,4.8,12,4,3,8,1,5,11,45.5,6,6,1,5,4,16,6,0,MF,25-29,Midfielder,Guinea,Africa
2685,Abdoulaye Touré,GUI,Genoa,Serie A,2021,27.0,1994.0,4.8,12,4,3,8,1,5,11,45.5,6,6,1,5,4,16,6,0,MF,25-29,Midfielder,Guinea,Africa
2685,Abdoulaye Touré,GUI,Genoa,Serie A,2021,27.0,1994.0,4.8,12,4,3,8,1,5,11,45.5,6,6,1,5,4,16,6,0,MF,25-29,Midfielder,Guinea,Africa
2686,Almamy Touré,MLI,Eint Frankfurt,Bundesliga,2021,25.0,1996.0,5.6,12,9,8,3,1,4,17,23.5,13,10,3,7,5,17,19,0,"DF,MF",25-29,Defender,Mali,Africa
2687,Lucas Tousart,FRA,Hertha BSC,Bundesliga,2021,24.0,1997.0,21.8,42,25,15,22,5,10,34,29.4,24,30,6,24,35,77,55,0,MF,20-24,Midfielder,France,Europe
2688,Yoann Touzghar,TUN,Troyes,Ligue 1,2021,34.0,1986.0,16.2,5,2,1,3,1,1,3,33.3,2,3,1,2,3,8,8,0,FW,30-34,Forward,Tunisia,Africa
2689,Andros Townsend,ENG,Everton,Premier League,2021,30.0,1991.0,16.2,31,17,15,6,10,15,40,37.5,25,28,2,26,14,45,6,1,"MF,FW",30-34,Midfielder,England,Europe
2692,Amadou Traore,FRA,Bordeaux,Ligue 1,2021,19.0,2002.0,0.2,0,0,0,0,0,0,0,,0,0,0,0,0,0,0,0,FW,Under 20,Forward,France,Europe
2693,Bertrand Traoré,BFA,Aston Villa,Premier League,2021,25.0,1995.0,2.4,3,3,0,1,2,1,2,50.0,1,0,0,0,0,3,1,0,"MF,FW",25-29,Midfielder,Burkina Faso,Africa
2694,Boubacar Traoré,MLI,Metz,Ligue 1,2021,19.0,2001.0,19.2,43,26,18,23,2,10,39,25.6,29,29,5,24,25,68,11,1,MF,Under 20,Midfielder,Mali,Africa
2695,Charles Traore,MLI,Nantes,Ligue 1,2021,29.0,1992.0,8.0,16,12,10,4,2,2,13,15.4,11,11,4,7,15,31,30,0,DF,25-29,Defender,Mali,Africa
2696,Hamari Traoré,MLI,Rennes,Ligue 1,2021,29.0,1992.0,32.1,63,36,25,26,12,41,59,69.5,18,29,8,21,37,100,81,1,DF,25-29,Defender,Mali,Africa
2697,Ismaël Traoré,CIV,Angers,Ligue 1,2021,34.0,1986.0,35.7,28,17,16,11,1,13,28,46.4,15,25,17,8,44,72,122,1,DF,30-34,Defender,Ivory Coast,Africa
2698,Kevin Trapp,GER,Eint Frankfurt,Bundesliga,2021,31.0,1990.0,32.0,0,0,0,0,0,0,1,0.0,1,0,0,0,1,1,13,2,GK,30-34,Goalkeeper,Germany,Europe
2699,Miguel Trauco,PER,Saint-Étienne,Ligue 1,2021,28.0,1992.0,12.4,25,18,16,8,1,12,22,54.5,10,13,4,9,23,48,17,0,"DF,MF",25-29,Defender,Peru,South America
2700,Óscar Trejo,ARG,Rayo Vallecano,La Liga,2021,33.0,1988.0,22.3,42,24,14,18,10,15,50,30.0,35,26,1,25,13,55,11,0,MF,30-34,Midfielder,Argentina,South America
2701,Trézéguet,EGY,Aston Villa,Premier League,2021,26.0,1994.0,0.1,0,0,0,0,0,0,0,,0,0,0,0,0,0,0,0,FW,25-29,Forward,Egypt,Africa
2703,Simone Trimboli,ITA,Sampdoria,Serie A,2021,19.0,2002.0,0.7,2,1,2,0,0,2,2,100.0,0,0,0,0,2,4,0,0,MF,Under 20,Midfielder,Italy,Europe
2704,Christopher Trimmel,AUT,Union Berlin,Bundesliga,2021,34.0,1987.0,22.1,49,30,25,19,5,26,45,57.8,19,20,3,17,34,83,75,0,"DF,FW",30-34,Defender,Austria,Europe
2705,Francisco Trincão,POR,Wolves,Premier League,2021,21.0,1999.0,14.8,28,15,9,13,6,3,19,15.8,16,17,1,16,12,40,1,1,"FW,MF",20-24,Forward,Portugal,Europe
2706,Kieran Trippier,ENG,Newcastle Utd,Premier League,2021,30.0,1990.0,4.8,17,10,8,8,1,10,16,62.5,6,10,3,7,10,27,10,0,DF,30-34,Defender,England,Europe
2707,Kieran Trippier,ENG,Atlético Madrid,La Liga,2021,30.0,1990.0,10.8,22,12,12,5,5,12,21,57.1,9,12,1,11,10,32,11,0,"DF,FW",30-34,Defender,England,Europe
2708,William Troost-Ekong,NGA,Watford,Premier League,2021,27.0,1993.0,15.4,18,9,11,6,1,10,15,66.7,5,24,14,10,7,25,82,1,DF,25-29,Defender,Nigeria,Africa
2709,Leandro Trossard,BEL,Brighton,Premier League,2021,26.0,1994.0,31.2,34,20,12,9,13,4,31,12.9,27,33,4,29,15,49,10,0,"FW,MF",25-29,Forward,Belgium,Europe
2710,Adrien Truffert,FRA,Rennes,Ligue 1,2021,19.0,2001.0,18.2,29,21,17,9,3,11,24,45.8,13,25,5,20,19,48,30,0,DF,Under 20,Defender,France,Europe
2711,Philipp Tschauner,GER,RB Leipzig,Bundesliga,2021,35.0,1985.0,0.0,0,0,0,0,0,0,0,,0,0,0,0,0,0,0,0,GK,35-39,Goalkeeper,Germany,Europe
2712,Kostas Tsimikas,GRE,Liverpool,Premier League,2021,25.0,1996.0,9.7,27,12,12,8,7,12,16,75.0,4,6,2,4,10,37,22,2,DF,25-29,Defender,Greece,Europe
2713,Axel Tuanzebe,COD,Aston Villa,Premier League,2021,23.0,1997.0,5.6,5,3,3,2,0,2,5,40.0,3,5,4,1,5,10,12,1,DF,20-24,Defender,DR Congo,Africa
2714,Axel Tuanzebe,COD,Napoli,Serie A,2021,23.0,1997.0,0.1,0,0,0,0,0,0,0,,0,1,1,0,0,0,0,0,DF,20-24,Defender,DR Congo,Africa
2715,Ozan Tufan,TUR,Watford,Premier League,2021,26.0,1995.0,3.7,3,2,1,1,1,1,5,20.0,4,2,0,2,2,5,4,0,MF,25-29,Midfielder,Turkey,Asia
2717,Tuta,BRA,Eint Frankfurt,Bundesliga,2021,22.0,1999.0,24.3,46,28,20,22,4,26,47,55.3,21,43,15,28,41,87,76,1,DF,20-24,Defender,Brazil,South America
2718,Christos Tzolis,GRE,Norwich City,Premier League,2021,19.0,2002.0,3.7,5,3,3,1,1,2,9,22.2,7,3,0,3,1,6,1,0,"FW,MF",Under 20,Forward,Greece,Europe
2719,Destiny Udogie,ITA,Udinese,Serie A,2021,18.0,2002.0,27.5,64,40,30,27,7,33,60,55.0,27,39,6,33,27,91,42,0,DF,Under 20,Defender,Italy,Europe
2720,Matthieu Udol,FRA,Metz,Ligue 1,2021,25.0,1996.0,11.2,23,14,11,10,2,12,18,66.7,6,20,7,13,31,54,29,1,DF,25-29,Defender,France,Europe
2721,Ike Ugbo,CAN,Troyes,Ligue 1,2021,22.0,1998.0,9.0,3,1,0,1,2,0,1,0.0,1,4,1,3,2,5,1,0,FW,20-24,Forward,Canada,North America
2722,Lesley Ugochukwu,FRA,Rennes,Ligue 1,2021,17.0,2004.0,4.5,13,9,5,5,3,9,19,47.4,10,7,2,5,4,17,2,0,MF,Under 20,Midfielder,France,Europe
2723,Hwang Ui-jo,KOR,Bordeaux,Ligue 1,2021,28.0,1992.0,27.9,10,4,4,4,2,4,13,30.8,9,9,1,8,5,15,18,0,FW,25-29,Forward,South Korea,Asia
2724,Anthony Ujah,NGA,Union Berlin,Bundesliga,2021,30.0,1990.0,0.4,0,0,0,0,0,0,0,,0,0,0,0,0,0,0,0,"FW,MF",30-34,Forward,Nigeria,Africa
2725,Maximilian Ullmann,AUT,Venezia,Serie A,2021,25.0,1996.0,2.7,0,0,0,0,0,0,1,0.0,1,4,0,4,2,2,7,0,DF,25-29,Defender,Austria,Europe
2726,Sven Ulreich,GER,Bayern Munich,Bundesliga,2021,32.0,1988.0,6.0,0,0,0,0,0,0,0,,0,0,0,0,0,0,1,0,GK,30-34,Goalkeeper,Germany,Europe
2727,Samuel Umtiti,FRA,Barcelona,La Liga,2021,27.0,1993.0,1.0,2,2,2,0,0,1,2,50.0,1,1,1,0,0,2,4,0,DF,25-29,Defender,France,Europe
2728,Enes Ünal,TUR,Getafe,La Liga,2021,24.0,1997.0,31.1,37,22,2,18,17,5,42,11.9,37,25,5,20,5,42,36,0,FW,20-24,Forward,Turkey,Asia
2729,Cengiz Ünder,TUR,Marseille,Ligue 1,2021,24.0,1997.0,24.4,18,13,5,6,7,5,18,27.8,13,13,2,11,14,32,9,0,"FW,MF",20-24,Forward,Turkey,Asia
2730,Dayot Upamecano,FRA,Bayern Munich,Bundesliga,2021,22.0,1998.0,24.6,66,42,42,21,3,24,36,66.7,12,20,10,10,32,98,71,6,DF,20-24,Defender,France,Europe
2731,Benjamin Uphoff,GER,Freiburg,Bundesliga,2021,27.0,1993.0,2.0,0,0,0,0,0,0,0,,0,0,0,0,0,0,2,2,GK,25-29,Goalkeeper,Germany,Europe
2733,Jere Uronen,FIN,Brest,Ligue 1,2021,27.0,1994.0,9.8,28,15,15,10,3,14,24,58.3,10,12,3,9,16,44,21,0,DF,25-29,Defender,Finland,Europe
2734,Mark Uth,GER,Köln,Bundesliga,2021,29.0,1991.0,22.5,32,20,9,14,9,15,49,30.6,34,27,1,26,14,46,13,0,"MF,FW",25-29,Midfielder,Germany,Europe
2735,Myrto Uzuni,ALB,Granada,La Liga,2021,26.0,1995.0,9.5,7,4,6,1,0,0,2,0.0,2,13,1,12,10,17,7,0,"FW,MF",25-29,Forward,Albania,Europe
2736,Antonio Vacca,ITA,Venezia,Serie A,2021,31.0,1990.0,11.8,36,20,24,10,2,14,36,38.9,22,16,8,8,20,56,16,0,MF,30-34,Midfielder,Italy,Europe
2740,Yan Valery,TUN,Southampton,Premier League,2021,22.0,1999.0,4.1,8,6,4,3,1,4,9,44.4,5,6,3,3,6,14,19,1,DF,20-24,Defender,Tunisia,Africa
2741,Martin Valjent,SVK,Mallorca,La Liga,2021,25.0,1995.0,35.3,31,19,18,12,1,13,24,54.2,11,34,26,8,31,62,173,1,DF,25-29,Defender,Slovakia,Europe
2745,Federico Valverde,URU,Real Madrid,La Liga,2021,23.0,1998.0,20.4,36,16,11,16,9,12,31,38.7,19,23,5,18,24,60,12,0,MF,20-24,Midfielder,Uruguay,South America
2746,Virgil van Dijk,NED,Liverpool,Premier League,2021,30.0,1991.0,34.0,16,10,11,5,0,11,16,68.8,5,21,14,7,31,47,109,0,DF,30-34,Defender,Netherlands,Europe
2747,Vanderson,BRA,Monaco,Ligue 1,2021,20.0,2001.0,12.4,35,19,10,19,6,15,23,65.2,8,17,4,13,13,48,12,0,"FW,DF",20-24,Forward,Brazil,South America
2747,Vanderson,BRA,Monaco,Ligue 1,2021,20.0,2001.0,12.4,35,19,10,19,6,15,23,65.2,8,17,4,13,13,48,12,0,"FW,DF",20-24,Forward,Brazil,South America
2747,Vanderson,BRA,Monaco,Ligue 1,2021,20.0,2001.0,12.4,35,19,10,19,6,15,23,65.2,8,17,4,13,13,48,12,0,"FW,DF",20-24,Forward,Brazil,South America
2747,Vanderson,BRA,Monaco,Ligue 1,2021,20.0,2001.0,12.4,35,19,10,19,6,15,23,65.2,8,17,4,13,13,48,12,0,"FW,DF",20-24,Forward,Brazil,South America
2748,Zinho Vanheusden,BEL,Genoa,Serie A,2021,22.0,1999.0,11.0,18,6,12,5,1,8,14,57.1,6,19,14,5,23,41,42,0,DF,20-24,Defender,Belgium,Europe
2750,Raphaël Varane,FRA,Manchester Utd,Premier League,2021,28.0,1993.0,20.3,28,19,21,6,1,10,22,45.5,12,18,9,9,18,46,82,1,DF,25-29,Defender,France,Europe
2751,Jamie Vardy,ENG,Leicester City,Premier League,2021,34.0,1987.0,20.1,6,5,0,4,2,1,7,14.3,6,9,0,9,1,7,17,0,FW,30-34,Forward,England,Europe
2752,Ruben Vargas,SUI,Augsburg,Bundesliga,2021,22.0,1998.0,22.0,28,21,7,14,7,11,30,36.7,19,9,1,8,16,44,13,0,"MF,FW",20-24,Midfielder,Switzerland,Europe
2753,Sebastian Vasiliadis,GRE,Arminia,Bundesliga,2021,23.0,1997.0,13.3,31,17,12,15,4,15,42,35.7,27,15,2,13,25,56,31,1,MF,20-24,Midfielder,Greece,Europe
2754,Johan Vásquez,MEX,Genoa,Serie A,2021,22.0,1998.0,25.3,79,46,44,32,3,48,75,64.0,27,32,10,22,42,121,85,0,DF,20-24,Defender,Mexico,North America
2755,Denis Vavro,SVK,Lazio,Serie A,2021,25.0,1996.0,0.1,0,0,0,0,0,0,0,,0,0,0,0,0,0,0,0,DF,25-29,Defender,Slovakia,Europe
2760,Matías Vecino,URU,Inter,Serie A,2021,29.0,1991.0,4.2,7,5,2,3,2,3,9,33.3,6,10,1,9,4,11,7,0,MF,25-29,Midfielder,Uruguay,South America
2762,Miguel Veloso,POR,Hellas Verona,Serie A,2021,35.0,1986.0,14.9,23,15,4,17,2,10,16,62.5,6,18,5,13,11,34,18,1,MF,35-39,Midfielder,Portugal,Europe
2763,Joël Veltman,NED,Brighton,Premier League,2021,29.0,1992.0,31.9,74,48,47,21,6,21,53,39.6,32,46,16,30,45,119,89,0,DF,25-29,Defender,Netherlands,Europe
2764,Micky van de Ven,NED,Wolfsburg,Bundesliga,2021,20.0,2001.0,2.1,4,4,3,1,0,0,1,0.0,1,4,1,3,2,6,8,0,DF,20-24,Defender,Netherlands,Europe
2766,Lorenzo Venuti,ITA,Fiorentina,Serie A,2021,26.0,1995.0,17.5,25,10,13,10,2,14,24,58.3,10,13,4,9,5,30,27,0,DF,25-29,Defender,Italy,Europe
2767,Daniele Verde,ITA,Spezia,Serie A,2021,25.0,1996.0,21.7,11,4,8,2,1,9,20,45.0,11,17,2,15,18,29,8,0,"FW,MF",25-29,Forward,Italy,Europe
2768,Simone Verdi,ITA,Torino,Serie A,2021,29.0,1992.0,0.5,1,1,0,1,0,0,0,,0,0,0,0,0,1,0,0,"MF,FW",25-29,Midfielder,Italy,Europe
2769,Simone Verdi,ITA,Salernitana,Serie A,2021,29.0,1992.0,9.2,12,8,5,2,5,9,20,45.0,11,4,0,4,3,15,1,0,"FW,MF",25-29,Forward,Italy,Europe
2771,Jordan Veretout,FRA,Roma,Serie A,2021,28.0,1993.0,25.8,34,25,20,12,2,15,39,38.5,24,12,1,11,27,61,22,1,MF,25-29,Midfielder,France,Europe
2772,Edoardo Vergani,ITA,Salernitana,Serie A,2021,20.0,2001.0,1.1,2,2,2,0,0,0,0,,0,2,2,0,0,2,2,0,"FW,MF",20-24,Forward,Italy,Europe
2773,Vincent Vermeij,NED,Freiburg,Bundesliga,2021,26.0,1994.0,0.0,0,0,0,0,0,0,0,,0,1,0,1,0,0,0,0,MF,25-29,Midfielder,Netherlands,Europe
2774,Marco Verratti,ITA,Paris S-G,Ligue 1,2021,28.0,1992.0,21.5,60,40,16,30,14,32,64,50.0,32,36,10,26,18,78,14,2,MF,25-29,Midfielder,Italy,Europe
2775,Valerio Verre,ITA,Sampdoria,Serie A,2021,27.0,1994.0,4.7,7,5,1,4,2,4,9,44.4,5,7,0,7,0,7,5,0,"MF,FW",25-29,Midfielder,Italy,Europe
2776,Valerio Verre,ITA,Empoli,Serie A,2021,27.0,1994.0,3.4,4,2,3,1,0,2,7,28.6,5,2,0,2,1,5,0,0,MF,25-29,Midfielder,Italy,Europe
2777,Freddie Veseli,ALB,Salernitana,Serie A,2021,28.0,1992.0,6.6,7,2,4,3,0,5,6,83.3,1,10,5,5,4,11,19,0,DF,25-29,Defender,Albania,Europe
2779,Jannik Vestergaard,DEN,Leicester City,Premier League,2021,28.0,1992.0,6.3,15,10,12,3,0,8,15,53.3,7,10,8,2,7,22,36,0,DF,25-29,Defender,Denmark,Europe
2780,Rúben Vezo,POR,Levante,La Liga,2021,27.0,1994.0,26.9,41,29,28,12,1,26,41,63.4,15,41,25,16,36,77,105,1,DF,25-29,Defender,Portugal,Europe
2781,Guglielmo Vicario,ITA,Empoli,Serie A,2021,24.0,1996.0,38.0,1,1,1,0,0,1,1,100.0,0,1,0,1,1,2,21,1,GK,20-24,Goalkeeper,Italy,Europe
2783,Arturo Vidal,CHI,Inter,Serie A,2021,34.0,1987.0,8.2,26,10,16,9,1,9,26,34.6,17,13,5,8,7,33,7,1,MF,30-34,Midfielder,Chile,South America
2785,Gabriel Vidovic,CRO,Bayern Munich,Bundesliga,2021,17.0,2003.0,0.4,0,0,0,0,0,0,0,,0,0,0,0,0,0,0,0,"FW,MF",Under 20,Forward,Croatia,Europe
2786,Ronaldo Vieira,ENG,Sampdoria,Serie A,2021,23.0,1998.0,5.5,10,6,6,4,0,5,10,50.0,5,5,2,3,6,16,5,1,MF,20-24,Midfielder,England,Europe
2787,Nick Viergever,NED,Greuther Fürth,Bundesliga,2021,31.0,1989.0,23.7,32,23,25,7,0,24,34,70.6,10,31,22,9,37,69,119,1,DF,30-34,Defender,Netherlands,Europe
2788,Luca Vignali,ITA,Spezia,Serie A,2021,25.0,1996.0,0.9,1,1,0,1,0,0,3,0.0,3,0,0,0,1,2,1,0,"DF,MF",25-29,Defender,Italy,Europe
2789,Emanuel Vignato,ITA,Bologna,Serie A,2021,20.0,2000.0,6.6,12,7,5,7,0,6,13,46.2,7,2,0,2,2,14,5,0,"MF,DF",20-24,Midfielder,Italy,Europe
2791,Tonny Vilhena,NED,Espanyol,La Liga,2021,26.0,1995.0,10.3,16,6,7,8,1,7,21,33.3,14,10,2,8,8,24,17,0,"MF,FW",25-29,Midfielder,Netherlands,Europe
2795,Matías Viña,URU,Roma,Serie A,2021,23.0,1997.0,17.4,46,30,27,14,5,29,59,49.2,30,26,3,23,25,71,33,0,"DF,FW",20-24,Defender,Uruguay,South America
2796,Nicolas Viola,ITA,Bologna,Serie A,2021,31.0,1989.0,1.1,2,2,1,1,0,1,2,50.0,1,1,1,0,0,2,1,0,MF,30-34,Midfielder,Italy,Europe
2797,Mattia Viti,ITA,Empoli,Serie A,2021,19.0,2002.0,16.6,28,16,16,9,3,15,24,62.5,9,28,25,3,29,57,69,1,DF,Under 20,Defender,Italy,Europe
2802,Nikola Vlašić,CRO,West Ham,Premier League,2021,23.0,1997.0,6.2,11,7,4,6,1,5,20,25.0,15,4,0,4,2,13,1,0,"FW,MF",20-24,Forward,Croatia,Europe
2803,Andreas Voglsammer,GER,Union Berlin,Bundesliga,2021,29.0,1992.0,9.8,14,9,8,3,3,6,14,42.9,8,9,2,7,2,16,7,0,"FW,MF",25-29,Forward,Germany,Europe
2804,Kevin Vogt,GER,Hoffenheim,Bundesliga,2021,29.0,1991.0,28.5,21,12,15,6,0,11,21,52.4,10,18,7,11,13,34,101,1,DF,25-29,Defender,Germany,Europe
2806,Kevin Volland,GER,Monaco,Ligue 1,2021,29.0,1992.0,27.1,24,10,2,18,4,6,31,19.4,25,20,0,20,3,27,9,0,"MF,FW",25-29,Midfielder,Germany,Europe
2807,Cristian Volpato,ITA,Roma,Serie A,2021,17.0,2003.0,0.4,1,1,0,0,1,1,1,100.0,0,0,0,0,0,1,0,0,"FW,MF",Under 20,Forward,Italy,Europe
2808,Aster Vranckx,BEL,Wolfsburg,Bundesliga,2021,18.0,2002.0,12.7,34,13,14,16,4,14,26,53.8,12,19,7,12,13,47,16,0,MF,Under 20,Midfielder,Belgium,Europe
2809,Stefan de Vrij,NED,Inter,Serie A,2021,29.0,1992.0,26.8,38,29,22,16,0,12,17,70.6,5,17,8,9,32,70,52,0,DF,25-29,Defender,Netherlands,Europe
2810,Šime Vrsaljko,CRO,Atlético Madrid,La Liga,2021,29.0,1992.0,10.2,27,17,14,12,1,12,20,60.0,8,10,1,9,12,39,30,0,DF,25-29,Defender,Croatia,Europe
2811,Nikola Vukčević,MNE,Levante,La Liga,2021,29.0,1991.0,1.3,3,2,2,1,0,0,1,0.0,1,2,0,2,2,5,1,0,MF,25-29,Midfielder,Montenegro,Europe
2813,Elye Wahi,FRA,Montpellier,Ligue 1,2021,18.0,2003.0,19.8,18,10,9,6,3,6,16,37.5,10,7,0,7,4,22,4,0,FW,Under 20,Forward,France,Europe
2814,Walace,BRA,Udinese,Serie A,2021,26.0,1995.0,33.0,83,49,37,38,8,50,113,44.2,63,51,5,46,54,137,32,1,MF,25-29,Midfielder,Brazil,South America
2815,Theo Walcott,ENG,Southampton,Premier League,2021,32.0,1989.0,4.2,4,2,2,0,2,1,5,20.0,4,3,0,3,5,9,2,0,"MF,FW",30-34,Midfielder,England,Europe
2816,Luca Waldschmidt,GER,Wolfsburg,Bundesliga,2021,25.0,1996.0,8.0,9,1,3,5,1,5,13,38.5,8,5,0,5,8,17,3,0,"MF,FW",25-29,Midfielder,Germany,Europe
2817,Kyle Walker,ENG,Manchester City,Premier League,2021,31.0,1990.0,19.5,15,6,7,7,1,8,17,47.1,9,14,4,10,14,29,16,1,DF,30-34,Defender,England,Europe
2818,Kyle Walker-Peters,ENG,Southampton,Premier League,2021,24.0,1997.0,29.3,57,33,28,21,8,26,38,68.4,12,29,8,21,37,94,53,1,DF,20-24,Defender,England,Europe
2820,Aaron Wan-Bissaka,ENG,Manchester Utd,Premier League,2021,23.0,1997.0,19.9,49,36,25,18,6,14,20,70.0,6,24,14,10,34,83,41,2,DF,20-24,Defender,England,Europe
2821,Paul Wanner,GER,Bayern Munich,Bundesliga,2021,15.0,2005.0,0.4,2,2,0,2,0,1,1,100.0,0,0,0,0,0,2,0,0,"FW,MF",Under 20,Forward,Germany,Europe
2822,Danny Ward,WAL,Leicester City,Premier League,2021,28.0,1993.0,1.0,0,0,0,0,0,0,0,,0,0,0,0,0,0,1,0,GK,25-29,Goalkeeper,Wales,Europe
2822,Danny Ward,WAL,Leicester City,Premier League,2021,28.0,1993.0,1.0,0,0,0,0,0,0,0,,0,0,0,0,0,0,1,0,GK,25-29,Goalkeeper,Wales,Europe
2822,Danny Ward,WAL,Leicester City,Premier League,2021,28.0,1993.0,1.0,0,0,0,0,0,0,0,,0,0,0,0,0,0,1,0,GK,25-29,Goalkeeper,Wales,Europe
2822,Danny Ward,WAL,Leicester City,Premier League,2021,28.0,1993.0,1.0,0,0,0,0,0,0,0,,0,0,0,0,0,0,1,0,GK,25-29,Goalkeeper,Wales,Europe
2823,Joel Ward,ENG,Crystal Palace,Premier League,2021,31.0,1989.0,27.6,44,26,30,11,3,30,57,52.6,27,24,11,13,32,76,107,1,DF,30-34,Defender,England,Europe
2824,James Ward-Prowse,ENG,Southampton,Premier League,2021,26.0,1994.0,35.7,41,24,12,24,5,19,70,27.1,51,43,15,28,40,81,45,1,MF,25-29,Midfielder,England,Europe
2825,Magnus Warming,DEN,Torino,Serie A,2021,21.0,2000.0,0.6,1,1,0,1,0,0,0,,0,2,0,2,0,1,0,0,"MF,FW",20-24,Midfielder,Denmark,Europe
2826,Daniel Wass,DEN,Atlético Madrid,La Liga,2021,32.0,1989.0,0.5,0,0,0,0,0,0,0,,0,0,0,0,0,0,3,0,"DF,FW",30-34,Defender,Denmark,Europe
2827,Daniel Wass,DEN,Valencia,La Liga,2021,32.0,1989.0,17.6,23,13,6,14,3,8,31,25.8,23,13,2,11,13,36,19,0,MF,30-34,Midfielder,Denmark,Europe
2828,Ollie Watkins,ENG,Aston Villa,Premier League,2021,25.0,1995.0,32.8,17,13,2,7,8,2,15,13.3,13,25,3,22,12,29,27,0,FW,25-29,Forward,England,Europe
2829,Timothy Weah,USA,Lille,Ligue 1,2021,21.0,2000.0,18.0,19,7,8,8,3,10,20,50.0,10,16,1,15,10,29,7,0,"MF,FW",20-24,Midfielder,United States,North America
2830,Adam Webster,ENG,Brighton,Premier League,2021,26.0,1995.0,15.9,26,8,17,7,2,13,20,65.0,7,25,17,8,17,43,66,2,DF,25-29,Defender,England,Europe
2831,Wout Weghorst,NED,Burnley,Premier League,2021,28.0,1992.0,16.1,17,9,3,9,5,6,19,31.6,13,16,5,11,6,23,13,0,FW,25-29,Forward,Netherlands,Europe
2832,Wout Weghorst,NED,Wolfsburg,Bundesliga,2021,28.0,1992.0,17.3,13,7,3,3,7,7,17,41.2,10,10,3,7,2,15,11,1,FW,25-29,Forward,Netherlands,Europe
2833,Noah Weißhaupt,GER,Freiburg,Bundesliga,2021,19.0,2001.0,1.1,1,1,1,0,0,1,2,50.0,1,2,0,2,1,2,1,1,"MF,FW",Under 20,Midfielder,Germany,Europe
2834,Danny Welbeck,ENG,Brighton,Premier League,2021,30.0,1990.0,16.4,14,7,2,8,4,3,10,30.0,7,18,2,16,5,19,18,0,"FW,MF",30-34,Forward,England,Europe
2835,Timo Werner,GER,Chelsea,Premier League,2021,25.0,1996.0,14.3,8,4,3,3,2,2,20,10.0,18,9,0,9,2,10,4,0,"FW,MF",25-29,Forward,Germany,Europe
2836,Ashley Westwood,ENG,Burnley,Premier League,2021,31.0,1990.0,25.4,21,12,8,12,1,10,31,32.3,21,21,9,12,30,51,16,1,MF,30-34,Midfielder,England,Europe
2837,Ben White,ENG,Arsenal,Premier League,2021,23.0,1997.0,32.0,44,23,30,8,6,28,45,62.2,17,42,24,18,42,86,102,0,DF,20-24,Defender,England,Europe
2838,Silvan Widmer,SUI,Mainz 05,Bundesliga,2021,28.0,1993.0,32.4,60,28,32,20,8,36,61,59.0,25,44,16,28,43,103,59,2,DF,25-29,Defender,Switzerland,Europe
2839,Georginio Wijnaldum,NED,Paris S-G,Ligue 1,2021,30.0,1990.0,18.4,15,9,2,12,1,11,19,57.9,8,13,3,10,9,24,7,0,MF,30-34,Midfielder,Netherlands,Europe
2840,Jetro Willems,NED,Greuther Fürth,Bundesliga,2021,27.0,1994.0,17.8,30,15,18,10,2,15,26,57.7,11,15,3,12,14,44,42,0,DF,25-29,Defender,Netherlands,Europe
2841,Brandon Williams,ENG,Norwich City,Premier League,2021,20.0,2000.0,23.6,55,37,35,18,2,36,64,56.3,28,26,6,20,44,99,50,0,DF,20-24,Defender,England,Europe
2842,Iñaki Williams,GHA,Athletic Club,La Liga,2021,27.0,1994.0,30.9,14,5,1,6,7,5,17,29.4,12,18,3,15,3,17,20,0,FW,25-29,Forward,Ghana,Africa
2843,Neco Williams,WAL,Liverpool,Premier League,2021,20.0,2001.0,0.1,0,0,0,0,0,0,0,,0,0,0,0,0,0,0,0,DF,20-24,Defender,Wales,Europe
2845,Joe Willock,ENG,Newcastle Utd,Premier League,2021,21.0,1999.0,22.6,64,37,30,28,6,29,68,42.6,39,37,6,31,21,85,10,1,MF,20-24,Midfielder,England,Europe
2846,Callum Wilson,ENG,Newcastle Utd,Premier League,2021,29.0,1992.0,15.4,9,8,1,5,3,1,4,25.0,3,7,2,5,3,12,10,0,FW,25-29,Forward,England,Europe
2846,Callum Wilson,ENG,Newcastle Utd,Premier League,2021,29.0,1992.0,15.4,9,8,1,5,3,1,4,25.0,3,7,2,5,3,12,10,0,FW,25-29,Forward,England,Europe
2846,Callum Wilson,ENG,Newcastle Utd,Premier League,2021,29.0,1992.0,15.4,9,8,1,5,3,1,4,25.0,3,7,2,5,3,12,10,0,FW,25-29,Forward,England,Europe
2846,Callum Wilson,ENG,Newcastle Utd,Premier League,2021,29.0,1992.0,15.4,9,8,1,5,3,1,4,25.0,3,7,2,5,3,12,10,0,FW,25-29,Forward,England,Europe
2847,Patrick Wimmer,AUT,Arminia,Bundesliga,2021,20.0,2001.0,22.8,53,31,13,31,9,22,61,36.1,39,30,1,29,27,80,13,0,"FW,MF",20-24,Forward,Austria,Europe
2848,Jonas Wind,DEN,Wolfsburg,Bundesliga,2021,22.0,1999.0,13.1,10,6,1,7,2,1,4,25.0,3,8,3,5,6,16,13,0,"FW,MF",20-24,Forward,Denmark,Europe
2849,Marten Winkler,GER,Hertha BSC,Bundesliga,2021,18.0,2002.0,0.3,0,0,0,0,0,0,0,,0,0,0,0,0,0,0,0,MF,Under 20,Midfielder,Germany,Europe
2850,Harry Winks,ENG,Tottenham,Premier League,2021,25.0,1996.0,10.1,15,10,4,9,2,8,21,38.1,13,14,3,11,16,31,10,2,MF,25-29,Midfielder,England,Europe
2851,Frederik Winther,DEN,Augsburg,Bundesliga,2021,20.0,2001.0,3.6,7,2,7,0,0,5,6,83.3,1,4,1,3,8,15,21,0,DF,20-24,Defender,Denmark,Europe
2852,Florian Wirtz,GER,Leverkusen,Bundesliga,2021,18.0,2003.0,20.6,25,10,6,16,3,10,28,35.7,18,12,1,11,13,38,4,0,"MF,FW",Under 20,Midfielder,Germany,Europe
2853,Yoane Wissa,COD,Brentford,Premier League,2021,24.0,1996.0,14.3,12,6,5,4,3,1,16,6.3,15,12,5,7,8,20,6,0,FW,20-24,Forward,DR Congo,Africa
2854,Axel Witsel,BEL,Dortmund,Bundesliga,2021,32.0,1989.0,21.6,42,27,12,23,7,18,30,60.0,12,24,9,15,27,69,38,0,"MF,DF",30-34,Midfielder,Belgium,Europe
2855,Hannes Wolf,AUT,Gladbach,Bundesliga,2021,22.0,1999.0,3.4,23,12,4,13,6,10,20,50.0,10,10,0,10,2,25,1,0,"FW,MF",20-24,Forward,Austria,Europe
2856,Marius Wolf,GER,Dortmund,Bundesliga,2021,26.0,1995.0,14.7,26,10,13,9,4,12,24,50.0,12,14,1,13,13,39,8,0,"DF,FW",25-29,Defender,Germany,Europe
2857,Luca Wollschläger,GER,Hertha BSC,Bundesliga,2021,18.0,2003.0,0.2,1,1,0,1,0,0,1,0.0,1,0,0,0,0,1,0,0,"FW,MF",Under 20,Forward,Germany,Europe
2858,Jeong Woo-yeong,KOR,Freiburg,Bundesliga,2021,21.0,1999.0,19.8,15,9,6,7,2,5,15,33.3,10,8,1,7,7,22,11,0,"FW,MF",20-24,Forward,South Korea,Asia
2859,Chris Wood,NZL,Burnley,Premier League,2021,29.0,1991.0,15.2,7,5,0,3,4,3,10,30.0,7,13,4,9,0,7,3,0,FW,25-29,Forward,New Zealand,Oceania
2860,Chris Wood,NZL,Newcastle Utd,Premier League,2021,29.0,1991.0,14.7,2,0,1,1,0,1,2,50.0,1,5,2,3,2,4,9,0,FW,25-29,Forward,New Zealand,Oceania
2861,Freddie Woodman,ENG,Newcastle Utd,Premier League,2021,24.0,1997.0,4.0,0,0,0,0,0,0,0,,0,0,0,0,0,0,0,1,GK,20-24,Goalkeeper,England,Europe
2862,Christopher Wooh,CMR,Lens,Ligue 1,2021,19.0,2001.0,11.7,29,11,20,8,1,11,18,61.1,7,21,14,7,21,50,40,1,DF,Under 20,Defender,Cameroon,Africa
2863,Joscha Wosz,GER,RB Leipzig,Bundesliga,2021,19.0,2002.0,0.1,0,0,0,0,0,0,0,,0,0,0,0,0,0,0,0,DF,Under 20,Defender,Germany,Europe
2864,Xeka,POR,Lille,Ligue 1,2021,26.0,1994.0,18.0,47,27,18,24,5,27,56,48.2,29,23,3,20,24,71,26,1,MF,25-29,Midfielder,Portugal,Europe
2865,Granit Xhaka,SUI,Arsenal,Premier League,2021,28.0,1992.0,25.9,32,18,16,12,4,16,41,39.0,25,21,6,15,21,53,31,0,"MF,DF",25-29,Midfielder,Switzerland,Europe
2866,Sekou Yansané,GUI,Paris S-G,Ligue 1,2021,18.0,2003.0,0.2,0,0,0,0,0,0,1,0.0,1,0,0,0,0,0,1,0,FW,Under 20,Forward,Guinea,Africa
2867,Andriy Yarmolenko,UKR,West Ham,Premier League,2021,31.0,1989.0,3.5,4,2,2,2,0,2,8,25.0,6,4,2,2,0,4,2,0,"FW,MF",30-34,Forward,Ukraine,Europe
2868,Yusuf Yazıcı,TUR,Lille,Ligue 1,2021,24.0,1997.0,5.7,10,5,3,6,1,1,9,11.1,8,4,0,4,2,12,1,0,"MF,FW",20-24,Midfielder,Turkey,Asia
2869,Kelvin Yeboah,ITA,Genoa,Serie A,2021,21.0,2000.0,9.4,14,7,5,7,2,9,19,47.4,10,22,1,21,1,15,7,0,"FW,MF",20-24,Forward,Italy,Europe
2871,Burak Yılmaz,TUR,Lille,Ligue 1,2021,36.0,1985.0,24.6,7,2,0,2,5,2,17,11.8,15,8,1,7,2,9,11,0,FW,35-39,Forward,Turkey,Asia
2872,Okay Yokuşlu,TUR,Getafe,La Liga,2021,27.0,1994.0,5.2,9,8,6,2,1,5,5,100.0,0,7,5,2,5,14,17,0,"DF,MF",25-29,Defender,Turkey,Asia
2873,Okay Yokuşlu,TUR,Celta Vigo,La Liga,2021,27.0,1994.0,1.6,4,1,2,1,1,2,3,66.7,1,2,1,1,2,6,6,0,"DF,MF",25-29,Defender,Turkey,Asia
2874,Leny Yoro,FRA,Lille,Ligue 1,2021,15.0,2005.0,0.1,1,0,0,1,0,0,0,,0,1,0,1,0,1,0,0,MF,Under 20,Midfielder,France,Europe
2875,Maya Yoshida,JPN,Sampdoria,Serie A,2021,32.0,1988.0,20.3,17,10,8,9,0,8,15,53.3,7,27,20,7,28,45,72,1,DF,30-34,Defender,Japan,Asia
2876,Ashley Young,ENG,Aston Villa,Premier League,2021,36.0,1985.0,13.9,18,6,9,6,3,11,16,68.8,5,10,4,6,13,31,25,1,"DF,FW",35-39,Defender,England,Europe
2877,Nathan Young-Coombes,ENG,Brentford,Premier League,2021,18.0,2003.0,0.0,0,0,0,0,0,0,0,,0,0,0,0,0,0,0,0,MF,Under 20,Midfielder,England,Europe
2879,Mattia Zaccagni,ITA,Hellas Verona,Serie A,2021,26.0,1995.0,2.0,3,1,1,0,2,1,2,50.0,1,1,0,1,4,7,0,0,MF,25-29,Midfielder,Italy,Europe
2880,Mattia Zaccagni,ITA,Lazio,Serie A,2021,26.0,1995.0,20.8,33,16,10,13,10,11,19,57.9,8,17,2,15,20,53,5,0,FW,25-29,Forward,Italy,Europe
2881,Dan-Axel Zagadou,FRA,Dortmund,Bundesliga,2021,22.0,1999.0,10.6,13,7,11,1,1,7,10,70.0,3,14,4,10,15,28,38,2,DF,20-24,Defender,France,Europe
2882,Wilfried Zaha,CIV,Crystal Palace,Premier League,2021,28.0,1992.0,30.7,40,20,14,15,11,10,31,32.3,21,28,0,28,5,45,5,0,FW,25-29,Forward,Ivory Coast,Africa
2883,Denis Zakaria,SUI,Juventus,Serie A,2021,24.0,1996.0,6.6,11,7,3,6,2,3,11,27.3,8,16,3,13,11,22,7,0,MF,20-24,Midfielder,Switzerland,Europe
2884,Denis Zakaria,SUI,Gladbach,Bundesliga,2021,24.0,1996.0,15.5,23,14,9,10,4,12,35,34.3,23,25,5,20,19,42,22,1,"MF,DF",20-24,Midfielder,Switzerland,Europe
2887,Andre-Frank Zambo Anguissa,CMR,Napoli,Serie A,2021,25.0,1995.0,21.4,50,26,24,17,9,25,51,49.0,26,31,5,26,24,74,33,1,MF,25-29,Midfielder,Cameroon,Africa
2888,Nicolò Zaniolo,ITA,Roma,Serie A,2021,22.0,1999.0,21.9,24,15,0,15,9,6,28,21.4,22,19,0,19,7,31,6,0,"FW,MF",20-24,Forward,Italy,Europe
2889,Alessandro Zanoli,ITA,Napoli,Serie A,2021,20.0,2000.0,5.1,10,7,6,3,1,3,5,60.0,2,2,1,1,4,14,16,0,DF,20-24,Defender,Italy,Europe
2890,Mattia Zanotti,ITA,Inter,Serie A,2021,18.0,2003.0,0.1,1,0,1,0,0,0,1,0.0,1,0,0,0,0,1,0,0,DF,Under 20,Defender,Italy,Europe
2891,Duván Zapata,COL,Atalanta,Serie A,2021,30.0,1991.0,19.1,6,2,0,4,2,4,8,50.0,4,8,1,7,3,9,5,0,FW,30-34,Forward,Colombia,South America
2892,Gabriele Zappa,ITA,Cagliari,Serie A,2021,21.0,1999.0,12.7,21,9,12,6,3,6,24,25.0,18,15,5,10,14,35,28,0,DF,20-24,Defender,Italy,Europe
2893,Davide Zappacosta,ITA,Atalanta,Serie A,2021,29.0,1992.0,26.1,32,22,12,13,7,19,37,51.4,18,32,2,30,12,44,22,0,DF,25-29,Defender,Italy,Europe
2895,Simone Zaza,ITA,Torino,Serie A,2021,30.0,1991.0,1.4,2,2,1,1,0,1,1,100.0,0,3,0,3,0,2,3,0,"FW,DF",30-34,Forward,Italy,Europe
2896,Akim Zedadka,ALG,Clermont Foot,Ligue 1,2021,26.0,1995.0,37.1,72,44,34,29,9,37,71,52.1,34,32,8,24,58,130,48,0,DF,25-29,Defender,Algeria,Africa
2897,Deyovaisio Zeefuik,NED,Hertha BSC,Bundesliga,2021,23.0,1998.0,6.3,11,10,6,4,1,6,12,50.0,6,12,4,8,11,22,21,1,DF,20-24,Defender,Netherlands,Europe
2898,Marvin Zeegelaar,NED,Udinese,Serie A,2021,30.0,1990.0,7.1,15,11,6,8,1,5,14,35.7,9,12,4,8,12,27,22,1,DF,30-34,Defender,Netherlands,Europe
2900,Robin Zentner,GER,Mainz 05,Bundesliga,2021,26.0,1994.0,32.0,2,2,2,0,0,2,2,100.0,0,0,0,0,2,4,21,1,GK,25-29,Goalkeeper,Germany,Europe
2901,Andi Zeqiri,SUI,Augsburg,Bundesliga,2021,22.0,1999.0,11.3,14,7,3,5,6,3,12,25.0,9,10,1,9,2,16,12,0,"FW,MF",20-24,Forward,Switzerland,Europe
2902,Mehdi Zerkane,ALG,Bordeaux,Ligue 1,2021,22.0,1999.0,0.9,0,0,0,0,0,0,1,0.0,1,1,1,0,2,2,0,0,"MF,DF",20-24,Midfielder,Algeria,Africa
2904,Luca Zidane,FRA,Rayo Vallecano,La Liga,2021,23.0,1998.0,7.2,0,0,0,0,0,0,1,0.0,1,0,0,0,0,0,1,1,GK,20-24,Goalkeeper,France,Europe
2907,Christoph Zimmermann,GER,Norwich City,Premier League,2021,28.0,1993.0,1.7,6,3,5,1,0,3,4,75.0,1,0,0,0,1,7,4,0,DF,25-29,Defender,Germany,Europe
2908,Oleksandr Zinchenko,UKR,Manchester City,Premier League,2021,24.0,1996.0,11.6,20,14,7,10,3,11,20,55.0,9,11,3,8,14,34,15,1,DF,20-24,Defender,Ukraine,Europe
2909,Hakim Ziyech,MAR,Chelsea,Premier League,2021,28.0,1993.0,14.7,19,10,5,12,2,10,36,27.8,26,11,1,10,10,29,10,0,"MF,FW",25-29,Midfielder,Morocco,Africa
2910,Jeroen Zoet,NED,Spezia,Serie A,2021,30.0,1991.0,7.0,1,0,1,0,0,1,1,100.0,0,0,0,0,0,1,4,0,GK,30-34,Goalkeeper,Netherlands,Europe
2911,Simon Zoller,GER,Bochum,Bundesliga,2021,30.0,1991.0,6.6,4,2,2,1,1,1,3,33.3,2,3,0,3,4,8,2,0,FW,30-34,Forward,Germany,Europe
2912,Nadir Zortea,ITA,Salernitana,Serie A,2021,22.0,1999.0,15.7,21,15,9,7,5,11,19,57.9,8,14,2,12,7,28,33,0,"DF,MF",20-24,Defender,Italy,Europe
2913,Tanguy Zoukrou,FRA,Troyes,Ligue 1,2021,18.0,2003.0,0.9,1,0,1,0,0,1,2,50.0,1,0,0,0,0,1,2,0,DF,Under 20,Defender,France,Europe
2914,Kurt Zouma,FRA,West Ham,Premier League,2021,26.0,1994.0,23.1,11,6,8,3,0,4,7,57.1,3,31,26,5,34,45,132,0,DF,25-29,Defender,France,Europe
2915,Petar Zovko,BIH,Spezia,Serie A,2021,19.0,2002.0,0.3,0,0,0,0,0,0,0,,0,0,0,0,0,0,1,0,GK,Under 20,Goalkeeper,Bosnia and Herzegovina,Europe
2920,Milan Đurić,BIH,Salernitana,Serie A,2021,31.0,1990.0,24.1,1,1,0,1,0,1,3,33.3,2,6,1,5,2,3,32,0,FW,30-34,Forward,Bosnia and Herzegovina,Europe
2053,Patric,ESP,Lazio,Serie A,2021,28.0,1993.0,18.3,21,15,17,4,0,9,20,45.0,11,22,11,11,12,33,44,2,DF,25-29,Defender,Spain,Europe
2058,Strahinja Pavlović,SRB,Monaco,Ligue 1,2021,20.0,2001.0,5.0,23,16,8,13,2,8,12,66.7,4,5,3,2,9,32,15,0,DF,20-24,Defender,Serbia,Europe
2062,Alfonso Pedraza,ESP,Villarreal,La Liga,2021,25.0,1996.0,18.9,34,16,17,12,5,10,28,35.7,18,12,3,9,31,65,32,0,DF,25-29,Defender,Spain,Europe
2063,Pedri,ESP,Barcelona,La Liga,2021,18.0,2002.0,9.8,20,12,9,8,3,7,20,35.0,13,13,0,13,5,25,7,1,MF,Under 20,Midfielder,Spain,Europe
2064,Pedro,ESP,Lazio,Serie A,2021,34.0,1987.0,22.6,36,23,8,19,9,16,47,34.0,31,18,2,16,6,42,8,0,FW,30-34,Forward,Spain,Europe
2064,Pedro,ESP,Lazio,Serie A,2021,34.0,1987.0,22.6,36,23,8,19,9,16,47,34.0,31,18,2,16,6,42,8,0,FW,30-34,Forward,Spain,Europe
2064,Pedro,ESP,Lazio,Serie A,2021,34.0,1987.0,22.6,36,23,8,19,9,16,47,34.0,31,18,2,16,6,42,8,0,FW,30-34,Forward,Spain,Europe
2064,Pedro,ESP,Lazio,Serie A,2021,34.0,1987.0,22.6,36,23,8,19,9,16,47,34.0,31,18,2,16,6,42,8,0,FW,30-34,Forward,Spain,Europe
2064,Pedro,ESP,Lazio,Serie A,2021,34.0,1987.0,22.6,36,23,8,19,9,16,47,34.0,31,18,2,16,6,42,8,0,FW,30-34,Forward,Spain,Europe
2064,Pedro,ESP,Lazio,Serie A,2021,34.0,1987.0,22.6,36,23,8,19,9,16,47,34.0,31,18,2,16,6,42,8,0,FW,30-34,Forward,Spain,Europe
2064,Pedro,ESP,Lazio,Serie A,2021,34.0,1987.0,22.6,36,23,8,19,9,16,47,34.0,31,18,2,16,6,42,8,0,FW,30-34,Forward,Spain,Europe
2064,Pedro,ESP,Lazio,Serie A,2021,34.0,1987.0,22.6,36,23,8,19,9,16,47,34.0,31,18,2,16,6,42,8,0,FW,30-34,Forward,Spain,Europe
2064,Pedro,ESP,Lazio,Serie A,2021,34.0,1987.0,22.6,36,23,8,19,9,16,47,34.0,31,18,2,16,6,42,8,0,FW,30-34,Forward,Spain,Europe
2064,Pedro,ESP,Lazio,Serie A,2021,34.0,1987.0,22.6,36,23,8,19,9,16,47,34.0,31,18,2,16,6,42,8,0,FW,30-34,Forward,Spain,Europe
2064,Pedro,ESP,Lazio,Serie A,2021,34.0,1987.0,22.6,36,23,8,19,9,16,47,34.0,31,18,2,16,6,42,8,0,FW,30-34,Forward,Spain,Europe
2064,Pedro,ESP,Lazio,Serie A,2021,34.0,1987.0,22.6,36,23,8,19,9,16,47,34.0,31,18,2,16,6,42,8,0,FW,30-34,Forward,Spain,Europe
2064,Pedro,ESP,Lazio,Serie A,2021,34.0,1987.0,22.6,36,23,8,19,9,16,47,34.0,31,18,2,16,6,42,8,0,FW,30-34,Forward,Spain,Europe
2064,Pedro,ESP,Lazio,Serie A,2021,34.0,1987.0,22.6,36,23,8,19,9,16,47,34.0,31,18,2,16,6,42,8,0,FW,30-34,Forward,Spain,Europe
2064,Pedro,ESP,Lazio,Serie A,2021,34.0,1987.0,22.6,36,23,8,19,9,16,47,34.0,31,18,2,16,6,42,8,0,FW,30-34,Forward,Spain,Europe
2064,Pedro,ESP,Lazio,Serie A,2021,34.0,1987.0,22.6,36,23,8,19,9,16,47,34.0,31,18,2,16,6,42,8,0,FW,30-34,Forward,Spain,Europe
2066,Adrià Pedrosa,ESP,Espanyol,La Liga,2021,23.0,1998.0,30.2,58,30,38,14,6,26,57,45.6,31,25,7,18,25,83,92,2,DF,20-24,Defender,Spain,Europe
2076,Rubén Peña,ESP,Villarreal,La Liga,2021,30.0,1991.0,1.5,2,0,1,1,0,2,6,33.3,4,1,0,1,5,7,2,0,"MF,FW",30-34,Midfielder,Spain,Europe
2080,Alberto Perea,ESP,Cádiz,La Liga,2021,30.0,1990.0,8.6,19,9,7,9,3,6,20,30.0,14,15,1,14,9,28,4,0,MF,30-34,Midfielder,Spain,Europe
2089,Ayoze Pérez,ESP,Leicester City,Premier League,2021,28.0,1993.0,4.9,4,2,0,3,1,0,13,0.0,13,11,1,10,2,6,5,0,"MF,FW",25-29,Midfielder,Spain,Europe
2090,Carles Pérez,ESP,Roma,Serie A,2021,23.0,1998.0,6.2,8,3,3,1,4,3,12,25.0,9,10,0,10,2,10,2,0,"MF,FW",20-24,Midfielder,Spain,Europe
2091,Iñigo Pérez,ESP,Osasuna,La Liga,2021,33.0,1988.0,3.8,3,2,2,1,0,2,4,50.0,2,1,0,1,0,3,3,0,MF,30-34,Midfielder,Spain,Europe
2092,Juan Pérez,ESP,Osasuna,La Liga,2021,25.0,1996.0,2.0,0,0,0,0,0,0,1,0.0,1,0,0,0,0,0,1,1,GK,25-29,Goalkeeper,Spain,Europe
2093,Kike Pérez,ESP,Elche,La Liga,2021,24.0,1997.0,5.8,8,6,1,3,4,0,10,0.0,10,6,1,5,3,11,4,0,"MF,FW",20-24,Midfielder,Spain,Europe
2094,Lucas Pérez,ESP,Elche,La Liga,2021,32.0,1988.0,14.1,4,1,2,1,1,3,10,30.0,7,2,0,2,3,7,4,0,FW,30-34,Forward,Spain,Europe
2095,Lucas Pérez,ESP,Cádiz,La Liga,2021,32.0,1988.0,11.8,3,3,2,1,0,0,10,0.0,10,3,1,2,0,3,1,0,"FW,MF",30-34,Forward,Spain,Europe
2110,Njegoš Petrović,SRB,Granada,La Liga,2021,22.0,1999.0,10.2,24,11,4,19,1,8,14,57.1,6,16,4,12,9,33,11,0,MF,20-24,Midfielder,Serbia,Europe
2111,Jens Petter Hauge,NOR,Eint Frankfurt,Bundesliga,2021,21.0,1999.0,11.6,14,5,6,7,1,7,23,30.4,16,7,0,7,3,17,5,0,"MF,FW",20-24,Midfielder,Norway,Europe
2112,Alex Petxa,ESP,Athletic Club,La Liga,2021,24.0,1997.0,4.6,12,9,4,7,1,4,8,50.0,4,8,2,6,4,16,6,0,"DF,MF",20-24,Defender,Spain,Europe
2121,Krzysztof Piątek,POL,Fiorentina,Serie A,2021,26.0,1995.0,8.1,5,4,1,1,3,2,3,66.7,1,6,0,6,2,7,8,0,FW,25-29,Forward,Poland,Europe
2122,Krzysztof Piątek,POL,Hertha BSC,Bundesliga,2021,26.0,1995.0,3.9,2,2,0,1,1,0,1,0.0,1,0,0,0,0,2,6,0,FW,25-29,Forward,Poland,Europe
2132,Tomás Pina Isla,ESP,Alavés,La Liga,2021,33.0,1987.0,16.0,28,16,13,11,4,14,29,48.3,15,12,3,9,22,50,23,0,MF,30-34,Midfielder,Spain,Europe
2136,Yeremi Pino,ESP,Villarreal,La Liga,2021,18.0,2002.0,18.6,32,14,14,8,10,10,24,41.7,14,33,4,29,6,38,12,1,"MF,FW",Under 20,Midfielder,Spain,Europe
2139,Gerard Piqué,ESP,Barcelona,La Liga,2021,34.0,1987.0,23.2,22,12,18,4,0,11,14,78.6,3,19,16,3,34,56,86,1,DF,30-34,Defender,Spain,Europe
2153,Pere Pons,ESP,Alavés,La Liga,2021,28.0,1993.0,15.2,26,18,4,20,2,7,21,33.3,14,10,1,9,6,32,11,0,MF,25-29,Midfielder,Spain,Europe
2156,Portu,ESP,Real Sociedad,La Liga,2021,29.0,1992.0,17.7,16,7,2,6,8,3,19,15.8,16,21,3,18,7,23,8,0,"FW,MF",25-29,Forward,Spain,Europe
2158,Sergio Postigo,ESP,Levante,La Liga,2021,32.0,1988.0,9.4,11,7,8,2,1,4,8,50.0,4,7,5,2,7,18,45,1,DF,30-34,Defender,Spain,Europe
2161,Darío Poveda,ESP,Getafe,La Liga,2021,24.0,1997.0,4.2,2,0,1,0,1,0,5,0.0,5,7,1,6,1,3,1,0,"FW,MF",20-24,Forward,Spain,Europe
2162,José Pozo,ESP,Rayo Vallecano,La Liga,2021,25.0,1996.0,0.8,2,2,0,2,0,2,3,66.7,1,1,0,1,0,2,1,0,"MF,DF",25-29,Midfielder,Spain,Europe
2164,Mateusz Praszelik,POL,Hellas Verona,Serie A,2021,20.0,2000.0,0.3,0,0,0,0,0,0,0,,0,0,0,0,0,0,0,0,MF,20-24,Midfielder,Poland,Europe
2165,Abdón Prats,ESP,Mallorca,La Liga,2021,28.0,1992.0,7.1,2,2,1,0,1,1,5,20.0,4,5,0,5,1,3,6,0,FW,25-29,Forward,Spain,Europe
2168,Isaac Price,NIR,Everton,Premier League,2021,17.0,2003.0,0.2,0,0,0,0,0,0,0,,0,1,0,1,0,0,0,0,MF,Under 20,Midfielder,Northern Ireland,Europe
2170,Alejandro Primo,ESP,Levante,La Liga,2021,17.0,2004.0,1.0,0,0,0,0,0,0,0,,0,0,0,0,0,0,0,0,GK,Under 20,Goalkeeper,Spain,Europe
2174,Javi Puado,ESP,Espanyol,La Liga,2021,23.0,1998.0,24.9,24,14,18,5,1,12,37,32.4,25,18,2,16,11,35,24,0,"MF,FW",20-24,Midfielder,Spain,Europe
2175,Marc Pubill,ESP,Levante,La Liga,2021,18.0,2003.0,5.7,12,6,10,2,0,4,8,50.0,4,7,2,5,4,16,8,2,"DF,MF",Under 20,Defender,Spain,Europe
2176,Antonio Puertas,ESP,Granada,La Liga,2021,29.0,1992.0,25.1,34,20,18,12,4,17,44,38.6,27,33,3,30,11,45,36,0,"MF,FW",25-29,Midfielder,Spain,Europe
2177,Riqui Puig,ESP,Barcelona,La Liga,2021,21.0,1999.0,5.4,6,3,2,4,0,2,14,14.3,12,5,0,5,3,9,0,0,MF,20-24,Midfielder,Spain,Europe
2184,Przemysław Płacheta,POL,Norwich City,Premier League,2021,23.0,1998.0,5.6,4,3,3,1,0,2,7,28.6,5,3,1,2,2,6,5,1,"FW,MF",20-24,Forward,Poland,Europe
2187,Quini,ESP,Granada,La Liga,2021,31.0,1989.0,25.6,73,34,48,21,4,42,79,53.2,37,28,10,18,36,109,62,0,DF,30-34,Defender,Spain,Europe
2188,Dani Raba,ESP,Villarreal,La Liga,2021,25.0,1995.0,1.0,1,0,0,1,0,1,2,50.0,1,2,0,2,0,1,2,0,"MF,FW",25-29,Midfielder,Spain,Europe
2189,Dani Raba,ESP,Granada,La Liga,2021,25.0,1995.0,0.3,2,2,1,0,1,2,3,66.7,1,0,0,0,1,3,0,0,"MF,FW",25-29,Midfielder,Spain,Europe
2191,Uroš Račić,SRB,Valencia,La Liga,2021,23.0,1998.0,13.4,32,18,9,19,4,12,33,36.4,21,16,6,10,16,48,21,0,MF,20-24,Midfielder,Serbia,Europe
2192,Nemanja Radoja,SRB,Levante,La Liga,2021,28.0,1993.0,13.5,25,8,9,13,3,8,20,40.0,12,16,9,7,22,47,16,2,MF,25-29,Midfielder,Serbia,Europe
2193,Nemanja Radonjić,SRB,Marseille,Ligue 1,2021,25.0,1996.0,0.2,0,0,0,0,0,0,0,,0,0,0,0,0,0,0,0,FW,25-29,Forward,Serbia,Europe
2194,Ivan Radovanović,SRB,Salernitana,Serie A,2021,32.0,1988.0,11.7,11,7,8,3,0,7,19,36.8,12,14,7,7,7,18,29,0,"DF,MF",30-34,Defender,Serbia,Europe
2197,Boris Radunović,SRB,Cagliari,Serie A,2021,25.0,1996.0,3.0,0,0,0,0,0,0,0,,0,0,0,0,0,0,0,0,GK,25-29,Goalkeeper,Serbia,Europe
2201,Antonio Raillo,ESP,Mallorca,La Liga,2021,29.0,1991.0,17.0,16,7,10,4,2,5,6,83.3,1,17,14,3,18,34,81,0,DF,25-29,Defender,Spain,Europe
2203,Predrag Rajković,SRB,Reims,Ligue 1,2021,25.0,1995.0,38.0,2,2,2,0,0,2,3,66.7,1,1,0,1,1,3,21,1,GK,25-29,Goalkeeper,Serbia,Europe
2207,Jonás Ramalho,ESP,Osasuna,La Liga,2021,28.0,1993.0,2.7,4,2,2,2,0,2,3,66.7,1,4,1,3,3,7,9,0,DF,25-29,Defender,Spain,Europe
2209,Sandro Ramírez,ESP,Getafe,La Liga,2021,26.0,1995.0,16.2,7,3,1,3,3,1,12,8.3,11,14,3,11,2,9,3,0,FW,25-29,Forward,Spain,Europe
2211,Sergio Ramos,ESP,Paris S-G,Ligue 1,2021,35.0,1986.0,8.9,12,5,6,6,0,8,15,53.3,7,4,2,2,8,20,27,0,DF,35-39,Defender,Spain,Europe
2223,Raúl,ESP,Betis,La Liga,2021,20.0,2000.0,0.0,0,0,0,0,0,0,0,,0,0,0,0,0,0,0,0,"FW,DF",20-24,Forward,Spain,Europe
2226,David Raya,ESP,Brentford,Premier League,2021,25.0,1995.0,24.0,0,0,0,0,0,0,0,,0,1,0,1,0,0,10,1,GK,25-29,Goalkeeper,Spain,Europe
2228,Arkadiusz Reca,POL,Spezia,Serie A,2021,26.0,1995.0,19.7,31,19,21,3,7,20,30,66.7,10,20,7,13,32,63,47,2,DF,25-29,Defender,Poland,Europe
2229,Lluís Recasens,ESP,Espanyol,La Liga,2021,19.0,2002.0,0.5,2,0,2,0,0,1,1,100.0,0,0,0,0,2,4,2,0,DF,Under 20,Defender,Spain,Europe
2231,Sergio Reguilón,ESP,Tottenham,Premier League,2021,24.0,1996.0,21.3,40,24,15,18,7,22,43,51.2,21,20,8,12,31,71,45,1,"DF,MF",20-24,Defender,Spain,Europe
2232,Manolo Reina,ESP,Mallorca,La Liga,2021,36.0,1985.0,21.0,0,0,0,0,0,0,0,,0,0,0,0,1,1,6,2,GK,35-39,Goalkeeper,Spain,Europe
2233,Pepe Reina,ESP,Lazio,Serie A,2021,38.0,1982.0,15.0,0,0,0,0,0,0,1,0.0,1,0,0,0,0,0,1,1,GK,35-39,Goalkeeper,Spain,Europe
2237,Álex Remiro,ESP,Real Sociedad,La Liga,2021,26.0,1995.0,35.0,0,0,0,0,0,0,0,,0,0,0,0,1,1,24,2,GK,25-29,Goalkeeper,Spain,Europe
2244,Nico Ribaudo,ESP,Espanyol,La Liga,2021,20.0,2001.0,12.4,15,6,9,5,1,11,34,32.4,23,14,2,12,7,22,3,0,"MF,FW",20-24,Midfielder,Spain,Europe
2256,Diego Rico,ESP,Real Sociedad,La Liga,2021,28.0,1993.0,18.3,41,20,19,17,5,22,45,48.9,23,29,4,25,30,71,54,0,DF,25-29,Defender,Spain,Europe
2257,Sergio Rico,ESP,Mallorca,La Liga,2021,27.0,1993.0,14.0,0,0,0,0,0,0,0,,0,0,0,0,0,0,5,2,GK,25-29,Goalkeeper,Spain,Europe
2258,Sergio Rico,ESP,Paris S-G,Ligue 1,2021,27.0,1993.0,0.3,0,0,0,0,0,0,0,,0,0,0,0,0,0,1,0,GK,25-29,Goalkeeper,Spain,Europe
2263,Luis Rioja,ESP,Alavés,La Liga,2021,27.0,1993.0,34.6,28,15,11,10,7,14,58,24.1,44,22,1,21,25,53,20,0,"MF,FW",25-29,Midfielder,Spain,Europe
2265,Mihailo Ristić,SRB,Montpellier,Ligue 1,2021,25.0,1995.0,20.0,44,32,26,16,2,25,43,58.1,18,16,6,10,17,61,48,0,DF,25-29,Defender,Serbia,Europe
2268,Rober,ESP,Levante,La Liga,2021,26.0,1995.0,22.3,36,20,27,7,2,23,39,59.0,16,25,15,10,30,66,90,1,DF,25-29,Defender,Spain,Europe
2269,Sergi Roberto,ESP,Barcelona,La Liga,2021,29.0,1992.0,4.4,5,1,2,3,0,3,5,60.0,2,2,0,2,4,9,6,0,"MF,DF",25-29,Midfielder,Spain,Europe
2274,Marc Roca,ESP,Bayern Munich,Bundesliga,2021,24.0,1996.0,4.2,9,7,2,4,3,2,8,25.0,6,6,0,6,6,15,4,0,MF,20-24,Midfielder,Spain,Europe
2275,Rubén Rochina,ESP,Granada,La Liga,2021,30.0,1991.0,8.3,21,13,7,8,6,8,28,28.6,20,11,1,10,6,27,5,1,"MF,FW",30-34,Midfielder,Spain,Europe
2278,Stian Rode Gregersen,NOR,Bordeaux,Ligue 1,2021,26.0,1995.0,21.7,39,26,23,12,4,18,33,54.5,15,26,16,10,38,77,103,2,DF,25-29,Defender,Norway,Europe
2281,Rodri,ESP,Manchester City,Premier League,2021,25.0,1996.0,32.0,72,43,24,38,10,32,59,54.2,27,28,5,23,28,100,45,0,MF,25-29,Midfielder,Spain,Europe
2281,Rodri,ESP,Manchester City,Premier League,2021,25.0,1996.0,32.0,72,43,24,38,10,32,59,54.2,27,28,5,23,28,100,45,0,MF,25-29,Midfielder,Spain,Europe
2281,Rodri,ESP,Manchester City,Premier League,2021,25.0,1996.0,32.0,72,43,24,38,10,32,59,54.2,27,28,5,23,28,100,45,0,MF,25-29,Midfielder,Spain,Europe
2281,Rodri,ESP,Manchester City,Premier League,2021,25.0,1996.0,32.0,72,43,24,38,10,32,59,54.2,27,28,5,23,28,100,45,0,MF,25-29,Midfielder,Spain,Europe
2282,Rodri,ESP,Betis,La Liga,2021,21.0,2000.0,9.8,10,7,4,5,1,5,22,22.7,17,11,0,11,3,13,4,0,FW,20-24,Forward,Spain,Europe
2282,Rodri,ESP,Betis,La Liga,2021,21.0,2000.0,9.8,10,7,4,5,1,5,22,22.7,17,11,0,11,3,13,4,0,FW,20-24,Forward,Spain,Europe
2282,Rodri,ESP,Betis,La Liga,2021,21.0,2000.0,9.8,10,7,4,5,1,5,22,22.7,17,11,0,11,3,13,4,0,FW,20-24,Forward,Spain,Europe
2282,Rodri,ESP,Betis,La Liga,2021,21.0,2000.0,9.8,10,7,4,5,1,5,22,22.7,17,11,0,11,3,13,4,0,FW,20-24,Forward,Spain,Europe
2283,Rodrigo,ESP,Leeds United,Premier League,2021,30.0,1991.0,25.2,20,9,7,6,7,4,32,12.5,28,12,0,12,11,31,27,1,"MF,FW",30-34,Midfielder,Spain,Europe
2286,Ángel Rodríguez,ESP,Mallorca,La Liga,2021,34.0,1987.0,17.2,15,9,6,7,2,4,21,19.0,17,15,1,14,3,18,13,0,"FW,MF",30-34,Forward,Spain,Europe
2287,Óscar Rodríguez Arnaiz,ESP,Getafe,La Liga,2021,23.0,1998.0,10.5,16,11,6,8,2,4,12,33.3,8,7,1,6,11,27,6,0,"MF,FW",20-24,Midfielder,Spain,Europe
2288,Óscar Rodríguez Arnaiz,ESP,Sevilla,La Liga,2021,23.0,1998.0,4.6,4,3,1,3,0,2,3,66.7,1,2,0,2,5,9,7,1,"FW,MF",20-24,Forward,Spain,Europe
2289,Dani Rodríguez,ESP,Mallorca,La Liga,2021,33.0,1988.0,31.5,53,31,20,24,9,15,46,32.6,31,28,3,25,20,73,27,0,"MF,FW",30-34,Midfielder,Spain,Europe
2289,Dani Rodríguez,ESP,Mallorca,La Liga,2021,33.0,1988.0,31.5,53,31,20,24,9,15,46,32.6,31,28,3,25,20,73,27,0,"MF,FW",30-34,Midfielder,Spain,Europe
2289,Dani Rodríguez,ESP,Mallorca,La Liga,2021,33.0,1988.0,31.5,53,31,20,24,9,15,46,32.6,31,28,3,25,20,73,27,0,"MF,FW",30-34,Midfielder,Spain,Europe
2289,Dani Rodríguez,ESP,Mallorca,La Liga,2021,33.0,1988.0,31.5,53,31,20,24,9,15,46,32.6,31,28,3,25,20,73,27,0,"MF,FW",30-34,Midfielder,Spain,Europe
2299,Leo Román,ESP,Mallorca,La Liga,2021,21.0,2000.0,2.0,0,0,0,0,0,0,0,,0,0,0,0,0,0,2,0,GK,20-24,Goalkeeper,Spain,Europe
2301,Iván Romero,ESP,Sevilla,La Liga,2021,20.0,2001.0,2.0,2,2,0,2,0,0,0,,0,1,0,1,2,4,0,0,FW,20-24,Forward,Spain,Europe
2304,Oriol Romeu,ESP,Southampton,Premier League,2021,29.0,1991.0,32.1,77,39,25,45,7,28,73,38.4,45,39,8,31,51,128,43,0,MF,25-29,Midfielder,Spain,Europe
2310,Unai Ropero,ESP,Alavés,La Liga,2021,19.0,2001.0,0.1,0,0,0,0,0,0,0,,0,0,0,0,1,1,0,0,MF,Under 20,Midfielder,Spain,Europe
2321,Rubén,ESP,Espanyol,La Liga,2021,20.0,2001.0,1.7,6,1,4,2,0,4,7,57.1,3,0,0,0,2,8,4,0,DF,20-24,Defender,Spain,Europe
2328,Aitor Ruibal,ESP,Betis,La Liga,2021,25.0,1996.0,9.5,21,15,13,3,5,10,34,29.4,24,8,0,8,8,29,6,0,"FW,DF",25-29,Forward,Spain,Europe
2329,Isma Ruiz,ESP,Granada,La Liga,2021,20.0,2001.0,3.1,3,1,3,0,0,1,9,11.1,8,5,2,3,3,6,2,0,MF,20-24,Midfielder,Spain,Europe
2330,Fabián Ruiz Peña,ESP,Napoli,Serie A,2021,25.0,1996.0,26.5,55,33,22,29,4,29,67,43.3,38,34,1,33,22,77,32,0,MF,25-29,Midfielder,Spain,Europe
2331,Víctor Ruiz,ESP,Betis,La Liga,2021,32.0,1989.0,15.8,11,9,7,2,2,6,9,66.7,3,18,13,5,29,40,71,1,DF,30-34,Defender,Spain,Europe
2338,Julian Ryerson,NOR,Union Berlin,Bundesliga,2021,23.0,1997.0,15.9,27,15,11,12,4,17,25,68.0,8,12,4,8,16,43,32,0,DF,20-24,Defender,Norway,Europe
2350,Rafiki Said,COM,Brest,Ligue 1,2021,21.0,2000.0,1.4,4,3,1,2,1,3,4,75.0,1,2,0,2,0,4,0,0,"MF,FW",20-24,Midfielder,Comoros,Africa
2365,Salvi,ESP,Cádiz,La Liga,2021,30.0,1991.0,15.5,20,10,9,8,3,8,20,40.0,12,17,2,15,6,26,11,0,"MF,FW",30-34,Midfielder,Spain,Europe
2366,Lazar Samardzic,SRB,Udinese,Serie A,2021,19.0,2002.0,5.4,13,9,4,7,2,7,26,26.9,19,6,0,6,2,15,2,0,"MF,FW",Under 20,Midfielder,Serbia,Europe
2372,Fede San Emeterio,ESP,Cádiz,La Liga,2021,24.0,1997.0,9.2,16,5,5,8,3,5,15,33.3,10,5,0,5,8,24,6,0,MF,20-24,Midfielder,Spain,Europe
2374,Oihan Sancet,ESP,Athletic Club,La Liga,2021,21.0,2000.0,15.8,12,7,2,8,2,5,20,25.0,15,2,0,2,5,17,13,0,FW,20-24,Forward,Spain,Europe
2377,Antonio Sánchez,ESP,Mallorca,La Liga,2021,24.0,1997.0,18.0,53,24,29,17,7,19,49,38.8,30,32,2,30,32,85,32,1,"MF,FW",20-24,Midfielder,Spain,Europe
2379,Germán Sánchez,ESP,Granada,La Liga,2021,34.0,1986.0,25.5,27,19,18,9,0,11,20,55.0,9,19,16,3,28,55,137,0,DF,30-34,Defender,Spain,Europe
2380,Manu Sánchez,ESP,Osasuna,La Liga,2021,20.0,2000.0,25.1,72,34,41,22,9,43,79,54.4,36,28,3,25,18,90,43,0,DF,20-24,Defender,Spain,Europe
2381,Robert Sánchez,ESP,Brighton,Premier League,2021,23.0,1997.0,37.0,2,1,2,0,0,1,1,100.0,0,1,0,1,0,2,11,4,GK,20-24,Goalkeeper,Spain,Europe
2386,Oier Sanjurjo,ESP,Osasuna,La Liga,2021,35.0,1986.0,8.4,10,6,3,7,0,2,19,10.5,17,8,3,5,1,11,9,0,MF,35-39,Midfielder,Spain,Europe
2393,Jesús Santiago,ESP,Valencia,La Liga,2021,17.0,2004.0,0.9,2,2,1,1,0,0,2,0.0,2,1,0,1,0,2,1,0,MF,Under 20,Midfielder,Spain,Europe
2396,Sergio Santos,ESP,Real Madrid,La Liga,2021,20.0,2001.0,0.1,0,0,0,0,0,0,0,,0,0,0,0,0,0,0,0,DF,20-24,Defender,Spain,Europe
2397,Alvaro Sanz,ESP,Barcelona,La Liga,2021,20.0,2001.0,0.3,0,0,0,0,0,0,1,0.0,1,0,0,0,0,0,0,0,MF,20-24,Midfielder,Spain,Europe
2399,Pablo Sarabia,ESP,Paris S-G,Ligue 1,2021,29.0,1992.0,0.2,0,0,0,0,0,0,1,0.0,1,0,0,0,0,0,0,0,FW,25-29,Forward,Spain,Europe
2406,Joan Sastre Vanrell,ESP,Mallorca,La Liga,2021,24.0,1997.0,2.9,6,3,5,0,1,3,4,75.0,1,3,0,3,2,8,10,0,DF,20-24,Defender,Spain,Europe
2422,Patrik Schick,CZE,Leverkusen,Bundesliga,2021,25.0,1996.0,23.1,5,2,2,2,1,1,9,11.1,8,6,1,5,3,8,28,0,FW,25-29,Forward,Czech Republic,Europe
2438,Valentino Scotta,ESP,Sevilla,La Liga,2021,19.0,2001.0,0.0,0,0,0,0,0,0,0,,0,0,0,0,0,0,0,0,DF,Under 20,Defender,Spain,Europe
2440,Aleksandar Sedlar,SRB,Mallorca,La Liga,2021,29.0,1991.0,4.5,5,3,4,1,0,3,5,60.0,2,4,4,0,5,10,19,0,"DF,MF",25-29,Defender,Serbia,Europe
2455,Javier Serrano,ESP,Atlético Madrid,La Liga,2021,18.0,2003.0,0.8,3,1,0,3,0,2,4,50.0,2,0,0,0,3,6,2,0,MF,Under 20,Midfielder,Spain,Europe
2456,Nicolás Serrano,ESP,Athletic Club,La Liga,2021,18.0,2003.0,3.5,9,6,3,5,1,3,10,30.0,7,5,1,4,2,11,3,0,"MF,FW",Under 20,Midfielder,Spain,Europe
2460,Salva Sevilla,ESP,Mallorca,La Liga,2021,37.0,1984.0,16.7,18,12,8,8,2,6,17,35.3,11,12,6,6,14,32,11,0,MF,35-39,Midfielder,Spain,Europe
2481,David Silva,ESP,Real Sociedad,La Liga,2021,35.0,1986.0,19.1,28,17,10,11,7,3,20,15.0,17,13,3,10,7,35,12,0,MF,35-39,Midfielder,Spain,Europe
2481,David Silva,ESP,Real Sociedad,La Liga,2021,35.0,1986.0,19.1,28,17,10,11,7,3,20,15.0,17,13,3,10,7,35,12,0,MF,35-39,Midfielder,Spain,Europe
2481,David Silva,ESP,Real Sociedad,La Liga,2021,35.0,1986.0,19.1,28,17,10,11,7,3,20,15.0,17,13,3,10,7,35,12,0,MF,35-39,Midfielder,Spain,Europe
2481,David Silva,ESP,Real Sociedad,La Liga,2021,35.0,1986.0,19.1,28,17,10,11,7,3,20,15.0,17,13,3,10,7,35,12,0,MF,35-39,Midfielder,Spain,Europe
2494,Unai Simón,ESP,Athletic Club,La Liga,2021,24.0,1997.0,34.0,0,0,0,0,0,0,0,,0,0,0,0,1,1,5,1,GK,20-24,Goalkeeper,Spain,Europe
2506,Antonio Sivera,ESP,Alavés,La Liga,2021,24.0,1996.0,3.1,0,0,0,0,0,0,1,0.0,1,0,0,0,0,0,0,0,GK,20-24,Goalkeeper,Spain,Europe
2509,Leo Skiri Østigård,NOR,Genoa,Serie A,2021,21.0,1999.0,13.0,16,9,8,7,1,9,11,81.8,2,17,10,7,8,24,55,1,DF,20-24,Defender,Norway,Europe
2510,Łukasz Skorupski,POL,Bologna,Serie A,2021,30.0,1991.0,36.0,0,0,0,0,0,0,1,0.0,1,0,0,0,0,0,17,0,GK,30-34,Goalkeeper,Poland,Europe
2520,Rubén Sobrino,ESP,Valencia,La Liga,2021,29.0,1992.0,0.2,1,1,1,0,0,1,1,100.0,0,1,0,1,2,3,0,0,MF,25-29,Midfielder,Spain,Europe
2521,Rubén Sobrino,ESP,Cádiz,La Liga,2021,29.0,1992.0,20.7,28,17,11,10,7,5,35,14.3,30,21,1,20,21,49,18,0,"FW,MF",25-29,Forward,Spain,Europe
2522,Alex Sola,ESP,Real Sociedad,La Liga,2021,22.0,1999.0,0.5,1,1,1,0,0,1,3,33.3,2,1,0,1,2,3,3,0,"DF,FW",20-24,Defender,Spain,Europe
2524,Roberto Soldado,ESP,Levante,La Liga,2021,36.0,1985.0,7.4,3,1,0,1,2,1,3,33.3,2,4,0,4,1,4,7,0,FW,35-39,Forward,Spain,Europe
2525,Carlos Soler,ESP,Valencia,La Liga,2021,24.0,1997.0,27.5,29,19,10,15,4,11,37,29.7,26,19,4,15,14,43,28,0,MF,20-24,Midfielder,Spain,Europe
2527,Son,ESP,Levante,La Liga,2021,27.0,1994.0,21.9,28,18,16,7,5,17,34,50.0,17,11,5,6,19,47,33,1,DF,25-29,Defender,Spain,Europe
2529,David Soria,ESP,Getafe,La Liga,2021,28.0,1993.0,37.9,1,0,1,0,0,1,2,50.0,1,0,0,0,0,1,22,2,GK,25-29,Goalkeeper,Spain,Europe
2531,Alberto Soro,ESP,Granada,La Liga,2021,22.0,1999.0,6.4,12,10,3,6,3,1,7,14.3,6,21,2,19,3,15,4,0,"MF,FW",20-24,Midfielder,Spain,Europe
2533,Hugo Sotelo,ESP,Celta Vigo,La Liga,2021,17.0,2003.0,0.0,0,0,0,0,0,0,0,,0,0,0,0,0,0,0,0,FW,Under 20,Forward,Spain,Europe
2536,Tomáš Souček,CZE,West Ham,Premier League,2021,26.0,1995.0,34.0,66,32,27,33,6,28,65,43.1,37,34,13,21,52,118,98,1,MF,25-29,Midfielder,Czech Republic,Europe
2568,Petar Stojanović,SVN,Empoli,Serie A,2021,25.0,1995.0,30.4,96,63,55,32,9,59,114,51.8,55,39,13,26,27,123,65,1,DF,25-29,Defender,Slovenia,Europe
2571,Stefan Strandberg,NOR,Salernitana,Serie A,2021,31.0,1990.0,10.4,13,8,10,3,0,8,11,72.7,3,15,13,2,9,22,49,0,DF,30-34,Defender,Norway,Europe
2577,Leo Štulac,SVN,Empoli,Serie A,2021,26.0,1994.0,9.3,13,6,5,6,2,7,19,36.8,12,6,2,4,8,21,15,0,MF,25-29,Midfielder,Slovenia,Europe
2580,Denis Suárez,ESP,Celta Vigo,La Liga,2021,27.0,1994.0,31.3,61,29,20,33,8,25,82,30.5,57,32,4,28,16,77,11,0,MF,25-29,Midfielder,Spain,Europe
2582,Mario Suárez,ESP,Rayo Vallecano,La Liga,2021,34.0,1987.0,7.9,9,4,7,2,0,3,9,33.3,6,6,4,2,7,16,37,1,DF,30-34,Defender,Spain,Europe
2588,Suso,ESP,Sevilla,La Liga,2021,27.0,1993.0,4.3,4,3,1,3,0,3,13,23.1,10,4,0,4,0,4,0,0,FW,25-29,Forward,Spain,Europe
2596,Wojciech Szczęsny,POL,Juventus,Serie A,2021,31.0,1990.0,33.0,1,1,1,0,0,1,2,50.0,1,0,0,0,0,1,8,1,GK,30-34,Goalkeeper,Poland,Europe
2599,Alexander Sørloth,NOR,Real Sociedad,La Liga,2021,25.0,1995.0,19.6,20,7,4,10,6,7,17,41.2,10,14,1,13,4,24,15,0,FW,25-29,Forward,Norway,Europe
2600,Tachi,ESP,Alavés,La Liga,2021,23.0,1997.0,2.7,6,3,3,3,0,5,7,71.4,2,4,3,1,1,7,9,0,DF,20-24,Defender,Spain,Europe
2625,Cristian Tello,ESP,Betis,La Liga,2021,29.0,1991.0,9.1,17,11,6,7,4,13,31,41.9,18,9,0,9,10,27,6,0,FW,25-29,Forward,Spain,Europe
2627,Marc Tenas,ESP,Alavés,La Liga,2021,20.0,2001.0,0.6,1,1,1,0,0,1,1,100.0,0,1,0,1,0,1,0,1,"FW,MF",20-24,Forward,Spain,Europe
2632,Aleksa Terzić,SRB,Fiorentina,Serie A,2021,21.0,1999.0,3.0,8,5,3,3,2,4,7,57.1,3,7,0,7,4,12,5,0,DF,20-24,Defender,Serbia,Europe
2646,Morten Thorsby,NOR,Sampdoria,Serie A,2021,25.0,1996.0,32.7,46,26,15,23,8,28,56,50.0,28,37,12,25,25,71,39,0,MF,25-29,Midfielder,Norway,Europe
2657,David Timor,ESP,Getafe,La Liga,2021,31.0,1989.0,3.8,1,1,1,0,0,0,3,0.0,3,3,2,1,1,2,4,1,MF,30-34,Midfielder,Spain,Europe
2665,Raúl de Tomás,ESP,Espanyol,La Liga,2021,26.0,1994.0,32.4,15,11,6,7,2,6,17,35.3,11,12,3,9,6,21,42,1,FW,25-29,Forward,Spain,Europe
2676,Raúl Torrente,ESP,Granada,La Liga,2021,19.0,2001.0,14.2,31,21,18,11,2,16,29,55.2,13,14,9,5,12,43,69,0,DF,Under 20,Defender,Spain,Europe
2677,Ferrán Torres,ESP,Manchester City,Premier League,2021,21.0,2000.0,3.4,2,2,0,1,1,0,3,0.0,3,2,0,2,0,2,1,0,FW,20-24,Forward,Spain,Europe
2678,Ferrán Torres,ESP,Barcelona,La Liga,2021,21.0,2000.0,15.7,10,5,3,4,3,3,7,42.9,4,12,3,9,6,16,7,0,FW,20-24,Forward,Spain,Europe
2679,Óliver Torres,ESP,Sevilla,La Liga,2021,26.0,1994.0,11.2,22,12,8,7,7,8,25,32.0,17,10,1,9,6,28,4,0,"MF,FW",25-29,Midfielder,Spain,Europe
2680,Pau Torres,ESP,Villarreal,La Liga,2021,24.0,1997.0,31.7,32,19,23,7,2,18,25,72.0,7,32,23,9,19,51,105,2,DF,20-24,Defender,Spain,Europe
2681,Roberto Torres,ESP,Osasuna,La Liga,2021,32.0,1989.0,9.0,7,4,3,1,3,3,15,20.0,12,8,0,8,8,15,4,0,"MF,FW",30-34,Midfielder,Spain,Europe
2682,Lucas Torró,ESP,Osasuna,La Liga,2021,27.0,1994.0,30.3,71,40,25,38,8,29,57,50.9,28,32,11,21,47,118,55,0,MF,25-29,Midfielder,Spain,Europe
2690,Adama Traoré,ESP,Wolves,Premier League,2021,25.0,1996.0,11.9,8,3,6,0,2,3,7,42.9,4,4,1,3,2,10,1,0,"FW,MF",25-29,Forward,Spain,Europe
2690,Adama Traoré,ESP,Wolves,Premier League,2021,25.0,1996.0,11.9,8,3,6,0,2,3,7,42.9,4,4,1,3,2,10,1,0,"FW,MF",25-29,Forward,Spain,Europe
2690,Adama Traoré,ESP,Wolves,Premier League,2021,25.0,1996.0,11.9,8,3,6,0,2,3,7,42.9,4,4,1,3,2,10,1,0,"FW,MF",25-29,Forward,Spain,Europe
2690,Adama Traoré,ESP,Wolves,Premier League,2021,25.0,1996.0,11.9,8,3,6,0,2,3,7,42.9,4,4,1,3,2,10,1,0,"FW,MF",25-29,Forward,Spain,Europe
2690,Adama Traoré,ESP,Wolves,Premier League,2021,25.0,1996.0,11.9,8,3,6,0,2,3,7,42.9,4,4,1,3,2,10,1,0,"FW,MF",25-29,Forward,Spain,Europe
2690,Adama Traoré,ESP,Wolves,Premier League,2021,25.0,1996.0,11.9,8,3,6,0,2,3,7,42.9,4,4,1,3,2,10,1,0,"FW,MF",25-29,Forward,Spain,Europe
2690,Adama Traoré,ESP,Wolves,Premier League,2021,25.0,1996.0,11.9,8,3,6,0,2,3,7,42.9,4,4,1,3,2,10,1,0,"FW,MF",25-29,Forward,Spain,Europe
2690,Adama Traoré,ESP,Wolves,Premier League,2021,25.0,1996.0,11.9,8,3,6,0,2,3,7,42.9,4,4,1,3,2,10,1,0,"FW,MF",25-29,Forward,Spain,Europe
2690,Adama Traoré,ESP,Wolves,Premier League,2021,25.0,1996.0,11.9,8,3,6,0,2,3,7,42.9,4,4,1,3,2,10,1,0,"FW,MF",25-29,Forward,Spain,Europe
2690,Adama Traoré,ESP,Wolves,Premier League,2021,25.0,1996.0,11.9,8,3,6,0,2,3,7,42.9,4,4,1,3,2,10,1,0,"FW,MF",25-29,Forward,Spain,Europe
2690,Adama Traoré,ESP,Wolves,Premier League,2021,25.0,1996.0,11.9,8,3,6,0,2,3,7,42.9,4,4,1,3,2,10,1,0,"FW,MF",25-29,Forward,Spain,Europe
2690,Adama Traoré,ESP,Wolves,Premier League,2021,25.0,1996.0,11.9,8,3,6,0,2,3,7,42.9,4,4,1,3,2,10,1,0,"FW,MF",25-29,Forward,Spain,Europe
2690,Adama Traoré,ESP,Wolves,Premier League,2021,25.0,1996.0,11.9,8,3,6,0,2,3,7,42.9,4,4,1,3,2,10,1,0,"FW,MF",25-29,Forward,Spain,Europe
2690,Adama Traoré,ESP,Wolves,Premier League,2021,25.0,1996.0,11.9,8,3,6,0,2,3,7,42.9,4,4,1,3,2,10,1,0,"FW,MF",25-29,Forward,Spain,Europe
2690,Adama Traoré,ESP,Wolves,Premier League,2021,25.0,1996.0,11.9,8,3,6,0,2,3,7,42.9,4,4,1,3,2,10,1,0,"FW,MF",25-29,Forward,Spain,Europe
2690,Adama Traoré,ESP,Wolves,Premier League,2021,25.0,1996.0,11.9,8,3,6,0,2,3,7,42.9,4,4,1,3,2,10,1,0,"FW,MF",25-29,Forward,Spain,Europe
2691,Adama Traoré,ESP,Barcelona,La Liga,2021,25.0,1996.0,4.2,4,2,0,3,1,3,5,60.0,2,2,0,2,4,8,3,1,FW,25-29,Forward,Spain,Europe
2691,Adama Traoré,ESP,Barcelona,La Liga,2021,25.0,1996.0,4.2,4,2,0,3,1,3,5,60.0,2,2,0,2,4,8,3,1,FW,25-29,Forward,Spain,Europe
2691,Adama Traoré,ESP,Barcelona,La Liga,2021,25.0,1996.0,4.2,4,2,0,3,1,3,5,60.0,2,2,0,2,4,8,3,1,FW,25-29,Forward,Spain,Europe
2691,Adama Traoré,ESP,Barcelona,La Liga,2021,25.0,1996.0,4.2,4,2,0,3,1,3,5,60.0,2,2,0,2,4,8,3,1,FW,25-29,Forward,Spain,Europe
2691,Adama Traoré,ESP,Barcelona,La Liga,2021,25.0,1996.0,4.2,4,2,0,3,1,3,5,60.0,2,2,0,2,4,8,3,1,FW,25-29,Forward,Spain,Europe
2691,Adama Traoré,ESP,Barcelona,La Liga,2021,25.0,1996.0,4.2,4,2,0,3,1,3,5,60.0,2,2,0,2,4,8,3,1,FW,25-29,Forward,Spain,Europe
2691,Adama Traoré,ESP,Barcelona,La Liga,2021,25.0,1996.0,4.2,4,2,0,3,1,3,5,60.0,2,2,0,2,4,8,3,1,FW,25-29,Forward,Spain,Europe
2691,Adama Traoré,ESP,Barcelona,La Liga,2021,25.0,1996.0,4.2,4,2,0,3,1,3,5,60.0,2,2,0,2,4,8,3,1,FW,25-29,Forward,Spain,Europe
2691,Adama Traoré,ESP,Barcelona,La Liga,2021,25.0,1996.0,4.2,4,2,0,3,1,3,5,60.0,2,2,0,2,4,8,3,1,FW,25-29,Forward,Spain,Europe
2691,Adama Traoré,ESP,Barcelona,La Liga,2021,25.0,1996.0,4.2,4,2,0,3,1,3,5,60.0,2,2,0,2,4,8,3,1,FW,25-29,Forward,Spain,Europe
2691,Adama Traoré,ESP,Barcelona,La Liga,2021,25.0,1996.0,4.2,4,2,0,3,1,3,5,60.0,2,2,0,2,4,8,3,1,FW,25-29,Forward,Spain,Europe
2691,Adama Traoré,ESP,Barcelona,La Liga,2021,25.0,1996.0,4.2,4,2,0,3,1,3,5,60.0,2,2,0,2,4,8,3,1,FW,25-29,Forward,Spain,Europe
2691,Adama Traoré,ESP,Barcelona,La Liga,2021,25.0,1996.0,4.2,4,2,0,3,1,3,5,60.0,2,2,0,2,4,8,3,1,FW,25-29,Forward,Spain,Europe
2691,Adama Traoré,ESP,Barcelona,La Liga,2021,25.0,1996.0,4.2,4,2,0,3,1,3,5,60.0,2,2,0,2,4,8,3,1,FW,25-29,Forward,Spain,Europe
2691,Adama Traoré,ESP,Barcelona,La Liga,2021,25.0,1996.0,4.2,4,2,0,3,1,3,5,60.0,2,2,0,2,4,8,3,1,FW,25-29,Forward,Spain,Europe
2691,Adama Traoré,ESP,Barcelona,La Liga,2021,25.0,1996.0,4.2,4,2,0,3,1,3,5,60.0,2,2,0,2,4,8,3,1,FW,25-29,Forward,Spain,Europe
2702,Manu Trigueros,ESP,Villarreal,La Liga,2021,29.0,1991.0,24.2,45,25,16,18,11,23,66,34.8,43,19,3,16,13,58,17,0,"MF,FW",25-29,Midfielder,Spain,Europe
2716,Beñat Turrientes,ESP,Real Sociedad,La Liga,2021,19.0,2002.0,2.3,0,0,0,0,0,0,4,0.0,4,1,0,1,2,2,2,0,MF,Under 20,Midfielder,Spain,Europe
2732,Kacper Urbanski,POL,Bologna,Serie A,2021,16.0,2004.0,0.5,3,2,1,2,0,2,2,100.0,0,2,0,2,0,3,0,0,MF,Under 20,Midfielder,Poland,Europe
2737,Álvaro Vadillo,ESP,Espanyol,La Liga,2021,26.0,1994.0,0.1,1,1,1,0,0,1,2,50.0,1,0,0,0,0,1,1,0,"DF,MF",25-29,Defender,Spain,Europe
2738,Óscar Valentín,ESP,Rayo Vallecano,La Liga,2021,26.0,1994.0,28.5,102,53,46,51,5,44,105,41.9,61,56,10,46,39,141,43,0,MF,25-29,Midfielder,Spain,Europe
2739,Germán Valera,ESP,Real Sociedad,La Liga,2021,19.0,2002.0,0.6,3,2,3,0,0,1,1,100.0,0,0,0,0,0,3,1,0,FW,Under 20,Forward,Spain,Europe
2742,Jesús Vallejo,ESP,Real Madrid,La Liga,2021,24.0,1997.0,3.8,7,5,7,0,0,5,6,83.3,1,9,8,1,6,13,16,0,DF,20-24,Defender,Spain,Europe
2743,Manu Vallejo,ESP,Alavés,La Liga,2021,24.0,1997.0,4.1,8,2,1,4,3,4,13,30.8,9,7,0,7,0,8,4,0,"MF,FW",20-24,Midfielder,Spain,Europe
2744,Manu Vallejo,ESP,Valencia,La Liga,2021,24.0,1997.0,1.1,2,1,1,1,0,0,1,0.0,1,0,0,0,0,2,1,0,"FW,MF",20-24,Forward,Spain,Europe
2756,José Luis García Vayá,ESP,Levante,La Liga,2021,22.0,1998.0,22.4,46,27,10,31,5,16,41,39.0,25,24,5,19,38,84,30,0,MF,20-24,Midfielder,Spain,Europe
2757,Jesus Vazquez,ESP,Valencia,La Liga,2021,18.0,2003.0,9.0,24,13,10,8,6,10,22,45.5,12,16,3,13,9,33,19,0,DF,Under 20,Defender,Spain,Europe
2758,Kevin Vázquez,ESP,Celta Vigo,La Liga,2021,28.0,1993.0,14.8,34,24,12,13,9,14,28,50.0,14,20,7,13,36,70,34,0,DF,25-29,Defender,Spain,Europe
2759,Lucas Vázquez,ESP,Real Madrid,La Liga,2021,30.0,1991.0,20.4,43,22,24,9,10,17,35,48.6,18,25,7,18,20,63,41,1,DF,30-34,Defender,Spain,Europe
2761,Gabriel Veiga,ESP,Celta Vigo,La Liga,2021,19.0,2002.0,1.2,5,4,0,4,1,3,12,25.0,9,2,0,2,4,9,1,0,MF,Under 20,Midfielder,Spain,Europe
2765,Unai Vencedor Paris,ESP,Athletic Club,La Liga,2021,20.0,2000.0,26.5,26,11,11,9,6,8,42,19.0,34,31,13,18,19,45,22,0,MF,20-24,Midfielder,Spain,Europe
2770,Gonzalo Verdú,ESP,Elche,La Liga,2021,32.0,1988.0,15.5,19,9,15,4,0,8,16,50.0,8,20,14,6,13,32,59,1,DF,30-34,Defender,Spain,Europe
2778,Mikel Vesga,ESP,Athletic Club,La Liga,2021,28.0,1993.0,15.1,27,14,7,18,2,11,31,35.5,20,16,5,11,20,47,34,2,MF,25-29,Midfielder,Spain,Europe
2782,Aleix Vidal,ESP,Espanyol,La Liga,2021,31.0,1989.0,21.1,31,25,17,9,5,19,39,48.7,20,19,6,13,25,56,35,2,"DF,MF",30-34,Defender,Spain,Europe
2784,Nacho Vidal,ESP,Osasuna,La Liga,2021,26.0,1995.0,32.2,83,47,49,25,9,39,77,50.6,38,32,14,18,58,141,79,0,DF,25-29,Defender,Spain,Europe
2790,Dídac Vilà,ESP,Espanyol,La Liga,2021,32.0,1989.0,2.3,7,5,2,5,0,4,9,44.4,5,2,1,1,3,10,8,0,"DF,MF",30-34,Defender,Spain,Europe
2792,Daniel Villahermosa,ESP,Espanyol,La Liga,2021,20.0,2001.0,0.3,0,0,0,0,0,0,0,,0,0,0,0,0,0,1,0,MF,20-24,Midfielder,Spain,Europe
2793,Asier Villalibre,ESP,Athletic Club,La Liga,2021,23.0,1997.0,6.1,4,3,2,1,1,1,2,50.0,1,3,1,2,1,5,7,0,FW,20-24,Forward,Spain,Europe
2794,Gonzalo Villar,ESP,Getafe,La Liga,2021,23.0,1998.0,3.3,5,3,4,1,0,2,5,40.0,3,4,1,3,1,6,1,0,MF,20-24,Midfielder,Spain,Europe
2798,Vitolo,ESP,Getafe,La Liga,2021,31.0,1989.0,2.5,3,2,1,1,1,2,5,40.0,3,3,0,3,1,4,1,0,MF,30-34,Midfielder,Spain,Europe
2798,Vitolo,ESP,Getafe,La Liga,2021,31.0,1989.0,2.5,3,2,1,1,1,2,5,40.0,3,3,0,3,1,4,1,0,MF,30-34,Midfielder,Spain,Europe
2798,Vitolo,ESP,Getafe,La Liga,2021,31.0,1989.0,2.5,3,2,1,1,1,2,5,40.0,3,3,0,3,1,4,1,0,MF,30-34,Midfielder,Spain,Europe
2798,Vitolo,ESP,Getafe,La Liga,2021,31.0,1989.0,2.5,3,2,1,1,1,2,5,40.0,3,3,0,3,1,4,1,0,MF,30-34,Midfielder,Spain,Europe
2799,Daniel Vivian,ESP,Athletic Club,La Liga,2021,22.0,1999.0,22.1,32,21,24,7,1,17,24,70.8,7,20,15,5,26,58,107,1,DF,20-24,Defender,Spain,Europe
2800,Dušan Vlahović,SRB,Fiorentina,Serie A,2021,21.0,2000.0,20.6,5,0,0,2,3,2,11,18.2,9,6,2,4,1,6,16,0,FW,20-24,Forward,Serbia,Europe
2801,Dušan Vlahović,SRB,Juventus,Serie A,2021,21.0,2000.0,12.0,0,0,0,0,0,0,4,0.0,4,3,0,3,0,0,7,0,FW,20-24,Forward,Serbia,Europe
2812,Matěj Vydra,CZE,Burnley,Premier League,2021,29.0,1992.0,7.5,12,7,3,4,5,3,7,42.9,4,5,1,4,0,12,9,0,FW,25-29,Forward,Czech Republic,Europe
2819,Sebastian Walukiewicz,POL,Cagliari,Serie A,2021,21.0,2000.0,3.4,9,5,7,2,0,3,5,60.0,2,5,2,3,7,16,14,0,DF,20-24,Defender,Poland,Europe
2844,Nico Williams,ESP,Athletic Club,La Liga,2021,19.0,2002.0,14.9,20,10,6,11,3,10,31,32.3,21,18,2,16,5,25,9,0,MF,Under 20,Midfielder,Spain,Europe
2870,Gerard Yepes,ESP,Sampdoria,Serie A,2021,18.0,2002.0,0.2,1,0,0,1,0,1,1,100.0,0,1,0,1,0,1,0,0,"MF,DF",Under 20,Midfielder,Spain,Europe
2878,Zaydou Youssouf,COM,Saint-Étienne,Ligue 1,2021,22.0,1999.0,17.3,48,26,21,25,2,14,34,41.2,20,11,3,8,17,65,13,0,MF,20-24,Midfielder,Comoros,Africa
2885,Joseba Zaldúa,ESP,Real Sociedad,La Liga,2021,29.0,1992.0,13.0,31,22,20,8,3,16,22,72.7,6,14,4,10,13,44,35,0,DF,25-29,Defender,Spain,Europe
2886,Nicola Zalewski,POL,Roma,Serie A,2021,19.0,2002.0,8.8,32,19,17,11,4,21,35,60.0,14,18,1,17,16,48,4,0,DF,Under 20,Defender,Poland,Europe
2894,Oier Zarraga,ESP,Athletic Club,La Liga,2021,22.0,1999.0,13.0,13,5,4,7,2,3,28,10.7,25,17,10,7,19,32,10,0,MF,20-24,Midfielder,Spain,Europe
2905,Piotr Zieliński,POL,Napoli,Serie A,2021,27.0,1994.0,23.2,19,12,5,9,5,6,21,28.6,15,13,2,11,8,27,4,0,MF,25-29,Midfielder,Poland,Europe
2906,David Zima,CZE,Torino,Serie A,2021,20.0,2000.0,14.6,20,12,8,11,1,9,20,45.0,11,15,13,2,23,43,42,0,DF,20-24,Defender,Czech Republic,Europe
2916,Igor Zubeldia,ESP,Real Sociedad,La Liga,2021,24.0,1997.0,18.3,20,10,12,8,0,12,18,66.7,6,16,6,10,27,47,53,0,DF,20-24,Defender,Spain,Europe
2917,Martín Zubimendi,ESP,Real Sociedad,La Liga,2021,22.0,1999.0,28.8,52,25,19,30,3,22,44,50.0,22,30,13,17,49,101,48,1,MF,20-24,Midfielder,Spain,Europe
2918,Szymon Żurkowski,POL,Empoli,Serie A,2021,23.0,1997.0,25.6,58,33,24,21,13,29,68,42.6,39,43,10,33,35,93,32,1,MF,20-24,Midfielder,Poland,Europe
2919,Martin Ødegaard,NOR,Arsenal,Premier League,2021,22.0,1998.0,30.9,49,21,6,24,19,22,61,36.1,39,18,1,17,11,60,11,1,"MF,FW",20-24,Midfielder,Norway,Europe
2921,Filip Đuričić,SRB,Sassuolo,Serie A,2021,29.0,1992.0,7.5,13,10,7,1,5,5,13,38.5,8,7,1,6,4,17,1,0,"MF,FW",25-29,Midfielder,Serbia,Europe
1,Max Aarons,ENG,Bournemouth,Premier League,2024,24.0,2000.0,0.2,0,0,0,0,0,0,0,,0,0,0,0,0,0,0,0,DF,20-24,Defender,England,Europe
3,James Abankwah,IRL,Udinese,Serie A,2024,20.0,2004.0,0.8,4,2,4,0,0,2,3,66.7,1,2,1,1,1,5,2,0,"DF,MF",20-24,Defender,Republic of Ireland,Europe
4,Keyliane Abdallah,FRA,Marseille,Ligue 1,2024,18.0,2006.0,0.0,1,1,1,0,0,1,1,100.0,0,0,0,0,0,1,0,0,FW,Under 20,Forward,France,Europe
5,Yunis Abdelhamid,MAR,Saint-Étienne,Ligue 1,2024,37.0,1987.0,10.4,17,11,15,2,0,10,16,62.5,6,22,15,7,12,29,54,1,DF,35-39,Defender,Morocco,Africa
6,Himad Abdelli,ALG,Angers,Ligue 1,2024,25.0,1999.0,14.8,23,17,7,8,8,8,23,34.8,15,8,0,8,12,35,11,1,"MF,FW",25-29,Midfielder,Algeria,Africa
7,Mohamed Abdelmoneim,EGY,Nice,Ligue 1,2024,25.0,1999.0,5.8,15,11,9,5,1,10,17,58.8,7,6,3,3,13,28,33,1,DF,25-29,Defender,Egypt,Africa
8,Ali Abdi,TUN,Nice,Ligue 1,2024,31.0,1993.0,6.5,16,10,7,4,5,14,21,66.7,7,13,3,10,3,19,13,0,"DF,MF",30-34,Defender,Tunisia,Africa
9,Saud Abdulhamid,KSA,Roma,Serie A,2024,25.0,1999.0,1.6,2,1,1,0,1,1,1,100.0,0,1,0,1,1,3,0,0,DF,25-29,Defender,Saudi Arabia,Asia
11,Nabil Aberdin,FRA,Getafe,La Liga,2024,22.0,2002.0,2.9,6,4,3,3,0,1,1,100.0,0,3,0,3,0,6,5,0,MF,20-24,Midfielder,France,Europe
12,Oliver Abildgaard,DEN,Como,Serie A,2024,28.0,1996.0,0.1,0,0,0,0,0,0,0,,0,1,0,1,0,0,0,0,MF,25-29,Midfielder,Denmark,Europe
13,Matthis Abline,FRA,Nantes,Ligue 1,2024,21.0,2003.0,12.6,6,3,2,2,2,1,6,16.7,5,3,0,3,2,8,20,1,FW,20-24,Forward,France,Europe
14,Abner,BRA,Lyon,Ligue 1,2024,24.0,2000.0,7.3,17,12,7,7,3,12,17,70.6,5,10,1,9,5,22,22,0,DF,20-24,Defender,Brazil,South America
15,Zakaria Aboukhlal,MAR,Toulouse,Ligue 1,2024,24.0,2000.0,13.1,12,7,5,4,3,4,14,28.6,10,10,0,10,6,18,5,0,"MF,FW",20-24,Midfielder,Morocco,Africa
16,Abdel Abqar,MAR,Alavés,La Liga,2024,25.0,1999.0,15.5,23,14,14,8,1,11,20,55.0,9,15,10,5,24,47,80,0,DF,25-29,Defender,Morocco,Africa
17,Tammy Abraham,ENG,Roma,Serie A,2024,27.0,1997.0,0.0,0,0,0,0,0,0,1,0.0,1,0,0,0,0,0,0,0,FW,25-29,Forward,England,Europe
18,Tammy Abraham,ENG,Milan,Serie A,2024,27.0,1997.0,5.9,6,3,0,5,1,1,1,100.0,0,4,0,4,2,8,4,0,FW,25-29,Forward,England,Europe
19,Federico Accornero,ITA,Genoa,Serie A,2024,20.0,2004.0,0.1,0,0,0,0,0,0,0,,0,0,0,0,0,0,0,0,MF,20-24,Midfielder,Italy,Europe
20,Francesco Acerbi,ITA,Inter,Serie A,2024,36.0,1988.0,7.4,6,4,5,1,0,2,3,66.7,1,6,6,0,15,21,28,0,DF,35-39,Defender,Italy,Europe
21,Akor Adams,NGA,Montpellier,Ligue 1,2024,24.0,2000.0,10.2,3,2,1,1,1,2,3,66.7,1,2,1,1,1,4,4,1,FW,20-24,Forward,Nigeria,Africa
22,Che Adams,SCO,Torino,Serie A,2024,28.0,1996.0,10.8,6,3,1,3,2,0,1,0.0,1,6,3,3,1,7,4,0,FW,25-29,Forward,Scotland,Europe
23,Tyler Adams,USA,Bournemouth,Premier League,2024,25.0,1999.0,5.1,26,18,10,13,3,11,16,68.8,5,6,3,3,18,44,11,0,MF,25-29,Midfielder,United States,North America
24,Junior Adamu,AUT,Freiburg,Bundesliga,2024,23.0,2001.0,9.1,3,0,1,1,1,0,4,0.0,4,7,0,7,6,9,9,0,FW,20-24,Forward,Austria,Europe
25,Tosin Adarabioyo,ENG,Chelsea,Premier League,2024,27.0,1997.0,4.9,8,7,7,1,0,4,5,80.0,1,4,3,1,3,11,21,0,DF,25-29,Defender,England,Europe
26,Martin Adeline,FRA,Reims,Ligue 1,2024,21.0,2003.0,0.3,1,1,0,1,0,1,2,50.0,1,0,0,0,0,1,2,0,MF,20-24,Midfielder,France,Europe
27,Karim Adeyemi,GER,Dortmund,Bundesliga,2024,22.0,2002.0,3.9,7,5,3,1,3,2,4,50.0,2,6,0,6,1,8,1,0,"FW,MF",20-24,Forward,Germany,Europe
28,Simon Adingra,CIV,Brighton,Premier League,2024,22.0,2002.0,3.9,9,4,5,3,1,4,10,40.0,6,5,0,5,4,13,1,0,"FW,MF",20-24,Forward,Ivory Coast,Africa
29,Amine Adli,MAR,Leverkusen,Bundesliga,2024,24.0,2000.0,2.3,7,4,1,1,5,3,5,60.0,2,3,0,3,0,7,3,0,MF,20-24,Midfielder,Morocco,Africa
30,Yacine Adli,FRA,Fiorentina,Serie A,2024,24.0,2000.0,7.9,19,10,8,7,4,11,23,47.8,12,8,1,7,3,22,14,0,MF,20-24,Midfielder,France,Europe
31,Adryelson,BRA,Lyon,Ligue 1,2024,26.0,1998.0,0.0,0,0,0,0,0,0,0,,0,0,0,0,1,1,1,0,DF,25-29,Defender,Brazil,South America
32,Vasilije Adžić,MNE,Juventus,Serie A,2024,18.0,2006.0,0.3,2,2,0,1,1,0,1,0.0,1,0,0,0,0,2,0,0,"MF,FW",Under 20,Midfielder,Montenegro,Europe
33,Michel Aebischer,SUI,Bologna,Serie A,2024,27.0,1997.0,4.2,7,4,1,4,2,4,8,50.0,4,3,1,2,5,12,2,0,MF,25-29,Midfielder,Switzerland,Europe
34,Oladapo Afolayan,ENG,St. Pauli,Bundesliga,2024,26.0,1998.0,11.6,15,8,4,7,4,5,12,41.7,7,9,1,8,7,22,10,0,"FW,MF",25-29,Forward,England,Europe
35,Emmanuel Agbadou,CIV,Reims,Ligue 1,2024,27.0,1997.0,14.0,25,17,19,3,3,19,26,73.1,7,22,13,9,19,44,64,1,DF,25-29,Defender,Ivory Coast,Africa
36,Asher Agbinone,ENG,Crystal Palace,Premier League,2024,19.0,2005.0,0.1,2,1,0,2,0,0,0,,0,0,0,0,0,2,0,0,MF,Under 20,Midfielder,England,Europe
38,Lucien Agoume,FRA,Sevilla,La Liga,2024,22.0,2002.0,10.5,25,7,10,12,3,11,17,64.7,6,15,6,9,18,43,14,0,MF,20-24,Midfielder,France,Europe
39,Felix Agu,GER,Werder Bremen,Bundesliga,2024,25.0,1999.0,8.9,10,5,6,3,1,5,11,45.5,6,6,2,4,8,18,23,0,DF,25-29,Defender,Germany,Europe
41,Nayef Aguerd,MAR,Real Sociedad,La Liga,2024,28.0,1996.0,12.2,19,15,11,8,0,7,13,53.8,6,11,6,5,9,28,46,0,DF,25-29,Defender,Morocco,Africa
42,Ruben Aguilar,FRA,Lens,Ligue 1,2024,31.0,1993.0,3.0,9,6,5,4,0,7,9,77.8,2,5,1,4,5,14,2,0,DF,30-34,Defender,France,Europe
43,Honest Ahanor,ITA,Genoa,Serie A,2024,16.0,2008.0,0.9,2,1,0,2,0,2,4,50.0,2,0,0,0,0,2,2,0,DF,Under 20,Defender,Italy,Europe
44,Erik Ahlstrand,SWE,St. Pauli,Bundesliga,2024,23.0,2001.0,0.5,0,0,0,0,0,0,0,,0,1,0,1,1,1,1,0,"FW,MF",20-24,Forward,Sweden,Europe
45,Jean-Eudes Aholou,CIV,Angers,Ligue 1,2024,30.0,1994.0,12.2,34,22,17,9,8,15,27,55.6,12,21,11,10,24,58,13,0,MF,30-34,Midfielder,Ivory Coast,Africa
46,Joseph Aidoo,GHA,Celta Vigo,La Liga,2024,29.0,1995.0,0.0,1,0,1,0,0,0,0,,0,0,0,0,0,1,0,0,DF,25-29,Defender,Ghana,Africa
47,Ayman Aiki,FRA,Saint-Étienne,Ligue 1,2024,19.0,2005.0,1.4,3,3,1,2,0,1,1,100.0,0,1,0,1,1,4,0,0,"FW,MF",Under 20,Forward,France,Europe
48,Ola Aina,NGA,Nott'ham Forest,Premier League,2024,28.0,1996.0,16.3,36,25,27,8,1,23,35,65.7,12,17,5,12,23,59,45,1,DF,25-29,Defender,Nigeria,Africa
49,Rayan Aït-Nouri,ALG,Wolves,Premier League,2024,23.0,2001.0,15.2,40,25,28,9,3,19,30,63.3,11,20,4,16,13,53,38,1,DF,20-24,Defender,Algeria,Africa
51,Ludovic Ajorque,FRA,Brest,Ligue 1,2024,30.0,1994.0,10.8,11,8,1,5,5,4,12,33.3,8,5,2,3,3,14,8,0,FW,30-34,Forward,France,Europe
52,Manuel Akanji,SUI,Manchester City,Premier League,2024,29.0,1995.0,12.2,13,10,6,4,3,6,11,54.5,5,7,5,2,6,19,33,1,DF,25-29,Defender,Switzerland,Europe
53,Ümit Akdag,ROU,Toulouse,Ligue 1,2024,21.0,2003.0,2.5,4,2,1,3,0,3,6,50.0,3,5,4,1,10,14,8,0,DF,20-24,Defender,Romania,Europe
54,Nathan Aké,NED,Manchester City,Premier League,2024,29.0,1995.0,3.3,5,4,4,1,0,2,2,100.0,0,5,1,4,3,8,5,1,DF,25-29,Defender,Netherlands,Europe
55,Ilias Akhomach,MAR,Villarreal,La Liga,2024,20.0,2004.0,6.5,12,7,4,4,4,6,12,50.0,6,8,0,8,3,15,13,0,"MF,FW",20-24,Midfielder,Morocco,Africa
57,Maghnes Akliouche,FRA,Monaco,Ligue 1,2024,22.0,2002.0,11.6,26,16,8,9,9,9,23,39.1,14,8,0,8,8,34,3,0,"FW,MF",20-24,Forward,France,Europe
58,Clément Akpa,CIV,Auxerre,Ligue 1,2024,23.0,2001.0,12.0,26,17,15,6,5,16,25,64.0,9,21,5,16,16,42,50,1,DF,20-24,Defender,Ivory Coast,Africa
59,David Akpan Ankeye,NGA,Genoa,Serie A,2024,22.0,2002.0,0.5,0,0,0,0,0,0,1,0.0,1,0,0,0,0,0,1,0,"FW,MF",20-24,Forward,Nigeria,Africa
60,Kevin Akpoguma,NGA,Hoffenheim,Bundesliga,2024,29.0,1995.0,11.3,19,9,13,4,2,9,18,50.0,9,33,21,12,13,32,58,0,DF,25-29,Defender,Nigeria,Africa
61,Andreas Albers,DEN,St. Pauli,Bundesliga,2024,34.0,1990.0,0.6,1,1,0,0,1,0,1,0.0,1,0,0,0,0,1,1,0,FW,30-34,Forward,Denmark,Europe
63,Carlos Alcaraz,ARG,Southampton,Premier League,2024,22.0,2002.0,0.1,0,0,0,0,0,0,0,,0,0,0,0,1,1,0,0,MF,20-24,Midfielder,Argentina,South America
64,Omar Alderete,PAR,Getafe,La Liga,2024,28.0,1996.0,16.8,26,17,18,6,2,13,17,76.5,4,17,11,6,21,47,74,1,DF,25-29,Defender,Paraguay,South America
66,Trent Alexander-Arnold,ENG,Liverpool,Premier League,2024,26.0,1998.0,12.6,38,29,25,9,4,25,50,50.0,25,14,5,9,12,50,23,0,DF,25-29,Defender,England,Europe
68,Mohamed Ali Cho,FRA,Nice,Ligue 1,2024,20.0,2004.0,8.5,6,3,1,1,4,2,6,33.3,4,7,1,6,1,7,2,0,"FW,MF",20-24,Forward,France,Europe
69,Faride Alidou,GER,Hellas Verona,Serie A,2024,23.0,2001.0,0.8,0,0,0,0,0,0,0,,0,1,0,1,1,1,3,1,"FW,MF",20-24,Forward,Germany,Europe
70,Alisson,BRA,Liverpool,Premier League,2024,32.0,1992.0,7.9,0,0,0,0,0,0,0,,0,0,0,0,0,0,3,0,GK,30-34,Goalkeeper,Brazil,South America
70,Alisson,BRA,Liverpool,Premier League,2024,32.0,1992.0,7.9,0,0,0,0,0,0,0,,0,0,0,0,0,0,3,0,GK,30-34,Goalkeeper,Brazil,South America
70,Alisson,BRA,Liverpool,Premier League,2024,32.0,1992.0,7.9,0,0,0,0,0,0,0,,0,0,0,0,0,0,3,0,GK,30-34,Goalkeeper,Brazil,South America
70,Alisson,BRA,Liverpool,Premier League,2024,32.0,1992.0,7.9,0,0,0,0,0,0,0,,0,0,0,0,0,0,3,0,GK,30-34,Goalkeeper,Brazil,South America
71,Tadeo Allende,ARG,Celta Vigo,La Liga,2024,25.0,1999.0,0.0,0,0,0,0,0,0,0,,0,0,0,0,0,0,0,0,FW,25-29,Forward,Argentina,South America
72,Jim Allevinah,GAB,Angers,Ligue 1,2024,29.0,1995.0,8.3,7,5,3,2,2,2,13,15.4,11,2,0,2,4,11,8,0,FW,25-29,Forward,Gabon,Africa
73,Domingos André Ribeiro Almeida,POR,Valencia,La Liga,2024,24.0,2000.0,7.7,18,10,7,8,3,7,12,58.3,5,10,1,9,4,22,3,0,"MF,FW",20-24,Midfielder,Portugal,Europe
75,Miguel Almirón,PAR,Newcastle Utd,Premier League,2024,30.0,1994.0,1.6,2,1,2,0,0,1,2,50.0,1,1,0,1,0,2,0,0,FW,30-34,Forward,Paraguay,South America
76,Pontus Almqvist,SWE,Parma,Serie A,2024,25.0,1999.0,5.3,8,6,4,2,2,4,6,66.7,2,4,0,4,6,14,2,0,"FW,MF",25-29,Forward,Sweden,Europe
78,Giorgio Altare,ITA,Venezia,Serie A,2024,26.0,1998.0,6.4,9,8,5,2,2,4,11,36.4,7,13,5,8,11,20,31,0,DF,25-29,Defender,Italy,Europe
81,Edson Álvarez,MEX,West Ham,Premier League,2024,27.0,1997.0,8.8,20,10,11,5,4,11,16,68.8,5,12,5,7,11,31,22,0,MF,25-29,Midfielder,Mexico,North America
83,Julián Álvarez,ARG,Atlético Madrid,La Liga,2024,24.0,2000.0,12.3,6,3,1,1,4,1,11,9.1,10,9,0,9,0,6,6,0,"FW,MF",20-24,Forward,Argentina,South America
85,Skelly Alvero,FRA,Werder Bremen,Bundesliga,2024,22.0,2002.0,1.2,4,3,3,0,1,1,1,100.0,0,4,0,4,2,6,5,0,MF,20-24,Midfielder,France,Europe
86,Selim Amallah,MAR,Valladolid,La Liga,2024,28.0,1996.0,7.8,13,8,4,8,1,1,7,14.3,6,13,0,13,7,20,2,1,"MF,FW",25-29,Midfielder,Morocco,Africa
87,Amath,SEN,Valladolid,La Liga,2024,28.0,1996.0,3.3,1,0,1,0,0,1,5,20.0,4,5,1,4,2,3,2,0,"FW,DF",25-29,Forward,Senegal,Africa
88,Jordan Amavi,FRA,Brest,Ligue 1,2024,30.0,1994.0,8.3,24,17,10,11,3,15,21,71.4,6,8,2,6,7,31,16,0,DF,30-34,Defender,France,Europe
89,Aurele Amenda,SUI,Eint Frankfurt,Bundesliga,2024,21.0,2003.0,0.8,0,0,0,0,0,0,0,,0,2,2,0,1,1,4,0,DF,20-24,Defender,Switzerland,Europe
90,Kelvin Amian,FRA,Nantes,Ligue 1,2024,26.0,1998.0,9.9,26,15,23,3,0,13,16,81.3,3,8,4,4,2,28,23,0,"DF,MF",25-29,Defender,France,Europe
91,Michael Amir Murillo,PAN,Marseille,Ligue 1,2024,28.0,1996.0,12.8,26,15,16,6,4,14,24,58.3,10,7,3,4,10,36,36,2,DF,25-29,Defender,Panama,North America
92,Nadiem Amiri,GER,Mainz 05,Bundesliga,2024,28.0,1996.0,12.3,19,9,8,9,2,5,21,23.8,16,12,2,10,12,31,16,1,MF,25-29,Midfielder,Germany,Europe
93,Samuel Amo-Ameyaw,ENG,Southampton,Premier League,2024,18.0,2006.0,0.3,1,0,0,1,0,1,1,100.0,0,0,0,0,0,1,0,0,"FW,DF",Under 20,Forward,England,Europe
94,Mathis Amougou,FRA,Saint-Étienne,Ligue 1,2024,18.0,2006.0,8.0,14,9,10,4,0,7,13,53.8,6,6,0,6,12,26,4,0,MF,Under 20,Midfielder,France,Europe
95,Mohamed Amoura,ALG,Wolfsburg,Bundesliga,2024,24.0,2000.0,11.7,9,6,3,1,5,4,15,26.7,11,18,0,18,4,13,6,0,FW,20-24,Forward,Algeria,Africa
96,Sofyan Amrabat,MAR,Fiorentina,Serie A,2024,28.0,1996.0,2.0,3,2,1,2,0,2,2,100.0,0,1,1,0,0,3,2,0,MF,25-29,Midfielder,Morocco,Africa
97,Joachim Andersen,DEN,Crystal Palace,Premier League,2024,28.0,1996.0,1.0,1,1,1,0,0,1,2,50.0,1,0,0,0,0,1,7,0,DF,25-29,Defender,Denmark,Europe
98,Joachim Andersen,DEN,Fulham,Premier League,2024,28.0,1996.0,7.7,8,5,8,0,0,4,8,50.0,4,9,6,3,11,19,42,0,DF,25-29,Defender,Denmark,Europe
99,Elliot Anderson,ENG,Nott'ham Forest,Premier League,2024,22.0,2002.0,10.8,38,28,21,11,6,18,34,52.9,16,21,4,17,9,47,22,1,"MF,FW",20-24,Midfielder,England,Europe
100,André,BRA,Wolves,Premier League,2024,23.0,2001.0,9.1,33,24,16,12,5,17,24,70.8,7,21,5,16,6,39,15,1,MF,20-24,Midfielder,Brazil,South America
101,Benjamin André,FRA,Lille,Ligue 1,2024,34.0,1990.0,12.9,36,14,14,19,3,23,41,56.1,18,18,3,15,18,54,25,0,MF,30-34,Midfielder,France,Europe
102,Marcos André,BRA,Valladolid,La Liga,2024,28.0,1996.0,5.8,3,3,0,2,1,0,3,0.0,3,6,1,5,2,5,3,0,FW,25-29,Forward,Brazil,South America
102,Marcos André,BRA,Valladolid,La Liga,2024,28.0,1996.0,5.8,3,3,0,2,1,0,3,0.0,3,6,1,5,2,5,3,0,FW,25-29,Forward,Brazil,South America
102,Marcos André,BRA,Valladolid,La Liga,2024,28.0,1996.0,5.8,3,3,0,2,1,0,3,0.0,3,6,1,5,2,5,3,0,FW,25-29,Forward,Brazil,South America
102,Marcos André,BRA,Valladolid,La Liga,2024,28.0,1996.0,5.8,3,3,0,2,1,0,3,0.0,3,6,1,5,2,5,3,0,FW,25-29,Forward,Brazil,South America
103,Robert Andrich,GER,Leverkusen,Bundesliga,2024,30.0,1994.0,9.3,15,7,5,10,0,4,9,44.4,5,6,3,3,15,30,11,0,MF,30-34,Midfielder,Germany,Europe
105,Lorenzo Anghelè,ITA,Juventus,Serie A,2024,19.0,2005.0,0.1,0,0,0,0,0,0,0,,0,0,0,0,0,0,0,0,FW,Under 20,Forward,Italy,Europe
106,Faustino Anjorin,ENG,Empoli,Serie A,2024,23.0,2001.0,8.4,21,8,6,10,5,5,13,38.5,8,12,3,9,7,28,15,0,MF,20-24,Midfielder,England,Europe
107,Waldemar Anton,GER,Dortmund,Bundesliga,2024,28.0,1996.0,9.0,15,12,7,5,3,7,9,77.8,2,19,11,8,9,24,36,1,DF,25-29,Defender,Germany,Europe
108,Michail Antonio,JAM,West Ham,Premier League,2024,34.0,1990.0,9.3,2,2,0,1,1,2,3,66.7,1,6,0,6,0,2,2,0,FW,30-34,Forward,Jamaica,North America
110,Antony,BRA,Manchester Utd,Premier League,2024,24.0,2000.0,0.6,2,0,2,0,0,1,3,33.3,2,1,0,1,2,4,0,0,"FW,MF",20-24,Forward,Brazil,South America
110,Antony,BRA,Manchester Utd,Premier League,2024,24.0,2000.0,0.6,2,0,2,0,0,1,3,33.3,2,1,0,1,2,4,0,0,"FW,MF",20-24,Forward,Brazil,South America
110,Antony,BRA,Manchester Utd,Premier League,2024,24.0,2000.0,0.6,2,0,2,0,0,1,3,33.3,2,1,0,1,2,4,0,0,"FW,MF",20-24,Forward,Brazil,South America
110,Antony,BRA,Manchester Utd,Premier League,2024,24.0,2000.0,0.6,2,0,2,0,0,1,3,33.3,2,1,0,1,2,4,0,0,"FW,MF",20-24,Forward,Brazil,South America
111,Anuar,MAR,Valladolid,La Liga,2024,29.0,1995.0,6.7,11,8,6,2,3,2,10,20.0,8,9,3,6,6,17,7,1,"FW,MF",25-29,Forward,Morocco,Africa
112,Dennis Appiah,FRA,Saint-Étienne,Ligue 1,2024,32.0,1992.0,11.3,29,21,15,12,2,16,32,50.0,16,13,5,8,10,39,34,0,DF,30-34,Defender,France,Europe
114,Mauro Arambarri,URU,Getafe,La Liga,2024,29.0,1995.0,12.7,17,9,1,12,4,8,18,44.4,10,12,1,11,6,23,18,0,MF,25-29,Midfielder,Uruguay,South America
115,Jon Aramburu,VEN,Real Sociedad,La Liga,2024,22.0,2002.0,13.3,54,39,30,18,6,38,59,64.4,21,21,3,18,19,73,44,0,DF,20-24,Defender,Venezuela,South America
116,Julian Araujo,MEX,Bournemouth,Premier League,2024,23.0,2001.0,3.9,7,3,3,4,0,4,10,40.0,6,3,0,3,4,11,13,0,DF,20-24,Defender,Mexico,North America
117,Cameron Archer,ENG,Southampton,Premier League,2024,23.0,2001.0,10.0,8,5,4,2,2,1,4,25.0,3,5,1,4,2,10,5,0,FW,20-24,Forward,England,Europe
118,Carlens Arcus,HAI,Angers,Ligue 1,2024,28.0,1996.0,13.0,34,21,22,11,1,23,38,60.5,15,14,2,12,18,52,45,2,DF,25-29,Defender,Haiti,North America
119,Alphonse Areola,FRA,West Ham,Premier League,2024,31.0,1993.0,7.5,1,1,1,0,0,1,2,50.0,1,0,0,0,0,1,5,0,GK,30-34,Goalkeeper,France,Europe
123,Joe Aribo,NGA,Southampton,Premier League,2024,28.0,1996.0,10.7,20,14,6,9,5,9,19,47.4,10,11,6,5,9,29,15,1,MF,25-29,Midfielder,Nigeria,Africa
124,Adam Armstrong,ENG,Southampton,Premier League,2024,27.0,1997.0,10.5,11,2,1,7,3,3,12,25.0,9,4,1,3,3,14,6,0,"FW,MF",25-29,Forward,England,Europe
125,Harrison Armstrong,ENG,Everton,Premier League,2024,17.0,2007.0,0.0,0,0,0,0,0,0,1,0.0,1,0,0,0,0,0,0,0,MF,Under 20,Midfielder,England,Europe
127,Hákon Arnar Haraldsson,ISL,Lille,Ligue 1,2024,21.0,2003.0,3.8,12,5,3,7,2,5,9,55.6,4,2,1,1,3,15,0,0,MF,20-24,Midfielder,Iceland,Europe
128,Marko Arnautović,AUT,Inter,Serie A,2024,35.0,1989.0,0.8,4,3,1,2,1,2,3,66.7,1,0,0,0,1,5,1,0,FW,35-39,Forward,Austria,Europe
129,Maximilian Arnold,GER,Wolfsburg,Bundesliga,2024,30.0,1994.0,13.4,20,12,6,12,2,10,18,55.6,8,12,7,5,11,31,32,1,MF,30-34,Midfielder,Germany,Europe
130,Jann-Fiete Arp,GER,Holstein Kiel,Bundesliga,2024,24.0,2000.0,3.8,5,4,3,1,1,1,5,20.0,4,2,0,2,0,5,1,0,FW,20-24,Forward,Germany,Europe
132,Arthur,BRA,Leverkusen,Bundesliga,2024,21.0,2003.0,2.3,5,3,2,2,1,1,4,25.0,3,3,0,3,4,9,8,0,DF,20-24,Defender,Brazil,South America
132,Arthur,BRA,Leverkusen,Bundesliga,2024,21.0,2003.0,2.3,5,3,2,2,1,1,4,25.0,3,3,0,3,4,9,8,0,DF,20-24,Defender,Brazil,South America
132,Arthur,BRA,Leverkusen,Bundesliga,2024,21.0,2003.0,2.3,5,3,2,2,1,1,4,25.0,3,3,0,3,4,9,8,0,DF,20-24,Defender,Brazil,South America
132,Arthur,BRA,Leverkusen,Bundesliga,2024,21.0,2003.0,2.3,5,3,2,2,1,1,4,25.0,3,3,0,3,4,9,8,0,DF,20-24,Defender,Brazil,South America
133,Takuma Asano,JPN,Mallorca,La Liga,2024,30.0,1994.0,4.4,6,4,1,4,1,3,5,60.0,2,5,0,5,3,9,4,0,"FW,MF",30-34,Forward,Japan,Asia
136,Kristjan Asllani,ALB,Inter,Serie A,2024,22.0,2002.0,3.1,5,0,4,1,0,2,8,25.0,6,6,1,5,2,7,7,0,MF,20-24,Midfielder,Albania,Europe
138,Yaser Asprilla,COL,Girona,La Liga,2024,21.0,2003.0,7.2,12,7,4,6,2,4,10,40.0,6,4,0,4,3,15,4,0,"FW,MF",20-24,Forward,Colombia,South America
140,Dehmaine Assoumani,FRA,Nantes,Ligue 1,2024,19.0,2005.0,0.4,5,2,0,3,2,3,3,100.0,0,0,0,0,1,6,1,0,"MF,FW",Under 20,Midfielder,France,Europe
141,Valentin Atangana Edoa,FRA,Reims,Ligue 1,2024,19.0,2005.0,13.7,31,23,15,13,3,12,16,75.0,4,12,4,8,17,48,24,0,MF,Under 20,Midfielder,France,Europe
142,Arthur Atta,FRA,Udinese,Serie A,2024,21.0,2003.0,1.6,4,2,1,2,1,2,3,66.7,1,1,1,0,0,4,0,1,MF,20-24,Midfielder,France,Europe
143,Noah Atubolu,GER,Freiburg,Bundesliga,2024,22.0,2002.0,13.0,0,0,0,0,0,0,0,,0,0,0,0,0,0,7,2,GK,20-24,Goalkeeper,Germany,Europe
144,Emil Audero,ITA,Como,Serie A,2024,27.0,1997.0,8.0,0,0,0,0,0,0,1,0.0,1,0,0,0,0,0,4,1,GK,25-29,Goalkeeper,Italy,Europe
145,Tommaso Augello,ITA,Cagliari,Serie A,2024,30.0,1994.0,13.7,22,12,12,7,3,13,20,65.0,7,12,4,8,12,34,48,0,DF,30-34,Defender,Italy,Europe
146,Carlos Augusto,BRA,Inter,Serie A,2024,25.0,1999.0,4.2,7,5,2,3,2,4,8,50.0,4,3,2,1,2,9,10,0,DF,25-29,Defender,Brazil,South America
147,Yann Aurel Bisseck,GER,Inter,Serie A,2024,24.0,2000.0,7.6,6,4,4,1,1,4,5,80.0,1,8,3,5,6,12,22,1,DF,20-24,Defender,Germany,Europe
148,Ezequiel Ávila,ARG,Betis,La Liga,2024,30.0,1994.0,6.4,7,3,1,2,4,3,8,37.5,5,4,0,4,1,8,5,0,FW,30-34,Forward,Argentina,South America
149,Taiwo Awoniyi,NGA,Nott'ham Forest,Premier League,2024,27.0,1997.0,2.3,3,1,0,2,1,2,2,100.0,0,1,0,1,0,3,3,0,FW,25-29,Forward,Nigeria,Africa
150,Yasin Ayari,SWE,Brighton,Premier League,2024,21.0,2003.0,9.2,32,15,5,21,6,14,26,53.8,12,9,2,7,8,40,10,0,MF,20-24,Midfielder,Sweden,Europe
151,Florian Ayé,FRA,Auxerre,Ligue 1,2024,27.0,1997.0,3.5,2,2,0,0,2,0,1,0.0,1,3,0,3,3,5,5,0,FW,25-29,Forward,France,Europe
152,André Ayew,GHA,Le Havre,Ligue 1,2024,35.0,1989.0,5.6,6,4,1,3,2,3,5,60.0,2,2,1,1,1,7,4,0,FW,35-39,Forward,Ghana,Africa
153,Jordan Ayew,GHA,Crystal Palace,Premier League,2024,33.0,1991.0,0.2,1,0,0,0,1,0,0,,0,0,0,0,0,1,0,0,"FW,MF",30-34,Forward,Ghana,Africa
154,Jordan Ayew,GHA,Leicester City,Premier League,2024,33.0,1991.0,8.2,12,5,4,6,2,2,8,25.0,6,6,0,6,7,19,3,0,"FW,MF",30-34,Forward,Ghana,Africa
155,Neil El Aynaoui,FRA,Lens,Ligue 1,2024,23.0,2001.0,3.2,11,8,9,2,0,4,14,28.6,10,7,3,4,2,13,5,0,MF,20-24,Midfielder,France,Europe
156,Ayman Azhil,MAR,Dortmund,Bundesliga,2024,23.0,2001.0,0.3,1,1,1,0,0,0,0,,0,0,0,0,0,1,0,0,MF,20-24,Midfielder,Morocco,Africa
157,Adam Aznou,MAR,Bayern Munich,Bundesliga,2024,18.0,2006.0,0.1,0,0,0,0,0,0,0,,0,0,0,0,0,0,0,0,DF,Under 20,Defender,Morocco,Africa
159,Paulo Azzi,BRA,Cagliari,Serie A,2024,30.0,1994.0,4.7,11,9,3,6,2,5,9,55.6,4,5,2,3,5,16,11,0,DF,30-34,Defender,Brazil,South America
161,Shavy Babicka,GAB,Toulouse,Ligue 1,2024,24.0,2000.0,5.6,12,9,3,5,4,7,11,63.6,4,9,0,9,1,13,3,2,"MF,FW",20-24,Midfielder,Gabon,Africa
162,Aliou Badara Baldé,GUI,Bochum,Bundesliga,2024,22.0,2002.0,1.0,1,1,1,0,0,0,0,,0,2,0,2,0,1,0,0,"MF,FW",20-24,Midfielder,Guinea,Africa
163,Loïc Bade,FRA,Sevilla,La Liga,2024,24.0,2000.0,13.2,28,17,20,8,0,12,16,75.0,4,11,7,4,14,42,59,1,DF,20-24,Defender,France,Europe
164,Milan Badelj,CRO,Genoa,Serie A,2024,35.0,1989.0,11.7,20,10,10,5,5,9,23,39.1,14,14,6,8,15,35,31,0,MF,35-39,Midfielder,Croatia,Europe
165,Benoît Badiashile,FRA,Chelsea,Premier League,2024,23.0,2001.0,2.8,6,4,3,3,0,2,2,100.0,0,2,2,0,6,12,6,1,DF,20-24,Defender,France,Europe
167,Leon Bailey,JAM,Aston Villa,Premier League,2024,27.0,1997.0,8.1,3,1,0,1,2,0,3,0.0,3,6,0,6,2,5,7,0,"FW,MF",25-29,Forward,Jamaica,North America
168,Eric Bailly,CIV,Villarreal,La Liga,2024,30.0,1994.0,6.4,11,3,5,6,0,2,3,66.7,1,11,6,5,6,17,24,0,DF,30-34,Defender,Ivory Coast,Africa
169,Theo Bair,CAN,Auxerre,Ligue 1,2024,25.0,1999.0,4.6,2,1,0,1,1,0,0,,0,5,2,3,0,2,5,0,FW,25-29,Forward,Canada,North America
170,Cédric Bakambu,COD,Betis,La Liga,2024,33.0,1991.0,3.1,1,0,0,1,0,0,1,0.0,1,4,0,4,0,1,1,0,FW,30-34,Forward,DR Congo,Africa
171,Mitchel Bakker,NED,Atalanta,Serie A,2024,24.0,2000.0,0.2,1,0,1,0,0,1,1,100.0,0,0,0,0,0,1,0,0,MF,20-24,Midfielder,Netherlands,Europe
172,Mitchel Bakker,NED,Lille,Ligue 1,2024,24.0,2000.0,4.3,14,11,5,6,3,6,11,54.5,5,3,0,3,7,21,9,0,"DF,FW",20-24,Defender,Netherlands,Europe
173,Ridle Baku,GER,Wolfsburg,Bundesliga,2024,26.0,1998.0,13.0,23,15,9,9,5,8,19,42.1,11,22,1,21,15,38,15,0,"FW,MF",25-29,Forward,Germany,Europe
174,Dilane Bakwa,FRA,Strasbourg,Ligue 1,2024,22.0,2002.0,14.5,13,9,7,3,3,6,14,42.9,8,13,0,13,6,19,16,0,"FW,MF",20-24,Forward,France,Europe
175,Tommaso Baldanzi,ITA,Roma,Serie A,2024,21.0,2003.0,4.3,6,1,3,1,2,1,4,25.0,3,2,0,2,4,10,2,0,"MF,FW",20-24,Midfielder,Italy,Europe
177,Carlos Baleba,CMR,Brighton,Premier League,2024,20.0,2004.0,11.0,30,16,5,17,8,18,29,62.1,11,17,4,13,23,53,7,0,MF,20-24,Midfielder,Cameroon,Africa
178,Leonardo Balerdi,ARG,Marseille,Ligue 1,2024,25.0,1999.0,11.0,18,14,13,4,1,11,20,55.0,9,16,10,6,14,32,32,3,DF,25-29,Defender,Argentina,South America
179,Iván Balliu,ALB,Rayo Vallecano,La Liga,2024,32.0,1992.0,7.6,10,8,2,5,3,3,11,27.3,8,6,2,4,6,16,20,0,DF,30-34,Defender,Albania,Europe
180,Botond Balogh,HUN,Parma,Serie A,2024,22.0,2002.0,14.8,23,9,16,7,0,12,17,70.6,5,27,21,6,18,41,89,2,DF,20-24,Defender,Hungary,Europe
181,Folarin Balogun,USA,Monaco,Ligue 1,2024,23.0,2001.0,5.2,0,0,0,0,0,0,2,0.0,2,0,0,0,0,0,0,0,FW,20-24,Forward,United States,North America
182,Mario Balotelli,ITA,Genoa,Serie A,2024,34.0,1990.0,0.7,0,0,0,0,0,0,0,,0,0,0,0,0,0,1,0,"FW,MF",30-34,Forward,Italy,Europe
183,Abdoulaye Bamba,CIV,Angers,Ligue 1,2024,34.0,1990.0,6.8,12,6,10,2,0,7,9,77.8,2,5,3,2,7,19,31,0,DF,30-34,Defender,Ivory Coast,Africa
184,Jonathan Bamba,CIV,Celta Vigo,La Liga,2024,28.0,1996.0,8.3,10,5,3,5,2,4,10,40.0,6,6,0,6,5,15,6,0,"FW,MF",25-29,Forward,Ivory Coast,Africa
185,Mohamed Bamba,CIV,Reims,Ligue 1,2024,20.0,2004.0,0.0,0,0,0,0,0,0,0,,0,1,0,1,0,0,0,0,MF,20-24,Midfielder,Ivory Coast,Africa
185,Mohamed Bamba,CIV,Reims,Ligue 1,2024,20.0,2004.0,0.0,0,0,0,0,0,0,0,,0,1,0,1,0,0,0,0,MF,20-24,Midfielder,Ivory Coast,Africa
185,Mohamed Bamba,CIV,Reims,Ligue 1,2024,20.0,2004.0,0.0,0,0,0,0,0,0,0,,0,1,0,1,0,0,0,0,MF,20-24,Midfielder,Ivory Coast,Africa
185,Mohamed Bamba,CIV,Reims,Ligue 1,2024,20.0,2004.0,0.0,0,0,0,0,0,0,0,,0,1,0,1,0,0,0,0,MF,20-24,Midfielder,Ivory Coast,Africa
186,Samuel Bamba,GER,Bochum,Bundesliga,2024,20.0,2004.0,0.1,0,0,0,0,0,0,0,,0,0,0,0,0,0,0,0,"FW,MF",20-24,Forward,Germany,Europe
187,Lameck Banda,ZAM,Lecce,Serie A,2024,23.0,2001.0,5.6,5,4,4,1,0,3,10,30.0,7,6,0,6,1,6,6,0,"FW,MF",20-24,Forward,Zambia,Africa
188,Daniel Bandeira,POR,Hellas Verona,Serie A,2024,24.0,2000.0,4.5,4,0,1,3,0,3,6,50.0,3,2,1,1,6,10,8,0,MF,20-24,Midfielder,Portugal,Europe
189,Mattia Bani,ITA,Genoa,Serie A,2024,31.0,1993.0,8.9,6,3,4,2,0,3,5,60.0,2,7,4,3,14,20,34,2,DF,30-34,Defender,Italy,Europe
190,Scott Banks,SCO,St. Pauli,Bundesliga,2024,23.0,2001.0,0.6,0,0,0,0,0,0,2,0.0,2,0,0,0,1,1,2,0,"FW,MF",20-24,Forward,Scotland,Europe
193,Federico Barba,ITA,Como,Serie A,2024,31.0,1993.0,4.8,2,2,1,1,0,1,4,25.0,3,2,2,0,4,6,15,0,DF,30-34,Defender,Italy,Europe
194,Valentín Barco,ARG,Sevilla,La Liga,2024,20.0,2004.0,3.2,15,9,8,3,4,12,15,80.0,3,0,0,0,2,17,5,0,"DF,FW",20-24,Defender,Argentina,South America
195,Bradley Barcola,FRA,Paris S-G,Ligue 1,2024,22.0,2002.0,11.7,12,6,5,5,2,1,13,7.7,12,11,0,11,8,20,4,0,FW,20-24,Forward,France,Europe
196,Melvin Bard,FRA,Nice,Ligue 1,2024,24.0,2000.0,6.5,21,11,16,5,0,9,14,64.3,5,11,6,5,7,28,15,2,"DF,MF",20-24,Defender,France,Europe
197,Nicolò Barella,ITA,Inter,Serie A,2024,27.0,1997.0,11.4,22,12,6,11,5,10,27,37.0,17,11,0,11,5,27,5,1,MF,25-29,Midfielder,Italy,Europe
198,Gabriel Bares,SUI,Montpellier,Ligue 1,2024,24.0,2000.0,0.6,2,2,2,0,0,1,2,50.0,1,0,0,0,1,3,3,0,"MF,DF",20-24,Midfielder,Switzerland,Europe
200,Ross Barkley,ENG,Aston Villa,Premier League,2024,31.0,1993.0,5.0,9,2,4,5,0,7,10,70.0,3,7,2,5,5,14,4,0,MF,30-34,Midfielder,England,Europe
201,Aymen Barkok,MAR,Mainz 05,Bundesliga,2024,26.0,1998.0,0.8,2,1,1,1,0,1,1,100.0,0,1,1,0,2,4,0,0,MF,25-29,Midfielder,Morocco,Africa
202,Harvey Barnes,ENG,Newcastle Utd,Premier League,2024,27.0,1997.0,8.3,9,5,3,4,2,3,5,60.0,2,4,1,3,4,13,5,1,FW,25-29,Forward,England,Europe
203,Enzo Barrenechea,ARG,Valencia,La Liga,2024,23.0,2001.0,8.0,16,8,8,5,3,7,14,50.0,7,11,3,8,7,23,14,0,MF,20-24,Midfielder,Argentina,South America
206,Thierno Barry,FRA,Villarreal,La Liga,2024,22.0,2002.0,12.4,6,4,2,3,1,2,5,40.0,3,11,2,9,0,6,6,0,FW,20-24,Forward,France,Europe
207,Davide Bartesaghi,ITA,Milan,Serie A,2024,18.0,2005.0,0.1,0,0,0,0,0,0,0,,0,0,0,0,0,0,0,0,DF,Under 20,Defender,Italy,Europe
209,Federico Baschirotto,ITA,Lecce,Serie A,2024,28.0,1996.0,17.0,20,16,14,4,2,12,15,80.0,3,24,18,6,15,35,71,0,DF,25-29,Defender,Italy,Europe
210,Daniele Baselli,ITA,Como,Serie A,2024,32.0,1992.0,0.2,0,0,0,0,0,0,0,,0,0,0,0,1,1,1,0,MF,30-34,Midfielder,Italy,Europe
211,Calvin Bassey,NGA,Fulham,Premier League,2024,24.0,1999.0,16.0,19,12,12,7,0,8,11,72.7,3,27,13,14,7,26,51,3,DF,20-24,Defender,Nigeria,Africa
212,Aboubacar Bassinga,CIV,Las Palmas,La Liga,2024,19.0,2005.0,0.0,0,0,0,0,0,0,0,,0,0,0,0,0,0,0,0,MF,Under 20,Midfielder,Ivory Coast,Africa
213,Alessandro Bastoni,ITA,Inter,Serie A,2024,25.0,1999.0,12.7,22,13,10,9,3,10,15,66.7,5,10,4,6,11,33,17,1,DF,25-29,Defender,Italy,Europe
214,Augusto Batalla,ARG,Rayo Vallecano,La Liga,2024,28.0,1996.0,14.0,1,1,1,0,0,1,2,50.0,1,0,0,0,0,1,5,3,GK,25-29,Goalkeeper,Argentina,South America
215,Dylan Batubinsika,COD,Saint-Étienne,Ligue 1,2024,28.0,1996.0,13.6,15,8,11,3,1,7,13,53.8,6,16,8,8,29,44,72,3,DF,25-29,Defender,DR Congo,Africa
216,Maximilian Bauer,GER,Augsburg,Bundesliga,2024,24.0,2000.0,7.0,13,7,5,7,1,8,13,61.5,5,9,3,6,6,19,33,1,DF,20-24,Defender,Germany,Europe
217,Oliver Baumann,GER,Hoffenheim,Bundesliga,2024,34.0,1990.0,15.0,1,1,1,0,0,1,2,50.0,1,0,0,0,0,1,7,0,GK,30-34,Goalkeeper,Germany,Europe
218,Christoph Baumgartner,AUT,RB Leipzig,Bundesliga,2024,25.0,1999.0,9.0,19,13,3,10,6,7,26,26.9,19,20,6,14,9,28,9,1,MF,25-29,Midfielder,Austria,Europe
220,Adrian Beck,GER,Heidenheim,Bundesliga,2024,27.0,1997.0,4.8,16,6,11,5,0,5,15,33.3,10,16,1,15,4,20,10,0,"FW,MF",25-29,Forward,Germany,Europe
221,Sheraldo Becker,SUR,Real Sociedad,La Liga,2024,29.0,1995.0,7.6,2,2,0,2,0,0,2,0.0,2,4,0,4,1,3,8,0,"FW,MF",25-29,Forward,Suriname,South America
222,Timo Becker,GER,Holstein Kiel,Bundesliga,2024,27.0,1997.0,11.5,19,12,14,5,0,13,19,68.4,6,9,6,3,7,26,32,0,DF,25-29,Defender,Germany,Europe
224,Donny van de Beek,NED,Girona,La Liga,2024,27.0,1997.0,9.7,20,11,12,4,4,9,16,56.3,7,13,2,11,4,24,7,0,MF,25-29,Midfielder,Netherlands,Europe
225,Kevin Behrens,GER,Wolfsburg,Bundesliga,2024,33.0,1991.0,1.2,1,1,0,1,0,0,1,0.0,1,0,0,0,0,1,1,0,FW,30-34,Forward,Germany,Europe
226,Maximilian Beier,GER,Dortmund,Bundesliga,2024,22.0,2002.0,8.6,16,11,5,7,4,6,18,33.3,12,12,1,11,5,21,7,1,"FW,MF",20-24,Forward,Germany,Europe
227,Reda Belahyane,MAR,Hellas Verona,Serie A,2024,20.0,2004.0,14.8,28,18,11,10,7,10,12,83.3,2,16,5,11,7,35,13,0,MF,20-24,Midfielder,Morocco,Africa
228,Haris Belkebla,ALG,Angers,Ligue 1,2024,30.0,1994.0,10.0,19,13,13,5,1,9,18,50.0,9,12,2,10,16,35,21,1,MF,30-34,Midfielder,Algeria,Africa
229,Yassin Belkhdim,FRA,Angers,Ligue 1,2024,22.0,2002.0,6.4,30,15,13,11,6,13,29,44.8,16,11,2,9,9,39,13,0,"MF,FW",20-24,Midfielder,France,Europe
230,Stefan Bell,GER,Mainz 05,Bundesliga,2024,33.0,1991.0,8.8,11,5,9,2,0,4,8,50.0,4,8,8,0,18,29,59,0,DF,30-34,Defender,Germany,Europe
231,Raoul Bellanova,ITA,Torino,Serie A,2024,24.0,2000.0,1.0,0,0,0,0,0,0,1,0.0,1,0,0,0,0,0,4,0,DF,20-24,Defender,Italy,Europe
232,Raoul Bellanova,ITA,Atalanta,Serie A,2024,24.0,2000.0,11.4,8,6,2,4,2,3,6,50.0,3,6,2,4,10,18,10,0,DF,20-24,Defender,Italy,Europe
233,Jean-Ricner Bellegarde,FRA,Wolves,Premier League,2024,26.0,1998.0,8.1,10,6,4,4,2,4,6,66.7,2,9,2,7,6,16,7,0,"MF,FW",25-29,Midfielder,France,Europe
235,Jude Bellingham,ENG,Real Madrid,La Liga,2024,21.0,2003.0,12.7,29,16,12,12,5,14,20,70.0,6,20,2,18,13,42,12,0,MF,20-24,Midfielder,England,Europe
236,Jeanuël Belocian,FRA,Leverkusen,Bundesliga,2024,19.0,2005.0,0.8,1,1,1,0,0,1,1,100.0,0,0,0,0,0,1,2,0,"DF,MF",Under 20,Defender,France,Europe
237,Andrea Belotti,ITA,Como,Serie A,2024,31.0,1993.0,6.0,7,5,1,4,2,1,4,25.0,3,3,0,3,1,8,8,0,FW,30-34,Forward,Italy,Europe
239,Lucas Beltrán,ARG,Fiorentina,Serie A,2024,23.0,2001.0,8.4,11,6,4,5,2,3,7,42.9,4,7,1,6,3,14,3,0,"MF,FW",20-24,Midfielder,Argentina,South America
240,Eliesse Ben Seghir,MAR,Monaco,Ligue 1,2024,19.0,2005.0,11.6,20,16,6,10,4,12,19,63.2,7,12,0,12,6,26,1,0,"MF,FW",Under 20,Midfielder,Morocco,Africa
241,Carlos Benavídez,URU,Alavés,La Liga,2024,26.0,1998.0,2.6,5,3,2,2,1,0,3,0.0,3,1,1,0,6,11,3,1,MF,25-29,Midfielder,Uruguay,South America
243,László Bénes,SVK,Union Berlin,Bundesliga,2024,27.0,1997.0,2.1,1,1,0,1,0,0,1,0.0,1,2,1,1,0,1,1,0,"MF,FW",25-29,Midfielder,Slovakia,Europe
245,Ismaël Bennacer,ALG,Milan,Serie A,2024,27.0,1997.0,0.6,1,1,0,1,0,0,0,,0,0,0,0,0,1,0,0,MF,25-29,Midfielder,Algeria,Africa
246,Saïd Benrahma,ALG,Lyon,Ligue 1,2024,29.0,1995.0,6.6,7,4,3,3,1,2,7,28.6,5,6,0,6,2,9,1,0,"FW,MF",25-29,Forward,Algeria,Africa
247,Ramy Bensebaini,ALG,Dortmund,Bundesliga,2024,29.0,1995.0,9.8,24,11,14,8,2,14,22,63.6,8,26,3,23,13,37,31,1,DF,25-29,Defender,Algeria,Africa
248,Rodrigo Bentancur,URU,Tottenham,Premier League,2024,27.0,1997.0,5.9,19,9,9,9,1,11,16,68.8,5,5,0,5,16,35,5,0,MF,25-29,Midfielder,Uruguay,South America
249,Lucas Beraldo,BRA,Paris S-G,Ligue 1,2024,21.0,2003.0,9.1,16,14,12,4,0,10,20,50.0,10,6,2,4,8,24,15,1,DF,20-24,Defender,Brazil,South America
253,Lucas Bergvall,SWE,Tottenham,Premier League,2024,18.0,2006.0,2.3,9,5,2,5,2,6,9,66.7,3,1,1,0,5,14,3,0,MF,Under 20,Midfielder,Sweden,Europe
254,Medon Berisha,ALB,Lecce,Serie A,2024,21.0,2003.0,2.7,3,2,2,1,0,1,3,33.3,2,1,0,1,3,6,2,0,MF,20-24,Midfielder,Albania,Europe
255,Mergim Berisha,GER,Hoffenheim,Bundesliga,2024,26.0,1998.0,3.7,3,3,1,2,0,0,3,0.0,3,2,1,1,0,3,3,0,"FW,MF",25-29,Forward,Germany,Europe
258,Bernardo,BRA,Bochum,Bundesliga,2024,29.0,1995.0,3.8,10,5,9,1,0,7,8,87.5,1,9,5,4,6,16,8,0,DF,25-29,Defender,Brazil,South America
258,Bernardo,BRA,Bochum,Bundesliga,2024,29.0,1995.0,3.8,10,5,9,1,0,7,8,87.5,1,9,5,4,6,16,8,0,DF,25-29,Defender,Brazil,South America
258,Bernardo,BRA,Bochum,Bundesliga,2024,29.0,1995.0,3.8,10,5,9,1,0,7,8,87.5,1,9,5,4,6,16,8,0,DF,25-29,Defender,Brazil,South America
258,Bernardo,BRA,Bochum,Bundesliga,2024,29.0,1995.0,3.8,10,5,9,1,0,7,8,87.5,1,9,5,4,6,16,8,0,DF,25-29,Defender,Brazil,South America
260,Alexander Bernhardsson,SWE,Holstein Kiel,Bundesliga,2024,26.0,1998.0,3.5,5,4,1,1,3,4,6,66.7,2,4,0,4,0,5,5,0,"DF,FW",25-29,Defender,Sweden,Europe
261,Victor Bernth Kristiansen,DEN,Leicester City,Premier League,2024,22.0,2002.0,14.5,51,32,35,15,1,28,48,58.3,20,24,10,14,18,69,37,2,DF,20-24,Defender,Denmark,Europe
262,Matúš Bero,SVK,Bochum,Bundesliga,2024,29.0,1995.0,12.2,20,9,8,8,4,8,29,27.6,21,20,3,17,8,28,8,1,MF,25-29,Midfielder,Slovakia,Europe
264,Dimitry Bertaud,COD,Montpellier,Ligue 1,2024,26.0,1998.0,3.0,0,0,0,0,0,0,0,,0,0,0,0,0,0,2,0,GK,25-29,Goalkeeper,DR Congo,Africa
265,Beto,GNB,Everton,Premier League,2024,26.0,1998.0,2.3,3,0,0,2,1,1,2,50.0,1,1,0,1,0,3,2,0,FW,25-29,Forward,Guinea-Bissau,Africa
265,Beto,GNB,Everton,Premier League,2024,26.0,1998.0,2.3,3,0,0,2,1,1,2,50.0,1,1,0,1,0,3,2,0,FW,25-29,Forward,Guinea-Bissau,Africa
265,Beto,GNB,Everton,Premier League,2024,26.0,1998.0,2.3,3,0,0,2,1,1,2,50.0,1,1,0,1,0,3,2,0,FW,25-29,Forward,Guinea-Bissau,Africa
265,Beto,GNB,Everton,Premier League,2024,26.0,1998.0,2.3,3,0,0,2,1,1,2,50.0,1,1,0,1,0,3,2,0,FW,25-29,Forward,Guinea-Bissau,Africa
266,Sam Beukema,NED,Bologna,Serie A,2024,26.0,1998.0,15.5,16,6,7,8,1,5,15,33.3,10,16,12,4,13,29,49,0,DF,25-29,Defender,Netherlands,Europe
267,Alessandro Bianco,ITA,Monza,Serie A,2024,22.0,2002.0,11.1,24,15,9,11,4,15,21,71.4,6,11,2,9,6,30,18,4,MF,20-24,Midfielder,Italy,Europe
268,Alessandro Bianco,ITA,Fiorentina,Serie A,2024,22.0,2002.0,0.2,0,0,0,0,0,0,1,0.0,1,0,0,0,0,0,0,0,MF,20-24,Midfielder,Italy,Europe
270,El Bilal Touré,MLI,Stuttgart,Bundesliga,2024,23.0,2001.0,3.5,3,1,1,1,1,3,3,100.0,0,1,0,1,0,3,1,0,"FW,MF",20-24,Forward,Mali,Africa
271,Philip Billing,DEN,Bournemouth,Premier League,2024,28.0,1996.0,0.9,9,2,5,4,0,2,2,100.0,0,1,0,1,3,12,2,0,MF,25-29,Midfielder,Denmark,Europe
272,Cristiano Biraghi,ITA,Fiorentina,Serie A,2024,32.0,1992.0,4.8,4,4,1,3,0,2,7,28.6,5,2,0,2,4,8,11,0,DF,30-34,Defender,Italy,Europe
273,Samuele Birindelli,ITA,Monza,Serie A,2024,25.0,1999.0,4.2,10,8,2,4,4,3,5,60.0,2,2,1,1,2,12,7,0,"DF,MF",25-29,Defender,Italy,Europe
274,Tom Bischof,GER,Hoffenheim,Bundesliga,2024,19.0,2005.0,11.4,50,27,15,28,7,20,35,57.1,15,26,5,21,13,63,20,0,MF,Under 20,Midfielder,Germany,Europe
275,Yves Bissouma,MLI,Tottenham,Premier League,2024,28.0,1996.0,9.2,29,19,12,15,2,14,23,60.9,9,5,2,3,11,40,20,2,MF,25-29,Midfielder,Mali,Africa
276,Leonardo Bittencourt,GER,Werder Bremen,Bundesliga,2024,31.0,1993.0,5.3,8,3,4,3,1,3,8,37.5,5,6,0,6,7,15,7,0,MF,30-34,Midfielder,Germany,Europe
277,Emmanuel Biumla,FRA,Angers,Ligue 1,2024,19.0,2005.0,8.1,14,7,10,4,0,9,14,64.3,5,11,5,6,6,20,37,0,DF,Under 20,Defender,France,Europe
278,Marco Bizot,NED,Brest,Ligue 1,2024,33.0,1991.0,14.0,1,1,1,0,0,0,0,,0,0,0,0,0,1,11,0,GK,30-34,Goalkeeper,Netherlands,Europe
279,Bjarki Bjarkason,ISL,Venezia,Serie A,2024,24.0,2000.0,0.0,1,1,1,0,0,0,0,,0,0,0,0,0,1,1,0,DF,20-24,Defender,Iceland,Europe
281,Ludovic Blas,FRA,Rennes,Ligue 1,2024,26.0,1997.0,13.5,18,13,3,6,9,12,23,52.2,11,11,2,9,4,22,3,0,"MF,FW",25-29,Midfielder,France,Europe
282,Daley Blind,NED,Girona,La Liga,2024,34.0,1990.0,13.1,21,10,10,10,1,12,17,70.6,5,17,6,11,14,35,38,1,DF,30-34,Defender,Netherlands,Europe
283,Myron Boadu,NED,Bochum,Bundesliga,2024,23.0,2001.0,3.9,0,0,0,0,0,0,1,0.0,1,1,0,1,0,0,3,0,FW,20-24,Forward,Netherlands,Europe
284,Augustine Boakye,GHA,Saint-Étienne,Ligue 1,2024,24.0,2000.0,3.7,4,2,1,3,0,2,8,25.0,6,1,0,1,4,8,2,0,"MF,FW",20-24,Midfielder,Ghana,Africa
285,Sacha Boey,FRA,Bayern Munich,Bundesliga,2024,24.0,2000.0,3.1,10,3,4,2,4,5,7,71.4,2,3,0,3,1,11,4,0,DF,20-24,Defender,France,Europe
286,Jeremie Boga,CIV,Nice,Ligue 1,2024,27.0,1997.0,6.9,6,4,1,5,0,2,3,66.7,1,9,0,9,2,8,1,0,"MF,FW",25-29,Midfielder,Ivory Coast,Africa
287,Lamare Bogarde,NED,Aston Villa,Premier League,2024,20.0,2004.0,2.4,8,4,2,5,1,5,9,55.6,4,2,0,2,1,9,4,0,DF,20-24,Defender,Netherlands,Europe
290,Willy Boly,CIV,Nott'ham Forest,Premier League,2024,33.0,1991.0,1.0,5,1,4,1,0,4,4,100.0,0,3,1,2,1,6,11,0,DF,30-34,Defender,Ivory Coast,Africa
291,Moïse Bombito,CAN,Nice,Ligue 1,2024,24.0,2000.0,12.7,17,12,9,8,0,14,21,66.7,7,18,10,8,9,26,67,1,DF,20-24,Defender,Canada,North America
292,Warren Bondo,FRA,Monza,Serie A,2024,21.0,2003.0,14.9,29,18,18,7,4,11,16,68.8,5,15,6,9,5,34,6,3,MF,20-24,Midfielder,France,Europe
293,Victor Boniface,NGA,Leverkusen,Bundesliga,2024,24.0,2000.0,7.3,4,3,0,3,1,2,2,100.0,0,1,0,1,0,4,4,0,FW,20-24,Forward,Nigeria,Africa
294,Ange-Yoan Bonny,FRA,Parma,Serie A,2024,21.0,2003.0,13.0,14,8,2,9,3,4,8,50.0,4,7,0,7,0,14,5,0,FW,20-24,Forward,France,Europe
295,Sebastiaan Bornauw,BEL,Wolfsburg,Bundesliga,2024,25.0,1999.0,7.0,7,4,2,4,1,2,6,33.3,4,13,12,1,9,16,26,0,DF,25-29,Defender,Belgium,Europe
296,Saïmon Bouabré,FRA,Monaco,Ligue 1,2024,18.0,2006.0,0.1,0,0,0,0,0,0,2,0.0,2,1,0,1,0,0,0,0,MF,Under 20,Midfielder,France,Europe
297,Ayyoub Bouaddi,FRA,Lille,Ligue 1,2024,17.0,2007.0,5.8,23,15,12,6,5,7,13,53.8,6,4,0,4,6,29,4,0,MF,Under 20,Midfielder,France,Europe
298,Badredine Bouanani,ALG,Nice,Ligue 1,2024,20.0,2004.0,5.5,3,1,1,1,1,0,5,0.0,5,9,2,7,3,6,3,0,"MF,FW",20-24,Midfielder,Algeria,Africa
299,Benjamin Bouchouari,MAR,Saint-Étienne,Ligue 1,2024,23.0,2001.0,7.2,14,11,5,6,3,9,18,50.0,9,7,1,6,8,22,6,1,MF,20-24,Midfielder,Morocco,Africa
300,Hicham Boudaoui,ALG,Nice,Ligue 1,2024,25.0,1999.0,10.9,35,19,15,14,6,15,26,57.7,11,17,4,13,12,47,23,0,MF,25-29,Midfielder,Algeria,Africa
301,Carlo Boukhalfa,MAR,St. Pauli,Bundesliga,2024,25.0,1999.0,10.3,19,6,5,13,1,5,10,50.0,5,13,3,10,10,29,15,1,MF,25-29,Midfielder,Morocco,Africa
302,Benjamin Bourigeaud,FRA,Rennes,Ligue 1,2024,30.0,1994.0,0.9,1,0,0,1,0,0,2,0.0,2,2,1,1,2,3,1,0,MF,30-34,Midfielder,France,Europe
303,Edoardo Bove,ITA,Fiorentina,Serie A,2024,22.0,2002.0,9.3,24,17,7,14,3,14,28,50.0,14,12,0,12,6,30,8,0,"MF,FW",20-24,Midfielder,Italy,Europe
304,Jarrod Bowen,ENG,West Ham,Premier League,2024,28.0,1996.0,16.7,25,15,8,6,11,11,26,42.3,15,11,2,9,11,36,17,0,"FW,MF",25-29,Forward,England,Europe
305,Enzo Boyomo,CMR,Osasuna,La Liga,2024,23.0,2001.0,15.0,29,19,21,6,2,13,16,81.3,3,20,13,7,18,47,68,2,DF,20-24,Defender,Cameroon,Africa
306,Enzo Boyomo,CMR,Valladolid,La Liga,2024,23.0,2001.0,3.0,6,2,4,2,0,3,3,100.0,0,4,3,1,1,7,7,0,DF,20-24,Defender,Cameroon,Africa
307,Domagoj Bradarić,CRO,Hellas Verona,Serie A,2024,25.0,1999.0,6.4,12,9,10,1,1,7,12,58.3,5,5,2,3,2,14,18,0,DF,25-29,Defender,Croatia,Europe
309,Bilal Brahimi,ALG,Nice,Ligue 1,2024,24.0,2000.0,0.8,0,0,0,0,0,0,0,,0,1,0,1,0,0,2,0,MF,20-24,Midfielder,Algeria,Africa
310,Julian Brandt,GER,Dortmund,Bundesliga,2024,28.0,1996.0,10.9,10,4,6,3,1,7,18,38.9,11,6,0,6,4,14,7,0,MF,25-29,Midfielder,Germany,Europe
311,Jarrad Branthwaite,ENG,Everton,Premier League,2024,22.0,2002.0,7.1,15,6,12,3,0,7,9,77.8,2,7,3,4,10,25,28,1,DF,20-24,Defender,England,Europe
313,Lilian Brassier,FRA,Marseille,Ligue 1,2024,25.0,1999.0,7.0,6,5,6,0,0,3,4,75.0,1,7,2,5,4,10,25,1,DF,25-29,Defender,France,Europe
314,Matthias Braunöder,AUT,Como,Serie A,2024,22.0,2002.0,3.0,10,4,6,3,1,7,11,63.6,4,3,0,3,2,12,4,1,MF,20-24,Midfielder,Austria,Europe
316,James Bree,ENG,Southampton,Premier League,2024,27.0,1997.0,1.6,4,2,1,3,0,2,3,66.7,1,2,1,1,2,6,6,0,DF,25-29,Defender,England,Europe
317,Tim Breithaupt,GER,Augsburg,Bundesliga,2024,22.0,2002.0,1.3,1,1,0,1,0,0,4,0.0,4,1,0,1,2,3,0,0,MF,20-24,Midfielder,Germany,Europe
318,Gleison Bremer,BRA,Juventus,Serie A,2024,27.0,1997.0,6.0,15,7,9,5,1,4,5,80.0,1,15,11,4,6,21,16,0,DF,25-29,Defender,Brazil,South America
319,Brenner,BRA,Udinese,Serie A,2024,24.0,2000.0,4.3,6,4,2,3,1,3,8,37.5,5,4,0,4,1,7,6,0,"MF,FW",20-24,Midfielder,Brazil,South America
319,Brenner,BRA,Udinese,Serie A,2024,24.0,2000.0,4.3,6,4,2,3,1,3,8,37.5,5,4,0,4,1,7,6,0,"MF,FW",20-24,Midfielder,Brazil,South America
319,Brenner,BRA,Udinese,Serie A,2024,24.0,2000.0,4.3,6,4,2,3,1,3,8,37.5,5,4,0,4,1,7,6,0,"MF,FW",20-24,Midfielder,Brazil,South America
319,Brenner,BRA,Udinese,Serie A,2024,24.0,2000.0,4.3,6,4,2,3,1,3,8,37.5,5,4,0,4,1,7,6,0,"MF,FW",20-24,Midfielder,Brazil,South America
320,Ben Brereton,CHI,Southampton,Premier League,2024,25.0,1999.0,5.0,3,2,0,2,1,1,9,11.1,8,2,1,1,0,3,4,0,FW,25-29,Forward,Chile,South America
321,Marco Brescianini,ITA,Atalanta,Serie A,2024,24.0,2000.0,5.6,5,2,1,3,1,2,3,66.7,1,9,1,8,1,6,4,0,MF,20-24,Midfielder,Italy,Europe
322,Maximilian Breunig,GER,Heidenheim,Bundesliga,2024,24.0,2000.0,3.6,4,3,1,2,1,3,6,50.0,3,9,2,7,1,5,3,0,"FW,MF",20-24,Forward,Germany,Europe
323,Nathan Broadhead,WAL,Ipswich Town,Premier League,2024,26.0,1998.0,0.6,2,2,1,1,0,1,1,100.0,0,1,0,1,0,2,0,0,"FW,MF",25-29,Forward,Wales,Europe
324,Armando Broja,ALB,Everton,Premier League,2024,23.0,2001.0,0.4,1,0,0,1,0,0,0,,0,0,0,0,0,1,1,0,FW,20-24,Forward,Albania,Europe
325,David Brooks,WAL,Bournemouth,Premier League,2024,27.0,1997.0,2.0,3,1,0,3,0,1,3,33.3,2,4,1,3,2,5,1,1,"FW,MF",25-29,Forward,Wales,Europe
326,Moritz Broschinski,GER,Bochum,Bundesliga,2024,24.0,2000.0,9.7,13,9,4,4,5,1,9,11.1,8,12,0,12,0,13,10,0,"FW,MF",20-24,Forward,Germany,Europe
327,Nathaniel Brown,GER,Eint Frankfurt,Bundesliga,2024,21.0,2003.0,6.3,17,12,7,6,4,10,14,71.4,4,7,0,7,2,19,18,0,"DF,MF",20-24,Defender,Germany,Europe
328,Jacob Bruun Larsen,DEN,Hoffenheim,Bundesliga,2024,26.0,1998.0,4.4,4,3,1,2,1,3,8,37.5,5,5,1,4,1,5,2,0,"FW,MF",25-29,Forward,Denmark,Europe
329,Tajon Buchanan,CAN,Inter,Serie A,2024,25.0,1999.0,0.6,1,0,1,0,0,1,2,50.0,1,0,0,0,0,1,2,0,"DF,FW",25-29,Defender,Canada,North America
330,Ante Budimir,CRO,Osasuna,La Liga,2024,33.0,1991.0,15.3,10,5,1,7,2,2,5,40.0,3,12,3,9,1,11,12,0,FW,30-34,Forward,Croatia,Europe
331,Emi Buendía,ARG,Aston Villa,Premier League,2024,28.0,1996.0,0.5,3,3,2,1,0,0,2,0.0,2,4,0,4,0,3,1,0,"MF,FW",25-29,Midfielder,Argentina,South America
333,Santiago Bueno,URU,Wolves,Premier League,2024,26.0,1998.0,8.8,13,7,9,4,0,8,11,72.7,3,16,10,6,4,17,25,0,DF,25-29,Defender,Uruguay,South America
334,Marius Bülter,GER,Hoffenheim,Bundesliga,2024,31.0,1993.0,8.9,6,6,1,4,1,6,8,75.0,2,3,1,2,1,7,4,0,FW,30-34,Forward,Germany,Europe
335,Facundo Buonanotte,ARG,Leicester City,Premier League,2024,20.0,2004.0,10.2,27,13,9,10,8,12,44,27.3,32,24,5,19,7,34,7,0,"MF,FW",20-24,Midfielder,Argentina,South America
336,Alessandro Buongiorno,ITA,Napoli,Serie A,2024,25.0,1999.0,15.0,25,16,16,9,0,17,20,85.0,3,21,13,8,24,49,43,1,DF,25-29,Defender,Italy,Europe
337,Cameron Burgess,AUS,Ipswich Town,Premier League,2024,29.0,1995.0,9.0,7,5,5,2,0,3,3,100.0,0,11,9,2,6,13,61,1,DF,25-29,Defender,Australia,Oceania
338,Jonathan Burkardt,GER,Mainz 05,Bundesliga,2024,24.0,2000.0,11.7,5,3,1,2,2,1,4,25.0,3,6,1,5,0,5,11,0,FW,20-24,Forward,Germany,Europe
339,Oliver Burke,SCO,Werder Bremen,Bundesliga,2024,27.0,1997.0,1.3,6,2,3,0,3,2,3,66.7,1,2,0,2,0,6,1,0,"FW,MF",25-29,Forward,Scotland,Europe
340,Dan Burn,ENG,Newcastle Utd,Premier League,2024,32.0,1992.0,16.0,17,11,11,6,0,11,20,55.0,9,15,11,4,11,28,70,1,DF,30-34,Defender,England,Europe
341,Wes Burns,WAL,Ipswich Town,Premier League,2024,30.0,1994.0,8.1,7,7,1,5,1,3,9,33.3,6,5,1,4,7,14,7,2,FW,30-34,Forward,Wales,Europe
342,Marnon Busch,GER,Heidenheim,Bundesliga,2024,30.0,1994.0,5.2,8,5,5,3,0,8,11,72.7,3,9,5,4,7,15,23,2,"DF,MF",30-34,Defender,Germany,Europe
343,Gianluca Busio,USA,Venezia,Serie A,2024,22.0,2002.0,12.5,16,11,9,4,3,9,22,40.9,13,13,2,11,4,20,21,0,MF,20-24,Midfielder,United States,North America
344,Aurélio Buta,POR,Reims,Ligue 1,2024,27.0,1997.0,9.9,25,16,15,8,2,14,25,56.0,11,4,0,4,11,36,24,0,DF,25-29,Defender,Portugal,Europe
347,Rémy Cabella,FRA,Lille,Ligue 1,2024,34.0,1990.0,5.2,17,11,3,8,6,10,16,62.5,6,4,0,4,6,23,1,0,"MF,FW",30-34,Midfielder,France,Europe
348,Leandro Cabrera,URU,Espanyol,La Liga,2024,33.0,1991.0,13.0,22,13,16,5,1,8,15,53.3,7,13,6,7,14,36,72,1,DF,30-34,Defender,Uruguay,South America
349,Liberato Cacace,NZL,Empoli,Serie A,2024,24.0,2000.0,7.4,11,5,7,3,1,7,10,70.0,3,14,5,9,1,12,20,0,"DF,MF",20-24,Defender,New Zealand,Oceania
350,Anthony Caci,FRA,Mainz 05,Bundesliga,2024,27.0,1997.0,13.6,26,16,7,12,7,13,21,61.9,8,13,4,9,12,38,23,1,DF,25-29,Defender,France,Europe
351,Mathieu Cafaro,FRA,Saint-Étienne,Ligue 1,2024,27.0,1997.0,6.8,7,5,3,3,1,2,11,18.2,9,6,1,5,6,13,3,0,"MF,FW",25-29,Midfielder,France,Europe
352,Moisés Caicedo,ECU,Chelsea,Premier League,2024,23.0,2001.0,16.7,54,33,24,25,5,28,42,66.7,14,18,5,13,28,82,23,0,MF,20-24,Midfielder,Ecuador,South America
353,Tom Cairney,SCO,Fulham,Premier League,2024,33.0,1991.0,2.8,5,1,1,1,3,1,2,50.0,1,3,1,2,4,9,1,1,MF,30-34,Midfielder,Scotland,Europe
354,Jens Cajuste,SWE,Ipswich Town,Premier League,2024,25.0,1999.0,6.7,13,4,6,6,1,6,20,30.0,14,9,1,8,5,18,6,1,MF,25-29,Midfielder,Sweden,Europe
355,Davide Calabria,ITA,Milan,Serie A,2024,28.0,1996.0,2.0,5,3,5,0,0,4,6,66.7,2,0,0,0,3,8,4,0,"DF,FW",25-29,Defender,Italy,Europe
356,Riccardo Calafiori,ITA,Arsenal,Premier League,2024,22.0,2002.0,6.0,18,14,11,6,1,13,19,68.4,6,10,5,5,6,24,18,0,DF,20-24,Defender,Italy,Europe
357,Luca Caldirola,ITA,Monza,Serie A,2024,33.0,1991.0,4.4,5,3,4,1,0,2,5,40.0,3,4,4,0,2,7,17,0,DF,30-34,Defender,Italy,Europe
359,Duje Ćaleta-Car,CRO,Lyon,Ligue 1,2024,28.0,1996.0,11.9,14,8,7,7,0,7,13,53.8,6,22,17,5,12,26,60,2,DF,25-29,Defender,Croatia,Europe
360,Hakan Çalhanoğlu,TUR,Inter,Serie A,2024,30.0,1994.0,8.8,23,10,4,11,8,12,21,57.1,9,3,2,1,5,28,7,0,MF,30-34,Midfielder,Turkey,Asia
361,Dominic Calvert-Lewin,ENG,Everton,Premier League,2024,27.0,1997.0,13.7,7,5,1,3,3,0,2,0.0,2,5,2,3,6,13,15,0,FW,25-29,Forward,England,Europe
362,Drissa Camara,CIV,Parma,Serie A,2024,22.0,2002.0,1.5,3,2,1,2,0,0,3,0.0,3,2,0,2,2,5,1,0,"MF,FW",20-24,Midfielder,Ivory Coast,Africa
363,Issiaga Camara,GUI,Nice,Ligue 1,2024,19.0,2005.0,0.2,2,1,0,2,0,0,1,0.0,1,0,0,0,3,5,0,0,MF,Under 20,Midfielder,Guinea,Africa
364,Lamine Camara,SEN,Monaco,Ligue 1,2024,20.0,2004.0,10.3,41,29,14,21,6,17,30,56.7,13,20,4,16,18,59,11,1,MF,20-24,Midfielder,Senegal,Africa
365,Mahdi Camara,FRA,Brest,Ligue 1,2024,26.0,1998.0,11.6,36,16,5,21,10,11,19,57.9,8,19,2,17,13,49,14,0,MF,25-29,Midfielder,France,Europe
366,Francesco Camarda,ITA,Milan,Serie A,2024,16.0,2008.0,1.2,2,0,0,0,2,1,3,33.3,2,0,0,0,0,2,3,0,"FW,MF",Under 20,Forward,Italy,Europe
367,Eduardo Camavinga,FRA,Real Madrid,La Liga,2024,22.0,2002.0,5.5,17,11,7,8,2,9,15,60.0,6,11,4,7,8,25,7,0,"MF,DF",20-24,Midfielder,France,Europe
368,Nicolò Cambiaghi,ITA,Bologna,Serie A,2024,23.0,2000.0,0.2,1,0,0,1,0,0,0,,0,1,0,1,0,1,0,0,FW,20-24,Forward,Italy,Europe
369,Andrea Cambiaso,ITA,Juventus,Serie A,2024,24.0,2000.0,13.5,23,15,15,5,3,16,24,66.7,8,13,2,11,8,31,17,2,"DF,FW",20-24,Defender,Italy,Europe
370,Axel Camblan,FRA,Brest,Ligue 1,2024,21.0,2003.0,0.3,1,1,0,0,1,1,2,50.0,1,1,0,1,0,1,0,0,"MF,FW",20-24,Midfielder,France,Europe
373,Cole Campbell,ISL,Dortmund,Bundesliga,2024,18.0,2006.0,0.2,0,0,0,0,0,0,0,,0,0,0,0,0,0,1,0,"MF,FW",Under 20,Midfielder,Iceland,Europe
374,Emre Can,GER,Dortmund,Bundesliga,2024,30.0,1994.0,8.7,22,13,14,6,2,8,16,50.0,8,10,5,5,4,26,27,3,"DF,MF",30-34,Defender,Germany,Europe
376,Matteo Cancellieri,ITA,Parma,Serie A,2024,22.0,2002.0,8.2,17,11,11,5,1,5,11,45.5,6,6,0,6,9,26,14,0,"FW,MF",20-24,Forward,Italy,Europe
377,Antonio Candela,ITA,Venezia,Serie A,2024,24.0,2000.0,10.2,27,18,13,9,5,17,23,73.9,6,6,5,1,8,35,15,1,DF,20-24,Defender,Italy,Europe
379,Jaydee Canvot,FRA,Toulouse,Ligue 1,2024,18.0,2006.0,0.1,1,1,1,0,0,1,2,50.0,1,0,0,0,0,1,0,0,DF,Under 20,Defender,France,Europe
380,Pierrick Capelle,FRA,Angers,Ligue 1,2024,37.0,1987.0,2.9,11,7,4,5,2,3,7,42.9,4,1,1,0,4,15,0,1,MF,35-39,Midfielder,France,Europe
381,Gianluca Caprari,ITA,Monza,Serie A,2024,31.0,1993.0,7.7,10,7,3,6,1,2,5,40.0,3,7,0,7,3,13,1,1,MF,30-34,Midfielder,Italy,Europe
382,Elia Caprile,ITA,Napoli,Serie A,2024,23.0,2001.0,3.6,0,0,0,0,0,0,0,,0,0,0,0,0,0,2,0,GK,20-24,Goalkeeper,Italy,Europe
383,Francesco Caputo,ITA,Empoli,Serie A,2024,37.0,1987.0,0.1,0,0,0,0,0,0,0,,0,0,0,0,0,0,0,0,FW,35-39,Forward,Italy,Europe
384,Maxence Caqueret,FRA,Lyon,Ligue 1,2024,24.0,2000.0,6.4,21,11,5,11,5,4,22,18.2,18,12,2,10,7,28,2,0,MF,20-24,Midfielder,France,Europe
385,Andrea Carboni,ITA,Monza,Serie A,2024,23.0,2001.0,12.7,29,16,19,8,2,14,25,56.0,11,17,6,11,16,45,52,1,DF,20-24,Defender,Italy,Europe
386,Franco Carboni,ITA,Venezia,Serie A,2024,21.0,2003.0,0.1,0,0,0,0,0,0,0,,0,0,0,0,0,0,1,0,DF,20-24,Defender,Italy,Europe
387,Valentin Carboni,ARG,Marseille,Ligue 1,2024,19.0,2005.0,1.1,2,2,0,1,1,0,1,0.0,1,1,0,1,1,3,1,0,"MF,FW",Under 20,Midfielder,Argentina,South America
389,Irvin Cardona,FRA,Espanyol,La Liga,2024,27.0,1997.0,6.6,8,5,2,4,2,6,15,40.0,9,5,1,4,3,11,10,0,"FW,MF",25-29,Forward,France,Europe
392,Johnny Cardoso,USA,Betis,La Liga,2024,23.0,2001.0,8.3,21,14,4,13,4,9,23,39.1,14,10,4,6,19,40,29,0,MF,20-24,Midfielder,United States,North America
393,Patrik Carlgren,SWE,Nantes,Ligue 1,2024,32.0,1992.0,3.0,0,0,0,0,0,0,0,,0,0,0,0,0,0,0,0,GK,30-34,Goalkeeper,Sweden,Europe
394,Diego Carlos,BRA,Aston Villa,Premier League,2024,31.0,1993.0,8.2,7,3,6,1,0,3,5,60.0,2,8,5,3,5,12,32,2,DF,30-34,Defender,Brazil,South America
396,Marco Carnesecchi,ITA,Atalanta,Serie A,2024,24.0,2000.0,16.0,0,0,0,0,0,0,0,,0,1,0,1,0,0,9,1,GK,20-24,Goalkeeper,Italy,Europe
399,Fabio Carvalho,POR,Brentford,Premier League,2024,22.0,2002.0,4.8,13,9,4,4,5,6,13,46.2,7,6,1,5,3,16,2,0,"FW,MF",20-24,Forward,Portugal,Europe
400,William Carvalho,POR,Betis,La Liga,2024,32.0,1992.0,2.7,3,2,0,3,0,2,4,50.0,2,4,1,3,3,6,4,0,MF,30-34,Midfielder,Portugal,Europe
402,Nicolò Casale,ITA,Bologna,Serie A,2024,26.0,1998.0,2.9,3,1,1,2,0,1,2,50.0,1,8,6,2,2,5,8,2,DF,25-29,Defender,Italy,Europe
403,Nicolò Casale,ITA,Lazio,Serie A,2024,26.0,1998.0,1.5,5,3,4,1,0,0,0,,0,4,3,1,1,6,2,0,DF,25-29,Defender,Italy,Europe
404,Casemiro,BRA,Manchester Utd,Premier League,2024,32.0,1992.0,8.3,35,22,20,9,6,17,35,48.6,18,20,5,15,7,42,27,3,MF,30-34,Midfielder,Brazil,South America
405,Kaelan Casey,ENG,West Ham,Premier League,2024,20.0,2004.0,0.0,0,0,0,0,0,0,0,,0,0,0,0,0,0,1,0,DF,20-24,Defender,England,Europe
407,Josué Casimir,FRA,Le Havre,Ligue 1,2024,23.0,2001.0,7.5,15,9,5,8,2,4,9,44.4,5,7,0,7,1,16,16,1,"FW,DF",20-24,Forward,France,Europe
408,Federico Cassa,ITA,Atalanta,Serie A,2024,18.0,2006.0,0.2,0,0,0,0,0,0,0,,0,1,0,1,0,0,0,0,"MF,FW",Under 20,Midfielder,Italy,Europe
409,Cristian Cásseres Jr.,VEN,Toulouse,Ligue 1,2024,24.0,2000.0,12.3,44,30,23,18,3,17,37,45.9,20,16,3,13,19,63,14,1,MF,20-24,Midfielder,Venezuela,South America
410,Timothy Castagne,BEL,Fulham,Premier League,2024,29.0,1995.0,3.0,7,4,4,2,1,6,9,66.7,3,2,1,1,3,10,15,0,DF,25-29,Defender,Belgium,Europe
411,Valentín Castellanos,ARG,Lazio,Serie A,2024,26.0,1998.0,13.7,4,2,0,1,3,1,8,12.5,7,10,1,9,3,7,7,0,FW,25-29,Forward,Argentina,South America
412,Jean-Charles Castelletto,CMR,Nantes,Ligue 1,2024,29.0,1995.0,12.8,14,6,5,8,1,9,14,64.3,5,8,5,3,9,23,67,0,DF,25-29,Defender,Cameroon,Africa
413,Santiago Castro,ARG,Bologna,Serie A,2024,20.0,2004.0,13.5,10,4,3,6,1,2,7,28.6,5,10,2,8,2,12,11,0,FW,20-24,Forward,Argentina,South America
414,Gaetano Castrovilli,ITA,Lazio,Serie A,2024,27.0,1997.0,1.5,5,2,3,1,1,2,4,50.0,2,2,0,2,3,8,1,0,"MF,FW",25-29,Midfielder,Italy,Europe
415,Danilo Cataldi,ITA,Fiorentina,Serie A,2024,30.0,1994.0,9.0,18,13,7,9,2,8,16,50.0,8,7,4,3,9,27,16,0,MF,30-34,Midfielder,Italy,Europe
417,Maximiliano Caufriez,BEL,Valencia,La Liga,2024,27.0,1997.0,1.0,1,1,1,0,0,1,1,100.0,0,2,1,1,1,2,4,0,DF,25-29,Defender,Belgium,Europe
419,Zeki Çelik,TUR,Roma,Serie A,2024,27.0,1997.0,13.3,29,19,10,12,7,13,23,56.5,10,14,3,11,6,35,37,1,DF,25-29,Defender,Turkey,Asia
420,Fabien Centonze,FRA,Nantes,Ligue 1,2024,28.0,1996.0,0.9,3,1,1,1,1,1,3,33.3,2,1,0,1,1,4,7,0,DF,25-29,Defender,France,Europe
421,Alberto Cerri,ITA,Como,Serie A,2024,28.0,1996.0,1.0,0,0,0,0,0,0,0,,0,2,0,2,0,0,1,0,FW,25-29,Forward,Italy,Europe
422,Franco Cervi,ARG,Celta Vigo,La Liga,2024,30.0,1994.0,0.2,0,0,0,0,0,0,2,0.0,2,0,0,0,1,1,0,0,"DF,FW",30-34,Defender,Argentina,South America
423,Julian Chabot,GER,Stuttgart,Bundesliga,2024,26.0,1998.0,12.2,17,10,11,5,1,9,21,42.9,12,13,7,6,22,39,59,0,DF,25-29,Defender,Germany,Europe
424,El Chadaille Bitshiabu,FRA,RB Leipzig,Bundesliga,2024,19.0,2005.0,2.5,8,4,3,5,0,3,5,60.0,2,4,2,2,5,13,13,1,DF,Under 20,Defender,France,Europe
425,Fares Chaïbi,ALG,Eint Frankfurt,Bundesliga,2024,22.0,2002.0,6.8,11,7,4,4,3,6,12,50.0,6,9,0,9,7,18,21,1,"MF,FW",20-24,Midfielder,Algeria,Africa
426,Trevoh Chalobah,ENG,Crystal Palace,Premier League,2024,25.0,1999.0,9.8,18,14,7,10,1,10,20,50.0,10,18,9,9,17,35,49,3,DF,25-29,Defender,England,Europe
427,Timothy Chandler,USA,Eint Frankfurt,Bundesliga,2024,34.0,1990.0,0.2,0,0,0,0,0,0,0,,0,0,0,0,3,3,0,0,DF,30-34,Defender,United States,North America
428,Conor Chaplin,ENG,Ipswich Town,Premier League,2024,27.0,1997.0,6.8,11,5,3,6,2,6,13,46.2,7,8,1,7,3,14,2,0,"MF,FW",25-29,Midfielder,England,Europe
429,Brendan Chardonnet,FRA,Brest,Ligue 1,2024,30.0,1994.0,13.0,19,14,7,10,2,12,21,57.1,9,14,10,4,14,33,69,1,DF,30-34,Defender,France,Europe
430,Gabriel Charpentier,CGO,Parma,Serie A,2024,25.0,1999.0,3.0,4,3,2,1,1,3,4,75.0,1,3,0,3,0,4,9,0,FW,25-29,Forward,Congo,Africa
432,Anrie Chase,JPN,Stuttgart,Bundesliga,2024,20.0,2004.0,8.2,10,4,6,4,0,5,7,71.4,2,10,6,4,9,19,35,0,DF,20-24,Defender,Japan,Asia
434,Arthur Chaves,BRA,Hoffenheim,Bundesliga,2024,23.0,2001.0,6.7,12,7,5,7,0,7,12,58.3,5,13,3,10,9,21,29,0,DF,20-24,Defender,Brazil,South America
435,Jhoanner Chávez,ECU,Lens,Ligue 1,2024,22.0,2002.0,6.5,9,5,4,4,1,2,7,28.6,5,10,1,9,6,15,13,0,"DF,MF",20-24,Defender,Ecuador,South America
436,Walid Cheddira,MAR,Napoli,Serie A,2024,26.0,1998.0,0.1,0,0,0,0,0,0,0,,0,0,0,0,0,0,0,0,FW,25-29,Forward,Morocco,Africa
437,Walid Cheddira,MAR,Espanyol,La Liga,2024,26.0,1998.0,6.5,4,0,0,1,3,0,1,0.0,1,3,0,3,1,5,6,0,FW,25-29,Forward,Morocco,Africa
438,Théo Chennahi,FRA,Montpellier,Ligue 1,2024,19.0,2005.0,0.1,0,0,0,0,0,0,0,,0,1,0,1,0,0,0,0,"MF,DF",Under 20,Midfielder,France,Europe
439,Sidiki Cherif,FRA,Angers,Ligue 1,2024,18.0,2006.0,3.1,4,4,0,3,1,3,4,75.0,1,2,0,2,0,4,0,1,FW,Under 20,Forward,France,Europe
440,Rayan Cherki,FRA,Lyon,Ligue 1,2024,21.0,2003.0,7.0,6,5,1,4,1,2,8,25.0,6,3,0,3,3,9,2,0,"FW,MF",20-24,Forward,France,Europe
441,Lucas Chevalier,FRA,Lille,Ligue 1,2024,23.0,2001.0,15.0,2,2,2,0,0,2,3,66.7,1,0,0,0,0,2,2,0,GK,20-24,Goalkeeper,France,Europe
442,Fabio Chiarodia,ITA,Gladbach,Bundesliga,2024,19.0,2005.0,0.5,2,1,1,1,0,1,1,100.0,0,1,0,1,1,3,10,0,DF,Under 20,Defender,Italy,Europe
443,Julián Chicco,ARG,Leganés,La Liga,2024,26.0,1998.0,2.0,6,4,0,6,0,3,5,60.0,2,2,0,2,2,8,2,0,MF,25-29,Midfielder,Argentina,South America
444,Leandro Chichizola,ARG,Parma,Serie A,2024,34.0,1990.0,1.0,0,0,0,0,0,0,0,,0,0,0,0,0,0,2,0,GK,30-34,Goalkeeper,Argentina,South America
445,Federico Chiesa,ITA,Liverpool,Premier League,2024,27.0,1997.0,0.2,0,0,0,0,0,0,0,,0,0,0,0,0,0,0,0,FW,25-29,Forward,Italy,Europe
446,Chiquinho,POR,Wolves,Premier League,2024,24.0,2000.0,0.1,0,0,0,0,0,0,0,,0,0,0,0,0,0,0,0,MF,20-24,Midfielder,Portugal,Europe
446,Chiquinho,POR,Wolves,Premier League,2024,24.0,2000.0,0.1,0,0,0,0,0,0,0,,0,0,0,0,0,0,0,0,MF,20-24,Midfielder,Portugal,Europe
446,Chiquinho,POR,Wolves,Premier League,2024,24.0,2000.0,0.1,0,0,0,0,0,0,0,,0,0,0,0,0,0,0,0,MF,20-24,Midfielder,Portugal,Europe
446,Chiquinho,POR,Wolves,Premier League,2024,24.0,2000.0,0.1,0,0,0,0,0,0,0,,0,0,0,0,0,0,0,0,MF,20-24,Midfielder,Portugal,Europe
447,Chiquinho,POR,Mallorca,La Liga,2024,24.0,2000.0,1.6,1,0,0,1,0,0,7,0.0,7,3,0,3,2,3,0,0,"MF,FW",20-24,Midfielder,Portugal,Europe
447,Chiquinho,POR,Mallorca,La Liga,2024,24.0,2000.0,1.6,1,0,0,1,0,0,7,0.0,7,3,0,3,2,3,0,0,"MF,FW",20-24,Midfielder,Portugal,Europe
447,Chiquinho,POR,Mallorca,La Liga,2024,24.0,2000.0,1.6,1,0,0,1,0,0,7,0.0,7,3,0,3,2,3,0,0,"MF,FW",20-24,Midfielder,Portugal,Europe
447,Chiquinho,POR,Mallorca,La Liga,2024,24.0,2000.0,1.6,1,0,0,1,0,0,7,0.0,7,3,0,3,2,3,0,0,"MF,FW",20-24,Midfielder,Portugal,Europe
449,Joris Chotard,FRA,Montpellier,Ligue 1,2024,23.0,2001.0,7.5,20,13,7,13,0,11,19,57.9,8,10,2,8,9,29,16,0,MF,20-24,Midfielder,France,Europe
450,Hamza Choudhury,ENG,Leicester City,Premier League,2024,27.0,1997.0,1.2,1,1,1,0,0,1,3,33.3,2,2,1,1,3,4,2,0,"MF,DF",25-29,Midfielder,England,Europe
451,Andreas Christensen,DEN,Barcelona,La Liga,2024,28.0,1996.0,0.3,0,0,0,0,0,0,0,,0,0,0,0,0,0,2,0,DF,25-29,Defender,Denmark,Europe
452,Ryan Christie,SCO,Bournemouth,Premier League,2024,29.0,1995.0,12.6,24,15,10,9,5,12,27,44.4,15,23,7,16,13,37,29,1,MF,25-29,Midfielder,Scotland,Europe
453,Samuel Chukwueze,NGA,Milan,Serie A,2024,25.0,1999.0,7.5,10,5,4,3,3,5,14,35.7,9,3,0,3,0,10,4,0,FW,25-29,Forward,Nigeria,Africa
454,Aaron Ciammaglichella,ITA,Torino,Serie A,2024,19.0,2005.0,0.0,0,0,0,0,0,0,0,,0,0,0,0,0,0,0,0,MF,Under 20,Midfielder,Italy,Europe
455,Jasper Cillessen,NED,Las Palmas,La Liga,2024,35.0,1989.0,15.7,1,0,1,0,0,1,1,100.0,0,0,0,0,0,1,9,0,GK,35-39,Goalkeeper,Netherlands,Europe
456,Alessandro Circati,AUS,Parma,Serie A,2024,21.0,2003.0,4.0,4,2,3,1,0,1,1,100.0,0,5,4,1,2,6,29,1,DF,20-24,Defender,Australia,Oceania
457,Pathé Ciss,SEN,Rayo Vallecano,La Liga,2024,30.0,1994.0,8.2,16,9,7,9,0,7,17,41.2,10,10,4,6,13,29,29,0,MF,30-34,Midfielder,Senegal,Africa
458,Alphadjo Cissè,ITA,Hellas Verona,Serie A,2024,18.0,2006.0,0.0,0,0,0,0,0,0,0,,0,0,0,0,0,0,0,0,MF,Under 20,Midfielder,Italy,Europe
459,Seydouba Cissé,GUI,Leganés,La Liga,2024,23.0,2001.0,12.6,26,15,8,13,5,9,20,45.0,11,13,1,12,7,33,17,1,MF,20-24,Midfielder,Guinea,Africa
460,Patrick Ciurria,ITA,Monza,Serie A,2024,29.0,1995.0,0.2,1,1,0,1,0,0,0,,0,0,0,0,0,1,1,0,"MF,DF",25-29,Midfielder,Italy,Europe
461,Harry Clarke,ENG,Ipswich Town,Premier League,2024,23.0,2001.0,4.2,5,3,3,2,0,3,6,50.0,3,5,4,1,4,9,14,3,DF,20-24,Defender,England,Europe
462,Jack Clarke,ENG,Ipswich Town,Premier League,2024,24.0,2000.0,5.6,18,10,8,8,2,10,17,58.8,7,4,0,4,3,21,6,0,FW,20-24,Forward,England,Europe
463,Alexis Claude-Maurice,FRA,Augsburg,Bundesliga,2024,26.0,1998.0,6.4,13,8,4,6,3,4,7,57.1,3,2,0,2,5,18,1,0,"FW,MF",25-29,Forward,France,Europe
464,Jonathan Clauss,FRA,Nice,Ligue 1,2024,32.0,1992.0,9.5,27,19,15,11,1,16,26,61.5,10,12,2,10,19,46,30,0,"DF,MF",30-34,Defender,France,Europe
466,Nathaniel Clyne,ENG,Crystal Palace,Premier League,2024,33.0,1991.0,4.2,11,7,7,3,1,5,7,71.4,2,3,1,2,3,14,12,1,"DF,MF",30-34,Defender,England,Europe
467,Conor Coady,ENG,Leicester City,Premier League,2024,31.0,1993.0,5.1,6,4,3,3,0,2,3,66.7,1,11,9,2,6,12,16,1,DF,30-34,Defender,England,Europe
468,Marcus Coco,FRA,Nantes,Ligue 1,2024,28.0,1996.0,4.9,15,15,6,7,2,8,17,47.1,9,6,2,4,3,18,12,0,DF,25-29,Defender,France,Europe
469,Saúl Coco,EQG,Torino,Serie A,2024,25.0,1999.0,15.0,16,7,12,4,0,3,9,33.3,6,21,13,8,23,39,73,3,DF,25-29,Defender,Equatorial Guinea,Africa
470,Séamus Coleman,IRL,Everton,Premier League,2024,36.0,1988.0,1.2,1,0,0,1,0,1,2,50.0,1,2,1,1,0,1,2,0,DF,35-39,Defender,Republic of Ireland,Europe
471,Nathan Collins,IRL,Brentford,Premier League,2024,23.0,2001.0,17.0,21,13,14,5,2,14,18,77.8,4,36,27,9,17,38,88,0,DF,20-24,Defender,Republic of Ireland,Europe
472,Nnamdi Collins,GER,Eint Frankfurt,Bundesliga,2024,20.0,2004.0,3.6,6,6,5,0,1,3,3,100.0,0,9,4,5,3,9,14,1,DF,20-24,Defender,Germany,Europe
473,Toby Collyer,ENG,Manchester Utd,Premier League,2024,20.0,2004.0,0.5,4,3,1,3,0,2,2,100.0,0,0,0,0,0,4,1,0,MF,20-24,Midfielder,England,Europe
474,Lorenzo Colombo,ITA,Empoli,Serie A,2024,22.0,2002.0,12.5,13,8,4,5,4,5,13,38.5,8,14,1,13,1,14,8,0,"FW,MF",20-24,Forward,Italy,Europe
475,Andrea Colpani,ITA,Fiorentina,Serie A,2024,25.0,1999.0,12.2,10,5,5,4,1,1,7,14.3,6,5,0,5,6,16,9,0,"FW,MF",25-29,Forward,Italy,Europe
476,Levi Colwill,ENG,Chelsea,Premier League,2024,21.0,2003.0,16.0,13,9,10,3,0,4,9,44.4,5,23,17,6,16,29,50,1,DF,20-24,Defender,England,Europe
477,Kingsley Coman,FRA,Bayern Munich,Bundesliga,2024,28.0,1996.0,6.9,10,6,3,2,5,3,5,60.0,2,6,0,6,6,16,12,0,FW,25-29,Forward,France,Europe
478,Eray Cömert,SUI,Valladolid,La Liga,2024,26.0,1998.0,11.8,15,9,8,7,0,6,12,50.0,6,19,12,7,12,27,35,1,"DF,MF",25-29,Defender,Switzerland,Europe
480,Pietro Comuzzo,ITA,Fiorentina,Serie A,2024,19.0,2005.0,13.5,25,12,14,8,3,12,15,80.0,3,17,12,5,15,40,43,0,DF,Under 20,Defender,Italy,Europe
481,Francisco Conceição,POR,Juventus,Serie A,2024,22.0,2002.0,8.2,11,6,3,4,4,4,15,26.7,11,2,0,2,4,15,2,0,"FW,MF",20-24,Forward,Portugal,Europe
483,Tomás Conechny,ARG,Alavés,La Liga,2024,26.0,1998.0,5.3,4,2,2,2,0,2,10,20.0,8,9,1,8,4,8,5,0,"FW,MF",25-29,Forward,Argentina,South America
484,Sirlord Conteh,GER,Heidenheim,Bundesliga,2024,28.0,1996.0,3.9,7,4,3,4,0,2,3,66.7,1,1,1,0,0,7,1,0,"FW,MF",25-29,Forward,Germany,Europe
485,Lewis Cook,ENG,Bournemouth,Premier League,2024,27.0,1997.0,14.6,39,22,20,17,2,16,32,50.0,16,18,6,12,25,64,27,0,"MF,DF",25-29,Midfielder,England,Europe
487,Diego Coppola,ITA,Hellas Verona,Serie A,2024,20.0,2003.0,12.5,23,14,17,4,2,11,16,68.8,5,22,11,11,31,54,56,1,DF,20-24,Defender,Italy,Europe
489,Derek Cornelius,CAN,Marseille,Ligue 1,2024,27.0,1997.0,6.2,10,6,7,3,0,8,10,80.0,2,7,3,4,4,14,25,0,DF,25-29,Defender,Canada,North America
490,Maxwel Cornet,CIV,Southampton,Premier League,2024,28.0,1996.0,0.8,5,5,1,4,0,0,4,0.0,4,0,0,0,0,5,2,0,FW,25-29,Forward,Ivory Coast,Africa
491,Pierre Cornud,FRA,Saint-Étienne,Ligue 1,2024,28.0,1996.0,4.2,8,8,4,3,1,7,11,63.6,4,4,1,3,5,13,13,1,DF,25-29,Defender,France,Europe
492,Ángel Correa,ARG,Atlético Madrid,La Liga,2024,29.0,1995.0,5.1,4,0,2,0,2,1,6,16.7,5,5,0,5,3,7,3,0,"FW,MF",25-29,Forward,Argentina,South America
493,Joaquín Correa,ARG,Inter,Serie A,2024,30.0,1994.0,1.7,2,0,0,2,0,1,2,50.0,1,0,0,0,0,2,0,0,"FW,MF",30-34,Forward,Argentina,South America
494,Thierry Correia,POR,Valencia,La Liga,2024,25.0,1999.0,8.5,27,18,19,5,3,13,23,56.5,10,10,1,9,4,31,18,0,DF,25-29,Defender,Portugal,Europe
496,Danny da Costa,GER,Mainz 05,Bundesliga,2024,31.0,1993.0,4.9,10,4,7,2,1,3,3,100.0,0,8,4,4,4,14,16,0,DF,30-34,Defender,Germany,Europe
497,David Costa,POR,Lens,Ligue 1,2024,23.0,2001.0,3.5,2,0,1,1,0,1,4,25.0,3,5,1,4,1,3,0,0,MF,20-24,Midfielder,Portugal,Europe
498,Logan Costa,CPV,Villarreal,La Liga,2024,23.0,2001.0,12.7,18,10,10,7,1,11,13,84.6,2,11,6,5,6,24,46,1,DF,20-24,Defender,Cape Verde,Africa
499,Logan Costa,CPV,Toulouse,Ligue 1,2024,23.0,2001.0,1.0,2,1,0,2,0,1,1,100.0,0,2,2,0,2,4,4,0,DF,20-24,Defender,Cape Verde,Africa
500,Samu Costa,POR,Mallorca,La Liga,2024,24.0,2000.0,15.2,44,20,24,19,1,17,34,50.0,17,21,6,15,18,62,43,0,MF,20-24,Midfielder,Portugal,Europe
501,Grégoire Coudert,FRA,Brest,Ligue 1,2024,25.0,1999.0,1.0,0,0,0,0,0,0,0,,0,0,0,0,0,0,1,0,GK,25-29,Goalkeeper,France,Europe
503,Lassana Coulibaly,MLI,Lecce,Serie A,2024,28.0,1996.0,11.6,18,13,7,11,0,7,22,31.8,15,19,6,13,8,26,15,0,MF,25-29,Midfielder,Mali,Africa
504,Lasso Coulibaly,GHA,Auxerre,Ligue 1,2024,22.0,2002.0,0.4,0,0,0,0,0,0,0,,0,0,0,0,0,0,0,0,"FW,MF",20-24,Forward,Ghana,Africa
505,Soumaïla Coulibaly,FRA,Brest,Ligue 1,2024,21.0,2003.0,3.6,2,2,0,2,0,0,0,,0,4,1,3,5,7,13,0,DF,20-24,Defender,France,Europe
506,Tanguy Coulibaly,FRA,Montpellier,Ligue 1,2024,23.0,2001.0,4.9,9,6,2,6,1,2,8,25.0,6,3,0,3,4,13,0,0,"FW,MF",20-24,Forward,France,Europe
507,Woyo Coulibaly,FRA,Parma,Serie A,2024,25.0,1999.0,11.0,12,9,8,2,2,5,11,45.5,6,19,2,17,8,20,22,0,DF,25-29,Defender,France,Europe
508,Thibaut Courtois,BEL,Real Madrid,La Liga,2024,32.0,1992.0,15.0,0,0,0,0,0,0,0,,0,0,0,0,1,1,9,1,GK,30-34,Goalkeeper,Belgium,Europe
509,Yan Couto,BRA,Dortmund,Bundesliga,2024,22.0,2002.0,4.4,9,5,7,1,1,6,10,60.0,4,9,0,9,5,14,13,1,DF,20-24,Defender,Brazil,South America
510,Nicolas Cozza,FRA,Nantes,Ligue 1,2024,25.0,1999.0,10.3,27,18,14,10,3,12,21,57.1,9,11,3,8,11,38,28,0,"DF,MF",25-29,Defender,France,Europe
511,Aaron Cresswell,ENG,West Ham,Premier League,2024,35.0,1989.0,0.4,1,0,0,1,0,1,1,100.0,0,1,0,1,0,1,3,0,DF,35-39,Defender,England,Europe
512,Charlie Cresswell,ENG,Toulouse,Ligue 1,2024,22.0,2002.0,11.8,14,6,7,7,0,13,24,54.2,11,17,10,7,15,29,63,2,DF,20-24,Defender,England,Europe
513,Bryan Cristante,ITA,Roma,Serie A,2024,29.0,1995.0,11.1,23,17,7,13,3,9,16,56.3,7,12,7,5,11,34,20,0,MF,25-29,Midfielder,Italy,Europe
517,Juan Cuadrado,COL,Atalanta,Serie A,2024,36.0,1988.0,2.4,1,0,0,0,1,1,6,16.7,5,3,1,2,1,2,3,0,"DF,MF",35-39,Defender,Colombia,South America
521,Matheus Cunha,BRA,Wolves,Premier League,2024,25.0,1999.0,15.8,20,12,7,11,2,7,22,31.8,15,13,0,13,11,31,17,0,"MF,FW",25-29,Midfielder,Brazil,South America
522,Patrick Cutrone,ITA,Como,Serie A,2024,26.0,1998.0,12.9,10,8,0,6,4,5,9,55.6,4,5,0,5,2,12,6,0,FW,25-29,Forward,Italy,Europe
524,Wylan Cyprien,FRA,Parma,Serie A,2024,29.0,1995.0,0.3,0,0,0,0,0,0,1,0.0,1,1,0,1,1,1,0,0,MF,25-29,Midfielder,France,Europe
525,Danilo D'Ambrosio,ITA,Monza,Serie A,2024,36.0,1988.0,3.3,9,3,8,0,1,3,7,42.9,4,5,3,2,2,11,7,0,DF,35-39,Defender,Italy,Europe
526,Lucas Da Cunha,FRA,Como,Serie A,2024,23.0,2001.0,9.7,20,9,7,9,4,8,13,61.5,5,5,0,5,8,28,14,0,MF,20-24,Midfielder,France,Europe
527,Samuel Dahl,SWE,Roma,Serie A,2024,24.0,2000.0,0.5,2,2,0,2,0,1,2,50.0,1,2,0,2,0,2,0,0,"DF,MF",20-24,Defender,Sweden,Europe
528,Mahmoud Dahoud,GER,Eint Frankfurt,Bundesliga,2024,28.0,1996.0,3.6,9,4,4,5,0,4,6,66.7,2,5,1,4,2,11,4,0,MF,25-29,Midfielder,Germany,Europe
529,Patson Daka,ZAM,Leicester City,Premier League,2024,26.0,1998.0,1.2,5,1,0,3,2,4,8,50.0,4,1,1,0,0,5,2,0,"FW,MF",25-29,Forward,Zambia,Africa
530,Ameen Al-Dakhil,BEL,Stuttgart,Bundesliga,2024,22.0,2002.0,0.1,0,0,0,0,0,0,0,,0,0,0,0,0,0,2,0,DF,20-24,Defender,Belgium,Europe
531,Thijs Dallinga,NED,Bologna,Serie A,2024,24.0,2000.0,3.0,6,3,0,1,5,2,2,100.0,0,4,1,3,0,6,4,0,"FW,MF",20-24,Forward,Netherlands,Europe
532,Diogo Dalot,POR,Manchester Utd,Premier League,2024,25.0,1999.0,16.6,38,26,23,11,4,17,27,63.0,10,14,7,7,24,62,33,0,DF,25-29,Defender,Portugal,Europe
533,Mikkel Damsgaard,DEN,Brentford,Premier League,2024,24.0,2000.0,13.2,45,26,19,12,14,16,33,48.5,17,18,1,17,15,60,23,1,"MF,FW",20-24,Midfielder,Denmark,Europe
534,Flavius Daniliuc,AUT,Hellas Verona,Serie A,2024,23.0,2001.0,7.0,18,13,11,5,2,10,17,58.8,7,6,1,5,6,24,16,0,DF,20-24,Defender,Austria,Europe
535,Danilo,BRA,Nott'ham Forest,Premier League,2024,23.0,2001.0,0.2,0,0,0,0,0,0,0,,0,0,0,0,0,0,0,0,MF,20-24,Midfielder,Brazil,South America
535,Danilo,BRA,Nott'ham Forest,Premier League,2024,23.0,2001.0,0.2,0,0,0,0,0,0,0,,0,0,0,0,0,0,0,0,MF,20-24,Midfielder,Brazil,South America
535,Danilo,BRA,Nott'ham Forest,Premier League,2024,23.0,2001.0,0.2,0,0,0,0,0,0,0,,0,0,0,0,0,0,0,0,MF,20-24,Midfielder,Brazil,South America
535,Danilo,BRA,Nott'ham Forest,Premier League,2024,23.0,2001.0,0.2,0,0,0,0,0,0,0,,0,0,0,0,0,0,0,0,MF,20-24,Midfielder,Brazil,South America
535,Danilo,BRA,Nott'ham Forest,Premier League,2024,23.0,2001.0,0.2,0,0,0,0,0,0,0,,0,0,0,0,0,0,0,0,MF,20-24,Midfielder,Brazil,South America
535,Danilo,BRA,Nott'ham Forest,Premier League,2024,23.0,2001.0,0.2,0,0,0,0,0,0,0,,0,0,0,0,0,0,0,0,MF,20-24,Midfielder,Brazil,South America
535,Danilo,BRA,Nott'ham Forest,Premier League,2024,23.0,2001.0,0.2,0,0,0,0,0,0,0,,0,0,0,0,0,0,0,0,MF,20-24,Midfielder,Brazil,South America
535,Danilo,BRA,Nott'ham Forest,Premier League,2024,23.0,2001.0,0.2,0,0,0,0,0,0,0,,0,0,0,0,0,0,0,0,MF,20-24,Midfielder,Brazil,South America
535,Danilo,BRA,Nott'ham Forest,Premier League,2024,23.0,2001.0,0.2,0,0,0,0,0,0,0,,0,0,0,0,0,0,0,0,MF,20-24,Midfielder,Brazil,South America
535,Danilo,BRA,Nott'ham Forest,Premier League,2024,23.0,2001.0,0.2,0,0,0,0,0,0,0,,0,0,0,0,0,0,0,0,MF,20-24,Midfielder,Brazil,South America
535,Danilo,BRA,Nott'ham Forest,Premier League,2024,23.0,2001.0,0.2,0,0,0,0,0,0,0,,0,0,0,0,0,0,0,0,MF,20-24,Midfielder,Brazil,South America
535,Danilo,BRA,Nott'ham Forest,Premier League,2024,23.0,2001.0,0.2,0,0,0,0,0,0,0,,0,0,0,0,0,0,0,0,MF,20-24,Midfielder,Brazil,South America
535,Danilo,BRA,Nott'ham Forest,Premier League,2024,23.0,2001.0,0.2,0,0,0,0,0,0,0,,0,0,0,0,0,0,0,0,MF,20-24,Midfielder,Brazil,South America
535,Danilo,BRA,Nott'ham Forest,Premier League,2024,23.0,2001.0,0.2,0,0,0,0,0,0,0,,0,0,0,0,0,0,0,0,MF,20-24,Midfielder,Brazil,South America
535,Danilo,BRA,Nott'ham Forest,Premier League,2024,23.0,2001.0,0.2,0,0,0,0,0,0,0,,0,0,0,0,0,0,0,0,MF,20-24,Midfielder,Brazil,South America
535,Danilo,BRA,Nott'ham Forest,Premier League,2024,23.0,2001.0,0.2,0,0,0,0,0,0,0,,0,0,0,0,0,0,0,0,MF,20-24,Midfielder,Brazil,South America
535,Danilo,BRA,Nott'ham Forest,Premier League,2024,23.0,2001.0,0.2,0,0,0,0,0,0,0,,0,0,0,0,0,0,0,0,MF,20-24,Midfielder,Brazil,South America
535,Danilo,BRA,Nott'ham Forest,Premier League,2024,23.0,2001.0,0.2,0,0,0,0,0,0,0,,0,0,0,0,0,0,0,0,MF,20-24,Midfielder,Brazil,South America
535,Danilo,BRA,Nott'ham Forest,Premier League,2024,23.0,2001.0,0.2,0,0,0,0,0,0,0,,0,0,0,0,0,0,0,0,MF,20-24,Midfielder,Brazil,South America
535,Danilo,BRA,Nott'ham Forest,Premier League,2024,23.0,2001.0,0.2,0,0,0,0,0,0,0,,0,0,0,0,0,0,0,0,MF,20-24,Midfielder,Brazil,South America
535,Danilo,BRA,Nott'ham Forest,Premier League,2024,23.0,2001.0,0.2,0,0,0,0,0,0,0,,0,0,0,0,0,0,0,0,MF,20-24,Midfielder,Brazil,South America
535,Danilo,BRA,Nott'ham Forest,Premier League,2024,23.0,2001.0,0.2,0,0,0,0,0,0,0,,0,0,0,0,0,0,0,0,MF,20-24,Midfielder,Brazil,South America
535,Danilo,BRA,Nott'ham Forest,Premier League,2024,23.0,2001.0,0.2,0,0,0,0,0,0,0,,0,0,0,0,0,0,0,0,MF,20-24,Midfielder,Brazil,South America
535,Danilo,BRA,Nott'ham Forest,Premier League,2024,23.0,2001.0,0.2,0,0,0,0,0,0,0,,0,0,0,0,0,0,0,0,MF,20-24,Midfielder,Brazil,South America
535,Danilo,BRA,Nott'ham Forest,Premier League,2024,23.0,2001.0,0.2,0,0,0,0,0,0,0,,0,0,0,0,0,0,0,0,MF,20-24,Midfielder,Brazil,South America
535,Danilo,BRA,Nott'ham Forest,Premier League,2024,23.0,2001.0,0.2,0,0,0,0,0,0,0,,0,0,0,0,0,0,0,0,MF,20-24,Midfielder,Brazil,South America
535,Danilo,BRA,Nott'ham Forest,Premier League,2024,23.0,2001.0,0.2,0,0,0,0,0,0,0,,0,0,0,0,0,0,0,0,MF,20-24,Midfielder,Brazil,South America
535,Danilo,BRA,Nott'ham Forest,Premier League,2024,23.0,2001.0,0.2,0,0,0,0,0,0,0,,0,0,0,0,0,0,0,0,MF,20-24,Midfielder,Brazil,South America
535,Danilo,BRA,Nott'ham Forest,Premier League,2024,23.0,2001.0,0.2,0,0,0,0,0,0,0,,0,0,0,0,0,0,0,0,MF,20-24,Midfielder,Brazil,South America
535,Danilo,BRA,Nott'ham Forest,Premier League,2024,23.0,2001.0,0.2,0,0,0,0,0,0,0,,0,0,0,0,0,0,0,0,MF,20-24,Midfielder,Brazil,South America
535,Danilo,BRA,Nott'ham Forest,Premier League,2024,23.0,2001.0,0.2,0,0,0,0,0,0,0,,0,0,0,0,0,0,0,0,MF,20-24,Midfielder,Brazil,South America
535,Danilo,BRA,Nott'ham Forest,Premier League,2024,23.0,2001.0,0.2,0,0,0,0,0,0,0,,0,0,0,0,0,0,0,0,MF,20-24,Midfielder,Brazil,South America
535,Danilo,BRA,Nott'ham Forest,Premier League,2024,23.0,2001.0,0.2,0,0,0,0,0,0,0,,0,0,0,0,0,0,0,0,MF,20-24,Midfielder,Brazil,South America
535,Danilo,BRA,Nott'ham Forest,Premier League,2024,23.0,2001.0,0.2,0,0,0,0,0,0,0,,0,0,0,0,0,0,0,0,MF,20-24,Midfielder,Brazil,South America
535,Danilo,BRA,Nott'ham Forest,Premier League,2024,23.0,2001.0,0.2,0,0,0,0,0,0,0,,0,0,0,0,0,0,0,0,MF,20-24,Midfielder,Brazil,South America
535,Danilo,BRA,Nott'ham Forest,Premier League,2024,23.0,2001.0,0.2,0,0,0,0,0,0,0,,0,0,0,0,0,0,0,0,MF,20-24,Midfielder,Brazil,South America
535,Danilo,BRA,Nott'ham Forest,Premier League,2024,23.0,2001.0,0.2,0,0,0,0,0,0,0,,0,0,0,0,0,0,0,0,MF,20-24,Midfielder,Brazil,South America
535,Danilo,BRA,Nott'ham Forest,Premier League,2024,23.0,2001.0,0.2,0,0,0,0,0,0,0,,0,0,0,0,0,0,0,0,MF,20-24,Midfielder,Brazil,South America
535,Danilo,BRA,Nott'ham Forest,Premier League,2024,23.0,2001.0,0.2,0,0,0,0,0,0,0,,0,0,0,0,0,0,0,0,MF,20-24,Midfielder,Brazil,South America
535,Danilo,BRA,Nott'ham Forest,Premier League,2024,23.0,2001.0,0.2,0,0,0,0,0,0,0,,0,0,0,0,0,0,0,0,MF,20-24,Midfielder,Brazil,South America
535,Danilo,BRA,Nott'ham Forest,Premier League,2024,23.0,2001.0,0.2,0,0,0,0,0,0,0,,0,0,0,0,0,0,0,0,MF,20-24,Midfielder,Brazil,South America
535,Danilo,BRA,Nott'ham Forest,Premier League,2024,23.0,2001.0,0.2,0,0,0,0,0,0,0,,0,0,0,0,0,0,0,0,MF,20-24,Midfielder,Brazil,South America
535,Danilo,BRA,Nott'ham Forest,Premier League,2024,23.0,2001.0,0.2,0,0,0,0,0,0,0,,0,0,0,0,0,0,0,0,MF,20-24,Midfielder,Brazil,South America
535,Danilo,BRA,Nott'ham Forest,Premier League,2024,23.0,2001.0,0.2,0,0,0,0,0,0,0,,0,0,0,0,0,0,0,0,MF,20-24,Midfielder,Brazil,South America
535,Danilo,BRA,Nott'ham Forest,Premier League,2024,23.0,2001.0,0.2,0,0,0,0,0,0,0,,0,0,0,0,0,0,0,0,MF,20-24,Midfielder,Brazil,South America
535,Danilo,BRA,Nott'ham Forest,Premier League,2024,23.0,2001.0,0.2,0,0,0,0,0,0,0,,0,0,0,0,0,0,0,0,MF,20-24,Midfielder,Brazil,South America
535,Danilo,BRA,Nott'ham Forest,Premier League,2024,23.0,2001.0,0.2,0,0,0,0,0,0,0,,0,0,0,0,0,0,0,0,MF,20-24,Midfielder,Brazil,South America
535,Danilo,BRA,Nott'ham Forest,Premier League,2024,23.0,2001.0,0.2,0,0,0,0,0,0,0,,0,0,0,0,0,0,0,0,MF,20-24,Midfielder,Brazil,South America
535,Danilo,BRA,Nott'ham Forest,Premier League,2024,23.0,2001.0,0.2,0,0,0,0,0,0,0,,0,0,0,0,0,0,0,0,MF,20-24,Midfielder,Brazil,South America
536,Danilo,BRA,Juventus,Serie A,2024,33.0,1991.0,6.5,10,4,7,2,1,5,10,50.0,5,4,3,1,9,19,21,1,DF,30-34,Defender,Brazil,South America
536,Danilo,BRA,Juventus,Serie A,2024,33.0,1991.0,6.5,10,4,7,2,1,5,10,50.0,5,4,3,1,9,19,21,1,DF,30-34,Defender,Brazil,South America
536,Danilo,BRA,Juventus,Serie A,2024,33.0,1991.0,6.5,10,4,7,2,1,5,10,50.0,5,4,3,1,9,19,21,1,DF,30-34,Defender,Brazil,South America
536,Danilo,BRA,Juventus,Serie A,2024,33.0,1991.0,6.5,10,4,7,2,1,5,10,50.0,5,4,3,1,9,19,21,1,DF,30-34,Defender,Brazil,South America
536,Danilo,BRA,Juventus,Serie A,2024,33.0,1991.0,6.5,10,4,7,2,1,5,10,50.0,5,4,3,1,9,19,21,1,DF,30-34,Defender,Brazil,South America
536,Danilo,BRA,Juventus,Serie A,2024,33.0,1991.0,6.5,10,4,7,2,1,5,10,50.0,5,4,3,1,9,19,21,1,DF,30-34,Defender,Brazil,South America
536,Danilo,BRA,Juventus,Serie A,2024,33.0,1991.0,6.5,10,4,7,2,1,5,10,50.0,5,4,3,1,9,19,21,1,DF,30-34,Defender,Brazil,South America
536,Danilo,BRA,Juventus,Serie A,2024,33.0,1991.0,6.5,10,4,7,2,1,5,10,50.0,5,4,3,1,9,19,21,1,DF,30-34,Defender,Brazil,South America
536,Danilo,BRA,Juventus,Serie A,2024,33.0,1991.0,6.5,10,4,7,2,1,5,10,50.0,5,4,3,1,9,19,21,1,DF,30-34,Defender,Brazil,South America
536,Danilo,BRA,Juventus,Serie A,2024,33.0,1991.0,6.5,10,4,7,2,1,5,10,50.0,5,4,3,1,9,19,21,1,DF,30-34,Defender,Brazil,South America
536,Danilo,BRA,Juventus,Serie A,2024,33.0,1991.0,6.5,10,4,7,2,1,5,10,50.0,5,4,3,1,9,19,21,1,DF,30-34,Defender,Brazil,South America
536,Danilo,BRA,Juventus,Serie A,2024,33.0,1991.0,6.5,10,4,7,2,1,5,10,50.0,5,4,3,1,9,19,21,1,DF,30-34,Defender,Brazil,South America
536,Danilo,BRA,Juventus,Serie A,2024,33.0,1991.0,6.5,10,4,7,2,1,5,10,50.0,5,4,3,1,9,19,21,1,DF,30-34,Defender,Brazil,South America
536,Danilo,BRA,Juventus,Serie A,2024,33.0,1991.0,6.5,10,4,7,2,1,5,10,50.0,5,4,3,1,9,19,21,1,DF,30-34,Defender,Brazil,South America
536,Danilo,BRA,Juventus,Serie A,2024,33.0,1991.0,6.5,10,4,7,2,1,5,10,50.0,5,4,3,1,9,19,21,1,DF,30-34,Defender,Brazil,South America
536,Danilo,BRA,Juventus,Serie A,2024,33.0,1991.0,6.5,10,4,7,2,1,5,10,50.0,5,4,3,1,9,19,21,1,DF,30-34,Defender,Brazil,South America
536,Danilo,BRA,Juventus,Serie A,2024,33.0,1991.0,6.5,10,4,7,2,1,5,10,50.0,5,4,3,1,9,19,21,1,DF,30-34,Defender,Brazil,South America
536,Danilo,BRA,Juventus,Serie A,2024,33.0,1991.0,6.5,10,4,7,2,1,5,10,50.0,5,4,3,1,9,19,21,1,DF,30-34,Defender,Brazil,South America
536,Danilo,BRA,Juventus,Serie A,2024,33.0,1991.0,6.5,10,4,7,2,1,5,10,50.0,5,4,3,1,9,19,21,1,DF,30-34,Defender,Brazil,South America
536,Danilo,BRA,Juventus,Serie A,2024,33.0,1991.0,6.5,10,4,7,2,1,5,10,50.0,5,4,3,1,9,19,21,1,DF,30-34,Defender,Brazil,South America
536,Danilo,BRA,Juventus,Serie A,2024,33.0,1991.0,6.5,10,4,7,2,1,5,10,50.0,5,4,3,1,9,19,21,1,DF,30-34,Defender,Brazil,South America
536,Danilo,BRA,Juventus,Serie A,2024,33.0,1991.0,6.5,10,4,7,2,1,5,10,50.0,5,4,3,1,9,19,21,1,DF,30-34,Defender,Brazil,South America
536,Danilo,BRA,Juventus,Serie A,2024,33.0,1991.0,6.5,10,4,7,2,1,5,10,50.0,5,4,3,1,9,19,21,1,DF,30-34,Defender,Brazil,South America
536,Danilo,BRA,Juventus,Serie A,2024,33.0,1991.0,6.5,10,4,7,2,1,5,10,50.0,5,4,3,1,9,19,21,1,DF,30-34,Defender,Brazil,South America
536,Danilo,BRA,Juventus,Serie A,2024,33.0,1991.0,6.5,10,4,7,2,1,5,10,50.0,5,4,3,1,9,19,21,1,DF,30-34,Defender,Brazil,South America
536,Danilo,BRA,Juventus,Serie A,2024,33.0,1991.0,6.5,10,4,7,2,1,5,10,50.0,5,4,3,1,9,19,21,1,DF,30-34,Defender,Brazil,South America
536,Danilo,BRA,Juventus,Serie A,2024,33.0,1991.0,6.5,10,4,7,2,1,5,10,50.0,5,4,3,1,9,19,21,1,DF,30-34,Defender,Brazil,South America
536,Danilo,BRA,Juventus,Serie A,2024,33.0,1991.0,6.5,10,4,7,2,1,5,10,50.0,5,4,3,1,9,19,21,1,DF,30-34,Defender,Brazil,South America
536,Danilo,BRA,Juventus,Serie A,2024,33.0,1991.0,6.5,10,4,7,2,1,5,10,50.0,5,4,3,1,9,19,21,1,DF,30-34,Defender,Brazil,South America
536,Danilo,BRA,Juventus,Serie A,2024,33.0,1991.0,6.5,10,4,7,2,1,5,10,50.0,5,4,3,1,9,19,21,1,DF,30-34,Defender,Brazil,South America
536,Danilo,BRA,Juventus,Serie A,2024,33.0,1991.0,6.5,10,4,7,2,1,5,10,50.0,5,4,3,1,9,19,21,1,DF,30-34,Defender,Brazil,South America
536,Danilo,BRA,Juventus,Serie A,2024,33.0,1991.0,6.5,10,4,7,2,1,5,10,50.0,5,4,3,1,9,19,21,1,DF,30-34,Defender,Brazil,South America
536,Danilo,BRA,Juventus,Serie A,2024,33.0,1991.0,6.5,10,4,7,2,1,5,10,50.0,5,4,3,1,9,19,21,1,DF,30-34,Defender,Brazil,South America
536,Danilo,BRA,Juventus,Serie A,2024,33.0,1991.0,6.5,10,4,7,2,1,5,10,50.0,5,4,3,1,9,19,21,1,DF,30-34,Defender,Brazil,South America
536,Danilo,BRA,Juventus,Serie A,2024,33.0,1991.0,6.5,10,4,7,2,1,5,10,50.0,5,4,3,1,9,19,21,1,DF,30-34,Defender,Brazil,South America
536,Danilo,BRA,Juventus,Serie A,2024,33.0,1991.0,6.5,10,4,7,2,1,5,10,50.0,5,4,3,1,9,19,21,1,DF,30-34,Defender,Brazil,South America
536,Danilo,BRA,Juventus,Serie A,2024,33.0,1991.0,6.5,10,4,7,2,1,5,10,50.0,5,4,3,1,9,19,21,1,DF,30-34,Defender,Brazil,South America
536,Danilo,BRA,Juventus,Serie A,2024,33.0,1991.0,6.5,10,4,7,2,1,5,10,50.0,5,4,3,1,9,19,21,1,DF,30-34,Defender,Brazil,South America
536,Danilo,BRA,Juventus,Serie A,2024,33.0,1991.0,6.5,10,4,7,2,1,5,10,50.0,5,4,3,1,9,19,21,1,DF,30-34,Defender,Brazil,South America
536,Danilo,BRA,Juventus,Serie A,2024,33.0,1991.0,6.5,10,4,7,2,1,5,10,50.0,5,4,3,1,9,19,21,1,DF,30-34,Defender,Brazil,South America
536,Danilo,BRA,Juventus,Serie A,2024,33.0,1991.0,6.5,10,4,7,2,1,5,10,50.0,5,4,3,1,9,19,21,1,DF,30-34,Defender,Brazil,South America
536,Danilo,BRA,Juventus,Serie A,2024,33.0,1991.0,6.5,10,4,7,2,1,5,10,50.0,5,4,3,1,9,19,21,1,DF,30-34,Defender,Brazil,South America
536,Danilo,BRA,Juventus,Serie A,2024,33.0,1991.0,6.5,10,4,7,2,1,5,10,50.0,5,4,3,1,9,19,21,1,DF,30-34,Defender,Brazil,South America
536,Danilo,BRA,Juventus,Serie A,2024,33.0,1991.0,6.5,10,4,7,2,1,5,10,50.0,5,4,3,1,9,19,21,1,DF,30-34,Defender,Brazil,South America
536,Danilo,BRA,Juventus,Serie A,2024,33.0,1991.0,6.5,10,4,7,2,1,5,10,50.0,5,4,3,1,9,19,21,1,DF,30-34,Defender,Brazil,South America
536,Danilo,BRA,Juventus,Serie A,2024,33.0,1991.0,6.5,10,4,7,2,1,5,10,50.0,5,4,3,1,9,19,21,1,DF,30-34,Defender,Brazil,South America
536,Danilo,BRA,Juventus,Serie A,2024,33.0,1991.0,6.5,10,4,7,2,1,5,10,50.0,5,4,3,1,9,19,21,1,DF,30-34,Defender,Brazil,South America
536,Danilo,BRA,Juventus,Serie A,2024,33.0,1991.0,6.5,10,4,7,2,1,5,10,50.0,5,4,3,1,9,19,21,1,DF,30-34,Defender,Brazil,South America
536,Danilo,BRA,Juventus,Serie A,2024,33.0,1991.0,6.5,10,4,7,2,1,5,10,50.0,5,4,3,1,9,19,21,1,DF,30-34,Defender,Brazil,South America
537,Arnaut Danjuma,NED,Villarreal,La Liga,2024,27.0,1997.0,2.2,2,1,0,1,1,0,1,0.0,1,1,0,1,0,2,0,0,FW,25-29,Forward,Netherlands,Europe
538,Arnaut Danjuma,NED,Girona,La Liga,2024,27.0,1997.0,7.7,5,3,2,2,1,1,4,25.0,3,4,1,3,1,6,0,0,"FW,MF",25-29,Forward,Netherlands,Europe
539,Kévin Danois,FRA,Auxerre,Ligue 1,2024,20.0,2004.0,9.8,35,22,15,15,5,13,32,40.6,19,6,0,6,15,50,14,0,MF,20-24,Midfielder,France,Europe
540,Kevin Danso,AUT,Lens,Ligue 1,2024,26.0,1998.0,10.0,16,6,12,4,0,9,11,81.8,2,23,18,5,18,34,56,1,DF,25-29,Defender,Austria,Europe
541,Dante,BRA,Nice,Ligue 1,2024,41.0,1983.0,8.3,19,8,9,8,2,10,15,66.7,5,5,1,4,11,30,26,0,DF,Over 40,Defender,Brazil,South America
543,Mohammed Daramy,DEN,Reims,Ligue 1,2024,22.0,2002.0,0.2,0,0,0,0,0,0,0,,0,0,0,0,0,0,1,0,FW,20-24,Forward,Denmark,Europe
544,Bence Dárdai,GER,Wolfsburg,Bundesliga,2024,18.0,2006.0,5.2,8,6,2,6,0,4,8,50.0,4,8,2,6,3,11,10,0,MF,Under 20,Midfielder,Germany,Europe
546,Matteo Darmian,ITA,Inter,Serie A,2024,35.0,1989.0,9.1,19,10,8,8,3,11,16,68.8,5,6,3,3,2,21,16,0,DF,35-39,Defender,Italy,Europe
547,Lukas Daschner,GER,Bochum,Bundesliga,2024,26.0,1998.0,4.2,4,2,1,2,1,2,9,22.2,7,5,0,5,0,4,4,0,"MF,FW",25-29,Midfielder,Germany,Europe
548,Juan David Cabal,COL,Juventus,Serie A,2024,23.0,2001.0,5.1,10,4,7,3,0,8,12,66.7,4,2,0,2,2,12,14,1,DF,20-24,Defender,Colombia,South America
549,Jonathan David,CAN,Lille,Ligue 1,2024,24.0,2000.0,13.1,12,3,2,7,3,4,10,40.0,6,6,2,4,3,15,3,0,FW,20-24,Forward,Canada,North America
550,Alphonso Davies,CAN,Bayern Munich,Bundesliga,2024,24.0,2000.0,12.1,20,12,6,11,3,11,16,68.8,5,12,1,11,8,28,15,1,DF,20-24,Defender,Canada,North America
551,Ben Davies,WAL,Tottenham,Premier League,2024,31.0,1993.0,3.0,1,0,0,1,0,1,4,25.0,3,6,5,1,5,6,18,0,DF,30-34,Defender,Wales,Europe
551,Ben Davies,WAL,Tottenham,Premier League,2024,31.0,1993.0,3.0,1,0,0,1,0,1,4,25.0,3,6,5,1,5,6,18,0,DF,30-34,Defender,Wales,Europe
551,Ben Davies,WAL,Tottenham,Premier League,2024,31.0,1993.0,3.0,1,0,0,1,0,1,4,25.0,3,6,5,1,5,6,18,0,DF,30-34,Defender,Wales,Europe
551,Ben Davies,WAL,Tottenham,Premier League,2024,31.0,1993.0,3.0,1,0,0,1,0,1,4,25.0,3,6,5,1,5,6,18,0,DF,30-34,Defender,Wales,Europe
552,Keinan Davis,ENG,Udinese,Serie A,2024,26.0,1998.0,7.6,6,3,1,3,2,1,2,50.0,1,2,1,1,1,7,4,0,FW,25-29,Forward,England,Europe
553,Leif Davis,ENG,Ipswich Town,Premier League,2024,24.0,2000.0,17.0,25,15,19,3,3,18,30,60.0,12,12,2,10,13,38,45,0,DF,20-24,Defender,England,Europe
554,Zuriko Davitashvili,GEO,Saint-Étienne,Ligue 1,2024,23.0,2001.0,14.2,10,5,3,5,2,8,23,34.8,15,8,0,8,9,19,3,0,"MF,FW",20-24,Midfielder,Georgia,Asia
556,Craig Dawson,ENG,Wolves,Premier League,2024,34.0,1990.0,9.9,14,3,8,5,1,11,14,78.6,3,14,11,3,9,23,48,1,DF,30-34,Defender,England,Europe
557,Kevin De Bruyne,BEL,Manchester City,Premier League,2024,33.0,1991.0,7.0,5,3,2,1,2,1,8,12.5,7,3,0,3,3,8,2,1,MF,30-34,Midfielder,Belgium,Europe
558,Charles De Ketelaere,BEL,Atalanta,Serie A,2024,23.0,2001.0,12.1,5,5,0,4,1,1,6,16.7,5,4,2,2,1,6,6,0,"MF,FW",20-24,Midfielder,Belgium,Europe
559,Rodrigo De Paul,ARG,Atlético Madrid,La Liga,2024,30.0,1994.0,9.9,10,8,6,4,0,6,14,42.9,8,8,0,8,4,14,8,2,MF,30-34,Midfielder,Argentina,South America
560,Mattia De Sciglio,ITA,Empoli,Serie A,2024,32.0,1992.0,1.9,3,1,0,3,0,3,4,75.0,1,2,0,2,2,5,8,0,DF,30-34,Defender,Italy,Europe
561,Lorenzo De Silvestri,ITA,Bologna,Serie A,2024,36.0,1988.0,5.7,5,3,3,1,1,3,10,30.0,7,6,1,5,4,9,16,0,DF,35-39,Defender,Italy,Europe
562,Thibault De Smet,BEL,Reims,Ligue 1,2024,26.0,1998.0,1.1,2,2,2,0,0,1,1,100.0,0,3,1,2,2,4,9,0,DF,25-29,Defender,Belgium,Europe
563,Koni De Winter,BEL,Genoa,Serie A,2024,22.0,2002.0,7.0,12,9,6,5,1,4,6,66.7,2,2,1,1,8,20,34,0,DF,20-24,Defender,Belgium,Europe
564,Alessandro Deiola,ITA,Cagliari,Serie A,2024,29.0,1995.0,7.7,18,11,5,11,2,5,19,26.3,14,11,6,5,4,22,24,0,MF,25-29,Midfielder,Italy,Europe
565,Romain Del Castillo,FRA,Brest,Ligue 1,2024,28.0,1996.0,8.8,18,11,4,8,6,11,19,57.9,8,11,0,11,5,23,0,0,FW,25-29,Forward,France,Europe
566,Enrico Del Prato,ITA,Parma,Serie A,2024,25.0,1999.0,14.7,10,8,5,4,1,5,10,50.0,5,36,20,16,13,23,64,1,DF,25-29,Defender,Italy,Europe
567,Liam Delap,ENG,Ipswich Town,Premier League,2024,21.0,2003.0,13.2,6,4,2,1,3,0,7,0.0,7,4,0,4,2,8,14,0,FW,20-24,Forward,England,Europe
568,Fisayo Dele-Bashiru,NGA,Lazio,Serie A,2024,23.0,2001.0,3.8,4,3,1,2,1,0,0,,0,4,1,3,2,6,2,0,"MF,FW",20-24,Midfielder,Nigeria,Africa
569,Olivier Deman,BEL,Werder Bremen,Bundesliga,2024,24.0,2000.0,0.7,6,3,2,4,0,2,7,28.6,5,3,1,2,3,9,4,0,DF,20-24,Defender,Belgium,Europe
570,Ali Dembélé,FRA,Torino,Serie A,2024,20.0,2004.0,0.8,3,2,2,1,0,3,3,100.0,0,0,0,0,0,3,2,0,DF,20-24,Defender,France,Europe
571,Ousmane Dembélé,FRA,Paris S-G,Ligue 1,2024,27.0,1997.0,10.0,5,2,0,2,3,2,6,33.3,4,1,0,1,7,12,0,1,FW,25-29,Forward,France,Europe
572,Ermedin Demirović,BIH,Stuttgart,Bundesliga,2024,26.0,1998.0,10.8,5,3,1,1,3,1,6,16.7,5,8,1,7,2,7,4,0,FW,25-29,Forward,Bosnia and Herzegovina,Europe
573,Sepp van den Berg,NED,Brentford,Premier League,2024,23.0,2001.0,13.0,22,13,14,6,2,11,20,55.0,9,23,14,9,10,32,50,2,DF,20-24,Defender,Netherlands,Europe
574,Arthur Desmas,FRA,Le Havre,Ligue 1,2024,30.0,1994.0,15.0,0,0,0,0,0,0,1,0.0,1,0,0,0,0,0,6,1,GK,30-34,Goalkeeper,France,Europe
576,Kiernan Dewsbury-Hall,ENG,Chelsea,Premier League,2024,26.0,1998.0,0.7,0,0,0,0,0,0,0,,0,1,0,1,1,1,2,1,MF,25-29,Midfielder,England,Europe
577,Michele Di Gregorio,ITA,Juventus,Serie A,2024,27.0,1997.0,12.0,0,0,0,0,0,0,0,,0,0,0,0,0,0,2,0,GK,25-29,Goalkeeper,Italy,Europe
578,Giovanni Di Lorenzo,ITA,Napoli,Serie A,2024,31.0,1993.0,17.0,38,26,20,15,3,24,34,70.6,10,6,3,3,17,55,43,1,DF,30-34,Defender,Italy,Europe
579,Boulaye Dia,SEN,Lazio,Serie A,2024,28.0,1996.0,9.5,9,3,4,1,4,5,10,50.0,5,2,0,2,3,12,3,1,"MF,FW",25-29,Midfielder,Senegal,Africa
580,Mamadou Diakhon,FRA,Reims,Ligue 1,2024,19.0,2005.0,1.7,5,5,2,0,3,4,5,80.0,1,0,0,0,1,6,1,0,"FW,MF",Under 20,Forward,France,Europe
581,Bafodé Diakité,FRA,Lille,Ligue 1,2024,23.0,2001.0,15.0,15,9,9,4,2,11,17,64.7,6,13,6,7,16,31,42,3,DF,20-24,Defender,France,Europe
582,Oumar Diakité,CIV,Reims,Ligue 1,2024,21.0,2003.0,11.8,15,10,7,5,3,7,14,50.0,7,8,1,7,2,17,6,0,FW,20-24,Forward,Ivory Coast,Africa
583,Amad Diallo,CIV,Manchester Utd,Premier League,2024,22.0,2002.0,10.8,24,20,4,12,8,12,18,66.7,6,3,0,3,8,32,11,0,"FW,DF",20-24,Forward,Ivory Coast,Africa
585,Habib Diarra,SEN,Strasbourg,Ligue 1,2024,20.0,2004.0,13.2,10,6,1,7,2,5,9,55.6,4,8,2,6,4,14,19,1,"MF,FW",20-24,Midfielder,Senegal,Africa
586,Moussa Diarra,MLI,Alavés,La Liga,2024,24.0,2000.0,10.4,19,12,7,11,1,11,17,64.7,6,6,1,5,12,31,12,0,DF,20-24,Defender,Mali,Africa
587,Rúben Dias,POR,Manchester City,Premier League,2024,27.0,1997.0,12.1,9,5,3,5,1,3,4,75.0,1,10,9,1,12,21,32,1,DF,25-29,Defender,Portugal,Europe
588,Krépin Diatta,SEN,Monaco,Ligue 1,2024,25.0,1999.0,2.2,11,7,8,1,2,7,13,53.8,6,4,1,3,3,14,7,1,DF,25-29,Defender,Senegal,Africa
589,Kandet Diawara,GUI,Le Havre,Ligue 1,2024,24.0,2000.0,0.0,0,0,0,0,0,0,0,,0,1,0,1,0,0,1,0,FW,20-24,Forward,Guinea,Africa
590,Mahamadou Diawara,FRA,Lyon,Ligue 1,2024,19.0,2005.0,0.2,1,0,0,1,0,1,3,33.3,2,2,0,2,0,1,0,0,MF,Under 20,Midfielder,France,Europe
591,Brahim Díaz,MAR,Real Madrid,La Liga,2024,25.0,1999.0,6.5,14,10,6,7,1,1,6,16.7,5,8,0,8,2,16,1,0,"FW,MF",25-29,Forward,Morocco,Africa
592,Luis Díaz,COL,Liverpool,Premier League,2024,27.0,1997.0,10.7,13,7,5,7,1,6,14,42.9,8,10,0,10,3,16,4,1,FW,25-29,Forward,Colombia,South America
594,Tyler Dibling,ENG,Southampton,Premier League,2024,18.0,2006.0,10.8,18,12,6,10,2,8,14,57.1,6,8,2,6,4,22,6,0,"FW,MF",Under 20,Forward,England,Europe
596,Justin Diehl,GER,Stuttgart,Bundesliga,2024,20.0,2004.0,0.9,0,0,0,0,0,0,0,,0,2,0,2,0,0,0,0,"FW,DF",20-24,Forward,Germany,Europe
597,Bamba Dieng,SEN,Angers,Ligue 1,2024,24.0,2000.0,4.3,3,0,1,1,1,0,0,,0,1,0,1,0,3,3,0,FW,20-24,Forward,Senegal,Africa
598,Eric Dier,ENG,Bayern Munich,Bundesliga,2024,30.0,1994.0,1.3,2,2,2,0,0,1,2,50.0,1,3,0,3,1,3,4,0,DF,30-34,Defender,England,Europe
599,Lucas Digne,FRA,Aston Villa,Premier League,2024,31.0,1993.0,13.9,33,20,19,8,6,22,34,64.7,12,13,3,10,19,52,42,1,DF,30-34,Defender,France,Europe
600,Federico Dimarco,ITA,Inter,Serie A,2024,27.0,1997.0,13.2,9,4,4,3,2,5,8,62.5,3,11,2,9,9,18,13,0,"DF,FW",25-29,Defender,Italy,Europe
601,Stole Dimitrievski,MKD,Valencia,La Liga,2024,31.0,1993.0,3.0,0,0,0,0,0,0,0,,0,0,0,0,0,0,1,1,GK,30-34,Goalkeeper,North Macedonia,Europe
602,Junior Dina Ebimbe,FRA,Eint Frankfurt,Bundesliga,2024,24.0,2000.0,3.1,2,1,1,1,0,0,2,0.0,2,4,0,4,7,9,6,0,"MF,FW",20-24,Midfielder,France,Europe
603,Eren Dinkçi,GER,Freiburg,Bundesliga,2024,23.0,2001.0,6.9,13,7,3,6,4,3,13,23.1,10,14,2,12,4,17,1,0,MF,20-24,Midfielder,Germany,Europe
604,Sinaly Diomande,CIV,Auxerre,Ligue 1,2024,23.0,2001.0,7.8,10,7,3,6,1,8,12,66.7,4,13,9,4,9,19,26,0,DF,20-24,Defender,Ivory Coast,Africa
605,Lois Diony,FRA,Angers,Ligue 1,2024,32.0,1992.0,0.2,0,0,0,0,0,0,0,,0,0,0,0,0,0,0,0,FW,30-34,Forward,France,Europe
606,Issa Diop,FRA,Fulham,Premier League,2024,27.0,1997.0,9.4,14,8,10,4,0,6,9,66.7,3,7,6,1,2,16,44,0,DF,25-29,Defender,France,Europe
607,Sofiane Diop,FRA,Nice,Ligue 1,2024,24.0,2000.0,5.3,14,11,9,2,3,7,14,50.0,7,15,2,13,5,19,4,0,"MF,FW",20-24,Midfielder,France,Europe
608,Andy Diouf,FRA,Lens,Ligue 1,2024,21.0,2003.0,11.4,17,11,4,10,3,10,20,50.0,10,16,1,15,8,25,8,0,MF,20-24,Midfielder,France,Europe
609,Yehvann Diouf,FRA,Reims,Ligue 1,2024,25.0,1999.0,15.0,1,1,1,0,0,1,2,50.0,1,0,0,0,0,1,4,1,GK,25-29,Goalkeeper,France,Europe
610,Assane Dioussé,SEN,Auxerre,Ligue 1,2024,27.0,1997.0,0.3,1,1,0,1,0,0,0,,0,0,0,0,0,1,1,0,MF,25-29,Midfielder,Senegal,Africa
611,Axel Disasi,FRA,Chelsea,Premier League,2024,26.0,1998.0,3.0,5,4,4,0,1,4,7,57.1,3,3,1,2,1,6,9,0,DF,25-29,Defender,France,Europe
612,Roman Dixon,ENG,Everton,Premier League,2024,20.0,2004.0,1.0,5,5,3,2,0,4,4,100.0,0,1,0,1,1,6,3,0,DF,20-24,Defender,England,Europe
615,Berat Djimsiti,ALB,Atalanta,Serie A,2024,31.0,1993.0,12.5,29,18,15,14,0,15,18,83.3,3,15,9,6,23,52,42,1,DF,30-34,Defender,Albania,Europe
617,Ritsu Doan,JPN,Freiburg,Bundesliga,2024,26.0,1998.0,13.7,24,18,12,10,2,9,16,56.3,7,21,0,21,7,31,12,1,"FW,MF",25-29,Forward,Japan,Asia
618,Dodô,BRA,Fiorentina,Serie A,2024,26.0,1998.0,14.9,15,12,8,4,3,9,18,50.0,9,10,3,7,20,35,28,1,DF,25-29,Defender,Brazil,South America
618,Dodô,BRA,Fiorentina,Serie A,2024,26.0,1998.0,14.9,15,12,8,4,3,9,18,50.0,9,10,3,7,20,35,28,1,DF,25-29,Defender,Brazil,South America
618,Dodô,BRA,Fiorentina,Serie A,2024,26.0,1998.0,14.9,15,12,8,4,3,9,18,50.0,9,10,3,7,20,35,28,1,DF,25-29,Defender,Brazil,South America
618,Dodô,BRA,Fiorentina,Serie A,2024,26.0,1998.0,14.9,15,12,8,4,3,9,18,50.0,9,10,3,7,20,35,28,1,DF,25-29,Defender,Brazil,South America
618,Dodô,BRA,Fiorentina,Serie A,2024,26.0,1998.0,14.9,15,12,8,4,3,9,18,50.0,9,10,3,7,20,35,28,1,DF,25-29,Defender,Brazil,South America
618,Dodô,BRA,Fiorentina,Serie A,2024,26.0,1998.0,14.9,15,12,8,4,3,9,18,50.0,9,10,3,7,20,35,28,1,DF,25-29,Defender,Brazil,South America
618,Dodô,BRA,Fiorentina,Serie A,2024,26.0,1998.0,14.9,15,12,8,4,3,9,18,50.0,9,10,3,7,20,35,28,1,DF,25-29,Defender,Brazil,South America
618,Dodô,BRA,Fiorentina,Serie A,2024,26.0,1998.0,14.9,15,12,8,4,3,9,18,50.0,9,10,3,7,20,35,28,1,DF,25-29,Defender,Brazil,South America
618,Dodô,BRA,Fiorentina,Serie A,2024,26.0,1998.0,14.9,15,12,8,4,3,9,18,50.0,9,10,3,7,20,35,28,1,DF,25-29,Defender,Brazil,South America
619,Danilho Doekhi,NED,Union Berlin,Bundesliga,2024,26.0,1998.0,15.0,19,11,10,7,2,8,11,72.7,3,19,7,12,22,41,46,0,DF,25-29,Defender,Netherlands,Europe
620,Matt Doherty,IRL,Wolves,Premier League,2024,32.0,1992.0,5.9,11,7,7,4,0,4,6,66.7,2,7,3,4,5,16,16,0,DF,30-34,Defender,Republic of Ireland,Europe
621,Jeremy Doku,BEL,Manchester City,Premier League,2024,22.0,2002.0,6.9,14,9,6,4,4,3,5,60.0,2,6,1,5,1,15,2,0,"FW,MF",20-24,Forward,Belgium,Europe
624,Benjamín Domínguez,ARG,Bologna,Serie A,2024,21.0,2003.0,3.1,3,0,0,2,1,0,3,0.0,3,3,1,2,2,5,2,0,FW,20-24,Forward,Argentina,South America
627,Nicolás Domínguez,ARG,Nott'ham Forest,Premier League,2024,26.0,1998.0,9.0,29,13,13,11,5,14,29,48.3,15,17,4,13,16,45,15,0,"MF,FW",25-29,Midfielder,Argentina,South America
629,Gianluigi Donnarumma,ITA,Paris S-G,Ligue 1,2024,25.0,1999.0,11.2,1,1,1,0,0,1,1,100.0,0,0,0,0,0,1,5,0,GK,25-29,Goalkeeper,Italy,Europe
630,Patrick Dorgu,DEN,Lecce,Serie A,2024,20.0,2004.0,15.4,30,17,13,13,4,16,30,53.3,14,16,3,13,13,43,32,2,"FW,DF",20-24,Forward,Denmark,Europe
631,Alfie Dorrington,ENG,Tottenham,Premier League,2024,19.0,2005.0,0.2,0,0,0,0,0,0,0,,0,0,0,0,0,0,0,0,DF,Under 20,Defender,England,Europe
632,Niklas Dorsch,GER,Augsburg,Bundesliga,2024,26.0,1998.0,0.4,0,0,0,0,0,0,0,,0,1,0,1,0,0,0,0,MF,25-29,Midfielder,Germany,Europe
633,Niklas Dorsch,GER,Heidenheim,Bundesliga,2024,26.0,1998.0,7.2,13,7,4,9,0,4,9,44.4,5,9,1,8,7,20,9,0,MF,25-29,Midfielder,Germany,Europe
634,Alberto Dossena,ITA,Como,Serie A,2024,26.0,1998.0,12.6,17,9,13,4,0,7,12,58.3,5,12,9,3,13,30,63,1,DF,25-29,Defender,Italy,Europe
635,Abdoulaye Doucouré,MLI,Everton,Premier League,2024,31.0,1993.0,11.9,21,9,12,7,2,6,13,46.2,7,17,4,13,5,26,10,0,MF,30-34,Midfielder,Mali,Africa
636,Cheick Doucouré,MLI,Crystal Palace,Premier League,2024,24.0,2000.0,3.0,8,3,1,5,2,3,8,37.5,5,4,0,4,7,15,4,0,MF,20-24,Midfielder,Mali,Africa
637,Désiré Doué,FRA,Paris S-G,Ligue 1,2024,19.0,2005.0,6.5,8,6,2,5,1,3,13,23.1,10,5,0,5,3,11,4,0,FW,Under 20,Forward,France,Europe
638,Guela Doué,CIV,Strasbourg,Ligue 1,2024,22.0,2002.0,14.0,27,20,16,4,7,16,23,69.6,7,12,0,12,22,49,68,0,DF,20-24,Defender,Ivory Coast,Africa
639,Douglas,BRA,Nantes,Ligue 1,2024,27.0,1997.0,12.4,32,18,10,17,5,11,20,55.0,9,25,5,20,8,40,15,0,MF,25-29,Midfielder,Brazil,South America
639,Douglas,BRA,Nantes,Ligue 1,2024,27.0,1997.0,12.4,32,18,10,17,5,11,20,55.0,9,25,5,20,8,40,15,0,MF,25-29,Midfielder,Brazil,South America
639,Douglas,BRA,Nantes,Ligue 1,2024,27.0,1997.0,12.4,32,18,10,17,5,11,20,55.0,9,25,5,20,8,40,15,0,MF,25-29,Midfielder,Brazil,South America
639,Douglas,BRA,Nantes,Ligue 1,2024,27.0,1997.0,12.4,32,18,10,17,5,11,20,55.0,9,25,5,20,8,40,15,0,MF,25-29,Midfielder,Brazil,South America
639,Douglas,BRA,Nantes,Ligue 1,2024,27.0,1997.0,12.4,32,18,10,17,5,11,20,55.0,9,25,5,20,8,40,15,0,MF,25-29,Midfielder,Brazil,South America
639,Douglas,BRA,Nantes,Ligue 1,2024,27.0,1997.0,12.4,32,18,10,17,5,11,20,55.0,9,25,5,20,8,40,15,0,MF,25-29,Midfielder,Brazil,South America
639,Douglas,BRA,Nantes,Ligue 1,2024,27.0,1997.0,12.4,32,18,10,17,5,11,20,55.0,9,25,5,20,8,40,15,0,MF,25-29,Midfielder,Brazil,South America
639,Douglas,BRA,Nantes,Ligue 1,2024,27.0,1997.0,12.4,32,18,10,17,5,11,20,55.0,9,25,5,20,8,40,15,0,MF,25-29,Midfielder,Brazil,South America
639,Douglas,BRA,Nantes,Ligue 1,2024,27.0,1997.0,12.4,32,18,10,17,5,11,20,55.0,9,25,5,20,8,40,15,0,MF,25-29,Midfielder,Brazil,South America
639,Douglas,BRA,Nantes,Ligue 1,2024,27.0,1997.0,12.4,32,18,10,17,5,11,20,55.0,9,25,5,20,8,40,15,0,MF,25-29,Midfielder,Brazil,South America
639,Douglas,BRA,Nantes,Ligue 1,2024,27.0,1997.0,12.4,32,18,10,17,5,11,20,55.0,9,25,5,20,8,40,15,0,MF,25-29,Midfielder,Brazil,South America
639,Douglas,BRA,Nantes,Ligue 1,2024,27.0,1997.0,12.4,32,18,10,17,5,11,20,55.0,9,25,5,20,8,40,15,0,MF,25-29,Midfielder,Brazil,South America
639,Douglas,BRA,Nantes,Ligue 1,2024,27.0,1997.0,12.4,32,18,10,17,5,11,20,55.0,9,25,5,20,8,40,15,0,MF,25-29,Midfielder,Brazil,South America
639,Douglas,BRA,Nantes,Ligue 1,2024,27.0,1997.0,12.4,32,18,10,17,5,11,20,55.0,9,25,5,20,8,40,15,0,MF,25-29,Midfielder,Brazil,South America
639,Douglas,BRA,Nantes,Ligue 1,2024,27.0,1997.0,12.4,32,18,10,17,5,11,20,55.0,9,25,5,20,8,40,15,0,MF,25-29,Midfielder,Brazil,South America
639,Douglas,BRA,Nantes,Ligue 1,2024,27.0,1997.0,12.4,32,18,10,17,5,11,20,55.0,9,25,5,20,8,40,15,0,MF,25-29,Midfielder,Brazil,South America
639,Douglas,BRA,Nantes,Ligue 1,2024,27.0,1997.0,12.4,32,18,10,17,5,11,20,55.0,9,25,5,20,8,40,15,0,MF,25-29,Midfielder,Brazil,South America
639,Douglas,BRA,Nantes,Ligue 1,2024,27.0,1997.0,12.4,32,18,10,17,5,11,20,55.0,9,25,5,20,8,40,15,0,MF,25-29,Midfielder,Brazil,South America
639,Douglas,BRA,Nantes,Ligue 1,2024,27.0,1997.0,12.4,32,18,10,17,5,11,20,55.0,9,25,5,20,8,40,15,0,MF,25-29,Midfielder,Brazil,South America
639,Douglas,BRA,Nantes,Ligue 1,2024,27.0,1997.0,12.4,32,18,10,17,5,11,20,55.0,9,25,5,20,8,40,15,0,MF,25-29,Midfielder,Brazil,South America
639,Douglas,BRA,Nantes,Ligue 1,2024,27.0,1997.0,12.4,32,18,10,17,5,11,20,55.0,9,25,5,20,8,40,15,0,MF,25-29,Midfielder,Brazil,South America
639,Douglas,BRA,Nantes,Ligue 1,2024,27.0,1997.0,12.4,32,18,10,17,5,11,20,55.0,9,25,5,20,8,40,15,0,MF,25-29,Midfielder,Brazil,South America
639,Douglas,BRA,Nantes,Ligue 1,2024,27.0,1997.0,12.4,32,18,10,17,5,11,20,55.0,9,25,5,20,8,40,15,0,MF,25-29,Midfielder,Brazil,South America
639,Douglas,BRA,Nantes,Ligue 1,2024,27.0,1997.0,12.4,32,18,10,17,5,11,20,55.0,9,25,5,20,8,40,15,0,MF,25-29,Midfielder,Brazil,South America
639,Douglas,BRA,Nantes,Ligue 1,2024,27.0,1997.0,12.4,32,18,10,17,5,11,20,55.0,9,25,5,20,8,40,15,0,MF,25-29,Midfielder,Brazil,South America
640,Ismaël Doukouré,FRA,Strasbourg,Ligue 1,2024,21.0,2003.0,11.8,21,8,10,11,0,10,13,76.9,3,16,6,10,12,33,42,2,"MF,DF",20-24,Midfielder,France,Europe
641,Issa Doumbia,CIV,Venezia,Serie A,2024,21.0,2003.0,2.3,3,1,1,2,0,3,4,75.0,1,6,2,4,1,4,3,0,MF,20-24,Midfielder,Ivory Coast,Africa
642,Kamory Doumbia,MLI,Brest,Ligue 1,2024,21.0,2003.0,6.2,18,13,7,9,2,8,18,44.4,10,4,0,4,11,29,6,0,"MF,FW",20-24,Midfielder,Mali,Africa
643,Amidou Doumbouya,FRA,Nice,Ligue 1,2024,17.0,2007.0,0.5,1,1,0,0,1,1,1,100.0,0,3,1,2,1,2,1,0,DF,Under 20,Defender,France,Europe
644,Anastasios Douvikas,GRE,Celta Vigo,La Liga,2024,25.0,1999.0,7.0,8,3,2,5,1,3,5,60.0,2,5,2,3,3,11,5,0,FW,25-29,Forward,Greece,Europe
645,Artem Dovbyk,UKR,Roma,Serie A,2024,27.0,1997.0,13.8,3,2,0,1,2,0,2,0.0,2,6,2,4,1,4,7,0,FW,25-29,Forward,Ukraine,Europe
646,Flynn Downes,ENG,Southampton,Premier League,2024,25.0,1999.0,14.5,32,17,16,14,2,10,26,38.5,16,17,4,13,19,51,27,3,MF,25-29,Midfielder,England,Europe
647,Tommy Doyle,ENG,Wolves,Premier League,2024,23.0,2001.0,3.8,7,3,2,3,2,3,9,33.3,6,5,2,3,3,10,6,0,MF,20-24,Midfielder,England,Europe
648,Radu Drăgușin,ROU,Tottenham,Premier League,2024,22.0,2002.0,9.0,9,5,7,2,0,6,10,60.0,4,13,9,4,12,21,34,4,DF,20-24,Defender,Romania,Europe
649,Patrick Drewes,GER,Bochum,Bundesliga,2024,31.0,1993.0,15.0,0,0,0,0,0,0,1,0.0,1,0,0,0,0,0,10,1,GK,30-34,Goalkeeper,Germany,Europe
650,Tim Drexler,GER,Hoffenheim,Bundesliga,2024,19.0,2005.0,4.0,17,7,11,6,0,9,12,75.0,3,6,4,2,1,18,9,1,DF,Under 20,Defender,Germany,Europe
651,Domingos Duarte,POR,Getafe,La Liga,2024,29.0,1995.0,3.0,3,2,3,0,0,2,2,100.0,0,1,1,0,3,6,10,0,DF,25-29,Defender,Portugal,Europe
652,Martin Dúbravka,SVK,Newcastle Utd,Premier League,2024,35.0,1989.0,2.0,0,0,0,0,0,0,0,,0,0,0,0,0,0,0,0,GK,35-39,Goalkeeper,Slovakia,Europe
653,Marvin Ducksch,GER,Werder Bremen,Bundesliga,2024,30.0,1994.0,13.8,6,4,1,4,1,2,11,18.2,9,2,0,2,4,10,14,1,FW,30-34,Forward,Germany,Europe
654,Ondrej Duda,SVK,Hellas Verona,Serie A,2024,30.0,1994.0,9.9,15,10,6,8,1,10,22,45.5,12,8,2,6,13,28,7,3,MF,30-34,Midfielder,Slovakia,Europe
655,Denzel Dumfries,NED,Inter,Serie A,2024,28.0,1996.0,8.3,9,7,2,5,2,5,12,41.7,7,11,0,11,2,11,9,0,"DF,FW",25-29,Defender,Netherlands,Europe
656,Alfred Duncan,GHA,Venezia,Serie A,2024,31.0,1993.0,8.8,14,5,3,9,2,4,12,33.3,8,4,2,2,8,22,6,0,MF,30-34,Midfielder,Ghana,Africa
657,Lewis Dunk,ENG,Brighton,Premier League,2024,33.0,1991.0,12.0,8,4,4,3,1,2,3,66.7,1,14,9,5,9,17,34,0,DF,30-34,Defender,England,Europe
658,Jhon Durán,COL,Aston Villa,Premier League,2024,21.0,2003.0,6.3,8,7,1,2,5,1,4,25.0,3,5,0,5,0,8,12,0,FW,20-24,Forward,Colombia,South America
660,Julien Duranville,BEL,Dortmund,Bundesliga,2024,18.0,2006.0,0.6,0,0,0,0,0,0,0,,0,1,0,1,0,0,0,0,"FW,MF",Under 20,Forward,Belgium,Europe
662,Jean-Kevin Duverne,HAI,Nantes,Ligue 1,2024,27.0,1997.0,6.0,21,12,13,4,4,15,27,55.6,12,10,3,7,8,29,23,0,DF,25-29,Defender,Haiti,North America
663,Paulo Dybala,ARG,Roma,Serie A,2024,31.0,1993.0,9.7,12,5,2,6,4,6,10,60.0,4,4,0,4,1,13,0,0,"FW,MF",30-34,Forward,Argentina,South America
667,Enzo Ebosse,CMR,Udinese,Serie A,2024,25.0,1999.0,1.0,0,0,0,0,0,0,2,0.0,2,3,3,0,1,1,1,0,DF,25-29,Defender,Cameroon,Africa
668,Ederson,BRA,Manchester City,Premier League,2024,31.0,1993.0,13.0,0,0,0,0,0,0,2,0.0,2,0,0,0,1,1,3,1,GK,30-34,Goalkeeper,Brazil,South America
668,Ederson,BRA,Manchester City,Premier League,2024,31.0,1993.0,13.0,0,0,0,0,0,0,2,0.0,2,0,0,0,1,1,3,1,GK,30-34,Goalkeeper,Brazil,South America
668,Ederson,BRA,Manchester City,Premier League,2024,31.0,1993.0,13.0,0,0,0,0,0,0,2,0.0,2,0,0,0,1,1,3,1,GK,30-34,Goalkeeper,Brazil,South America
668,Ederson,BRA,Manchester City,Premier League,2024,31.0,1993.0,13.0,0,0,0,0,0,0,2,0.0,2,0,0,0,1,1,3,1,GK,30-34,Goalkeeper,Brazil,South America
669,Éderson,BRA,Atalanta,Serie A,2024,25.0,1999.0,15.8,19,14,8,10,1,9,15,60.0,6,8,1,7,20,39,16,0,MF,25-29,Midfielder,Brazil,South America
670,George Edmundson,ENG,Ipswich Town,Premier League,2024,27.0,1997.0,0.0,0,0,0,0,0,0,0,,0,0,0,0,0,0,0,0,DF,25-29,Defender,England,Europe
671,Odsonne Édouard,FRA,Crystal Palace,Premier League,2024,26.0,1998.0,1.3,1,0,0,1,0,0,2,0.0,2,1,0,1,0,1,1,0,"MF,FW",25-29,Midfielder,France,Europe
672,Odsonne Édouard,FRA,Leicester City,Premier League,2024,26.0,1998.0,0.3,1,1,1,0,0,0,0,,0,0,0,0,0,1,1,0,FW,25-29,Forward,France,Europe
673,Samuel Edozie,ENG,Southampton,Premier League,2024,21.0,2003.0,0.7,3,1,0,1,2,2,2,100.0,0,0,0,0,0,3,0,0,"DF,FW",20-24,Defender,England,Europe
674,Ronnie Edwards,ENG,Southampton,Premier League,2024,21.0,2003.0,0.1,0,0,0,0,0,0,0,,0,1,1,0,0,0,0,0,DF,20-24,Defender,England,Europe
675,Johannes Eggestein,GER,St. Pauli,Bundesliga,2024,26.0,1998.0,13.4,3,2,0,1,2,0,2,0.0,2,2,0,2,0,3,5,0,FW,25-29,Forward,Germany,Europe
676,Maximilian Eggestein,GER,Freiburg,Bundesliga,2024,28.0,1996.0,13.3,23,14,7,13,3,10,19,52.6,9,15,2,13,18,41,19,0,MF,25-29,Midfielder,Germany,Europe
677,Kingsley Ehizibue,NED,Udinese,Serie A,2024,29.0,1995.0,15.4,34,24,19,13,2,17,27,63.0,10,19,5,14,12,46,36,4,DF,25-29,Defender,Netherlands,Europe
678,Chidera Ejuke,NGA,Sevilla,La Liga,2024,26.0,1998.0,6.0,5,3,0,3,2,3,9,33.3,6,6,0,6,1,6,2,0,"FW,MF",25-29,Forward,Nigeria,Africa
679,Jeff Ekhator,ITA,Genoa,Serie A,2024,18.0,2006.0,4.0,0,0,0,0,0,0,0,,0,4,0,4,0,0,1,0,"FW,MF",Under 20,Forward,Italy,Europe
680,Hugo Ekitike,FRA,Eint Frankfurt,Bundesliga,2024,22.0,2002.0,11.2,9,6,3,3,3,4,5,80.0,1,5,1,4,5,14,6,0,FW,20-24,Forward,France,Europe
681,Jurgen Ekkelenkamp,NED,Udinese,Serie A,2024,24.0,2000.0,7.4,18,12,5,12,1,10,19,52.6,9,10,3,7,5,23,13,0,MF,20-24,Midfielder,Netherlands,Europe
682,Jacques Ekomie,GAB,Angers,Ligue 1,2024,21.0,2003.0,3.2,8,6,3,4,1,3,6,50.0,3,7,1,6,2,10,8,0,DF,20-24,Defender,Gabon,Africa
683,Emmanuel Ekong,SWE,Empoli,Serie A,2024,22.0,2002.0,1.9,4,3,0,2,2,3,3,100.0,0,1,0,1,1,5,1,0,"MF,FW",20-24,Midfielder,Sweden,Europe
684,Caleb Ekuban,GHA,Genoa,Serie A,2024,30.0,1994.0,2.6,1,1,0,1,0,0,0,,0,3,0,3,0,1,3,0,FW,30-34,Forward,Ghana,Africa
685,Pierre Ekwah Elimby,FRA,Saint-Étienne,Ligue 1,2024,22.0,2002.0,11.7,19,12,9,10,0,12,20,60.0,8,10,6,4,18,37,41,0,"MF,DF",20-24,Midfielder,France,Europe
686,Anthony Elanga,SWE,Nott'ham Forest,Premier League,2024,22.0,2002.0,9.8,8,5,4,3,1,2,6,33.3,4,4,0,4,4,12,16,0,"FW,MF",20-24,Forward,Sweden,Europe
687,Mikael Ellertsson,ISL,Venezia,Serie A,2024,22.0,2002.0,11.6,25,12,13,9,3,14,24,58.3,10,14,2,12,8,33,31,0,"DF,MF",20-24,Defender,Iceland,Europe
688,Harvey Elliott,ENG,Liverpool,Premier League,2024,21.0,2003.0,0.3,3,2,2,1,0,0,0,,0,1,0,1,0,3,0,0,"FW,DF",20-24,Forward,England,Europe
689,Elif Elmas,MKD,RB Leipzig,Bundesliga,2024,25.0,1999.0,0.5,3,1,3,0,0,1,3,33.3,2,2,0,2,0,3,2,0,MF,25-29,Midfielder,North Macedonia,Europe
691,Nico Elvedi,SUI,Gladbach,Bundesliga,2024,28.0,1996.0,8.5,12,6,7,2,3,6,7,85.7,1,11,9,2,10,22,49,0,DF,25-29,Defender,Switzerland,Europe
693,Breel Embolo,SUI,Monaco,Ligue 1,2024,27.0,1997.0,9.1,5,4,1,2,2,1,8,12.5,7,4,0,4,1,6,3,0,FW,25-29,Forward,Switzerland,Europe
694,Emanuel Emegha,NED,Strasbourg,Ligue 1,2024,21.0,2003.0,8.7,4,4,0,2,2,1,2,50.0,1,7,4,3,0,4,9,0,FW,20-24,Forward,Netherlands,Europe
695,Emerson,BRA,Milan,Serie A,2024,25.0,1999.0,12.5,32,20,16,12,4,15,32,46.9,17,8,2,6,13,45,43,0,DF,25-29,Defender,Brazil,South America
696,Yunus Emre Konak,TUR,Brentford,Premier League,2024,18.0,2006.0,0.2,1,1,0,1,0,0,1,0.0,1,0,0,0,0,1,0,0,"MF,FW",Under 20,Midfielder,Turkey,Asia
697,Julio Enciso,PAR,Brighton,Premier League,2024,20.0,2004.0,1.8,0,0,0,0,0,0,1,0.0,1,2,0,2,0,0,1,0,"MF,FW",20-24,Midfielder,Paraguay,South America
698,Wataru Endo,JPN,Liverpool,Premier League,2024,31.0,1993.0,0.3,3,2,0,3,0,2,2,100.0,0,2,0,2,1,4,1,0,MF,30-34,Midfielder,Japan,Asia
699,Endrick,BRA,Real Madrid,La Liga,2024,18.0,2006.0,1.0,0,0,0,0,0,0,1,0.0,1,0,0,0,1,1,0,0,FW,Under 20,Forward,Brazil,South America
700,Yannik Engelhardt,GER,Como,Serie A,2024,23.0,2001.0,6.6,18,7,6,11,1,10,14,71.4,4,1,0,1,4,22,14,0,MF,20-24,Midfielder,Germany,Europe
701,Arne Engels,BEL,Augsburg,Bundesliga,2024,21.0,2003.0,0.9,0,0,0,0,0,0,0,,0,1,1,0,0,0,0,0,"MF,FW",20-24,Midfielder,Belgium,Europe
702,Christian Eriksen,DEN,Manchester Utd,Premier League,2024,32.0,1992.0,5.6,9,3,2,5,2,5,10,50.0,5,4,1,3,4,13,5,0,MF,30-34,Midfielder,Denmark,Europe
703,Martin Erlic,CRO,Bologna,Serie A,2024,26.0,1998.0,2.5,2,0,0,2,0,1,2,50.0,1,5,4,1,1,3,5,0,DF,25-29,Defender,Croatia,Europe
704,Patrick Erras,GER,Holstein Kiel,Bundesliga,2024,29.0,1995.0,9.2,8,5,6,2,0,2,9,22.2,7,13,11,2,9,17,64,0,DF,25-29,Defender,Germany,Europe
705,Alfonso Espino,URU,Rayo Vallecano,La Liga,2024,32.0,1992.0,4.4,22,13,16,5,1,13,25,52.0,12,10,3,7,9,31,13,0,DF,30-34,Defender,Uruguay,South America
706,Sebastiano Esposito,ITA,Empoli,Serie A,2024,22.0,2002.0,9.2,20,10,5,12,3,8,16,50.0,8,6,1,5,8,28,4,0,"FW,MF",20-24,Forward,Italy,Europe
707,Samuel Essende,COD,Augsburg,Bundesliga,2024,26.0,1998.0,8.0,1,1,0,0,1,0,0,,0,8,1,7,0,1,3,0,FW,25-29,Forward,DR Congo,Africa
708,Dario Essugo,POR,Las Palmas,La Liga,2024,19.0,2005.0,10.6,29,20,18,7,4,14,25,56.0,11,10,5,5,23,52,24,6,MF,Under 20,Midfielder,Portugal,Europe
709,Nahuel Estévez,ARG,Parma,Serie A,2024,29.0,1995.0,4.0,6,3,4,1,1,2,8,25.0,6,6,2,4,3,9,14,0,MF,25-29,Midfielder,Argentina,South America
710,Pervis Estupiñán,ECU,Brighton,Premier League,2024,26.0,1998.0,11.8,28,19,16,8,4,12,19,63.2,7,5,2,3,15,43,32,0,DF,25-29,Defender,Ecuador,South America
711,Evanilson,BRA,Bournemouth,Premier League,2024,25.0,1999.0,13.1,8,4,1,4,3,3,7,42.9,4,7,1,6,0,8,11,0,FW,25-29,Forward,Brazil,South America
714,Eberechi Eze,ENG,Crystal Palace,Premier League,2024,26.0,1998.0,12.0,20,12,9,8,3,9,19,47.4,10,11,0,11,6,26,3,1,"MF,FW",25-29,Midfielder,England,Europe
715,Abde Ezzalzouli,MAR,Betis,La Liga,2024,23.0,2001.0,14.3,28,19,13,12,3,10,17,58.8,7,16,3,13,5,33,9,0,"FW,MF",20-24,Forward,Morocco,Africa
716,Giovanni Fabbian,ITA,Bologna,Serie A,2024,21.0,2003.0,5.2,8,5,1,2,5,5,8,62.5,3,1,1,0,2,10,4,0,MF,20-24,Midfielder,Italy,Europe
718,Alieu Fadera,GAM,Como,Serie A,2024,23.0,2001.0,11.9,40,32,14,16,10,14,31,45.2,17,10,1,9,5,45,6,0,FW,20-24,Forward,Gambia,Africa
719,Wout Faes,BEL,Leicester City,Premier League,2024,26.0,1998.0,14.0,21,13,15,5,1,9,24,37.5,15,26,18,8,11,32,85,3,DF,25-29,Defender,Belgium,Europe
720,Nicolò Fagioli,ITA,Juventus,Serie A,2024,23.0,2001.0,6.2,13,9,7,5,1,6,8,75.0,2,4,0,4,2,15,5,0,MF,20-24,Midfielder,Italy,Europe
721,Romain Faivre,FRA,Brest,Ligue 1,2024,26.0,1998.0,5.4,8,8,3,4,1,4,9,44.4,5,1,0,1,3,11,2,1,"FW,MF",25-29,Forward,France,Europe
722,Wladimiro Falcone,ITA,Lecce,Serie A,2024,29.0,1995.0,17.0,0,0,0,0,0,0,0,,0,0,0,0,0,0,12,1,GK,25-29,Goalkeeper,Italy,Europe
723,Davide Faraoni,ITA,Hellas Verona,Serie A,2024,33.0,1991.0,0.5,1,1,0,1,0,0,2,0.0,2,1,1,0,0,1,2,1,"DF,MF",30-34,Defender,Italy,Europe
724,Abdul Fatawu Issahaku,GHA,Leicester City,Premier League,2024,20.0,2004.0,6.4,21,15,13,2,6,11,19,57.9,8,7,0,7,4,25,12,0,FW,20-24,Forward,Ghana,Africa
726,Khalil Fayad,FRA,Montpellier,Ligue 1,2024,20.0,2004.0,2.8,14,7,5,9,0,5,8,62.5,3,4,0,4,1,15,4,0,"MF,FW",20-24,Midfielder,France,Europe
727,Jacopo Fazzini,ITA,Empoli,Serie A,2024,21.0,2003.0,6.3,17,9,8,8,1,10,14,71.4,4,7,1,6,2,19,10,0,MF,20-24,Midfielder,Italy,Europe
728,Peter Federico,DOM,Getafe,La Liga,2024,22.0,2002.0,3.4,6,3,1,3,2,3,4,75.0,1,5,0,5,0,6,3,0,"MF,FW",20-24,Midfielder,Dominican Republic,North America
729,Nabil Fekir,FRA,Betis,La Liga,2024,31.0,1993.0,2.0,3,2,1,1,1,1,2,50.0,1,2,0,2,0,3,0,0,MF,30-34,Midfielder,France,Europe
730,Mattia Felici,ITA,Cagliari,Serie A,2024,23.0,2001.0,2.0,4,4,1,2,1,1,4,25.0,3,1,0,1,5,9,1,0,"MF,DF",20-24,Midfielder,Italy,Europe
731,João Félix,POR,Chelsea,Premier League,2024,25.0,1999.0,3.3,7,3,2,4,1,5,8,62.5,3,2,0,2,3,10,2,0,"FW,MF",25-29,Forward,Portugal,Europe
733,Evan Ferguson,IRL,Brighton,Premier League,2024,20.0,2004.0,2.5,3,2,0,3,0,2,5,40.0,3,3,1,2,0,3,4,0,FW,20-24,Forward,Republic of Ireland,Europe
734,Lewis Ferguson,SCO,Bologna,Serie A,2024,25.0,1999.0,1.1,3,2,0,1,2,2,4,50.0,2,1,0,1,0,3,1,0,MF,25-29,Midfielder,Scotland,Europe
735,Zinedine Ferhat,ALG,Angers,Ligue 1,2024,31.0,1993.0,2.5,1,0,0,1,0,0,2,0.0,2,1,0,1,2,3,2,0,"FW,MF",30-34,Forward,Algeria,Africa
736,Bruno Fernandes,POR,Manchester Utd,Premier League,2024,30.0,1994.0,15.9,38,24,8,22,8,13,38,34.2,25,15,2,13,13,51,18,1,"MF,FW",30-34,Midfielder,Portugal,Europe
737,Edimilson Fernandes,SUI,Brest,Ligue 1,2024,28.0,1996.0,4.7,4,3,2,2,0,4,7,57.1,3,8,3,5,9,13,11,1,MF,25-29,Midfielder,Switzerland,Europe
738,Mateus Fernandes,POR,Southampton,Premier League,2024,20.0,2004.0,13.7,39,23,20,12,7,12,30,40.0,18,17,1,16,8,47,18,2,MF,20-24,Midfielder,Portugal,Europe
740,Enzo Fernández,ARG,Chelsea,Premier League,2024,23.0,2001.0,12.8,38,17,10,17,11,19,45,42.2,26,16,2,14,6,44,10,3,MF,20-24,Midfielder,Argentina,South America
742,Matias Fernandez-Pardo,BEL,Lille,Ligue 1,2024,19.0,2005.0,4.8,6,4,3,3,0,4,8,50.0,4,5,0,5,1,7,4,0,FW,Under 20,Forward,Belgium,Europe
743,Jordan Ferri,FRA,Montpellier,Ligue 1,2024,32.0,1992.0,8.8,21,10,9,11,1,10,17,58.8,7,7,1,6,4,25,7,0,MF,30-34,Midfielder,France,Europe
745,Kilian Fischer,GER,Wolfsburg,Bundesliga,2024,24.0,2000.0,11.7,28,18,21,5,2,20,45,44.4,25,20,3,17,8,36,47,2,DF,20-24,Defender,Germany,Europe
746,Mark Flekken,NED,Brentford,Premier League,2024,31.0,1993.0,17.0,2,2,2,0,0,1,6,16.7,5,0,0,0,0,2,16,2,GK,30-34,Goalkeeper,Netherlands,Europe
748,Phil Foden,ENG,Manchester City,Premier League,2024,24.0,2000.0,9.0,2,1,2,0,0,2,7,28.6,5,4,1,3,4,6,3,0,"MF,FW",20-24,Midfielder,England,Europe
749,Malick Fofana,BEL,Lyon,Ligue 1,2024,19.0,2005.0,9.0,12,8,5,6,1,6,11,54.5,5,8,0,8,6,18,6,0,FW,Under 20,Forward,Belgium,Europe
750,Wesley Fofana,FRA,Chelsea,Premier League,2024,24.0,2000.0,11.3,13,12,6,7,0,6,14,42.9,8,14,9,5,12,25,49,2,DF,20-24,Defender,France,Europe
751,Yahia Fofana,CIV,Angers,Ligue 1,2024,24.0,2000.0,15.0,0,0,0,0,0,0,1,0.0,1,0,0,0,1,1,12,0,GK,20-24,Goalkeeper,Ivory Coast,Africa
752,Youssouf Fofana,FRA,Milan,Serie A,2024,25.0,1999.0,13.6,24,15,5,17,2,12,24,50.0,12,13,3,10,10,34,14,2,MF,25-29,Midfielder,France,Europe
753,Jonas Föhrenbach,GER,Heidenheim,Bundesliga,2024,28.0,1996.0,14.1,26,13,15,10,1,13,20,65.0,7,20,3,17,11,37,40,0,DF,25-29,Defender,Germany,Europe
754,Michael Folorunsho,ITA,Napoli,Serie A,2024,26.0,1998.0,0.4,3,2,0,3,0,2,4,50.0,2,0,0,0,1,4,1,1,"FW,MF",25-29,Forward,Italy,Europe
755,Lamine Fomba,FRA,Saint-Étienne,Ligue 1,2024,26.0,1998.0,0.8,4,3,2,2,0,1,2,50.0,1,4,1,3,2,6,3,1,MF,25-29,Midfielder,France,Europe
756,Carlos Forbs,POR,Wolves,Premier League,2024,20.0,2004.0,2.3,7,5,4,2,1,4,5,80.0,1,3,0,3,1,8,2,1,"MF,FW",20-24,Midfielder,Portugal,Europe
758,Omari Forson,ENG,Monza,Serie A,2024,20.0,2004.0,0.7,2,2,1,1,0,1,1,100.0,0,2,0,2,0,2,0,0,"MF,FW",20-24,Midfielder,England,Europe
759,Fraser Forster,ENG,Tottenham,Premier League,2024,36.0,1988.0,5.0,0,0,0,0,0,0,1,0.0,1,0,0,0,0,0,4,2,GK,35-39,Goalkeeper,England,Europe
761,Dimitri Foulquier,FRA,Valencia,La Liga,2024,31.0,1993.0,10.1,26,18,16,7,3,13,20,65.0,7,9,1,8,4,30,23,1,DF,30-34,Defender,France,Europe
762,Juan Foyth,ARG,Villarreal,La Liga,2024,26.0,1998.0,0.3,0,0,0,0,0,0,0,,0,1,0,1,0,0,2,0,DF,25-29,Defender,Argentina,South America
766,Ryan Fraser,SCO,Southampton,Premier League,2024,30.0,1994.0,3.4,6,2,2,4,0,4,6,66.7,2,1,1,0,1,7,9,0,"FW,DF",30-34,Forward,Scotland,Europe
767,Davide Frattesi,ITA,Inter,Serie A,2024,25.0,1999.0,6.5,8,4,3,4,1,6,11,54.5,5,4,2,2,2,10,2,1,MF,25-29,Midfielder,Italy,Europe
768,Morten Frendrup,DEN,Genoa,Serie A,2024,23.0,2001.0,15.5,62,40,15,29,18,23,43,53.5,20,29,10,19,20,82,26,0,MF,20-24,Midfielder,Denmark,Europe
769,Martin Frese,DEN,Hellas Verona,Serie A,2024,26.0,1998.0,3.7,13,7,6,7,0,5,8,62.5,3,2,1,1,6,19,14,1,DF,25-29,Defender,Denmark,Europe
770,Remo Freuler,SUI,Bologna,Serie A,2024,32.0,1992.0,15.7,36,19,16,16,4,18,41,43.9,23,18,2,16,18,54,33,1,MF,30-34,Midfielder,Switzerland,Europe
771,Marco Friedl,AUT,Werder Bremen,Bundesliga,2024,26.0,1998.0,12.4,35,26,20,15,0,19,32,59.4,13,22,13,9,20,55,66,0,DF,25-29,Defender,Austria,Europe
772,Marvin Friedrich,GER,Gladbach,Bundesliga,2024,29.0,1995.0,6.8,7,2,7,0,0,4,6,66.7,2,11,9,2,2,9,33,0,DF,25-29,Defender,Germany,Europe
773,Jeremie Frimpong,NED,Leverkusen,Bundesliga,2024,24.0,2000.0,11.9,15,12,7,5,3,8,16,50.0,8,11,0,11,6,21,9,0,"DF,MF",20-24,Defender,Netherlands,Europe
776,Chris Führich,GER,Stuttgart,Bundesliga,2024,26.0,1998.0,8.5,5,3,1,3,1,5,12,41.7,7,10,2,8,1,6,10,0,"FW,MF",25-29,Forward,Germany,Europe
777,Angelo Fulgini,FRA,Lens,Ligue 1,2024,28.0,1996.0,6.5,5,4,2,1,2,3,5,60.0,2,7,1,6,0,5,2,0,"MF,FW",25-29,Midfielder,France,Europe
778,Niclas Füllkrug,GER,West Ham,Premier League,2024,31.0,1993.0,1.9,1,1,0,0,1,1,1,100.0,0,0,0,0,0,1,3,0,FW,30-34,Forward,Germany,Europe
780,Matteo Gabbia,ITA,Milan,Serie A,2024,25.0,1999.0,8.7,7,5,4,2,1,3,4,75.0,1,12,10,2,6,13,32,1,DF,25-29,Defender,Italy,Europe
781,Alessandro Gabrielloni,ITA,Como,Serie A,2024,30.0,1994.0,1.1,0,0,0,0,0,0,3,0.0,3,0,0,0,0,0,0,0,"FW,MF",30-34,Forward,Italy,Europe
782,Gianluca Gaetano,ITA,Cagliari,Serie A,2024,24.0,2000.0,6.3,6,4,3,3,0,3,11,27.3,8,5,0,5,4,10,7,0,"MF,FW",20-24,Midfielder,Italy,Europe
783,Roberto Gagliardini,ITA,Monza,Serie A,2024,30.0,1994.0,1.1,1,0,0,1,0,0,2,0.0,2,0,0,0,1,2,4,0,"MF,DF",30-34,Midfielder,Italy,Europe
784,Cody Gakpo,NED,Liverpool,Premier League,2024,25.0,1999.0,8.4,15,9,4,6,5,8,13,61.5,5,9,0,9,6,21,9,1,FW,25-29,Forward,Netherlands,Europe
787,Conor Gallagher,ENG,Atlético Madrid,La Liga,2024,24.0,2000.0,9.0,23,16,7,12,4,11,24,45.8,13,11,2,9,7,30,14,0,MF,20-24,Midfielder,England,Europe
788,Antonino Gallo,ITA,Lecce,Serie A,2024,24.0,2000.0,12.3,26,16,17,6,3,10,20,50.0,10,15,1,14,9,35,51,0,DF,20-24,Defender,Italy,Europe
789,Gauthier Gallon,FRA,Rennes,Ligue 1,2024,31.0,1993.0,0.5,0,0,0,0,0,0,0,,0,0,0,0,0,0,0,0,GK,30-34,Goalkeeper,France,Europe
790,Cristian Gamboa,CRC,Bochum,Bundesliga,2024,35.0,1989.0,1.3,1,1,1,0,0,1,2,50.0,1,0,0,0,0,1,2,0,DF,35-39,Defender,Costa Rica,North America
791,Idrissa Gana Gueye,SEN,Everton,Premier League,2024,35.0,1989.0,12.9,46,25,23,17,6,20,33,60.6,13,18,2,16,14,60,8,0,MF,35-39,Midfielder,Senegal,Africa
792,Ignatius Ganago,CMR,Nantes,Ligue 1,2024,25.0,1999.0,1.8,1,1,0,1,0,1,1,100.0,0,2,1,1,3,4,1,0,"FW,MF",25-29,Forward,Cameroon,Africa
799,Ulisses Garcia,SUI,Marseille,Ligue 1,2024,28.0,1996.0,4.4,9,7,4,4,1,3,10,30.0,7,3,0,3,2,11,8,0,DF,25-29,Defender,Switzerland,Europe
800,Alejandro Garnacho,ARG,Manchester Utd,Premier League,2024,20.0,2004.0,10.9,13,10,4,4,5,3,13,23.1,10,8,0,8,6,19,8,1,"FW,MF",20-24,Forward,Argentina,South America
801,James Garner,ENG,Everton,Premier League,2024,23.0,2001.0,2.8,10,8,6,4,0,7,10,70.0,3,2,2,0,4,14,9,0,"DF,MF",20-24,Defender,England,Europe
803,Federico Gatti,ITA,Juventus,Serie A,2024,26.0,1998.0,13.5,13,10,11,2,0,8,12,66.7,4,14,11,3,8,21,32,1,DF,25-29,Defender,Italy,Europe
805,Paulo Gazzaniga,ARG,Girona,La Liga,2024,32.0,1992.0,18.0,1,1,1,0,0,1,1,100.0,0,0,0,0,0,1,5,1,GK,30-34,Goalkeeper,Argentina,South America
806,Jean-Philippe Gbamin,CIV,Nantes,Ligue 1,2024,29.0,1995.0,2.1,2,1,0,2,0,1,3,33.3,2,4,1,3,3,5,2,0,MF,25-29,Midfielder,Ivory Coast,Africa
807,Yann Gboho,FRA,Toulouse,Ligue 1,2024,23.0,2001.0,13.3,18,6,5,8,5,9,17,52.9,8,10,0,10,3,21,3,0,"MF,FW",20-24,Midfielder,France,Europe
809,Viggo Gebel,GER,RB Leipzig,Bundesliga,2024,17.0,2007.0,0.2,0,0,0,0,0,0,0,,0,0,0,0,0,0,0,0,MF,Under 20,Midfielder,Germany,Europe
810,Lutsharel Geertruida,NED,RB Leipzig,Bundesliga,2024,24.0,2000.0,10.2,21,13,14,7,0,9,21,42.9,12,7,1,6,12,33,32,3,DF,20-24,Defender,Netherlands,Europe
811,Dennis Geiger,GER,Hoffenheim,Bundesliga,2024,26.0,1998.0,2.6,10,7,2,7,1,3,6,50.0,3,5,0,5,1,11,2,0,MF,25-29,Midfielder,Germany,Europe
812,Valentin Gendrey,FRA,Lecce,Serie A,2024,24.0,2000.0,2.0,2,2,1,0,1,1,1,100.0,0,3,1,2,2,4,1,0,DF,20-24,Defender,France,Europe
813,Valentin Gendrey,FRA,Hoffenheim,Bundesliga,2024,24.0,2000.0,8.5,20,9,12,7,1,6,11,54.5,5,9,2,7,7,27,25,0,DF,20-24,Defender,France,Europe
814,Denis Genreau,AUS,Toulouse,Ligue 1,2024,25.0,1999.0,0.4,1,1,0,0,1,1,2,50.0,1,0,0,0,0,1,0,0,"MF,FW",25-29,Midfielder,Australia,Oceania
815,Yannick Gerhardt,GER,Wolfsburg,Bundesliga,2024,30.0,1994.0,5.2,10,6,6,4,0,4,8,50.0,4,11,1,10,7,17,15,0,"MF,DF",30-34,Midfielder,Germany,Europe
816,Max Geschwill,GER,Holstein Kiel,Bundesliga,2024,23.0,2001.0,11.3,21,17,9,11,1,9,14,64.3,5,12,7,5,22,43,33,0,DF,20-24,Defender,Germany,Europe
817,Daniele Ghilardi,ITA,Hellas Verona,Serie A,2024,21.0,2003.0,7.1,12,7,7,5,0,7,16,43.8,9,9,6,3,7,19,36,0,DF,20-24,Defender,Italy,Europe
818,Lautaro Gianetti,ARG,Udinese,Serie A,2024,31.0,1993.0,9.3,22,10,16,5,1,14,20,70.0,6,19,10,9,15,37,44,1,DF,30-34,Defender,Argentina,South America
819,Dimitris Giannoulis,GRE,Augsburg,Bundesliga,2024,29.0,1995.0,11.8,19,12,10,8,1,15,27,55.6,12,23,7,16,18,37,27,0,DF,25-29,Defender,Greece,Europe
820,Morgan Gibbs-White,ENG,Nott'ham Forest,Premier League,2024,24.0,2000.0,11.2,23,8,10,10,3,7,11,63.6,4,4,2,2,8,31,11,0,MF,20-24,Midfielder,England,Europe
821,Samuel Gigot,FRA,Lazio,Serie A,2024,31.0,1993.0,0.9,0,0,0,0,0,0,1,0.0,1,2,1,1,1,1,3,0,DF,30-34,Defender,France,Europe
822,Armin Gigovic,BIH,Holstein Kiel,Bundesliga,2024,22.0,2002.0,9.2,11,7,6,4,1,2,14,14.3,12,9,0,9,12,23,16,0,MF,20-24,Midfielder,Bosnia and Herzegovina,Europe
825,Billy Gilmour,SCO,Brighton,Premier League,2024,23.0,2001.0,1.1,3,3,2,1,0,3,4,75.0,1,1,0,1,0,3,1,0,MF,20-24,Midfielder,Scotland,Europe
826,Billy Gilmour,SCO,Napoli,Serie A,2024,23.0,2001.0,4.5,9,3,3,1,5,3,7,42.9,4,5,1,4,3,12,6,0,MF,20-24,Midfielder,Scotland,Europe
827,Benedikt Gimber,GER,Heidenheim,Bundesliga,2024,27.0,1997.0,13.5,42,24,32,10,0,23,34,67.6,11,27,8,19,15,57,73,1,DF,25-29,Defender,Germany,Europe
828,Gvidas Gineitis,LTU,Torino,Serie A,2024,20.0,2004.0,6.8,11,5,5,4,2,5,13,38.5,8,7,2,5,5,16,15,0,MF,20-24,Midfielder,Lithuania,Europe
829,Matthias Ginter,GER,Freiburg,Bundesliga,2024,30.0,1994.0,11.7,12,9,7,4,1,5,9,55.6,4,15,10,5,5,17,51,3,DF,30-34,Defender,Germany,Europe
830,Jamie Gittens,ENG,Dortmund,Bundesliga,2024,20.0,2004.0,10.7,19,10,7,8,4,9,13,69.2,4,8,0,8,6,25,3,0,"FW,MF",20-24,Forward,England,Europe
831,Serge Gnabry,GER,Bayern Munich,Bundesliga,2024,29.0,1995.0,5.5,7,5,3,1,3,3,7,42.9,4,4,0,4,4,11,3,0,"FW,MF",25-29,Forward,Germany,Europe
832,Ben Godfrey,ENG,Atalanta,Serie A,2024,26.0,1998.0,0.3,0,0,0,0,0,0,1,0.0,1,1,1,0,0,0,0,0,DF,25-29,Defender,England,Europe
833,Martial Godo,ENG,Fulham,Premier League,2024,21.0,2003.0,0.2,0,0,0,0,0,0,0,,0,1,0,1,1,1,0,0,FW,20-24,Forward,England,Europe
834,Saba Goglichidze,GEO,Empoli,Serie A,2024,20.0,2004.0,12.5,34,19,20,13,1,15,26,57.7,11,14,7,7,15,49,38,0,DF,20-24,Defender,Georgia,Asia
835,Edoardo Goldaniga,ITA,Como,Serie A,2024,31.0,1993.0,10.5,15,9,11,2,2,7,8,87.5,1,9,4,5,12,27,36,0,DF,30-34,Defender,Italy,Europe
836,Pierluigi Gollini,ITA,Genoa,Serie A,2024,29.0,1995.0,7.0,0,0,0,0,0,0,0,,0,1,0,1,0,0,2,1,GK,25-29,Goalkeeper,Italy,Europe
837,Aleksandr Golovin,RUS,Monaco,Ligue 1,2024,28.0,1996.0,10.8,33,22,8,18,7,16,31,51.6,15,14,4,10,9,42,6,0,"MF,FW",25-29,Midfielder,Russia,Europe
838,André Gomes,POR,Lille,Ligue 1,2024,31.0,1993.0,4.3,5,3,2,2,1,2,7,28.6,5,2,1,1,3,8,2,1,MF,30-34,Midfielder,Portugal,Europe
838,André Gomes,POR,Lille,Ligue 1,2024,31.0,1993.0,4.3,5,3,2,2,1,2,7,28.6,5,2,1,1,3,8,2,1,MF,30-34,Midfielder,Portugal,Europe
838,André Gomes,POR,Lille,Ligue 1,2024,31.0,1993.0,4.3,5,3,2,2,1,2,7,28.6,5,2,1,1,3,8,2,1,MF,30-34,Midfielder,Portugal,Europe
838,André Gomes,POR,Lille,Ligue 1,2024,31.0,1993.0,4.3,5,3,2,2,1,2,7,28.6,5,2,1,1,3,8,2,1,MF,30-34,Midfielder,Portugal,Europe
839,Angel Gomes,ENG,Lille,Ligue 1,2024,24.0,2000.0,6.8,7,4,3,2,2,1,7,14.3,6,0,0,0,0,7,2,0,MF,20-24,Midfielder,England,Europe
840,João Gomes,BRA,Wolves,Premier League,2024,23.0,2001.0,15.1,52,26,29,22,1,14,45,31.1,31,14,1,13,12,64,13,0,MF,20-24,Midfielder,Brazil,South America
840,João Gomes,BRA,Wolves,Premier League,2024,23.0,2001.0,15.1,52,26,29,22,1,14,45,31.1,31,14,1,13,12,64,13,0,MF,20-24,Midfielder,Brazil,South America
840,João Gomes,BRA,Wolves,Premier League,2024,23.0,2001.0,15.1,52,26,29,22,1,14,45,31.1,31,14,1,13,12,64,13,0,MF,20-24,Midfielder,Brazil,South America
840,João Gomes,BRA,Wolves,Premier League,2024,23.0,2001.0,15.1,52,26,29,22,1,14,45,31.1,31,14,1,13,12,64,13,0,MF,20-24,Midfielder,Brazil,South America
841,Rodrigo Gomes,POR,Wolves,Premier League,2024,21.0,2003.0,3.9,10,5,7,3,0,3,9,33.3,6,5,1,4,3,13,8,1,"DF,FW",20-24,Defender,Portugal,Europe
842,Toti Gomes,POR,Wolves,Premier League,2024,25.0,1999.0,13.0,26,19,18,7,1,12,15,80.0,3,13,9,4,6,32,61,2,DF,25-29,Defender,Portugal,Europe
843,Carlos Gómez,COL,Rennes,Ligue 1,2024,22.0,2002.0,3.0,7,6,2,4,1,3,7,42.9,4,3,0,3,1,8,2,0,"MF,FW",20-24,Midfielder,Colombia,South America
845,Joe Gomez,ENG,Liverpool,Premier League,2024,27.0,1997.0,4.4,11,8,4,7,0,9,14,64.3,5,7,6,1,6,17,16,2,DF,25-29,Defender,England,Europe
851,Nicolás González,ARG,Juventus,Serie A,2024,26.0,1998.0,3.3,4,1,2,0,2,2,4,50.0,2,5,1,4,0,4,1,1,"FW,MF",25-29,Forward,Argentina,South America
853,Anthony Gordon,ENG,Newcastle Utd,Premier League,2024,23.0,2001.0,14.1,18,9,7,9,2,6,17,35.3,11,19,1,18,5,23,3,1,FW,20-24,Forward,England,Europe
854,Leon Goretzka,GER,Bayern Munich,Bundesliga,2024,29.0,1995.0,5.2,8,5,2,6,0,3,8,37.5,5,10,1,9,5,13,6,0,"MF,DF",25-29,Midfielder,Germany,Europe
856,Robin Gosens,GER,Fiorentina,Serie A,2024,30.0,1994.0,13.5,31,18,18,8,5,13,24,54.2,11,10,1,9,9,40,43,0,DF,30-34,Defender,Germany,Europe
857,Robin Gosens,GER,Union Berlin,Bundesliga,2024,30.0,1994.0,1.0,0,0,0,0,0,0,3,0.0,3,1,0,1,1,1,2,0,DF,30-34,Defender,Germany,Europe
858,Mario Götze,GER,Eint Frankfurt,Bundesliga,2024,32.0,1992.0,6.2,14,11,5,6,3,6,17,35.3,11,6,1,5,4,18,6,0,"MF,FW",30-34,Midfielder,Germany,Europe
859,Amine Gouiri,ALG,Rennes,Ligue 1,2024,24.0,2000.0,9.5,8,5,4,3,1,2,7,28.6,5,7,0,7,1,9,2,0,"MF,FW",20-24,Midfielder,Algeria,Africa
860,Jeffrey Gouweleeuw,NED,Augsburg,Bundesliga,2024,33.0,1991.0,14.0,19,11,9,7,3,11,18,61.1,7,20,9,11,13,32,68,0,DF,30-34,Defender,Netherlands,Europe
862,Jonathan Gradit,FRA,Lens,Ligue 1,2024,32.0,1992.0,8.3,18,9,10,7,1,10,19,52.6,9,9,4,5,12,30,26,0,DF,30-34,Defender,France,Europe
864,Samuel Grandsir,FRA,Le Havre,Ligue 1,2024,28.0,1996.0,0.9,5,5,0,3,2,2,3,66.7,1,2,0,2,0,5,0,0,"MF,FW",25-29,Midfielder,France,Europe
865,Alberto Grassi,ITA,Empoli,Serie A,2024,29.0,1995.0,6.9,16,7,5,9,2,5,6,83.3,1,5,3,2,8,24,12,1,MF,25-29,Midfielder,Italy,Europe
866,Ryan Gravenberch,NED,Liverpool,Premier League,2024,22.0,2002.0,15.7,31,18,11,14,6,17,28,60.7,11,20,5,15,33,64,17,0,MF,20-24,Midfielder,Netherlands,Europe
867,Archie Gray,ENG,Tottenham,Premier League,2024,18.0,2006.0,3.7,7,2,1,3,3,2,6,33.3,4,8,4,4,4,11,7,2,"DF,MF",Under 20,Defender,England,Europe
868,Jack Grealish,ENG,Manchester City,Premier League,2024,29.0,1995.0,6.4,9,5,4,2,3,2,4,50.0,2,9,2,7,2,11,4,1,"FW,MF",25-29,Forward,England,Europe
869,Jacob Greaves,ENG,Ipswich Town,Premier League,2024,24.0,2000.0,8.0,17,7,7,9,1,7,12,58.3,5,9,7,2,9,26,48,1,DF,20-24,Defender,England,Europe
870,Mason Greenwood,ENG,Marseille,Ligue 1,2024,23.0,2001.0,14.1,21,11,8,8,5,11,25,44.0,14,3,0,3,4,25,5,1,"FW,MF",20-24,Forward,England,Europe
871,Michael Gregoritsch,AUT,Freiburg,Bundesliga,2024,30.0,1994.0,4.0,3,2,1,0,2,0,3,0.0,3,2,1,1,0,3,5,0,FW,30-34,Forward,Austria,Europe
872,Dominik Greif,SVK,Mallorca,La Liga,2024,27.0,1997.0,14.0,0,0,0,0,0,0,0,,0,0,0,0,0,0,5,1,GK,25-29,Goalkeeper,Slovakia,Europe
873,Antoine Griezmann,FRA,Atlético Madrid,La Liga,2024,33.0,1991.0,14.8,16,11,9,5,2,5,17,29.4,12,11,0,11,5,21,13,1,"FW,MF",30-34,Forward,France,Europe
874,Vincenzo Grifo,ITA,Freiburg,Bundesliga,2024,31.0,1993.0,12.3,8,7,3,4,1,2,16,12.5,14,9,1,8,2,10,8,0,"FW,MF",30-34,Forward,Italy,Europe
875,Florian Grillitsch,AUT,Hoffenheim,Bundesliga,2024,29.0,1995.0,6.7,15,9,5,9,1,8,14,57.1,6,6,2,4,8,23,18,0,MF,25-29,Midfielder,Austria,Europe
877,Pascal Groß,GER,Dortmund,Bundesliga,2024,33.0,1991.0,11.6,20,12,5,12,3,6,20,30.0,14,14,2,12,3,23,11,1,"MF,DF",30-34,Midfielder,Germany,Europe
878,Brajan Gruda,GER,Brighton,Premier League,2024,20.0,2004.0,1.7,6,1,0,4,2,4,6,66.7,2,5,0,5,0,6,1,0,"MF,FW",20-24,Midfielder,Germany,Europe
879,Marco Grüll,AUT,Werder Bremen,Bundesliga,2024,26.0,1998.0,5.9,5,3,0,2,3,1,7,14.3,6,6,1,5,2,7,2,0,"MF,FW",25-29,Midfielder,Austria,Europe
880,Albert Grønbaek,DEN,Rennes,Ligue 1,2024,23.0,2001.0,8.3,21,11,10,7,4,10,26,38.5,16,7,0,7,4,25,6,0,"MF,FW",20-24,Midfielder,Denmark,Europe
884,Gabriel Gudmundsson,SWE,Lille,Ligue 1,2024,25.0,1999.0,10.9,20,14,6,10,4,14,24,58.3,10,14,4,10,7,27,20,2,DF,25-29,Defender,Sweden,Europe
885,Gonçalo Guedes,POR,Wolves,Premier League,2024,28.0,1996.0,3.8,11,3,1,3,7,2,8,25.0,6,7,0,7,2,13,2,0,"FW,MF",25-29,Forward,Portugal,Europe
886,Axel Gueguin,FRA,Montpellier,Ligue 1,2024,19.0,2005.0,0.3,1,1,0,1,0,1,1,100.0,0,0,0,0,0,1,0,0,FW,Under 20,Forward,France,Europe
887,Marc Guéhi,ENG,Crystal Palace,Premier League,2024,24.0,2000.0,17.0,26,12,16,9,1,14,20,70.0,6,28,14,14,9,35,84,1,DF,20-24,Defender,England,Europe
888,Mattéo Guendouzi,FRA,Lazio,Serie A,2024,25.0,1999.0,16.5,18,10,4,10,4,9,23,39.1,14,14,5,9,15,33,21,0,MF,25-29,Midfielder,France,Europe
890,Raphaël Guerreiro,POR,Bayern Munich,Bundesliga,2024,31.0,1993.0,9.0,10,7,6,2,2,7,9,77.8,2,5,0,5,6,16,10,1,"DF,MF",30-34,Defender,Portugal,Europe
891,Evann Guessand,CIV,Nice,Ligue 1,2024,23.0,2001.0,14.4,18,9,2,9,7,0,2,0.0,2,10,1,9,6,24,9,0,"FW,MF",20-24,Forward,Ivory Coast,Africa
893,Pape Gueye,SEN,Villarreal,La Liga,2024,25.0,1999.0,11.8,28,15,13,11,4,11,13,84.6,2,9,2,7,12,40,24,0,"MF,FW",25-29,Midfielder,Senegal,Africa
894,Morgan Guilavogui,GUI,St. Pauli,Bundesliga,2024,26.0,1998.0,9.9,21,12,7,12,2,10,19,52.6,9,15,0,15,7,28,20,0,"FW,MF",25-29,Forward,Guinea,Africa
895,Frederic Guilbert,FRA,Lecce,Serie A,2024,30.0,1994.0,10.8,30,13,12,13,5,13,20,65.0,7,14,5,9,14,44,36,0,DF,30-34,Defender,France,Europe
896,Luis Guilherme,BRA,West Ham,Premier League,2024,18.0,2006.0,0.1,0,0,0,0,0,0,0,,0,1,0,1,0,0,0,0,MF,Under 20,Midfielder,Brazil,South America
898,Bruno Guimarães,BRA,Newcastle Utd,Premier League,2024,27.0,1997.0,16.4,37,21,18,14,5,16,29,55.2,13,15,5,10,15,52,14,2,MF,25-29,Midfielder,Brazil,South America
900,Bahereba Guirassy,FRA,Nantes,Ligue 1,2024,18.0,2006.0,1.2,2,2,0,0,2,1,3,33.3,2,3,0,3,0,2,1,0,"FW,MF",Under 20,Forward,France,Europe
901,Serhou Guirassy,GUI,Dortmund,Bundesliga,2024,28.0,1996.0,11.8,3,2,1,0,2,0,1,0.0,1,6,3,3,2,5,16,0,FW,25-29,Forward,Guinea,Africa
903,Péter Gulácsi,HUN,RB Leipzig,Bundesliga,2024,34.0,1990.0,13.5,0,0,0,0,0,0,0,,0,0,0,0,0,0,4,1,GK,30-34,Goalkeeper,Hungary,Europe
904,Arda Güler,TUR,Real Madrid,La Liga,2024,19.0,2005.0,6.4,15,6,6,2,7,6,13,46.2,7,9,0,9,3,18,6,0,"MF,FW",Under 20,Midfielder,Turkey,Asia
907,İlkay Gündoğan,GER,Manchester City,Premier League,2024,34.0,1990.0,12.4,13,7,2,8,3,6,16,37.5,10,7,0,7,11,24,14,0,MF,30-34,Midfielder,Germany,Europe
908,Christian Günter,GER,Freiburg,Bundesliga,2024,31.0,1993.0,14.3,12,10,8,4,0,8,17,47.1,9,13,7,6,7,19,27,0,DF,30-34,Defender,Germany,Europe
911,Malo Gusto,FRA,Chelsea,Premier League,2024,21.0,2003.0,11.6,31,21,17,12,2,18,32,56.3,14,19,5,14,12,43,24,2,DF,20-24,Defender,France,Europe
913,Albert Guðmundsson,ISL,Fiorentina,Serie A,2024,27.0,1997.0,3.4,2,1,1,1,0,2,4,50.0,2,1,0,1,4,6,2,0,MF,25-29,Midfielder,Iceland,Europe
914,Joško Gvardiol,CRO,Manchester City,Premier League,2024,22.0,2002.0,15.5,27,19,13,7,7,13,18,72.2,5,20,8,12,19,46,45,3,DF,20-24,Defender,Croatia,Europe
915,Emmanuel Gyasi,GHA,Empoli,Serie A,2024,30.0,1994.0,16.8,27,14,17,8,2,13,21,61.9,8,14,5,9,4,31,46,0,"DF,FW",30-34,Defender,Ghana,Africa
916,Christian Gytkjær,DEN,Venezia,Serie A,2024,34.0,1990.0,2.8,1,1,1,0,0,1,2,50.0,1,1,1,0,0,1,4,0,"FW,MF",30-34,Forward,Denmark,Europe
918,Nicolas Haas,SUI,Empoli,Serie A,2024,28.0,1996.0,3.2,11,8,4,5,2,5,9,55.6,4,2,1,1,4,15,6,0,MF,25-29,Midfielder,Switzerland,Europe
919,Janik Haberer,GER,Union Berlin,Bundesliga,2024,30.0,1994.0,5.3,10,6,4,5,1,10,18,55.6,8,2,0,2,1,11,8,0,"DF,MF",30-34,Defender,Germany,Europe
920,Robin Hack,GER,Gladbach,Bundesliga,2024,26.0,1998.0,8.4,9,9,4,3,2,5,14,35.7,9,9,0,9,1,10,10,0,FW,25-29,Forward,Germany,Europe
921,Saad El Haddad,MAR,Venezia,Serie A,2024,19.0,2005.0,0.3,0,0,0,0,0,0,0,,0,0,0,0,0,0,0,0,MF,Under 20,Midfielder,Morocco,Africa
922,Munir El Haddadi,MAR,Leganés,La Liga,2024,29.0,1995.0,4.8,11,8,5,4,2,3,9,33.3,6,6,1,5,0,11,1,0,"MF,FW",25-29,Midfielder,Morocco,Africa
923,Amadou Haidara,MLI,RB Leipzig,Bundesliga,2024,26.0,1998.0,7.8,17,10,8,8,1,7,13,53.8,6,19,6,13,7,24,31,0,MF,25-29,Midfielder,Mali,Africa
924,Massadio Haïdara,MLI,Brest,Ligue 1,2024,32.0,1992.0,6.2,7,4,5,2,0,3,9,33.3,6,3,0,3,11,18,31,0,DF,30-34,Defender,Mali,Africa
925,Antoine Hainaut,FRA,Parma,Serie A,2024,22.0,2002.0,6.6,12,9,7,4,1,6,7,85.7,1,8,2,6,5,17,31,0,DF,20-24,Defender,France,Europe
926,Mohamed Haj,TUN,Parma,Serie A,2024,19.0,2005.0,3.2,2,1,1,1,0,1,1,100.0,0,1,0,1,3,5,3,0,MF,Under 20,Midfielder,Tunisia,Africa
927,Achraf Hakimi,MAR,Paris S-G,Ligue 1,2024,26.0,1998.0,13.4,32,25,14,11,7,20,32,62.5,12,13,0,13,19,51,9,2,DF,25-29,Defender,Morocco,Africa
928,Lewis Hall,ENG,Newcastle Utd,Premier League,2024,20.0,2004.0,14.6,31,22,10,13,8,21,44,47.7,23,23,13,10,14,45,52,2,DF,20-24,Defender,England,Europe
929,Sébastien Haller,CIV,Leganés,La Liga,2024,30.0,1994.0,4.5,2,0,1,0,1,1,2,50.0,1,1,0,1,0,2,7,0,FW,30-34,Forward,Ivory Coast,Africa
932,Florent Hanin,ALG,Angers,Ligue 1,2024,34.0,1990.0,11.7,28,23,14,10,4,16,28,57.1,12,5,2,3,21,49,38,2,DF,30-34,Defender,Algeria,Africa
933,Ridgeciano Haps,SUR,Venezia,Serie A,2024,31.0,1993.0,7.6,14,9,12,1,1,8,12,66.7,4,7,1,6,2,16,22,0,DF,30-34,Defender,Suriname,South America
934,Amine Harit,MAR,Marseille,Ligue 1,2024,27.0,1997.0,5.2,7,6,0,5,2,1,2,50.0,1,6,0,6,3,10,1,1,MF,25-29,Midfielder,Morocco,Africa
935,Marcus Harness,ENG,Ipswich Town,Premier League,2024,28.0,1996.0,0.5,1,0,0,0,1,0,3,0.0,3,2,1,1,0,1,1,0,MF,25-29,Midfielder,England,Europe
936,Phil Harres,GER,Holstein Kiel,Bundesliga,2024,22.0,2002.0,6.4,3,3,0,2,1,2,2,100.0,0,7,3,4,2,5,5,0,FW,20-24,Forward,Germany,Europe
937,Jack Harrison,ENG,Everton,Premier League,2024,28.0,1996.0,8.9,16,11,8,3,5,9,19,47.4,10,4,0,4,5,21,16,2,FW,25-29,Forward,England,Europe
938,Abdou Harroui,NED,Hellas Verona,Serie A,2024,26.0,1998.0,5.1,9,6,6,3,0,4,4,100.0,0,5,0,5,2,11,5,0,"MF,FW",25-29,Midfielder,Netherlands,Europe
939,Taylor Harwood-Bellis,ENG,Southampton,Premier League,2024,22.0,2002.0,14.6,11,7,6,4,1,8,12,66.7,4,36,23,13,16,27,63,3,DF,20-24,Defender,England,Europe
940,Hans Hateboer,NED,Rennes,Ligue 1,2024,30.0,1994.0,10.3,19,11,10,5,4,9,19,47.4,10,13,4,9,12,31,29,0,DF,30-34,Defender,Netherlands,Europe
941,Kai Havertz,GER,Arsenal,Premier League,2024,25.0,1999.0,15.4,12,8,2,6,4,3,10,30.0,7,16,3,13,6,18,28,1,"FW,MF",25-29,Forward,Germany,Europe
942,Jan Paul van Hecke,NED,Brighton,Premier League,2024,24.0,2000.0,13.9,20,13,12,8,0,12,20,60.0,8,18,11,7,9,29,51,2,DF,20-24,Defender,Netherlands,Europe
943,Hwang Hee-chan,KOR,Wolves,Premier League,2024,28.0,1996.0,3.7,3,2,1,1,1,1,2,50.0,1,7,0,7,1,4,3,0,"MF,FW",25-29,Midfielder,South Korea,Asia
944,Dean Henderson,ENG,Crystal Palace,Premier League,2024,27.0,1997.0,17.0,2,1,2,0,0,2,4,50.0,2,0,0,0,0,2,12,0,GK,25-29,Goalkeeper,England,Europe
945,Liam Henderson,SCO,Empoli,Serie A,2024,28.0,1996.0,11.9,21,11,11,9,1,12,25,48.0,13,10,5,5,8,29,22,0,MF,25-29,Midfielder,Scotland,Europe
946,Ramon Hendriks,NED,Stuttgart,Bundesliga,2024,23.0,2001.0,2.0,3,2,2,1,0,2,3,66.7,1,1,0,1,7,10,12,0,DF,20-24,Defender,Netherlands,Europe
947,Paul Hennrich,GER,Hoffenheim,Bundesliga,2024,19.0,2005.0,0.1,0,0,0,0,0,0,0,,0,1,1,0,0,0,0,0,MF,Under 20,Midfielder,Germany,Europe
948,Benjamin Henrichs,GER,RB Leipzig,Bundesliga,2024,27.0,1997.0,10.4,32,16,18,10,4,14,27,51.9,13,22,3,19,15,47,33,0,DF,25-29,Defender,Germany,Europe
949,Luis Henrique,BRA,Marseille,Ligue 1,2024,23.0,2001.0,12.6,7,5,2,4,1,4,4,100.0,0,10,2,8,4,11,16,0,"FW,DF",20-24,Forward,Brazil,South America
949,Luis Henrique,BRA,Marseille,Ligue 1,2024,23.0,2001.0,12.6,7,5,2,4,1,4,4,100.0,0,10,2,8,4,11,16,0,"FW,DF",20-24,Forward,Brazil,South America
949,Luis Henrique,BRA,Marseille,Ligue 1,2024,23.0,2001.0,12.6,7,5,2,4,1,4,4,100.0,0,10,2,8,4,11,16,0,"FW,DF",20-24,Forward,Brazil,South America
949,Luis Henrique,BRA,Marseille,Ligue 1,2024,23.0,2001.0,12.6,7,5,2,4,1,4,4,100.0,0,10,2,8,4,11,16,0,"FW,DF",20-24,Forward,Brazil,South America
950,Mads Hermansen,DEN,Leicester City,Premier League,2024,24.0,2000.0,15.5,1,1,1,0,0,1,1,100.0,0,1,0,1,0,1,8,2,GK,20-24,Goalkeeper,Denmark,Europe
954,Lucas Hernández,FRA,Paris S-G,Ligue 1,2024,28.0,1996.0,0.6,3,1,2,1,0,3,6,50.0,3,0,0,0,1,4,1,0,DF,25-29,Defender,France,Europe
955,Theo Hernández,FRA,Milan,Serie A,2024,27.0,1997.0,11.0,14,10,13,0,1,7,13,53.8,6,9,5,4,12,26,29,2,DF,25-29,Defender,France,Europe
956,Hernani,BRA,Parma,Serie A,2024,30.0,1994.0,6.4,16,10,7,7,2,8,19,42.1,11,10,2,8,4,20,2,1,MF,30-34,Midfielder,Brazil,South America
960,Yangel Herrera,VEN,Girona,La Liga,2024,26.0,1998.0,9.0,28,17,12,14,2,13,23,56.5,10,7,1,6,12,40,17,0,MF,25-29,Midfielder,Venezuela,South America
962,Son Heung-min,KOR,Tottenham,Premier League,2024,32.0,1992.0,11.8,6,3,1,4,1,2,13,15.4,11,5,0,5,3,9,8,0,FW,30-34,Forward,South Korea,Asia
963,Isak Hien,SWE,Atalanta,Serie A,2024,25.0,1999.0,11.5,25,15,14,11,0,12,19,63.2,7,14,8,6,15,40,37,1,DF,25-29,Defender,Sweden,Europe
964,Omar El Hilali,MAR,Espanyol,La Liga,2024,21.0,2003.0,16.4,52,35,37,11,4,25,39,64.1,14,22,6,16,16,68,61,1,DF,20-24,Defender,Morocco,Africa
965,James Hill,ENG,Bournemouth,Premier League,2024,22.0,2002.0,0.1,1,0,1,0,0,0,1,0.0,1,0,0,0,1,2,2,0,MF,20-24,Midfielder,England,Europe
966,Piero Hincapié,ECU,Leverkusen,Bundesliga,2024,22.0,2002.0,13.6,22,18,10,8,4,13,21,61.9,8,18,9,9,18,40,36,1,DF,20-24,Defender,Ecuador,South America
967,Jack Hinshelwood,ENG,Brighton,Premier League,2024,19.0,2005.0,9.3,12,9,4,6,2,5,11,45.5,6,4,2,2,4,16,14,1,"MF,DF",Under 20,Midfielder,England,Europe
968,George Hirst,ENG,Ipswich Town,Premier League,2024,25.0,1999.0,2.0,1,1,1,0,0,0,1,0.0,1,0,0,0,0,1,4,0,FW,25-29,Forward,England,Europe
970,Ki-Jana Hoever,NED,Auxerre,Ligue 1,2024,22.0,2002.0,10.5,22,16,14,6,2,13,22,59.1,9,16,1,15,11,33,29,0,DF,20-24,Defender,Netherlands,Europe
971,Nicolas Höfler,GER,Freiburg,Bundesliga,2024,34.0,1990.0,5.1,16,11,4,11,1,8,16,50.0,8,3,0,3,11,27,18,1,MF,30-34,Midfielder,Germany,Europe
972,Jonas Hofmann,GER,Leverkusen,Bundesliga,2024,32.0,1992.0,2.5,0,0,0,0,0,0,1,0.0,1,2,0,2,0,0,2,0,"MF,DF",30-34,Midfielder,Germany,Europe
972,Jonas Hofmann,GER,Leverkusen,Bundesliga,2024,32.0,1992.0,2.5,0,0,0,0,0,0,1,0.0,1,2,0,2,0,0,2,0,"MF,DF",30-34,Midfielder,Germany,Europe
972,Jonas Hofmann,GER,Leverkusen,Bundesliga,2024,32.0,1992.0,2.5,0,0,0,0,0,0,1,0.0,1,2,0,2,0,0,2,0,"MF,DF",30-34,Midfielder,Germany,Europe
972,Jonas Hofmann,GER,Leverkusen,Bundesliga,2024,32.0,1992.0,2.5,0,0,0,0,0,0,1,0.0,1,2,0,2,0,0,2,0,"MF,DF",30-34,Midfielder,Germany,Europe
973,Philipp Hofmann,GER,Bochum,Bundesliga,2024,31.0,1993.0,11.5,10,8,3,3,4,4,7,57.1,3,5,0,5,1,11,17,0,FW,30-34,Forward,Germany,Europe
974,Lucas Höler,GER,Freiburg,Bundesliga,2024,30.0,1994.0,6.3,14,8,6,7,1,3,13,23.1,10,10,3,7,1,15,11,0,"MF,FW",30-34,Midfielder,Germany,Europe
975,Mason Holgate,ENG,Everton,Premier League,2024,28.0,1996.0,0.1,0,0,0,0,0,0,0,,0,0,0,0,0,0,0,0,"FW,DF",25-29,Forward,England,Europe
976,Benedict Hollerbach,GER,Union Berlin,Bundesliga,2024,23.0,2001.0,12.4,19,12,5,9,5,10,19,52.6,9,15,0,15,1,20,4,0,"MF,FW",20-24,Midfielder,Germany,Europe
977,Emil Holm,SWE,Bologna,Serie A,2024,24.0,2000.0,4.5,15,11,7,6,2,9,14,64.3,5,5,2,3,3,18,17,0,DF,20-24,Defender,Sweden,Europe
978,Lewis Holtby,GER,Holstein Kiel,Bundesliga,2024,34.0,1990.0,8.1,20,10,11,8,1,6,15,40.0,9,6,1,5,14,34,10,1,MF,30-34,Midfielder,Germany,Europe
979,Gerrit Holtmann,PHI,Bochum,Bundesliga,2024,29.0,1995.0,3.8,7,6,4,2,1,4,9,44.4,5,5,0,5,7,14,5,0,"DF,FW",25-29,Defender,Philippines,Asia
980,Franck Honorat,FRA,Gladbach,Bundesliga,2024,28.0,1996.0,10.9,9,2,4,2,3,1,4,25.0,3,7,1,6,4,13,21,1,FW,25-29,Forward,France,Europe
981,Mathias Honsak,AUT,Heidenheim,Bundesliga,2024,28.0,1996.0,6.5,11,6,8,3,0,8,14,57.1,6,7,3,4,5,16,16,0,"FW,DF",25-29,Forward,Austria,Europe
982,Dinko Horkaš,CRO,Las Palmas,La Liga,2024,25.0,1999.0,2.3,0,0,0,0,0,0,0,,0,0,0,0,0,0,2,0,GK,25-29,Goalkeeper,Croatia,Europe
983,Cédric Hountondji,BEN,Angers,Ligue 1,2024,30.0,1994.0,3.0,6,4,4,2,0,3,7,42.9,4,3,3,0,4,10,14,0,DF,30-34,Defender,Benin,Africa
984,Ilyes Housni,FRA,Le Havre,Ligue 1,2024,19.0,2005.0,1.6,5,4,0,3,2,2,4,50.0,2,2,0,2,1,6,1,0,FW,Under 20,Forward,France,Europe
985,Lukáš Hrádecký,FIN,Leverkusen,Bundesliga,2024,35.0,1989.0,14.0,0,0,0,0,0,0,0,,0,0,0,0,0,0,3,1,GK,35-39,Goalkeeper,Finland,Europe
987,Callum Hudson-Odoi,ENG,Nott'ham Forest,Premier League,2024,24.0,2000.0,13.7,13,8,4,6,3,6,9,66.7,3,4,0,4,9,22,4,1,"FW,MF",20-24,Forward,England,Europe
988,Will Hughes,ENG,Crystal Palace,Premier League,2024,29.0,1995.0,10.6,38,19,12,17,9,14,35,40.0,21,11,5,6,6,44,7,0,MF,25-29,Midfielder,England,Europe
990,Mats Hummels,GER,Roma,Serie A,2024,36.0,1988.0,3.5,17,7,10,7,0,9,11,81.8,2,8,2,6,9,26,15,0,DF,35-39,Defender,Germany,Europe
991,Omari Hutchinson,ENG,Ipswich Town,Premier League,2024,21.0,2003.0,15.1,18,8,8,7,3,9,28,32.1,19,14,1,13,6,24,7,1,"MF,FW",20-24,Midfielder,England,Europe
992,Elseid Hysaj,ALB,Lazio,Serie A,2024,30.0,1994.0,0.1,1,1,0,1,0,0,0,,0,0,0,0,0,1,1,0,DF,30-34,Defender,Albania,Europe
993,Hong Hyunseok,KOR,Mainz 05,Bundesliga,2024,25.0,1999.0,3.5,4,1,2,1,1,0,2,0.0,2,3,1,2,5,9,6,0,MF,25-29,Midfielder,South Korea,Asia
994,Pierre Højbjerg,DEN,Marseille,Ligue 1,2024,29.0,1995.0,14.9,36,26,17,15,4,22,44,50.0,22,17,4,13,22,58,22,1,MF,25-29,Midfielder,Denmark,Europe
995,Oscar Højlund,DEN,Eint Frankfurt,Bundesliga,2024,19.0,2005.0,1.6,5,3,3,1,1,0,1,0.0,1,3,2,1,1,6,1,0,MF,Under 20,Midfielder,Denmark,Europe
996,Rasmus Højlund,DEN,Manchester Utd,Premier League,2024,21.0,2003.0,8.0,2,0,0,1,1,0,1,0.0,1,2,0,2,1,3,3,0,FW,20-24,Forward,Denmark,Europe
998,Arijon Ibrahimović,GER,Bayern Munich,Bundesliga,2024,19.0,2005.0,0.0,0,0,0,0,0,0,0,,0,0,0,0,0,0,0,0,FW,Under 20,Forward,Germany,Europe
999,Stanis Idumbo,BEL,Sevilla,La Liga,2024,19.0,2005.0,2.2,8,5,3,3,2,2,4,50.0,2,3,1,2,4,12,1,0,"FW,MF",Under 20,Forward,Belgium,Europe
1000,Jay Idzes,IDN,Venezia,Serie A,2024,24.0,2000.0,14.7,22,15,14,6,2,7,13,53.8,6,23,11,12,11,33,51,0,DF,20-24,Defender,Indonesia,Asia
1003,Igor,BRA,Brighton,Premier League,2024,26.0,1998.0,8.3,3,3,1,1,1,3,6,50.0,3,19,11,8,2,5,38,1,DF,25-29,Defender,Brazil,South America
1003,Igor,BRA,Brighton,Premier League,2024,26.0,1998.0,8.3,3,3,1,1,1,3,6,50.0,3,19,11,8,2,5,38,1,DF,25-29,Defender,Brazil,South America
1003,Igor,BRA,Brighton,Premier League,2024,26.0,1998.0,8.3,3,3,1,1,1,3,6,50.0,3,19,11,8,2,5,38,1,DF,25-29,Defender,Brazil,South America
1003,Igor,BRA,Brighton,Premier League,2024,26.0,1998.0,8.3,3,3,1,1,1,3,6,50.0,3,19,11,8,2,5,38,1,DF,25-29,Defender,Brazil,South America
1004,Kelechi Iheanacho,NGA,Sevilla,La Liga,2024,28.0,1996.0,4.4,1,0,0,1,0,1,3,33.3,2,0,0,0,0,1,1,0,FW,25-29,Forward,Nigeria,Africa
1005,Jonathan Ikone,FRA,Fiorentina,Serie A,2024,26.0,1998.0,3.3,5,2,3,2,0,2,4,50.0,2,3,0,3,0,5,1,0,"FW,MF",25-29,Forward,France,Europe
1006,George Ilenikhena,FRA,Monaco,Ligue 1,2024,18.0,2006.0,6.1,1,1,0,1,0,0,1,0.0,1,0,0,0,1,2,0,0,FW,Under 20,Forward,France,Europe
1008,Rareş Ilie,ROU,Nice,Ligue 1,2024,21.0,2003.0,0.1,1,1,1,0,0,1,1,100.0,0,0,0,0,0,1,0,0,MF,20-24,Midfielder,Romania,Europe
1009,Samuel Iling-Junior,ENG,Bologna,Serie A,2024,21.0,2003.0,1.2,3,2,1,1,1,0,1,0.0,1,0,0,0,2,5,1,0,"FW,MF",20-24,Forward,England,Europe
1010,Danny Ings,ENG,West Ham,Premier League,2024,32.0,1992.0,2.0,2,1,2,0,0,1,2,50.0,1,0,0,0,1,3,2,0,FW,30-34,Forward,England,Europe
1011,Alessio Iovine,ITA,Como,Serie A,2024,33.0,1991.0,3.4,3,1,1,2,0,2,4,50.0,2,6,1,5,2,5,18,0,"DF,FW",30-34,Defender,Italy,Europe
1012,Tim Iroegbunam,ENG,Everton,Premier League,2024,21.0,2003.0,4.3,18,9,9,4,5,7,12,58.3,5,6,0,6,8,26,5,1,MF,20-24,Midfielder,England,Europe
1013,Jackson Irvine,AUS,St. Pauli,Bundesliga,2024,31.0,1993.0,15.0,32,15,13,16,3,11,24,45.8,13,13,2,11,25,57,40,0,MF,30-34,Midfielder,Australia,Oceania
1014,Andy Irving,SCO,West Ham,Premier League,2024,24.0,2000.0,0.6,4,3,1,2,1,1,4,25.0,3,1,0,1,0,4,2,0,MF,20-24,Midfielder,Scotland,Europe
1015,Alexander Isak,SWE,Newcastle Utd,Premier League,2024,25.0,1999.0,13.3,5,3,0,2,3,3,7,42.9,4,10,1,9,1,6,5,1,FW,25-29,Forward,Sweden,Europe
1016,Gustav Isaksen,DEN,Lazio,Serie A,2024,23.0,2001.0,10.5,8,3,4,4,0,3,13,23.1,10,4,0,4,5,13,6,0,FW,20-24,Forward,Denmark,Europe
1018,Ismaily,BRA,Lille,Ligue 1,2024,34.0,1990.0,0.9,2,0,0,1,1,0,1,0.0,1,4,0,4,0,2,2,0,DF,30-34,Defender,Brazil,South America
1019,Ardian Ismajli,ALB,Empoli,Serie A,2024,28.0,1996.0,17.0,14,13,10,4,0,6,9,66.7,3,24,19,5,35,49,151,0,DF,25-29,Defender,Albania,Europe
1020,Yanis Issoufou,FRA,Montpellier,Ligue 1,2024,18.0,2006.0,0.8,5,3,4,1,0,3,5,60.0,2,1,0,1,0,5,1,0,"FW,MF",Under 20,Forward,France,Europe
1021,Ko Itakura,JPN,Gladbach,Bundesliga,2024,27.0,1997.0,15.0,21,14,11,9,1,12,18,66.7,6,20,10,10,13,34,78,0,DF,25-29,Defender,Japan,Asia
1022,Junya Ito,JPN,Reims,Ligue 1,2024,31.0,1993.0,14.6,20,15,6,9,5,6,29,20.7,23,18,0,18,6,26,3,1,FW,30-34,Forward,Japan,Asia
1024,Alex Iwobi,NGA,Fulham,Premier League,2024,28.0,1996.0,16.4,22,13,9,10,3,9,15,60.0,6,12,1,11,6,28,20,0,"FW,MF",25-29,Forward,Nigeria,Africa
1025,Armando Izzo,ITA,Monza,Serie A,2024,32.0,1992.0,13.4,23,11,16,7,0,10,22,45.5,12,21,15,6,23,46,37,0,DF,30-34,Defender,Italy,Europe
1026,Fellipe Jack,BRA,Como,Serie A,2024,18.0,2006.0,0.1,0,0,0,0,0,0,0,,0,1,1,0,1,1,2,0,DF,Under 20,Defender,Brazil,South America
1027,Nicolas Jackson,SEN,Chelsea,Premier League,2024,23.0,2001.0,14.0,11,7,2,4,5,1,5,20.0,4,8,1,7,2,13,12,0,FW,20-24,Forward,Senegal,Africa
1028,Lee Jae-sung,KOR,Mainz 05,Bundesliga,2024,32.0,1992.0,13.1,17,7,5,9,3,6,14,42.9,8,15,1,14,17,34,19,0,MF,30-34,Midfielder,South Korea,Asia
1029,Kristijan Jakić,CRO,Augsburg,Bundesliga,2024,27.0,1997.0,11.1,23,10,8,14,1,10,21,47.6,11,21,3,18,13,36,24,1,MF,25-29,Midfielder,Croatia,Europe
1030,Karl Jakob Hein,EST,Valladolid,La Liga,2024,22.0,2002.0,18.0,0,0,0,0,0,0,1,0.0,1,0,0,0,0,0,13,0,GK,20-24,Goalkeeper,Estonia,Europe
1031,Ismail Jakobs,SEN,Monaco,Ligue 1,2024,25.0,1999.0,2.0,5,5,3,0,2,3,5,60.0,2,0,0,0,2,7,6,0,DF,25-29,Defender,Senegal,Africa
1032,Jordan James,WAL,Rennes,Ligue 1,2024,20.0,2004.0,3.4,6,3,3,2,1,5,7,71.4,2,4,0,4,4,10,4,0,MF,20-24,Midfielder,Wales,Europe
1033,Reece James,ENG,Chelsea,Premier League,2024,25.0,1999.0,2.7,2,2,2,0,0,1,3,33.3,2,4,2,2,3,5,5,1,DF,25-29,Defender,England,Europe
1033,Reece James,ENG,Chelsea,Premier League,2024,25.0,1999.0,2.7,2,2,2,0,0,1,3,33.3,2,4,2,2,3,5,5,1,DF,25-29,Defender,England,Europe
1033,Reece James,ENG,Chelsea,Premier League,2024,25.0,1999.0,2.7,2,2,2,0,0,1,3,33.3,2,4,2,2,3,5,5,1,DF,25-29,Defender,England,Europe
1033,Reece James,ENG,Chelsea,Premier League,2024,25.0,1999.0,2.7,2,2,2,0,0,1,3,33.3,2,4,2,2,3,5,5,1,DF,25-29,Defender,England,Europe
1034,Vitaly Janelt,GER,Brentford,Premier League,2024,26.0,1998.0,13.6,17,10,7,6,4,9,18,50.0,9,19,4,15,13,30,32,1,MF,25-29,Midfielder,Germany,Europe
1035,Adnan Januzaj,BEL,Las Palmas,La Liga,2024,29.0,1995.0,3.3,4,2,1,3,0,2,3,66.7,1,3,0,3,0,4,2,0,"MF,FW",25-29,Midfielder,Belgium,Europe
1039,Dominik Javorček,SVK,Holstein Kiel,Bundesliga,2024,22.0,2002.0,0.9,1,0,1,0,0,1,2,50.0,1,1,1,0,2,3,4,1,DF,20-24,Defender,Slovakia,Europe
1040,Gaby Jean,FRA,Lecce,Serie A,2024,24.0,2000.0,3.3,3,1,2,0,1,0,2,0.0,2,5,4,1,1,4,17,0,DF,20-24,Defender,France,Europe
1041,Daniel Jebbison,ENG,Bournemouth,Premier League,2024,21.0,2003.0,0.3,0,0,0,0,0,0,1,0.0,1,0,0,0,0,0,1,0,FW,20-24,Forward,England,Europe
1042,Fredrik Jensen,FIN,Augsburg,Bundesliga,2024,27.0,1997.0,1.3,1,1,0,0,1,1,1,100.0,0,2,0,2,0,1,1,0,"MF,DF",25-29,Midfielder,Finland,Europe
1043,Mathias Jensen,DEN,Brentford,Premier League,2024,28.0,1996.0,5.3,4,3,2,1,1,2,6,33.3,4,7,1,6,4,8,6,1,MF,25-29,Midfielder,Denmark,Europe
1044,Moritz Jenz,GER,Mainz 05,Bundesliga,2024,25.0,1999.0,7.1,14,6,6,8,0,5,8,62.5,3,10,7,3,9,23,52,0,DF,25-29,Defender,Germany,Europe
1045,Gabriel Jesus,BRA,Arsenal,Premier League,2024,27.0,1997.0,4.0,6,5,4,2,0,3,5,60.0,2,7,1,6,4,10,5,0,FW,25-29,Forward,Brazil,South America
1046,Juan Jesus,BRA,Napoli,Serie A,2024,33.0,1991.0,1.9,3,1,2,1,0,3,3,100.0,0,1,0,1,1,4,5,0,DF,30-34,Defender,Brazil,South America
1048,Raúl Jiménez,MEX,Fulham,Premier League,2024,33.0,1991.0,11.1,16,9,2,10,4,3,9,33.3,6,7,2,5,5,21,7,2,FW,30-34,Forward,Mexico,North America
1049,João Pedro,BRA,Brighton,Premier League,2024,23.0,2001.0,8.5,7,4,1,4,2,1,4,25.0,3,5,0,5,5,12,6,0,"MF,FW",20-24,Midfielder,Brazil,South America
1049,João Pedro,BRA,Brighton,Premier League,2024,23.0,2001.0,8.5,7,4,1,4,2,1,4,25.0,3,5,0,5,5,12,6,0,"MF,FW",20-24,Midfielder,Brazil,South America
1049,João Pedro,BRA,Brighton,Premier League,2024,23.0,2001.0,8.5,7,4,1,4,2,1,4,25.0,3,5,0,5,5,12,6,0,"MF,FW",20-24,Midfielder,Brazil,South America
1049,João Pedro,BRA,Brighton,Premier League,2024,23.0,2001.0,8.5,7,4,1,4,2,1,4,25.0,3,5,0,5,5,12,6,0,"MF,FW",20-24,Midfielder,Brazil,South America
1049,João Pedro,BRA,Brighton,Premier League,2024,23.0,2001.0,8.5,7,4,1,4,2,1,4,25.0,3,5,0,5,5,12,6,0,"MF,FW",20-24,Midfielder,Brazil,South America
1049,João Pedro,BRA,Brighton,Premier League,2024,23.0,2001.0,8.5,7,4,1,4,2,1,4,25.0,3,5,0,5,5,12,6,0,"MF,FW",20-24,Midfielder,Brazil,South America
1049,João Pedro,BRA,Brighton,Premier League,2024,23.0,2001.0,8.5,7,4,1,4,2,1,4,25.0,3,5,0,5,5,12,6,0,"MF,FW",20-24,Midfielder,Brazil,South America
1049,João Pedro,BRA,Brighton,Premier League,2024,23.0,2001.0,8.5,7,4,1,4,2,1,4,25.0,3,5,0,5,5,12,6,0,"MF,FW",20-24,Midfielder,Brazil,South America
1049,João Pedro,BRA,Brighton,Premier League,2024,23.0,2001.0,8.5,7,4,1,4,2,1,4,25.0,3,5,0,5,5,12,6,0,"MF,FW",20-24,Midfielder,Brazil,South America
1049,João Pedro,BRA,Brighton,Premier League,2024,23.0,2001.0,8.5,7,4,1,4,2,1,4,25.0,3,5,0,5,5,12,6,0,"MF,FW",20-24,Midfielder,Brazil,South America
1049,João Pedro,BRA,Brighton,Premier League,2024,23.0,2001.0,8.5,7,4,1,4,2,1,4,25.0,3,5,0,5,5,12,6,0,"MF,FW",20-24,Midfielder,Brazil,South America
1049,João Pedro,BRA,Brighton,Premier League,2024,23.0,2001.0,8.5,7,4,1,4,2,1,4,25.0,3,5,0,5,5,12,6,0,"MF,FW",20-24,Midfielder,Brazil,South America
1049,João Pedro,BRA,Brighton,Premier League,2024,23.0,2001.0,8.5,7,4,1,4,2,1,4,25.0,3,5,0,5,5,12,6,0,"MF,FW",20-24,Midfielder,Brazil,South America
1049,João Pedro,BRA,Brighton,Premier League,2024,23.0,2001.0,8.5,7,4,1,4,2,1,4,25.0,3,5,0,5,5,12,6,0,"MF,FW",20-24,Midfielder,Brazil,South America
1049,João Pedro,BRA,Brighton,Premier League,2024,23.0,2001.0,8.5,7,4,1,4,2,1,4,25.0,3,5,0,5,5,12,6,0,"MF,FW",20-24,Midfielder,Brazil,South America
1049,João Pedro,BRA,Brighton,Premier League,2024,23.0,2001.0,8.5,7,4,1,4,2,1,4,25.0,3,5,0,5,5,12,6,0,"MF,FW",20-24,Midfielder,Brazil,South America
1049,João Pedro,BRA,Brighton,Premier League,2024,23.0,2001.0,8.5,7,4,1,4,2,1,4,25.0,3,5,0,5,5,12,6,0,"MF,FW",20-24,Midfielder,Brazil,South America
1049,João Pedro,BRA,Brighton,Premier League,2024,23.0,2001.0,8.5,7,4,1,4,2,1,4,25.0,3,5,0,5,5,12,6,0,"MF,FW",20-24,Midfielder,Brazil,South America
1049,João Pedro,BRA,Brighton,Premier League,2024,23.0,2001.0,8.5,7,4,1,4,2,1,4,25.0,3,5,0,5,5,12,6,0,"MF,FW",20-24,Midfielder,Brazil,South America
1049,João Pedro,BRA,Brighton,Premier League,2024,23.0,2001.0,8.5,7,4,1,4,2,1,4,25.0,3,5,0,5,5,12,6,0,"MF,FW",20-24,Midfielder,Brazil,South America
1049,João Pedro,BRA,Brighton,Premier League,2024,23.0,2001.0,8.5,7,4,1,4,2,1,4,25.0,3,5,0,5,5,12,6,0,"MF,FW",20-24,Midfielder,Brazil,South America
1049,João Pedro,BRA,Brighton,Premier League,2024,23.0,2001.0,8.5,7,4,1,4,2,1,4,25.0,3,5,0,5,5,12,6,0,"MF,FW",20-24,Midfielder,Brazil,South America
1049,João Pedro,BRA,Brighton,Premier League,2024,23.0,2001.0,8.5,7,4,1,4,2,1,4,25.0,3,5,0,5,5,12,6,0,"MF,FW",20-24,Midfielder,Brazil,South America
1049,João Pedro,BRA,Brighton,Premier League,2024,23.0,2001.0,8.5,7,4,1,4,2,1,4,25.0,3,5,0,5,5,12,6,0,"MF,FW",20-24,Midfielder,Brazil,South America
1049,João Pedro,BRA,Brighton,Premier League,2024,23.0,2001.0,8.5,7,4,1,4,2,1,4,25.0,3,5,0,5,5,12,6,0,"MF,FW",20-24,Midfielder,Brazil,South America
1049,João Pedro,BRA,Brighton,Premier League,2024,23.0,2001.0,8.5,7,4,1,4,2,1,4,25.0,3,5,0,5,5,12,6,0,"MF,FW",20-24,Midfielder,Brazil,South America
1049,João Pedro,BRA,Brighton,Premier League,2024,23.0,2001.0,8.5,7,4,1,4,2,1,4,25.0,3,5,0,5,5,12,6,0,"MF,FW",20-24,Midfielder,Brazil,South America
1049,João Pedro,BRA,Brighton,Premier League,2024,23.0,2001.0,8.5,7,4,1,4,2,1,4,25.0,3,5,0,5,5,12,6,0,"MF,FW",20-24,Midfielder,Brazil,South America
1049,João Pedro,BRA,Brighton,Premier League,2024,23.0,2001.0,8.5,7,4,1,4,2,1,4,25.0,3,5,0,5,5,12,6,0,"MF,FW",20-24,Midfielder,Brazil,South America
1049,João Pedro,BRA,Brighton,Premier League,2024,23.0,2001.0,8.5,7,4,1,4,2,1,4,25.0,3,5,0,5,5,12,6,0,"MF,FW",20-24,Midfielder,Brazil,South America
1049,João Pedro,BRA,Brighton,Premier League,2024,23.0,2001.0,8.5,7,4,1,4,2,1,4,25.0,3,5,0,5,5,12,6,0,"MF,FW",20-24,Midfielder,Brazil,South America
1049,João Pedro,BRA,Brighton,Premier League,2024,23.0,2001.0,8.5,7,4,1,4,2,1,4,25.0,3,5,0,5,5,12,6,0,"MF,FW",20-24,Midfielder,Brazil,South America
1049,João Pedro,BRA,Brighton,Premier League,2024,23.0,2001.0,8.5,7,4,1,4,2,1,4,25.0,3,5,0,5,5,12,6,0,"MF,FW",20-24,Midfielder,Brazil,South America
1049,João Pedro,BRA,Brighton,Premier League,2024,23.0,2001.0,8.5,7,4,1,4,2,1,4,25.0,3,5,0,5,5,12,6,0,"MF,FW",20-24,Midfielder,Brazil,South America
1049,João Pedro,BRA,Brighton,Premier League,2024,23.0,2001.0,8.5,7,4,1,4,2,1,4,25.0,3,5,0,5,5,12,6,0,"MF,FW",20-24,Midfielder,Brazil,South America
1049,João Pedro,BRA,Brighton,Premier League,2024,23.0,2001.0,8.5,7,4,1,4,2,1,4,25.0,3,5,0,5,5,12,6,0,"MF,FW",20-24,Midfielder,Brazil,South America
1049,João Pedro,BRA,Brighton,Premier League,2024,23.0,2001.0,8.5,7,4,1,4,2,1,4,25.0,3,5,0,5,5,12,6,0,"MF,FW",20-24,Midfielder,Brazil,South America
1049,João Pedro,BRA,Brighton,Premier League,2024,23.0,2001.0,8.5,7,4,1,4,2,1,4,25.0,3,5,0,5,5,12,6,0,"MF,FW",20-24,Midfielder,Brazil,South America
1049,João Pedro,BRA,Brighton,Premier League,2024,23.0,2001.0,8.5,7,4,1,4,2,1,4,25.0,3,5,0,5,5,12,6,0,"MF,FW",20-24,Midfielder,Brazil,South America
1049,João Pedro,BRA,Brighton,Premier League,2024,23.0,2001.0,8.5,7,4,1,4,2,1,4,25.0,3,5,0,5,5,12,6,0,"MF,FW",20-24,Midfielder,Brazil,South America
1049,João Pedro,BRA,Brighton,Premier League,2024,23.0,2001.0,8.5,7,4,1,4,2,1,4,25.0,3,5,0,5,5,12,6,0,"MF,FW",20-24,Midfielder,Brazil,South America
1049,João Pedro,BRA,Brighton,Premier League,2024,23.0,2001.0,8.5,7,4,1,4,2,1,4,25.0,3,5,0,5,5,12,6,0,"MF,FW",20-24,Midfielder,Brazil,South America
1049,João Pedro,BRA,Brighton,Premier League,2024,23.0,2001.0,8.5,7,4,1,4,2,1,4,25.0,3,5,0,5,5,12,6,0,"MF,FW",20-24,Midfielder,Brazil,South America
1049,João Pedro,BRA,Brighton,Premier League,2024,23.0,2001.0,8.5,7,4,1,4,2,1,4,25.0,3,5,0,5,5,12,6,0,"MF,FW",20-24,Midfielder,Brazil,South America
1049,João Pedro,BRA,Brighton,Premier League,2024,23.0,2001.0,8.5,7,4,1,4,2,1,4,25.0,3,5,0,5,5,12,6,0,"MF,FW",20-24,Midfielder,Brazil,South America
1049,João Pedro,BRA,Brighton,Premier League,2024,23.0,2001.0,8.5,7,4,1,4,2,1,4,25.0,3,5,0,5,5,12,6,0,"MF,FW",20-24,Midfielder,Brazil,South America
1049,João Pedro,BRA,Brighton,Premier League,2024,23.0,2001.0,8.5,7,4,1,4,2,1,4,25.0,3,5,0,5,5,12,6,0,"MF,FW",20-24,Midfielder,Brazil,South America
1049,João Pedro,BRA,Brighton,Premier League,2024,23.0,2001.0,8.5,7,4,1,4,2,1,4,25.0,3,5,0,5,5,12,6,0,"MF,FW",20-24,Midfielder,Brazil,South America
1049,João Pedro,BRA,Brighton,Premier League,2024,23.0,2001.0,8.5,7,4,1,4,2,1,4,25.0,3,5,0,5,5,12,6,0,"MF,FW",20-24,Midfielder,Brazil,South America
1049,João Pedro,BRA,Brighton,Premier League,2024,23.0,2001.0,8.5,7,4,1,4,2,1,4,25.0,3,5,0,5,5,12,6,0,"MF,FW",20-24,Midfielder,Brazil,South America
1049,João Pedro,BRA,Brighton,Premier League,2024,23.0,2001.0,8.5,7,4,1,4,2,1,4,25.0,3,5,0,5,5,12,6,0,"MF,FW",20-24,Midfielder,Brazil,South America
1049,João Pedro,BRA,Brighton,Premier League,2024,23.0,2001.0,8.5,7,4,1,4,2,1,4,25.0,3,5,0,5,5,12,6,0,"MF,FW",20-24,Midfielder,Brazil,South America
1049,João Pedro,BRA,Brighton,Premier League,2024,23.0,2001.0,8.5,7,4,1,4,2,1,4,25.0,3,5,0,5,5,12,6,0,"MF,FW",20-24,Midfielder,Brazil,South America
1049,João Pedro,BRA,Brighton,Premier League,2024,23.0,2001.0,8.5,7,4,1,4,2,1,4,25.0,3,5,0,5,5,12,6,0,"MF,FW",20-24,Midfielder,Brazil,South America
1049,João Pedro,BRA,Brighton,Premier League,2024,23.0,2001.0,8.5,7,4,1,4,2,1,4,25.0,3,5,0,5,5,12,6,0,"MF,FW",20-24,Midfielder,Brazil,South America
1049,João Pedro,BRA,Brighton,Premier League,2024,23.0,2001.0,8.5,7,4,1,4,2,1,4,25.0,3,5,0,5,5,12,6,0,"MF,FW",20-24,Midfielder,Brazil,South America
1049,João Pedro,BRA,Brighton,Premier League,2024,23.0,2001.0,8.5,7,4,1,4,2,1,4,25.0,3,5,0,5,5,12,6,0,"MF,FW",20-24,Midfielder,Brazil,South America
1049,João Pedro,BRA,Brighton,Premier League,2024,23.0,2001.0,8.5,7,4,1,4,2,1,4,25.0,3,5,0,5,5,12,6,0,"MF,FW",20-24,Midfielder,Brazil,South America
1049,João Pedro,BRA,Brighton,Premier League,2024,23.0,2001.0,8.5,7,4,1,4,2,1,4,25.0,3,5,0,5,5,12,6,0,"MF,FW",20-24,Midfielder,Brazil,South America
1049,João Pedro,BRA,Brighton,Premier League,2024,23.0,2001.0,8.5,7,4,1,4,2,1,4,25.0,3,5,0,5,5,12,6,0,"MF,FW",20-24,Midfielder,Brazil,South America
1049,João Pedro,BRA,Brighton,Premier League,2024,23.0,2001.0,8.5,7,4,1,4,2,1,4,25.0,3,5,0,5,5,12,6,0,"MF,FW",20-24,Midfielder,Brazil,South America
1049,João Pedro,BRA,Brighton,Premier League,2024,23.0,2001.0,8.5,7,4,1,4,2,1,4,25.0,3,5,0,5,5,12,6,0,"MF,FW",20-24,Midfielder,Brazil,South America
1049,João Pedro,BRA,Brighton,Premier League,2024,23.0,2001.0,8.5,7,4,1,4,2,1,4,25.0,3,5,0,5,5,12,6,0,"MF,FW",20-24,Midfielder,Brazil,South America
1049,João Pedro,BRA,Brighton,Premier League,2024,23.0,2001.0,8.5,7,4,1,4,2,1,4,25.0,3,5,0,5,5,12,6,0,"MF,FW",20-24,Midfielder,Brazil,South America
1049,João Pedro,BRA,Brighton,Premier League,2024,23.0,2001.0,8.5,7,4,1,4,2,1,4,25.0,3,5,0,5,5,12,6,0,"MF,FW",20-24,Midfielder,Brazil,South America
1049,João Pedro,BRA,Brighton,Premier League,2024,23.0,2001.0,8.5,7,4,1,4,2,1,4,25.0,3,5,0,5,5,12,6,0,"MF,FW",20-24,Midfielder,Brazil,South America
1049,João Pedro,BRA,Brighton,Premier League,2024,23.0,2001.0,8.5,7,4,1,4,2,1,4,25.0,3,5,0,5,5,12,6,0,"MF,FW",20-24,Midfielder,Brazil,South America
1049,João Pedro,BRA,Brighton,Premier League,2024,23.0,2001.0,8.5,7,4,1,4,2,1,4,25.0,3,5,0,5,5,12,6,0,"MF,FW",20-24,Midfielder,Brazil,South America
1049,João Pedro,BRA,Brighton,Premier League,2024,23.0,2001.0,8.5,7,4,1,4,2,1,4,25.0,3,5,0,5,5,12,6,0,"MF,FW",20-24,Midfielder,Brazil,South America
1049,João Pedro,BRA,Brighton,Premier League,2024,23.0,2001.0,8.5,7,4,1,4,2,1,4,25.0,3,5,0,5,5,12,6,0,"MF,FW",20-24,Midfielder,Brazil,South America
1049,João Pedro,BRA,Brighton,Premier League,2024,23.0,2001.0,8.5,7,4,1,4,2,1,4,25.0,3,5,0,5,5,12,6,0,"MF,FW",20-24,Midfielder,Brazil,South America
1049,João Pedro,BRA,Brighton,Premier League,2024,23.0,2001.0,8.5,7,4,1,4,2,1,4,25.0,3,5,0,5,5,12,6,0,"MF,FW",20-24,Midfielder,Brazil,South America
1049,João Pedro,BRA,Brighton,Premier League,2024,23.0,2001.0,8.5,7,4,1,4,2,1,4,25.0,3,5,0,5,5,12,6,0,"MF,FW",20-24,Midfielder,Brazil,South America
1049,João Pedro,BRA,Brighton,Premier League,2024,23.0,2001.0,8.5,7,4,1,4,2,1,4,25.0,3,5,0,5,5,12,6,0,"MF,FW",20-24,Midfielder,Brazil,South America
1049,João Pedro,BRA,Brighton,Premier League,2024,23.0,2001.0,8.5,7,4,1,4,2,1,4,25.0,3,5,0,5,5,12,6,0,"MF,FW",20-24,Midfielder,Brazil,South America
1049,João Pedro,BRA,Brighton,Premier League,2024,23.0,2001.0,8.5,7,4,1,4,2,1,4,25.0,3,5,0,5,5,12,6,0,"MF,FW",20-24,Midfielder,Brazil,South America
1049,João Pedro,BRA,Brighton,Premier League,2024,23.0,2001.0,8.5,7,4,1,4,2,1,4,25.0,3,5,0,5,5,12,6,0,"MF,FW",20-24,Midfielder,Brazil,South America
1049,João Pedro,BRA,Brighton,Premier League,2024,23.0,2001.0,8.5,7,4,1,4,2,1,4,25.0,3,5,0,5,5,12,6,0,"MF,FW",20-24,Midfielder,Brazil,South America
1049,João Pedro,BRA,Brighton,Premier League,2024,23.0,2001.0,8.5,7,4,1,4,2,1,4,25.0,3,5,0,5,5,12,6,0,"MF,FW",20-24,Midfielder,Brazil,South America
1049,João Pedro,BRA,Brighton,Premier League,2024,23.0,2001.0,8.5,7,4,1,4,2,1,4,25.0,3,5,0,5,5,12,6,0,"MF,FW",20-24,Midfielder,Brazil,South America
1049,João Pedro,BRA,Brighton,Premier League,2024,23.0,2001.0,8.5,7,4,1,4,2,1,4,25.0,3,5,0,5,5,12,6,0,"MF,FW",20-24,Midfielder,Brazil,South America
1050,John Joe,IRL,Getafe,La Liga,2024,21.0,2003.0,0.5,0,0,0,0,0,0,0,,0,1,1,0,0,0,1,0,"MF,FW",20-24,Midfielder,Republic of Ireland,Europe
1051,Joelinton,BRA,Newcastle Utd,Premier League,2024,28.0,1996.0,14.7,33,19,13,13,7,13,24,54.2,11,22,3,19,12,45,26,1,"MF,FW",25-29,Midfielder,Brazil,South America
1053,Þórir Jóhann Helgason,ISL,Lecce,Serie A,2024,24.0,2000.0,0.4,2,1,1,1,0,1,1,100.0,0,1,0,1,1,3,2,0,"MF,FW",20-24,Midfielder,Iceland,Europe
1054,Carl Johansson,SWE,Holstein Kiel,Bundesliga,2024,30.0,1994.0,4.1,4,2,4,0,0,3,6,50.0,3,7,6,1,6,10,25,1,DF,30-34,Defender,Sweden,Europe
1055,Ben Johnson,ENG,Ipswich Town,Premier League,2024,24.0,2000.0,5.7,22,13,14,7,1,13,21,61.9,8,9,3,6,9,31,10,0,"DF,FW",20-24,Defender,England,Europe
1056,Brennan Johnson,WAL,Tottenham,Premier League,2024,23.0,2001.0,13.4,26,16,4,14,8,11,22,50.0,11,13,2,11,3,29,8,0,FW,20-24,Forward,Wales,Europe
1057,Karl-Johan Johnsson,SWE,Strasbourg,Ligue 1,2024,34.0,1990.0,3.0,0,0,0,0,0,0,1,0.0,1,0,0,0,0,0,3,0,GK,30-34,Goalkeeper,Sweden,Europe
1058,Sam Johnstone,ENG,Wolves,Premier League,2024,31.0,1993.0,7.0,0,0,0,0,0,0,1,0.0,1,0,0,0,0,0,7,0,GK,30-34,Goalkeeper,England,Europe
1059,Paul Joly,FRA,Auxerre,Ligue 1,2024,24.0,2000.0,5.7,20,13,14,6,0,11,23,47.8,12,6,0,6,14,34,19,5,DF,20-24,Defender,France,Europe
1060,Curtis Jones,ENG,Liverpool,Premier League,2024,23.0,2001.0,7.3,14,7,2,10,2,5,10,50.0,5,8,4,4,2,16,5,0,MF,20-24,Midfielder,England,Europe
1061,Frenkie de Jong,NED,Barcelona,La Liga,2024,27.0,1997.0,2.6,1,1,0,1,0,0,1,0.0,1,3,0,3,1,2,0,0,MF,25-29,Midfielder,Netherlands,Europe
1063,Jorginho,ITA,Arsenal,Premier League,2024,33.0,1991.0,4.4,8,3,1,5,2,5,11,45.5,6,0,0,0,5,13,1,1,MF,30-34,Midfielder,Italy,Europe
1063,Jorginho,ITA,Arsenal,Premier League,2024,33.0,1991.0,4.4,8,3,1,5,2,5,11,45.5,6,0,0,0,5,13,1,1,MF,30-34,Midfielder,Italy,Europe
1063,Jorginho,ITA,Arsenal,Premier League,2024,33.0,1991.0,4.4,8,3,1,5,2,5,11,45.5,6,0,0,0,5,13,1,1,MF,30-34,Midfielder,Italy,Europe
1063,Jorginho,ITA,Arsenal,Premier League,2024,33.0,1991.0,4.4,8,3,1,5,2,5,11,45.5,6,0,0,0,5,13,1,1,MF,30-34,Midfielder,Italy,Europe
1063,Jorginho,ITA,Arsenal,Premier League,2024,33.0,1991.0,4.4,8,3,1,5,2,5,11,45.5,6,0,0,0,5,13,1,1,MF,30-34,Midfielder,Italy,Europe
1063,Jorginho,ITA,Arsenal,Premier League,2024,33.0,1991.0,4.4,8,3,1,5,2,5,11,45.5,6,0,0,0,5,13,1,1,MF,30-34,Midfielder,Italy,Europe
1063,Jorginho,ITA,Arsenal,Premier League,2024,33.0,1991.0,4.4,8,3,1,5,2,5,11,45.5,6,0,0,0,5,13,1,1,MF,30-34,Midfielder,Italy,Europe
1063,Jorginho,ITA,Arsenal,Premier League,2024,33.0,1991.0,4.4,8,3,1,5,2,5,11,45.5,6,0,0,0,5,13,1,1,MF,30-34,Midfielder,Italy,Europe
1063,Jorginho,ITA,Arsenal,Premier League,2024,33.0,1991.0,4.4,8,3,1,5,2,5,11,45.5,6,0,0,0,5,13,1,1,MF,30-34,Midfielder,Italy,Europe
1063,Jorginho,ITA,Arsenal,Premier League,2024,33.0,1991.0,4.4,8,3,1,5,2,5,11,45.5,6,0,0,0,5,13,1,1,MF,30-34,Midfielder,Italy,Europe
1063,Jorginho,ITA,Arsenal,Premier League,2024,33.0,1991.0,4.4,8,3,1,5,2,5,11,45.5,6,0,0,0,5,13,1,1,MF,30-34,Midfielder,Italy,Europe
1063,Jorginho,ITA,Arsenal,Premier League,2024,33.0,1991.0,4.4,8,3,1,5,2,5,11,45.5,6,0,0,0,5,13,1,1,MF,30-34,Midfielder,Italy,Europe
1063,Jorginho,ITA,Arsenal,Premier League,2024,33.0,1991.0,4.4,8,3,1,5,2,5,11,45.5,6,0,0,0,5,13,1,1,MF,30-34,Midfielder,Italy,Europe
1063,Jorginho,ITA,Arsenal,Premier League,2024,33.0,1991.0,4.4,8,3,1,5,2,5,11,45.5,6,0,0,0,5,13,1,1,MF,30-34,Midfielder,Italy,Europe
1063,Jorginho,ITA,Arsenal,Premier League,2024,33.0,1991.0,4.4,8,3,1,5,2,5,11,45.5,6,0,0,0,5,13,1,1,MF,30-34,Midfielder,Italy,Europe
1063,Jorginho,ITA,Arsenal,Premier League,2024,33.0,1991.0,4.4,8,3,1,5,2,5,11,45.5,6,0,0,0,5,13,1,1,MF,30-34,Midfielder,Italy,Europe
1064,Jesse Joronen,FIN,Venezia,Serie A,2024,31.0,1993.0,7.0,0,0,0,0,0,0,0,,0,0,0,0,0,0,3,0,GK,30-34,Goalkeeper,Finland,Europe
1065,Jota,POR,Rennes,Ligue 1,2024,25.0,1999.0,3.7,5,2,2,3,0,4,7,57.1,3,1,0,1,3,8,2,0,"FW,MF",25-29,Forward,Portugal,Europe
1065,Jota,POR,Rennes,Ligue 1,2024,25.0,1999.0,3.7,5,2,2,3,0,4,7,57.1,3,1,0,1,3,8,2,0,"FW,MF",25-29,Forward,Portugal,Europe
1065,Jota,POR,Rennes,Ligue 1,2024,25.0,1999.0,3.7,5,2,2,3,0,4,7,57.1,3,1,0,1,3,8,2,0,"FW,MF",25-29,Forward,Portugal,Europe
1065,Jota,POR,Rennes,Ligue 1,2024,25.0,1999.0,3.7,5,2,2,3,0,4,7,57.1,3,1,0,1,3,8,2,0,"FW,MF",25-29,Forward,Portugal,Europe
1065,Jota,POR,Rennes,Ligue 1,2024,25.0,1999.0,3.7,5,2,2,3,0,4,7,57.1,3,1,0,1,3,8,2,0,"FW,MF",25-29,Forward,Portugal,Europe
1065,Jota,POR,Rennes,Ligue 1,2024,25.0,1999.0,3.7,5,2,2,3,0,4,7,57.1,3,1,0,1,3,8,2,0,"FW,MF",25-29,Forward,Portugal,Europe
1065,Jota,POR,Rennes,Ligue 1,2024,25.0,1999.0,3.7,5,2,2,3,0,4,7,57.1,3,1,0,1,3,8,2,0,"FW,MF",25-29,Forward,Portugal,Europe
1065,Jota,POR,Rennes,Ligue 1,2024,25.0,1999.0,3.7,5,2,2,3,0,4,7,57.1,3,1,0,1,3,8,2,0,"FW,MF",25-29,Forward,Portugal,Europe
1065,Jota,POR,Rennes,Ligue 1,2024,25.0,1999.0,3.7,5,2,2,3,0,4,7,57.1,3,1,0,1,3,8,2,0,"FW,MF",25-29,Forward,Portugal,Europe
1066,Diogo Jota,POR,Liverpool,Premier League,2024,28.0,1996.0,5.9,4,2,0,3,1,3,8,37.5,5,2,0,2,3,7,4,0,FW,25-29,Forward,Portugal,Europe
1067,Antoine Joujou,FRA,Le Havre,Ligue 1,2024,21.0,2003.0,3.9,6,5,4,1,1,2,4,50.0,2,8,2,6,3,9,3,0,"MF,FW",20-24,Midfielder,France,Europe
1071,Jubal,BRA,Auxerre,Ligue 1,2024,31.0,1993.0,12.4,27,19,24,3,0,13,22,59.1,9,29,14,15,9,36,71,1,DF,30-34,Defender,Brazil,South America
1072,Abdulai Juma Bah,SLE,Valladolid,La Liga,2024,18.0,2006.0,8.1,10,7,7,3,0,3,5,60.0,2,13,8,5,10,20,54,0,DF,Under 20,Defender,Sierra Leone,Africa
1073,Anthony Jung,GER,Werder Bremen,Bundesliga,2024,33.0,1991.0,10.3,14,9,12,2,0,8,14,57.1,6,8,4,4,14,28,42,0,DF,30-34,Defender,Germany,Europe
1074,Luiz Lúcio Reis Júnior,BRA,Villarreal,La Liga,2024,23.0,2001.0,3.2,0,0,0,0,0,0,0,,0,0,0,0,0,0,4,0,GK,20-24,Goalkeeper,Brazil,South America
1075,Hamed Junior Traorè,CIV,Auxerre,Ligue 1,2024,24.0,2000.0,11.1,20,10,5,9,6,6,28,21.4,22,5,0,5,4,24,7,0,MF,20-24,Midfielder,Ivory Coast,Africa
1076,Vinicius Júnior,BRA,Real Madrid,La Liga,2024,24.0,2000.0,12.2,11,6,4,2,5,3,7,42.9,4,5,0,5,0,11,1,1,FW,20-24,Forward,Brazil,South America
1077,Josip Juranović,CRO,Union Berlin,Bundesliga,2024,29.0,1995.0,0.7,2,1,1,0,1,1,1,100.0,0,1,0,1,0,2,2,0,DF,25-29,Defender,Croatia,Europe
1079,Stanko Jurić,CRO,Valladolid,La Liga,2024,28.0,1996.0,11.6,28,15,15,12,1,14,34,41.2,20,18,5,13,12,40,42,0,MF,25-29,Midfielder,Croatia,Europe
1080,James Justin,ENG,Leicester City,Premier League,2024,26.0,1998.0,15.5,35,21,19,12,4,19,33,57.6,14,23,6,17,24,59,66,1,DF,25-29,Defender,England,Europe
1081,Filip Jørgensen,DEN,Chelsea,Premier League,2024,22.0,2002.0,1.0,0,0,0,0,0,0,0,,0,0,0,0,0,0,0,0,GK,20-24,Goalkeeper,Denmark,Europe
1082,Mohamed Kaba,FRA,Lecce,Serie A,2024,23.0,2001.0,1.1,6,3,2,4,0,4,5,80.0,1,3,1,2,1,7,2,1,MF,20-24,Midfielder,France,Europe
1083,Yusuf Kabadayı,GER,Augsburg,Bundesliga,2024,20.0,2004.0,0.8,1,0,0,1,0,0,0,,0,1,0,1,0,1,0,0,"FW,MF",20-24,Forward,Germany,Europe
1084,Almugera Kabar,GER,Dortmund,Bundesliga,2024,18.0,2006.0,0.5,2,2,0,2,0,0,0,,0,1,0,1,1,3,2,0,DF,Under 20,Defender,Germany,Europe
1085,Christian Kabasele,BEL,Udinese,Serie A,2024,33.0,1991.0,8.2,9,5,5,4,0,4,5,80.0,1,8,2,6,8,17,37,1,DF,30-34,Defender,Belgium,Europe
1086,Yaya Kader Fofana,MLI,Reims,Ligue 1,2024,20.0,2004.0,7.0,17,11,8,5,4,4,12,33.3,8,11,2,9,3,20,2,0,"MF,FW",20-24,Midfielder,Mali,Africa
1088,Tino Kadewere,ZIM,Nantes,Ligue 1,2024,28.0,1996.0,5.3,13,7,4,3,6,6,12,50.0,6,3,0,3,5,18,8,0,"MF,FW",25-29,Midfielder,Zimbabwe,Africa
1089,Ferdi Kadioglu,TUR,Brighton,Premier League,2024,25.0,1999.0,4.3,10,6,4,5,1,6,15,40.0,9,2,2,0,8,18,17,0,"DF,MF",25-29,Defender,Turkey,Asia
1090,Arnaud Kalimuendo,FRA,Rennes,Ligue 1,2024,22.0,2002.0,12.1,6,4,2,2,2,2,3,66.7,1,4,1,3,1,7,2,0,FW,20-24,Forward,France,Europe
1091,Pierre Kalulu,FRA,Juventus,Serie A,2024,24.0,2000.0,13.0,11,7,8,3,0,7,8,87.5,1,13,8,5,8,19,27,1,DF,20-24,Defender,France,Europe
1092,Daichi Kamada,JPN,Crystal Palace,Premier League,2024,28.0,1996.0,7.9,22,11,7,13,2,6,21,28.6,15,9,2,7,8,30,8,0,MF,25-29,Midfielder,Japan,Asia
1094,Boubacar Kamara,FRA,Aston Villa,Premier League,2024,25.0,1999.0,4.8,12,6,6,4,2,7,16,43.8,9,6,3,3,6,18,10,1,MF,25-29,Midfielder,France,Europe
1095,Glen Kamara,FIN,Rennes,Ligue 1,2024,29.0,1995.0,7.4,23,11,10,11,2,11,17,64.7,6,7,0,7,7,30,7,0,MF,25-29,Midfielder,Finland,Europe
1096,Hassane Kamara,CIV,Udinese,Serie A,2024,30.0,1994.0,7.3,15,10,5,8,2,4,10,40.0,6,9,2,7,9,24,15,0,DF,30-34,Defender,Ivory Coast,Africa
1097,Willy Kambwala,FRA,Villarreal,La Liga,2024,20.0,2004.0,1.3,5,3,4,0,1,2,2,100.0,0,1,1,0,1,6,6,0,DF,20-24,Defender,France,Europe
1100,Nordine Kandil,FRA,Strasbourg,Ligue 1,2024,23.0,2001.0,0.1,0,0,0,0,0,0,0,,0,0,0,0,0,0,1,0,MF,20-24,Midfielder,France,Europe
1101,Harry Kane,ENG,Bayern Munich,Bundesliga,2024,31.0,1993.0,11.6,2,2,0,1,1,0,2,0.0,2,3,0,3,0,2,5,0,FW,30-34,Forward,England,Europe
1102,Lee Kang-in,KOR,Paris S-G,Ligue 1,2024,23.0,2001.0,10.1,15,10,5,5,5,13,22,59.1,9,2,0,2,1,16,3,0,"FW,MF",20-24,Forward,South Korea,Asia
1103,Yann Karamoh,FRA,Torino,Serie A,2024,26.0,1998.0,2.9,3,1,2,0,1,3,5,60.0,2,2,1,1,0,3,1,0,"FW,MF",25-29,Forward,France,Europe
1105,Jesper Karlsson,SWE,Bologna,Serie A,2024,26.0,1998.0,3.3,1,0,0,0,1,0,2,0.0,2,4,0,4,0,1,3,0,FW,25-29,Forward,Sweden,Europe
1106,Jesper Karlström,SWE,Udinese,Serie A,2024,29.0,1995.0,16.1,30,15,16,11,3,12,25,48.0,13,12,6,6,21,51,43,1,MF,25-29,Midfielder,Sweden,Europe
1107,Lior Kasa,ISR,Genoa,Serie A,2024,19.0,2005.0,0.2,0,0,0,0,0,0,0,,0,0,0,0,1,1,0,0,MF,Under 20,Midfielder,Israel,Asia
1108,Grigoris Kastanos,CYP,Hellas Verona,Serie A,2024,26.0,1998.0,5.9,12,6,3,4,5,5,11,45.5,6,12,2,10,5,17,3,0,"MF,FW",25-29,Midfielder,Cyprus,Asia
1109,Mikkel Kaufmann,DEN,Heidenheim,Bundesliga,2024,23.0,2001.0,4.1,6,4,1,3,2,2,5,40.0,3,5,2,3,2,8,7,0,FW,20-24,Forward,Denmark,Europe
1110,Michael Kayode,ITA,Fiorentina,Serie A,2024,20.0,2004.0,1.4,1,1,1,0,0,0,0,,0,3,1,2,2,3,7,0,"DF,FW",20-24,Defender,Italy,Europe
1111,Moise Kean,ITA,Fiorentina,Serie A,2024,24.0,2000.0,13.5,5,3,0,2,3,2,3,66.7,1,4,0,4,0,5,9,1,FW,20-24,Forward,Italy,Europe
1112,Michael Keane,ENG,Everton,Premier League,2024,31.0,1993.0,9.0,10,7,7,2,1,7,10,70.0,3,9,6,3,10,20,50,0,DF,30-34,Defender,England,Europe
1113,Yassine Kechta,MAR,Le Havre,Ligue 1,2024,22.0,2002.0,10.7,30,19,14,13,3,15,39,38.5,24,13,2,11,12,42,7,1,"MF,FW",20-24,Midfielder,Morocco,Africa
1114,Thilo Kehrer,GER,Monaco,Ligue 1,2024,28.0,1996.0,13.0,27,19,20,7,0,16,26,61.5,10,7,5,2,14,41,66,1,DF,25-29,Defender,Germany,Europe
1116,Mandela Keita,BEL,Parma,Serie A,2024,22.0,2002.0,4.2,9,3,1,7,1,1,4,25.0,3,4,2,2,4,13,5,1,MF,20-24,Midfielder,Belgium,Europe
1117,Yannik Keitel,GER,Stuttgart,Bundesliga,2024,24.0,2000.0,1.1,2,1,0,1,1,2,3,66.7,1,3,1,2,1,3,2,0,"MF,DF",20-24,Midfielder,Germany,Europe
1118,Andu Kelati,GER,Holstein Kiel,Bundesliga,2024,22.0,2002.0,1.1,1,1,1,0,0,0,1,0.0,1,1,0,1,2,3,1,0,MF,20-24,Midfielder,Germany,Europe
1119,Caoimhín Kelleher,IRL,Liverpool,Premier League,2024,26.0,1998.0,8.0,0,0,0,0,0,0,0,,0,0,0,0,0,0,0,2,GK,25-29,Goalkeeper,Republic of Ireland,Europe
1120,Thomas Keller,GER,Heidenheim,Bundesliga,2024,25.0,1999.0,0.7,0,0,0,0,0,0,1,0.0,1,1,1,0,0,0,4,0,"DF,MF",25-29,Defender,Germany,Europe
1121,Lloyd Kelly,ENG,Newcastle Utd,Premier League,2024,26.0,1998.0,3.3,5,4,4,1,0,1,1,100.0,0,6,4,2,1,6,16,0,DF,25-29,Defender,England,Europe
1122,Aljoscha Kemlein,GER,Union Berlin,Bundesliga,2024,20.0,2004.0,6.9,7,2,3,3,1,4,12,33.3,8,9,1,8,4,11,8,0,MF,20-24,Midfielder,Germany,Europe
1123,Marc-Oliver Kempf,GER,Como,Serie A,2024,29.0,1995.0,13.8,13,11,5,7,1,5,11,45.5,6,10,5,5,22,35,59,1,DF,25-29,Defender,Germany,Europe
1124,Kenedy,BRA,Valladolid,La Liga,2024,28.0,1996.0,0.1,0,0,0,0,0,0,0,,0,1,0,1,0,0,0,0,"MF,FW",25-29,Midfielder,Brazil,South America
1125,Luca Kerber,GER,Heidenheim,Bundesliga,2024,22.0,2002.0,2.1,8,6,6,2,0,5,7,71.4,2,4,1,3,0,8,7,0,"MF,DF",20-24,Midfielder,Germany,Europe
1126,Milos Kerkez,HUN,Bournemouth,Premier League,2024,21.0,2003.0,16.2,23,12,9,12,2,11,17,64.7,6,14,6,8,17,40,46,0,DF,20-24,Defender,Hungary,Europe
1127,Reda Khadra,GER,Reims,Ligue 1,2024,23.0,2001.0,0.9,1,1,1,0,0,0,1,0.0,1,0,0,0,0,1,1,0,"MF,FW",20-24,Midfielder,Germany,Europe
1128,Bilal El Khannouss,MAR,Leicester City,Premier League,2024,20.0,2004.0,6.3,16,6,5,8,3,4,7,57.1,3,6,0,6,3,19,2,0,"MF,FW",20-24,Midfielder,Morocco,Africa
1129,Wahbi Khazri,TUN,Montpellier,Ligue 1,2024,33.0,1991.0,7.2,15,10,4,8,3,4,10,40.0,6,5,1,4,4,19,4,0,"FW,MF",30-34,Forward,Tunisia,Africa
1130,Rani Khedira,GER,Union Berlin,Bundesliga,2024,30.0,1994.0,14.4,28,19,8,18,2,10,15,66.7,5,14,5,9,22,50,13,0,MF,30-34,Midfielder,Germany,Europe
1131,Abdukodir Khusanov,UZB,Lens,Ligue 1,2024,20.0,2004.0,10.8,15,11,9,5,1,7,11,63.6,4,17,11,6,26,41,57,0,DF,20-24,Defender,Uzbekistan,Asia
1132,Kialonda,ANG,Lecce,Serie A,2024,27.0,1997.0,15.0,24,7,18,6,0,10,12,83.3,2,30,21,9,17,41,73,1,DF,25-29,Defender,Angola,Africa
1134,Max Kilman,ENG,West Ham,Premier League,2024,27.0,1997.0,17.0,16,7,7,7,2,11,15,73.3,4,30,20,10,23,39,93,3,DF,25-29,Defender,England,Europe
1135,Joshua Kimmich,GER,Bayern Munich,Bundesliga,2024,29.0,1995.0,15.0,25,17,6,15,4,17,25,68.0,8,7,0,7,10,35,14,2,"MF,DF",25-29,Midfielder,Germany,Europe
1136,Joshua King,ENG,Fulham,Premier League,2024,17.0,2007.0,0.8,5,3,2,3,0,0,1,0.0,1,2,0,2,1,6,1,0,MF,Under 20,Midfielder,England,Europe
1138,Cédric Kipré,CIV,Reims,Ligue 1,2024,28.0,1996.0,9.8,22,15,17,5,0,17,22,77.3,5,15,7,8,15,37,57,1,DF,25-29,Defender,Ivory Coast,Africa
1140,Tim Kleindienst,GER,Gladbach,Bundesliga,2024,29.0,1995.0,14.7,14,7,1,7,6,5,20,25.0,15,20,2,18,7,21,26,0,FW,25-29,Forward,Germany,Europe
1141,Lukas Klostermann,GER,RB Leipzig,Bundesliga,2024,28.0,1996.0,8.5,11,7,7,3,1,5,10,50.0,5,18,9,9,10,21,42,1,DF,25-29,Defender,Germany,Europe
1142,Justin Kluivert,NED,Bournemouth,Premier League,2024,25.0,1999.0,11.7,13,8,3,6,4,3,8,37.5,5,13,0,13,8,21,13,1,"MF,FW",25-29,Midfielder,Netherlands,Europe
1143,Ansgar Knauff,GER,Eint Frankfurt,Bundesliga,2024,22.0,2002.0,7.6,24,13,12,7,5,5,7,71.4,2,12,1,11,7,31,11,0,"MF,DF",20-24,Midfielder,Germany,Europe
1145,Gregor Kobel,SUI,Dortmund,Bundesliga,2024,27.0,1997.0,13.0,0,0,0,0,0,0,0,,0,0,0,0,0,0,7,2,GK,25-29,Goalkeeper,Switzerland,Europe
1146,Robin Koch,GER,Eint Frankfurt,Bundesliga,2024,28.0,1996.0,14.8,10,4,6,3,1,3,11,27.3,8,29,18,11,13,23,74,3,DF,25-29,Defender,Germany,Europe
1147,Magnus Kofod Andersen,DEN,Venezia,Serie A,2024,25.0,1999.0,7.2,9,2,2,6,1,2,7,28.6,5,6,1,5,6,15,10,0,MF,25-29,Midfielder,Denmark,Europe
1148,Derrick Köhn,GER,Werder Bremen,Bundesliga,2024,25.0,1999.0,8.8,9,6,3,4,2,4,6,66.7,2,15,4,11,5,14,16,0,DF,25-29,Defender,Germany,Europe
1149,Philipp Köhn,SUI,Monaco,Ligue 1,2024,26.0,1998.0,9.0,0,0,0,0,0,0,1,0.0,1,0,0,0,0,0,6,0,GK,25-29,Goalkeeper,Switzerland,Europe
1150,Dominik Kohr,GER,Mainz 05,Bundesliga,2024,30.0,1994.0,13.8,31,24,18,10,3,16,27,59.3,11,23,12,11,24,55,72,0,DF,30-34,Defender,Germany,Europe
1152,Sead Kolašinac,BIH,Atalanta,Serie A,2024,31.0,1993.0,10.5,17,9,9,8,0,6,13,46.2,7,4,1,3,14,31,19,1,DF,30-34,Defender,Bosnia and Herzegovina,Europe
1153,Randal Kolo Muani,FRA,Paris S-G,Ligue 1,2024,26.0,1998.0,4.0,4,4,1,1,2,0,2,0.0,2,1,0,1,0,4,5,0,FW,25-29,Forward,France,Europe
1154,Marco Komenda,CRO,Holstein Kiel,Bundesliga,2024,28.0,1996.0,3.0,10,6,3,6,1,5,7,71.4,2,3,1,2,1,11,12,0,DF,25-29,Defender,Croatia,Europe
1155,Mert Kömür,GER,Augsburg,Bundesliga,2024,19.0,2005.0,1.5,1,0,1,0,0,0,0,,0,3,2,1,3,4,1,1,MF,Under 20,Midfielder,Germany,Europe
1156,Ibrahima Konaté,FRA,Liverpool,Premier League,2024,25.0,1999.0,10.8,14,10,10,3,1,9,12,75.0,3,13,5,8,4,18,44,1,DF,25-29,Defender,France,Europe
1157,Ismael Konate,CIV,Empoli,Serie A,2024,18.0,2006.0,0.1,0,0,0,0,0,0,0,,0,0,0,0,0,0,0,0,"FW,DF",Under 20,Forward,Ivory Coast,Africa
1158,Geoffrey Kondogbia,CTA,Marseille,Ligue 1,2024,31.0,1993.0,12.2,34,20,20,13,1,21,24,87.5,3,11,1,10,11,45,36,2,"DF,MF",30-34,Defender,Central African Republic,Africa
1159,Abdoul Koné,FRA,Reims,Ligue 1,2024,19.0,2005.0,1.2,5,3,4,1,0,3,5,60.0,2,2,1,1,1,6,4,0,DF,Under 20,Defender,France,Europe
1160,Amadou Koné,MLI,Reims,Ligue 1,2024,19.0,2005.0,5.2,21,14,12,9,0,10,13,76.9,3,9,2,7,6,27,7,0,MF,Under 20,Midfielder,Mali,Africa
1161,Ismaël Koné,CAN,Marseille,Ligue 1,2024,22.0,2002.0,3.5,6,3,3,2,1,2,3,66.7,1,4,1,3,3,9,2,1,"MF,FW",20-24,Midfielder,Canada,North America
1162,Manu Koné,FRA,Roma,Serie A,2024,23.0,2001.0,11.9,19,12,7,8,4,13,25,52.0,12,6,0,6,12,31,7,0,MF,20-24,Midfielder,France,Europe
1163,Ezri Konsa,ENG,Aston Villa,Premier League,2024,27.0,1997.0,14.1,19,11,11,4,4,11,13,84.6,2,6,3,3,11,30,45,0,DF,25-29,Defender,England,Europe
1164,Teun Koopmeiners,NED,Juventus,Serie A,2024,26.0,1998.0,10.4,15,10,3,10,2,5,16,31.3,11,11,5,6,5,20,9,0,"MF,FW",25-29,Midfielder,Netherlands,Europe
1165,Odilon Kossounou,CIV,Atalanta,Serie A,2024,23.0,2001.0,7.0,10,6,7,3,0,4,7,57.1,3,10,2,8,7,17,11,0,DF,20-24,Defender,Ivory Coast,Africa
1166,Christian Kouamé,CIV,Fiorentina,Serie A,2024,27.0,1997.0,6.5,12,7,4,3,5,0,3,0.0,3,2,0,2,2,14,9,0,"FW,MF",25-29,Forward,Ivory Coast,Africa
1167,Henri Koudossou,GER,Augsburg,Bundesliga,2024,25.0,1999.0,4.7,7,6,2,4,1,6,10,60.0,4,4,2,2,6,13,23,0,DF,25-29,Defender,Germany,Europe
1168,Konstantinos Koulierakis,GRE,Wolfsburg,Bundesliga,2024,21.0,2003.0,11.3,19,9,11,6,2,9,16,56.3,7,20,9,11,13,32,61,0,DF,20-24,Defender,Greece,Europe
1169,Emmanuel Koum Mbondo,FRA,Marseille,Ligue 1,2024,18.0,2006.0,0.1,0,0,0,0,0,0,0,,0,0,0,0,0,0,0,0,DF,Under 20,Defender,France,Europe
1170,Jules Koundé,FRA,Barcelona,La Liga,2024,26.0,1998.0,16.9,42,30,17,19,6,33,45,73.3,12,22,3,19,9,51,39,2,DF,25-29,Defender,France,Europe
1171,Boubakar Kouyaté,MLI,Montpellier,Ligue 1,2024,27.0,1997.0,1.2,4,1,3,1,0,3,5,60.0,2,0,0,0,3,7,5,0,DF,25-29,Defender,Mali,Africa
1172,Mateo Kovačić,CRO,Manchester City,Premier League,2024,30.0,1994.0,10.9,24,15,6,12,6,12,28,42.9,16,12,0,12,6,30,6,0,MF,30-34,Midfielder,Croatia,Europe
1175,Caleb Kporha,ENG,Crystal Palace,Premier League,2024,18.0,2006.0,0.1,2,1,2,0,0,2,2,100.0,0,0,0,0,0,2,1,0,DF,Under 20,Defender,England,Europe
1176,Emil Krafth,SWE,Newcastle Utd,Premier League,2024,30.0,1994.0,2.7,2,1,0,1,1,1,2,50.0,1,5,4,1,2,4,10,0,DF,30-34,Defender,Sweden,Europe
1178,Andrej Kramarić,CRO,Hoffenheim,Bundesliga,2024,33.0,1991.0,13.0,6,3,1,5,0,3,6,50.0,3,6,2,4,2,8,6,0,"MF,FW",30-34,Midfielder,Croatia,Europe
1179,Frans Krätzig,GER,Stuttgart,Bundesliga,2024,21.0,2003.0,0.6,2,1,1,0,1,1,3,33.3,2,2,1,1,0,2,1,0,DF,20-24,Defender,Germany,Europe
1181,Marcus Kristensen,GER,Stuttgart,Bundesliga,2024,21.0,2003.0,0.0,0,0,0,0,0,0,0,,0,0,0,0,0,0,0,0,DF,20-24,Defender,Germany,Europe
1182,Rasmus Kristensen,DEN,Eint Frankfurt,Bundesliga,2024,27.0,1997.0,11.4,22,12,16,3,3,17,32,53.1,15,17,5,12,11,33,34,0,DF,25-29,Defender,Denmark,Europe
1183,Thomas Kristensen,DEN,Udinese,Serie A,2024,22.0,2002.0,5.1,6,4,3,3,0,3,6,50.0,3,4,4,0,3,9,19,0,DF,20-24,Defender,Denmark,Europe
1183,Thomas Kristensen,DEN,Udinese,Serie A,2024,22.0,2002.0,5.1,6,4,3,3,0,3,6,50.0,3,4,4,0,3,9,19,0,DF,20-24,Defender,Denmark,Europe
1183,Thomas Kristensen,DEN,Udinese,Serie A,2024,22.0,2002.0,5.1,6,4,3,3,0,3,6,50.0,3,4,4,0,3,9,19,0,DF,20-24,Defender,Denmark,Europe
1183,Thomas Kristensen,DEN,Udinese,Serie A,2024,22.0,2002.0,5.1,6,4,3,3,0,3,6,50.0,3,4,4,0,3,9,19,0,DF,20-24,Defender,Denmark,Europe
1184,Nikola Krstović,MNE,Lecce,Serie A,2024,24.0,2000.0,15.6,13,6,4,4,5,5,11,45.5,6,8,5,3,5,18,10,0,FW,20-24,Forward,Montenegro,Europe
1185,Lukas Kübler,GER,Freiburg,Bundesliga,2024,32.0,1992.0,12.7,24,11,11,11,2,17,26,65.4,9,24,10,14,31,55,32,3,DF,30-34,Defender,Germany,Europe
1186,Takefusa Kubo,JPN,Real Sociedad,La Liga,2024,23.0,2001.0,13.2,20,13,7,7,6,12,23,52.2,11,26,1,25,8,28,5,1,"MF,FW",20-24,Midfielder,Japan,Asia
1187,Mohammed Kudus,GHA,West Ham,Premier League,2024,24.0,2000.0,11.0,18,13,5,9,4,5,14,35.7,9,14,1,13,1,19,1,0,"MF,FW",20-24,Midfielder,Ghana,Africa
1188,Dejan Kulusevski,SWE,Tottenham,Premier League,2024,24.0,2000.0,14.7,19,11,6,5,8,7,22,31.8,15,17,3,14,8,27,8,0,"MF,FW",20-24,Midfielder,Sweden,Europe
1189,Sael Kumbedi,FRA,Lyon,Ligue 1,2024,19.0,2005.0,2.0,5,2,1,3,1,4,5,80.0,1,0,0,0,4,9,5,0,DF,Under 20,Defender,France,Europe
1190,Marash Kumbulla,ALB,Espanyol,La Liga,2024,24.0,2000.0,14.2,20,14,15,3,2,11,21,52.4,10,26,19,7,13,33,81,0,DF,20-24,Defender,Albania,Europe
1191,Daler Kuzyaev,RUS,Le Havre,Ligue 1,2024,31.0,1993.0,5.7,12,7,6,4,2,2,9,22.2,7,7,4,3,9,21,7,0,MF,30-34,Midfielder,Russia,Europe
1192,Khvicha Kvaratskhelia,GEO,Napoli,Serie A,2024,23.0,2001.0,12.3,14,8,4,9,1,4,14,28.6,10,12,0,12,2,16,7,0,"FW,MF",20-24,Forward,Georgia,Asia
1193,Moritz-Broni Kwarteng,GHA,Bochum,Bundesliga,2024,26.0,1998.0,1.9,4,3,1,1,2,1,2,50.0,1,0,0,0,0,4,1,0,"MF,FW",25-29,Midfielder,Ghana,Africa
1194,Giorgos Kyriakopoulos,GRE,Monza,Serie A,2024,28.0,1996.0,17.0,31,20,13,15,3,20,37,54.1,17,21,6,15,16,47,45,0,DF,25-29,Defender,Greece,Europe
1195,Luca de la Torre,USA,Celta Vigo,La Liga,2024,26.0,1998.0,0.0,0,0,0,0,0,0,0,,0,0,0,0,0,0,0,0,MF,25-29,Midfielder,United States,North America
1197,Gaëtan Laborde,FRA,Nice,Ligue 1,2024,30.0,1994.0,4.3,6,4,4,2,0,4,10,40.0,6,5,0,5,2,8,3,0,FW,30-34,Forward,France,Europe
1198,Nediljko Labrović,CRO,Augsburg,Bundesliga,2024,25.0,1999.0,15.0,0,0,0,0,0,0,0,,0,0,0,0,0,0,12,1,GK,25-29,Goalkeeper,Croatia,Europe
1199,Alexandre Lacazette,FRA,Lyon,Ligue 1,2024,33.0,1991.0,10.5,5,2,1,3,1,3,10,30.0,7,5,0,5,3,8,1,0,FW,30-34,Forward,France,Europe
1200,Maxence Lacroix,FRA,Crystal Palace,Premier League,2024,24.0,2000.0,14.0,30,18,23,6,1,14,22,63.6,8,17,6,11,26,56,74,1,DF,20-24,Defender,France,Europe
1201,Alban Lafont,FRA,Nantes,Ligue 1,2024,25.0,1999.0,12.0,1,1,1,0,0,1,1,100.0,0,2,0,2,0,1,8,1,GK,25-29,Goalkeeper,France,Europe
1202,Konrad Laimer,AUT,Bayern Munich,Bundesliga,2024,27.0,1997.0,5.4,18,10,5,10,3,6,18,33.3,12,6,0,6,1,19,8,0,DF,25-29,Defender,Austria,Europe
1203,Stefan Lainer,AUT,Gladbach,Bundesliga,2024,32.0,1992.0,3.5,8,3,6,2,0,3,3,100.0,0,4,3,1,4,12,12,0,DF,30-34,Defender,Austria,Europe
1204,Kenny Lala,MAD,Brest,Ligue 1,2024,33.0,1991.0,11.8,33,21,19,10,4,23,36,63.9,13,18,8,10,11,44,26,0,DF,30-34,Defender,Madagascar,Africa
1205,Adam Lallana,ENG,Southampton,Premier League,2024,36.0,1988.0,3.5,6,5,3,3,0,2,8,25.0,6,4,1,3,4,10,5,0,MF,35-39,Midfielder,England,Europe
1206,Mathis Lambourde,FRA,Hellas Verona,Serie A,2024,18.0,2006.0,0.4,3,1,2,1,0,1,3,33.3,2,1,0,1,0,3,0,0,"FW,MF",Under 20,Forward,France,Europe
1207,Mohamed Lamine Bayo,GUI,Lille,Ligue 1,2024,26.0,1998.0,2.4,0,0,0,0,0,0,0,,0,0,0,0,0,0,1,0,"FW,MF",25-29,Forward,Guinea,Africa
1208,Tariq Lamptey,GHA,Brighton,Premier League,2024,24.0,2000.0,2.9,4,4,2,2,0,2,7,28.6,5,7,1,6,4,8,9,0,DF,20-24,Defender,Ghana,Africa
1209,Will Lankshear,ENG,Tottenham,Premier League,2024,19.0,2005.0,0.1,0,0,0,0,0,0,0,,0,0,0,0,0,0,0,0,FW,Under 20,Forward,England,Europe
1210,Gianluca Lapadula,PER,Cagliari,Serie A,2024,34.0,1990.0,3.1,2,0,1,0,1,0,0,,0,0,0,0,0,2,1,0,"FW,MF",30-34,Forward,Peru,South America
1211,Cyle Larin,CAN,Mallorca,La Liga,2024,29.0,1995.0,10.9,5,2,1,2,2,0,3,0.0,3,7,1,6,1,6,4,0,FW,25-29,Forward,Canada,North America
1212,Gautier Larsonneur,FRA,Saint-Étienne,Ligue 1,2024,27.0,1997.0,15.0,1,0,1,0,0,0,1,0.0,1,0,0,0,0,1,11,0,GK,25-29,Goalkeeper,France,Europe
1213,Hugo Larsson,SWE,Eint Frankfurt,Bundesliga,2024,20.0,2004.0,10.8,16,8,8,5,3,11,25,44.0,14,17,6,11,14,30,16,1,MF,20-24,Midfielder,Sweden,Europe
1216,Roméo Lavia,BEL,Chelsea,Premier League,2024,20.0,2004.0,5.3,15,9,5,7,3,6,13,46.2,7,6,0,6,11,26,5,0,MF,20-24,Midfielder,Belgium,Europe
1217,Valentino Lazaro,AUT,Torino,Serie A,2024,28.0,1996.0,11.9,17,7,9,6,2,10,14,71.4,4,11,3,8,3,20,17,1,DF,25-29,Defender,Austria,Europe
1219,Manuel Lazzari,ITA,Lazio,Serie A,2024,31.0,1993.0,9.8,16,12,7,7,2,9,14,64.3,5,6,4,2,6,22,10,0,DF,30-34,Defender,Italy,Europe
1220,Julien Le Cardinal,FRA,Brest,Ligue 1,2024,27.0,1997.0,8.8,14,9,8,6,0,6,10,60.0,4,11,8,3,24,38,39,0,DF,25-29,Defender,France,Europe
1221,Jérémy Le Douaron,FRA,Brest,Ligue 1,2024,26.0,1998.0,1.1,1,0,0,0,1,0,1,0.0,1,1,0,1,0,1,0,0,FW,25-29,Forward,France,Europe
1222,Enzo Le Fée,FRA,Roma,Serie A,2024,24.0,2000.0,3.5,7,4,5,2,0,2,6,33.3,4,9,3,6,5,12,2,0,MF,20-24,Midfielder,France,Europe
1224,Nicola Leali,ITA,Genoa,Serie A,2024,31.0,1993.0,10.0,0,0,0,0,0,0,0,,0,0,0,0,0,0,6,1,GK,30-34,Goalkeeper,Italy,Europe
1225,Rafael Leão,POR,Milan,Serie A,2024,25.0,1999.0,11.5,7,6,1,4,2,5,10,50.0,5,8,0,8,4,11,0,0,FW,25-29,Forward,Portugal,Europe
1226,Benjamin Lecomte,FRA,Montpellier,Ligue 1,2024,33.0,1991.0,12.0,0,0,0,0,0,0,0,,0,0,0,0,0,0,7,0,GK,30-34,Goalkeeper,France,Europe
1227,Pierre Lees-Melou,FRA,Brest,Ligue 1,2024,31.0,1993.0,3.9,11,7,3,5,3,7,10,70.0,3,4,2,2,4,15,2,0,MF,30-34,Midfielder,France,Europe
1228,Jordan Lefort,FRA,Angers,Ligue 1,2024,31.0,1993.0,15.0,26,17,19,6,1,15,25,60.0,10,25,12,13,15,41,80,1,DF,30-34,Defender,France,Europe
1229,Diogo Leite,POR,Union Berlin,Bundesliga,2024,25.0,1999.0,13.1,41,22,24,14,3,19,30,63.3,11,30,9,21,29,70,56,1,DF,25-29,Defender,Portugal,Europe
1230,Maxim Leitsch,GER,Mainz 05,Bundesliga,2024,26.0,1998.0,6.1,11,3,6,3,2,7,8,87.5,1,9,4,5,8,19,34,1,DF,25-29,Defender,Germany,Europe
1231,Florian Lejeune,FRA,Rayo Vallecano,La Liga,2024,33.0,1991.0,17.9,26,17,15,9,2,10,18,55.6,8,21,16,5,13,39,83,0,DF,30-34,Defender,France,Europe
1233,Nunzio Lella,ITA,Venezia,Serie A,2024,24.0,2000.0,0.1,0,0,0,0,0,0,0,,0,0,0,0,0,0,0,0,MF,20-24,Midfielder,Italy,Europe
1234,Thomas Lemar,FRA,Atlético Madrid,La Liga,2024,29.0,1995.0,0.1,0,0,0,0,0,0,1,0.0,1,0,0,0,0,0,0,0,MF,25-29,Midfielder,France,Europe
1235,Félix Lemaréchal,FRA,Strasbourg,Ligue 1,2024,21.0,2003.0,3.1,8,6,1,5,2,2,3,66.7,1,6,0,6,4,12,2,0,"MF,FW",20-24,Midfielder,France,Europe
1236,Mario Lemina,GAB,Wolves,Premier League,2024,31.0,1993.0,14.8,49,30,27,18,4,19,28,67.9,9,12,7,5,27,76,49,3,"MF,DF",30-34,Midfielder,Gabon,Africa
1237,Clément Lenglet,FRA,Atlético Madrid,La Liga,2024,29.0,1995.0,8.3,8,4,7,1,0,2,3,66.7,1,9,6,3,11,19,41,0,DF,25-29,Defender,France,Europe
1238,Bernd Leno,GER,Fulham,Premier League,2024,32.0,1992.0,17.0,0,0,0,0,0,0,0,,0,1,0,1,0,0,3,3,GK,30-34,Goalkeeper,Germany,Europe
1240,Giovanni Leoni,ITA,Parma,Serie A,2024,18.0,2006.0,3.1,1,0,0,1,0,0,0,,0,7,2,5,5,6,8,0,DF,Under 20,Defender,Italy,Europe
1241,Esteban Lepaul,FRA,Angers,Ligue 1,2024,24.0,2000.0,2.5,1,1,0,0,1,0,5,0.0,5,6,1,5,2,3,2,0,"FW,MF",20-24,Forward,France,Europe
1242,Johann Lepenant,FRA,Nantes,Ligue 1,2024,22.0,2002.0,9.7,27,14,10,11,6,9,25,36.0,16,10,2,8,10,37,8,0,MF,20-24,Midfielder,France,Europe
1243,Jefferson Lerma,COL,Crystal Palace,Premier League,2024,30.0,1994.0,9.2,10,3,4,5,1,6,12,50.0,6,16,10,6,15,25,18,0,MF,30-34,Midfielder,Colombia,South America
1244,Louis Leroux,FRA,Nantes,Ligue 1,2024,18.0,2006.0,0.2,1,1,1,0,0,1,1,100.0,0,0,0,0,0,1,0,0,"MF,FW",Under 20,Midfielder,France,Europe
1246,Jamie Leweling,GER,Stuttgart,Bundesliga,2024,23.0,2001.0,7.3,5,2,2,0,3,3,9,33.3,6,10,0,10,4,9,7,0,"FW,MF",20-24,Forward,Germany,Europe
1247,Rico Lewis,ENG,Manchester City,Premier League,2024,20.0,2004.0,12.4,23,13,10,10,3,8,11,72.7,3,16,2,14,11,34,26,1,"DF,MF",20-24,Defender,England,Europe
1248,Keane Lewis-Potter,ENG,Brentford,Premier League,2024,23.0,2001.0,14.3,21,10,8,9,4,11,17,64.7,6,10,4,6,7,28,26,1,"DF,FW",20-24,Defender,England,Europe
1249,Myles Lewis-Skelly,ENG,Arsenal,Premier League,2024,18.0,2006.0,1.6,5,3,3,2,0,2,2,100.0,0,0,0,0,0,5,1,0,DF,Under 20,Defender,England,Europe
1250,Ben Lhassine Kone,CIV,Como,Serie A,2024,24.0,2000.0,0.4,2,2,1,0,1,2,2,100.0,0,0,0,0,1,3,1,0,MF,20-24,Midfielder,Ivory Coast,Africa
1251,Mattia Liberali,ITA,Milan,Serie A,2024,17.0,2007.0,0.7,2,1,0,1,1,2,2,100.0,0,0,0,0,0,2,0,0,MF,Under 20,Midfielder,Italy,Europe
1252,Philipp Lienhart,AUT,Freiburg,Bundesliga,2024,28.0,1996.0,14.2,11,9,7,4,0,8,17,47.1,9,16,9,7,21,32,44,2,DF,25-29,Defender,Austria,Europe
1253,Matthijs de Ligt,NED,Manchester Utd,Premier League,2024,25.0,1999.0,12.7,13,7,9,4,0,10,14,71.4,4,14,11,3,20,33,38,0,DF,25-29,Defender,Netherlands,Europe
1254,Victor Lindelöf,SWE,Manchester Utd,Premier League,2024,30.0,1994.0,0.7,3,0,3,0,0,1,1,100.0,0,1,0,1,2,5,4,0,"DF,MF",30-34,Defender,Sweden,Europe
1255,Jesper Lindstrøm,DEN,Everton,Premier League,2024,24.0,2000.0,6.0,20,10,9,11,0,11,30,36.7,19,9,3,6,3,23,6,0,FW,20-24,Forward,Denmark,Europe
1257,Samuel Lino,BRA,Atlético Madrid,La Liga,2024,25.0,1999.0,7.9,9,3,6,2,1,6,21,28.6,15,12,1,11,4,13,4,0,"MF,DF",25-29,Midfielder,Brazil,South America
1259,Dailon Livramento,CPV,Hellas Verona,Serie A,2024,23.0,2001.0,6.0,10,8,1,4,5,4,10,40.0,6,6,1,5,2,12,4,0,"FW,MF",20-24,Forward,Cape Verde,Africa
1260,Valentino Livramento,ENG,Newcastle Utd,Premier League,2024,22.0,2002.0,13.3,21,14,15,5,1,15,24,62.5,9,17,6,11,12,33,48,1,DF,20-24,Defender,England,Europe
1264,Gautier Lloris,FRA,Le Havre,Ligue 1,2024,29.0,1995.0,15.0,36,24,25,11,0,20,31,64.5,11,13,5,8,7,43,77,0,DF,25-29,Defender,France,Europe
1265,Giovani Lo Celso,ARG,Betis,La Liga,2024,28.0,1996.0,9.7,24,13,5,12,7,13,17,76.5,4,8,1,7,4,28,3,1,MF,25-29,Midfielder,Argentina,South America
1266,Stanislav Lobotka,SVK,Napoli,Serie A,2024,30.0,1994.0,12.0,26,18,5,14,7,10,13,76.9,3,10,3,7,8,34,18,0,MF,30-34,Midfielder,Slovakia,Europe
1267,Manuel Locatelli,ITA,Juventus,Serie A,2024,26.0,1998.0,13.3,29,22,15,13,1,11,23,47.8,12,23,8,15,9,38,29,0,MF,25-29,Midfielder,Italy,Europe
1268,Ruben Loftus-Cheek,ENG,Milan,Serie A,2024,28.0,1996.0,7.6,14,6,3,7,4,4,7,57.1,3,1,0,1,2,16,9,0,MF,25-29,Midfielder,England,Europe
1269,Enzo Loiodice,FRA,Las Palmas,La Liga,2024,24.0,2000.0,3.1,5,2,4,1,0,2,7,28.6,5,3,0,3,4,9,3,0,MF,20-24,Midfielder,France,Europe
1270,Sean Longstaff,ENG,Newcastle Utd,Premier League,2024,27.0,1997.0,7.9,27,16,10,9,8,18,26,69.2,8,13,2,11,5,32,4,0,MF,25-29,Midfielder,England,Europe
1271,Ademola Lookman,NGA,Atalanta,Serie A,2024,27.0,1997.0,10.4,17,7,8,7,2,7,12,58.3,5,11,0,11,1,18,1,1,"FW,MF",25-29,Forward,Nigeria,Africa
1280,Anthony Losilla,FRA,Bochum,Bundesliga,2024,38.0,1986.0,10.7,25,16,14,10,1,13,26,50.0,13,17,7,10,12,37,18,1,MF,35-39,Midfielder,France,Europe
1281,Jordan Lotomba,SUI,Nice,Ligue 1,2024,26.0,1998.0,0.4,0,0,0,0,0,0,0,,0,0,0,0,0,0,1,0,"MF,DF",25-29,Midfielder,Switzerland,Europe
1282,Tom Louchet,FRA,Nice,Ligue 1,2024,21.0,2003.0,5.3,18,12,12,2,4,12,14,85.7,2,8,3,5,6,24,13,0,"DF,MF",20-24,Defender,France,Europe
1285,Lorenzo Lucca,ITA,Udinese,Serie A,2024,24.0,2000.0,12.3,8,5,2,2,4,4,7,57.1,3,6,0,6,2,10,16,0,FW,20-24,Forward,Italy,Europe
1286,Jhon Lucumí,COL,Bologna,Serie A,2024,26.0,1998.0,11.4,17,10,9,8,0,7,13,53.8,6,15,9,6,7,24,37,1,DF,25-29,Defender,Colombia,South America
1287,Yannik Lührs,GER,Dortmund,Bundesliga,2024,21.0,2003.0,0.4,1,1,1,0,0,0,0,,0,0,0,0,1,2,3,0,DF,20-24,Defender,Germany,Europe
1289,José Luis Palomino,ARG,Cagliari,Serie A,2024,34.0,1990.0,3.2,5,4,0,3,2,2,3,66.7,1,4,4,0,6,11,8,0,DF,30-34,Defender,Argentina,South America
1290,Douglas Luiz,BRA,Juventus,Serie A,2024,26.0,1998.0,3.3,7,3,3,3,1,4,6,66.7,2,3,0,3,2,9,0,0,MF,25-29,Midfielder,Brazil,South America
1291,Romelu Lukaku,BEL,Napoli,Serie A,2024,31.0,1993.0,12.4,1,1,0,1,0,0,2,0.0,2,2,1,1,0,1,8,0,FW,30-34,Forward,Belgium,Europe
1292,Castello Lukeba,FRA,RB Leipzig,Bundesliga,2024,22.0,2002.0,8.1,17,7,7,7,3,6,9,66.7,3,13,6,7,4,21,29,0,DF,20-24,Defender,France,Europe
1293,Dodi Lukebakio,BEL,Sevilla,La Liga,2024,27.0,1997.0,16.1,10,7,3,5,2,5,13,38.5,8,8,0,8,2,12,7,2,FW,25-29,Forward,Belgium,Europe
1296,Joe Lumley,ENG,Southampton,Premier League,2024,29.0,1995.0,3.0,0,0,0,0,0,0,0,,0,0,0,0,0,0,3,3,GK,25-29,Goalkeeper,England,Europe
1297,Daniel Luna,COL,Mallorca,La Liga,2024,21.0,2003.0,0.2,0,0,0,0,0,0,0,,0,1,0,1,0,0,0,0,MF,20-24,Midfielder,Colombia,South America
1298,Andriy Lunin,UKR,Real Madrid,La Liga,2024,25.0,1999.0,3.0,0,0,0,0,0,0,0,,0,0,0,0,0,0,1,0,GK,25-29,Goalkeeper,Ukraine,Europe
1299,Massimo Luongo,AUS,Ipswich Town,Premier League,2024,32.0,1992.0,1.6,5,3,5,0,0,4,6,66.7,2,3,2,1,2,7,2,0,MF,30-34,Midfielder,Australia,Oceania
1300,Sebastiano Luperto,ITA,Cagliari,Serie A,2024,28.0,1996.0,17.0,27,14,18,8,1,8,13,61.5,5,11,7,4,16,43,76,1,DF,25-29,Defender,Italy,Europe
1301,Zito Luvumbo,ANG,Cagliari,Serie A,2024,22.0,2002.0,11.0,5,2,1,3,1,2,10,20.0,8,2,0,2,1,6,4,0,"FW,MF",20-24,Forward,Angola,Africa
1302,Charalambos Lykogiannis,GRE,Bologna,Serie A,2024,31.0,1993.0,4.8,5,2,3,2,0,3,7,42.9,4,1,1,0,4,9,16,0,DF,30-34,Defender,Greece,Europe
1303,Senne Lynen,BEL,Werder Bremen,Bundesliga,2024,25.0,1999.0,13.6,35,18,16,15,4,23,30,76.7,7,25,7,18,26,61,29,5,MF,25-29,Midfielder,Belgium,Europe
1304,Othmane Maamma,MAR,Montpellier,Ligue 1,2024,19.0,2005.0,0.7,0,0,0,0,0,0,1,0.0,1,2,0,2,0,0,1,0,"FW,MF",Under 20,Forward,Morocco,Africa
1305,Ian Maatsen,NED,Aston Villa,Premier League,2024,22.0,2002.0,3.2,11,7,5,5,1,4,6,66.7,2,2,0,2,3,14,7,1,DF,20-24,Defender,Netherlands,Europe
1306,Alexis Mac Allister,ARG,Liverpool,Premier League,2024,26.0,1998.0,11.7,43,28,13,25,5,24,46,52.2,22,29,0,29,8,51,10,1,MF,25-29,Midfielder,Argentina,South America
1307,Deiver Machado,COL,Lens,Ligue 1,2024,31.0,1993.0,6.0,13,10,8,4,1,9,10,90.0,1,7,1,6,5,18,7,0,"DF,MF",30-34,Defender,Colombia,South America
1308,Shuto Machino,JPN,Holstein Kiel,Bundesliga,2024,25.0,1999.0,8.0,4,3,2,1,1,3,6,50.0,3,3,0,3,4,8,3,0,"FW,MF",25-29,Forward,Japan,Asia
1309,Darwin Machís,VEN,Valladolid,La Liga,2024,31.0,1993.0,3.4,3,2,2,1,0,2,6,33.3,4,3,0,3,2,5,7,0,"FW,MF",30-34,Forward,Venezuela,South America
1310,Yvann Macon,FRA,Saint-Étienne,Ligue 1,2024,26.0,1998.0,3.2,4,3,0,3,1,1,5,20.0,4,7,2,5,0,4,6,1,DF,25-29,Defender,France,Europe
1311,James Maddison,ENG,Tottenham,Premier League,2024,28.0,1996.0,12.0,18,11,5,9,4,8,21,38.1,13,8,3,5,10,28,15,0,MF,25-29,Midfielder,England,Europe
1312,Eros Maddy,NED,Auxerre,Ligue 1,2024,23.0,2001.0,0.1,0,0,0,0,0,0,0,,0,0,0,0,0,0,0,0,DF,20-24,Defender,Netherlands,Europe
1313,Noni Madueke,ENG,Chelsea,Premier League,2024,22.0,2002.0,11.5,14,10,6,7,1,9,21,42.9,12,11,0,11,5,19,5,0,FW,20-24,Forward,England,Europe
1315,Gabriel Magalhães,BRA,Arsenal,Premier League,2024,27.0,1997.0,14.1,11,7,5,5,1,5,9,55.6,4,28,20,8,8,19,44,2,DF,25-29,Defender,Brazil,South America
1316,Soungoutou Magassa,FRA,Monaco,Ligue 1,2024,21.0,2003.0,7.3,26,14,6,18,2,15,27,55.6,12,6,1,5,13,39,12,1,MF,20-24,Midfielder,France,Europe
1317,Edmond-Paris Maghoma,ENG,Brentford,Premier League,2024,23.0,2001.0,0.6,1,0,0,1,0,1,2,50.0,1,1,1,0,1,2,1,0,MF,20-24,Midfielder,England,Europe
1318,Giangiacomo Magnani,ITA,Hellas Verona,Serie A,2024,29.0,1995.0,10.4,20,15,14,6,0,7,7,100.0,0,16,9,7,13,33,60,1,DF,25-29,Defender,Italy,Europe
1319,Hugo Magnetti,FRA,Brest,Ligue 1,2024,26.0,1998.0,11.3,20,12,7,12,1,8,19,42.1,11,9,3,6,7,27,11,0,MF,25-29,Midfielder,France,Europe
1320,Frank Magri,CMR,Toulouse,Ligue 1,2024,25.0,1999.0,3.9,1,0,0,0,1,1,4,25.0,3,8,0,8,1,2,4,0,"FW,MF",25-29,Forward,Cameroon,Africa
1321,Harry Maguire,ENG,Manchester Utd,Premier League,2024,31.0,1993.0,6.0,8,5,5,3,0,5,6,83.3,1,4,3,1,14,22,16,1,DF,30-34,Defender,England,Europe
1323,Arne Maier,GER,Augsburg,Bundesliga,2024,25.0,1999.0,5.1,6,2,1,5,0,4,8,50.0,4,9,1,8,1,7,6,1,MF,25-29,Midfielder,Germany,Europe
1324,Mike Maignan,FRA,Milan,Serie A,2024,29.0,1995.0,16.0,0,0,0,0,0,0,0,,0,0,0,0,0,0,8,1,GK,25-29,Goalkeeper,France,Europe
1325,Patrick Mainka,GER,Heidenheim,Bundesliga,2024,30.0,1994.0,15.0,31,16,17,14,0,18,29,62.1,11,30,16,14,32,63,73,0,DF,30-34,Defender,Germany,Europe
1326,Kobbie Mainoo,ENG,Manchester Utd,Premier League,2024,19.0,2005.0,10.1,23,17,13,6,4,14,21,66.7,7,11,2,9,15,38,5,1,MF,Under 20,Midfielder,England,Europe
1327,Ainsley Maitland-Niles,ENG,Lyon,Ligue 1,2024,27.0,1997.0,11.4,36,21,15,12,9,24,35,68.6,11,17,2,15,15,51,26,4,"DF,MF",25-29,Defender,England,Europe
1329,Lovro Majer,CRO,Wolfsburg,Bundesliga,2024,26.0,1998.0,1.6,0,0,0,0,0,0,2,0.0,2,2,0,2,0,0,1,0,MF,25-29,Midfielder,Croatia,Europe
1330,Jordy Makengo,FRA,Freiburg,Bundesliga,2024,23.0,2001.0,0.8,5,3,4,1,0,3,3,100.0,0,0,0,0,0,5,5,0,"DF,MF",20-24,Defender,France,Europe
1331,Antoine Makoumbou,CGO,Cagliari,Serie A,2024,26.0,1998.0,9.4,17,9,9,6,2,9,12,75.0,3,11,2,9,6,23,7,0,MF,25-29,Midfielder,Congo,Africa
1333,Tyrell Malacia,NED,Manchester Utd,Premier League,2024,25.0,1999.0,1.0,1,0,1,0,0,0,1,0.0,1,0,0,0,1,2,0,1,DF,25-29,Defender,Netherlands,Europe
1334,Julián Malatini,ARG,Werder Bremen,Bundesliga,2024,23.0,2001.0,4.8,10,9,4,5,1,4,10,40.0,6,6,3,3,7,17,16,0,DF,20-24,Defender,Argentina,South America
1335,Daniel Maldini,ITA,Monza,Serie A,2024,23.0,2001.0,11.0,14,6,5,9,0,6,10,60.0,4,7,2,5,4,18,10,2,MF,20-24,Midfielder,Italy,Europe
1336,Youssef Maleh,MAR,Empoli,Serie A,2024,26.0,1998.0,9.7,16,8,6,8,2,5,15,33.3,10,18,5,13,7,23,13,0,MF,25-29,Midfielder,Morocco,Africa
1337,Donyell Malen,NED,Dortmund,Bundesliga,2024,25.0,1999.0,6.7,0,0,0,0,0,0,2,0.0,2,2,0,2,3,3,6,0,"FW,MF",25-29,Forward,Netherlands,Europe
1338,Ruslan Malinovskyi,UKR,Genoa,Serie A,2024,31.0,1993.0,2.5,8,6,2,5,1,2,3,66.7,1,1,0,1,1,9,3,0,"MF,FW",30-34,Midfielder,Ukraine,Europe
1339,Lennard Maloney,USA,Heidenheim,Bundesliga,2024,25.0,1999.0,8.4,20,11,12,7,1,14,23,60.9,9,9,2,7,14,34,38,0,MF,25-29,Midfielder,United States,North America
1340,Giorgi Mamardashvili,GEO,Valencia,La Liga,2024,24.0,2000.0,14.0,0,0,0,0,0,0,0,,0,0,0,0,0,0,4,0,GK,20-24,Goalkeeper,Georgia,Asia
1341,Dennis Man,ROU,Parma,Serie A,2024,26.0,1998.0,14.9,6,3,3,1,2,4,15,26.7,11,8,2,6,8,14,8,0,"FW,MF",25-29,Forward,Romania,Europe
1342,Hianga Mananga Mbock,FRA,Brest,Ligue 1,2024,24.0,1999.0,0.2,0,0,0,0,0,0,0,,0,0,0,0,1,1,0,0,MF,20-24,Midfielder,France,Europe
1343,Gianluca Mancini,ITA,Roma,Serie A,2024,28.0,1996.0,15.4,19,11,11,6,2,11,13,84.6,2,9,6,3,17,36,28,0,DF,25-29,Defender,Italy,Europe
1344,Steve Mandanda,FRA,Rennes,Ligue 1,2024,39.0,1985.0,14.5,0,0,0,0,0,0,1,0.0,1,0,0,0,0,0,5,1,GK,35-39,Goalkeeper,France,Europe
1345,Reinildo Mandava,MOZ,Atlético Madrid,La Liga,2024,30.0,1994.0,7.2,16,10,8,7,1,9,16,56.3,7,7,3,4,10,26,25,0,DF,30-34,Defender,Mozambique,Africa
1346,Aïssa Mandi,ALG,Lille,Ligue 1,2024,33.0,1991.0,9.5,16,9,4,10,2,9,13,69.2,4,13,8,5,6,22,21,0,DF,30-34,Defender,Algeria,Africa
1347,Rolando Mandragora,ITA,Fiorentina,Serie A,2024,27.0,1997.0,3.7,2,0,1,0,1,0,2,0.0,2,4,1,3,6,8,6,1,MF,25-29,Midfielder,Italy,Europe
1348,Orel Mangala,BEL,Everton,Premier League,2024,26.0,1998.0,8.5,12,5,1,10,1,4,6,66.7,2,4,1,3,14,26,11,0,MF,25-29,Midfielder,Belgium,Europe
1349,Orel Mangala,BEL,Lyon,Ligue 1,2024,26.0,1998.0,0.7,1,0,0,0,1,0,1,0.0,1,2,0,2,0,1,1,0,MF,25-29,Midfielder,Belgium,Europe
1350,Ryan Manning,IRL,Southampton,Premier League,2024,28.0,1996.0,7.3,15,10,7,6,2,8,14,57.1,6,11,7,4,8,23,13,0,DF,25-29,Defender,Republic of Ireland,Europe
1352,Johan Manzambi,SUI,Freiburg,Bundesliga,2024,19.0,2005.0,0.1,0,0,0,0,0,0,0,,0,0,0,0,0,0,0,0,FW,Under 20,Forward,Switzerland,Europe
1353,Alberto Manzoni,ITA,Atalanta,Serie A,2024,19.0,2005.0,0.1,0,0,0,0,0,0,0,,0,0,0,0,0,0,0,0,MF,Under 20,Midfielder,Italy,Europe
1354,Sekou Mara,FRA,Strasbourg,Ligue 1,2024,22.0,2002.0,6.5,8,5,0,4,4,2,7,28.6,5,6,0,6,3,11,2,0,"FW,MF",20-24,Forward,France,Europe
1355,Alessandro Marcandalli,ITA,Genoa,Serie A,2024,22.0,2002.0,0.5,1,0,1,0,0,0,0,,0,0,0,0,0,1,2,0,DF,20-24,Defender,Italy,Europe
1356,Marcão,BRA,Sevilla,La Liga,2024,28.0,1996.0,5.1,9,6,6,3,0,2,3,66.7,1,9,6,3,6,15,26,1,DF,25-29,Defender,Brazil,South America
1356,Marcão,BRA,Sevilla,La Liga,2024,28.0,1996.0,5.1,9,6,6,3,0,2,3,66.7,1,9,6,3,6,15,26,1,DF,25-29,Defender,Brazil,South America
1356,Marcão,BRA,Sevilla,La Liga,2024,28.0,1996.0,5.1,9,6,6,3,0,2,3,66.7,1,9,6,3,6,15,26,1,DF,25-29,Defender,Brazil,South America
1356,Marcão,BRA,Sevilla,La Liga,2024,28.0,1996.0,5.1,9,6,6,3,0,2,3,66.7,1,9,6,3,6,15,26,1,DF,25-29,Defender,Brazil,South America
1356,Marcão,BRA,Sevilla,La Liga,2024,28.0,1996.0,5.1,9,6,6,3,0,2,3,66.7,1,9,6,3,6,15,26,1,DF,25-29,Defender,Brazil,South America
1356,Marcão,BRA,Sevilla,La Liga,2024,28.0,1996.0,5.1,9,6,6,3,0,2,3,66.7,1,9,6,3,6,15,26,1,DF,25-29,Defender,Brazil,South America
1356,Marcão,BRA,Sevilla,La Liga,2024,28.0,1996.0,5.1,9,6,6,3,0,2,3,66.7,1,9,6,3,6,15,26,1,DF,25-29,Defender,Brazil,South America
1356,Marcão,BRA,Sevilla,La Liga,2024,28.0,1996.0,5.1,9,6,6,3,0,2,3,66.7,1,9,6,3,6,15,26,1,DF,25-29,Defender,Brazil,South America
1356,Marcão,BRA,Sevilla,La Liga,2024,28.0,1996.0,5.1,9,6,6,3,0,2,3,66.7,1,9,6,3,6,15,26,1,DF,25-29,Defender,Brazil,South America
1356,Marcão,BRA,Sevilla,La Liga,2024,28.0,1996.0,5.1,9,6,6,3,0,2,3,66.7,1,9,6,3,6,15,26,1,DF,25-29,Defender,Brazil,South America
1356,Marcão,BRA,Sevilla,La Liga,2024,28.0,1996.0,5.1,9,6,6,3,0,2,3,66.7,1,9,6,3,6,15,26,1,DF,25-29,Defender,Brazil,South America
1356,Marcão,BRA,Sevilla,La Liga,2024,28.0,1996.0,5.1,9,6,6,3,0,2,3,66.7,1,9,6,3,6,15,26,1,DF,25-29,Defender,Brazil,South America
1356,Marcão,BRA,Sevilla,La Liga,2024,28.0,1996.0,5.1,9,6,6,3,0,2,3,66.7,1,9,6,3,6,15,26,1,DF,25-29,Defender,Brazil,South America
1356,Marcão,BRA,Sevilla,La Liga,2024,28.0,1996.0,5.1,9,6,6,3,0,2,3,66.7,1,9,6,3,6,15,26,1,DF,25-29,Defender,Brazil,South America
1356,Marcão,BRA,Sevilla,La Liga,2024,28.0,1996.0,5.1,9,6,6,3,0,2,3,66.7,1,9,6,3,6,15,26,1,DF,25-29,Defender,Brazil,South America
1356,Marcão,BRA,Sevilla,La Liga,2024,28.0,1996.0,5.1,9,6,6,3,0,2,3,66.7,1,9,6,3,6,15,26,1,DF,25-29,Defender,Brazil,South America
1356,Marcão,BRA,Sevilla,La Liga,2024,28.0,1996.0,5.1,9,6,6,3,0,2,3,66.7,1,9,6,3,6,15,26,1,DF,25-29,Defender,Brazil,South America
1356,Marcão,BRA,Sevilla,La Liga,2024,28.0,1996.0,5.1,9,6,6,3,0,2,3,66.7,1,9,6,3,6,15,26,1,DF,25-29,Defender,Brazil,South America
1356,Marcão,BRA,Sevilla,La Liga,2024,28.0,1996.0,5.1,9,6,6,3,0,2,3,66.7,1,9,6,3,6,15,26,1,DF,25-29,Defender,Brazil,South America
1356,Marcão,BRA,Sevilla,La Liga,2024,28.0,1996.0,5.1,9,6,6,3,0,2,3,66.7,1,9,6,3,6,15,26,1,DF,25-29,Defender,Brazil,South America
1356,Marcão,BRA,Sevilla,La Liga,2024,28.0,1996.0,5.1,9,6,6,3,0,2,3,66.7,1,9,6,3,6,15,26,1,DF,25-29,Defender,Brazil,South America
1356,Marcão,BRA,Sevilla,La Liga,2024,28.0,1996.0,5.1,9,6,6,3,0,2,3,66.7,1,9,6,3,6,15,26,1,DF,25-29,Defender,Brazil,South America
1356,Marcão,BRA,Sevilla,La Liga,2024,28.0,1996.0,5.1,9,6,6,3,0,2,3,66.7,1,9,6,3,6,15,26,1,DF,25-29,Defender,Brazil,South America
1356,Marcão,BRA,Sevilla,La Liga,2024,28.0,1996.0,5.1,9,6,6,3,0,2,3,66.7,1,9,6,3,6,15,26,1,DF,25-29,Defender,Brazil,South America
1356,Marcão,BRA,Sevilla,La Liga,2024,28.0,1996.0,5.1,9,6,6,3,0,2,3,66.7,1,9,6,3,6,15,26,1,DF,25-29,Defender,Brazil,South America
1361,José María Giménez,URU,Atlético Madrid,La Liga,2024,29.0,1995.0,13.9,17,12,12,5,0,12,19,63.2,7,18,12,6,16,33,64,1,DF,25-29,Defender,Uruguay,South America
1362,Luca Marianucci,ITA,Empoli,Serie A,2024,20.0,2004.0,0.5,2,1,2,0,0,1,3,33.3,2,0,0,0,0,2,3,0,"DF,MF",20-24,Defender,Italy,Europe
1363,Mirko Marić,CRO,Monza,Serie A,2024,29.0,1995.0,1.1,1,0,1,0,0,1,2,50.0,1,1,1,0,1,2,1,0,"FW,MF",25-29,Forward,Croatia,Europe
1365,Răzvan Marin,ROU,Cagliari,Serie A,2024,28.0,1996.0,10.2,14,8,5,8,1,8,16,50.0,8,4,0,4,2,16,15,2,MF,25-29,Midfielder,Romania,Europe
1366,Guillermo Maripán,CHI,Torino,Serie A,2024,30.0,1994.0,5.0,9,3,5,3,1,5,7,71.4,2,3,0,3,8,17,27,0,DF,30-34,Defender,Chile,South America
1368,Omar Marmoush,EGY,Eint Frankfurt,Bundesliga,2024,25.0,1999.0,14.1,11,7,0,3,8,3,7,42.9,4,7,1,6,2,13,2,0,"FW,MF",25-29,Forward,Egypt,Africa
1370,Marquinhos,BRA,Paris S-G,Ligue 1,2024,30.0,1994.0,11.3,18,12,6,8,4,14,18,77.8,4,15,6,9,7,25,34,0,DF,30-34,Defender,Brazil,South America
1370,Marquinhos,BRA,Paris S-G,Ligue 1,2024,30.0,1994.0,11.3,18,12,6,8,4,14,18,77.8,4,15,6,9,7,25,34,0,DF,30-34,Defender,Brazil,South America
1370,Marquinhos,BRA,Paris S-G,Ligue 1,2024,30.0,1994.0,11.3,18,12,6,8,4,14,18,77.8,4,15,6,9,7,25,34,0,DF,30-34,Defender,Brazil,South America
1370,Marquinhos,BRA,Paris S-G,Ligue 1,2024,30.0,1994.0,11.3,18,12,6,8,4,14,18,77.8,4,15,6,9,7,25,34,0,DF,30-34,Defender,Brazil,South America
1370,Marquinhos,BRA,Paris S-G,Ligue 1,2024,30.0,1994.0,11.3,18,12,6,8,4,14,18,77.8,4,15,6,9,7,25,34,0,DF,30-34,Defender,Brazil,South America
1370,Marquinhos,BRA,Paris S-G,Ligue 1,2024,30.0,1994.0,11.3,18,12,6,8,4,14,18,77.8,4,15,6,9,7,25,34,0,DF,30-34,Defender,Brazil,South America
1370,Marquinhos,BRA,Paris S-G,Ligue 1,2024,30.0,1994.0,11.3,18,12,6,8,4,14,18,77.8,4,15,6,9,7,25,34,0,DF,30-34,Defender,Brazil,South America
1370,Marquinhos,BRA,Paris S-G,Ligue 1,2024,30.0,1994.0,11.3,18,12,6,8,4,14,18,77.8,4,15,6,9,7,25,34,0,DF,30-34,Defender,Brazil,South America
1370,Marquinhos,BRA,Paris S-G,Ligue 1,2024,30.0,1994.0,11.3,18,12,6,8,4,14,18,77.8,4,15,6,9,7,25,34,0,DF,30-34,Defender,Brazil,South America
1376,Jonas Martin,FRA,Brest,Ligue 1,2024,34.0,1990.0,5.1,11,5,8,2,1,5,10,50.0,5,3,0,3,6,17,11,1,MF,30-34,Midfielder,France,Europe
1378,Gabriel Martinelli,BRA,Arsenal,Premier League,2024,23.0,2001.0,10.5,12,10,2,4,6,5,14,35.7,9,4,0,4,1,13,10,0,"FW,MF",20-24,Forward,Brazil,South America
1380,Emiliano Martínez,ARG,Aston Villa,Premier League,2024,32.0,1992.0,16.5,1,1,1,0,0,0,0,,0,0,0,0,0,1,10,4,GK,30-34,Goalkeeper,Argentina,South America
1380,Emiliano Martínez,ARG,Aston Villa,Premier League,2024,32.0,1992.0,16.5,1,1,1,0,0,0,0,,0,0,0,0,0,1,10,4,GK,30-34,Goalkeeper,Argentina,South America
1380,Emiliano Martínez,ARG,Aston Villa,Premier League,2024,32.0,1992.0,16.5,1,1,1,0,0,0,0,,0,0,0,0,0,1,10,4,GK,30-34,Goalkeeper,Argentina,South America
1380,Emiliano Martínez,ARG,Aston Villa,Premier League,2024,32.0,1992.0,16.5,1,1,1,0,0,0,0,,0,0,0,0,0,1,10,4,GK,30-34,Goalkeeper,Argentina,South America
1383,Lautaro Martínez,ARG,Inter,Serie A,2024,27.0,1997.0,12.9,9,5,3,3,3,4,9,44.4,5,7,1,6,5,14,3,0,FW,25-29,Forward,Argentina,South America
1384,Lisandro Martínez,ARG,Manchester Utd,Premier League,2024,26.0,1998.0,13.8,29,17,18,8,3,15,26,57.7,11,16,5,11,26,55,39,1,DF,25-29,Defender,Argentina,South America
1385,Lucas Martínez Quarta,ARG,Fiorentina,Serie A,2024,28.0,1996.0,3.9,12,7,9,3,0,8,13,61.5,5,5,2,3,3,15,25,1,DF,25-29,Defender,Argentina,South America
1387,Kevin Martins,ITA,Monza,Serie A,2024,19.0,2005.0,0.0,0,0,0,0,0,0,0,,0,0,0,0,0,0,0,0,DF,Under 20,Defender,Italy,Europe
1389,Adam Marušić,MNE,Lazio,Serie A,2024,32.0,1992.0,9.5,15,8,9,6,0,7,13,53.8,6,5,2,3,5,20,23,0,DF,30-34,Defender,Montenegro,Europe
1391,Omar Mascarell,EQG,Mallorca,La Liga,2024,31.0,1993.0,10.1,15,7,8,7,0,9,16,56.3,7,16,10,6,25,40,37,2,MF,30-34,Midfielder,Equatorial Guinea,Africa
1392,Adam Masina,MAR,Torino,Serie A,2024,30.0,1994.0,15.5,25,11,18,6,1,18,33,54.5,15,21,13,8,18,43,58,2,DF,30-34,Defender,Morocco,Africa
1393,Patrizio Masini,ITA,Genoa,Serie A,2024,23.0,2001.0,0.9,6,3,2,4,0,1,1,100.0,0,4,0,4,0,6,4,0,"MF,FW",20-24,Midfielder,Italy,Europe
1395,Clinton Mata,ANG,Lyon,Ligue 1,2024,32.0,1992.0,11.1,20,12,11,8,1,16,19,84.2,3,10,6,4,18,38,22,2,DF,30-34,Defender,Angola,Africa
1397,Igor Matanovic,CRO,Eint Frankfurt,Bundesliga,2024,21.0,2003.0,3.2,1,0,0,1,0,0,1,0.0,1,2,0,2,1,2,7,0,"FW,MF",20-24,Forward,Croatia,Europe
1398,Pape Matar Sarr,SEN,Tottenham,Premier League,2024,22.0,2002.0,10.1,29,21,11,16,2,6,13,46.2,7,15,3,12,16,45,11,0,MF,20-24,Midfielder,Senegal,Africa
1399,Eliot Matazo,BEL,Monaco,Ligue 1,2024,22.0,2002.0,0.8,3,2,0,3,0,0,0,,0,0,0,0,1,4,2,0,MF,20-24,Midfielder,Belgium,Europe
1400,Jean-Philippe Mateta,FRA,Crystal Palace,Premier League,2024,27.0,1997.0,13.9,7,6,2,4,1,0,6,0.0,6,7,1,6,1,8,13,0,FW,25-29,Forward,France,Europe
1402,Chrislain Matsima,FRA,Augsburg,Bundesliga,2024,22.0,2002.0,9.5,4,3,4,0,0,2,6,33.3,4,19,11,8,21,25,44,0,DF,20-24,Defender,France,Europe
1403,Jean Mattéo Bahoya,FRA,Eint Frankfurt,Bundesliga,2024,19.0,2005.0,2.4,7,7,5,2,0,4,8,50.0,4,1,0,1,1,8,3,0,"MF,DF",Under 20,Midfielder,France,Europe
1404,Alan Matturro,URU,Genoa,Serie A,2024,20.0,2004.0,7.2,9,4,4,5,0,3,12,25.0,9,5,2,3,11,20,25,0,DF,20-24,Defender,Uruguay,South America
1405,Azor Matusiwa,NED,Rennes,Ligue 1,2024,26.0,1998.0,12.2,38,21,18,19,1,21,27,77.8,6,15,5,10,17,55,25,0,MF,25-29,Midfielder,Netherlands,Europe
1406,Neal Maupay,FRA,Marseille,Ligue 1,2024,28.0,1996.0,6.7,7,3,1,5,1,3,3,100.0,0,4,0,4,0,7,0,0,FW,25-29,Forward,France,Europe
1407,Maurides,BRA,St. Pauli,Bundesliga,2024,30.0,1994.0,0.0,0,0,0,0,0,0,0,,0,0,0,0,0,0,0,0,FW,30-34,Forward,Brazil,South America
1408,Stephy Mavididi,ENG,Leicester City,Premier League,2024,26.0,1998.0,9.4,20,13,9,7,4,9,23,39.1,14,16,1,15,2,22,4,0,FW,25-29,Forward,England,Europe
1409,Konstantinos Mavropanos,GRE,West Ham,Premier League,2024,27.0,1997.0,11.1,21,15,16,4,1,11,15,73.3,4,16,12,4,20,41,50,1,DF,25-29,Defender,Greece,Europe
1410,Christian Mawissa,FRA,Monaco,Ligue 1,2024,19.0,2005.0,5.2,18,11,8,8,2,13,20,65.0,7,10,1,9,13,31,6,0,DF,Under 20,Defender,France,Europe
1411,Keke Maximilian Topp,GER,Werder Bremen,Bundesliga,2024,20.0,2004.0,2.2,2,1,0,1,1,1,2,50.0,1,0,0,0,1,3,1,0,"FW,MF",20-24,Forward,Germany,Europe
1413,Senny Mayulu,FRA,Paris S-G,Ligue 1,2024,18.0,2006.0,2.1,9,5,4,4,1,3,6,50.0,3,5,3,2,2,11,3,0,"MF,DF",Under 20,Midfielder,France,Europe
1414,Noussair Mazraoui,MAR,Manchester Utd,Premier League,2024,27.0,1997.0,13.9,55,32,29,17,9,32,49,65.3,17,19,4,15,14,69,41,0,DF,25-29,Defender,Morocco,Africa
1415,Luca Mazzitelli,ITA,Como,Serie A,2024,29.0,1995.0,3.7,9,6,4,5,0,5,7,71.4,2,5,2,3,3,12,10,0,MF,25-29,Midfielder,Italy,Europe
1416,Pasquale Mazzocchi,ITA,Napoli,Serie A,2024,29.0,1995.0,4.3,5,2,3,1,1,2,6,33.3,4,3,1,2,3,8,12,0,"DF,FW",25-29,Defender,Italy,Europe
1417,Samuel Mbangula,BEL,Juventus,Serie A,2024,20.0,2004.0,4.0,11,8,7,3,1,5,8,62.5,3,4,0,4,1,12,2,0,FW,20-24,Forward,Belgium,Europe
1418,Ethan Mbappé,FRA,Lille,Ligue 1,2024,17.0,2006.0,0.9,1,0,0,1,0,0,2,0.0,2,4,0,4,0,1,0,0,"MF,FW",Under 20,Midfielder,France,Europe
1419,Kylian Mbappé,FRA,Real Madrid,La Liga,2024,26.0,1998.0,15.2,2,2,0,2,0,0,0,,0,2,0,2,0,2,0,0,FW,25-29,Forward,France,Europe
1420,Ibrahim Mbaye,FRA,Paris S-G,Ligue 1,2024,16.0,2008.0,1.0,0,0,0,0,0,0,3,0.0,3,0,0,0,0,0,0,0,"FW,MF",Under 20,Forward,France,Europe
1421,Bryan Mbeumo,CMR,Brentford,Premier League,2024,25.0,1999.0,16.9,21,12,7,7,7,9,13,69.2,4,12,2,10,7,28,24,0,FW,25-29,Forward,Cameroon,Africa
1422,James Mcatee,ENG,Manchester City,Premier League,2024,22.0,2002.0,0.0,0,0,0,0,0,0,0,,0,1,0,1,0,0,0,0,"FW,MF",20-24,Forward,England,Europe
1423,Kasey McAteer,IRL,Leicester City,Premier League,2024,23.0,2001.0,3.7,10,7,6,3,1,5,12,41.7,7,7,1,6,1,11,8,0,"FW,MF",20-24,Forward,Republic of Ireland,Europe
1424,Oliver McBurnie,SCO,Las Palmas,La Liga,2024,28.0,1996.0,8.1,6,4,2,3,1,2,5,40.0,3,4,1,3,4,10,9,0,FW,25-29,Forward,Scotland,Europe
1425,Alex McCarthy,ENG,Southampton,Premier League,2024,35.0,1989.0,4.0,0,0,0,0,0,0,0,,0,0,0,0,0,0,1,4,GK,35-39,Goalkeeper,England,Europe
1426,John McGinn,SCO,Aston Villa,Premier League,2024,30.0,1994.0,11.9,15,10,4,8,3,4,10,40.0,6,9,0,9,4,19,3,0,"FW,MF",30-34,Forward,Scotland,Europe
1427,Scott McKenna,SCO,Las Palmas,La Liga,2024,28.0,1996.0,13.1,10,7,8,2,0,4,5,80.0,1,21,16,5,5,15,76,2,DF,25-29,Defender,Scotland,Europe
1428,Weston McKennie,USA,Juventus,Serie A,2024,26.0,1998.0,7.0,8,3,3,5,0,2,4,50.0,2,7,1,6,6,14,3,0,"MF,DF",25-29,Midfielder,United States,North America
1429,Mark McKenzie,USA,Toulouse,Ligue 1,2024,25.0,1999.0,12.7,21,14,12,9,0,14,21,66.7,7,14,10,4,10,31,52,0,DF,25-29,Defender,United States,North America
1430,Dwight McNeil,ENG,Everton,Premier League,2024,25.0,1999.0,12.7,10,6,5,3,2,7,16,43.8,9,7,0,7,5,15,1,1,"MF,FW",25-29,Midfielder,England,Europe
1431,Scott McTominay,SCO,Manchester Utd,Premier League,2024,28.0,1996.0,0.2,0,0,0,0,0,0,1,0.0,1,0,0,0,0,0,1,0,MF,25-29,Midfielder,Scotland,Europe
1432,Scott McTominay,SCO,Napoli,Serie A,2024,28.0,1996.0,13.1,19,11,5,12,2,11,22,50.0,11,7,0,7,13,32,15,0,MF,25-29,Midfielder,Scotland,Europe
1433,Jakov Medić,CRO,Bochum,Bundesliga,2024,26.0,1998.0,10.2,7,6,4,2,1,4,8,50.0,4,23,15,8,12,19,53,2,DF,25-29,Defender,Croatia,Europe
1434,Facundo Medina,ARG,Lens,Ligue 1,2024,25.0,1999.0,13.7,28,19,14,12,2,13,21,61.9,8,13,4,9,18,46,30,0,"DF,MF",25-29,Defender,Argentina,South America
1435,Ben Mee,ENG,Brentford,Premier League,2024,35.0,1989.0,1.1,2,2,0,2,0,1,1,100.0,0,1,1,0,3,5,3,0,DF,35-39,Defender,England,Europe
1436,Jayden Meghoma,ENG,Brentford,Premier League,2024,18.0,2006.0,0.1,0,0,0,0,0,0,0,,0,0,0,0,0,0,0,0,DF,Under 20,Defender,England,Europe
1437,Henrik Meister,DEN,Rennes,Ligue 1,2024,21.0,2003.0,0.7,2,0,0,2,0,0,0,,0,4,0,4,1,3,0,0,FW,20-24,Forward,Denmark,Europe
1438,Bamo Meïté,CIV,Marseille,Ligue 1,2024,23.0,2001.0,0.3,0,0,0,0,0,0,0,,0,0,0,0,0,0,1,0,"DF,MF",20-24,Defender,Ivory Coast,Africa
1439,Mohamed Meité,FRA,Rennes,Ligue 1,2024,17.0,2007.0,0.1,0,0,0,0,0,0,0,,0,0,0,0,0,0,0,0,FW,Under 20,Forward,France,Europe
1441,Farid El Melali,ALG,Angers,Ligue 1,2024,27.0,1997.0,10.5,18,8,8,5,5,7,21,33.3,14,9,1,8,7,25,8,1,FW,25-29,Forward,Algeria,Africa
1442,Filippo Melegoni,ITA,Genoa,Serie A,2024,25.0,1999.0,1.0,1,1,1,0,0,0,4,0.0,4,0,0,0,0,1,2,0,"MF,FW",25-29,Midfielder,Italy,Europe
1443,Nuno Mendes,POR,Paris S-G,Ligue 1,2024,22.0,2002.0,7.0,13,9,5,7,1,9,15,60.0,6,10,5,5,5,18,12,0,DF,20-24,Defender,Portugal,Europe
1445,Antoine Mendy,FRA,Nice,Ligue 1,2024,20.0,2004.0,4.5,19,13,10,9,0,12,18,66.7,6,6,2,4,4,23,15,0,DF,20-24,Defender,France,Europe
1446,Ferland Mendy,FRA,Real Madrid,La Liga,2024,29.0,1995.0,8.5,15,12,6,5,4,8,11,72.7,3,10,3,7,9,24,6,1,DF,25-29,Defender,France,Europe
1447,Nampalys Mendy,SEN,Lens,Ligue 1,2024,32.0,1992.0,1.2,4,2,3,1,0,2,5,40.0,3,2,1,1,1,5,0,0,MF,30-34,Midfielder,Senegal,Africa
1448,Gideon Mensah,GHA,Auxerre,Ligue 1,2024,26.0,1998.0,9.3,26,17,16,7,3,13,28,46.4,15,7,1,6,21,47,27,0,DF,25-29,Defender,Ghana,Africa
1449,Alex Meret,ITA,Napoli,Serie A,2024,27.0,1997.0,13.4,0,0,0,0,0,0,0,,0,1,0,1,0,0,6,0,GK,25-29,Goalkeeper,Italy,Europe
1451,Quentin Merlin,FRA,Marseille,Ligue 1,2024,22.0,2002.0,6.2,6,5,4,1,1,2,6,33.3,4,3,1,2,7,13,6,1,"DF,MF",20-24,Defender,France,Europe
1453,Rafik Messali,FRA,Toulouse,Ligue 1,2024,21.0,2003.0,0.0,0,0,0,0,0,0,0,,0,0,0,0,0,0,0,0,MF,20-24,Midfielder,France,Europe
1454,Junior Messias,BRA,Genoa,Serie A,2024,33.0,1991.0,3.4,4,1,3,1,0,1,2,50.0,1,1,1,0,4,8,7,0,"MF,FW",30-34,Midfielder,Brazil,South America
1455,Connor Metcalfe,AUS,St. Pauli,Bundesliga,2024,25.0,1999.0,2.5,1,0,0,1,0,0,3,0.0,3,3,0,3,2,3,4,0,MF,25-29,Midfielder,Australia,Oceania
1456,Karol Mets,EST,St. Pauli,Bundesliga,2024,31.0,1993.0,10.0,13,8,6,7,0,4,7,57.1,3,9,3,6,12,25,60,0,DF,30-34,Defender,Estonia,Europe
1457,Thomas Meunier,BEL,Lille,Ligue 1,2024,33.0,1991.0,6.9,14,10,10,3,1,8,13,61.5,5,9,3,6,12,26,24,0,DF,30-34,Defender,Belgium,Europe
1458,Alexander Meyer,GER,Dortmund,Bundesliga,2024,33.0,1991.0,2.0,0,0,0,0,0,0,0,,0,0,0,0,0,0,0,0,GK,30-34,Goalkeeper,Germany,Europe
1459,Florian Micheler,AUT,Hoffenheim,Bundesliga,2024,19.0,2005.0,0.4,0,0,0,0,0,0,2,0.0,2,0,0,0,0,0,0,0,MF,Under 20,Midfielder,Austria,Europe
1461,Valentin Mihaila,ROU,Parma,Serie A,2024,24.0,2000.0,9.2,24,12,7,11,6,7,14,50.0,7,13,0,13,3,27,3,0,"FW,MF",20-24,Forward,Romania,Europe
1462,Georges Mikautadze,GEO,Lyon,Ligue 1,2024,24.0,2000.0,6.4,5,4,1,2,2,2,5,40.0,3,2,0,2,1,6,0,0,FW,20-24,Forward,Georgia,Asia
1464,Lewis Miley,ENG,Newcastle Utd,Premier League,2024,18.0,2006.0,0.1,0,0,0,0,0,0,0,,0,0,0,0,0,0,0,0,MF,Under 20,Midfielder,England,Europe
1466,Éder Militão,BRA,Real Madrid,La Liga,2024,26.0,1998.0,10.4,19,17,14,5,0,7,12,58.3,5,13,8,5,12,31,35,0,DF,25-29,Defender,Brazil,South America
1469,Enzo Millot,FRA,Stuttgart,Bundesliga,2024,22.0,2002.0,11.4,16,9,7,7,2,6,20,30.0,14,15,0,15,7,23,2,1,"MF,FW",20-24,Midfielder,France,Europe
1470,James Milner,ENG,Brighton,Premier League,2024,38.0,1986.0,1.9,5,2,1,3,1,3,3,100.0,0,4,2,2,2,7,2,1,MF,35-39,Midfielder,England,Europe
1471,Kim Min-jae,KOR,Bayern Munich,Bundesliga,2024,28.0,1996.0,14.3,19,10,8,8,3,3,10,30.0,7,14,7,7,21,40,41,2,DF,25-29,Defender,South Korea,Asia
1472,Yerry Mina,COL,Cagliari,Serie A,2024,30.0,1994.0,12.9,28,11,18,9,1,20,26,76.9,6,30,18,12,13,41,68,2,DF,30-34,Defender,Colombia,South America
1473,Takumi Minamino,JPN,Monaco,Ligue 1,2024,29.0,1995.0,10.7,11,6,2,5,4,3,13,23.1,10,9,1,8,4,15,8,0,"MF,FW",25-29,Midfielder,Japan,Asia
1474,Lucas Mincarelli,FRA,Montpellier,Ligue 1,2024,20.0,2004.0,2.8,4,4,1,2,1,1,5,20.0,4,1,1,0,1,5,8,0,DF,20-24,Defender,France,Europe
1475,Tyrone Mings,ENG,Aston Villa,Premier League,2024,31.0,1993.0,1.0,1,1,1,0,0,0,0,,0,1,1,0,0,1,6,0,DF,30-34,Defender,England,Europe
1477,Kim Minsu,KOR,Girona,La Liga,2024,18.0,2006.0,0.2,1,0,0,1,0,0,0,,0,0,0,0,0,1,0,0,"MF,FW",Under 20,Midfielder,South Korea,Asia
1478,Yankuba Minteh,GAM,Brighton,Premier League,2024,20.0,2004.0,5.9,9,5,2,1,6,4,12,33.3,8,10,0,10,3,12,5,0,"FW,MF",20-24,Forward,Gambia,Africa
1479,Bojan Miovski,MKD,Girona,La Liga,2024,25.0,1999.0,7.1,6,4,1,2,3,2,7,28.6,5,4,0,4,2,8,7,0,FW,25-29,Forward,North Macedonia,Europe
1482,Fabio Miretti,ITA,Genoa,Serie A,2024,21.0,2003.0,8.0,17,9,5,6,6,12,19,63.2,7,7,1,6,5,22,5,0,"MF,FW",20-24,Midfielder,Italy,Europe
1483,Tyrick Mitchell,ENG,Crystal Palace,Premier League,2024,25.0,1999.0,16.4,45,31,30,12,3,10,23,43.5,13,35,5,30,7,52,43,1,DF,25-29,Defender,England,Europe
1484,Kaoru Mitoma,JPN,Brighton,Premier League,2024,27.0,1997.0,16.1,24,16,7,9,8,12,32,37.5,20,25,2,23,8,32,3,0,"FW,MF",25-29,Forward,Japan,Asia
1485,Maximilian Mittelstädt,GER,Stuttgart,Bundesliga,2024,27.0,1997.0,13.0,30,22,20,9,1,22,33,66.7,11,19,8,11,16,46,38,1,DF,25-29,Defender,Germany,Europe
1486,Koji Miyoshi,JPN,Bochum,Bundesliga,2024,27.0,1997.0,3.8,5,4,0,1,4,3,7,42.9,4,8,1,7,2,7,2,0,"MF,FW",25-29,Midfielder,Japan,Asia
1487,Henrikh Mkhitaryan,ARM,Inter,Serie A,2024,35.0,1989.0,14.6,23,14,7,10,6,10,21,47.6,11,10,2,8,11,34,16,0,MF,35-39,Midfielder,Armenia,Asia
1489,Rui Modesto,ANG,Udinese,Serie A,2024,25.0,1999.0,0.4,1,1,0,1,0,1,1,100.0,0,0,0,0,1,2,2,0,DF,25-29,Defender,Angola,Africa
1490,Luka Modrić,CRO,Real Madrid,La Liga,2024,39.0,1985.0,9.2,8,4,5,2,1,6,13,46.2,7,6,1,5,10,18,8,0,MF,35-39,Midfielder,Croatia,Europe
1491,Max Moerstedt,GER,Hoffenheim,Bundesliga,2024,18.0,2006.0,1.9,3,3,1,2,0,1,1,100.0,0,1,0,1,0,3,3,0,FW,Unknown,Forward,Germany,Europe
1492,Mostafa Mohamed,EGY,Nantes,Ligue 1,2024,27.0,1997.0,5.4,8,5,3,4,1,2,7,28.6,5,2,0,2,2,10,10,0,FW,25-29,Forward,Egypt,Africa
1493,Johan Mojica,COL,Mallorca,La Liga,2024,32.0,1992.0,15.5,18,12,13,2,3,10,17,58.8,7,4,2,2,17,35,42,1,DF,30-34,Defender,Colombia,South America
1495,Nahuel Molina,ARG,Atlético Madrid,La Liga,2024,26.0,1998.0,8.5,19,9,10,9,0,14,29,48.3,15,8,0,8,7,26,23,0,DF,25-29,Defender,Argentina,South America
1496,Florent Mollet,FRA,Nantes,Ligue 1,2024,33.0,1991.0,1.8,1,1,1,0,0,1,1,100.0,0,2,0,2,1,2,2,0,"MF,FW",30-34,Midfielder,France,Europe
1498,Gonzalo Montiel,ARG,Sevilla,La Liga,2024,27.0,1997.0,1.3,4,2,3,1,0,3,4,75.0,1,0,0,0,2,6,11,0,"DF,MF",25-29,Defender,Argentina,South America
1499,Lorenzo Montipò,ITA,Hellas Verona,Serie A,2024,28.0,1996.0,16.0,1,0,1,0,0,1,3,33.3,2,0,0,0,0,1,8,2,GK,25-29,Goalkeeper,Italy,Europe
1500,Mikey Moore,ENG,Tottenham,Premier League,2024,17.0,2007.0,0.9,0,0,0,0,0,0,0,,0,0,0,0,1,1,0,0,FW,Under 20,Forward,England,Europe
1502,Morato,BRA,Nott'ham Forest,Premier League,2024,23.0,2001.0,2.9,7,5,5,1,1,2,3,66.7,1,5,3,2,5,12,27,2,DF,20-24,Defender,Brazil,South America
1503,Diego Moreira,POR,Strasbourg,Ligue 1,2024,20.0,2004.0,13.2,20,14,6,10,4,9,19,47.4,10,8,1,7,14,34,31,0,"DF,MF",20-24,Defender,Portugal,Europe
1509,Ilaix Moriba,GUI,Celta Vigo,La Liga,2024,21.0,2003.0,9.7,29,22,9,17,3,17,30,56.7,13,12,3,9,6,35,14,0,MF,20-24,Midfielder,Guinea,Africa
1511,Nikola Moro,CRO,Bologna,Serie A,2024,26.0,1998.0,7.4,21,17,6,11,4,15,19,78.9,4,13,6,7,7,28,10,0,MF,25-29,Midfielder,Croatia,Europe
1513,Sam Morsy,EGY,Ipswich Town,Premier League,2024,33.0,1991.0,15.9,37,20,18,15,4,15,37,40.5,22,16,6,10,17,54,26,2,MF,30-34,Midfielder,Egypt,Africa
1514,Gabriel Moscardo,BRA,Reims,Ligue 1,2024,19.0,2005.0,0.4,2,0,2,0,0,1,3,33.3,2,1,1,0,0,2,0,0,MF,Under 20,Midfielder,Brazil,South America
1516,Daniel Mosquera,COL,Hellas Verona,Serie A,2024,25.0,1999.0,6.0,4,2,1,1,2,0,2,0.0,2,4,1,3,0,4,4,0,"FW,MF",25-29,Forward,Colombia,South America
1517,Yerson Mosquera,COL,Wolves,Premier League,2024,23.0,2001.0,4.9,11,7,9,2,0,9,14,64.3,5,13,10,3,10,21,14,0,DF,20-24,Defender,Colombia,South America
1518,Dany Mota,POR,Monza,Serie A,2024,26.0,1998.0,10.7,8,1,2,0,6,2,4,50.0,2,11,0,11,7,15,9,1,"MF,FW",25-29,Midfielder,Portugal,Europe
1519,Yael Mouanga,FRA,Montpellier,Ligue 1,2024,19.0,2005.0,1.0,2,2,2,0,0,1,1,100.0,0,3,3,0,0,2,7,0,DF,Under 20,Defender,France,Europe
1520,Aimen Moueffek,FRA,Saint-Étienne,Ligue 1,2024,23.0,2001.0,5.3,11,6,3,7,1,3,11,27.3,8,6,3,3,2,13,17,0,MF,20-24,Midfielder,France,Europe
1521,Youssoufa Moukoko,GER,Nice,Ligue 1,2024,20.0,2004.0,2.0,1,0,1,0,0,0,1,0.0,1,0,0,0,0,1,0,0,"FW,MF",20-24,Forward,Germany,Europe
1522,Steve Mounié,BEN,Augsburg,Bundesliga,2024,30.0,1994.0,2.6,3,3,0,1,2,0,1,0.0,1,1,1,0,0,3,4,0,"FW,MF",30-34,Forward,Benin,Africa
1523,Mason Mount,ENG,Manchester Utd,Premier League,2024,25.0,1999.0,2.7,6,2,3,3,0,5,7,71.4,2,4,1,3,0,6,0,0,"MF,FW",25-29,Midfielder,England,Europe
1524,Santiago Mouriño,URU,Alavés,La Liga,2024,22.0,2002.0,7.0,15,11,11,4,0,8,15,53.3,7,6,0,6,11,26,28,0,DF,20-24,Defender,Uruguay,South America
1525,Louis Mouton,FRA,Saint-Étienne,Ligue 1,2024,22.0,2002.0,6.0,15,8,6,5,4,4,9,44.4,5,4,1,3,6,21,10,0,MF,20-24,Midfielder,France,Europe
1526,Mykhailo Mudryk,UKR,Chelsea,Premier League,2024,23.0,2001.0,1.7,2,2,2,0,0,0,0,,0,3,1,2,0,2,1,0,FW,20-24,Forward,Ukraine,Europe
1527,Ngal'Ayel Mukau,COD,Lille,Ligue 1,2024,20.0,2004.0,6.1,19,11,5,12,2,12,19,63.2,7,7,0,7,10,29,11,0,MF,20-24,Midfielder,DR Congo,Africa
1528,Nordi Mukiele,FRA,Leverkusen,Bundesliga,2024,27.0,1997.0,1.4,3,2,0,2,1,2,2,100.0,0,1,0,1,3,6,5,1,DF,25-29,Defender,France,Europe
1529,Florian Müller,GER,Freiburg,Bundesliga,2024,27.0,1997.0,2.0,0,0,0,0,0,0,0,,0,0,0,0,0,0,0,0,GK,25-29,Goalkeeper,Germany,Europe
1530,Kevin Müller,GER,Heidenheim,Bundesliga,2024,33.0,1991.0,15.0,1,1,1,0,0,1,1,100.0,0,0,0,0,0,1,6,2,GK,30-34,Goalkeeper,Germany,Europe
1531,Thomas Müller,GER,Bayern Munich,Bundesliga,2024,35.0,1989.0,6.2,4,2,1,2,1,2,6,33.3,4,5,0,5,0,4,7,0,"MF,FW",35-39,Midfielder,Germany,Europe
1532,Abdul Mumin,GHA,Rayo Vallecano,La Liga,2024,26.0,1998.0,15.0,19,12,14,5,0,7,16,43.8,9,23,14,9,18,37,93,0,DF,25-29,Defender,Ghana,Africa
1533,Marshall Munetsi,ZIM,Reims,Ligue 1,2024,28.0,1996.0,13.8,22,12,13,5,4,14,25,56.0,11,18,3,15,15,37,16,0,MF,25-29,Midfielder,Zimbabwe,Africa
1534,Rodrigo Muniz,BRA,Fulham,Premier League,2024,23.0,2001.0,5.9,4,2,1,2,1,3,3,100.0,0,5,1,4,4,8,5,0,FW,20-24,Forward,Brazil,South America
1537,Daniel Muñoz,COL,Crystal Palace,Premier League,2024,28.0,1996.0,15.0,56,38,26,21,9,25,44,56.8,19,14,2,12,16,72,43,0,DF,25-29,Defender,Colombia,South America
1541,Murillo,BRA,Nott'ham Forest,Premier League,2024,22.0,2002.0,16.7,21,12,15,5,1,12,23,52.2,11,31,22,9,13,34,102,1,DF,20-24,Defender,Brazil,South America
1543,Jacob Murphy,ENG,Newcastle Utd,Premier League,2024,29.0,1995.0,8.6,10,7,4,4,2,7,12,58.3,5,14,0,14,3,13,6,0,FW,25-29,Forward,England,Europe
1544,Yunus Musah,USA,Milan,Serie A,2024,22.0,2002.0,6.0,11,10,5,4,2,3,4,75.0,1,4,1,3,4,15,3,1,"MF,FW",20-24,Midfielder,United States,North America
1545,Jamal Musiala,GER,Bayern Munich,Bundesliga,2024,21.0,2003.0,11.2,21,13,5,8,8,5,15,33.3,10,15,0,15,6,27,4,1,MF,20-24,Midfielder,Germany,Europe
1547,Juan Musso,ARG,Atalanta,Serie A,2024,30.0,1994.0,1.0,0,0,0,0,0,0,0,,0,0,0,0,0,0,0,0,GK,30-34,Goalkeeper,Argentina,South America
1548,Juan Musso,ARG,Atlético Madrid,La Liga,2024,30.0,1994.0,1.0,0,0,0,0,0,0,0,,0,0,0,0,0,0,0,0,GK,30-34,Goalkeeper,Argentina,South America
1549,Kingstone Mutandwa,ZAM,Cagliari,Serie A,2024,21.0,2003.0,0.5,0,0,0,0,0,0,0,,0,0,0,0,0,0,0,0,"MF,FW",20-24,Midfielder,Zambia,Africa
1550,Junior Mwanga,FRA,Strasbourg,Ligue 1,2024,21.0,2003.0,3.3,17,9,9,7,1,5,9,55.6,4,2,0,2,2,19,2,0,MF,20-24,Midfielder,France,Europe
1551,Phillipp Mwene,AUT,Mainz 05,Bundesliga,2024,30.0,1994.0,14.8,25,15,9,13,3,7,19,36.8,12,18,4,14,15,40,30,0,DF,30-34,Defender,Austria,Europe
1552,Vitaliy Mykolenko,UKR,Everton,Premier League,2024,25.0,1999.0,13.3,24,15,15,6,3,13,26,50.0,13,9,4,5,15,39,52,1,DF,25-29,Defender,Ukraine,Europe
1553,Joakim Mæhle,DEN,Wolfsburg,Bundesliga,2024,27.0,1997.0,7.3,5,2,4,1,0,2,9,22.2,7,9,1,8,7,12,13,1,DF,25-29,Defender,Denmark,Europe
1554,Obite N'Dicka,CIV,Roma,Serie A,2024,25.0,1999.0,17.0,15,12,7,8,0,8,10,80.0,2,19,14,5,22,37,59,1,DF,25-29,Defender,Ivory Coast,Africa
1555,Nathan N'Goumou,FRA,Gladbach,Bundesliga,2024,24.0,2000.0,3.0,6,6,3,2,1,2,4,50.0,2,7,2,5,2,8,4,0,FW,20-24,Forward,France,Europe
1556,Stanley N'Soki,FRA,Hoffenheim,Bundesliga,2024,25.0,1999.0,6.5,7,5,5,2,0,4,6,66.7,2,8,2,6,15,22,29,1,DF,25-29,Defender,France,Europe
1557,Mickael Nade,FRA,Saint-Étienne,Ligue 1,2024,25.0,1999.0,6.6,21,15,13,8,0,10,10,100.0,0,12,4,8,8,29,26,2,DF,25-29,Defender,France,Europe
1558,Bilal Nadir,FRA,Marseille,Ligue 1,2024,21.0,2003.0,0.2,1,0,0,1,0,0,0,,0,0,0,0,0,1,0,0,MF,20-24,Midfielder,France,Europe
1559,Mahamadou Nagida,CMR,Rennes,Ligue 1,2024,19.0,2005.0,3.6,6,5,4,1,1,3,3,100.0,0,3,0,3,8,14,5,0,DF,Under 20,Defender,Cameroon,Africa
1560,Keito Nakamura,JPN,Reims,Ligue 1,2024,24.0,2000.0,12.9,15,10,6,5,4,7,15,46.7,8,10,0,10,7,22,7,0,FW,20-24,Forward,Japan,Asia
1561,Sebastian Nanasi,SWE,Strasbourg,Ligue 1,2024,22.0,2002.0,12.0,10,8,3,5,2,4,12,33.3,8,10,1,9,3,13,8,0,"FW,MF",20-24,Forward,Sweden,Europe
1562,Yael Nandjou,FRA,Nice,Ligue 1,2024,19.0,2005.0,1.7,4,1,2,1,1,4,8,50.0,4,4,1,3,4,8,7,0,DF,Under 20,Defender,France,Europe
1564,Natan,BRA,Betis,La Liga,2024,23.0,2001.0,9.1,13,10,10,2,1,10,10,100.0,0,10,5,5,13,26,46,0,DF,20-24,Defender,Brazil,South America
1568,Michel Ndary Adopo,FRA,Cagliari,Serie A,2024,24.0,2000.0,9.1,21,13,5,15,1,6,10,60.0,4,7,0,7,7,28,5,0,MF,20-24,Midfielder,France,Europe
1570,Iliman Ndiaye,SEN,Everton,Premier League,2024,24.0,2000.0,14.0,30,15,13,9,8,13,26,50.0,13,14,4,10,15,45,13,0,FW,20-24,Forward,Senegal,Africa
1571,Junior Ndiaye,FRA,Montpellier,Ligue 1,2024,19.0,2005.0,0.8,1,0,1,0,0,0,0,,0,1,1,0,0,1,1,0,"FW,MF",Under 20,Forward,France,Europe
1572,Rassoul Ndiaye,SEN,Le Havre,Ligue 1,2024,23.0,2001.0,6.6,16,12,9,7,0,2,12,16.7,10,6,1,5,6,22,7,0,MF,20-24,Midfielder,Senegal,Africa
1573,Wilfred Ndidi,NGA,Leicester City,Premier League,2024,28.0,1996.0,13.5,48,28,26,19,3,15,33,45.5,18,32,12,20,9,57,47,0,MF,25-29,Midfielder,Nigeria,Africa
1574,Tanguy Ndombele,FRA,Nice,Ligue 1,2024,27.0,1996.0,9.5,27,18,8,16,3,11,17,64.7,6,9,0,9,8,35,7,0,MF,25-29,Midfielder,France,Europe
1575,Dan Ndoye,SUI,Bologna,Serie A,2024,24.0,2000.0,9.2,8,7,2,2,4,5,12,41.7,7,10,0,10,3,11,2,0,FW,20-24,Forward,Switzerland,Europe
1576,Paul Nebel,GER,Mainz 05,Bundesliga,2024,22.0,2002.0,8.7,13,8,4,5,4,4,11,36.4,7,14,1,13,8,21,14,1,MF,20-24,Midfielder,Germany,Europe
1578,Loïc Nego,HUN,Le Havre,Ligue 1,2024,33.0,1991.0,8.7,19,11,10,7,2,14,22,63.6,8,6,0,6,14,33,19,0,"DF,FW",30-34,Defender,Hungary,Europe
1579,Reiss Nelson,ENG,Arsenal,Premier League,2024,25.0,1999.0,0.0,1,0,0,1,0,0,1,0.0,1,0,0,0,0,1,1,0,FW,25-29,Forward,England,Europe
1580,Reiss Nelson,ENG,Fulham,Premier League,2024,25.0,1999.0,5.4,8,6,3,3,2,5,13,38.5,8,11,0,11,5,13,2,0,FW,25-29,Forward,England,Europe
1581,David Nemeth,AUT,St. Pauli,Bundesliga,2024,23.0,2001.0,5.0,10,7,9,1,0,7,13,53.8,6,7,3,4,4,14,18,0,DF,20-24,Defender,Austria,Europe
1582,David Neres,BRA,Napoli,Serie A,2024,27.0,1997.0,4.4,5,2,1,2,2,2,4,50.0,2,2,0,2,2,7,0,0,"FW,MF",25-29,Forward,Brazil,South America
1583,Neto,BRA,Bournemouth,Premier League,2024,35.0,1989.0,2.0,0,0,0,0,0,0,0,,0,0,0,0,0,0,1,1,GK,35-39,Goalkeeper,Brazil,South America
1583,Neto,BRA,Bournemouth,Premier League,2024,35.0,1989.0,2.0,0,0,0,0,0,0,0,,0,0,0,0,0,0,1,1,GK,35-39,Goalkeeper,Brazil,South America
1583,Neto,BRA,Bournemouth,Premier League,2024,35.0,1989.0,2.0,0,0,0,0,0,0,0,,0,0,0,0,0,0,1,1,GK,35-39,Goalkeeper,Brazil,South America
1583,Neto,BRA,Bournemouth,Premier League,2024,35.0,1989.0,2.0,0,0,0,0,0,0,0,,0,0,0,0,0,0,1,1,GK,35-39,Goalkeeper,Brazil,South America
1583,Neto,BRA,Bournemouth,Premier League,2024,35.0,1989.0,2.0,0,0,0,0,0,0,0,,0,0,0,0,0,0,1,1,GK,35-39,Goalkeeper,Brazil,South America
1583,Neto,BRA,Bournemouth,Premier League,2024,35.0,1989.0,2.0,0,0,0,0,0,0,0,,0,0,0,0,0,0,1,1,GK,35-39,Goalkeeper,Brazil,South America
1583,Neto,BRA,Bournemouth,Premier League,2024,35.0,1989.0,2.0,0,0,0,0,0,0,0,,0,0,0,0,0,0,1,1,GK,35-39,Goalkeeper,Brazil,South America
1583,Neto,BRA,Bournemouth,Premier League,2024,35.0,1989.0,2.0,0,0,0,0,0,0,0,,0,0,0,0,0,0,1,1,GK,35-39,Goalkeeper,Brazil,South America
1583,Neto,BRA,Bournemouth,Premier League,2024,35.0,1989.0,2.0,0,0,0,0,0,0,0,,0,0,0,0,0,0,1,1,GK,35-39,Goalkeeper,Brazil,South America
1584,Pedro Neto,POR,Chelsea,Premier League,2024,24.0,2000.0,9.0,10,5,3,6,1,4,9,44.4,5,7,0,7,5,15,2,0,FW,20-24,Forward,Portugal,Europe
1585,Luca Netz,GER,Gladbach,Bundesliga,2024,21.0,2003.0,6.1,13,6,9,3,1,5,10,50.0,5,10,2,8,7,20,13,0,DF,20-24,Defender,Germany,Europe
1586,Manuel Neuer,GER,Bayern Munich,Bundesliga,2024,38.0,1986.0,11.0,1,0,1,0,0,1,1,100.0,0,0,0,0,0,1,5,1,GK,35-39,Goalkeeper,Germany,Europe
1587,Florian Neuhaus,GER,Gladbach,Bundesliga,2024,27.0,1997.0,1.0,2,0,1,1,0,1,6,16.7,5,5,0,5,2,4,0,0,"MF,FW",25-29,Midfielder,Germany,Europe
1588,João Neves,POR,Paris S-G,Ligue 1,2024,20.0,2004.0,12.1,48,26,16,22,10,20,34,58.8,14,17,5,12,8,56,8,0,MF,20-24,Midfielder,Portugal,Europe
1589,Yvan Neyou,CMR,Leganés,La Liga,2024,27.0,1997.0,12.4,28,20,11,15,2,12,22,54.5,10,17,0,17,14,42,18,1,MF,25-29,Midfielder,Cameroon,Africa
1590,Cyril Ngonge,BEL,Napoli,Serie A,2024,24.0,2000.0,1.2,4,3,1,3,0,1,3,33.3,2,0,0,0,0,4,3,0,"FW,DF",20-24,Forward,Belgium,Europe
1591,Mikayil Ngor Faye,SEN,Rennes,Ligue 1,2024,20.0,2004.0,5.7,11,8,8,2,1,6,6,100.0,0,4,2,2,8,19,21,0,DF,20-24,Defender,Senegal,Africa
1592,Steve Ngoura,FRA,Le Havre,Ligue 1,2024,19.0,2005.0,3.2,4,2,1,1,2,3,3,100.0,0,2,1,1,0,4,2,0,FW,Under 20,Forward,France,Europe
1593,Moussa Niakhate,SEN,Lyon,Ligue 1,2024,28.0,1996.0,12.0,24,15,21,3,0,11,14,78.6,3,13,8,5,8,32,43,3,DF,25-29,Defender,Senegal,Africa
1594,Abdoulaye Niakhate Ndiaye,SEN,Brest,Ligue 1,2024,22.0,2002.0,4.6,11,7,8,3,0,7,8,87.5,1,6,2,4,4,15,29,0,DF,20-24,Defender,Senegal,Africa
1595,Ibrahima Niane,SEN,Angers,Ligue 1,2024,25.0,1999.0,7.4,5,2,3,2,0,3,3,100.0,0,5,1,4,2,7,3,2,FW,25-29,Forward,Senegal,Africa
1596,Tanguy Nianzou,FRA,Sevilla,La Liga,2024,22.0,2002.0,5.8,7,5,6,0,1,5,6,83.3,1,1,0,1,8,15,27,0,DF,20-24,Defender,France,Europe
1597,Rasmus Nicolaisen,DEN,Toulouse,Ligue 1,2024,27.0,1997.0,6.9,6,3,4,2,0,3,5,60.0,2,10,5,5,10,16,25,0,DF,25-29,Defender,Denmark,Europe
1598,Moritz Nicolas,GER,Gladbach,Bundesliga,2024,27.0,1997.0,12.0,0,0,0,0,0,0,0,,0,1,0,1,1,1,7,1,GK,25-29,Goalkeeper,Germany,Europe
1599,Hans Nicolussi Caviglia,ITA,Venezia,Serie A,2024,24.0,2000.0,11.9,21,11,4,12,5,15,25,60.0,10,10,2,8,8,29,16,2,MF,20-24,Midfielder,Italy,Europe
1601,Eybi Nije,SWE,Torino,Serie A,2024,19.0,2005.0,3.3,5,1,3,1,1,0,2,0.0,2,3,0,3,0,5,0,0,"FW,MF",Under 20,Forward,Sweden,Europe
1602,Justin Njinmah,GER,Werder Bremen,Bundesliga,2024,24.0,2000.0,5.1,2,1,1,1,0,2,3,66.7,1,2,0,2,2,4,0,0,"MF,FW",20-24,Midfielder,Germany,Europe
1603,Eddie Nketiah,ENG,Crystal Palace,Premier League,2024,25.0,1999.0,6.4,12,5,6,2,4,5,9,55.6,4,6,0,6,1,13,5,0,"MF,FW",25-29,Midfielder,England,Europe
1604,Niels Nkounkou,FRA,Eint Frankfurt,Bundesliga,2024,24.0,2000.0,3.4,6,5,2,1,3,1,4,25.0,3,4,2,2,5,11,6,0,"DF,MF",20-24,Defender,France,Europe
1605,Christopher Nkunku,FRA,Chelsea,Premier League,2024,27.0,1997.0,3.6,3,3,0,1,2,2,2,100.0,0,5,1,4,2,5,6,0,FW,25-29,Forward,France,Europe
1606,Felix Nmecha,GER,Dortmund,Bundesliga,2024,24.0,2000.0,9.7,22,15,2,14,6,8,14,57.1,6,13,5,8,14,36,20,0,MF,20-24,Midfielder,Germany,Europe
1607,Lukas Nmecha,GER,Wolfsburg,Bundesliga,2024,26.0,1998.0,1.5,1,0,0,1,0,0,0,,0,0,0,0,2,3,3,0,FW,25-29,Forward,Germany,Europe
1608,Arnaud Nordin,FRA,Montpellier,Ligue 1,2024,26.0,1998.0,12.2,23,14,6,15,2,10,18,55.6,8,11,0,11,5,28,7,0,FW,25-29,Forward,France,Europe
1609,Brooke Norton-Cuffy,ENG,Genoa,Serie A,2024,20.0,2004.0,1.3,3,2,1,2,0,1,2,50.0,1,1,0,1,1,4,0,0,"DF,MF",20-24,Defender,England,Europe
1610,Tijjani Noslin,NED,Lazio,Serie A,2024,25.0,1999.0,6.0,4,3,1,1,2,0,3,0.0,3,13,1,12,0,4,7,0,"FW,MF",25-29,Forward,Netherlands,Europe
1612,Randy Nteka,ANG,Rayo Vallecano,La Liga,2024,27.0,1997.0,7.1,9,5,2,5,2,4,7,57.1,3,7,1,6,2,11,9,0,FW,25-29,Forward,Angola,Africa
1613,Ernest Nuamah,GHA,Lyon,Ligue 1,2024,21.0,2003.0,3.8,9,3,6,2,1,7,11,63.6,4,2,0,2,2,11,3,0,"FW,MF",20-24,Forward,Ghana,Africa
1614,Alexander Nübel,GER,Stuttgart,Bundesliga,2024,28.0,1996.0,15.0,0,0,0,0,0,0,0,,0,0,0,0,0,0,6,2,GK,25-29,Goalkeeper,Germany,Europe
1615,Matheus Nunes,POR,Manchester City,Premier League,2024,26.0,1998.0,5.9,17,9,9,5,3,7,14,50.0,7,8,2,6,4,21,7,0,"MF,FW",25-29,Midfielder,Portugal,Europe
1616,Darwin Núñez,URU,Liverpool,Premier League,2024,25.0,1999.0,7.2,16,14,9,3,4,5,12,41.7,7,3,0,3,1,17,8,0,FW,25-29,Forward,Uruguay,South America
1619,Ethan Nwaneri,ENG,Arsenal,Premier League,2024,17.0,2007.0,1.3,2,1,0,1,1,0,5,0.0,5,4,1,3,0,2,1,0,"MF,FW",Under 20,Midfielder,England,Europe
1621,Allan Nyom,CMR,Getafe,La Liga,2024,36.0,1988.0,6.3,10,6,4,5,1,8,10,80.0,2,2,1,1,2,12,14,0,"DF,MF",35-39,Defender,Cameroon,Africa
1622,Rabby Nzingoula,CGO,Montpellier,Ligue 1,2024,19.0,2005.0,8.0,29,17,11,13,5,12,24,50.0,12,9,2,7,12,41,10,0,MF,Under 20,Midfielder,Congo,Africa
1623,M'Bala Nzola,ANG,Lens,Ligue 1,2024,28.0,1996.0,8.4,3,2,0,0,3,2,5,40.0,3,3,1,2,2,5,5,0,FW,25-29,Forward,Angola,Africa
1624,Marwann Nzuzi,FRA,Saint-Étienne,Ligue 1,2024,20.0,2004.0,1.4,2,2,1,0,1,1,2,50.0,1,0,0,0,2,4,6,0,DF,20-24,Defender,France,Europe
1625,Christian Nørgaard,DEN,Brentford,Premier League,2024,30.0,1994.0,12.8,42,27,17,21,4,26,36,72.2,10,20,6,14,19,61,29,1,MF,30-34,Midfielder,Denmark,Europe
1626,Jake O'Brien,IRL,Everton,Premier League,2024,23.0,2001.0,0.4,2,2,1,1,0,2,2,100.0,0,1,0,1,0,2,0,0,DF,20-24,Defender,Republic of Ireland,Europe
1627,Matt O'Riley,DEN,Brighton,Premier League,2024,24.0,2000.0,2.5,5,4,1,4,0,2,5,40.0,3,1,0,1,4,9,3,0,MF,20-24,Midfielder,Denmark,Europe
1628,Dara O'Shea,IRL,Ipswich Town,Premier League,2024,25.0,1999.0,13.7,20,13,12,7,1,7,11,63.6,4,26,21,5,19,39,76,3,DF,25-29,Defender,Republic of Ireland,Europe
1629,Adam Obert,SVK,Cagliari,Serie A,2024,22.0,2002.0,4.1,12,8,4,8,0,6,12,50.0,6,8,4,4,11,23,18,1,DF,20-24,Defender,Slovakia,Europe
1631,Lucas Ocampos,ARG,Sevilla,La Liga,2024,30.0,1994.0,1.9,3,2,2,0,1,1,2,50.0,1,2,0,2,0,3,2,0,FW,30-34,Forward,Argentina,South America
1632,Jens Odgaard,DEN,Bologna,Serie A,2024,25.0,1999.0,9.7,11,10,2,8,1,3,9,33.3,6,7,1,6,5,16,6,0,"MF,FW",25-29,Midfielder,Denmark,Europe
1633,Wilson Odobert,FRA,Tottenham,Premier League,2024,20.0,2004.0,1.8,5,2,2,2,1,4,6,66.7,2,1,0,1,0,5,1,1,FW,20-24,Forward,France,Europe
1635,Tim Oermann,GER,Bochum,Bundesliga,2024,21.0,2003.0,7.8,11,5,8,2,1,5,10,50.0,5,10,6,4,8,19,16,0,DF,20-24,Defender,Germany,Europe
1636,Chiedozie Ogbene,IRL,Ipswich Town,Premier League,2024,27.0,1997.0,2.6,7,3,1,2,4,2,4,50.0,2,1,0,1,1,8,3,0,FW,25-29,Forward,Republic of Ireland,Europe
1637,Ifechukwu Ogbus,SUI,Freiburg,Bundesliga,2024,19.0,2005.0,0.2,1,1,0,0,1,0,1,0.0,1,0,0,0,1,2,2,0,DF,Under 20,Defender,Switzerland,Europe
1638,Thiago Ojeda,ARG,Villarreal,La Liga,2024,21.0,2003.0,0.1,0,0,0,0,0,0,0,,0,0,0,0,0,0,1,0,MF,20-24,Midfielder,Argentina,South America
1639,Hamzat Ojediran,NGA,Lens,Ligue 1,2024,21.0,2003.0,3.2,17,10,5,10,2,4,11,36.4,7,8,2,6,9,26,5,0,MF,20-24,Midfielder,Nigeria,Africa
1640,Noah Okafor,SUI,Milan,Serie A,2024,24.0,2000.0,4.6,2,1,0,0,2,0,1,0.0,1,1,0,1,2,4,1,0,FW,20-24,Forward,Switzerland,Europe
1641,Caleb Okoli,ITA,Leicester City,Premier League,2024,23.0,2001.0,8.7,18,10,6,11,1,9,12,75.0,3,18,11,7,10,28,56,1,DF,20-24,Defender,Italy,Europe
1642,Yllan Okou,FRA,Hellas Verona,Serie A,2024,22.0,2002.0,0.0,0,0,0,0,0,0,0,,0,1,0,1,0,0,0,0,DF,20-24,Defender,France,Europe
1643,Maduka Okoye,NGA,Udinese,Serie A,2024,25.0,1999.0,14.0,0,0,0,0,0,0,0,,0,0,0,0,0,0,4,1,GK,25-29,Goalkeeper,Nigeria,Africa
1644,Joseph Okumu,KEN,Reims,Ligue 1,2024,27.0,1997.0,6.3,16,8,13,3,0,9,13,69.2,4,13,9,4,11,27,29,2,DF,25-29,Defender,Kenya,Africa
1646,Ben Old,NZL,Saint-Étienne,Ligue 1,2024,22.0,2002.0,4.2,4,4,3,1,0,2,8,25.0,6,5,1,4,1,5,1,0,"MF,FW",20-24,Midfielder,New Zealand,Oceania
1647,Michael Olise,FRA,Bayern Munich,Bundesliga,2024,23.0,2001.0,10.5,19,11,7,10,2,7,15,46.7,8,11,0,11,2,21,7,0,"FW,MF",20-24,Forward,France,Europe
1649,Lucas Oliveira Rosa,BRA,Valladolid,La Liga,2024,24.0,2000.0,17.0,45,28,35,9,1,31,45,68.9,14,20,9,11,25,70,53,2,DF,20-24,Defender,Brazil,South America
1650,Mathías Olivera,URU,Napoli,Serie A,2024,27.0,1997.0,14.4,40,23,20,15,5,20,31,64.5,11,17,5,12,19,59,33,0,DF,25-29,Defender,Uruguay,South America
1652,Robin Olsen,SWE,Aston Villa,Premier League,2024,34.0,1990.0,0.5,1,0,1,0,0,1,1,100.0,0,0,0,0,0,1,1,0,GK,30-34,Goalkeeper,Sweden,Europe
1654,Becir Omeragic,SUI,Montpellier,Ligue 1,2024,22.0,2002.0,8.3,16,6,11,4,1,9,14,64.3,5,8,4,4,5,21,29,0,DF,20-24,Defender,Switzerland,Europe
1655,Jonas Omlin,SUI,Gladbach,Bundesliga,2024,30.0,1994.0,3.0,0,0,0,0,0,0,0,,0,0,0,0,0,0,0,0,GK,30-34,Goalkeeper,Switzerland,Europe
1656,Ado Onaiwu,JPN,Auxerre,Ligue 1,2024,29.0,1995.0,5.5,5,4,0,5,0,2,6,33.3,4,1,0,1,1,6,6,0,"MF,FW",25-29,Midfielder,Japan,Asia
1657,Amadou Onana,BEL,Aston Villa,Premier League,2024,23.0,2001.0,9.0,28,16,16,10,2,9,17,52.9,8,9,5,4,17,45,18,2,MF,20-24,Midfielder,Belgium,Europe
1658,André Onana,CMR,Manchester Utd,Premier League,2024,28.0,1996.0,17.0,1,1,1,0,0,1,3,33.3,2,0,0,0,0,1,7,2,GK,25-29,Goalkeeper,Cameroon,Africa
1659,Karim Onisiwo,AUT,Mainz 05,Bundesliga,2024,32.0,1992.0,1.2,1,1,0,0,1,0,0,,0,0,0,0,0,1,0,0,"MF,FW",30-34,Midfielder,Austria,Europe
1660,Paul Onuachu,NGA,Southampton,Premier League,2024,30.0,1994.0,1.3,0,0,0,0,0,0,0,,0,1,0,1,1,1,1,0,FW,30-34,Forward,Nigeria,Africa
1661,Frank Onyeka,NGA,Brentford,Premier League,2024,26.0,1998.0,0.3,0,0,0,0,0,0,0,,0,0,0,0,0,0,0,0,MF,25-29,Midfielder,Nigeria,Africa
1662,Frank Onyeka,NGA,Augsburg,Bundesliga,2024,26.0,1998.0,12.2,24,19,8,12,4,10,21,47.6,11,14,4,10,17,41,13,0,MF,25-29,Midfielder,Nigeria,Africa
1663,Loïs Openda,BEL,RB Leipzig,Bundesliga,2024,24.0,2000.0,14.0,6,3,2,4,0,1,4,25.0,3,8,1,7,2,8,4,0,FW,20-24,Forward,Belgium,Europe
1664,Christopher Operi,CIV,Le Havre,Ligue 1,2024,27.0,1997.0,13.0,13,9,6,2,5,7,12,58.3,5,20,6,14,14,27,30,0,"DF,FW",25-29,Defender,Ivory Coast,Africa
1665,Victor Orakpo,NGA,Nice,Ligue 1,2024,18.0,2006.0,0.4,0,0,0,0,0,0,0,,0,0,0,0,0,0,0,0,FW,Under 20,Forward,Nigeria,Africa
1666,Gift Orban,NGA,Lyon,Ligue 1,2024,22.0,2002.0,2.1,0,0,0,0,0,0,1,0.0,1,0,0,0,0,0,0,0,"FW,DF",20-24,Forward,Nigeria,Africa
1667,Willi Orban,HUN,RB Leipzig,Bundesliga,2024,32.0,1992.0,12.9,25,15,13,11,1,14,20,70.0,6,26,18,8,9,34,74,3,DF,30-34,Defender,Hungary,Europe
1668,Ivan Ordets,UKR,Bochum,Bundesliga,2024,32.0,1992.0,8.0,8,4,6,2,0,5,7,71.4,2,12,6,6,15,23,48,0,DF,30-34,Defender,Ukraine,Europe
1669,Gaetano Oristanio,ITA,Venezia,Serie A,2024,22.0,2002.0,13.9,8,6,3,4,1,3,8,37.5,5,13,0,13,5,13,4,0,"MF,FW",20-24,Midfielder,Italy,Europe
1671,Riccardo Orsolini,ITA,Bologna,Serie A,2024,27.0,1997.0,9.4,6,6,1,3,2,2,5,40.0,3,13,0,13,3,9,6,0,FW,25-29,Forward,Italy,Europe
1672,Stefan Ortega,GER,Manchester City,Premier League,2024,32.0,1992.0,4.0,0,0,0,0,0,0,0,,0,0,0,0,0,0,5,0,GK,30-34,Goalkeeper,Germany,Europe
1673,Gabriel Osei Misehouy,NED,Girona,La Liga,2024,19.0,2005.0,2.5,1,1,0,1,0,0,0,,0,0,0,0,0,1,0,0,"FW,MF",Under 20,Forward,Netherlands,Europe
1674,Gabriel Osho,NGA,Auxerre,Ligue 1,2024,26.0,1998.0,11.1,12,8,10,1,1,6,11,54.5,5,22,14,8,11,23,52,0,DF,25-29,Defender,Nigeria,Africa
1675,Yordan Osorio,VEN,Parma,Serie A,2024,30.0,1994.0,1.9,5,3,4,1,0,2,2,100.0,0,3,1,2,4,9,6,1,DF,30-34,Defender,Venezuela,South America
1676,Patrick Osterhage,GER,Freiburg,Bundesliga,2024,24.0,2000.0,11.9,25,16,9,15,1,6,14,42.9,8,13,2,11,14,39,11,0,MF,20-24,Midfielder,Germany,Europe
1677,William Osula,DEN,Newcastle Utd,Premier League,2024,21.0,2003.0,0.3,0,0,0,0,0,0,0,,0,0,0,0,0,0,0,0,"FW,MF",20-24,Forward,Denmark,Europe
1678,Jibril Othman,TUN,Saint-Étienne,Ligue 1,2024,20.0,2004.0,0.1,0,0,0,0,0,0,0,,0,0,0,0,0,0,0,0,FW,20-24,Forward,Tunisia,Africa
1680,Dango Ouattara,BFA,Bournemouth,Premier League,2024,22.0,2002.0,7.8,23,19,9,7,7,13,27,48.1,14,15,4,11,7,30,18,0,"FW,DF",20-24,Forward,Burkina Faso,Africa
1681,Guimissongui Ouattara,FRA,Strasbourg,Ligue 1,2024,19.0,2005.0,0.8,1,1,0,0,1,0,0,,0,2,0,2,1,2,0,0,"FW,MF",Under 20,Forward,France,Europe
1682,Kassoum Ouattara,FRA,Monaco,Ligue 1,2024,20.0,2004.0,3.0,8,6,4,4,0,4,12,33.3,8,4,0,4,4,12,1,0,"DF,FW",20-24,Defender,France,Europe
1683,Remi Oudin,FRA,Lecce,Serie A,2024,28.0,1996.0,3.0,3,1,1,1,1,2,4,50.0,2,5,2,3,1,4,0,0,"MF,FW",25-29,Midfielder,France,Europe
1684,Assan Ouedraogo,GER,RB Leipzig,Bundesliga,2024,18.0,2006.0,0.6,0,0,0,0,0,0,0,,0,1,0,1,0,0,0,0,MF,Under 20,Midfielder,Germany,Europe
1685,Zinédine Ould Khaled,FRA,Angers,Ligue 1,2024,24.0,2000.0,0.6,1,1,1,0,0,0,1,0.0,1,2,0,2,0,1,1,0,MF,20-24,Midfielder,France,Europe
1686,Jesús Owono,EQG,Alavés,La Liga,2024,23.0,2001.0,0.4,0,0,0,0,0,0,0,,0,0,0,0,0,0,1,0,GK,20-24,Goalkeeper,Equatorial Guinea,Africa
1687,Beres Owusu,FRA,Saint-Étienne,Ligue 1,2024,21.0,2003.0,1.0,2,2,1,1,0,2,2,100.0,0,2,2,0,0,2,5,0,DF,20-24,Defender,France,Europe
1688,Elisha Owusu,GHA,Auxerre,Ligue 1,2024,27.0,1997.0,13.4,43,25,16,26,1,20,31,64.5,11,17,3,14,22,65,20,0,MF,25-29,Midfielder,Ghana,Africa
1690,Salih Özcan,TUR,Wolfsburg,Bundesliga,2024,26.0,1998.0,3.9,2,2,1,0,1,1,5,20.0,4,5,1,4,7,9,5,0,MF,25-29,Midfielder,Turkey,Asia
1691,Cenk Özkacar,TUR,Valladolid,La Liga,2024,24.0,2000.0,2.2,3,3,2,1,0,2,5,40.0,3,4,2,2,7,10,18,0,DF,20-24,Defender,Turkey,Asia
1693,Willian Pacho,ECU,Paris S-G,Ligue 1,2024,23.0,2001.0,13.3,34,19,21,13,0,16,22,72.7,6,21,13,8,25,59,48,0,DF,20-24,Defender,Ecuador,South America
1695,Exequiel Palacios,ARG,Leverkusen,Bundesliga,2024,26.0,1998.0,3.9,7,6,1,4,2,3,5,60.0,2,8,1,7,3,10,4,0,MF,25-29,Midfielder,Argentina,South America
1696,Tiago Palacios,ARG,Inter,Serie A,2024,21.0,2003.0,0.1,0,0,0,0,0,0,0,,0,0,0,0,1,1,0,0,DF,20-24,Defender,Argentina,South America
1698,Alberto Paleari,ITA,Torino,Serie A,2024,32.0,1992.0,1.0,0,0,0,0,0,0,0,,0,0,0,0,0,0,2,0,GK,30-34,Goalkeeper,Italy,Europe
1699,Marco Palestra,ITA,Atalanta,Serie A,2024,19.0,2005.0,0.7,2,1,1,1,0,1,1,100.0,0,0,0,0,0,2,0,0,DF,Under 20,Defender,Italy,Europe
1700,João Palhinha,POR,Bayern Munich,Bundesliga,2024,29.0,1995.0,3.9,7,7,1,5,1,4,7,57.1,3,5,0,5,3,10,4,0,MF,25-29,Midfielder,Portugal,Europe
1701,Nicolas Pallois,FRA,Nantes,Ligue 1,2024,37.0,1987.0,9.0,22,9,15,6,1,13,23,56.5,10,12,4,8,12,34,59,1,DF,35-39,Defender,France,Europe
1702,Cole Palmer,ENG,Chelsea,Premier League,2024,22.0,2002.0,16.4,12,7,6,4,2,4,13,30.8,9,11,1,10,5,17,7,0,MF,20-24,Midfielder,England,Europe
1703,Emerson Palmieri,ITA,West Ham,Premier League,2024,30.0,1994.0,13.1,38,21,24,12,2,14,25,56.0,11,18,4,14,12,50,31,0,DF,30-34,Defender,Italy,Europe
1704,Mats Pannewig,GER,Bochum,Bundesliga,2024,20.0,2004.0,1.1,2,2,1,1,0,0,4,0.0,4,4,0,4,0,2,4,0,MF,20-24,Midfielder,Germany,Europe
1705,Lucas Paquetá,BRA,West Ham,Premier League,2024,27.0,1997.0,13.3,30,18,16,12,2,10,25,40.0,15,20,2,18,9,39,22,3,MF,25-29,Midfielder,Brazil,South America
1707,Leandro Paredes,ARG,Roma,Serie A,2024,30.0,1994.0,4.4,10,8,5,4,1,4,7,57.1,3,4,1,3,8,18,5,1,MF,30-34,Midfielder,Argentina,South America
1709,Fabiano Parisi,ITA,Fiorentina,Serie A,2024,24.0,2000.0,2.0,6,4,1,3,2,1,2,50.0,1,1,0,1,2,8,4,0,DF,20-24,Defender,Italy,Europe
1710,Thomas Partey,GHA,Arsenal,Premier League,2024,31.0,1993.0,14.5,41,28,15,14,12,22,38,57.9,16,11,5,6,18,59,27,2,"MF,DF",30-34,Midfielder,Ghana,Africa
1711,Mario Pašalić,CRO,Atalanta,Serie A,2024,29.0,1995.0,11.3,14,9,6,7,1,6,14,42.9,8,9,3,6,6,20,17,0,MF,25-29,Midfielder,Croatia,Europe
1713,Felix Passlack,GER,Bochum,Bundesliga,2024,26.0,1998.0,13.6,33,17,21,8,4,21,39,53.8,18,27,8,19,9,42,29,1,DF,25-29,Defender,Germany,Europe
1715,Nathan Patterson,SCO,Everton,Premier League,2024,23.0,2001.0,0.2,1,0,0,1,0,1,1,100.0,0,0,0,0,0,1,0,0,DF,20-24,Defender,Scotland,Europe
1716,Benjamin Pavard,FRA,Inter,Serie A,2024,28.0,1996.0,8.5,16,8,7,6,3,10,14,71.4,4,7,5,2,10,26,18,0,DF,25-29,Defender,France,Europe
1717,Aleksandar Pavlovic,GER,Bayern Munich,Bundesliga,2024,20.0,2004.0,6.3,14,8,2,7,5,6,11,54.5,5,9,1,8,1,15,6,0,MF,20-24,Midfielder,Germany,Europe
1719,Leonardo Pavoletti,ITA,Cagliari,Serie A,2024,36.0,1988.0,2.1,0,0,0,0,0,0,0,,0,1,1,0,0,0,1,0,"FW,MF",35-39,Forward,Italy,Europe
1720,Martín Payero,ARG,Udinese,Serie A,2024,26.0,1998.0,6.4,8,5,1,3,4,5,9,55.6,4,8,1,7,5,13,5,0,MF,25-29,Midfielder,Argentina,South America
1721,Nicolás Paz,ARG,Como,Serie A,2024,20.0,2004.0,13.9,23,14,6,11,6,10,18,55.6,8,24,2,22,11,34,8,0,"MF,FW",20-24,Midfielder,Argentina,South America
1722,Mads Pedersen,DEN,Augsburg,Bundesliga,2024,28.0,1996.0,2.4,6,5,4,1,1,3,4,75.0,1,4,0,4,2,8,5,0,DF,25-29,Defender,Denmark,Europe
1722,Mads Pedersen,DEN,Augsburg,Bundesliga,2024,28.0,1996.0,2.4,6,5,4,1,1,3,4,75.0,1,4,0,4,2,8,5,0,DF,25-29,Defender,Denmark,Europe
1722,Mads Pedersen,DEN,Augsburg,Bundesliga,2024,28.0,1996.0,2.4,6,5,4,1,1,3,4,75.0,1,4,0,4,2,8,5,0,DF,25-29,Defender,Denmark,Europe
1722,Mads Pedersen,DEN,Augsburg,Bundesliga,2024,28.0,1996.0,2.4,6,5,4,1,1,3,4,75.0,1,4,0,4,2,8,5,0,DF,25-29,Defender,Denmark,Europe
1726,Kévin Pedro,FRA,Saint-Étienne,Ligue 1,2024,18.0,2006.0,0.1,3,0,2,1,0,3,3,100.0,0,1,0,1,2,5,1,0,DF,Under 20,Defender,France,Europe
1728,Jordan Pefok,USA,Union Berlin,Bundesliga,2024,28.0,1996.0,6.9,6,4,5,0,1,1,4,25.0,3,4,1,3,4,10,12,0,FW,25-29,Forward,United States,North America
1730,Pietro Pellegri,ITA,Empoli,Serie A,2024,23.0,2001.0,4.6,7,2,0,6,1,2,4,50.0,2,2,0,2,0,7,3,0,FW,20-24,Forward,Italy,Europe
1731,Lorenzo Pellegrini,ITA,Roma,Serie A,2024,28.0,1996.0,9.9,11,7,2,6,3,3,8,37.5,5,2,0,2,0,11,10,0,MF,25-29,Midfielder,Italy,Europe
1732,Luca Pellegrini,ITA,Lazio,Serie A,2024,25.0,1999.0,4.1,5,3,1,4,0,2,5,40.0,3,4,0,4,5,10,8,0,DF,25-29,Defender,Italy,Europe
1733,Théo Pellenard,FRA,Auxerre,Ligue 1,2024,30.0,1994.0,0.5,3,2,2,1,0,1,3,33.3,2,1,0,1,0,3,3,0,DF,30-34,Defender,France,Europe
1734,Andy Pelmard,FRA,Lecce,Serie A,2024,24.0,2000.0,1.4,6,6,5,1,0,4,4,100.0,0,1,0,1,0,6,5,0,DF,20-24,Defender,France,Europe
1735,Timothee Pembele,FRA,Le Havre,Ligue 1,2024,22.0,2002.0,6.5,12,9,6,5,1,4,8,50.0,4,11,4,7,4,16,23,0,"DF,FW",20-24,Defender,France,Europe
1736,Faris Pemi Moumbagna,CMR,Marseille,Ligue 1,2024,24.0,2000.0,0.1,0,0,0,0,0,0,0,,0,0,0,0,0,0,0,0,FW,20-24,Forward,Cameroon,Africa
1739,Nicolas Pépé,CIV,Villarreal,La Liga,2024,29.0,1995.0,6.3,4,1,1,1,2,0,3,0.0,3,3,1,2,3,7,3,0,"FW,MF",25-29,Forward,Ivory Coast,Africa
1741,Óscar Perea,COL,Strasbourg,Ligue 1,2024,19.0,2005.0,0.1,0,0,0,0,0,0,0,,0,0,0,0,0,0,0,0,MF,Under 20,Midfielder,Colombia,South America
1742,Andreas Pereira,BRA,Fulham,Premier League,2024,28.0,1996.0,11.2,10,4,3,4,3,5,20,25.0,15,6,1,5,4,14,3,0,MF,25-29,Midfielder,Brazil,South America
1743,Mathias Pereira Lage,POR,Brest,Ligue 1,2024,28.0,1996.0,5.7,11,8,6,3,2,4,9,44.4,5,6,1,5,6,17,10,0,"FW,MF",25-29,Forward,Portugal,Europe
1744,Pedro Pereira,POR,Monza,Serie A,2024,26.0,1998.0,12.2,17,9,8,8,1,9,20,45.0,11,10,4,6,8,25,29,2,DF,25-29,Defender,Portugal,Europe
1744,Pedro Pereira,POR,Monza,Serie A,2024,26.0,1998.0,12.2,17,9,8,8,1,9,20,45.0,11,10,4,6,8,25,29,2,DF,25-29,Defender,Portugal,Europe
1744,Pedro Pereira,POR,Monza,Serie A,2024,26.0,1998.0,12.2,17,9,8,8,1,9,20,45.0,11,10,4,6,8,25,29,2,DF,25-29,Defender,Portugal,Europe
1744,Pedro Pereira,POR,Monza,Serie A,2024,26.0,1998.0,12.2,17,9,8,8,1,9,20,45.0,11,10,4,6,8,25,29,2,DF,25-29,Defender,Portugal,Europe
1745,Ricardo Pereira,POR,Leicester City,Premier League,2024,31.0,1993.0,1.6,3,2,0,1,2,1,4,25.0,3,3,1,2,1,4,0,0,DF,30-34,Defender,Portugal,Europe
1746,Gastón Pereiro,URU,Genoa,Serie A,2024,29.0,1995.0,0.3,1,0,0,1,0,1,1,100.0,0,0,0,0,0,1,1,0,MF,25-29,Midfielder,Uruguay,South America
1747,Daniel Peretz,ISR,Bayern Munich,Bundesliga,2024,24.0,2000.0,3.0,0,0,0,0,0,0,1,0.0,1,0,0,0,0,0,2,0,GK,20-24,Goalkeeper,Israel,Asia
1753,Nehuén Pérez,ARG,Udinese,Serie A,2024,24.0,2000.0,2.0,1,1,0,0,1,0,1,0.0,1,2,2,0,1,2,7,0,DF,20-24,Defender,Argentina,South America
1754,Simone Perilli,ITA,Hellas Verona,Serie A,2024,29.0,1995.0,1.0,0,0,0,0,0,0,0,,0,0,0,0,0,0,1,0,GK,25-29,Goalkeeper,Italy,Europe
1755,Mattia Perin,ITA,Juventus,Serie A,2024,32.0,1992.0,5.0,0,0,0,0,0,0,0,,0,0,0,0,0,0,2,0,GK,30-34,Goalkeeper,Italy,Europe
1756,Romain Perraud,FRA,Betis,La Liga,2024,27.0,1997.0,14.1,27,17,11,12,4,16,37,43.2,21,11,2,9,18,45,43,1,DF,25-29,Defender,France,Europe
1757,Lucas Perri,BRA,Lyon,Ligue 1,2024,27.0,1997.0,15.0,1,1,1,0,0,0,3,0.0,3,1,0,1,0,1,9,1,GK,25-29,Goalkeeper,Brazil,South America
1758,Gaëtan Perrin,FRA,Auxerre,Ligue 1,2024,28.0,1996.0,11.3,31,15,15,8,8,17,28,60.7,11,5,0,5,6,37,2,0,"MF,FW",25-29,Midfielder,France,Europe
1759,Máximo Perrone,ARG,Como,Serie A,2024,21.0,2003.0,7.3,14,9,8,5,1,4,19,21.1,15,4,0,4,6,20,16,0,MF,20-24,Midfielder,Argentina,South America
1760,Matteo Pessina,ITA,Monza,Serie A,2024,27.0,1997.0,9.5,15,4,3,11,1,9,14,64.3,5,6,0,6,12,27,7,0,MF,25-29,Midfielder,Italy,Europe
1761,Andrea Petagna,ITA,Monza,Serie A,2024,29.0,1995.0,2.0,0,0,0,0,0,0,0,,0,0,0,0,1,1,1,0,FW,25-29,Forward,Italy,Europe
1762,Léo Pétrot,FRA,Saint-Étienne,Ligue 1,2024,27.0,1997.0,10.5,35,22,22,12,1,21,24,87.5,3,20,7,13,19,54,37,0,DF,25-29,Defender,France,Europe
1764,Giuseppe Pezzella,ITA,Empoli,Serie A,2024,27.0,1997.0,13.3,25,16,17,7,1,17,32,53.1,15,11,4,7,5,30,44,0,"DF,FW",25-29,Defender,Italy,Europe
1765,Maximilian Philipp,GER,Freiburg,Bundesliga,2024,30.0,1994.0,0.0,0,0,0,0,0,0,0,,0,0,0,0,0,0,0,0,FW,30-34,Forward,Germany,Europe
1766,Kalvin Phillips,ENG,Ipswich Town,Premier League,2024,29.0,1995.0,6.3,15,7,4,9,2,8,18,44.4,10,16,3,13,8,23,11,1,MF,25-29,Midfielder,England,Europe
1767,Jaden Philogene Bidace,ENG,Aston Villa,Premier League,2024,22.0,2002.0,3.7,11,5,4,7,0,4,6,66.7,2,5,0,5,3,14,2,1,"FW,MF",20-24,Forward,England,Europe
1769,Roberto Piccoli,ITA,Cagliari,Serie A,2024,23.0,2001.0,15.6,4,2,2,1,1,1,2,50.0,1,8,2,6,1,5,13,0,FW,20-24,Forward,Italy,Europe
1770,Benedikt Pichler,AUT,Holstein Kiel,Bundesliga,2024,27.0,1997.0,8.1,5,2,1,0,4,2,4,50.0,2,4,2,2,2,7,11,0,FW,25-29,Forward,Austria,Europe
1771,Jordan Pickford,ENG,Everton,Premier League,2024,30.0,1994.0,16.0,1,0,1,0,0,1,1,100.0,0,0,0,0,1,2,18,1,GK,30-34,Goalkeeper,England,Europe
1772,Amos Pieper,GER,Werder Bremen,Bundesliga,2024,26.0,1998.0,3.5,7,2,5,1,1,3,6,50.0,3,7,3,4,10,17,14,0,DF,25-29,Defender,Germany,Europe
1773,Marvin Pieringer,GER,Heidenheim,Bundesliga,2024,25.0,1999.0,10.4,11,6,4,4,3,2,4,50.0,2,13,2,11,3,14,12,0,FW,25-29,Forward,Germany,Europe
1774,Nicholas Pierini,ITA,Venezia,Serie A,2024,26.0,1998.0,0.9,0,0,0,0,0,0,1,0.0,1,2,0,2,0,0,0,0,MF,25-29,Midfielder,Italy,Europe
1775,Santiago Pierotti,ARG,Lecce,Serie A,2024,23.0,2001.0,7.7,15,11,10,4,1,10,20,50.0,10,8,2,6,5,20,12,0,FW,20-24,Forward,Argentina,South America
1776,Balthazar Pierret,FRA,Lecce,Serie A,2024,24.0,2000.0,6.1,16,8,10,6,0,3,8,37.5,5,6,1,5,3,19,12,0,MF,20-24,Midfielder,France,Europe
1777,Andrea Pinamonti,ITA,Genoa,Serie A,2024,25.0,1999.0,14.5,5,3,0,4,1,0,3,0.0,3,9,2,7,1,6,16,1,FW,25-29,Forward,Italy,Europe
1778,Ethan Pinnock,JAM,Brentford,Premier League,2024,31.0,1993.0,16.0,29,16,14,12,3,12,17,70.6,5,25,16,9,18,47,105,3,DF,30-34,Defender,Jamaica,North America
1780,Niccolò Pisilli,ITA,Roma,Serie A,2024,20.0,2004.0,7.1,12,7,7,4,1,6,9,66.7,3,8,1,7,5,17,7,0,MF,20-24,Midfielder,Italy,Europe
1781,Semuel Pizzignacco,ITA,Monza,Serie A,2024,23.0,2001.0,3.0,0,0,0,0,0,0,0,,0,0,0,0,0,0,1,0,GK,20-24,Goalkeeper,Italy,Europe
1782,Alassane Pléa,FRA,Gladbach,Bundesliga,2024,31.0,1993.0,11.5,4,2,0,1,3,2,5,40.0,3,5,0,5,2,6,3,1,"MF,FW",30-34,Midfielder,France,Europe
1783,Tommaso Pobega,ITA,Bologna,Serie A,2024,25.0,1999.0,5.5,16,10,7,6,3,10,16,62.5,6,11,3,8,8,24,7,0,MF,25-29,Midfielder,Italy,Europe
1784,Daniel Podence,POR,Wolves,Premier League,2024,29.0,1995.0,0.5,0,0,0,0,0,0,1,0.0,1,0,0,0,0,0,0,0,"MF,FW",25-29,Midfielder,Portugal,Europe
1785,Joel Pohjanpalo,FIN,Venezia,Serie A,2024,30.0,1994.0,13.7,3,3,1,2,0,0,2,0.0,2,3,2,1,4,7,18,0,FW,30-34,Forward,Finland,Europe
1786,Matteo Politano,ITA,Napoli,Serie A,2024,31.0,1993.0,14.4,11,5,5,6,0,8,22,36.4,14,12,1,11,5,16,22,0,"FW,MF",30-34,Forward,Italy,Europe
1787,Alfie Pond,ENG,Wolves,Premier League,2024,20.0,2004.0,0.0,0,0,0,0,0,0,0,,0,0,0,0,0,0,0,0,DF,20-24,Defender,England,Europe
1788,Marin Pongračić,CRO,Fiorentina,Serie A,2024,27.0,1997.0,1.1,1,1,1,0,0,1,3,33.3,2,0,0,0,2,3,6,0,DF,25-29,Defender,Croatia,Europe
1789,Nick Pope,ENG,Newcastle Utd,Premier League,2024,32.0,1992.0,15.0,0,0,0,0,0,0,0,,0,1,0,1,1,1,16,4,GK,30-34,Goalkeeper,England,Europe
1790,Finn Porath,GER,Holstein Kiel,Bundesliga,2024,27.0,1997.0,11.6,30,18,16,9,5,18,34,52.9,16,19,6,13,11,41,29,0,"DF,MF",25-29,Defender,Germany,Europe
1793,Stefan Posch,AUT,Bologna,Serie A,2024,27.0,1997.0,7.0,22,14,11,7,4,13,22,59.1,9,18,4,14,5,27,19,0,DF,25-29,Defender,Austria,Europe
1794,Tom Pouilly,FRA,Lens,Ligue 1,2024,21.0,2003.0,0.5,2,2,1,1,0,1,1,100.0,0,1,0,1,1,3,3,0,DF,20-24,Defender,France,Europe
1795,Yussuf Poulsen,DEN,RB Leipzig,Bundesliga,2024,30.0,1994.0,2.2,5,3,1,4,0,3,6,50.0,3,4,2,2,0,5,4,0,"FW,MF",30-34,Forward,Denmark,Europe
1797,Alexander Prass,AUT,Hoffenheim,Bundesliga,2024,23.0,2001.0,12.2,25,13,14,8,3,14,39,35.9,25,18,3,15,3,28,24,4,DF,20-24,Defender,Austria,Europe
1798,Matteo Prati,ITA,Cagliari,Serie A,2024,20.0,2003.0,2.6,5,2,1,3,1,2,6,33.3,4,0,0,0,2,7,3,1,MF,20-24,Midfielder,Italy,Europe
1800,Grischa Prömel,GER,Hoffenheim,Bundesliga,2024,29.0,1995.0,1.9,0,0,0,0,0,0,1,0.0,1,1,1,0,2,2,4,0,MF,25-29,Midfielder,Germany,Europe
1801,Ivan Provedel,ITA,Lazio,Serie A,2024,30.0,1994.0,17.0,0,0,0,0,0,0,0,,0,1,0,1,0,0,8,3,GK,30-34,Goalkeeper,Italy,Europe
1802,Ivan Prtajin,CRO,Union Berlin,Bundesliga,2024,28.0,1996.0,0.2,0,0,0,0,0,0,0,,0,0,0,0,0,0,0,0,FW,25-29,Forward,Croatia,Europe
1805,Diego Pugno,ITA,Juventus,Serie A,2024,18.0,2006.0,0.1,0,0,0,0,0,0,0,,0,0,0,0,0,0,0,0,FW,Under 20,Forward,Italy,Europe
1806,Christian Pulisic,USA,Milan,Serie A,2024,26.0,1998.0,10.9,20,12,6,7,7,6,14,42.9,8,9,1,8,0,20,5,1,"MF,FW",25-29,Midfielder,United States,North America
1807,Jarell Quansah,ENG,Liverpool,Premier League,2024,21.0,2003.0,1.9,8,6,6,2,0,4,5,80.0,1,2,2,0,3,11,10,0,DF,20-24,Defender,England,Europe
1808,Leopold Querfeld,AUT,Union Berlin,Bundesliga,2024,21.0,2003.0,6.2,7,3,5,2,0,3,6,50.0,3,8,1,7,8,15,32,0,DF,20-24,Defender,Austria,Europe
1810,Adrien Rabiot,FRA,Marseille,Ligue 1,2024,29.0,1995.0,8.6,20,14,9,8,3,10,14,71.4,4,9,0,9,10,30,14,0,MF,25-29,Midfielder,France,Europe
1811,Hamza Rafia,TUN,Lecce,Serie A,2024,25.0,1999.0,9.5,33,19,13,17,3,13,28,46.4,15,7,2,5,4,37,15,0,MF,25-29,Midfielder,Tunisia,Africa
1813,Antonio Raimondo,ITA,Venezia,Serie A,2024,20.0,2004.0,1.0,2,1,1,1,0,0,0,,0,0,0,0,0,2,0,1,"FW,DF",20-24,Forward,Italy,Europe
1814,Ylber Ramadani,ALB,Lecce,Serie A,2024,28.0,1996.0,13.6,32,18,14,18,0,19,27,70.4,8,22,8,14,12,44,21,3,MF,25-29,Midfielder,Albania,Europe
1817,Gonçalo Ramos,POR,Paris S-G,Ligue 1,2024,23.0,2001.0,2.1,4,3,2,1,1,2,2,100.0,0,1,0,1,0,4,2,0,FW,20-24,Forward,Portugal,Europe
1818,Aaron Ramsdale,ENG,Southampton,Premier League,2024,26.0,1998.0,10.0,0,0,0,0,0,0,1,0.0,1,0,0,0,2,2,7,2,GK,25-29,Goalkeeper,England,Europe
1819,Jacob Ramsey,ENG,Aston Villa,Premier League,2024,23.0,2001.0,7.0,7,3,3,3,1,3,5,60.0,2,8,2,6,5,12,2,0,"FW,MF",20-24,Forward,England,Europe
1820,Luca Ranieri,ITA,Fiorentina,Serie A,2024,25.0,1999.0,14.3,13,8,9,3,1,5,9,55.6,4,24,16,8,9,22,57,1,DF,25-29,Defender,Italy,Europe
1821,Grant Ranos,ARM,Gladbach,Bundesliga,2024,21.0,2003.0,0.1,1,0,0,1,0,0,1,0.0,1,1,0,1,0,1,0,0,FW,20-24,Forward,Armenia,Asia
1822,Lilian Raolisoa,FRA,Angers,Ligue 1,2024,24.0,2000.0,2.5,5,3,2,1,2,1,6,16.7,5,2,1,1,2,7,5,0,"DF,FW",20-24,Defender,France,Europe
1823,Raphinha,BRA,Barcelona,La Liga,2024,28.0,1996.0,17.6,23,15,6,13,4,10,20,50.0,10,13,2,11,5,28,17,0,"FW,MF",25-29,Forward,Brazil,South America
1824,Marcus Rashford,ENG,Manchester Utd,Premier League,2024,27.0,1997.0,10.9,7,4,2,2,3,3,9,33.3,6,8,0,8,4,11,7,0,"FW,MF",25-29,Forward,England,Europe
1825,Giacomo Raspadori,ITA,Napoli,Serie A,2024,24.0,2000.0,2.9,3,1,2,1,0,2,4,50.0,2,5,1,4,2,5,1,0,"FW,MF",20-24,Forward,Italy,Europe
1826,Andrei Ratiu,ROU,Rayo Vallecano,La Liga,2024,26.0,1998.0,15.3,34,20,21,7,6,21,27,77.8,6,14,2,12,13,47,32,1,DF,25-29,Defender,Romania,Europe
1828,David Raum,GER,RB Leipzig,Bundesliga,2024,26.0,1998.0,5.5,12,9,6,4,2,3,7,42.9,4,6,2,4,2,14,10,0,DF,25-29,Defender,Germany,Europe
1829,Federico Ravaglia,ITA,Bologna,Serie A,2024,25.0,1999.0,6.0,0,0,0,0,0,0,0,,0,0,0,0,0,0,2,0,GK,25-29,Goalkeeper,Italy,Europe
1830,Rayan Raveloson,MAD,Auxerre,Ligue 1,2024,27.0,1997.0,8.0,6,5,2,4,0,5,15,33.3,10,8,7,1,5,11,22,0,"MF,DF",25-29,Midfielder,Madagascar,Africa
1832,Abderrahman Rebbach,ALG,Alavés,La Liga,2024,26.0,1998.0,4.3,3,2,3,0,0,0,6,0.0,6,4,0,4,0,3,6,0,"FW,MF",25-29,Forward,Algeria,Africa
1833,Ante Rebić,CRO,Lecce,Serie A,2024,31.0,1993.0,5.4,8,6,4,2,2,2,7,28.6,5,3,1,2,0,8,3,0,"FW,MF",30-34,Forward,Croatia,Europe
1834,Harrison Reed,ENG,Fulham,Premier League,2024,29.0,1995.0,0.7,5,2,2,2,1,0,2,0.0,2,1,0,1,1,6,2,0,MF,25-29,Midfielder,England,Europe
1835,Bobby Reid,JAM,Leicester City,Premier League,2024,31.0,1993.0,3.1,4,3,0,4,0,3,7,42.9,4,4,1,3,0,4,4,0,"FW,MF",30-34,Forward,Jamaica,North America
1836,Tijjani Reijnders,NED,Milan,Serie A,2024,26.0,1998.0,13.1,6,3,1,4,1,2,11,18.2,9,3,0,3,12,18,10,1,MF,25-29,Midfielder,Netherlands,Europe
1838,Rocco Reitz,GER,Gladbach,Bundesliga,2024,22.0,2002.0,10.2,31,14,12,17,2,13,23,56.5,10,13,6,7,33,64,22,1,MF,20-24,Midfielder,Germany,Europe
1839,Nicolai Remberg,GER,Holstein Kiel,Bundesliga,2024,24.0,2000.0,10.2,19,11,7,11,1,7,13,53.8,6,17,5,12,6,25,29,0,MF,20-24,Midfielder,Germany,Europe
1841,Guillaume Restes,FRA,Toulouse,Ligue 1,2024,19.0,2005.0,14.8,0,0,0,0,0,0,0,,0,0,0,0,0,0,10,0,GK,Under 20,Goalkeeper,France,Europe
1842,Mateo Retegui,ITA,Atalanta,Serie A,2024,25.0,1999.0,10.7,8,4,0,4,4,2,6,33.3,4,1,0,1,1,9,6,0,FW,25-29,Forward,Italy,Europe
1844,Gio Reyna,USA,Dortmund,Bundesliga,2024,22.0,2002.0,1.3,2,0,1,0,1,1,1,100.0,0,2,0,2,0,2,5,0,MF,20-24,Midfielder,United States,North America
1845,Chadi Riad,MAR,Crystal Palace,Premier League,2024,21.0,2003.0,1.0,5,2,2,2,1,2,3,66.7,1,0,0,0,2,7,0,0,DF,20-24,Defender,Morocco,Africa
1846,Alexsandro Ribeiro,BRA,Lille,Ligue 1,2024,25.0,1999.0,13.0,14,10,6,7,1,11,17,64.7,6,7,3,4,16,30,61,1,DF,25-29,Defender,Brazil,South America
1847,Samuele Ricci,ITA,Torino,Serie A,2024,23.0,2001.0,16.1,19,10,9,6,4,9,12,75.0,3,11,6,5,14,33,25,2,MF,20-24,Midfielder,Italy,Europe
1848,Declan Rice,ENG,Arsenal,Premier League,2024,25.0,1999.0,13.3,23,11,7,13,3,8,14,57.1,6,14,8,6,10,33,20,0,MF,25-29,Midfielder,England,Europe
1849,Chris Richards,USA,Crystal Palace,Premier League,2024,24.0,2000.0,4.9,11,5,6,4,1,7,13,53.8,6,12,2,10,3,14,24,0,DF,20-24,Defender,United States,North America
1850,Amir Richardson,MAR,Fiorentina,Serie A,2024,22.0,2002.0,4.2,13,5,8,5,0,3,8,37.5,5,4,1,3,1,14,11,1,MF,20-24,Midfielder,Morocco,Africa
1851,Richarlison,BRA,Tottenham,Premier League,2024,27.0,1997.0,1.0,1,1,0,0,1,0,0,,0,0,0,0,0,1,2,0,FW,25-29,Forward,Brazil,South America
1853,Fabian Rieder,SUI,Stuttgart,Bundesliga,2024,22.0,2002.0,7.1,13,11,3,6,4,6,21,28.6,15,8,1,7,6,19,3,0,"MF,FW",20-24,Midfielder,Switzerland,Europe
1859,Lars Ritzka,GER,St. Pauli,Bundesliga,2024,26.0,1998.0,5.0,30,18,18,9,3,16,26,61.5,10,10,2,8,5,35,21,0,"DF,FW",25-29,Defender,Germany,Europe
1862,Andrew Robertson,SCO,Liverpool,Premier League,2024,30.0,1994.0,12.6,21,13,13,5,3,16,26,61.5,10,2,1,1,7,28,19,0,DF,30-34,Defender,Scotland,Europe
1863,Antonee Robinson,USA,Fulham,Premier League,2024,27.0,1997.0,17.0,50,31,33,16,1,27,48,56.3,21,20,3,17,35,85,60,0,DF,25-29,Defender,United States,North America
1867,Álvaro Rodríguez,URU,Getafe,La Liga,2024,20.0,2004.0,5.4,5,3,0,4,1,2,5,40.0,3,18,0,18,3,8,9,0,FW,20-24,Forward,Uruguay,South America
1871,Guido Rodríguez,ARG,West Ham,Premier League,2024,30.0,1994.0,9.2,26,13,17,9,0,11,26,42.3,15,15,7,8,10,36,22,1,MF,30-34,Midfielder,Argentina,South America
1872,James Rodríguez,COL,Rayo Vallecano,La Liga,2024,33.0,1991.0,1.6,3,2,1,2,0,0,2,0.0,2,2,0,2,1,4,0,0,"MF,FW",30-34,Midfielder,Colombia,South America
1876,Ricardo Rodríguez,SUI,Betis,La Liga,2024,32.0,1992.0,3.7,9,7,6,1,2,5,9,55.6,4,2,0,2,3,12,12,0,DF,30-34,Defender,Switzerland,Europe
1877,Rodrygo,BRA,Real Madrid,La Liga,2024,23.0,2001.0,10.9,9,7,6,2,1,4,13,30.8,9,11,1,10,2,11,4,0,FW,20-24,Forward,Brazil,South America
1878,Mads Roerslev,DEN,Brentford,Premier League,2024,25.0,1999.0,6.3,7,3,5,2,0,3,10,30.0,7,7,3,4,3,10,17,0,DF,25-29,Defender,Denmark,Europe
1879,Morgan Rogers,ENG,Aston Villa,Premier League,2024,22.0,2002.0,15.6,15,8,3,7,5,7,20,35.0,13,12,2,10,3,18,10,0,"MF,FW",20-24,Midfielder,England,Europe
1880,Merlin Röhl,GER,Freiburg,Bundesliga,2024,22.0,2002.0,2.9,4,4,1,3,0,1,1,100.0,0,2,0,2,1,5,1,0,"MF,FW",20-24,Midfielder,Germany,Europe
1881,Alessio Romagnoli,ITA,Lazio,Serie A,2024,29.0,1995.0,11.4,21,13,9,12,0,10,12,83.3,2,9,6,3,13,34,36,0,DF,25-29,Defender,Italy,Europe
1884,Cristian Romero,ARG,Tottenham,Premier League,2024,26.0,1998.0,10.8,27,23,22,5,0,15,22,68.2,7,13,3,10,13,40,32,0,DF,25-29,Defender,Argentina,South America
1886,Luka Romero,ARG,Alavés,La Liga,2024,20.0,2004.0,2.2,4,4,1,1,2,2,3,66.7,1,2,0,2,1,5,0,0,"FW,MF",20-24,Forward,Argentina,South America
1888,Valentin Rongier,FRA,Marseille,Ligue 1,2024,30.0,1994.0,5.4,17,11,8,8,1,8,13,61.5,5,14,5,9,11,28,14,1,"MF,DF",30-34,Midfielder,France,Europe
1889,Marten de Roon,NED,Atalanta,Serie A,2024,33.0,1991.0,15.5,35,20,13,21,1,15,30,50.0,15,21,2,19,17,52,28,1,"MF,DF",30-34,Midfielder,Netherlands,Europe
1890,Vitor Roque,BRA,Betis,La Liga,2024,19.0,2005.0,10.9,6,4,0,2,4,0,3,0.0,3,4,0,4,5,11,3,0,FW,Under 20,Forward,Brazil,South America
1891,Pablo Rosario,NED,Nice,Ligue 1,2024,27.0,1997.0,12.8,15,9,4,9,2,6,12,50.0,6,12,7,5,22,37,29,2,"MF,DF",25-29,Midfielder,Netherlands,Europe
1892,Lasse Rosenboom,GER,Holstein Kiel,Bundesliga,2024,22.0,2002.0,5.4,13,10,8,3,2,8,11,72.7,3,10,2,8,8,21,18,1,DF,20-24,Defender,Germany,Europe
1893,Max Rosenfelder,GER,Freiburg,Bundesliga,2024,21.0,2003.0,6.0,16,10,11,5,0,9,10,90.0,1,6,2,4,4,20,34,0,DF,20-24,Defender,Germany,Europe
1894,Valentin Rosier,FRA,Leganés,La Liga,2024,28.0,1996.0,12.1,36,29,26,9,1,22,35,62.9,13,15,2,13,18,54,61,1,DF,25-29,Defender,France,Europe
1895,Tom Rothe,GER,Union Berlin,Bundesliga,2024,20.0,2004.0,10.3,30,15,21,8,1,19,32,59.4,13,22,3,19,7,37,26,1,"DF,MF",20-24,Defender,Germany,Europe
1896,Anthony Rouault,FRA,Stuttgart,Bundesliga,2024,23.0,2001.0,9.2,10,8,7,1,2,8,11,72.7,3,14,6,8,13,23,42,1,DF,20-24,Defender,France,Europe
1897,Jonas Rouhi,SWE,Juventus,Serie A,2024,20.0,2004.0,2.1,4,1,1,3,0,0,1,0.0,1,1,0,1,3,7,2,0,DF,20-24,Defender,Sweden,Europe
1898,Jérôme Roussillon,FRA,Union Berlin,Bundesliga,2024,31.0,1993.0,0.1,0,0,0,0,0,0,0,,0,0,0,0,0,0,1,0,DF,30-34,Defender,France,Europe
1899,Nicolò Rovella,ITA,Lazio,Serie A,2024,23.0,2001.0,12.8,41,26,12,25,4,19,37,51.4,18,9,3,6,20,61,17,2,MF,20-24,Midfielder,Italy,Europe
1900,Jon Rowe,ENG,Marseille,Ligue 1,2024,21.0,2003.0,4.3,6,6,0,2,4,4,6,66.7,2,1,1,0,1,7,0,0,"FW,MF",20-24,Forward,England,Europe
1902,Tommaso Rubino,ITA,Fiorentina,Serie A,2024,18.0,2006.0,0.1,0,0,0,0,0,0,1,0.0,1,0,0,0,0,0,0,0,MF,Under 20,Midfielder,Italy,Europe
1903,Antonio Rüdiger,GER,Real Madrid,La Liga,2024,31.0,1993.0,17.1,13,8,8,5,0,8,10,80.0,2,18,11,7,7,20,69,1,DF,30-34,Defender,Germany,Europe
1904,Matteo Ruggeri,ITA,Atalanta,Serie A,2024,22.0,2002.0,12.6,25,16,9,9,7,16,20,80.0,4,16,1,15,14,39,24,1,DF,20-24,Defender,Italy,Europe
1909,Gerónimo Rulli,ARG,Marseille,Ligue 1,2024,32.0,1992.0,15.0,2,1,2,0,0,2,5,40.0,3,0,0,0,0,2,14,1,GK,30-34,Goalkeeper,Argentina,South America
1910,Georginio Rutter,FRA,Brighton,Premier League,2024,22.0,2002.0,11.0,20,7,9,7,4,8,24,33.3,16,13,2,11,7,27,9,1,"FW,MF",20-24,Forward,France,Europe
1912,Frederik Rønnow,DEN,Union Berlin,Bundesliga,2024,32.0,1992.0,14.0,0,0,0,0,0,0,1,0.0,1,0,0,0,0,0,6,2,GK,30-34,Goalkeeper,Denmark,Europe
1913,José Sá,POR,Wolves,Premier League,2024,31.0,1993.0,10.0,1,1,1,0,0,1,1,100.0,0,0,0,0,0,1,5,1,GK,30-34,Goalkeeper,Portugal,Europe
1914,Elias Saad,TUN,St. Pauli,Bundesliga,2024,24.0,1999.0,3.8,12,7,4,5,3,6,11,54.5,5,6,0,6,1,13,1,0,"FW,MF",20-24,Forward,Tunisia,Africa
1915,Youssouf Sabaly,SEN,Betis,La Liga,2024,31.0,1993.0,10.0,22,16,12,8,2,12,17,70.6,5,10,2,8,6,28,29,0,DF,30-34,Defender,Senegal,Africa
1916,Emmanuel Sabbi,USA,Le Havre,Ligue 1,2024,27.0,1997.0,4.9,7,5,3,2,2,3,4,75.0,1,2,0,2,2,9,3,0,"MF,FW",25-29,Midfielder,United States,North America
1917,Stefano Sabelli,ITA,Genoa,Serie A,2024,31.0,1993.0,10.8,29,16,15,11,3,11,30,36.7,19,15,3,12,9,38,30,0,DF,30-34,Defender,Italy,Europe
1918,Marcel Sabitzer,AUT,Dortmund,Bundesliga,2024,30.0,1994.0,9.7,14,9,1,10,3,7,14,50.0,7,8,4,4,2,16,12,0,"MF,FW",30-34,Midfielder,Austria,Europe
1919,Falaye Sacko,MLI,Montpellier,Ligue 1,2024,29.0,1995.0,9.4,13,7,9,3,1,8,15,53.3,7,14,5,9,11,24,9,0,DF,25-29,Defender,Mali,Africa
1920,Umar Sadiq,NGA,Real Sociedad,La Liga,2024,27.0,1997.0,2.5,2,1,1,1,0,1,2,50.0,1,3,1,2,1,3,2,0,FW,25-29,Forward,Nigeria,Africa
1921,Alexis Saelemaekers,BEL,Roma,Serie A,2024,25.0,1999.0,3.7,11,5,6,4,1,7,11,63.6,4,3,1,2,1,12,1,0,"DF,FW",25-29,Defender,Belgium,Europe
1922,Alexis Saelemaekers,BEL,Milan,Serie A,2024,25.0,1999.0,1.0,1,1,0,0,1,1,1,100.0,0,0,0,0,1,2,0,0,"DF,FW",25-29,Defender,Belgium,Europe
1924,Matvei Safonov,RUS,Paris S-G,Ligue 1,2024,25.0,1999.0,4.8,0,0,0,0,0,0,0,,0,1,0,1,1,1,3,0,GK,25-29,Goalkeeper,Russia,Europe
1925,Modibo Sagnan,MLI,Montpellier,Ligue 1,2024,25.0,1999.0,12.3,26,14,16,7,3,15,26,57.7,11,12,7,5,17,43,53,3,DF,25-29,Defender,Mali,Africa
1926,Richie Sagrado,BEL,Venezia,Serie A,2024,20.0,2004.0,1.3,2,2,1,1,0,1,1,100.0,0,1,0,1,1,3,2,0,DF,20-24,Defender,Belgium,Europe
1927,Osame Sahraoui,MAR,Lille,Ligue 1,2024,23.0,2001.0,8.1,5,3,2,2,1,1,4,25.0,3,10,1,9,4,9,5,1,"FW,MF",20-24,Forward,Morocco,Africa
1928,Wesley Saïd,FRA,Lens,Ligue 1,2024,29.0,1995.0,4.2,3,2,1,2,0,1,2,50.0,1,0,0,0,0,3,1,0,"FW,MF",25-29,Forward,France,Europe
1929,Théo Sainte-Luce,FRA,Montpellier,Ligue 1,2024,26.0,1998.0,0.2,0,0,0,0,0,0,0,,0,0,0,0,0,0,0,0,MF,25-29,Midfielder,France,Europe
1930,Bukayo Saka,ENG,Arsenal,Premier League,2024,23.0,2001.0,14.1,22,13,5,10,7,9,19,47.4,10,16,0,16,2,24,7,0,"FW,MF",20-24,Forward,England,Europe
1931,Faik Sakar,GER,RB Leipzig,Bundesliga,2024,16.0,2008.0,0.0,0,0,0,0,0,0,0,,0,0,0,0,0,0,0,0,MF,Under 20,Midfielder,Germany,Europe
1932,Marco Sala,ITA,Como,Serie A,2024,25.0,1999.0,2.9,9,6,5,3,1,5,8,62.5,3,2,0,2,1,10,9,0,DF,25-29,Defender,Italy,Europe
1933,Ibrahim Salah,MAR,Brest,Ligue 1,2024,23.0,2001.0,3.5,3,2,1,1,1,1,5,20.0,4,2,0,2,1,4,0,0,FW,20-24,Forward,Morocco,Africa
1934,Mohamed Salah,EGY,Liverpool,Premier League,2024,32.0,1992.0,15.6,9,6,3,3,3,3,4,75.0,1,1,0,1,4,13,4,0,FW,30-34,Forward,Egypt,Africa
1935,Amine Salama,FRA,Reims,Ligue 1,2024,24.0,2000.0,2.7,2,2,0,1,1,0,3,0.0,3,2,1,1,0,2,0,0,FW,20-24,Forward,France,Europe
1937,Manolis Saliakas,GRE,St. Pauli,Bundesliga,2024,28.0,1996.0,11.7,22,8,10,9,3,11,21,52.4,10,16,3,13,10,32,30,0,"MF,DF",25-29,Midfielder,Greece,Europe
1938,William Saliba,FRA,Arsenal,Premier League,2024,23.0,2001.0,15.3,36,22,24,12,0,15,19,78.9,4,10,5,5,11,47,47,3,DF,20-24,Defender,France,Europe
1939,Mohammed Salisu,GHA,Monaco,Ligue 1,2024,25.0,1999.0,7.3,20,11,11,9,0,10,10,100.0,0,9,7,2,8,28,38,2,DF,25-29,Defender,Ghana,Africa
1940,Roland Sallai,HUN,Freiburg,Bundesliga,2024,27.0,1997.0,0.5,2,1,1,1,0,0,0,,0,0,0,0,1,3,0,0,"FW,MF",25-29,Forward,Hungary,Europe
1943,Diadie Samassékou,MLI,Hoffenheim,Bundesliga,2024,28.0,1996.0,2.2,4,4,0,2,2,2,4,50.0,2,2,1,1,3,7,1,0,MF,25-29,Midfielder,Mali,Africa
1944,Mama Samba Baldé,GNB,Lyon,Ligue 1,2024,29.0,1995.0,0.4,2,2,0,2,0,0,0,,0,0,0,0,1,3,1,0,FW,25-29,Forward,Guinea-Bissau,Africa
1945,Mama Samba Baldé,GNB,Brest,Ligue 1,2024,29.0,1995.0,6.8,5,4,1,1,3,2,7,28.6,5,4,0,4,3,8,6,0,FW,25-29,Forward,Guinea-Bissau,Africa
1946,Brice Samba,FRA,Lens,Ligue 1,2024,30.0,1994.0,15.0,0,0,0,0,0,0,0,,0,0,0,0,1,1,6,2,GK,30-34,Goalkeeper,France,Europe
1947,Albert Sambi Lokonga,BEL,Sevilla,La Liga,2024,25.0,1999.0,8.4,11,9,6,5,0,4,5,80.0,1,6,1,5,2,13,15,2,MF,25-29,Midfielder,Belgium,Europe
1948,Junior Sambia,FRA,Empoli,Serie A,2024,28.0,1996.0,0.5,3,2,1,1,1,3,3,100.0,0,0,0,0,0,3,0,0,"FW,DF",25-29,Forward,France,Europe
1950,Antonio Sanabria,PAR,Torino,Serie A,2024,28.0,1996.0,10.7,2,2,1,0,1,1,4,25.0,3,5,0,5,0,2,9,0,FW,25-29,Forward,Paraguay,South America
1958,Jadon Sancho,ENG,Chelsea,Premier League,2024,24.0,2000.0,7.4,4,3,1,1,2,2,5,40.0,3,2,0,2,0,4,0,0,FW,20-24,Forward,England,Europe
1959,Philipp Sander,GER,Gladbach,Bundesliga,2024,26.0,1998.0,6.3,15,9,7,7,1,6,10,60.0,4,9,2,7,7,22,16,0,MF,25-29,Midfielder,Germany,Europe
1960,Leroy Sané,GER,Bayern Munich,Bundesliga,2024,28.0,1996.0,6.3,8,5,1,4,3,1,3,33.3,2,3,0,3,2,10,1,0,FW,25-29,Forward,Germany,Europe
1961,Arouna Sangante,SEN,Le Havre,Ligue 1,2024,22.0,2002.0,5.8,9,7,4,5,0,5,8,62.5,3,7,4,3,14,23,21,1,DF,20-24,Defender,Senegal,Africa
1962,Ibrahim Sangaré,CIV,Nott'ham Forest,Premier League,2024,27.0,1997.0,2.4,15,9,5,10,0,4,8,50.0,4,4,0,4,2,17,2,0,MF,25-29,Midfielder,Ivory Coast,Africa
1963,Nhoa Sangui,FRA,Reims,Ligue 1,2024,18.0,2006.0,6.4,8,4,1,4,3,3,6,50.0,3,6,2,4,3,11,12,0,DF,Under 20,Defender,France,Europe
1964,Kaishu Sano,JPN,Mainz 05,Bundesliga,2024,23.0,2000.0,14.8,32,21,9,18,5,11,24,45.8,13,35,10,25,27,59,22,0,MF,20-24,Midfielder,Japan,Asia
1965,Nicola Sansone,ITA,Lecce,Serie A,2024,33.0,1991.0,0.6,0,0,0,0,0,0,0,,0,0,0,0,0,0,0,0,"MF,FW",30-34,Midfielder,Italy,Europe
1966,Baptiste Santamaria,FRA,Rennes,Ligue 1,2024,29.0,1995.0,5.4,11,4,7,3,1,6,11,54.5,5,10,4,6,12,23,7,0,MF,25-29,Midfielder,France,Europe
1968,Andrey Santos,BRA,Strasbourg,Ligue 1,2024,20.0,2004.0,13.7,54,36,26,24,4,25,42,59.5,17,15,4,11,13,67,19,0,MF,20-24,Midfielder,Brazil,South America
1969,Kauã Santos,BRA,Eint Frankfurt,Bundesliga,2024,21.0,2003.0,4.5,0,0,0,0,0,0,0,,0,0,0,0,0,0,2,2,GK,20-24,Goalkeeper,Brazil,South America
1970,Tiago Santos,POR,Lille,Ligue 1,2024,22.0,2002.0,4.5,12,7,4,5,3,6,9,66.7,3,2,0,2,2,14,4,0,DF,20-24,Defender,Portugal,Europe
1972,Jeremy Sarmiento,ECU,Brighton,Premier League,2024,22.0,2002.0,0.1,0,0,0,0,0,0,0,,0,0,0,0,0,0,0,0,MF,20-24,Midfielder,Ecuador,South America
1973,Amin Sarr,SWE,Hellas Verona,Serie A,2024,23.0,2001.0,4.1,7,4,2,2,3,3,4,75.0,1,3,1,2,1,8,4,0,FW,20-24,Forward,Sweden,Europe
1974,Ismaila Sarr,SEN,Crystal Palace,Premier League,2024,26.0,1998.0,11.2,9,5,3,5,1,1,9,11.1,8,11,3,8,5,14,9,0,"MF,FW",25-29,Midfielder,Senegal,Africa
1975,Malang Sarr,FRA,Lens,Ligue 1,2024,25.0,1999.0,2.3,1,0,1,0,0,0,0,,0,4,1,3,5,6,3,0,DF,25-29,Defender,France,Europe
1976,Mamadou Sarr,FRA,Strasbourg,Ligue 1,2024,19.0,2005.0,8.5,16,10,8,8,0,9,14,64.3,5,6,5,1,9,25,30,0,DF,Under 20,Defender,France,Europe
1977,Martin Satriano,URU,Lens,Ligue 1,2024,23.0,2001.0,0.5,3,1,1,1,1,3,3,100.0,0,0,0,0,0,3,2,0,"FW,DF",20-24,Forward,Uruguay,South America
1978,Razvan Sava,ROU,Udinese,Serie A,2024,22.0,2002.0,3.0,0,0,0,0,0,0,0,,0,0,0,0,0,0,3,1,GK,20-24,Goalkeeper,Romania,Europe
1979,Téji Savanier,FRA,Montpellier,Ligue 1,2024,33.0,1991.0,12.3,14,11,4,6,4,11,25,44.0,14,4,0,4,10,24,9,2,MF,30-34,Midfielder,France,Europe
1980,Sávio,BRA,Manchester City,Premier League,2024,20.0,2004.0,8.1,16,10,3,8,5,3,7,42.9,4,4,0,4,1,17,3,1,"FW,MF",20-24,Forward,Brazil,South America
1981,Nicolò Savona,ITA,Juventus,Serie A,2024,21.0,2003.0,10.4,17,9,8,8,1,8,14,57.1,6,4,1,3,6,23,9,0,DF,20-24,Defender,Italy,Europe
1982,Saba Sazonov,GEO,Torino,Serie A,2024,22.0,2002.0,0.0,0,0,0,0,0,0,0,,0,1,1,0,0,0,0,0,DF,20-24,Defender,Georgia,Asia
1983,Joe Scally,USA,Gladbach,Bundesliga,2024,21.0,2002.0,13.9,22,16,15,7,0,13,24,54.2,11,21,8,13,9,31,37,1,DF,20-24,Defender,United States,North America
1984,Giorgio Scalvini,ITA,Atalanta,Serie A,2024,21.0,2003.0,0.1,1,1,1,0,0,1,1,100.0,0,0,0,0,0,1,1,0,DF,20-24,Defender,Italy,Europe
1985,Oliver Scarles,ENG,West Ham,Premier League,2024,19.0,2005.0,0.4,1,0,1,0,0,1,1,100.0,0,1,0,1,0,1,0,0,DF,Under 20,Defender,England,Europe
1986,Kevin Schade,GER,Brentford,Premier League,2024,23.0,2001.0,8.4,19,14,8,5,6,9,12,75.0,3,6,1,5,1,20,9,0,FW,20-24,Forward,Germany,Europe
1987,András Schäfer,HUN,Union Berlin,Bundesliga,2024,25.0,1999.0,7.5,24,12,10,11,3,14,20,70.0,6,15,1,14,12,36,13,0,MF,25-29,Midfielder,Hungary,Europe
1988,Fabian Schär,SUI,Newcastle Utd,Premier League,2024,33.0,1991.0,14.3,13,8,4,9,0,3,12,25.0,9,20,12,8,21,34,51,0,DF,30-34,Defender,Switzerland,Europe
1990,Stefan Schimmer,GER,Heidenheim,Bundesliga,2024,30.0,1994.0,1.9,2,0,1,1,0,1,1,100.0,0,1,0,1,0,2,0,0,"FW,MF",30-34,Forward,Germany,Europe
1991,Joël Schingtienne,BEL,Venezia,Serie A,2024,22.0,2002.0,1.0,4,4,3,1,0,1,1,100.0,0,2,0,2,2,6,2,0,DF,20-24,Defender,Belgium,Europe
1992,Xaver Schlager,AUT,RB Leipzig,Bundesliga,2024,27.0,1997.0,2.0,4,2,2,1,1,3,7,42.9,4,7,0,7,0,4,3,0,MF,25-29,Midfielder,Austria,Europe
1993,Keven Schlotterbeck,GER,Augsburg,Bundesliga,2024,27.0,1997.0,11.5,11,10,4,7,0,6,10,60.0,4,11,5,6,10,21,57,1,DF,25-29,Defender,Germany,Europe
1994,Nico Schlotterbeck,GER,Dortmund,Bundesliga,2024,25.0,1999.0,13.8,30,19,16,13,1,23,35,65.7,12,20,10,10,18,48,52,0,DF,25-29,Defender,Germany,Europe
1995,Jeffrey Schlupp,GHA,Crystal Palace,Premier League,2024,32.0,1992.0,1.1,2,0,1,0,1,0,3,0.0,3,6,0,6,0,2,2,0,"MF,DF",30-34,Midfielder,Ghana,Africa
1996,Romano Schmid,AUT,Werder Bremen,Bundesliga,2024,24.0,2000.0,14.8,21,10,4,12,5,12,30,40.0,18,21,1,20,10,31,5,0,MF,20-24,Midfielder,Austria,Europe
1997,Niklas Schmidt,GER,Toulouse,Ligue 1,2024,26.0,1998.0,2.3,6,4,1,5,0,4,7,57.1,3,0,0,0,1,7,4,0,MF,25-29,Midfielder,Germany,Europe
1998,Jan Schöppner,GER,Heidenheim,Bundesliga,2024,25.0,1999.0,13.5,25,12,6,11,8,13,32,40.6,19,18,2,16,21,46,41,1,MF,25-29,Midfielder,Germany,Europe
1999,Marvin Schulz,GER,Holstein Kiel,Bundesliga,2024,29.0,1995.0,2.9,5,4,2,2,1,2,8,25.0,6,10,6,4,0,5,10,0,"DF,MF",25-29,Defender,Germany,Europe
2000,Alexander Schwolow,GER,Union Berlin,Bundesliga,2024,32.0,1992.0,1.0,0,0,0,0,0,0,0,,0,0,0,0,0,0,0,0,GK,30-34,Goalkeeper,Germany,Europe
2001,Léo Scienza,BRA,Heidenheim,Bundesliga,2024,26.0,1998.0,8.2,12,8,7,4,1,4,10,40.0,6,8,1,7,4,16,7,1,"FW,MF",25-29,Forward,Brazil,South America
2002,Alex Scott,ENG,Bournemouth,Premier League,2024,21.0,2003.0,2.9,16,7,8,4,4,12,16,75.0,4,9,1,8,6,22,5,0,MF,20-24,Midfielder,England,Europe
2003,Simone Scuffet,ITA,Cagliari,Serie A,2024,28.0,1996.0,11.0,0,0,0,0,0,0,1,0.0,1,0,0,0,0,0,7,2,GK,25-29,Goalkeeper,Italy,Europe
2006,Alidu Seidu,GHA,Rennes,Ligue 1,2024,24.0,2000.0,8.9,22,18,14,6,2,12,15,80.0,3,13,6,7,14,36,17,0,DF,20-24,Defender,Ghana,Africa
2007,Nicolas Seiwald,AUT,RB Leipzig,Bundesliga,2024,23.0,2001.0,7.8,20,14,10,10,0,10,22,45.5,12,10,2,8,15,35,24,1,"MF,DF",20-24,Midfielder,Austria,Europe
2008,Matz Sels,BEL,Nott'ham Forest,Premier League,2024,32.0,1992.0,17.0,1,1,1,0,0,1,1,100.0,0,0,0,0,0,1,12,0,GK,30-34,Goalkeeper,Belgium,Europe
2009,Nélson Semedo,POR,Wolves,Premier League,2024,31.0,1993.0,13.6,34,19,23,6,5,17,32,53.1,15,17,6,11,7,41,61,1,DF,30-34,Defender,Portugal,Europe
2010,Antoine Semenyo,GHA,Bournemouth,Premier League,2024,24.0,2000.0,15.4,25,16,10,11,4,5,17,29.4,12,31,4,27,4,29,14,0,FW,20-24,Forward,Ghana,Africa
2012,Marcos Senesi,ARG,Bournemouth,Premier League,2024,27.0,1997.0,10.2,33,21,21,10,2,13,26,50.0,13,14,6,8,11,44,42,0,DF,25-29,Defender,Argentina,South America
2013,Stefano Sensi,ITA,Monza,Serie A,2024,29.0,1995.0,0.5,2,2,0,2,0,1,2,50.0,1,0,0,0,0,2,0,0,MF,25-29,Midfielder,Italy,Europe
2014,Suat Serdar,GER,Hellas Verona,Serie A,2024,27.0,1997.0,6.1,12,8,5,7,0,3,10,30.0,7,4,1,3,4,16,5,0,MF,25-29,Midfielder,Germany,Europe
2018,Ryan Sessegnon,ENG,Fulham,Premier League,2024,24.0,2000.0,0.1,0,0,0,0,0,0,1,0.0,1,0,0,0,1,1,1,0,MF,20-24,Midfielder,England,Europe
2019,Stephan El Shaarawy,ITA,Roma,Serie A,2024,32.0,1992.0,7.3,9,7,2,3,4,3,5,60.0,2,2,0,2,4,13,5,0,"DF,MF",30-34,Defender,Italy,Europe
2020,Luke Shaw,ENG,Manchester Utd,Premier League,2024,29.0,1995.0,0.8,2,2,1,1,0,1,1,100.0,0,1,0,1,1,3,1,0,DF,25-29,Defender,England,Europe
2021,Alen Sherri,ALB,Cagliari,Serie A,2024,27.0,1997.0,6.0,1,0,1,0,0,1,2,50.0,1,0,0,0,0,1,1,0,GK,25-29,Goalkeeper,Albania,Europe
2022,Eldor Shomurodov,UZB,Roma,Serie A,2024,29.0,1995.0,1.3,1,0,0,1,0,0,1,0.0,1,2,0,2,0,1,0,0,"FW,MF",25-29,Forward,Uzbekistan,Asia
2023,Djibril Sidibé,FRA,Toulouse,Ligue 1,2024,32.0,1992.0,11.1,35,19,17,13,5,17,28,60.7,11,6,1,5,14,49,27,0,DF,30-34,Defender,France,Europe
2024,Armindo Sieb,GER,Mainz 05,Bundesliga,2024,21.0,2003.0,5.6,6,3,3,2,1,2,8,25.0,6,2,0,2,1,7,6,0,"FW,MF",20-24,Forward,Germany,Europe
2025,Vincent Sierro,SUI,Toulouse,Ligue 1,2024,29.0,1995.0,13.7,26,17,9,15,2,16,33,48.5,17,21,3,18,11,37,26,1,MF,25-29,Midfielder,Switzerland,Europe
2026,Tim Siersleben,GER,Heidenheim,Bundesliga,2024,24.0,2000.0,2.6,3,2,3,0,0,2,4,50.0,2,4,1,3,3,6,16,0,DF,20-24,Defender,Germany,Europe
2027,Kiliann Sildillia,FRA,Freiburg,Bundesliga,2024,22.0,2002.0,0.8,1,0,0,0,1,0,0,,0,1,0,1,0,1,5,0,"FW,MF",20-24,Forward,France,Europe
2028,André Silva,POR,RB Leipzig,Bundesliga,2024,29.0,1995.0,1.4,1,1,1,0,0,0,1,0.0,1,1,0,1,1,2,2,0,FW,25-29,Forward,Portugal,Europe
2028,André Silva,POR,RB Leipzig,Bundesliga,2024,29.0,1995.0,1.4,1,1,1,0,0,0,1,0.0,1,1,0,1,1,2,2,0,FW,25-29,Forward,Portugal,Europe
2028,André Silva,POR,RB Leipzig,Bundesliga,2024,29.0,1995.0,1.4,1,1,1,0,0,0,1,0.0,1,1,0,1,1,2,2,0,FW,25-29,Forward,Portugal,Europe
2028,André Silva,POR,RB Leipzig,Bundesliga,2024,29.0,1995.0,1.4,1,1,1,0,0,0,1,0.0,1,1,0,1,1,2,2,0,FW,25-29,Forward,Portugal,Europe
2028,André Silva,POR,RB Leipzig,Bundesliga,2024,29.0,1995.0,1.4,1,1,1,0,0,0,1,0.0,1,1,0,1,1,2,2,0,FW,25-29,Forward,Portugal,Europe
2028,André Silva,POR,RB Leipzig,Bundesliga,2024,29.0,1995.0,1.4,1,1,1,0,0,0,1,0.0,1,1,0,1,1,2,2,0,FW,25-29,Forward,Portugal,Europe
2028,André Silva,POR,RB Leipzig,Bundesliga,2024,29.0,1995.0,1.4,1,1,1,0,0,0,1,0.0,1,1,0,1,1,2,2,0,FW,25-29,Forward,Portugal,Europe
2028,André Silva,POR,RB Leipzig,Bundesliga,2024,29.0,1995.0,1.4,1,1,1,0,0,0,1,0.0,1,1,0,1,1,2,2,0,FW,25-29,Forward,Portugal,Europe
2028,André Silva,POR,RB Leipzig,Bundesliga,2024,29.0,1995.0,1.4,1,1,1,0,0,0,1,0.0,1,1,0,1,1,2,2,0,FW,25-29,Forward,Portugal,Europe
2029,Bernardo Silva,POR,Manchester City,Premier League,2024,30.0,1994.0,15.3,16,11,3,8,5,7,23,30.4,16,19,3,16,11,27,12,3,"MF,FW",30-34,Midfielder,Portugal,Europe
2030,Caio Henrique Oliveira Silva,BRA,Monaco,Ligue 1,2024,27.0,1997.0,7.6,14,11,7,6,1,7,13,53.8,6,8,1,7,4,18,17,0,DF,25-29,Defender,Brazil,South America
2031,Fábio Silva,POR,Las Palmas,La Liga,2024,22.0,2002.0,10.7,5,1,1,2,2,1,8,12.5,7,8,0,8,3,8,14,0,"FW,MF",20-24,Forward,Portugal,Europe
2032,Jota Silva,POR,Nott'ham Forest,Premier League,2024,25.0,1999.0,5.8,11,5,5,5,1,2,14,14.3,12,4,0,4,10,21,9,0,"FW,MF",25-29,Forward,Portugal,Europe
2033,Eric da Silva Moreira,GER,Nott'ham Forest,Premier League,2024,18.0,2006.0,0.3,2,2,2,0,0,2,6,33.3,4,0,0,0,1,3,0,0,"MF,DF",Under 20,Midfielder,Germany,Europe
2034,Rui Silva,POR,Betis,La Liga,2024,30.0,1994.0,15.0,0,0,0,0,0,0,1,0.0,1,1,0,1,0,0,7,0,GK,30-34,Goalkeeper,Portugal,Europe
2034,Rui Silva,POR,Betis,La Liga,2024,30.0,1994.0,15.0,0,0,0,0,0,0,1,0.0,1,1,0,1,0,0,7,0,GK,30-34,Goalkeeper,Portugal,Europe
2034,Rui Silva,POR,Betis,La Liga,2024,30.0,1994.0,15.0,0,0,0,0,0,0,1,0.0,1,1,0,1,0,0,7,0,GK,30-34,Goalkeeper,Portugal,Europe
2034,Rui Silva,POR,Betis,La Liga,2024,30.0,1994.0,15.0,0,0,0,0,0,0,1,0.0,1,1,0,1,0,0,7,0,GK,30-34,Goalkeeper,Portugal,Europe
2035,Abdallah Sima,SEN,Brest,Ligue 1,2024,23.0,2001.0,4.6,3,3,0,2,1,2,4,50.0,2,1,0,1,1,4,3,0,FW,20-24,Forward,Senegal,Africa
2036,Mohamed Simakan,FRA,RB Leipzig,Bundesliga,2024,24.0,2000.0,0.6,0,0,0,0,0,0,0,,0,0,0,0,2,2,0,0,DF,20-24,Defender,France,Europe
2037,Giovanni Simeone,ARG,Napoli,Serie A,2024,29.0,1995.0,2.9,0,0,0,0,0,0,3,0.0,3,3,0,3,1,1,2,0,FW,25-29,Forward,Argentina,South America
2038,Giuliano Simeone,ARG,Atlético Madrid,La Liga,2024,22.0,2002.0,6.8,8,4,1,3,4,5,8,62.5,3,10,1,9,5,13,5,0,"MF,DF",20-24,Midfielder,Argentina,South America
2039,Moses Simon,NGA,Nantes,Ligue 1,2024,29.0,1995.0,13.1,9,7,2,4,3,5,12,41.7,7,5,0,5,9,18,4,0,FW,25-29,Forward,Nigeria,Africa
2041,Xavi Simons,NED,RB Leipzig,Bundesliga,2024,21.0,2003.0,6.8,8,7,2,5,1,3,5,60.0,2,3,1,2,2,10,6,0,MF,20-24,Midfielder,Netherlands,Europe
2042,Jahmai Simpson-Pusey,ENG,Manchester City,Premier League,2024,19.0,2005.0,1.0,1,0,1,0,0,0,0,,0,1,1,0,0,1,2,0,DF,Under 20,Defender,England,Europe
2043,Danel Sinani,LUX,St. Pauli,Bundesliga,2024,27.0,1997.0,2.7,5,4,0,2,3,1,3,33.3,2,3,0,3,1,6,4,0,"FW,MF",25-29,Forward,Luxembourg,Europe
2044,Lassine Sinayoko,MLI,Auxerre,Ligue 1,2024,25.0,1999.0,11.6,15,8,6,4,5,7,12,58.3,5,9,1,8,9,24,24,0,"FW,MF",25-29,Forward,Mali,Africa
2045,Wilfried Singo,CIV,Monaco,Ligue 1,2024,24.0,2000.0,12.2,21,15,13,7,1,10,14,71.4,4,4,2,2,26,47,50,1,DF,20-24,Defender,Ivory Coast,Africa
2046,Luis Sinisterra,COL,Bournemouth,Premier League,2024,25.0,1999.0,2.3,5,1,1,2,2,0,4,0.0,4,3,0,3,0,5,5,0,"FW,MF",25-29,Forward,Colombia,South America
2047,Daley Sinkgraven,NED,Las Palmas,La Liga,2024,29.0,1995.0,1.0,5,1,3,2,0,1,3,33.3,2,1,0,1,1,6,2,0,DF,25-29,Defender,Netherlands,Europe
2048,Jailson Siqueira,BRA,Celta Vigo,La Liga,2024,29.0,1995.0,5.0,7,7,5,2,0,5,6,83.3,1,5,3,2,8,15,18,1,"DF,MF",25-29,Defender,Brazil,South America
2,Rodrigo Abajas,ESP,Valencia,La Liga,2024,21.0,2003.0,0.7,3,2,2,1,0,3,3,100.0,0,1,0,1,1,4,0,0,DF,20-24,Defender,Spain,Europe
10,Abel,ESP,Osasuna,La Liga,2024,24.0,2000.0,11.7,24,17,11,8,5,14,28,50.0,14,16,2,14,10,34,34,0,"DF,FW",20-24,Defender,Spain,Europe
37,Julen Agirrezabala,ESP,Athletic Club,La Liga,2024,24.0,2000.0,13.4,0,0,0,0,0,0,1,0.0,1,0,0,0,0,0,4,0,GK,20-24,Goalkeeper,Spain,Europe
40,Álvaro Aguado,ESP,Espanyol,La Liga,2024,28.0,1996.0,3.6,4,2,2,2,0,2,6,33.3,4,5,0,5,2,6,5,1,MF,25-29,Midfielder,Spain,Europe
50,Kristoffer Ajer,NOR,Brentford,Premier League,2024,26.0,1998.0,8.0,9,7,7,2,0,4,12,33.3,8,8,1,7,6,15,23,0,DF,25-29,Defender,Norway,Europe
56,Sergio Akieme,ESP,Reims,Ligue 1,2024,27.0,1997.0,11.9,17,12,15,1,1,12,16,75.0,4,10,4,6,7,24,36,3,DF,25-29,Defender,Spain,Europe
62,Raúl Albiol,ESP,Villarreal,La Liga,2024,39.0,1985.0,13.2,10,9,9,1,0,6,10,60.0,4,10,9,1,6,16,69,1,DF,35-39,Defender,Spain,Europe
65,Carles Aleñá,ESP,Getafe,La Liga,2024,26.0,1998.0,3.5,6,3,2,3,1,4,8,50.0,4,7,1,6,0,6,2,0,"MF,FW",25-29,Midfielder,Spain,Europe
67,Alfon,ESP,Celta Vigo,La Liga,2024,25.0,1999.0,4.2,3,1,0,2,1,1,4,25.0,3,3,0,3,2,5,2,0,"FW,MF",25-29,Forward,Spain,Europe
74,Iker Almena,ESP,Girona,La Liga,2024,20.0,2004.0,0.5,0,0,0,0,0,0,1,0.0,1,1,0,1,0,0,2,0,"FW,DF",20-24,Forward,Spain,Europe
77,Marcos Alonso,ESP,Celta Vigo,La Liga,2024,33.0,1990.0,13.0,14,9,8,3,3,10,18,55.6,8,10,4,6,14,28,59,1,DF,30-34,Defender,Spain,Europe
79,Adrià Altimira,ESP,Leganés,La Liga,2024,23.0,2001.0,8.6,20,9,11,7,2,10,19,52.6,9,7,4,3,12,32,26,2,"DF,FW",20-24,Defender,Spain,Europe
80,Sergi Altimira,ESP,Betis,La Liga,2024,23.0,2001.0,11.8,31,20,8,19,4,18,32,56.3,14,18,1,17,9,40,15,1,MF,20-24,Midfielder,Spain,Europe
82,Hugo Álvarez,ESP,Celta Vigo,La Liga,2024,21.0,2003.0,13.5,23,9,11,10,2,9,16,56.3,7,17,1,16,7,30,22,1,"MF,DF",20-24,Midfielder,Spain,Europe
84,Yeray Álvarez,ESP,Athletic Club,La Liga,2024,29.0,1995.0,9.0,10,7,6,3,1,4,7,57.1,3,6,3,3,18,28,33,1,DF,25-29,Defender,Spain,Europe
104,Angeliño,ESP,Roma,Serie A,2024,27.0,1997.0,16.0,26,10,10,14,2,9,14,64.3,5,19,6,13,12,38,39,0,DF,25-29,Defender,Spain,Europe
109,Antoniu,ESP,Espanyol,La Liga,2024,22.0,2002.0,3.0,6,3,1,2,3,2,4,50.0,2,6,0,6,2,8,2,1,"MF,DF",20-24,Midfielder,Spain,Europe
113,Aritz Arambarri,ESP,Leganés,La Liga,2024,26.0,1998.0,2.0,1,1,1,0,0,1,1,100.0,0,2,2,0,3,4,8,0,DF,25-29,Defender,Spain,Europe
120,Adu Ares,ESP,Athletic Club,La Liga,2024,23.0,2001.0,0.2,0,0,0,0,0,0,1,0.0,1,0,0,0,0,0,0,0,FW,20-24,Forward,Spain,Europe
121,Jesús Areso,ESP,Osasuna,La Liga,2024,25.0,1999.0,16.7,28,19,19,6,3,22,33,66.7,11,17,3,14,6,34,47,0,DF,25-29,Defender,Spain,Europe
122,David Argüelles,ESP,Getafe,La Liga,2024,22.0,2002.0,0.1,0,0,0,0,0,0,0,,0,2,0,2,0,0,0,0,MF,20-24,Midfielder,Spain,Europe
126,José Arnaiz,ESP,Osasuna,La Liga,2024,29.0,1995.0,0.4,2,2,1,1,0,1,2,50.0,1,0,0,0,1,3,1,0,"FW,MF",25-29,Forward,Spain,Europe
131,Kepa Arrizabalaga,ESP,Bournemouth,Premier League,2024,30.0,1994.0,12.0,0,0,0,0,0,0,1,0.0,1,0,0,0,0,0,5,2,GK,30-34,Goalkeeper,Spain,Europe
134,Raúl Asencio,ESP,Real Madrid,La Liga,2024,21.0,2003.0,3.9,7,5,7,0,0,2,3,66.7,1,0,0,0,3,10,24,1,DF,20-24,Defender,Spain,Europe
134,Raúl Asencio,ESP,Real Madrid,La Liga,2024,21.0,2003.0,3.9,7,5,7,0,0,2,3,66.7,1,0,0,0,3,10,24,1,DF,20-24,Defender,Spain,Europe
134,Raúl Asencio,ESP,Real Madrid,La Liga,2024,21.0,2003.0,3.9,7,5,7,0,0,2,3,66.7,1,0,0,0,3,10,24,1,DF,20-24,Defender,Spain,Europe
134,Raúl Asencio,ESP,Real Madrid,La Liga,2024,21.0,2003.0,3.9,7,5,7,0,0,2,3,66.7,1,0,0,0,3,10,24,1,DF,20-24,Defender,Spain,Europe
135,Marco Asensio,ESP,Paris S-G,Ligue 1,2024,28.0,1996.0,6.8,4,3,1,3,0,0,6,0.0,6,1,0,1,0,4,1,0,"FW,MF",25-29,Forward,Spain,Europe
137,Iago Aspas,ESP,Celta Vigo,La Liga,2024,37.0,1987.0,13.4,11,7,4,4,3,8,16,50.0,8,13,1,12,6,17,4,0,"FW,MF",35-39,Forward,Spain,Europe
139,Lorenz Assignon,TOG,Rennes,Ligue 1,2024,24.0,2000.0,9.5,18,11,9,8,1,8,21,38.1,13,10,3,7,12,30,38,0,"DF,MF",20-24,Defender,Togo,Africa
158,César Azpilicueta,ESP,Atlético Madrid,La Liga,2024,35.0,1989.0,5.3,12,5,6,4,2,10,14,71.4,4,2,1,1,2,14,14,0,DF,35-39,Defender,Spain,Europe
160,Papa Ba,ESP,Girona,La Liga,2024,20.0,2004.0,0.5,1,1,1,0,0,0,0,,0,1,0,1,0,1,1,0,MF,20-24,Midfielder,Spain,Europe
166,Alex Baena,ESP,Villarreal,La Liga,2024,23.0,2001.0,14.2,10,4,2,6,2,3,12,25.0,9,18,2,16,14,24,9,1,"MF,FW",20-24,Midfielder,Spain,Europe
176,Alejandro Balde,ESP,Barcelona,La Liga,2024,21.0,2003.0,14.3,10,5,6,3,1,6,9,66.7,3,13,4,9,5,15,13,0,DF,20-24,Defender,Spain,Europe
191,Adrian Baquerin,ESP,Valladolid,La Liga,2024,17.0,2007.0,0.0,0,0,0,0,0,0,0,,0,0,0,0,0,0,0,0,FW,Under 20,Forward,Spain,Europe
192,Antonín Barák,CZE,Fiorentina,Serie A,2024,30.0,1994.0,0.6,2,0,0,2,0,0,2,0.0,2,1,1,0,0,2,0,0,MF,30-34,Midfielder,Czech Republic,Europe
199,Kike Barja,ESP,Osasuna,La Liga,2024,27.0,1997.0,0.8,1,1,0,1,0,0,1,0.0,1,0,0,0,2,3,0,0,FW,25-29,Forward,Spain,Europe
204,Ander Barrenetxea,ESP,Real Sociedad,La Liga,2024,22.0,2001.0,7.0,11,10,3,6,2,2,11,18.2,9,10,0,10,6,17,12,0,"MF,FW",20-24,Midfielder,Spain,Europe
205,Pablo Barrios,ESP,Atlético Madrid,La Liga,2024,21.0,2003.0,11.8,22,15,8,13,1,7,18,38.9,11,5,1,4,18,40,16,3,MF,20-24,Midfielder,Spain,Europe
208,Marc Bartra,ESP,Betis,La Liga,2024,33.0,1991.0,10.3,13,8,10,3,0,7,10,70.0,3,12,7,5,23,36,61,0,DF,30-34,Defender,Spain,Europe
219,Rafael Bauza,ESP,Espanyol,La Liga,2024,19.0,2005.0,1.9,4,2,2,1,1,3,5,60.0,2,3,1,2,0,4,4,0,MF,Under 20,Midfielder,Spain,Europe
223,Jan Bednarek,POL,Southampton,Premier League,2024,28.0,1996.0,12.9,9,4,7,2,0,4,11,36.4,7,20,17,3,22,31,70,2,DF,25-29,Defender,Poland,Europe
234,Héctor Bellerín,ESP,Betis,La Liga,2024,29.0,1995.0,5.8,12,7,6,4,2,9,16,56.3,7,4,3,1,6,18,18,0,DF,25-29,Defender,Spain,Europe
238,Fran Beltrán,ESP,Celta Vigo,La Liga,2024,25.0,1999.0,11.9,24,16,12,9,3,11,25,44.0,14,15,4,11,8,32,18,2,MF,25-29,Midfielder,Spain,Europe
242,Adrian Benedyczak,POL,Parma,Serie A,2024,24.0,2000.0,1.7,0,0,0,0,0,0,1,0.0,1,2,1,1,0,0,3,0,"FW,MF",20-24,Forward,Poland,Europe
244,Iker Benito,ESP,Osasuna,La Liga,2024,22.0,2002.0,0.4,0,0,0,0,0,0,1,0.0,1,0,0,0,1,1,2,0,"FW,MF",20-24,Forward,Spain,Europe
250,Yuri Berchiche,ESP,Athletic Club,La Liga,2024,34.0,1990.0,12.6,17,9,11,5,1,9,17,52.9,8,13,2,11,13,30,35,1,DF,30-34,Defender,Spain,Europe
251,Álex Berenguer,ESP,Athletic Club,La Liga,2024,29.0,1995.0,11.5,14,6,2,7,5,9,14,64.3,5,6,2,4,5,19,6,0,"FW,MF",25-29,Forward,Spain,Europe
252,Sander Berge,NOR,Fulham,Premier League,2024,26.0,1998.0,10.6,26,16,11,13,2,13,21,61.9,8,15,6,9,14,40,18,0,MF,25-29,Midfielder,Norway,Europe
256,Adrian Bernabe,ESP,Parma,Serie A,2024,23.0,2001.0,10.0,21,13,14,6,1,12,26,46.2,14,18,9,9,6,27,16,0,MF,20-24,Midfielder,Spain,Europe
257,Marc Bernal,ESP,Barcelona,La Liga,2024,17.0,2007.0,2.7,8,6,2,5,1,7,8,87.5,1,5,1,4,1,9,4,0,MF,Under 20,Midfielder,Spain,Europe
259,Juan Bernat,ESP,Villarreal,La Liga,2024,31.0,1993.0,2.4,9,7,7,1,1,4,5,80.0,1,3,1,2,1,10,4,0,"DF,MF",30-34,Defender,Spain,Europe
263,Juan Berrocal,ESP,Getafe,La Liga,2024,25.0,1999.0,6.8,11,4,9,2,0,8,11,72.7,3,1,1,0,9,20,31,0,DF,25-29,Defender,Spain,Europe
269,Jaka Bijol,SVN,Udinese,Serie A,2024,25.0,1999.0,15.0,21,13,14,7,0,12,22,54.5,10,18,9,9,17,38,75,1,DF,25-29,Defender,Slovenia,Europe
280,Antonio Blanco,ESP,Alavés,La Liga,2024,24.0,2000.0,13.1,29,19,10,18,1,14,35,40.0,21,16,5,11,23,52,20,1,MF,20-24,Midfielder,Spain,Europe
288,Emil Bohinen,NOR,Genoa,Serie A,2024,25.0,1999.0,1.8,4,4,3,0,1,2,5,40.0,3,2,0,2,1,5,6,0,MF,25-29,Midfielder,Norway,Europe
289,Adama Boiro,ESP,Athletic Club,La Liga,2024,22.0,2002.0,5.2,10,4,4,4,2,4,7,57.1,3,5,3,2,6,16,16,0,DF,20-24,Defender,Spain,Europe
308,Conor Bradley,NIR,Liverpool,Premier League,2024,21.0,2003.0,2.6,3,2,1,1,1,3,9,33.3,6,0,0,0,2,5,11,0,DF,20-24,Defender,Northern Ireland,Europe
312,Darko Brašanac,SRB,Leganés,La Liga,2024,32.0,1992.0,9.6,13,5,2,6,5,4,9,44.4,5,10,6,4,7,20,25,0,MF,30-34,Midfielder,Serbia,Europe
315,Iker Bravo,ESP,Udinese,Serie A,2024,19.0,2005.0,2.7,5,3,1,4,0,2,3,66.7,1,0,0,0,0,5,2,0,"FW,MF",Under 20,Forward,Spain,Europe
332,Manu Bueno,ESP,Sevilla,La Liga,2024,20.0,2004.0,0.8,3,3,0,1,2,1,1,100.0,0,0,0,0,0,3,2,0,MF,20-24,Midfielder,Spain,Europe
345,Marcin Bułka,POL,Nice,Ligue 1,2024,25.0,1999.0,15.0,0,0,0,0,0,0,0,,0,0,0,0,0,0,7,3,GK,25-29,Goalkeeper,Poland,Europe
346,Pau Cabanes,ESP,Villarreal,La Liga,2024,19.0,2005.0,1.1,3,3,0,2,1,2,2,100.0,0,3,0,3,0,3,1,1,"MF,FW",Under 20,Midfielder,Spain,Europe
358,Fernando Calero,ESP,Espanyol,La Liga,2024,29.0,1995.0,2.1,4,2,4,0,0,1,2,50.0,1,3,3,0,5,9,20,0,DF,25-29,Defender,Spain,Europe
371,Sergio Camello,ESP,Rayo Vallecano,La Liga,2024,23.0,2001.0,9.7,9,3,2,5,2,4,6,66.7,2,8,1,7,4,13,15,0,FW,20-24,Forward,Spain,Europe
372,José Campaña,ESP,Las Palmas,La Liga,2024,31.0,1993.0,8.0,13,11,5,6,2,7,11,63.6,4,2,0,2,15,28,12,1,MF,30-34,Midfielder,Spain,Europe
375,Peio Canales,ESP,Athletic Club,La Liga,2024,19.0,2005.0,0.2,1,1,0,0,1,0,0,,0,0,0,0,1,2,1,0,MF,Under 20,Midfielder,Spain,Europe
378,Sergi Canós,ESP,Valencia,La Liga,2024,27.0,1997.0,3.1,8,4,1,4,3,3,6,50.0,3,3,0,3,3,11,2,0,"MF,FW",25-29,Midfielder,Spain,Europe
388,Cárdenas,ESP,Rayo Vallecano,La Liga,2024,27.0,1997.0,4.0,0,0,0,0,0,0,0,,0,0,0,0,0,0,3,0,GK,25-29,Goalkeeper,Spain,Europe
390,Marc Cardona,ESP,Las Palmas,La Liga,2024,29.0,1995.0,0.8,1,0,0,1,0,0,0,,0,0,0,0,0,1,0,0,FW,25-29,Forward,Spain,Europe
391,Sergi Cardona,ESP,Villarreal,La Liga,2024,25.0,1999.0,16.7,33,24,18,12,3,23,37,62.2,14,33,7,26,21,54,56,0,DF,25-29,Defender,Spain,Europe
395,Carmona,ESP,Sevilla,La Liga,2024,22.0,2002.0,16.7,44,31,28,13,3,20,36,55.6,16,18,6,12,39,83,45,1,DF,20-24,Defender,Spain,Europe
397,Sergio Carreira,ESP,Celta Vigo,La Liga,2024,24.0,2000.0,3.4,7,4,4,2,1,3,5,60.0,2,6,1,5,2,9,12,0,"MF,DF",20-24,Midfielder,Spain,Europe
398,Dani Carvajal,ESP,Real Madrid,La Liga,2024,32.0,1992.0,6.8,12,8,7,3,2,9,12,75.0,3,8,3,5,10,22,19,1,DF,30-34,Defender,Spain,Europe
401,Marc Casado,ESP,Barcelona,La Liga,2024,21.0,2003.0,13.1,32,18,6,20,6,14,27,51.9,13,16,5,11,13,45,16,1,MF,20-24,Midfielder,Spain,Europe
406,Matty Cash,POL,Aston Villa,Premier League,2024,27.0,1997.0,9.2,24,11,16,7,1,10,17,58.8,7,9,4,5,13,37,24,1,"DF,FW",25-29,Defender,Poland,Europe
416,Catena,ESP,Osasuna,La Liga,2024,30.0,1994.0,16.0,25,14,19,6,0,15,25,60.0,10,17,10,7,18,43,101,0,DF,30-34,Defender,Spain,Europe
418,Dani Ceballos,ESP,Real Madrid,La Liga,2024,28.0,1996.0,4.8,19,8,10,6,3,8,14,57.1,6,4,0,4,4,23,3,1,MF,25-29,Midfielder,Spain,Europe
431,Raúl Chasco,ESP,Valladolid,La Liga,2024,21.0,2003.0,1.4,4,1,3,1,0,2,4,50.0,2,1,0,1,2,6,2,0,DF,20-24,Defender,Spain,Europe
433,Pep Chavarría,ESP,Rayo Vallecano,La Liga,2024,26.0,1998.0,10.3,19,13,13,6,0,12,22,54.5,10,14,4,10,14,33,45,0,DF,25-29,Defender,Spain,Europe
448,Pedro Chirivella,ESP,Nantes,Ligue 1,2024,27.0,1997.0,13.1,20,16,9,10,1,8,18,44.4,10,6,0,6,6,26,26,0,MF,25-29,Midfielder,Spain,Europe
465,Silvi Clúa,ESP,Girona,La Liga,2024,19.0,2005.0,1.8,8,7,4,3,1,4,6,66.7,2,1,0,1,2,10,6,0,MF,Under 20,Midfielder,Spain,Europe
479,Santi Comesaña,ESP,Villarreal,La Liga,2024,28.0,1996.0,14.1,39,25,20,15,4,16,33,48.5,17,28,8,20,12,51,23,1,MF,25-29,Midfielder,Spain,Europe
482,Diego Conde,ESP,Villarreal,La Liga,2024,26.0,1998.0,14.8,2,2,2,0,0,2,4,50.0,2,0,0,0,1,3,7,2,GK,25-29,Goalkeeper,Spain,Europe
486,Copete,ESP,Mallorca,La Liga,2024,25.0,1999.0,5.8,8,6,7,1,0,3,3,100.0,0,6,4,2,4,12,44,0,DF,25-29,Defender,Spain,Europe
488,Iker Córdoba,ESP,Valencia,La Liga,2024,19.0,2005.0,0.1,0,0,0,0,0,0,0,,0,0,0,0,0,0,1,0,DF,Under 20,Defender,Spain,Europe
495,Coba da Costa,ESP,Getafe,La Liga,2024,22.0,2002.0,2.9,7,7,1,6,0,1,7,14.3,6,3,0,3,2,9,2,0,"FW,MF",20-24,Forward,Spain,Europe
502,Vladimír Coufal,CZE,West Ham,Premier League,2024,32.0,1992.0,4.9,6,4,4,2,0,2,9,22.2,7,6,5,1,2,8,15,1,DF,30-34,Defender,Czech Republic,Europe
514,Domen Črnigoj,SVN,Venezia,Serie A,2024,29.0,1995.0,1.5,4,2,0,1,3,1,2,50.0,1,5,2,3,4,8,4,0,MF,25-29,Midfielder,Slovenia,Europe
515,Juan Cruz Armada,ESP,Osasuna,La Liga,2024,32.0,1992.0,7.3,8,4,3,5,0,4,8,50.0,4,5,0,5,3,11,23,0,DF,30-34,Defender,Spain,Europe
516,Juan Cruz,ESP,Leganés,La Liga,2024,24.0,2000.0,10.9,8,6,2,6,0,5,12,41.7,7,7,2,5,7,15,10,0,"FW,MF",20-24,Forward,Spain,Europe
516,Juan Cruz,ESP,Leganés,La Liga,2024,24.0,2000.0,10.9,8,6,2,6,0,5,12,41.7,7,7,2,5,7,15,10,0,"FW,MF",20-24,Forward,Spain,Europe
516,Juan Cruz,ESP,Leganés,La Liga,2024,24.0,2000.0,10.9,8,6,2,6,0,5,12,41.7,7,7,2,5,7,15,10,0,"FW,MF",20-24,Forward,Spain,Europe
516,Juan Cruz,ESP,Leganés,La Liga,2024,24.0,2000.0,10.9,8,6,2,6,0,5,12,41.7,7,7,2,5,7,15,10,0,"FW,MF",20-24,Forward,Spain,Europe
518,Pau Cubarsí,ESP,Barcelona,La Liga,2024,17.0,2007.0,16.5,16,12,12,3,1,9,16,56.3,7,5,4,1,9,25,40,0,DF,Under 20,Defender,Spain,Europe
519,Marc Cucurella,ESP,Chelsea,Premier League,2024,26.0,1998.0,13.0,26,18,17,8,1,13,26,50.0,13,21,5,16,13,39,34,2,DF,25-29,Defender,Spain,Europe
520,Jorge Cuenca,ESP,Fulham,Premier League,2024,25.0,1999.0,1.0,1,1,1,0,0,1,4,25.0,3,0,0,0,1,2,13,0,DF,25-29,Defender,Spain,Europe
523,Tomáš Čvančara,CZE,Gladbach,Bundesliga,2024,24.0,2000.0,2.4,1,1,0,1,0,1,2,50.0,1,3,2,1,0,1,5,0,"FW,MF",20-24,Forward,Czech Republic,Europe
545,Sergi Darder,ESP,Mallorca,La Liga,2024,31.0,1993.0,13.5,24,13,11,8,5,9,20,45.0,11,8,1,7,7,31,13,1,"MF,FW",30-34,Midfielder,Spain,Europe
555,Paweł Dawidowicz,POL,Hellas Verona,Serie A,2024,29.0,1995.0,7.2,16,8,5,10,1,7,9,77.8,2,7,3,4,8,24,25,1,DF,25-29,Defender,Poland,Europe
575,Justin Devenny,NIR,Crystal Palace,Premier League,2024,21.0,2003.0,2.5,10,7,6,3,1,7,11,63.6,4,3,0,3,0,10,5,0,MF,20-24,Midfielder,Northern Ireland,Europe
584,Assane Diao,ESP,Betis,La Liga,2024,19.0,2005.0,3.1,5,3,1,3,1,4,9,44.4,5,3,0,3,0,5,3,0,FW,Under 20,Forward,Spain,Europe
593,Pedro Díaz,ESP,Rayo Vallecano,La Liga,2024,26.0,1998.0,2.2,4,3,1,3,0,2,8,25.0,6,5,0,5,1,5,2,1,MF,25-29,Midfielder,Spain,Europe
595,Diego,ESP,Leganés,La Liga,2024,24.0,2000.0,4.6,0,0,0,0,0,0,1,0.0,1,2,1,1,0,0,6,0,"FW,MF",20-24,Forward,Spain,Europe
595,Diego,ESP,Leganés,La Liga,2024,24.0,2000.0,4.6,0,0,0,0,0,0,1,0.0,1,2,1,1,0,0,6,0,"FW,MF",20-24,Forward,Spain,Europe
595,Diego,ESP,Leganés,La Liga,2024,24.0,2000.0,4.6,0,0,0,0,0,0,1,0.0,1,2,1,1,0,0,6,0,"FW,MF",20-24,Forward,Spain,Europe
595,Diego,ESP,Leganés,La Liga,2024,24.0,2000.0,4.6,0,0,0,0,0,0,1,0.0,1,2,1,1,0,0,6,0,"FW,MF",20-24,Forward,Spain,Europe
595,Diego,ESP,Leganés,La Liga,2024,24.0,2000.0,4.6,0,0,0,0,0,0,1,0.0,1,2,1,1,0,0,6,0,"FW,MF",20-24,Forward,Spain,Europe
595,Diego,ESP,Leganés,La Liga,2024,24.0,2000.0,4.6,0,0,0,0,0,0,1,0.0,1,2,1,1,0,0,6,0,"FW,MF",20-24,Forward,Spain,Europe
595,Diego,ESP,Leganés,La Liga,2024,24.0,2000.0,4.6,0,0,0,0,0,0,1,0.0,1,2,1,1,0,0,6,0,"FW,MF",20-24,Forward,Spain,Europe
595,Diego,ESP,Leganés,La Liga,2024,24.0,2000.0,4.6,0,0,0,0,0,0,1,0.0,1,2,1,1,0,0,6,0,"FW,MF",20-24,Forward,Spain,Europe
595,Diego,ESP,Leganés,La Liga,2024,24.0,2000.0,4.6,0,0,0,0,0,0,1,0.0,1,2,1,1,0,0,6,0,"FW,MF",20-24,Forward,Spain,Europe
613,Álvaro djaló,ESP,Athletic Club,La Liga,2024,25.0,1999.0,4.9,6,4,3,2,1,1,3,33.3,2,2,0,2,1,7,4,0,FW,25-29,Forward,Spain,Europe
614,Djené,TOG,Getafe,La Liga,2024,32.0,1991.0,14.0,7,2,4,3,0,1,9,11.1,8,8,5,3,15,22,49,1,DF,30-34,Defender,Togo,Africa
616,Marko Dmitrović,SRB,Leganés,La Liga,2024,32.0,1992.0,12.0,0,0,0,0,0,0,1,0.0,1,0,0,0,0,0,13,2,GK,30-34,Goalkeeper,Serbia,Europe
622,Marc Domenech,ESP,Mallorca,La Liga,2024,18.0,2006.0,1.3,0,0,0,0,0,0,2,0.0,2,2,0,2,0,0,0,0,FW,Under 20,Forward,Spain,Europe
623,Álex Domínguez,ESP,Toulouse,Ligue 1,2024,26.0,1998.0,0.2,0,0,0,0,0,0,0,,0,0,0,0,0,0,0,0,GK,25-29,Goalkeeper,Spain,Europe
625,Carlos Dominguez,ESP,Celta Vigo,La Liga,2024,23.0,2001.0,3.8,7,4,4,3,0,4,7,57.1,3,4,4,0,4,11,23,0,DF,20-24,Defender,Spain,Europe
626,Israel Domínguez,ESP,Sevilla,La Liga,2024,21.0,2003.0,0.2,0,0,0,0,0,0,0,,0,0,0,0,0,0,0,0,FW,20-24,Forward,Spain,Europe
628,Sergi Dominguez,ESP,Barcelona,La Liga,2024,19.0,2005.0,1.9,1,1,1,0,0,0,0,,0,0,0,0,3,4,7,0,DF,Under 20,Defender,Spain,Europe
659,Pablo Durán,ESP,Celta Vigo,La Liga,2024,23.0,2001.0,3.7,3,2,0,2,1,2,5,40.0,3,1,1,0,3,6,3,0,"FW,MF",20-24,Forward,Spain,Europe
661,Hugo Duro,ESP,Valencia,La Liga,2024,25.0,1999.0,12.6,7,5,3,3,1,2,6,33.3,4,8,1,7,6,13,6,0,FW,25-29,Forward,Spain,Europe
664,Stefan Džodić,SRB,Montpellier,Ligue 1,2024,19.0,2005.0,1.9,5,2,3,2,0,3,5,60.0,2,2,1,1,4,9,7,0,DF,Under 20,Defender,Serbia,Europe
665,Adam Dźwigała,POL,St. Pauli,Bundesliga,2024,29.0,1995.0,1.4,11,5,8,2,1,5,7,71.4,2,1,1,0,0,11,15,0,"DF,MF",25-29,Defender,Poland,Europe
666,Aron Dønnum,NOR,Toulouse,Ligue 1,2024,26.0,1998.0,12.0,16,8,5,8,3,7,20,35.0,13,12,2,10,11,27,17,0,"DF,MF",25-29,Defender,Norway,Europe
690,Aritz Elustondo,ESP,Real Sociedad,La Liga,2024,30.0,1994.0,3.1,6,3,4,1,1,3,3,100.0,0,6,5,1,2,8,15,0,DF,30-34,Defender,Spain,Europe
692,Adri Embarba,ESP,Rayo Vallecano,La Liga,2024,32.0,1992.0,9.2,19,6,8,9,2,11,23,47.8,12,9,1,8,6,25,8,0,"FW,MF",30-34,Forward,Spain,Europe
712,Jonny Evans,NIR,Manchester Utd,Premier League,2024,36.0,1988.0,3.2,7,5,4,3,0,2,4,50.0,2,2,1,1,4,11,13,0,DF,35-39,Defender,Northern Ireland,Europe
713,Edu Expósito,ESP,Espanyol,La Liga,2024,28.0,1996.0,0.2,0,0,0,0,0,0,1,0.0,1,0,0,0,0,0,0,1,MF,25-29,Midfielder,Spain,Europe
717,Łukasz Fabiański,POL,West Ham,Premier League,2024,39.0,1985.0,9.5,0,0,0,0,0,0,1,0.0,1,0,0,0,0,0,4,0,GK,35-39,Goalkeeper,Poland,Europe
725,Ansu Fati,ESP,Barcelona,La Liga,2024,22.0,2002.0,1.4,1,1,0,1,0,0,0,,0,0,0,0,0,1,0,1,FW,20-24,Forward,Spain,Europe
732,Kiko Femenía,ESP,Villarreal,La Liga,2024,33.0,1991.0,15.2,28,17,20,7,1,17,33,51.5,16,15,8,7,22,50,31,1,DF,30-34,Defender,Spain,Europe
739,Álvaro Fernández,ESP,Sevilla,La Liga,2024,26.0,1998.0,7.3,0,0,0,0,0,0,1,0.0,1,0,0,0,0,0,7,0,GK,25-29,Goalkeeper,Spain,Europe
739,Álvaro Fernández,ESP,Sevilla,La Liga,2024,26.0,1998.0,7.3,0,0,0,0,0,0,1,0.0,1,0,0,0,0,0,7,0,GK,25-29,Goalkeeper,Spain,Europe
739,Álvaro Fernández,ESP,Sevilla,La Liga,2024,26.0,1998.0,7.3,0,0,0,0,0,0,1,0.0,1,0,0,0,0,0,7,0,GK,25-29,Goalkeeper,Spain,Europe
739,Álvaro Fernández,ESP,Sevilla,La Liga,2024,26.0,1998.0,7.3,0,0,0,0,0,0,1,0.0,1,0,0,0,0,0,7,0,GK,25-29,Goalkeeper,Spain,Europe
741,Valery Fernández,ESP,Mallorca,La Liga,2024,25.0,1999.0,2.5,8,7,3,2,3,5,7,71.4,2,2,1,1,0,8,1,0,"MF,FW",25-29,Midfielder,Spain,Europe
744,Karol Fila,POL,Strasbourg,Ligue 1,2024,26.0,1998.0,0.1,0,0,0,0,0,0,0,,0,0,0,0,0,0,0,0,MF,25-29,Midfielder,Poland,Europe
747,Mateo Flores,ESP,Betis,La Liga,2024,20.0,2004.0,1.2,0,0,0,0,0,0,0,,0,0,0,0,1,1,2,0,MF,20-24,Midfielder,Spain,Europe
757,Pablo Fornals,ESP,Betis,La Liga,2024,28.0,1996.0,10.9,11,7,5,5,1,4,14,28.6,10,17,0,17,14,25,8,1,"MF,FW",25-29,Midfielder,Spain,Europe
760,Héctor Fort,ESP,Barcelona,La Liga,2024,18.0,2006.0,3.1,8,6,4,3,1,7,10,70.0,3,6,0,6,4,12,9,0,DF,Under 20,Defender,Spain,Europe
763,Alejandro Francés,ESP,Girona,La Liga,2024,22.0,2002.0,6.2,19,13,11,7,1,16,22,72.7,6,6,2,4,9,28,19,0,DF,20-24,Defender,Spain,Europe
764,Przemysław Frankowski,POL,Lens,Ligue 1,2024,29.0,1995.0,10.5,19,12,10,6,3,13,20,65.0,7,5,0,5,7,26,20,0,DF,25-29,Defender,Poland,Europe
765,Enric Franquesa,ESP,Leganés,La Liga,2024,27.0,1997.0,6.8,17,9,9,6,2,9,13,69.2,4,7,1,6,5,22,12,0,"DF,FW",25-29,Defender,Spain,Europe
774,Jorge de Frutos,ESP,Rayo Vallecano,La Liga,2024,27.0,1997.0,13.8,23,12,9,8,6,10,27,37.0,17,11,0,11,8,31,15,0,"MF,FW",25-29,Midfielder,Spain,Europe
775,Darío Fuentes,ESP,Sevilla,La Liga,2024,21.0,2003.0,0.1,0,0,0,0,0,0,0,,0,0,0,0,0,0,0,0,DF,20-24,Defender,Spain,Europe
779,Manuel Fuster,ESP,Las Palmas,La Liga,2024,27.0,1997.0,3.8,7,3,1,6,0,7,12,58.3,5,5,1,4,1,8,8,0,"FW,MF",25-29,Forward,Spain,Europe
785,Javi Galán,ESP,Atlético Madrid,La Liga,2024,30.0,1994.0,7.5,23,14,12,8,3,12,25,48.0,13,10,2,8,5,28,6,0,DF,30-34,Defender,Spain,Europe
786,Iñigo Ruiz de Galarreta,ESP,Athletic Club,La Liga,2024,31.0,1993.0,9.8,20,14,9,8,3,12,19,63.2,7,6,2,4,6,26,8,2,MF,30-34,Midfielder,Spain,Europe
793,Aleix García,ESP,Leverkusen,Bundesliga,2024,27.0,1997.0,5.3,5,2,1,3,1,2,6,33.3,4,3,1,2,3,8,6,0,MF,25-29,Midfielder,Spain,Europe
794,Álvaro García,ESP,Rayo Vallecano,La Liga,2024,32.0,1992.0,11.8,23,16,13,7,3,8,16,50.0,8,14,0,14,17,40,22,1,"FW,MF",30-34,Forward,Spain,Europe
794,Álvaro García,ESP,Rayo Vallecano,La Liga,2024,32.0,1992.0,11.8,23,16,13,7,3,8,16,50.0,8,14,0,14,17,40,22,1,"FW,MF",30-34,Forward,Spain,Europe
794,Álvaro García,ESP,Rayo Vallecano,La Liga,2024,32.0,1992.0,11.8,23,16,13,7,3,8,16,50.0,8,14,0,14,17,40,22,1,"FW,MF",30-34,Forward,Spain,Europe
794,Álvaro García,ESP,Rayo Vallecano,La Liga,2024,32.0,1992.0,11.8,23,16,13,7,3,8,16,50.0,8,14,0,14,17,40,22,1,"FW,MF",30-34,Forward,Spain,Europe
794,Álvaro García,ESP,Rayo Vallecano,La Liga,2024,32.0,1992.0,11.8,23,16,13,7,3,8,16,50.0,8,14,0,14,17,40,22,1,"FW,MF",30-34,Forward,Spain,Europe
794,Álvaro García,ESP,Rayo Vallecano,La Liga,2024,32.0,1992.0,11.8,23,16,13,7,3,8,16,50.0,8,14,0,14,17,40,22,1,"FW,MF",30-34,Forward,Spain,Europe
794,Álvaro García,ESP,Rayo Vallecano,La Liga,2024,32.0,1992.0,11.8,23,16,13,7,3,8,16,50.0,8,14,0,14,17,40,22,1,"FW,MF",30-34,Forward,Spain,Europe
794,Álvaro García,ESP,Rayo Vallecano,La Liga,2024,32.0,1992.0,11.8,23,16,13,7,3,8,16,50.0,8,14,0,14,17,40,22,1,"FW,MF",30-34,Forward,Spain,Europe
794,Álvaro García,ESP,Rayo Vallecano,La Liga,2024,32.0,1992.0,11.8,23,16,13,7,3,8,16,50.0,8,14,0,14,17,40,22,1,"FW,MF",30-34,Forward,Spain,Europe
794,Álvaro García,ESP,Rayo Vallecano,La Liga,2024,32.0,1992.0,11.8,23,16,13,7,3,8,16,50.0,8,14,0,14,17,40,22,1,"FW,MF",30-34,Forward,Spain,Europe
794,Álvaro García,ESP,Rayo Vallecano,La Liga,2024,32.0,1992.0,11.8,23,16,13,7,3,8,16,50.0,8,14,0,14,17,40,22,1,"FW,MF",30-34,Forward,Spain,Europe
794,Álvaro García,ESP,Rayo Vallecano,La Liga,2024,32.0,1992.0,11.8,23,16,13,7,3,8,16,50.0,8,14,0,14,17,40,22,1,"FW,MF",30-34,Forward,Spain,Europe
794,Álvaro García,ESP,Rayo Vallecano,La Liga,2024,32.0,1992.0,11.8,23,16,13,7,3,8,16,50.0,8,14,0,14,17,40,22,1,"FW,MF",30-34,Forward,Spain,Europe
794,Álvaro García,ESP,Rayo Vallecano,La Liga,2024,32.0,1992.0,11.8,23,16,13,7,3,8,16,50.0,8,14,0,14,17,40,22,1,"FW,MF",30-34,Forward,Spain,Europe
794,Álvaro García,ESP,Rayo Vallecano,La Liga,2024,32.0,1992.0,11.8,23,16,13,7,3,8,16,50.0,8,14,0,14,17,40,22,1,"FW,MF",30-34,Forward,Spain,Europe
794,Álvaro García,ESP,Rayo Vallecano,La Liga,2024,32.0,1992.0,11.8,23,16,13,7,3,8,16,50.0,8,14,0,14,17,40,22,1,"FW,MF",30-34,Forward,Spain,Europe
795,Eric García,ESP,Barcelona,La Liga,2024,23.0,2001.0,6.0,13,6,3,8,2,6,8,75.0,2,8,3,5,4,17,11,0,"MF,DF",20-24,Midfielder,Spain,Europe
796,Fran Garcia,ESP,Real Madrid,La Liga,2024,25.0,1999.0,8.5,11,8,7,2,2,5,10,50.0,5,6,3,3,7,18,22,0,DF,25-29,Defender,Spain,Europe
797,Joan García,ESP,Espanyol,La Liga,2024,23.0,2001.0,18.0,0,0,0,0,0,0,1,0.0,1,0,0,0,0,0,7,3,GK,20-24,Goalkeeper,Spain,Europe
798,Rubén García,ESP,Osasuna,La Liga,2024,31.0,1993.0,11.2,27,18,11,10,6,16,27,59.3,11,17,1,16,10,37,17,0,"FW,MF",30-34,Forward,Spain,Europe
798,Rubén García,ESP,Osasuna,La Liga,2024,31.0,1993.0,11.2,27,18,11,10,6,16,27,59.3,11,17,1,16,10,37,17,0,"FW,MF",30-34,Forward,Spain,Europe
798,Rubén García,ESP,Osasuna,La Liga,2024,31.0,1993.0,11.2,27,18,11,10,6,16,27,59.3,11,17,1,16,10,37,17,0,"FW,MF",30-34,Forward,Spain,Europe
798,Rubén García,ESP,Osasuna,La Liga,2024,31.0,1993.0,11.2,27,18,11,10,6,16,27,59.3,11,17,1,16,10,37,17,0,"FW,MF",30-34,Forward,Spain,Europe
802,Yarek Gasiorowski,ESP,Valencia,La Liga,2024,19.0,2005.0,8.0,18,15,15,3,0,8,11,72.7,3,11,4,7,17,35,39,0,DF,Under 20,Defender,Spain,Europe
804,Gavi,ESP,Barcelona,La Liga,2024,20.0,2004.0,2.9,8,5,3,4,1,5,6,83.3,1,6,1,5,6,14,3,0,MF,20-24,Midfielder,Spain,Europe
808,David de Gea,ESP,Fiorentina,Serie A,2024,34.0,1990.0,13.0,0,0,0,0,0,0,0,,0,0,0,0,0,0,3,0,GK,30-34,Goalkeeper,Spain,Europe
823,Bryan Gil,ESP,Girona,La Liga,2024,23.0,2001.0,11.7,21,13,7,7,7,10,18,55.6,8,16,0,16,5,26,6,1,"FW,MF",20-24,Forward,Spain,Europe
824,Mario Gila,ESP,Lazio,Serie A,2024,24.0,2000.0,13.2,29,23,17,10,2,19,27,70.4,8,10,8,2,13,42,49,2,DF,20-24,Defender,Spain,Europe
844,Dani Gómez,ESP,Valencia,La Liga,2024,26.0,1998.0,5.9,3,2,0,0,3,0,0,,0,1,0,1,2,5,4,0,FW,25-29,Forward,Spain,Europe
846,Moi Gómez,ESP,Osasuna,La Liga,2024,30.0,1994.0,4.6,9,5,3,5,1,2,4,50.0,2,2,1,1,5,14,3,1,"MF,FW",30-34,Midfielder,Spain,Europe
847,Sergi Gómez,ESP,Espanyol,La Liga,2024,32.0,1992.0,7.2,8,5,7,1,0,2,3,66.7,1,12,8,4,7,15,36,0,DF,30-34,Defender,Spain,Europe
848,Sergio Gómez,ESP,Real Sociedad,La Liga,2024,24.0,2000.0,15.2,46,28,19,21,6,17,30,56.7,13,26,1,25,10,56,16,1,"MF,DF",20-24,Midfielder,Spain,Europe
849,Unai Gómez,ESP,Athletic Club,La Liga,2024,21.0,2003.0,5.7,5,1,2,2,1,2,2,100.0,0,5,0,5,2,7,6,0,"MF,FW",20-24,Midfielder,Spain,Europe
850,Fabio González,ESP,Las Palmas,La Liga,2024,27.0,1997.0,0.6,0,0,0,0,0,0,1,0.0,1,0,0,0,0,0,0,0,MF,25-29,Midfielder,Spain,Europe
852,Urko González,ESP,Real Sociedad,La Liga,2024,23.0,2001.0,0.5,0,0,0,0,0,0,0,,0,1,1,0,0,0,0,0,MF,20-24,Midfielder,Spain,Europe
855,Andoni Gorosabel,ESP,Athletic Club,La Liga,2024,28.0,1996.0,4.9,10,2,7,2,1,6,13,46.2,7,6,1,5,3,13,18,0,DF,25-29,Defender,Spain,Europe
861,Kamil Grabara,POL,Wolfsburg,Bundesliga,2024,25.0,1999.0,15.0,0,0,0,0,0,0,2,0.0,2,1,0,1,0,0,4,1,GK,25-29,Goalkeeper,Poland,Europe
863,José Gragera,ESP,Espanyol,La Liga,2024,24.0,2000.0,6.3,25,16,11,14,0,9,17,52.9,8,9,1,8,5,30,13,0,MF,20-24,Midfielder,Spain,Europe
876,Álex Grimaldo,ESP,Leverkusen,Bundesliga,2024,29.0,1995.0,14.7,15,7,7,5,3,10,22,45.5,12,8,2,6,12,27,20,2,DF,25-29,Defender,Spain,Europe
881,Vicente Guaita,ESP,Celta Vigo,La Liga,2024,37.0,1987.0,14.0,0,0,0,0,0,0,0,,0,0,0,0,0,0,7,0,GK,35-39,Goalkeeper,Spain,Europe
882,Sergi Guardiola,ESP,Rayo Vallecano,La Liga,2024,33.0,1991.0,0.9,3,2,0,3,0,0,0,,0,0,0,0,0,3,2,0,FW,30-34,Forward,Spain,Europe
883,Nemanja Gudelj,SRB,Sevilla,La Liga,2024,33.0,1991.0,15.0,26,11,8,14,4,10,13,76.9,3,15,5,10,18,44,42,0,"MF,DF",30-34,Midfielder,Serbia,Europe
889,Javier Guerra,ESP,Valencia,La Liga,2024,21.0,2003.0,10.3,28,14,8,11,9,12,22,54.5,10,6,0,6,5,33,16,1,"MF,FW",20-24,Midfielder,Spain,Europe
892,Ander Guevara,ESP,Alavés,La Liga,2024,27.0,1997.0,10.8,23,11,12,10,1,13,31,41.9,18,15,3,12,7,30,20,1,MF,25-29,Midfielder,Spain,Europe
897,Hugo Guillamón,ESP,Valencia,La Liga,2024,24.0,2000.0,3.7,10,7,0,9,1,8,9,88.9,1,2,1,1,5,15,8,0,MF,20-24,Midfielder,Spain,Europe
899,Carlos Guirao,ESP,Betis,La Liga,2024,21.0,2003.0,1.2,5,3,1,4,0,4,6,66.7,2,1,1,0,3,8,2,0,MF,20-24,Midfielder,Spain,Europe
902,Marc Guiu,ESP,Chelsea,Premier League,2024,18.0,2006.0,0.3,0,0,0,0,0,0,0,,0,0,0,0,0,0,0,0,FW,Under 20,Forward,Spain,Europe
905,Gerard Gumbau,ESP,Rayo Vallecano,La Liga,2024,30.0,1994.0,5.0,12,10,6,5,1,6,11,54.5,5,5,3,2,3,15,9,0,MF,30-34,Midfielder,Spain,Europe
906,Robert Gumny,POL,Augsburg,Bundesliga,2024,26.0,1998.0,0.3,0,0,0,0,0,0,2,0.0,2,0,0,0,0,0,0,0,DF,25-29,Defender,Poland,Europe
909,Jon Guridi,ESP,Alavés,La Liga,2024,29.0,1995.0,11.4,16,9,4,10,2,7,23,30.4,16,11,0,11,8,24,6,0,MF,25-29,Midfielder,Spain,Europe
910,Gorka Guruzeta,ESP,Athletic Club,La Liga,2024,28.0,1996.0,10.9,8,3,0,7,1,4,16,25.0,12,20,2,18,5,13,11,0,FW,25-29,Forward,Spain,Europe
912,Miguel Gutiérrez,ESP,Girona,La Liga,2024,23.0,2001.0,16.9,27,17,13,13,1,10,20,50.0,10,9,3,6,11,38,21,1,"DF,MF",20-24,Defender,Spain,Europe
917,Erling Haaland,NOR,Manchester City,Premier League,2024,24.0,2000.0,17.0,6,4,2,2,2,1,2,50.0,1,3,0,3,3,9,15,0,FW,20-24,Forward,Norway,Europe
930,Ali Al Hamadi,IRQ,Ipswich Town,Premier League,2024,22.0,2002.0,1.3,1,0,0,0,1,0,2,0.0,2,0,0,0,0,1,2,0,FW,20-24,Forward,Iraq,Asia
931,Andreas Hanche-Olsen,NOR,Mainz 05,Bundesliga,2024,27.0,1997.0,4.3,4,1,1,2,1,0,0,,0,7,6,1,3,7,21,1,DF,25-29,Defender,Norway,Europe
951,Mario Hermoso,ESP,Roma,Serie A,2024,29.0,1995.0,2.8,2,1,2,0,0,0,1,0.0,1,1,1,0,4,6,13,0,DF,25-29,Defender,Spain,Europe
952,Javi Hernández,ESP,Leganés,La Liga,2024,26.0,1998.0,12.8,18,11,9,6,3,10,27,37.0,17,15,3,12,17,35,53,0,DF,25-29,Defender,Spain,Europe
953,Aridane Hernández,ESP,Rayo Vallecano,La Liga,2024,35.0,1989.0,2.3,2,1,2,0,0,0,0,,0,2,1,1,2,4,17,0,DF,35-39,Defender,Spain,Europe
957,Jorge Herrando,ESP,Osasuna,La Liga,2024,23.0,2001.0,5.2,3,2,2,1,0,2,3,66.7,1,6,5,1,1,4,25,0,DF,20-24,Defender,Spain,Europe
958,Ander Herrera,ESP,Athletic Club,La Liga,2024,35.0,1989.0,3.0,8,4,1,7,0,3,6,50.0,3,1,0,1,2,10,10,0,MF,35-39,Midfielder,Spain,Europe
959,Sergio Herrera,ESP,Osasuna,La Liga,2024,31.0,1993.0,18.0,1,0,1,0,0,1,2,50.0,1,1,0,1,0,1,15,1,GK,30-34,Goalkeeper,Spain,Europe
961,Juan Herzog,ESP,Las Palmas,La Liga,2024,21.0,2003.0,5.2,3,3,3,0,0,2,4,50.0,2,5,3,2,4,7,27,0,DF,20-24,Defender,Spain,Europe
969,Adam Hložek,CZE,Hoffenheim,Bundesliga,2024,22.0,2002.0,10.9,14,6,5,3,6,8,14,57.1,6,9,1,8,0,14,10,0,"FW,MF",20-24,Forward,Czech Republic,Europe
986,Robin Hranáč,CZE,Hoffenheim,Bundesliga,2024,24.0,2000.0,1.6,0,0,0,0,0,0,1,0.0,1,1,0,1,4,4,4,1,DF,20-24,Defender,Czech Republic,Europe
989,Dean Huijsen,ESP,Bournemouth,Premier League,2024,19.0,2005.0,6.8,9,6,6,2,1,2,5,40.0,3,9,8,1,14,23,39,2,DF,Under 20,Defender,Spain,Europe
997,Pablo Ibáñez,ESP,Osasuna,La Liga,2024,26.0,1998.0,6.0,8,4,4,3,1,4,14,28.6,10,11,5,6,10,18,14,0,MF,25-29,Midfielder,Spain,Europe
1001,Iglesias,ESP,Getafe,La Liga,2024,26.0,1998.0,14.9,44,26,22,19,3,24,47,51.1,23,22,3,19,29,73,58,1,DF,25-29,Defender,Spain,Europe
1002,Borja Iglesias,ESP,Celta Vigo,La Liga,2024,31.0,1993.0,10.2,5,5,1,3,1,1,6,16.7,5,5,2,3,3,8,6,0,FW,30-34,Forward,Spain,Europe
1007,Ivan Ilić,SRB,Torino,Serie A,2024,23.0,2001.0,6.7,2,1,0,1,1,0,4,0.0,4,0,0,0,4,6,3,0,MF,20-24,Midfielder,Serbia,Europe
1017,Isco,ESP,Betis,La Liga,2024,32.0,1992.0,1.1,2,0,0,1,1,1,3,33.3,2,3,0,3,0,2,1,0,MF,30-34,Midfielder,Spain,Europe
1023,Marko Ivezić,SRB,Holstein Kiel,Bundesliga,2024,23.0,2001.0,11.0,22,14,15,4,3,11,27,40.7,16,15,9,6,15,37,46,2,DF,20-24,Defender,Serbia,Europe
1036,Vitezslav Jaros,CZE,Liverpool,Premier League,2024,23.0,2001.0,0.1,0,0,0,0,0,0,0,,0,0,0,0,0,0,0,0,GK,20-24,Goalkeeper,Czech Republic,Europe
1037,Ali Jasim,IRQ,Como,Serie A,2024,20.0,2004.0,0.1,1,0,1,0,0,1,1,100.0,0,0,0,0,0,1,0,0,"FW,DF",20-24,Forward,Iraq,Asia
1038,Mikel Jauregizar,ESP,Athletic Club,La Liga,2024,21.0,2003.0,11.0,35,18,9,18,8,18,32,56.3,14,8,1,7,12,47,14,1,MF,20-24,Midfielder,Spain,Europe
1047,Alejandro Jiménez,ESP,Milan,Serie A,2024,19.0,2005.0,2.0,3,2,1,1,1,3,4,75.0,1,2,0,2,1,4,3,0,"DF,FW",Under 20,Defender,Spain,Europe
1052,Jofre,ESP,Espanyol,La Liga,2024,23.0,2001.0,12.5,9,7,6,3,0,5,10,50.0,5,3,0,3,9,18,12,0,"MF,FW",20-24,Midfielder,Spain,Europe
1062,Joan Jordán,ESP,Alavés,La Liga,2024,30.0,1994.0,6.8,17,10,7,8,2,7,16,43.8,9,8,0,8,4,21,9,0,MF,30-34,Midfielder,Spain,Europe
1068,Luka Jović,SRB,Milan,Serie A,2024,27.0,1997.0,0.9,0,0,0,0,0,0,0,,0,0,0,0,1,1,0,0,FW,25-29,Forward,Serbia,Europe
1069,Juanmi,ESP,Betis,La Liga,2024,31.0,1993.0,2.2,7,4,3,3,1,4,6,66.7,2,4,0,4,1,8,4,0,"FW,MF",30-34,Forward,Spain,Europe
1070,Juanpe,ESP,Girona,La Liga,2024,33.0,1991.0,3.6,7,4,4,3,0,6,7,85.7,1,7,3,4,4,11,23,0,DF,30-34,Defender,Spain,Europe
1078,David Jurásek,CZE,Hoffenheim,Bundesliga,2024,24.0,2000.0,1.8,2,1,1,0,1,0,0,,0,2,0,2,2,4,5,0,"DF,FW",20-24,Defender,Czech Republic,Europe
1087,Pavel Kadeřábek,CZE,Hoffenheim,Bundesliga,2024,32.0,1992.0,7.6,14,7,7,2,5,8,16,50.0,8,7,2,5,10,24,20,1,DF,30-34,Defender,Czech Republic,Europe
1093,Waren Kamanzi,NOR,Toulouse,Ligue 1,2024,24.0,2000.0,7.6,23,11,9,11,3,12,21,57.1,9,2,0,2,5,28,17,0,"DF,MF",20-24,Defender,Norway,Europe
1098,Jakub Kamiński,POL,Wolfsburg,Bundesliga,2024,22.0,2002.0,7.4,11,5,5,2,4,5,16,31.3,11,12,6,6,8,19,13,1,"DF,MF",20-24,Defender,Poland,Europe
1099,Kevin Kampl,SVN,RB Leipzig,Bundesliga,2024,34.0,1990.0,8.5,11,7,3,4,4,7,13,53.8,6,11,2,9,12,23,12,0,MF,30-34,Midfielder,Slovenia,Europe
1115,Abdoulaye Keita,ESP,Getafe,La Liga,2024,22.0,2002.0,0.9,2,2,0,1,1,2,3,66.7,1,1,0,1,0,2,2,0,"FW,MF",20-24,Forward,Spain,Europe
1115,Abdoulaye Keita,ESP,Getafe,La Liga,2024,22.0,2002.0,0.9,2,2,0,1,1,2,3,66.7,1,1,0,1,0,2,2,0,"FW,MF",20-24,Forward,Spain,Europe
1115,Abdoulaye Keita,ESP,Getafe,La Liga,2024,22.0,2002.0,0.9,2,2,0,1,1,2,3,66.7,1,1,0,1,0,2,2,0,"FW,MF",20-24,Forward,Spain,Europe
1115,Abdoulaye Keita,ESP,Getafe,La Liga,2024,22.0,2002.0,0.9,2,2,0,1,1,2,3,66.7,1,1,0,1,0,2,2,0,"FW,MF",20-24,Forward,Spain,Europe
1133,Kiké,ESP,Alavés,La Liga,2024,35.0,1989.0,11.4,7,7,1,4,2,1,3,33.3,2,1,1,0,0,7,10,0,FW,35-39,Forward,Spain,Europe
1137,Joshua King,NOR,Toulouse,Ligue 1,2024,32.0,1992.0,9.1,6,6,2,2,2,2,6,33.3,4,5,2,3,2,8,10,0,"FW,MF",30-34,Forward,Norway,Europe
1139,Jakub Kiwior,POL,Arsenal,Premier League,2024,24.0,2000.0,3.6,4,2,3,1,0,3,5,60.0,2,5,2,3,1,5,16,1,DF,20-24,Defender,Poland,Europe
1144,Magnus Knudsen,NOR,Holstein Kiel,Bundesliga,2024,23.0,2001.0,10.3,28,17,14,9,5,16,23,69.6,7,11,4,7,8,36,15,0,MF,20-24,Midfielder,Norway,Europe
1151,Koke,ESP,Atlético Madrid,La Liga,2024,32.0,1992.0,12.7,30,20,12,12,6,17,29,58.6,12,15,0,15,13,43,20,0,MF,30-34,Midfielder,Spain,Europe
1173,Matej Kovar,CZE,Leverkusen,Bundesliga,2024,24.0,2000.0,1.0,0,0,0,0,0,0,0,,0,0,0,0,0,0,0,0,GK,20-24,Goalkeeper,Czech Republic,Europe
1174,Mateusz Kowalski,POL,Parma,Serie A,2024,19.0,2005.0,0.6,0,0,0,0,0,0,0,,0,1,0,1,0,0,1,0,MF,Under 20,Midfielder,Poland,Europe
1177,Alex Král,CZE,Espanyol,La Liga,2024,26.0,1998.0,17.4,41,28,22,19,0,9,17,52.9,8,21,9,12,16,57,27,0,MF,25-29,Midfielder,Czech Republic,Europe
1180,Ladislav Krejčí,CZE,Girona,La Liga,2024,25.0,1999.0,9.1,8,5,7,1,0,4,10,40.0,6,9,7,2,15,23,28,0,DF,25-29,Defender,Czech Republic,Europe
1214,Juanmi Latasa,ESP,Valladolid,La Liga,2024,23.0,2001.0,5.8,1,0,0,1,0,0,2,0.0,2,2,1,1,0,1,6,1,FW,20-24,Forward,Spain,Europe
1215,Toni Lato,ESP,Mallorca,La Liga,2024,27.0,1997.0,2.9,7,5,2,1,4,3,5,60.0,2,3,0,3,3,10,10,0,DF,25-29,Defender,Spain,Europe
1218,Darko Lazović,SRB,Hellas Verona,Serie A,2024,34.0,1990.0,13.3,19,9,5,12,2,10,24,41.7,14,16,3,13,9,28,31,0,"FW,MF",30-34,Forward,Serbia,Europe
1223,Robin Le Normand,ESP,Atlético Madrid,La Liga,2024,28.0,1996.0,7.3,11,8,11,0,0,3,6,50.0,3,3,2,1,2,13,27,0,DF,25-29,Defender,Spain,Europe
1232,Iñigo Lekue,ESP,Athletic Club,La Liga,2024,31.0,1993.0,4.1,6,4,4,2,0,3,6,50.0,3,2,1,1,3,9,14,2,DF,30-34,Defender,Spain,Europe
1245,Robert Lewandowski,POL,Barcelona,La Liga,2024,36.0,1988.0,16.4,7,3,1,4,2,3,6,50.0,3,9,2,7,1,8,17,0,FW,35-39,Forward,Poland,Europe
1256,Karol Linetty,POL,Torino,Serie A,2024,29.0,1995.0,11.9,26,18,11,15,0,14,25,56.0,11,13,5,8,7,33,19,1,MF,25-29,Midfielder,Poland,Europe
1258,Pol Lirola,ESP,Marseille,Ligue 1,2024,27.0,1997.0,4.0,8,5,4,4,0,3,9,33.3,6,4,2,2,0,8,5,0,DF,25-29,Defender,Spain,Europe
1261,Javier Llabrés,ESP,Mallorca,La Liga,2024,22.0,2002.0,0.6,0,0,0,0,0,0,0,,0,1,0,1,0,0,0,0,FW,20-24,Forward,Spain,Europe
1262,Diego Llorente,ESP,Betis,La Liga,2024,31.0,1993.0,16.6,19,8,10,8,1,11,20,55.0,9,18,12,6,30,49,86,1,DF,30-34,Defender,Spain,Europe
1262,Diego Llorente,ESP,Betis,La Liga,2024,31.0,1993.0,16.6,19,8,10,8,1,11,20,55.0,9,18,12,6,30,49,86,1,DF,30-34,Defender,Spain,Europe
1262,Diego Llorente,ESP,Betis,La Liga,2024,31.0,1993.0,16.6,19,8,10,8,1,11,20,55.0,9,18,12,6,30,49,86,1,DF,30-34,Defender,Spain,Europe
1262,Diego Llorente,ESP,Betis,La Liga,2024,31.0,1993.0,16.6,19,8,10,8,1,11,20,55.0,9,18,12,6,30,49,86,1,DF,30-34,Defender,Spain,Europe
1263,Marcos Llorente,ESP,Atlético Madrid,La Liga,2024,29.0,1995.0,10.9,26,19,16,7,3,15,20,75.0,5,10,1,9,10,36,22,1,"DF,MF",25-29,Defender,Spain,Europe
1272,David López,ESP,Girona,La Liga,2024,35.0,1989.0,16.4,19,13,12,5,2,13,23,56.5,10,16,9,7,10,29,62,1,DF,35-39,Defender,Spain,Europe
1272,David López,ESP,Girona,La Liga,2024,35.0,1989.0,16.4,19,13,12,5,2,13,23,56.5,10,16,9,7,10,29,62,1,DF,35-39,Defender,Spain,Europe
1272,David López,ESP,Girona,La Liga,2024,35.0,1989.0,16.4,19,13,12,5,2,13,23,56.5,10,16,9,7,10,29,62,1,DF,35-39,Defender,Spain,Europe
1272,David López,ESP,Girona,La Liga,2024,35.0,1989.0,16.4,19,13,12,5,2,13,23,56.5,10,16,9,7,10,29,62,1,DF,35-39,Defender,Spain,Europe
1273,Diego López,ESP,Valencia,La Liga,2024,22.0,2002.0,14.3,13,9,3,7,3,7,21,33.3,14,12,0,12,4,17,4,0,"MF,FW",20-24,Midfielder,Spain,Europe
1273,Diego López,ESP,Valencia,La Liga,2024,22.0,2002.0,14.3,13,9,3,7,3,7,21,33.3,14,12,0,12,4,17,4,0,"MF,FW",20-24,Midfielder,Spain,Europe
1273,Diego López,ESP,Valencia,La Liga,2024,22.0,2002.0,14.3,13,9,3,7,3,7,21,33.3,14,12,0,12,4,17,4,0,"MF,FW",20-24,Midfielder,Spain,Europe
1273,Diego López,ESP,Valencia,La Liga,2024,22.0,2002.0,14.3,13,9,3,7,3,7,21,33.3,14,12,0,12,4,17,4,0,"MF,FW",20-24,Midfielder,Spain,Europe
1273,Diego López,ESP,Valencia,La Liga,2024,22.0,2002.0,14.3,13,9,3,7,3,7,21,33.3,14,12,0,12,4,17,4,0,"MF,FW",20-24,Midfielder,Spain,Europe
1273,Diego López,ESP,Valencia,La Liga,2024,22.0,2002.0,14.3,13,9,3,7,3,7,21,33.3,14,12,0,12,4,17,4,0,"MF,FW",20-24,Midfielder,Spain,Europe
1273,Diego López,ESP,Valencia,La Liga,2024,22.0,2002.0,14.3,13,9,3,7,3,7,21,33.3,14,12,0,12,4,17,4,0,"MF,FW",20-24,Midfielder,Spain,Europe
1273,Diego López,ESP,Valencia,La Liga,2024,22.0,2002.0,14.3,13,9,3,7,3,7,21,33.3,14,12,0,12,4,17,4,0,"MF,FW",20-24,Midfielder,Spain,Europe
1273,Diego López,ESP,Valencia,La Liga,2024,22.0,2002.0,14.3,13,9,3,7,3,7,21,33.3,14,12,0,12,4,17,4,0,"MF,FW",20-24,Midfielder,Spain,Europe
1275,Fermin López,ESP,Barcelona,La Liga,2024,21.0,2003.0,4.4,6,5,3,1,2,2,8,25.0,6,1,0,1,3,9,1,0,"MF,FW",20-24,Midfielder,Spain,Europe
1276,Javi López,ESP,Real Sociedad,La Liga,2024,22.0,2002.0,9.6,18,8,9,7,2,8,15,53.3,7,8,3,5,3,21,27,1,DF,20-24,Defender,Spain,Europe
1276,Javi López,ESP,Real Sociedad,La Liga,2024,22.0,2002.0,9.6,18,8,9,7,2,8,15,53.3,7,8,3,5,3,21,27,1,DF,20-24,Defender,Spain,Europe
1276,Javi López,ESP,Real Sociedad,La Liga,2024,22.0,2002.0,9.6,18,8,9,7,2,8,15,53.3,7,8,3,5,3,21,27,1,DF,20-24,Defender,Spain,Europe
1276,Javi López,ESP,Real Sociedad,La Liga,2024,22.0,2002.0,9.6,18,8,9,7,2,8,15,53.3,7,8,3,5,3,21,27,1,DF,20-24,Defender,Spain,Europe
1277,Roberto López,ESP,Leganés,La Liga,2024,24.0,2000.0,4.0,7,5,4,3,0,4,13,30.8,9,4,0,4,1,8,7,2,MF,20-24,Midfielder,Spain,Europe
1278,Unai López,ESP,Rayo Vallecano,La Liga,2024,29.0,1995.0,9.0,10,6,4,3,3,4,12,33.3,8,8,1,7,13,23,8,0,MF,25-29,Midfielder,Spain,Europe
1279,Iker Losada,ESP,Betis,La Liga,2024,23.0,2001.0,3.7,10,7,2,4,4,5,10,50.0,5,2,0,2,3,13,2,0,"MF,FW",20-24,Midfielder,Spain,Europe
1283,Sandi Lovrić,SVN,Udinese,Serie A,2024,26.0,1998.0,11.2,21,11,12,6,3,10,21,47.6,11,17,2,15,14,35,12,0,MF,25-29,Midfielder,Slovenia,Europe
1284,Pol Lozano,ESP,Espanyol,La Liga,2024,25.0,1999.0,10.0,31,22,11,16,4,14,30,46.7,16,15,2,13,10,41,11,0,MF,25-29,Midfielder,Spain,Europe
1288,José Luis Gayà,ESP,Valencia,La Liga,2024,29.0,1995.0,3.6,7,6,2,4,1,6,10,60.0,4,1,0,1,5,12,9,0,DF,25-29,Defender,Spain,Europe
1294,Saša Lukić,SRB,Fulham,Premier League,2024,28.0,1996.0,9.9,24,10,9,14,1,7,21,33.3,14,11,5,6,13,37,10,0,MF,25-29,Midfielder,Serbia,Europe
1295,Milos Lukovic,SRB,Strasbourg,Ligue 1,2024,19.0,2005.0,0.1,0,0,0,0,0,0,0,,0,0,0,0,0,0,0,0,"FW,MF",Under 20,Forward,Serbia,Europe
1314,Pablo Maffeo,ESP,Mallorca,La Liga,2024,27.0,1997.0,12.2,26,15,19,6,1,14,20,70.0,6,15,6,9,12,38,36,1,DF,25-29,Defender,Spain,Europe
1322,Jon Magunacelaya,ESP,Real Sociedad,La Liga,2024,24.0,2000.0,0.1,1,1,1,0,0,0,0,,0,0,0,0,0,1,0,0,MF,20-24,Midfielder,Spain,Europe
1328,Radosław Majecki,POL,Monaco,Ligue 1,2024,25.0,1999.0,7.0,0,0,0,0,0,0,0,,0,0,0,0,0,0,5,0,GK,25-29,Goalkeeper,Poland,Europe
1332,Nikola Maksimović,SRB,Montpellier,Ligue 1,2024,33.0,1991.0,5.7,9,5,6,3,0,6,7,85.7,1,5,4,1,6,15,24,1,DF,30-34,Defender,Serbia,Europe
1351,Javier Manquillo,ESP,Celta Vigo,La Liga,2024,30.0,1994.0,5.5,7,5,4,3,0,2,9,22.2,7,5,3,2,7,14,13,0,DF,30-34,Defender,Spain,Europe
1357,Filip Marchwiński,POL,Lecce,Serie A,2024,22.0,2002.0,0.2,0,0,0,0,0,0,0,,0,0,0,0,0,0,0,0,MF,20-24,Midfielder,Poland,Europe
1358,Óscar de Marcos,ESP,Athletic Club,La Liga,2024,35.0,1989.0,11.1,22,10,12,9,1,16,27,59.3,11,10,1,9,11,33,25,0,DF,35-39,Defender,Spain,Europe
1359,Alberto Marí,ESP,Valencia,La Liga,2024,23.0,2001.0,0.1,0,0,0,0,0,0,0,,0,0,0,0,0,0,0,0,FW,20-24,Forward,Spain,Europe
1360,Pablo Marí,ESP,Monza,Serie A,2024,31.0,1993.0,17.0,24,14,14,10,0,10,20,50.0,10,23,20,3,36,60,80,2,DF,30-34,Defender,Spain,Europe
1364,Pablo Marín,ESP,Real Sociedad,La Liga,2024,21.0,2003.0,1.0,4,3,1,3,0,1,2,50.0,1,0,0,0,0,4,2,0,MF,20-24,Midfielder,Spain,Europe
1367,Mika Màrmol,ESP,Las Palmas,La Liga,2024,22.0,2002.0,9.7,23,9,12,10,1,12,19,63.2,7,22,9,13,14,37,35,0,DF,20-24,Defender,Spain,Europe
1369,Mario Maroto,ESP,Valladolid,La Liga,2024,21.0,2003.0,0.2,0,0,0,0,0,0,1,0.0,1,0,0,0,2,2,1,0,MF,20-24,Midfielder,Spain,Europe
1371,Aarón Martín,ESP,Genoa,Serie A,2024,27.0,1997.0,15.2,34,24,17,15,2,17,24,70.8,7,15,5,10,9,43,31,1,DF,25-29,Defender,Spain,Europe
1372,Carlos Martín,ESP,Alavés,La Liga,2024,22.0,2002.0,7.2,21,10,9,8,4,5,24,20.8,19,14,1,13,2,23,9,0,"FW,MF",20-24,Forward,Spain,Europe
1373,Gerard Martín,ESP,Barcelona,La Liga,2024,22.0,2002.0,4.3,10,4,4,3,3,7,10,70.0,3,9,2,7,4,14,9,0,DF,20-24,Defender,Spain,Europe
1374,Iván Martín,ESP,Girona,La Liga,2024,25.0,1999.0,11.5,16,8,9,6,1,6,19,31.6,13,12,1,11,5,21,3,1,MF,25-29,Midfielder,Spain,Europe
1375,Jon Martin,ESP,Real Sociedad,La Liga,2024,18.0,2006.0,1.5,1,1,0,0,1,1,1,100.0,0,2,1,1,5,6,6,0,DF,Under 20,Defender,Spain,Europe
1377,Mario Martín,ESP,Valladolid,La Liga,2024,20.0,2004.0,9.2,28,14,14,13,1,12,27,44.4,15,15,4,11,9,37,26,4,MF,20-24,Midfielder,Spain,Europe
1379,Arnau Martinez,ESP,Girona,La Liga,2024,21.0,2003.0,12.9,20,12,12,4,4,13,20,65.0,7,5,3,2,6,26,27,2,"DF,MF",20-24,Defender,Spain,Europe
1381,Iñigo Martínez,ESP,Barcelona,La Liga,2024,33.0,1991.0,17.8,16,9,13,3,0,10,11,90.9,1,11,5,6,14,30,62,1,DF,30-34,Defender,Spain,Europe
1382,Javi Martínez,ESP,Osasuna,La Liga,2024,25.0,1999.0,0.1,0,0,0,0,0,0,0,,0,0,0,0,0,0,0,0,MF,25-29,Midfielder,Spain,Europe
1382,Javi Martínez,ESP,Osasuna,La Liga,2024,25.0,1999.0,0.1,0,0,0,0,0,0,0,,0,0,0,0,0,0,0,0,MF,25-29,Midfielder,Spain,Europe
1382,Javi Martínez,ESP,Osasuna,La Liga,2024,25.0,1999.0,0.1,0,0,0,0,0,0,0,,0,0,0,0,0,0,0,0,MF,25-29,Midfielder,Spain,Europe
1382,Javi Martínez,ESP,Osasuna,La Liga,2024,25.0,1999.0,0.1,0,0,0,0,0,0,0,,0,0,0,0,0,0,0,0,MF,25-29,Midfielder,Spain,Europe
1386,Toni Martínez,ESP,Alavés,La Liga,2024,27.0,1997.0,5.5,5,3,0,3,2,0,1,0.0,1,5,2,3,0,5,7,0,FW,25-29,Forward,Spain,Europe
1388,Javi Martón,ESP,Athletic Club,La Liga,2024,25.0,1999.0,0.6,0,0,0,0,0,0,0,,0,0,0,0,0,0,0,0,"FW,MF",25-29,Forward,Spain,Europe
1390,Marvin,ESP,Las Palmas,La Liga,2024,24.0,2000.0,6.0,12,5,5,4,3,5,17,29.4,12,9,3,6,5,17,16,0,"DF,FW",20-24,Defender,Spain,Europe
1394,Erhan Mašović,SRB,Bochum,Bundesliga,2024,26.0,1998.0,6.2,7,6,5,2,0,6,14,42.9,8,11,7,4,8,15,27,0,"DF,MF",25-29,Defender,Serbia,Europe
1396,Jaime Mata,ESP,Las Palmas,La Liga,2024,36.0,1988.0,4.0,4,0,1,3,0,3,8,37.5,5,4,1,3,1,5,5,0,FW,35-39,Forward,Spain,Europe
1401,Nemanja Matić,SRB,Lyon,Ligue 1,2024,36.0,1988.0,10.3,19,17,5,12,2,9,18,50.0,9,15,6,9,9,28,13,1,MF,35-39,Midfielder,Serbia,Europe
1412,Borja Mayoral,ESP,Getafe,La Liga,2024,27.0,1997.0,1.4,1,1,1,0,0,0,0,,0,1,0,1,0,1,1,0,FW,25-29,Forward,Spain,Europe
1440,Mateo Mejía,ESP,Sevilla,La Liga,2024,21.0,2003.0,0.1,0,0,0,0,0,0,0,,0,0,0,0,0,0,0,0,FW,20-24,Forward,Spain,Europe
1444,Brais Méndez,ESP,Real Sociedad,La Liga,2024,27.0,1997.0,11.2,16,11,5,7,4,7,16,43.8,9,9,1,8,4,20,12,1,MF,25-29,Midfielder,Spain,Europe
1450,Mikel Merino,ESP,Arsenal,Premier League,2024,28.0,1996.0,5.3,15,10,5,4,6,4,11,36.4,7,12,5,7,8,23,7,1,MF,25-29,Midfielder,Spain,Europe
1452,Víctor Meseguer,ESP,Valladolid,La Liga,2024,25.0,1999.0,4.6,10,6,4,4,2,2,10,20.0,8,3,0,3,2,12,4,1,MF,25-29,Midfielder,Spain,Europe
1460,Miguel,ESP,Leganés,La Liga,2024,25.0,1999.0,12.3,10,3,5,3,2,4,11,36.4,7,10,2,8,3,13,10,1,FW,25-29,Forward,Spain,Europe
1463,Nikola Milenković,SRB,Nott'ham Forest,Premier League,2024,27.0,1997.0,16.0,17,13,11,6,0,5,6,83.3,1,23,12,11,15,32,67,0,DF,25-29,Defender,Serbia,Europe
1465,Vanja Milinković-Savić,SRB,Torino,Serie A,2024,27.0,1997.0,16.0,0,0,0,0,0,0,2,0.0,2,0,0,0,0,0,7,1,GK,25-29,Goalkeeper,Serbia,Europe
1467,Luis Milla,ESP,Getafe,La Liga,2024,30.0,1994.0,17.8,33,23,18,13,2,17,36,47.2,19,19,0,19,14,47,13,0,MF,30-34,Midfielder,Spain,Europe
1468,Pere Milla,ESP,Espanyol,La Liga,2024,32.0,1992.0,2.5,3,1,2,0,1,0,10,0.0,10,9,2,7,2,5,2,0,"MF,FW",30-34,Midfielder,Spain,Europe
1476,Óscar Mingueza,ESP,Celta Vigo,La Liga,2024,25.0,1999.0,15.2,20,11,10,7,3,16,34,47.1,18,15,4,11,9,29,20,3,"MF,DF",25-29,Midfielder,Spain,Europe
1480,Rafa Mir,ESP,Valencia,La Liga,2024,27.0,1997.0,3.3,6,3,4,2,0,1,3,33.3,2,1,0,1,0,6,5,0,"MF,FW",25-29,Midfielder,Spain,Europe
1481,Juan Miranda,ESP,Bologna,Serie A,2024,24.0,2000.0,10.4,18,10,9,5,4,9,17,52.9,8,12,2,10,13,31,16,0,DF,20-24,Defender,Spain,Europe
1488,Jakub Moder,POL,Brighton,Premier League,2024,25.0,1999.0,0.1,0,0,0,0,0,0,2,0.0,2,0,0,0,0,0,2,0,MF,25-29,Midfielder,Poland,Europe
1494,Alberto Moleiro,ESP,Las Palmas,La Liga,2024,21.0,2003.0,14.3,17,9,7,9,1,13,28,46.4,15,17,0,17,8,25,5,0,"FW,MF",20-24,Forward,Spain,Europe
1497,Jon Moncayola,ESP,Osasuna,La Liga,2024,26.0,1998.0,11.8,35,18,7,23,5,13,29,44.8,16,18,1,17,8,43,12,0,MF,25-29,Midfielder,Spain,Europe
1501,Álvaro Morata,ESP,Milan,Serie A,2024,32.0,1992.0,9.1,8,6,2,5,1,3,6,50.0,3,4,1,3,5,13,4,0,"FW,MF",30-34,Forward,Spain,Europe
1504,Alberto Moreno,ESP,Como,Serie A,2024,32.0,1992.0,13.2,19,9,12,7,0,9,16,56.3,7,9,1,8,11,30,23,2,DF,30-34,Defender,Spain,Europe
1504,Alberto Moreno,ESP,Como,Serie A,2024,32.0,1992.0,13.2,19,9,12,7,0,9,16,56.3,7,9,1,8,11,30,23,2,DF,30-34,Defender,Spain,Europe
1504,Alberto Moreno,ESP,Como,Serie A,2024,32.0,1992.0,13.2,19,9,12,7,0,9,16,56.3,7,9,1,8,11,30,23,2,DF,30-34,Defender,Spain,Europe
1504,Alberto Moreno,ESP,Como,Serie A,2024,32.0,1992.0,13.2,19,9,12,7,0,9,16,56.3,7,9,1,8,11,30,23,2,DF,30-34,Defender,Spain,Europe
1505,Álex Moreno,ESP,Nott'ham Forest,Premier League,2024,31.0,1993.0,8.8,24,18,19,5,0,14,34,41.2,20,9,4,5,14,38,32,0,DF,30-34,Defender,Spain,Europe
1506,Gerard Moreno,ESP,Villarreal,La Liga,2024,32.0,1992.0,4.2,5,4,2,1,2,3,5,60.0,2,0,0,0,2,7,1,0,FW,30-34,Forward,Spain,Europe
1507,Tete Morente,ESP,Lecce,Serie A,2024,28.0,1996.0,7.6,11,8,4,5,2,3,18,16.7,15,8,1,7,6,17,8,1,"FW,MF",25-29,Forward,Spain,Europe
1508,Mateu Morey,ESP,Mallorca,La Liga,2024,24.0,2000.0,2.9,6,5,3,3,0,3,8,37.5,5,5,0,5,8,14,8,1,DF,20-24,Defender,Spain,Europe
1510,Manu Morlanes,ESP,Mallorca,La Liga,2024,25.0,1999.0,11.5,32,20,14,13,5,15,23,65.2,8,18,7,11,23,55,15,0,MF,25-29,Midfielder,Spain,Europe
1512,Raúl Moro,ESP,Valladolid,La Liga,2024,22.0,2002.0,12.9,14,8,11,2,1,8,20,40.0,12,6,0,6,9,23,6,0,"FW,MF",20-24,Forward,Spain,Europe
1515,Cristhian Mosquera,ESP,Valencia,La Liga,2024,20.0,2004.0,16.9,14,9,9,5,0,4,9,44.4,5,18,10,8,19,33,51,1,DF,20-24,Defender,Spain,Europe
1535,Aihen Muñoz,ESP,Real Sociedad,La Liga,2024,27.0,1997.0,4.4,5,4,3,2,0,4,12,33.3,8,2,1,1,10,15,20,0,DF,25-29,Defender,Spain,Europe
1536,Álex Muñoz,ESP,Las Palmas,La Liga,2024,30.0,1994.0,10.3,28,22,16,11,1,15,25,60.0,10,20,7,13,14,42,47,0,DF,30-34,Defender,Spain,Europe
1538,Iker Muñoz,ESP,Osasuna,La Liga,2024,22.0,2002.0,2.0,2,0,1,1,0,1,2,50.0,1,3,0,3,1,3,2,1,MF,20-24,Midfielder,Spain,Europe
1539,Javier Muñoz,ESP,Las Palmas,La Liga,2024,29.0,1995.0,13.1,25,19,10,9,6,9,22,40.9,13,14,1,13,17,42,22,2,"MF,DF",25-29,Midfielder,Spain,Europe
1563,Matija Nastasić,SRB,Leganés,La Liga,2024,31.0,1993.0,11.4,13,7,12,1,0,8,13,61.5,5,25,18,7,12,25,79,0,DF,30-34,Defender,Serbia,Europe
1565,Pau Navarro,ESP,Villarreal,La Liga,2024,19.0,2005.0,3.8,9,6,4,3,2,7,10,70.0,3,6,3,3,1,10,15,0,DF,Under 20,Defender,Spain,Europe
1566,Roberto Navarro,ESP,Mallorca,La Liga,2024,22.0,2002.0,9.9,22,16,10,8,4,6,13,46.2,7,13,0,13,11,33,8,0,"MF,FW",20-24,Midfielder,Spain,Europe
1567,Jesús Navas,ESP,Sevilla,La Liga,2024,39.0,1985.0,4.7,5,2,3,0,2,0,3,0.0,3,1,0,1,4,9,6,0,"FW,MF",35-39,Forward,Spain,Europe
1577,Kosta Nedeljković,SRB,Aston Villa,Premier League,2024,19.0,2005.0,1.1,7,5,1,3,3,2,3,66.7,1,1,0,1,0,7,3,0,DF,Under 20,Defender,Serbia,Europe
1600,Saúl Ñíguez,ESP,Sevilla,La Liga,2024,30.0,1994.0,5.2,11,8,3,5,3,2,8,25.0,6,8,1,7,7,18,9,0,MF,30-34,Midfielder,Spain,Europe
1611,Hugo Novoa,ESP,Alavés,La Liga,2024,21.0,2003.0,2.5,8,5,4,3,1,5,5,100.0,0,2,1,1,0,8,6,0,"DF,FW",20-24,Defender,Spain,Europe
1617,Unai Núñez,ESP,Athletic Club,La Liga,2024,27.0,1997.0,3.0,2,2,1,1,0,0,1,0.0,1,2,2,0,12,14,13,1,DF,25-29,Defender,Spain,Europe
1618,Antonio Nusa,NOR,RB Leipzig,Bundesliga,2024,19.0,2005.0,11.7,21,13,11,5,5,12,27,44.4,15,13,2,11,7,28,8,0,"MF,DF",Under 20,Midfielder,Norway,Europe
1620,Ørjan Nyland,NOR,Sevilla,La Liga,2024,34.0,1990.0,10.7,1,1,1,0,0,1,1,100.0,0,0,0,0,0,1,6,1,GK,30-34,Goalkeeper,Norway,Europe
1630,Jan Oblak,SVN,Atlético Madrid,La Liga,2024,31.0,1993.0,17.0,0,0,0,0,0,0,0,,0,0,0,0,0,0,4,1,GK,30-34,Goalkeeper,Slovenia,Europe
1634,Álvaro Odriozola,ESP,Real Sociedad,La Liga,2024,29.0,1995.0,0.5,1,1,1,0,0,0,0,,0,0,0,0,0,1,1,0,DF,25-29,Defender,Spain,Europe
1645,Olasagasti,ESP,Real Sociedad,La Liga,2024,24.0,2000.0,1.7,6,2,3,2,1,2,7,28.6,5,2,1,1,2,8,1,0,MF,20-24,Midfielder,Spain,Europe
1648,Brian Oliván,ESP,Espanyol,La Liga,2024,30.0,1994.0,9.1,12,9,6,6,0,4,12,33.3,8,6,2,4,7,19,19,0,DF,30-34,Defender,Spain,Europe
1651,Dani Olmo,ESP,Barcelona,La Liga,2024,26.0,1998.0,6.9,10,7,4,4,2,2,7,28.6,5,3,2,1,1,11,5,0,"MF,FW",25-29,Midfielder,Spain,Europe
1653,Warmed Omari,COM,Lyon,Ligue 1,2024,24.0,2000.0,0.1,0,0,0,0,0,0,0,,0,0,0,0,0,0,1,0,DF,20-24,Defender,Comoros,Africa
1670,Aimar Oroz,ESP,Osasuna,La Liga,2024,23.0,2001.0,16.3,19,10,9,6,4,7,24,29.2,17,17,2,15,15,34,2,0,"MF,FW",20-24,Midfielder,Spain,Europe
1679,David Otorbi,ESP,Valencia,La Liga,2024,17.0,2007.0,0.2,0,0,0,0,0,0,0,,0,1,0,1,0,0,0,0,MF,Under 20,Midfielder,Spain,Europe
1689,Mikel Oyarzabal,ESP,Real Sociedad,La Liga,2024,27.0,1997.0,12.2,10,5,3,4,3,4,9,44.4,5,7,0,7,0,10,8,0,"FW,MF",25-29,Forward,Spain,Europe
1692,Jon Pacheco,ESP,Real Sociedad,La Liga,2024,23.0,2001.0,5.3,5,3,4,1,0,3,5,60.0,2,6,5,1,5,10,22,1,DF,20-24,Defender,Spain,Europe
1694,Alex Padilla,ESP,Athletic Club,La Liga,2024,21.0,2003.0,3.6,0,0,0,0,0,0,0,,0,0,0,0,0,0,2,1,GK,20-24,Goalkeeper,Spain,Europe
1697,Isaac Palazón Camacho,ESP,Rayo Vallecano,La Liga,2024,29.0,1994.0,11.7,18,15,8,5,5,6,20,30.0,14,10,1,9,7,25,5,1,"FW,MF",25-29,Forward,Spain,Europe
1706,Aitor Paredes,ESP,Athletic Club,La Liga,2024,24.0,2000.0,11.4,8,7,6,2,0,4,9,44.4,5,15,7,8,15,23,67,2,DF,20-24,Defender,Spain,Europe
1708,Daniel Parejo,ESP,Villarreal,La Liga,2024,35.0,1989.0,12.9,23,18,14,7,2,11,26,42.3,15,10,3,7,10,33,17,1,MF,35-39,Midfielder,Spain,Europe
1712,Álvaro Pascual,ESP,Sevilla,La Liga,2024,22.0,2002.0,0.7,1,0,0,0,1,1,2,50.0,1,0,0,0,2,3,0,0,FW,20-24,Forward,Spain,Europe
1714,Patric,ESP,Lazio,Serie A,2024,31.0,1993.0,6.5,7,4,5,2,0,4,8,50.0,4,1,1,0,3,10,18,1,DF,30-34,Defender,Spain,Europe
1718,Strahinja Pavlović,SRB,Milan,Serie A,2024,23.0,2001.0,7.3,17,10,11,6,0,10,19,52.6,9,4,2,2,4,21,28,0,DF,20-24,Defender,Serbia,Europe
1723,Marcus Pedersen,NOR,Torino,Serie A,2024,24.0,2000.0,8.8,7,5,2,4,1,5,9,55.6,4,6,2,4,4,11,16,0,DF,20-24,Defender,Norway,Europe
1723,Marcus Pedersen,NOR,Torino,Serie A,2024,24.0,2000.0,8.8,7,5,2,4,1,5,9,55.6,4,6,2,4,4,11,16,0,DF,20-24,Defender,Norway,Europe
1723,Marcus Pedersen,NOR,Torino,Serie A,2024,24.0,2000.0,8.8,7,5,2,4,1,5,9,55.6,4,6,2,4,4,11,16,0,DF,20-24,Defender,Norway,Europe
1723,Marcus Pedersen,NOR,Torino,Serie A,2024,24.0,2000.0,8.8,7,5,2,4,1,5,9,55.6,4,6,2,4,4,11,16,0,DF,20-24,Defender,Norway,Europe
1724,Pedri,ESP,Barcelona,La Liga,2024,22.0,2002.0,15.8,28,14,7,18,3,13,38,34.2,25,23,2,21,12,40,11,1,MF,20-24,Midfielder,Spain,Europe
1725,Pedro,ESP,Lazio,Serie A,2024,37.0,1987.0,5.2,9,5,1,5,3,5,9,55.6,4,4,0,4,1,10,2,0,"FW,MF",35-39,Forward,Spain,Europe
1725,Pedro,ESP,Lazio,Serie A,2024,37.0,1987.0,5.2,9,5,1,5,3,5,9,55.6,4,4,0,4,1,10,2,0,"FW,MF",35-39,Forward,Spain,Europe
1725,Pedro,ESP,Lazio,Serie A,2024,37.0,1987.0,5.2,9,5,1,5,3,5,9,55.6,4,4,0,4,1,10,2,0,"FW,MF",35-39,Forward,Spain,Europe
1725,Pedro,ESP,Lazio,Serie A,2024,37.0,1987.0,5.2,9,5,1,5,3,5,9,55.6,4,4,0,4,1,10,2,0,"FW,MF",35-39,Forward,Spain,Europe
1725,Pedro,ESP,Lazio,Serie A,2024,37.0,1987.0,5.2,9,5,1,5,3,5,9,55.6,4,4,0,4,1,10,2,0,"FW,MF",35-39,Forward,Spain,Europe
1725,Pedro,ESP,Lazio,Serie A,2024,37.0,1987.0,5.2,9,5,1,5,3,5,9,55.6,4,4,0,4,1,10,2,0,"FW,MF",35-39,Forward,Spain,Europe
1725,Pedro,ESP,Lazio,Serie A,2024,37.0,1987.0,5.2,9,5,1,5,3,5,9,55.6,4,4,0,4,1,10,2,0,"FW,MF",35-39,Forward,Spain,Europe
1725,Pedro,ESP,Lazio,Serie A,2024,37.0,1987.0,5.2,9,5,1,5,3,5,9,55.6,4,4,0,4,1,10,2,0,"FW,MF",35-39,Forward,Spain,Europe
1725,Pedro,ESP,Lazio,Serie A,2024,37.0,1987.0,5.2,9,5,1,5,3,5,9,55.6,4,4,0,4,1,10,2,0,"FW,MF",35-39,Forward,Spain,Europe
1725,Pedro,ESP,Lazio,Serie A,2024,37.0,1987.0,5.2,9,5,1,5,3,5,9,55.6,4,4,0,4,1,10,2,0,"FW,MF",35-39,Forward,Spain,Europe
1725,Pedro,ESP,Lazio,Serie A,2024,37.0,1987.0,5.2,9,5,1,5,3,5,9,55.6,4,4,0,4,1,10,2,0,"FW,MF",35-39,Forward,Spain,Europe
1725,Pedro,ESP,Lazio,Serie A,2024,37.0,1987.0,5.2,9,5,1,5,3,5,9,55.6,4,4,0,4,1,10,2,0,"FW,MF",35-39,Forward,Spain,Europe
1725,Pedro,ESP,Lazio,Serie A,2024,37.0,1987.0,5.2,9,5,1,5,3,5,9,55.6,4,4,0,4,1,10,2,0,"FW,MF",35-39,Forward,Spain,Europe
1725,Pedro,ESP,Lazio,Serie A,2024,37.0,1987.0,5.2,9,5,1,5,3,5,9,55.6,4,4,0,4,1,10,2,0,"FW,MF",35-39,Forward,Spain,Europe
1725,Pedro,ESP,Lazio,Serie A,2024,37.0,1987.0,5.2,9,5,1,5,3,5,9,55.6,4,4,0,4,1,10,2,0,"FW,MF",35-39,Forward,Spain,Europe
1725,Pedro,ESP,Lazio,Serie A,2024,37.0,1987.0,5.2,9,5,1,5,3,5,9,55.6,4,4,0,4,1,10,2,0,"FW,MF",35-39,Forward,Spain,Europe
1727,Adrià Pedrosa,ESP,Sevilla,La Liga,2024,26.0,1998.0,11.2,31,21,22,4,5,19,32,59.4,13,20,4,16,9,40,36,0,DF,25-29,Defender,Spain,Europe
1729,Pejiño,ESP,Las Palmas,La Liga,2024,28.0,1996.0,0.2,1,1,0,1,0,1,1,100.0,0,0,0,0,0,1,0,0,FW,25-29,Forward,Spain,Europe
1737,Iñaki Peña,ESP,Barcelona,La Liga,2024,25.0,1999.0,13.5,0,0,0,0,0,0,2,0.0,2,0,0,0,0,0,20,1,GK,25-29,Goalkeeper,Spain,Europe
1738,Rubén Peña,ESP,Osasuna,La Liga,2024,33.0,1991.0,5.0,6,0,1,1,4,1,12,8.3,11,8,0,8,4,10,7,0,"FW,MF",30-34,Forward,Spain,Europe
1740,Peque,ESP,Sevilla,La Liga,2024,22.0,2002.0,8.0,9,3,3,5,1,3,11,27.3,8,11,0,11,7,16,4,0,"MF,FW",20-24,Midfielder,Spain,Europe
1748,Ayoze Pérez,ESP,Villarreal,La Liga,2024,31.0,1993.0,8.2,11,7,3,6,2,3,9,33.3,6,8,0,8,2,13,7,0,FW,30-34,Forward,Spain,Europe
1749,Carles Pérez,ESP,Getafe,La Liga,2024,26.0,1998.0,12.0,22,16,6,10,6,15,31,48.4,16,12,1,11,6,28,14,0,"MF,FW",25-29,Midfielder,Spain,Europe
1750,Francisco Perez,ESP,Valencia,La Liga,2024,22.0,2002.0,2.2,2,2,1,1,0,1,3,33.3,2,1,0,1,0,2,2,0,"FW,MF",20-24,Forward,Spain,Europe
1751,Kike Pérez,ESP,Valladolid,La Liga,2024,27.0,1997.0,10.9,33,22,13,18,2,13,24,54.2,11,14,3,11,7,40,15,0,MF,25-29,Midfielder,Spain,Europe
1752,Luis Pérez,ESP,Valladolid,La Liga,2024,29.0,1995.0,16.6,27,18,16,6,5,17,26,65.4,9,18,5,13,20,47,53,0,DF,25-29,Defender,Spain,Europe
1763,Đorđe Petrović,SRB,Strasbourg,Ligue 1,2024,25.0,1999.0,12.0,0,0,0,0,0,0,0,,0,0,0,0,0,0,9,0,GK,25-29,Goalkeeper,Serbia,Europe
1768,Pica,ESP,Alavés,La Liga,2024,22.0,2002.0,5.4,9,7,7,2,0,4,9,44.4,5,7,6,1,8,17,22,0,DF,20-24,Defender,Spain,Europe
1779,Yeremi Pino,ESP,Villarreal,La Liga,2024,22.0,2002.0,9.2,18,12,5,10,3,9,20,45.0,11,16,2,14,4,22,5,0,MF,20-24,Midfielder,Spain,Europe
1791,Pedro Porro,ESP,Tottenham,Premier League,2024,25.0,1999.0,16.0,31,22,11,13,7,20,37,54.1,17,24,9,15,18,49,42,1,DF,25-29,Defender,Spain,Europe
1792,Portu,ESP,Girona,La Liga,2024,32.0,1992.0,2.5,5,2,2,2,1,3,3,100.0,0,4,0,4,0,5,1,0,"FW,MF",30-34,Forward,Spain,Europe
1796,Beñat Prados,ESP,Athletic Club,La Liga,2024,23.0,2001.0,8.9,16,12,6,8,2,5,21,23.8,16,13,1,12,18,34,16,0,MF,20-24,Midfielder,Spain,Europe
1799,Abdón Prats,ESP,Mallorca,La Liga,2024,32.0,1992.0,2.4,1,1,1,0,0,0,0,,0,2,1,1,1,2,3,0,"FW,MF",30-34,Forward,Spain,Europe
1803,Javi Puado,ESP,Espanyol,La Liga,2024,26.0,1998.0,15.2,12,10,7,3,2,4,5,80.0,1,8,0,8,3,15,10,0,"FW,MF",25-29,Forward,Spain,Europe
1804,Tymoteusz Puchacz,POL,Holstein Kiel,Bundesliga,2024,25.0,1999.0,4.4,9,4,6,3,0,5,7,71.4,2,4,1,3,3,12,11,0,DF,25-29,Defender,Poland,Europe
1809,Dani Raba,ESP,Leganés,La Liga,2024,29.0,1995.0,5.0,14,8,7,5,2,6,14,42.9,8,5,0,5,6,20,5,0,"FW,MF",25-29,Forward,Spain,Europe
1812,Antonio Raillo,ESP,Mallorca,La Liga,2024,33.0,1991.0,17.6,16,10,8,5,3,7,8,87.5,1,22,17,5,22,38,82,1,DF,30-34,Defender,Spain,Europe
1815,Benito Ramírez,ESP,Las Palmas,La Liga,2024,29.0,1995.0,3.4,7,3,3,4,0,7,14,50.0,7,6,3,3,1,8,11,0,"DF,MF",25-29,Defender,Spain,Europe
1816,Sandro Ramírez,ESP,Las Palmas,La Liga,2024,29.0,1995.0,10.9,16,12,6,9,1,9,19,47.4,10,8,0,8,11,27,14,0,"FW,MF",25-29,Forward,Spain,Europe
1827,Raúl,ESP,Osasuna,La Liga,2024,24.0,2000.0,4.8,4,3,0,2,2,1,2,50.0,1,3,0,3,0,4,2,0,"FW,MF",20-24,Forward,Spain,Europe
1831,David Raya,ESP,Arsenal,Premier League,2024,29.0,1995.0,17.0,0,0,0,0,0,0,1,0.0,1,0,0,0,1,1,8,4,GK,25-29,Goalkeeper,Spain,Europe
1837,Pepe Reina,ESP,Como,Serie A,2024,42.0,1982.0,9.0,0,0,0,0,0,0,1,0.0,1,0,0,0,0,0,3,1,GK,Over 40,Goalkeeper,Spain,Europe
1840,Álex Remiro,ESP,Real Sociedad,La Liga,2024,29.0,1995.0,18.0,0,0,0,0,0,0,1,0.0,1,0,0,0,0,0,7,3,GK,25-29,Goalkeeper,Spain,Europe
1852,Diego Rico,ESP,Getafe,La Liga,2024,31.0,1993.0,16.0,41,20,23,15,3,21,37,56.8,16,14,1,13,18,59,31,1,DF,30-34,Defender,Spain,Europe
1854,Luis Rioja,ESP,Alavés,La Liga,2024,31.0,1993.0,0.3,2,1,0,1,1,1,2,50.0,1,2,0,2,0,2,0,0,FW,30-34,Forward,Spain,Europe
1855,Luis Rioja,ESP,Valencia,La Liga,2024,31.0,1993.0,14.5,19,12,3,11,5,8,20,40.0,12,15,0,15,15,34,21,0,"MF,DF",30-34,Midfielder,Spain,Europe
1856,Rodrigo Riquelme,ESP,Atlético Madrid,La Liga,2024,24.0,2000.0,4.5,8,3,3,5,0,4,9,44.4,5,2,0,2,1,9,3,0,"DF,MF",20-24,Defender,Spain,Europe
1857,Alberto Risco,ESP,Getafe,La Liga,2024,19.0,2005.0,0.8,4,4,2,0,2,1,6,16.7,5,2,0,2,0,4,0,0,"MF,FW",Under 20,Midfielder,Spain,Europe
1858,Mihailo Ristić,SRB,Celta Vigo,La Liga,2024,29.0,1995.0,1.4,3,3,2,1,0,1,2,50.0,1,0,0,0,0,3,4,0,"MF,DF",25-29,Midfielder,Serbia,Europe
1860,Gorka Rivera Alonso,ESP,Getafe,La Liga,2024,20.0,2004.0,0.2,2,0,0,2,0,2,2,100.0,0,0,0,0,0,2,0,0,"DF,MF",20-24,Defender,Spain,Europe
1861,Sergi Roberto,ESP,Como,Serie A,2024,32.0,1992.0,6.9,13,7,5,4,4,5,6,83.3,1,6,1,5,9,22,13,0,MF,30-34,Midfielder,Spain,Europe
1864,Marc Roca,ESP,Betis,La Liga,2024,28.0,1996.0,8.1,14,8,8,6,0,8,15,53.3,7,16,5,11,8,22,9,1,MF,25-29,Midfielder,Spain,Europe
1865,Rodri,ESP,Manchester City,Premier League,2024,28.0,1996.0,0.7,2,1,1,1,0,0,0,,0,1,0,1,1,3,0,0,MF,25-29,Midfielder,Spain,Europe
1865,Rodri,ESP,Manchester City,Premier League,2024,28.0,1996.0,0.7,2,1,1,1,0,0,0,,0,1,0,1,1,3,0,0,MF,25-29,Midfielder,Spain,Europe
1865,Rodri,ESP,Manchester City,Premier League,2024,28.0,1996.0,0.7,2,1,1,1,0,0,0,,0,1,0,1,1,3,0,0,MF,25-29,Midfielder,Spain,Europe
1865,Rodri,ESP,Manchester City,Premier League,2024,28.0,1996.0,0.7,2,1,1,1,0,0,0,,0,1,0,1,1,3,0,0,MF,25-29,Midfielder,Spain,Europe
1866,Rodri,ESP,Betis,La Liga,2024,24.0,2000.0,1.3,2,1,1,1,0,1,2,50.0,1,2,1,1,1,3,1,1,FW,20-24,Forward,Spain,Europe
1866,Rodri,ESP,Betis,La Liga,2024,24.0,2000.0,1.3,2,1,1,1,0,1,2,50.0,1,2,1,1,1,3,1,1,FW,20-24,Forward,Spain,Europe
1866,Rodri,ESP,Betis,La Liga,2024,24.0,2000.0,1.3,2,1,1,1,0,1,2,50.0,1,2,1,1,1,3,1,1,FW,20-24,Forward,Spain,Europe
1866,Rodri,ESP,Betis,La Liga,2024,24.0,2000.0,1.3,2,1,1,1,0,1,2,50.0,1,2,1,1,1,3,1,1,FW,20-24,Forward,Spain,Europe
1868,Óscar Rodríguez Arnaiz,ESP,Leganés,La Liga,2024,26.0,1998.0,7.5,18,8,7,8,3,6,16,37.5,10,5,1,4,9,27,10,0,MF,25-29,Midfielder,Spain,Europe
1869,Damián Rodríguez,ESP,Celta Vigo,La Liga,2024,21.0,2003.0,6.9,8,5,2,5,1,2,9,22.2,7,4,1,3,5,13,9,0,MF,20-24,Midfielder,Spain,Europe
1870,Dani Rodríguez,ESP,Mallorca,La Liga,2024,36.0,1988.0,11.4,25,16,11,9,5,8,10,80.0,2,9,1,8,4,29,14,0,"MF,FW",35-39,Midfielder,Spain,Europe
1870,Dani Rodríguez,ESP,Mallorca,La Liga,2024,36.0,1988.0,11.4,25,16,11,9,5,8,10,80.0,2,9,1,8,4,29,14,0,"MF,FW",35-39,Midfielder,Spain,Europe
1870,Dani Rodríguez,ESP,Mallorca,La Liga,2024,36.0,1988.0,11.4,25,16,11,9,5,8,10,80.0,2,9,1,8,4,29,14,0,"MF,FW",35-39,Midfielder,Spain,Europe
1870,Dani Rodríguez,ESP,Mallorca,La Liga,2024,36.0,1988.0,11.4,25,16,11,9,5,8,10,80.0,2,9,1,8,4,29,14,0,"MF,FW",35-39,Midfielder,Spain,Europe
1873,Javi Rodríguez,ESP,Celta Vigo,La Liga,2024,21.0,2003.0,12.7,25,16,17,8,0,14,22,63.6,8,13,1,12,19,44,44,0,DF,20-24,Defender,Spain,Europe
1874,Jesus Rodríguez,ESP,Betis,La Liga,2024,19.0,2005.0,1.0,2,2,0,2,0,2,2,100.0,0,0,0,0,1,3,0,0,FW,Under 20,Forward,Spain,Europe
1875,Kirian Rodríguez,ESP,Las Palmas,La Liga,2024,28.0,1996.0,15.9,27,13,11,14,2,19,38,50.0,19,22,4,18,7,34,17,0,MF,25-29,Midfielder,Spain,Europe
1882,Leo Román,ESP,Mallorca,La Liga,2024,24.0,2000.0,5.0,0,0,0,0,0,0,0,,0,0,0,0,0,0,0,0,GK,20-24,Goalkeeper,Spain,Europe
1883,Carlos Romero,ESP,Espanyol,La Liga,2024,23.0,2001.0,11.7,31,21,22,8,1,17,33,51.5,16,13,2,11,8,39,34,0,"DF,MF",20-24,Defender,Spain,Europe
1885,Isaac Romero,ESP,Sevilla,La Liga,2024,24.0,2000.0,12.7,6,3,0,3,3,1,9,11.1,8,12,1,11,1,7,14,0,FW,20-24,Forward,Spain,Europe
1887,Oriol Romeu,ESP,Girona,La Liga,2024,33.0,1991.0,8.5,23,13,9,11,3,10,14,71.4,4,12,3,9,3,26,8,0,MF,30-34,Midfielder,Spain,Europe
1905,Aitor Ruibal,ESP,Betis,La Liga,2024,28.0,1996.0,6.8,12,8,7,2,3,8,14,57.1,6,9,2,7,8,20,13,0,"FW,DF",25-29,Forward,Spain,Europe
1906,Abel Ruiz,ESP,Girona,La Liga,2024,24.0,2000.0,9.3,3,1,1,1,1,2,5,40.0,3,4,1,3,2,5,3,0,FW,20-24,Forward,Spain,Europe
1907,Ferrán Ruiz,ESP,Girona,La Liga,2024,21.0,2003.0,0.2,0,0,0,0,0,0,0,,0,2,1,1,1,1,0,0,MF,20-24,Midfielder,Spain,Europe
1908,Fabián Ruiz Peña,ESP,Paris S-G,Ligue 1,2024,28.0,1996.0,8.8,17,10,8,6,3,8,22,36.4,14,8,1,7,10,27,10,1,MF,25-29,Midfielder,Spain,Europe
1911,Julian Ryerson,NOR,Dortmund,Bundesliga,2024,27.0,1997.0,10.5,16,10,12,3,1,14,21,66.7,7,11,1,10,12,28,11,1,DF,25-29,Defender,Norway,Europe
1923,Jorge Sáenz,ESP,Leganés,La Liga,2024,28.0,1996.0,7.7,18,13,9,8,1,5,9,55.6,4,8,4,4,12,30,62,0,DF,25-29,Defender,Spain,Europe
1936,Kike Salas,ESP,Sevilla,La Liga,2024,22.0,2002.0,9.1,15,11,7,4,4,9,18,50.0,9,12,6,6,14,29,39,0,DF,20-24,Defender,Spain,Europe
1942,Lazar Samardzic,SRB,Atalanta,Serie A,2024,22.0,2002.0,5.7,8,7,1,4,3,3,5,60.0,2,4,1,3,1,9,4,0,"MF,FW",20-24,Midfielder,Serbia,Europe
1949,Chuky san jose,ESP,Valladolid,La Liga,2024,20.0,2004.0,1.0,1,0,0,0,1,1,1,100.0,0,2,0,2,0,1,0,0,"MF,FW",20-24,Midfielder,Spain,Europe
1951,Oihan Sancet,ESP,Athletic Club,La Liga,2024,24.0,2000.0,11.2,10,6,6,3,1,4,9,44.4,5,8,0,8,5,15,4,0,MF,20-24,Midfielder,Spain,Europe
1952,Antonio Sánchez,ESP,Mallorca,La Liga,2024,27.0,1997.0,8.9,15,9,11,3,1,9,19,47.4,10,11,2,9,11,26,20,0,"DF,MF",25-29,Defender,Spain,Europe
1953,Iván Sánchez,ESP,Valladolid,La Liga,2024,32.0,1992.0,8.3,18,11,9,4,5,7,16,43.8,9,10,3,7,8,26,4,0,"MF,FW",30-34,Midfielder,Spain,Europe
1954,Javi Sánchez,ESP,Valladolid,La Liga,2024,27.0,1997.0,10.8,12,9,9,3,0,10,16,62.5,6,19,15,4,9,21,56,2,DF,25-29,Defender,Spain,Europe
1955,Juanlu Sánchez,ESP,Sevilla,La Liga,2024,21.0,2003.0,7.2,12,9,7,3,2,10,12,83.3,2,5,0,5,7,19,8,0,MF,20-24,Midfielder,Spain,Europe
1956,Manu Sánchez,ESP,Alavés,La Liga,2024,24.0,2000.0,12.5,22,16,9,8,5,13,23,56.5,10,23,2,21,13,35,27,0,DF,20-24,Defender,Spain,Europe
1957,Robert Sánchez,ESP,Chelsea,Premier League,2024,27.0,1997.0,16.0,0,0,0,0,0,0,1,0.0,1,0,0,0,1,1,12,4,GK,25-29,Goalkeeper,Spain,Europe
1967,Jesús Santiago,ESP,Getafe,La Liga,2024,20.0,2004.0,3.2,11,7,5,6,0,4,7,57.1,3,4,1,3,0,11,2,0,MF,20-24,Midfielder,Spain,Europe
1971,Pablo Sarabia,ESP,Wolves,Premier League,2024,32.0,1992.0,2.0,5,3,2,2,1,3,5,60.0,2,3,0,3,2,7,2,1,"MF,FW",30-34,Midfielder,Spain,Europe
1989,Patrik Schick,CZE,Leverkusen,Bundesliga,2024,28.0,1996.0,5.6,4,3,0,2,2,0,0,,0,2,0,2,0,4,3,0,FW,25-29,Forward,Czech Republic,Europe
2005,Aleksandar Sedlar,SRB,Alavés,La Liga,2024,33.0,1991.0,4.7,15,9,5,10,0,7,9,77.8,2,2,1,1,7,22,12,1,DF,30-34,Defender,Serbia,Europe
2011,Marvin Senaya,TOG,Strasbourg,Ligue 1,2024,23.0,2001.0,2.2,6,3,3,2,1,5,11,45.5,6,5,2,3,7,13,10,0,DF,20-24,Defender,Togo,Africa
2015,Sergi,ESP,Leganés,La Liga,2024,32.0,1992.0,17.5,22,17,12,9,1,10,16,62.5,6,21,14,7,28,50,102,2,DF,30-34,Defender,Spain,Europe
2016,Nicolás Serrano,ESP,Athletic Club,La Liga,2024,21.0,2003.0,1.1,1,1,0,1,0,1,3,33.3,2,4,0,4,1,2,1,0,FW,20-24,Forward,Spain,Europe
2017,Benjamin Šeško,SVN,RB Leipzig,Bundesliga,2024,21.0,2003.0,11.3,5,2,0,3,2,1,6,16.7,5,5,3,2,4,9,8,0,"FW,MF",20-24,Forward,Slovenia,Europe
2040,Unai Simón,ESP,Athletic Club,La Liga,2024,27.0,1997.0,2.0,0,0,0,0,0,0,0,,0,0,0,0,0,0,1,1,GK,25-29,Goalkeeper,Spain,Europe
1569,Youssouf Ndayishimiye,BDI,Nice,Ligue 1,2024,26.0,1998.0,6.5,16,7,12,3,1,7,11,63.6,4,8,5,3,7,23,32,1,"DF,MF",25-29,Defender,Burundi,Africa
2049,Ibrahim Sissoko,MLI,Saint-Étienne,Ligue 1,2024,29.0,1995.0,8.9,11,9,5,3,3,2,5,40.0,3,9,1,8,2,13,13,0,FW,25-29,Forward,Mali,Africa
2049,Ibrahim Sissoko,MLI,Saint-Étienne,Ligue 1,2024,29.0,1995.0,8.9,11,9,5,3,3,2,5,40.0,3,9,1,8,2,13,13,0,FW,25-29,Forward,Mali,Africa
2049,Ibrahim Sissoko,MLI,Saint-Étienne,Ligue 1,2024,29.0,1995.0,8.9,11,9,5,3,3,2,5,40.0,3,9,1,8,2,13,13,0,FW,25-29,Forward,Mali,Africa
2049,Ibrahim Sissoko,MLI,Saint-Étienne,Ligue 1,2024,29.0,1995.0,8.9,11,9,5,3,3,2,5,40.0,3,9,1,8,2,13,13,0,FW,25-29,Forward,Mali,Africa
2050,Ibrahima Sissoko,MLI,Bochum,Bundesliga,2024,27.0,1997.0,13.0,31,21,16,13,2,10,20,50.0,10,15,4,11,15,46,23,0,MF,25-29,Midfielder,Mali,Africa
2051,Niama Sissoko,MLI,Reims,Ligue 1,2024,19.0,2005.0,0.2,0,0,0,0,0,0,0,,0,0,0,0,0,0,0,0,FW,Under 20,Forward,Mali,Africa
2053,Tim Skarke,GER,Union Berlin,Bundesliga,2024,28.0,1996.0,5.5,3,3,1,2,0,3,6,50.0,3,3,0,3,2,5,5,0,"FW,MF",25-29,Forward,Germany,Europe
2054,Ellyes Skhiri,TUN,Eint Frankfurt,Bundesliga,2024,29.0,1995.0,10.0,10,6,4,5,1,4,14,28.6,10,20,4,16,10,20,15,2,MF,25-29,Midfielder,Tunisia,Africa
2055,Oliver Skipp,ENG,Leicester City,Premier League,2024,24.0,2000.0,7.6,9,2,2,6,1,6,9,66.7,3,9,3,6,8,17,8,1,MF,20-24,Midfielder,England,Europe
2058,Robert Skov,DEN,Union Berlin,Bundesliga,2024,28.0,1996.0,4.2,11,8,7,4,0,8,11,72.7,3,4,0,4,4,15,4,0,"DF,MF",25-29,Defender,Denmark,Europe
2059,Milan Škriniar,SVK,Paris S-G,Ligue 1,2024,29.0,1995.0,4.2,7,5,3,4,0,3,3,100.0,0,7,6,1,3,10,16,0,DF,25-29,Defender,Slovakia,Europe
2060,Steven Skrzybski,GER,Holstein Kiel,Bundesliga,2024,32.0,1992.0,6.0,9,1,1,4,4,4,9,44.4,5,9,0,9,5,14,2,0,"FW,MF",30-34,Forward,Germany,Europe
2061,Naatan Skyttä,FIN,Toulouse,Ligue 1,2024,22.0,2002.0,0.1,1,0,0,0,1,0,0,,0,0,0,0,0,1,0,0,FW,20-24,Forward,Finland,Europe
2062,William Smallbone,IRL,Southampton,Premier League,2024,24.0,2000.0,2.7,7,3,3,3,1,3,5,60.0,2,3,0,3,0,7,2,1,MF,20-24,Midfielder,Republic of Ireland,Europe
2063,Adam Smith,ENG,Bournemouth,Premier League,2024,33.0,1991.0,11.5,16,8,8,4,4,9,19,47.4,10,9,2,7,11,27,37,1,DF,30-34,Defender,England,Europe
2063,Adam Smith,ENG,Bournemouth,Premier League,2024,33.0,1991.0,11.5,16,8,8,4,4,9,19,47.4,10,9,2,7,11,27,37,1,DF,30-34,Defender,England,Europe
2063,Adam Smith,ENG,Bournemouth,Premier League,2024,33.0,1991.0,11.5,16,8,8,4,4,9,19,47.4,10,9,2,7,11,27,37,1,DF,30-34,Defender,England,Europe
2063,Adam Smith,ENG,Bournemouth,Premier League,2024,33.0,1991.0,11.5,16,8,8,4,4,9,19,47.4,10,9,2,7,11,27,37,1,DF,30-34,Defender,England,Europe
2064,Eric Smith,SWE,St. Pauli,Bundesliga,2024,27.0,1997.0,13.4,18,12,13,5,0,10,14,71.4,4,20,7,13,22,40,46,3,DF,25-29,Defender,Sweden,Europe
2065,Justin Smith,CAN,Espanyol,La Liga,2024,21.0,2003.0,2.3,9,3,3,6,0,4,6,66.7,2,5,1,4,4,13,3,0,MF,20-24,Midfielder,Canada,North America
2066,Emile Smith Rowe,ENG,Fulham,Premier League,2024,24.0,2000.0,12.1,21,13,6,6,9,6,17,35.3,11,10,1,9,7,28,7,0,MF,20-24,Midfielder,England,Europe
2067,Eduard Sobol,UKR,Strasbourg,Ligue 1,2024,29.0,1995.0,0.4,0,0,0,0,0,0,0,,0,1,0,1,0,0,2,0,DF,25-29,Defender,Ukraine,Europe
2068,Simon Sohm,SUI,Parma,Serie A,2024,23.0,2001.0,14.8,14,8,4,7,3,9,19,47.4,10,5,1,4,12,26,23,0,MF,20-24,Midfielder,Switzerland,Europe
2070,Dominic Solanke,ENG,Tottenham,Premier League,2024,27.0,1997.0,13.8,11,7,1,8,2,2,6,33.3,4,8,2,6,0,11,18,0,FW,25-29,Forward,England,Europe
2073,Jhon Solis,COL,Girona,La Liga,2024,20.0,2004.0,3.6,4,4,2,2,0,3,9,33.3,6,10,1,9,3,7,4,0,MF,20-24,Midfielder,Colombia,South America
2074,Yann Sommer,SUI,Inter,Serie A,2024,36.0,1988.0,16.0,0,0,0,0,0,0,0,,0,0,0,0,0,0,4,1,GK,35-39,Goalkeeper,Switzerland,Europe
2077,Borna Sosa,CRO,Torino,Serie A,2024,26.0,1998.0,6.1,11,9,5,3,3,6,11,54.5,5,3,0,3,7,18,14,0,DF,25-29,Defender,Croatia,Europe
2078,Ramón Sosa,PAR,Nott'ham Forest,Premier League,2024,25.0,1999.0,1.7,3,2,2,0,1,1,2,50.0,1,3,0,3,2,5,2,0,"FW,MF",25-29,Forward,Paraguay,South America
2080,Florian Sotoca,FRA,Lens,Ligue 1,2024,34.0,1990.0,8.2,9,7,2,1,6,6,9,66.7,3,8,1,7,2,11,13,0,"FW,MF",30-34,Forward,France,Europe
2081,Riccardo Sottil,ITA,Fiorentina,Serie A,2024,25.0,1999.0,6.1,3,2,2,1,0,1,2,50.0,1,1,0,1,3,6,3,0,"FW,MF",25-29,Forward,Italy,Europe
2083,Matìas Soulé,ARG,Roma,Serie A,2024,21.0,2003.0,6.0,4,3,0,2,2,1,6,16.7,5,8,1,7,3,7,5,0,"MF,FW",20-24,Midfielder,Argentina,South America
2084,Boubakary Soumaré,FRA,Leicester City,Premier League,2024,25.0,1999.0,6.3,13,5,9,3,1,7,11,63.6,4,7,2,5,4,17,5,1,MF,25-29,Midfielder,France,Europe
2085,Issa Soumaré,SEN,Le Havre,Ligue 1,2024,24.0,2000.0,6.9,4,2,0,2,2,2,8,25.0,6,5,1,4,3,7,7,0,"FW,MF",20-24,Forward,Senegal,Africa
2086,Djibril Sow,SUI,Sevilla,La Liga,2024,27.0,1997.0,8.3,5,3,2,3,0,0,3,0.0,3,4,1,3,6,11,5,0,MF,25-29,Midfielder,Switzerland,Europe
2087,Saidou Sow,GUI,Strasbourg,Ligue 1,2024,22.0,2002.0,11.3,9,5,6,3,0,6,12,50.0,6,15,9,6,15,24,37,2,DF,20-24,Defender,Guinea,Africa
2088,Djed Spence,ENG,Tottenham,Premier League,2024,24.0,2000.0,2.6,10,9,6,3,1,5,5,100.0,0,4,3,1,4,14,10,0,DF,20-24,Defender,England,Europe
2089,Leonardo Spinazzola,ITA,Napoli,Serie A,2024,31.0,1993.0,3.0,3,3,0,2,1,1,2,50.0,1,4,1,3,0,3,7,1,DF,30-34,Defender,Italy,Europe
2090,Anton Stach,GER,Hoffenheim,Bundesliga,2024,26.0,1998.0,14.2,36,26,15,20,1,18,25,72.0,7,18,8,10,21,57,52,1,"DF,MF",25-29,Defender,Germany,Europe
2091,Jens Stage,DEN,Werder Bremen,Bundesliga,2024,28.0,1996.0,9.4,15,11,8,7,0,8,16,50.0,8,18,4,14,11,26,19,1,MF,25-29,Midfielder,Denmark,Europe
2093,Jay Stansfield,ENG,Fulham,Premier League,2024,22.0,2002.0,0.0,0,0,0,0,0,0,0,,0,0,0,0,0,0,0,0,MF,20-24,Midfielder,England,Europe
2094,Carl Starfelt,SWE,Celta Vigo,La Liga,2024,29.0,1995.0,15.2,20,10,13,6,1,8,12,66.7,4,21,14,7,23,43,79,1,DF,25-29,Defender,Sweden,Europe
2095,Niklas Stark,GER,Werder Bremen,Bundesliga,2024,29.0,1995.0,9.1,15,9,9,5,1,6,9,66.7,3,21,15,6,15,30,49,0,DF,25-29,Defender,Germany,Europe
2096,Lucas Stassin,BEL,Saint-Étienne,Ligue 1,2024,20.0,2004.0,5.9,5,3,1,2,2,3,5,60.0,2,4,0,4,0,5,3,0,FW,20-24,Forward,Belgium,Europe
2097,Jason Steele,ENG,Brighton,Premier League,2024,34.0,1990.0,2.0,0,0,0,0,0,0,0,,0,0,0,0,0,0,1,0,GK,30-34,Goalkeeper,England,Europe
2098,Orri Steinn Óskarsson,ISL,Real Sociedad,La Liga,2024,20.0,2004.0,4.2,4,4,1,1,2,1,6,16.7,5,6,0,6,0,4,5,0,FW,20-24,Forward,Iceland,Europe
2099,Pascal Stenzel,GER,Stuttgart,Bundesliga,2024,28.0,1996.0,1.5,1,0,1,0,0,0,1,0.0,1,4,1,3,0,1,4,0,DF,25-29,Defender,Germany,Europe
2100,Jack Stephens,ENG,Southampton,Premier League,2024,30.0,1994.0,8.8,15,10,12,3,0,6,16,37.5,10,8,6,2,5,20,32,2,DF,30-34,Defender,England,Europe
2101,Leonidas Stergiou,SUI,Stuttgart,Bundesliga,2024,22.0,2002.0,2.3,9,6,4,5,0,8,8,100.0,0,3,0,3,2,11,6,0,DF,20-24,Defender,Switzerland,Europe
2102,Raheem Sterling,ENG,Arsenal,Premier League,2024,30.0,1994.0,1.6,1,1,0,1,0,1,3,33.3,2,1,0,1,0,1,0,0,"MF,FW",30-34,Midfielder,England,Europe
2103,Enzo Sternal,FRA,Marseille,Ligue 1,2024,17.0,2007.0,0.3,0,0,0,0,0,0,0,,0,0,0,0,0,0,0,0,"FW,MF",Under 20,Forward,France,Europe
2104,Ross Stewart,SCO,Southampton,Premier League,2024,28.0,1996.0,1.5,0,0,0,0,0,0,3,0.0,3,3,0,3,0,0,4,0,"FW,MF",25-29,Forward,Scotland,Europe
2104,Ross Stewart,SCO,Southampton,Premier League,2024,28.0,1996.0,1.5,0,0,0,0,0,0,3,0.0,3,3,0,3,0,0,4,0,"FW,MF",25-29,Forward,Scotland,Europe
2104,Ross Stewart,SCO,Southampton,Premier League,2024,28.0,1996.0,1.5,0,0,0,0,0,0,3,0.0,3,3,0,3,0,0,4,0,"FW,MF",25-29,Forward,Scotland,Europe
2104,Ross Stewart,SCO,Southampton,Premier League,2024,28.0,1996.0,1.5,0,0,0,0,0,0,3,0.0,3,3,0,3,0,0,4,0,"FW,MF",25-29,Forward,Scotland,Europe
2105,Angelo Stiller,GER,Stuttgart,Bundesliga,2024,23.0,2001.0,14.3,23,11,11,11,1,8,14,57.1,6,9,4,5,9,32,25,1,MF,20-24,Midfielder,Germany,Europe
2106,Kevin Stöger,AUT,Gladbach,Bundesliga,2024,31.0,1993.0,7.8,16,9,10,3,3,8,20,40.0,12,13,1,12,6,22,13,1,"MF,FW",30-34,Midfielder,Austria,Europe
2109,John Stones,ENG,Manchester City,Premier League,2024,30.0,1994.0,3.7,5,2,2,2,1,4,4,100.0,0,2,0,2,3,8,9,1,"DF,MF",30-34,Defender,England,Europe
2111,Gabriel Strefezza,BRA,Como,Serie A,2024,27.0,1997.0,14.1,30,21,11,10,9,12,27,44.4,15,12,2,10,4,34,13,0,"FW,MF",25-29,Forward,Brazil,South America
2112,Cristhian Stuani,URU,Girona,La Liga,2024,38.0,1986.0,3.1,2,2,0,2,0,1,2,50.0,1,2,0,2,3,5,2,0,FW,35-39,Forward,Uruguay,South America
2115,Gabriel Suazo,CHI,Toulouse,Ligue 1,2024,27.0,1997.0,8.2,25,16,11,6,8,14,28,50.0,14,12,1,11,14,39,8,0,DF,25-29,Defender,Chile,South America
2116,Luka Sučić,CRO,Real Sociedad,La Liga,2024,22.0,2002.0,11.8,18,13,5,10,3,7,14,50.0,7,17,2,15,9,27,7,0,MF,20-24,Midfielder,Croatia,Europe
2117,Yukinari Sugawara,JPN,Southampton,Premier League,2024,24.0,2000.0,9.7,21,12,11,9,1,12,19,63.2,7,12,5,7,6,27,27,2,DF,20-24,Defender,Japan,Asia
2118,Niklas Süle,GER,Dortmund,Bundesliga,2024,29.0,1995.0,5.4,5,4,4,1,0,4,5,80.0,1,3,3,0,1,6,26,0,DF,25-29,Defender,Germany,Europe
2119,Ibrahim Sulemana,GHA,Atalanta,Serie A,2024,21.0,2003.0,0.3,2,1,1,1,0,1,1,100.0,0,0,0,0,0,2,0,0,MF,20-24,Midfielder,Ghana,Africa
2120,Kamaldeen Sulemana,GHA,Southampton,Premier League,2024,22.0,2002.0,0.7,4,4,2,1,1,3,4,75.0,1,1,0,1,2,6,1,0,"FW,MF",20-24,Forward,Ghana,Africa
2121,Crysencio Summerville,NED,West Ham,Premier League,2024,23.0,2001.0,7.1,13,7,2,8,3,3,8,37.5,5,10,4,6,0,13,7,0,"FW,MF",20-24,Forward,Netherlands,Europe
2122,Tomáš Suslov,SVK,Hellas Verona,Serie A,2024,22.0,2002.0,9.9,22,15,6,11,5,9,23,39.1,14,16,1,15,3,25,6,0,"FW,MF",20-24,Forward,Slovakia,Europe
2124,Zion Suzuki,JPN,Parma,Serie A,2024,22.0,2002.0,15.8,1,0,1,0,0,1,1,100.0,0,0,0,0,0,1,12,4,GK,20-24,Goalkeeper,Japan,Asia
2125,Mattias Svanberg,SWE,Wolfsburg,Bundesliga,2024,25.0,1999.0,5.2,8,4,1,5,2,2,6,33.3,4,3,0,3,4,12,5,0,MF,25-29,Midfielder,Sweden,Europe
2126,Marin Šverko,CRO,Venezia,Serie A,2024,26.0,1998.0,8.6,11,5,7,4,0,5,5,100.0,0,6,3,3,13,24,29,1,DF,25-29,Defender,Croatia,Europe
2128,Michael Svoboda,AUT,Venezia,Serie A,2024,26.0,1998.0,14.6,26,14,19,6,1,8,19,42.1,11,19,11,8,22,48,66,2,DF,25-29,Defender,Austria,Europe
2129,Williot Swedberg,SWE,Celta Vigo,La Liga,2024,20.0,2004.0,7.6,8,7,3,4,1,6,8,75.0,2,8,1,7,1,9,4,1,"FW,MF",20-24,Forward,Sweden,Europe
2130,Abakar Sylla,CIV,Strasbourg,Ligue 1,2024,22.0,2002.0,7.2,19,10,10,7,2,11,12,91.7,1,12,7,5,7,26,29,0,DF,20-24,Defender,Ivory Coast,Africa
2131,Issiaga Sylla,GUI,Montpellier,Ligue 1,2024,30.0,1994.0,7.6,19,6,14,5,0,11,21,52.4,10,8,3,5,7,26,22,0,"DF,MF",30-34,Defender,Guinea,Africa
2132,Mamadou Sylla,SEN,Valladolid,La Liga,2024,30.0,1994.0,8.4,2,0,0,0,2,1,2,50.0,1,3,0,3,1,3,8,1,"FW,MF",30-34,Forward,Senegal,Africa
2132,Mamadou Sylla,SEN,Valladolid,La Liga,2024,30.0,1994.0,8.4,2,0,0,0,2,1,2,50.0,1,3,0,3,1,3,8,1,"FW,MF",30-34,Forward,Senegal,Africa
2132,Mamadou Sylla,SEN,Valladolid,La Liga,2024,30.0,1994.0,8.4,2,0,0,0,2,1,2,50.0,1,3,0,3,1,3,8,1,"FW,MF",30-34,Forward,Senegal,Africa
2132,Mamadou Sylla,SEN,Valladolid,La Liga,2024,30.0,1994.0,8.4,2,0,0,0,2,1,2,50.0,1,3,0,3,1,3,8,1,"FW,MF",30-34,Forward,Senegal,Africa
2133,Sammie Szmodics,IRL,Ipswich Town,Premier League,2024,29.0,1995.0,9.1,12,8,2,8,2,5,16,31.3,11,8,1,7,4,16,10,0,FW,25-29,Forward,Republic of Ireland,Europe
2134,Dominik Szoboszlai,HUN,Liverpool,Premier League,2024,24.0,2000.0,12.4,14,9,5,5,4,7,17,41.2,10,22,2,20,7,21,6,0,MF,20-24,Midfielder,Hungary,Europe
2136,Musa Al-Taamari,JOR,Montpellier,Ligue 1,2024,27.0,1997.0,7.4,12,8,4,4,4,7,13,53.8,6,1,0,1,3,15,1,1,FW,25-29,Forward,Jordan,Asia
2137,Haris Tabakovic,BIH,Hoffenheim,Bundesliga,2024,30.0,1994.0,3.5,1,1,0,0,1,0,1,0.0,1,2,1,1,1,2,7,0,"FW,MF",30-34,Forward,Bosnia and Herzegovina,Europe
2138,Nicolás Tagliafico,ARG,Lyon,Ligue 1,2024,32.0,1992.0,7.9,27,17,9,11,7,15,20,75.0,5,11,4,7,17,44,21,0,DF,30-34,Defender,Argentina,South America
2139,Jonathan Tah,GER,Leverkusen,Bundesliga,2024,28.0,1996.0,15.0,6,5,4,1,1,3,5,60.0,2,13,8,5,15,21,50,2,DF,25-29,Defender,Germany,Europe
2140,Adrien Tameze,CMR,Torino,Serie A,2024,30.0,1994.0,3.6,2,1,0,2,0,0,6,0.0,6,3,3,0,10,12,3,1,"MF,DF",30-34,Midfielder,Cameroon,Africa
2141,Renato Tapia,PER,Leganés,La Liga,2024,29.0,1995.0,10.3,27,15,12,13,2,6,20,30.0,14,26,13,13,11,38,37,0,"MF,DF",25-29,Midfielder,Peru,South America
2142,Edmond Tapsoba,BFA,Leverkusen,Bundesliga,2024,25.0,1999.0,14.9,26,17,13,10,3,12,24,50.0,12,7,5,2,13,39,46,0,DF,25-29,Defender,Burkina Faso,Africa
2143,Florian Tardieu,FRA,Saint-Étienne,Ligue 1,2024,32.0,1992.0,1.9,1,1,1,0,0,0,2,0.0,2,3,1,2,3,4,2,0,MF,30-34,Midfielder,France,Europe
2144,Mehdi Taremi,IRN,Inter,Serie A,2024,32.0,1992.0,2.7,2,1,0,1,1,0,0,,0,5,0,5,0,2,3,0,FW,30-34,Forward,Iran,Asia
2145,Oussama Targhalline,MAR,Le Havre,Ligue 1,2024,22.0,2002.0,9.3,17,13,11,2,4,4,11,36.4,7,12,6,6,14,31,7,1,MF,20-24,Midfielder,Morocco,Africa
2146,James Tarkowski,ENG,Everton,Premier League,2024,32.0,1992.0,15.9,36,22,20,14,2,17,28,60.7,11,27,22,5,15,51,92,2,DF,30-34,Defender,England,Europe
2148,Nuno Tavares,POR,Lazio,Serie A,2024,24.0,2000.0,10.8,19,16,9,6,4,9,20,45.0,11,7,1,6,11,30,29,1,DF,20-24,Defender,Portugal,Europe
2149,Marcus Tavernier,ENG,Bournemouth,Premier League,2024,25.0,1999.0,12.7,31,18,9,13,9,7,19,36.8,12,8,0,8,3,34,8,0,"FW,MF",25-29,Forward,England,Europe
2150,Charlie Taylor,ENG,Southampton,Premier League,2024,31.0,1993.0,2.5,7,5,4,3,0,5,6,83.3,1,5,3,2,3,10,21,1,DF,30-34,Defender,England,Europe
2151,Jack Taylor,IRL,Ipswich Town,Premier League,2024,26.0,1998.0,3.7,5,1,2,3,0,3,8,37.5,5,3,1,2,3,8,12,0,MF,25-29,Midfielder,Republic of Ireland,Europe
2152,Loum Tchaouna,FRA,Lazio,Serie A,2024,21.0,2003.0,3.0,5,3,1,1,3,3,7,42.9,4,1,0,1,3,8,1,1,"FW,MF",20-24,Forward,France,Europe
2153,Jackson Tchatchoua,CMR,Hellas Verona,Serie A,2024,23.0,2001.0,15.4,26,13,18,5,3,19,26,73.1,7,14,7,7,8,34,32,0,"DF,MF",20-24,Defender,Cameroon,Africa
2154,Enzo Tchato,CMR,Montpellier,Ligue 1,2024,22.0,2002.0,10.8,21,12,13,7,1,12,24,50.0,12,18,5,13,14,35,29,0,DF,20-24,Defender,Cameroon,Africa
2155,Aurélien Tchouaméni,FRA,Real Madrid,La Liga,2024,24.0,2000.0,13.2,24,11,11,12,1,9,19,47.4,10,11,9,2,24,48,20,0,"MF,DF",20-24,Midfielder,France,Europe
2158,Mathys Tel,FRA,Bayern Munich,Bundesliga,2024,19.0,2005.0,2.3,2,2,0,2,0,0,0,,0,0,0,0,1,3,1,0,"FW,MF",Under 20,Forward,France,Europe
2159,Nathan Tella,NGA,Leverkusen,Bundesliga,2024,25.0,1999.0,4.7,4,3,1,2,1,2,6,33.3,4,5,0,5,2,6,1,0,"MF,FW",25-29,Midfielder,Nigeria,Africa
2160,Nahuel Tenaglia,ARG,Alavés,La Liga,2024,28.0,1996.0,14.3,39,25,28,8,3,21,33,63.6,12,9,2,7,14,53,44,0,DF,25-29,Defender,Argentina,South America
2161,Casper Tengstedt,DEN,Hellas Verona,Serie A,2024,24.0,2000.0,11.0,6,4,0,4,2,3,5,60.0,2,4,1,3,3,9,20,0,"FW,MF",20-24,Forward,Denmark,Europe
2162,Marc-André ter Stegen,GER,Barcelona,La Liga,2024,32.0,1992.0,5.5,0,0,0,0,0,0,1,0.0,1,0,0,0,0,0,2,2,GK,30-34,Goalkeeper,Germany,Europe
2163,Filippo Terracciano,ITA,Milan,Serie A,2024,21.0,2003.0,5.0,6,3,1,3,2,3,6,50.0,3,0,0,0,4,10,6,0,"DF,MF",20-24,Defender,Italy,Europe
2164,Pietro Terracciano,ITA,Fiorentina,Serie A,2024,34.0,1990.0,3.0,0,0,0,0,0,0,0,,0,0,0,0,0,0,0,0,GK,30-34,Goalkeeper,Italy,Europe
2166,Martin Terrier,FRA,Leverkusen,Bundesliga,2024,27.0,1997.0,6.2,2,1,0,0,2,1,4,25.0,3,3,0,3,1,3,1,0,"MF,FW",25-29,Midfielder,France,Europe
2167,Tanner Tessmann,USA,Lyon,Ligue 1,2024,23.0,2001.0,2.5,7,4,4,2,1,3,5,60.0,2,2,2,0,6,13,9,0,MF,20-24,Midfielder,United States,North America
2168,Kenny Tete,NED,Fulham,Premier League,2024,29.0,1995.0,14.0,41,27,20,12,9,17,28,60.7,11,19,6,13,28,69,36,0,DF,25-29,Defender,Netherlands,Europe
2169,Teddy Teuma,MLT,Reims,Ligue 1,2024,31.0,1993.0,3.2,7,4,1,4,2,4,11,36.4,7,6,1,5,5,12,4,0,MF,30-34,Midfielder,Malta,Europe
2170,Jordan Teze,NED,Monaco,Ligue 1,2024,25.0,1999.0,3.4,10,5,6,3,1,3,9,33.3,6,9,1,8,2,12,4,0,DF,25-29,Defender,Netherlands,Europe
2171,Florian Thauvin,FRA,Udinese,Serie A,2024,31.0,1993.0,11.2,12,10,6,4,2,7,15,46.7,8,5,0,5,5,17,6,0,"FW,MF",30-34,Forward,France,Europe
2172,Arthur Theate,BEL,Eint Frankfurt,Bundesliga,2024,24.0,2000.0,13.6,18,11,7,10,1,8,19,42.1,11,23,10,13,21,39,61,1,DF,20-24,Defender,Belgium,Europe
2173,Thiago,BRA,Brentford,Premier League,2024,23.0,2001.0,1.5,2,2,1,0,1,0,1,0.0,1,0,0,0,2,4,2,1,FW,20-24,Forward,Brazil,South America
2173,Thiago,BRA,Brentford,Premier League,2024,23.0,2001.0,1.5,2,2,1,0,1,0,1,0.0,1,0,0,0,2,4,2,1,FW,20-24,Forward,Brazil,South America
2173,Thiago,BRA,Brentford,Premier League,2024,23.0,2001.0,1.5,2,2,1,0,1,0,1,0.0,1,0,0,0,2,4,2,1,FW,20-24,Forward,Brazil,South America
2173,Thiago,BRA,Brentford,Premier League,2024,23.0,2001.0,1.5,2,2,1,0,1,0,1,0.0,1,0,0,0,2,4,2,1,FW,20-24,Forward,Brazil,South America
2174,Malick Thiaw,GER,Milan,Serie A,2024,23.0,2001.0,10.0,11,8,5,4,2,3,5,60.0,2,6,4,2,8,19,36,0,DF,20-24,Defender,Germany,Europe
2175,Denis Thomalla,GER,Heidenheim,Bundesliga,2024,32.0,1992.0,0.0,0,0,0,0,0,0,0,,0,0,0,0,0,0,0,0,MF,30-34,Midfielder,Germany,Europe
2176,Luke Thomas,ENG,Leicester City,Premier League,2024,23.0,2001.0,1.0,2,2,2,0,0,1,2,50.0,1,3,0,3,0,2,0,0,DF,20-24,Defender,England,Europe
2177,Sorba Thomas,WAL,Nantes,Ligue 1,2024,25.0,1999.0,7.2,8,4,3,4,1,5,9,55.6,4,8,0,8,2,10,10,1,FW,25-29,Forward,Wales,Europe
2178,Adrien Thomasson,FRA,Lens,Ligue 1,2024,31.0,1993.0,13.4,48,27,21,16,11,29,51,56.9,22,20,1,19,11,59,20,0,MF,30-34,Midfielder,France,Europe
2180,Khéphren Thuram,FRA,Juventus,Serie A,2024,23.0,2001.0,9.1,14,6,4,10,0,8,11,72.7,3,7,2,5,5,19,20,0,MF,20-24,Midfielder,France,Europe
2181,Marcus Thuram,FRA,Inter,Serie A,2024,27.0,1997.0,14.2,12,7,3,4,5,2,8,25.0,6,11,3,8,2,14,8,0,FW,25-29,Forward,France,Europe
2182,Youri Tielemans,BEL,Aston Villa,Premier League,2024,27.0,1997.0,16.3,38,25,15,20,3,18,33,54.5,15,12,6,6,15,53,16,2,MF,25-29,Midfielder,Belgium,Europe
2183,Phillip Tietz,GER,Augsburg,Bundesliga,2024,27.0,1997.0,11.0,10,5,2,6,2,5,8,62.5,3,5,1,4,3,13,14,0,FW,25-29,Forward,Germany,Europe
2184,Jurriën Timber,NED,Arsenal,Premier League,2024,23.0,2001.0,13.5,22,12,6,12,4,6,13,46.2,7,11,4,7,6,28,23,1,DF,20-24,Defender,Netherlands,Europe
2185,Jean-Clair Todibo,FRA,West Ham,Premier League,2024,24.0,1999.0,7.7,16,11,13,3,0,10,12,83.3,2,14,7,7,8,24,40,3,DF,20-24,Defender,France,Europe
2186,Harry Toffolo,ENG,Nott'ham Forest,Premier League,2024,29.0,1995.0,0.4,2,0,1,0,1,0,0,,0,0,0,0,1,3,3,0,DF,25-29,Defender,England,Europe
2187,Umut Tohumcu,GER,Hoffenheim,Bundesliga,2024,20.0,2004.0,3.2,9,5,3,5,1,5,7,71.4,2,2,0,2,3,12,6,0,MF,20-24,Midfielder,Germany,Europe
2188,Corentin Tolisso,FRA,Lyon,Ligue 1,2024,30.0,1994.0,10.6,24,11,12,8,4,9,23,39.1,14,18,5,13,9,33,16,1,MF,30-34,Midfielder,France,Europe
2189,Rafael Tolói,ITA,Atalanta,Serie A,2024,34.0,1990.0,1.3,4,1,2,2,0,2,4,50.0,2,1,0,1,2,6,1,0,DF,30-34,Defender,Italy,Europe
2190,Tiago Tomás,POR,Wolfsburg,Bundesliga,2024,22.0,2002.0,11.4,12,8,5,3,4,6,18,33.3,12,7,1,6,6,18,6,0,"FW,MF",20-24,Forward,Portugal,Europe
2191,Takehiro Tomiyasu,JPN,Arsenal,Premier League,2024,26.0,1998.0,0.1,0,0,0,0,0,0,0,,0,0,0,0,0,0,1,0,DF,25-29,Defender,Japan,Asia
2192,Fikayo Tomori,ENG,Milan,Serie A,2024,27.0,1997.0,6.2,8,7,5,2,1,3,7,42.9,4,7,5,2,7,15,19,0,DF,25-29,Defender,England,Europe
2193,Sandro Tonali,ITA,Newcastle Utd,Premier League,2024,24.0,2000.0,9.2,18,12,7,11,0,8,15,53.3,7,12,5,7,17,35,11,1,MF,20-24,Midfielder,Italy,Europe
2199,Abdoulaye Touré,GUI,Le Havre,Ligue 1,2024,30.0,1994.0,12.9,31,15,17,10,4,18,26,69.2,8,17,10,7,19,50,20,2,MF,30-34,Midfielder,Guinea,Africa
2199,Abdoulaye Touré,GUI,Le Havre,Ligue 1,2024,30.0,1994.0,12.9,31,15,17,10,4,18,26,69.2,8,17,10,7,19,50,20,2,MF,30-34,Midfielder,Guinea,Africa
2199,Abdoulaye Touré,GUI,Le Havre,Ligue 1,2024,30.0,1994.0,12.9,31,15,17,10,4,18,26,69.2,8,17,10,7,19,50,20,2,MF,30-34,Midfielder,Guinea,Africa
2199,Abdoulaye Touré,GUI,Le Havre,Ligue 1,2024,30.0,1994.0,12.9,31,15,17,10,4,18,26,69.2,8,17,10,7,19,50,20,2,MF,30-34,Midfielder,Guinea,Africa
2200,Birama Touré,MLI,Montpellier,Ligue 1,2024,32.0,1992.0,3.3,8,5,5,2,1,4,6,66.7,2,3,2,1,5,13,7,0,"MF,DF",30-34,Midfielder,Mali,Africa
2201,Ousmane Toure,FRA,Lille,Ligue 1,2024,19.0,2005.0,0.1,0,0,0,0,0,0,0,,0,0,0,0,1,1,2,0,DF,Under 20,Defender,France,Europe
2202,Souleymane Touré,FRA,Udinese,Serie A,2024,21.0,2003.0,7.3,5,5,4,1,0,3,4,75.0,1,15,6,9,8,13,14,1,DF,20-24,Defender,France,Europe
2203,Lucas Tousart,FRA,Union Berlin,Bundesliga,2024,27.0,1997.0,1.7,2,1,0,2,0,0,2,0.0,2,3,1,2,2,4,2,0,MF,25-29,Midfielder,France,Europe
2204,Conor Townsend,ENG,Ipswich Town,Premier League,2024,31.0,1993.0,0.0,1,1,1,0,0,0,0,,0,0,0,0,0,1,0,0,MF,30-34,Midfielder,England,Europe
2206,Hamari Traoré,MLI,Real Sociedad,La Liga,2024,32.0,1992.0,3.5,11,7,7,3,1,9,12,75.0,3,1,1,0,3,14,11,0,DF,30-34,Defender,Mali,Africa
2207,Omar Traoré,GER,Heidenheim,Bundesliga,2024,26.0,1998.0,12.3,21,15,14,7,0,12,15,80.0,3,14,2,12,10,31,26,0,"DF,FW",25-29,Defender,Germany,Europe
2208,Kevin Trapp,GER,Eint Frankfurt,Bundesliga,2024,34.0,1990.0,10.5,0,0,0,0,0,0,0,,0,0,0,0,0,0,4,2,GK,30-34,Goalkeeper,Germany,Europe
2209,Mark Travers,IRL,Bournemouth,Premier League,2024,25.0,1999.0,3.0,0,0,0,0,0,0,0,,0,0,0,0,0,0,4,0,GK,25-29,Goalkeeper,Republic of Ireland,Europe
2210,Óscar Trejo,ARG,Rayo Vallecano,La Liga,2024,36.0,1988.0,2.7,4,4,0,4,0,3,5,60.0,2,2,0,2,1,5,3,0,"MF,FW",35-39,Midfielder,Argentina,South America
2211,Philipp Treu,GER,St. Pauli,Bundesliga,2024,24.0,2000.0,13.5,29,21,17,8,4,16,33,48.5,17,24,5,19,8,37,27,0,"MF,DF",20-24,Midfielder,Germany,Europe
2212,Ryan Trevitt,ENG,Brentford,Premier League,2024,21.0,2003.0,0.0,1,1,1,0,0,0,0,,0,0,0,0,0,1,0,0,MF,20-24,Midfielder,England,Europe
2213,Christopher Trimmel,AUT,Union Berlin,Bundesliga,2024,37.0,1987.0,8.5,19,14,11,7,1,16,25,64.0,9,5,1,4,8,27,27,0,"DF,MF",35-39,Defender,Austria,Europe
2214,Kieran Trippier,ENG,Newcastle Utd,Premier League,2024,34.0,1990.0,3.9,12,7,5,5,2,6,15,40.0,9,2,1,1,2,14,7,0,DF,30-34,Defender,England,Europe
2215,Leandro Trossard,BEL,Arsenal,Premier League,2024,30.0,1994.0,10.2,14,10,3,8,3,7,17,41.2,10,12,0,12,7,21,10,0,FW,30-34,Forward,Belgium,Europe
2216,Adrien Truffert,FRA,Rennes,Ligue 1,2024,23.0,2001.0,11.6,25,11,12,8,5,16,22,72.7,6,16,2,14,8,33,22,0,"DF,MF",20-24,Defender,France,Europe
2217,Kostas Tsimikas,GRE,Liverpool,Premier League,2024,28.0,1996.0,2.6,12,7,8,2,2,6,8,75.0,2,3,1,2,3,15,6,0,DF,25-29,Defender,Greece,Europe
2218,Viktor Tsyhankov,UKR,Girona,La Liga,2024,27.0,1997.0,5.2,4,3,0,2,2,2,5,40.0,3,0,0,0,2,6,2,0,"FW,MF",25-29,Forward,Ukraine,Europe
2219,Axel Tuanzebe,COD,Ipswich Town,Premier League,2024,27.0,1997.0,8.6,18,11,13,2,3,10,14,71.4,4,7,3,4,11,29,25,0,DF,25-29,Defender,DR Congo,Africa
2220,Stefano Turati,ITA,Monza,Serie A,2024,23.0,2001.0,14.0,0,0,0,0,0,0,0,,0,0,0,0,0,0,10,1,GK,20-24,Goalkeeper,Italy,Europe
2222,Tuta,BRA,Eint Frankfurt,Bundesliga,2024,25.0,1999.0,12.5,26,16,14,10,2,18,26,69.2,8,22,13,9,21,47,73,0,"DF,MF",25-29,Defender,Brazil,South America
2223,Chrisantus Uche,NGA,Getafe,La Liga,2024,21.0,2003.0,14.5,11,8,2,5,4,2,4,50.0,2,8,1,7,2,13,8,0,"FW,MF",20-24,Forward,Nigeria,Africa
2224,Destiny Udogie,ITA,Tottenham,Premier League,2024,22.0,2002.0,14.5,44,28,25,12,7,23,34,67.6,11,24,2,22,16,60,25,1,DF,20-24,Defender,Italy,Europe
2225,Manuel Ugarte Ribeiro,URU,Manchester Utd,Premier League,2024,23.0,2001.0,7.2,31,17,11,16,4,10,23,43.5,13,9,2,7,11,42,8,1,MF,20-24,Midfielder,Uruguay,South America
2226,Lesley Ugochukwu,FRA,Southampton,Premier League,2024,20.0,2004.0,2.7,5,2,0,4,1,0,6,0.0,6,7,2,5,2,7,2,0,MF,20-24,Midfielder,France,Europe
2227,Lukas Ullrich,GER,Gladbach,Bundesliga,2024,20.0,2004.0,6.1,3,1,2,0,1,2,7,28.6,5,11,3,8,7,10,20,0,DF,20-24,Defender,Germany,Europe
2228,Sven Ulreich,GER,Bayern Munich,Bundesliga,2024,36.0,1988.0,1.0,0,0,0,0,0,0,0,,0,0,0,0,0,0,0,0,GK,35-39,Goalkeeper,Germany,Europe
2229,Enes Ünal,TUR,Bournemouth,Premier League,2024,27.0,1997.0,2.7,1,0,0,0,1,0,2,0.0,2,1,0,1,0,1,4,0,"FW,MF",25-29,Forward,Turkey,Asia
2230,Deniz Undav,GER,Stuttgart,Bundesliga,2024,28.0,1996.0,7.1,4,4,1,1,2,0,5,0.0,5,3,0,3,3,7,3,0,"FW,MF",25-29,Forward,Germany,Europe
2231,Naci Ünüvar,NED,Espanyol,La Liga,2024,21.0,2003.0,0.3,2,2,1,1,0,1,2,50.0,1,0,0,0,0,2,0,0,"MF,DF",20-24,Midfielder,Netherlands,Europe
2232,Dayot Upamecano,FRA,Bayern Munich,Bundesliga,2024,26.0,1998.0,13.9,21,14,9,10,2,12,23,52.2,11,13,6,7,22,43,31,1,DF,25-29,Defender,France,Europe
2234,Can Uzun,TUR,Eint Frankfurt,Bundesliga,2024,19.0,2005.0,2.7,5,2,1,2,2,4,6,66.7,2,5,0,5,0,5,1,0,"MF,FW",Under 20,Midfielder,Turkey,Asia
2235,Josha Vagnoman,GER,Stuttgart,Bundesliga,2024,24.0,2000.0,12.1,11,5,8,3,0,8,15,53.3,7,8,2,6,9,20,29,0,"DF,MF",20-24,Defender,Germany,Europe
2236,Lautaro Valenti,ARG,Parma,Serie A,2024,25.0,1999.0,0.6,1,1,1,0,0,0,0,,0,2,0,2,0,1,3,0,DF,25-29,Defender,Argentina,South America
2239,Emanuele Valeri,ITA,Parma,Serie A,2024,26.0,1998.0,12.0,19,9,13,4,2,14,20,70.0,6,13,5,8,13,32,33,1,DF,25-29,Defender,Italy,Europe
2240,Martin Valjent,SVK,Mallorca,La Liga,2024,29.0,1995.0,14.8,14,8,12,1,1,6,7,85.7,1,12,6,6,11,25,78,0,DF,25-29,Defender,Slovakia,Europe
2242,Mattia Valoti,ITA,Monza,Serie A,2024,31.0,1993.0,0.4,2,2,2,0,0,0,2,0.0,2,1,0,1,0,2,2,0,MF,30-34,Midfielder,Italy,Europe
2243,Federico Valverde,URU,Real Madrid,La Liga,2024,26.0,1998.0,17.3,27,17,12,13,2,15,21,71.4,6,25,4,21,35,62,21,1,"MF,DF",25-29,Midfielder,Uruguay,South America
2244,Ignace Van Der Brempt,BEL,Como,Serie A,2024,22.0,2002.0,8.2,26,21,17,7,2,13,17,76.5,4,6,2,4,7,33,18,0,DF,20-24,Defender,Belgium,Europe
2245,Siebe Van Der Heyden,BEL,Mallorca,La Liga,2024,26.0,1998.0,1.1,1,1,0,1,0,0,0,,0,1,0,1,2,3,3,0,"DF,MF",25-29,Defender,Belgium,Europe
2246,Virgil van Dijk,NED,Liverpool,Premier League,2024,33.0,1991.0,16.0,17,8,9,7,1,6,11,54.5,5,12,4,8,30,47,70,2,DF,30-34,Defender,Netherlands,Europe
2247,Vanderson,BRA,Monaco,Ligue 1,2024,23.0,2001.0,10.4,36,20,17,15,4,21,29,72.4,8,21,5,16,24,60,21,1,DF,20-24,Defender,Brazil,South America
2247,Vanderson,BRA,Monaco,Ligue 1,2024,23.0,2001.0,10.4,36,20,17,15,4,21,29,72.4,8,21,5,16,24,60,21,1,DF,20-24,Defender,Brazil,South America
2247,Vanderson,BRA,Monaco,Ligue 1,2024,23.0,2001.0,10.4,36,20,17,15,4,21,29,72.4,8,21,5,16,24,60,21,1,DF,20-24,Defender,Brazil,South America
2247,Vanderson,BRA,Monaco,Ligue 1,2024,23.0,2001.0,10.4,36,20,17,15,4,21,29,72.4,8,21,5,16,24,60,21,1,DF,20-24,Defender,Brazil,South America
2248,Maarten Vandevoordt,BEL,RB Leipzig,Bundesliga,2024,22.0,2002.0,1.5,0,0,0,0,0,0,0,,0,0,0,0,0,0,2,0,GK,20-24,Goalkeeper,Belgium,Europe
2249,Jamie Vardy,ENG,Leicester City,Premier League,2024,37.0,1987.0,14.2,5,5,2,3,0,1,5,20.0,4,4,2,2,1,6,13,0,FW,35-39,Forward,England,Europe
2250,Ruben Vargas,SUI,Augsburg,Bundesliga,2024,26.0,1998.0,3.4,2,1,1,1,0,1,4,25.0,3,1,0,1,2,4,1,1,"MF,FW",25-29,Midfielder,Switzerland,Europe
2251,Nikola Vasilj,BIH,St. Pauli,Bundesliga,2024,29.0,1995.0,15.0,0,0,0,0,0,0,1,0.0,1,0,0,0,0,0,11,1,GK,25-29,Goalkeeper,Bosnia and Herzegovina,Europe
2252,Devis Vásquez,COL,Empoli,Serie A,2024,26.0,1998.0,17.0,0,0,0,0,0,0,0,,0,0,0,0,0,0,12,1,GK,25-29,Goalkeeper,Colombia,South America
2253,Johan Vásquez,MEX,Genoa,Serie A,2024,26.0,1998.0,14.5,19,10,6,10,3,5,16,31.3,11,24,15,9,21,40,57,1,DF,25-29,Defender,Mexico,North America
2254,Denis Vavro,SVK,Wolfsburg,Bundesliga,2024,28.0,1996.0,10.0,4,3,4,0,0,3,8,37.5,5,13,7,6,10,14,80,1,DF,25-29,Defender,Slovakia,Europe
2258,Matías Vecino,URU,Lazio,Serie A,2024,33.0,1991.0,5.4,8,6,1,6,1,3,13,23.1,10,5,2,3,5,13,6,0,MF,30-34,Midfielder,Uruguay,South America
2259,Renato Veiga,POR,Chelsea,Premier League,2024,21.0,2003.0,2.0,9,6,6,3,0,4,12,33.3,8,3,1,2,1,10,2,0,"DF,MF",20-24,Defender,Portugal,Europe
2260,Alejo Véliz,ARG,Espanyol,La Liga,2024,21.0,2003.0,8.3,1,1,0,1,0,1,5,20.0,4,11,2,9,3,4,14,1,FW,20-24,Forward,Argentina,South America
2262,Joël Veltman,NED,Brighton,Premier League,2024,32.0,1992.0,11.4,27,19,16,9,2,19,38,50.0,19,12,5,7,11,38,39,0,DF,30-34,Defender,Netherlands,Europe
2263,Micky van de Ven,NED,Tottenham,Premier League,2024,23.0,2001.0,8.8,8,5,3,4,1,6,11,54.5,5,8,5,3,9,17,29,1,DF,20-24,Defender,Netherlands,Europe
2264,Nikolas Veratschnig,AUT,Mainz 05,Bundesliga,2024,21.0,2003.0,0.4,1,1,0,1,0,1,1,100.0,0,1,0,1,1,2,0,0,"FW,MF",20-24,Forward,Austria,Europe
2265,Bart Verbruggen,NED,Brighton,Premier League,2024,22.0,2002.0,15.0,0,0,0,0,0,0,2,0.0,2,0,0,0,0,0,11,3,GK,20-24,Goalkeeper,Netherlands,Europe
2266,Simone Verdi,ITA,Como,Serie A,2024,32.0,1992.0,1.2,2,2,0,1,1,0,2,0.0,2,1,0,1,0,2,2,0,"FW,MF",30-34,Forward,Italy,Europe
2267,Jordan Veretout,FRA,Lyon,Ligue 1,2024,31.0,1993.0,9.1,12,6,5,6,1,6,19,31.6,13,9,2,7,1,13,11,0,MF,30-34,Midfielder,France,Europe
2268,Arthur Vermeeren,BEL,RB Leipzig,Bundesliga,2024,19.0,2005.0,7.6,16,13,6,9,1,5,23,21.7,18,16,7,9,15,31,11,0,MF,Under 20,Midfielder,Belgium,Europe
2269,Yorbe Vertessen,BEL,Union Berlin,Bundesliga,2024,23.0,2001.0,7.4,6,3,3,2,1,2,6,33.3,4,6,0,6,3,9,6,0,"MF,FW",20-24,Midfielder,Belgium,Europe
2271,Jannik Vestergaard,DEN,Leicester City,Premier League,2024,32.0,1992.0,7.7,14,6,10,4,0,3,7,42.9,4,10,6,4,10,24,40,1,DF,30-34,Defender,Denmark,Europe
2272,Ben Viadere,FRA,Auxerre,Ligue 1,2024,19.0,2005.0,0.1,0,0,0,0,0,0,0,,0,0,0,0,0,0,0,0,MF,Under 20,Midfielder,France,Europe
2273,Guglielmo Vicario,ITA,Tottenham,Premier League,2024,28.0,1996.0,12.0,0,0,0,0,0,0,0,,0,0,0,0,1,1,7,2,GK,25-29,Goalkeeper,Italy,Europe
2277,Gabriel Vidovic,CRO,Mainz 05,Bundesliga,2024,21.0,2003.0,0.0,0,0,0,0,0,0,0,,0,0,0,0,0,0,0,0,MF,20-24,Midfielder,Croatia,Europe
2279,Samuele Vignato,ITA,Monza,Serie A,2024,20.0,2004.0,2.5,4,2,0,2,2,3,5,60.0,2,0,0,0,0,4,4,0,MF,20-24,Midfielder,Italy,Europe
2282,Carlos Vinícius,BRA,Fulham,Premier League,2024,29.0,1995.0,0.0,0,0,0,0,0,0,0,,0,0,0,0,0,0,0,0,MF,25-29,Midfielder,Brazil,South America
2283,Nicolas Viola,ITA,Cagliari,Serie A,2024,35.0,1989.0,5.3,5,5,1,4,0,0,4,0.0,4,1,0,1,2,7,2,0,"MF,FW",35-39,Midfielder,Italy,Europe
2285,Mattia Viti,ITA,Empoli,Serie A,2024,22.0,2002.0,16.0,39,26,29,9,1,21,29,72.4,8,27,15,12,28,67,68,2,DF,20-24,Defender,Italy,Europe
2286,Vitinha,POR,Genoa,Serie A,2024,24.0,2000.0,7.0,11,5,4,3,4,5,17,29.4,12,7,1,6,6,17,8,0,FW,20-24,Forward,Portugal,Europe
2286,Vitinha,POR,Genoa,Serie A,2024,24.0,2000.0,7.0,11,5,4,3,4,5,17,29.4,12,7,1,6,6,17,8,0,FW,20-24,Forward,Portugal,Europe
2286,Vitinha,POR,Genoa,Serie A,2024,24.0,2000.0,7.0,11,5,4,3,4,5,17,29.4,12,7,1,6,6,17,8,0,FW,20-24,Forward,Portugal,Europe
2286,Vitinha,POR,Genoa,Serie A,2024,24.0,2000.0,7.0,11,5,4,3,4,5,17,29.4,12,7,1,6,6,17,8,0,FW,20-24,Forward,Portugal,Europe
2287,Vitinha,POR,Paris S-G,Ligue 1,2024,24.0,2000.0,11.5,21,9,7,13,1,13,24,54.2,11,9,3,6,5,26,7,1,MF,20-24,Midfielder,Portugal,Europe
2287,Vitinha,POR,Paris S-G,Ligue 1,2024,24.0,2000.0,11.5,21,9,7,13,1,13,24,54.2,11,9,3,6,5,26,7,1,MF,20-24,Midfielder,Portugal,Europe
2287,Vitinha,POR,Paris S-G,Ligue 1,2024,24.0,2000.0,11.5,21,9,7,13,1,13,24,54.2,11,9,3,6,5,26,7,1,MF,20-24,Midfielder,Portugal,Europe
2287,Vitinha,POR,Paris S-G,Ligue 1,2024,24.0,2000.0,11.5,21,9,7,13,1,13,24,54.2,11,9,3,6,5,26,7,1,MF,20-24,Midfielder,Portugal,Europe
2291,Nikola Vlašić,CRO,Torino,Serie A,2024,27.0,1997.0,6.2,19,12,7,8,4,7,12,58.3,5,6,2,4,6,25,6,0,"MF,FW",25-29,Midfielder,Croatia,Europe
2292,Alessandro Vogliacco,ITA,Genoa,Serie A,2024,26.0,1998.0,7.9,15,3,7,7,1,10,12,83.3,2,11,7,4,9,24,20,0,DF,25-29,Defender,Italy,Europe
2293,Kevin Vogt,GER,Union Berlin,Bundesliga,2024,33.0,1991.0,12.4,8,5,6,2,0,7,10,70.0,3,13,7,6,7,15,59,0,DF,30-34,Defender,Germany,Europe
2295,Kevin Volland,GER,Union Berlin,Bundesliga,2024,32.0,1992.0,0.1,0,0,0,0,0,0,0,,0,0,0,0,0,0,1,0,MF,30-34,Midfielder,Germany,Europe
2296,Aster Vranckx,BEL,Wolfsburg,Bundesliga,2024,22.0,2002.0,1.4,3,2,1,2,0,1,1,100.0,0,2,1,1,3,6,4,0,MF,20-24,Midfielder,Belgium,Europe
2297,Stefan de Vrij,NED,Inter,Serie A,2024,32.0,1992.0,7.9,8,5,5,2,1,3,5,60.0,2,7,4,3,6,14,29,0,DF,30-34,Defender,Netherlands,Europe
2298,Ibrahima Wadji,SEN,Saint-Étienne,Ligue 1,2024,29.0,1995.0,1.2,4,4,1,2,1,3,7,42.9,4,0,0,0,0,4,0,0,"MF,FW",25-29,Midfielder,Senegal,Africa
2299,Robert Wagner,GER,St. Pauli,Bundesliga,2024,21.0,2003.0,4.0,7,2,1,6,0,3,10,30.0,7,6,0,6,1,8,9,0,MF,20-24,Midfielder,Germany,Europe
2300,Elye Wahi,FRA,Marseille,Ligue 1,2024,21.0,2003.0,6.0,0,0,0,0,0,0,4,0.0,4,1,0,1,1,1,0,0,FW,20-24,Forward,France,Europe
2301,Hauke Wahl,GER,St. Pauli,Bundesliga,2024,30.0,1994.0,15.0,19,13,12,6,1,10,15,66.7,5,15,10,5,13,32,59,3,DF,30-34,Defender,Germany,Europe
2302,Kyle Walker,ENG,Manchester City,Premier League,2024,34.0,1990.0,10.2,17,10,7,7,3,14,25,56.0,11,13,4,9,3,20,11,1,DF,30-34,Defender,England,Europe
2303,Kyle Walker-Peters,ENG,Southampton,Premier League,2024,27.0,1997.0,14.9,20,13,12,5,3,9,19,47.4,10,15,7,8,11,31,43,0,DF,25-29,Defender,England,Europe
2304,Christian Walton,ENG,Ipswich Town,Premier League,2024,29.0,1995.0,1.0,0,0,0,0,0,0,1,0.0,1,0,0,0,0,0,0,0,GK,25-29,Goalkeeper,England,Europe
2307,Aaron Wan-Bissaka,ENG,West Ham,Premier League,2024,27.0,1997.0,15.0,30,22,15,13,2,11,14,78.6,3,13,5,8,27,57,49,0,DF,25-29,Defender,England,Europe
2308,Paul Wanner,GER,Heidenheim,Bundesliga,2024,19.0,2005.0,11.7,26,16,10,16,0,10,20,50.0,10,7,0,7,3,29,11,0,"MF,FW",Under 20,Midfielder,Germany,Europe
2309,Danny Ward,WAL,Leicester City,Premier League,2024,31.0,1993.0,1.5,0,0,0,0,0,0,0,,0,0,0,0,0,0,1,0,GK,30-34,Goalkeeper,Wales,Europe
2309,Danny Ward,WAL,Leicester City,Premier League,2024,31.0,1993.0,1.5,0,0,0,0,0,0,0,,0,0,0,0,0,0,1,0,GK,30-34,Goalkeeper,Wales,Europe
2309,Danny Ward,WAL,Leicester City,Premier League,2024,31.0,1993.0,1.5,0,0,0,0,0,0,0,,0,0,0,0,0,0,1,0,GK,30-34,Goalkeeper,Wales,Europe
2309,Danny Ward,WAL,Leicester City,Premier League,2024,31.0,1993.0,1.5,0,0,0,0,0,0,0,,0,0,0,0,0,0,1,0,GK,30-34,Goalkeeper,Wales,Europe
2310,James Ward-Prowse,ENG,West Ham,Premier League,2024,30.0,1994.0,0.2,1,0,1,0,0,1,1,100.0,0,1,0,1,0,1,0,0,MF,30-34,Midfielder,England,Europe
2311,James Ward-Prowse,ENG,Nott'ham Forest,Premier League,2024,30.0,1994.0,4.2,4,1,1,3,0,2,2,100.0,0,3,2,1,5,9,6,0,MF,30-34,Midfielder,England,Europe
2312,Kjell-Arik Wätjen,GER,Dortmund,Bundesliga,2024,18.0,2006.0,0.2,0,0,0,0,0,0,0,,0,0,0,0,0,0,2,0,MF,Under 20,Midfielder,Germany,Europe
2313,Ollie Watkins,ENG,Aston Villa,Premier League,2024,28.0,1995.0,12.6,5,3,0,3,2,1,6,16.7,5,7,1,6,2,7,3,0,FW,25-29,Forward,England,Europe
2314,Timothy Weah,USA,Juventus,Serie A,2024,24.0,2000.0,7.7,10,5,2,5,3,4,8,50.0,4,7,1,6,4,14,5,0,FW,20-24,Forward,United States,North America
2315,Adam Webster,ENG,Brighton,Premier League,2024,29.0,1995.0,0.9,0,0,0,0,0,0,2,0.0,2,4,3,1,1,1,3,1,DF,25-29,Defender,England,Europe
2316,Julian Weigl,GER,Gladbach,Bundesliga,2024,29.0,1995.0,13.5,22,7,16,4,2,12,16,75.0,4,18,9,9,27,49,29,0,MF,25-29,Midfielder,Germany,Europe
2317,Timon Weiner,GER,Holstein Kiel,Bundesliga,2024,25.0,1999.0,15.0,0,0,0,0,0,0,0,,0,0,0,0,0,0,7,3,GK,25-29,Goalkeeper,Germany,Europe
2318,Nelson Weiper,GER,Mainz 05,Bundesliga,2024,19.0,2005.0,0.5,1,1,1,0,0,0,0,,0,1,0,1,0,1,0,0,"MF,FW",Under 20,Midfielder,Germany,Europe
2319,Mitchell Weiser,GER,Werder Bremen,Bundesliga,2024,30.0,1994.0,13.9,23,15,7,14,2,10,18,55.6,8,9,0,9,8,31,31,1,"DF,MF",30-34,Defender,Germany,Europe
2320,Noah Weißhaupt,GER,Freiburg,Bundesliga,2024,23.0,2001.0,0.9,0,0,0,0,0,0,1,0.0,1,0,0,0,0,0,1,0,FW,20-24,Forward,Germany,Europe
2321,Danny Welbeck,ENG,Brighton,Premier League,2024,34.0,1990.0,12.4,11,6,3,7,1,3,10,30.0,7,11,1,10,4,15,8,0,FW,30-34,Forward,England,Europe
2322,Timo Werner,GER,Tottenham,Premier League,2024,28.0,1996.0,4.5,3,2,2,1,0,2,10,20.0,8,10,1,9,1,4,6,0,"FW,MF",25-29,Forward,Germany,Europe
2323,Adam Wharton,ENG,Crystal Palace,Premier League,2024,20.0,2004.0,6.9,18,10,9,9,0,9,26,34.6,17,5,0,5,10,28,13,0,MF,20-24,Midfielder,England,Europe
2324,Ben White,ENG,Arsenal,Premier League,2024,27.0,1997.0,7.7,10,6,8,1,1,9,21,42.9,12,6,5,1,11,21,23,0,DF,25-29,Defender,England,Europe
2325,Silvan Widmer,SUI,Mainz 05,Bundesliga,2024,31.0,1993.0,2.0,5,3,1,3,1,3,4,75.0,1,1,0,1,3,8,10,0,DF,30-34,Defender,Switzerland,Europe
2326,Mats Wieffer,NED,Brighton,Premier League,2024,25.0,1999.0,5.2,20,11,4,13,3,7,14,50.0,7,10,1,9,7,27,11,2,MF,25-29,Midfielder,Netherlands,Europe
2328,Caleb Wiley,USA,Strasbourg,Ligue 1,2024,20.0,2004.0,3.0,1,0,0,1,0,0,1,0.0,1,3,1,2,4,5,5,0,"DF,MF",20-24,Defender,United States,North America
2329,Iñaki Williams,GHA,Athletic Club,La Liga,2024,30.0,1994.0,16.3,13,6,4,8,1,9,16,56.3,7,14,2,12,9,22,15,0,FW,30-34,Forward,Ghana,Africa
2330,Neco Williams,WAL,Nott'ham Forest,Premier League,2024,23.0,2001.0,8.2,24,14,20,4,0,13,24,54.2,11,12,2,10,5,29,34,0,DF,20-24,Defender,Wales,Europe
2332,Joe Willock,ENG,Newcastle Utd,Premier League,2024,25.0,1999.0,5.8,13,9,5,5,3,9,14,64.3,5,11,1,10,3,16,5,0,"MF,FW",25-29,Midfielder,England,Europe
2333,Callum Wilson,ENG,Newcastle Utd,Premier League,2024,32.0,1992.0,0.7,1,1,0,1,0,0,0,,0,0,0,0,0,1,0,0,"FW,MF",30-34,Forward,England,Europe
2333,Callum Wilson,ENG,Newcastle Utd,Premier League,2024,32.0,1992.0,0.7,1,1,0,1,0,0,0,,0,0,0,0,0,1,0,0,"FW,MF",30-34,Forward,England,Europe
2333,Callum Wilson,ENG,Newcastle Utd,Premier League,2024,32.0,1992.0,0.7,1,1,0,1,0,0,0,,0,0,0,0,0,1,0,0,"FW,MF",30-34,Forward,England,Europe
2333,Callum Wilson,ENG,Newcastle Utd,Premier League,2024,32.0,1992.0,0.7,1,1,0,1,0,0,0,,0,0,0,0,0,1,0,0,"FW,MF",30-34,Forward,England,Europe
2334,Harry Wilson,WAL,Fulham,Premier League,2024,27.0,1997.0,4.7,5,3,4,1,0,2,5,40.0,3,6,0,6,3,8,2,1,"FW,MF",25-29,Forward,Wales,Europe
2335,Patrick Wimmer,AUT,Wolfsburg,Bundesliga,2024,23.0,2001.0,7.1,15,10,7,6,2,6,12,50.0,6,10,1,9,9,24,4,0,"MF,FW",20-24,Midfielder,Austria,Europe
2336,Jonas Wind,DEN,Wolfsburg,Bundesliga,2024,25.0,1999.0,7.3,2,2,0,2,0,1,3,33.3,2,7,2,5,3,5,4,0,"MF,FW",25-29,Midfielder,Denmark,Europe
2337,Harry Winks,ENG,Leicester City,Premier League,2024,28.0,1996.0,10.1,14,8,6,6,2,7,15,46.7,8,10,4,6,4,18,14,0,MF,25-29,Midfielder,England,Europe
2338,Florian Wirtz,GER,Leverkusen,Bundesliga,2024,21.0,2003.0,13.4,18,10,6,8,4,6,13,46.2,7,17,1,16,8,26,1,0,MF,20-24,Midfielder,Germany,Europe
2339,Yoane Wissa,COD,Brentford,Premier League,2024,28.0,1996.0,11.6,3,2,0,1,2,0,5,0.0,5,6,1,5,3,6,4,0,FW,25-29,Forward,DR Congo,Africa
2340,Dani de Wit,NED,Bochum,Bundesliga,2024,26.0,1998.0,7.6,15,10,6,8,1,9,17,52.9,8,10,3,7,7,22,13,1,"MF,FW",25-29,Midfielder,Netherlands,Europe
2341,Axel Witsel,BEL,Atlético Madrid,La Liga,2024,35.0,1989.0,7.5,12,11,4,7,1,9,11,81.8,2,13,7,6,6,18,29,1,DF,35-39,Defender,Belgium,Europe
2342,Maximilian Wittek,GER,Bochum,Bundesliga,2024,29.0,1995.0,13.6,22,16,12,8,2,17,26,65.4,9,26,5,21,15,37,36,1,DF,25-29,Defender,Germany,Europe
2343,Marius Wolf,GER,Augsburg,Bundesliga,2024,29.0,1995.0,11.2,13,7,5,5,3,7,21,33.3,14,18,3,15,10,23,26,0,DF,25-29,Defender,Germany,Europe
2344,Nick Woltemade,GER,Stuttgart,Bundesliga,2024,22.0,2002.0,4.1,1,1,0,1,0,0,1,0.0,1,5,0,5,0,1,4,0,"FW,MF",20-24,Forward,Germany,Europe
2345,Jeong Woo-yeong,KOR,Union Berlin,Bundesliga,2024,25.0,1999.0,8.0,2,1,1,1,0,0,2,0.0,2,3,1,2,5,7,1,0,"MF,FW",25-29,Midfielder,South Korea,Asia
2346,Chris Wood,NZL,Nott'ham Forest,Premier League,2024,33.0,1991.0,14.7,1,1,0,0,1,1,5,20.0,4,5,3,2,4,5,12,0,FW,30-34,Forward,New Zealand,Oceania
2347,Nathan Wood-Gordon,ENG,Southampton,Premier League,2024,22.0,2002.0,3.8,6,4,5,1,0,3,5,60.0,2,5,4,1,2,8,14,1,DF,20-24,Defender,England,Europe
2348,Christopher Wooh,CMR,Rennes,Ligue 1,2024,23.0,2001.0,9.8,26,12,15,9,2,14,19,73.7,5,17,7,10,11,37,35,0,DF,20-24,Defender,Cameroon,Africa
2349,Luke Woolfenden,ENG,Ipswich Town,Premier League,2024,26.0,1998.0,4.2,1,1,1,0,0,0,2,0.0,2,8,3,5,8,9,22,0,DF,25-29,Defender,England,Europe
2350,Granit Xhaka,SUI,Leverkusen,Bundesliga,2024,32.0,1992.0,15.0,18,10,4,12,2,9,17,52.9,8,12,4,8,3,21,15,0,MF,30-34,Midfielder,Switzerland,Europe
2353,Yehor Yarmoliuk,UKR,Brentford,Premier League,2024,20.0,2004.0,4.4,12,9,4,5,3,5,18,27.8,13,15,5,10,6,18,10,0,MF,20-24,Midfielder,Ukraine,Europe
2354,Ryan Yates,ENG,Nott'ham Forest,Premier League,2024,27.0,1997.0,13.5,28,15,17,8,3,10,19,52.6,9,18,1,17,18,46,36,1,MF,25-29,Midfielder,England,Europe
2355,John Yeboah,ECU,Venezia,Serie A,2024,24.0,2000.0,2.8,3,3,1,1,1,0,6,0.0,6,2,0,2,2,5,0,0,"MF,FW",20-24,Midfielder,Ecuador,South America
2356,Bertuğ Yıldırım,TUR,Getafe,La Liga,2024,22.0,2002.0,8.9,6,3,0,5,1,1,5,20.0,4,8,1,7,1,7,11,0,FW,20-24,Forward,Turkey,Asia
2357,Kenan Yıldız,TUR,Juventus,Serie A,2024,19.0,2005.0,13.4,31,19,8,15,8,8,13,61.5,5,12,0,12,2,33,5,0,"FW,MF",Under 20,Forward,Turkey,Asia
2358,Leny Yoro,FRA,Manchester Utd,Premier League,2024,19.0,2005.0,1.7,6,1,6,0,0,3,4,75.0,1,1,1,0,2,8,4,0,DF,Under 20,Defender,France,Europe
2359,Ashley Young,ENG,Everton,Premier League,2024,39.0,1985.0,13.3,43,23,21,18,4,26,41,63.4,15,6,2,4,18,61,43,0,DF,35-39,Defender,England,Europe
2360,Etienne Youte Kinkoue,FRA,Le Havre,Ligue 1,2024,22.0,2002.0,10.5,8,3,4,4,0,6,10,60.0,4,19,11,8,13,21,62,0,DF,20-24,Defender,France,Europe
2361,Illia Zabarnyi,UKR,Bournemouth,Premier League,2024,22.0,2002.0,17.0,26,17,11,15,0,16,23,69.6,7,22,12,10,18,44,78,1,DF,20-24,Defender,Ukraine,Europe
2362,Mattia Zaccagni,ITA,Lazio,Serie A,2024,29.0,1995.0,13.1,11,8,1,8,2,4,10,40.0,6,6,0,6,13,24,5,0,"FW,MF",25-29,Forward,Italy,Europe
2363,Dan-Axel Zagadou,FRA,Stuttgart,Bundesliga,2024,25.0,1999.0,0.3,0,0,0,0,0,0,0,,0,0,0,0,1,1,1,0,"DF,MF",25-29,Defender,France,Europe
2364,Yoram Zague,FRA,Paris S-G,Ligue 1,2024,18.0,2006.0,1.8,4,3,2,1,1,2,3,66.7,1,2,0,2,2,6,2,0,DF,Under 20,Defender,France,Europe
2365,Wilfried Zaha,CIV,Lyon,Ligue 1,2024,32.0,1992.0,0.8,1,1,1,0,0,1,2,50.0,1,3,0,3,1,2,0,0,FW,30-34,Forward,Ivory Coast,Africa
2366,Warren Zaïre-Emery,FRA,Paris S-G,Ligue 1,2024,18.0,2006.0,12.6,32,14,10,14,8,14,27,51.9,13,22,3,19,13,45,15,2,"MF,DF",Under 20,Midfielder,France,Europe
2368,Denis Zakaria,SUI,Monaco,Ligue 1,2024,28.0,1996.0,9.3,12,8,5,5,2,7,11,63.6,4,10,4,6,14,26,22,0,MF,25-29,Midfielder,Switzerland,Europe
2370,Andre-Frank Zambo Anguissa,CMR,Napoli,Serie A,2024,29.0,1995.0,16.9,28,19,5,20,3,9,20,45.0,11,9,2,7,22,50,16,0,MF,25-29,Midfielder,Cameroon,Africa
2371,Francesco Zampano,ITA,Venezia,Serie A,2024,31.0,1993.0,14.0,22,15,12,8,2,10,22,45.5,12,17,0,17,5,27,20,2,DF,30-34,Defender,Italy,Europe
2372,Nicolò Zaniolo,ITA,Atalanta,Serie A,2024,25.0,1999.0,3.1,0,0,0,0,0,0,1,0.0,1,0,0,0,0,0,0,0,"FW,MF",25-29,Forward,Italy,Europe
2373,Alessandro Zanoli,ITA,Genoa,Serie A,2024,24.0,2000.0,10.1,20,14,7,11,2,6,10,60.0,4,7,2,5,5,25,24,0,"DF,FW",20-24,Defender,Italy,Europe
2374,Duván Zapata,COL,Torino,Serie A,2024,33.0,1991.0,6.5,7,5,2,0,5,0,3,0.0,3,2,1,1,2,9,7,0,FW,30-34,Forward,Colombia,South America
2375,Gabriele Zappa,ITA,Cagliari,Serie A,2024,25.0,1999.0,16.5,21,12,11,9,1,10,16,62.5,6,22,12,10,10,31,45,0,DF,25-29,Defender,Italy,Europe
2376,Davide Zappacosta,ITA,Atalanta,Serie A,2024,32.0,1992.0,8.6,6,4,3,2,1,6,13,46.2,7,9,1,8,2,8,7,0,DF,30-34,Defender,Italy,Europe
2378,Anass Zaroury,MAR,Lens,Ligue 1,2024,24.0,2000.0,7.1,7,6,0,5,2,3,12,25.0,9,5,0,5,0,7,4,0,"FW,MF",20-24,Forward,Morocco,Africa
2380,Jordan Zemura,ZIM,Udinese,Serie A,2024,25.0,1999.0,10.2,20,10,10,7,3,10,18,55.6,8,13,3,10,13,33,27,0,DF,25-29,Defender,Zimbabwe,Africa
2381,Robin Zentner,GER,Mainz 05,Bundesliga,2024,30.0,1994.0,15.0,0,0,0,0,0,0,0,,0,0,0,0,0,0,20,3,GK,30-34,Goalkeeper,Germany,Europe
2382,Alessio Zerbin,ITA,Napoli,Serie A,2024,25.0,1999.0,0.0,1,1,1,0,0,1,1,100.0,0,0,0,0,0,1,0,0,DF,25-29,Defender,Italy,Europe
2383,Kevin Zeroli,ITA,Milan,Serie A,2024,19.0,2005.0,0.1,1,1,0,1,0,0,0,,0,0,0,0,0,1,0,0,MF,Under 20,Midfielder,Italy,Europe
2384,Cedric Zesiger,SUI,Wolfsburg,Bundesliga,2024,26.0,1998.0,5.8,13,8,6,5,2,6,12,50.0,6,6,5,1,3,16,28,0,DF,25-29,Defender,Switzerland,Europe
2385,Michael Zetterer,GER,Werder Bremen,Bundesliga,2024,29.0,1995.0,15.0,0,0,0,0,0,0,0,,0,0,0,0,1,1,3,4,GK,25-29,Goalkeeper,Germany,Europe
2386,Nathan Zeze,FRA,Nantes,Ligue 1,2024,19.0,2005.0,9.8,23,12,12,11,0,14,20,70.0,6,17,8,9,12,35,76,0,DF,Under 20,Defender,France,Europe
2389,Oleksandr Zinchenko,UKR,Arsenal,Premier League,2024,28.0,1996.0,2.6,2,0,1,1,0,1,4,25.0,3,5,0,5,3,5,5,0,"DF,MF",25-29,Defender,Ukraine,Europe
2390,Joshua Zirkzee,NED,Manchester Utd,Premier League,2024,23.0,2001.0,7.3,4,1,3,1,0,3,3,100.0,0,7,2,5,2,6,2,0,"FW,MF",20-24,Forward,Netherlands,Europe
2391,Luc Zogbé,CIV,Brest,Ligue 1,2024,19.0,2005.0,3.4,12,9,7,3,2,8,12,66.7,4,4,0,4,4,16,8,0,DF,Under 20,Defender,Ivory Coast,Africa
2392,Nadir Zortea,ITA,Cagliari,Serie A,2024,25.0,1999.0,10.5,14,6,6,7,1,7,14,50.0,7,2,0,2,5,19,17,2,"DF,FW",25-29,Defender,Italy,Europe
2393,Aristide Zossou,CIV,Auxerre,Ligue 1,2024,19.0,2005.0,0.1,0,0,0,0,0,0,0,,0,0,0,0,0,0,0,0,MF,Under 20,Midfielder,Ivory Coast,Africa
2394,Yanis Zouaoui,ALG,Le Havre,Ligue 1,2024,30.0,1994.0,2.6,4,3,2,1,1,2,2,100.0,0,1,0,1,2,6,5,0,"DF,FW",30-34,Defender,Algeria,Africa
2398,Milan Đurić,BIH,Monza,Serie A,2024,34.0,1990.0,12.2,1,1,0,1,0,0,2,0.0,2,6,0,6,2,3,12,0,FW,30-34,Forward,Bosnia and Herzegovina,Europe
2052,Antonio Sivera,ESP,Alavés,La Liga,2024,28.0,1996.0,17.6,1,0,1,0,0,1,1,100.0,0,0,0,0,0,1,11,0,GK,25-29,Goalkeeper,Spain,Europe
2056,Leo Skiri Østigård,NOR,Rennes,Ligue 1,2024,25.0,1999.0,9.9,15,13,12,3,0,12,19,63.2,7,7,7,0,7,22,65,0,DF,25-29,Defender,Norway,Europe
2057,Łukasz Skorupski,POL,Bologna,Serie A,2024,33.0,1991.0,10.0,0,0,0,0,0,0,0,,0,0,0,0,0,0,3,0,GK,30-34,Goalkeeper,Poland,Europe
2069,Alex Sola,ESP,Getafe,La Liga,2024,25.0,1999.0,10.8,20,13,9,11,0,9,25,36.0,16,8,0,8,5,25,9,0,"MF,FW",25-29,Midfielder,Spain,Europe
2071,Ola Solbakken,NOR,Empoli,Serie A,2024,26.0,1998.0,6.6,5,3,0,5,0,2,4,50.0,2,0,0,0,2,7,8,0,"MF,FW",25-29,Midfielder,Norway,Europe
2072,Carlos Soler,ESP,West Ham,Premier League,2024,27.0,1997.0,6.7,6,6,3,3,0,2,13,15.4,11,11,3,8,2,8,6,0,MF,25-29,Midfielder,Spain,Europe
2075,David Soria,ESP,Getafe,La Liga,2024,31.0,1993.0,18.0,4,4,4,0,0,4,5,80.0,1,0,0,0,0,4,7,1,GK,30-34,Goalkeeper,Spain,Europe
2076,Juan Soriano,ESP,Leganés,La Liga,2024,27.0,1997.0,6.0,1,1,1,0,0,1,1,100.0,0,0,0,0,0,1,2,0,GK,25-29,Goalkeeper,Spain,Europe
2079,Hugo Sotelo,ESP,Celta Vigo,La Liga,2024,21.0,2003.0,6.8,14,10,5,4,5,4,11,36.4,7,6,0,6,2,16,4,0,MF,20-24,Midfielder,Spain,Europe
2082,Tomáš Souček,CZE,West Ham,Premier League,2024,29.0,1995.0,12.9,19,11,7,10,2,10,19,52.6,9,14,6,8,11,30,40,0,MF,25-29,Midfielder,Czech Republic,Europe
2092,Filip Stankovic,SRB,Venezia,Serie A,2024,22.0,2002.0,10.0,0,0,0,0,0,0,0,,0,0,0,0,0,0,7,0,GK,20-24,Goalkeeper,Serbia,Europe
2107,Stoichkov,ESP,Alavés,La Liga,2024,31.0,1993.0,7.6,14,9,6,7,1,6,11,54.5,5,2,0,2,1,15,5,0,"MF,FW",30-34,Midfielder,Spain,Europe
2108,Petar Stojanović,SVN,Empoli,Serie A,2024,29.0,1995.0,0.0,0,0,0,0,0,0,0,,0,0,0,0,0,0,0,0,MF,25-29,Midfielder,Slovenia,Europe
2110,Jørgen Strand Larsen,NOR,Wolves,Premier League,2024,24.0,2000.0,15.5,4,4,1,2,1,1,18,5.6,17,14,3,11,4,8,16,0,FW,20-24,Forward,Norway,Europe
2113,Álex Suárez,ESP,Las Palmas,La Liga,2024,31.0,1993.0,13.9,20,10,15,4,1,11,14,78.6,3,20,13,7,4,24,61,1,DF,30-34,Defender,Spain,Europe
2114,Denis Suárez,ESP,Villarreal,La Liga,2024,30.0,1994.0,2.6,3,2,2,0,1,2,3,66.7,1,2,1,1,1,4,1,0,"MF,DF",30-34,Midfielder,Spain,Europe
2123,Suso,ESP,Sevilla,La Liga,2024,31.0,1993.0,1.6,1,0,1,0,0,1,4,25.0,3,0,0,0,0,1,0,0,"FW,MF",30-34,Forward,Spain,Europe
2127,Mile Svilar,SRB,Roma,Serie A,2024,25.0,1999.0,17.0,0,0,0,0,0,0,0,,0,0,0,0,0,0,4,1,GK,25-29,Goalkeeper,Serbia,Europe
2135,Alexander Sørloth,NOR,Atlético Madrid,La Liga,2024,29.0,1995.0,8.7,4,1,0,2,2,1,2,50.0,1,4,1,3,0,4,14,0,FW,25-29,Forward,Norway,Europe
2147,César Tárrega,ESP,Valencia,La Liga,2024,22.0,2002.0,13.6,17,13,10,6,1,5,11,45.5,6,12,6,6,8,25,64,1,DF,20-24,Defender,Spain,Europe
2156,Álvaro Tejero,ESP,Espanyol,La Liga,2024,28.0,1996.0,9.6,9,3,4,4,1,3,13,23.1,10,7,0,7,8,17,22,1,"MF,DF",25-29,Midfielder,Spain,Europe
2157,Martín Tejón,ESP,Valencia,La Liga,2024,20.0,2004.0,0.5,2,0,0,2,0,1,2,50.0,1,0,0,0,0,2,0,0,"MF,DF",20-24,Midfielder,Spain,Europe
2165,Ramón Terrats,ESP,Villarreal,La Liga,2024,24.0,2000.0,1.4,3,3,1,2,0,2,4,50.0,2,3,1,2,2,5,3,0,"MF,FW",20-24,Midfielder,Spain,Europe
2179,Morten Thorsby,NOR,Genoa,Serie A,2024,28.0,1996.0,11.0,25,19,10,10,5,8,16,50.0,8,11,1,10,4,29,13,0,MF,25-29,Midfielder,Norway,Europe
2194,Pablo Torre,ESP,Barcelona,La Liga,2024,21.0,2003.0,2.8,5,4,1,3,1,2,2,100.0,0,0,0,0,1,6,4,1,"MF,FW",20-24,Midfielder,Spain,Europe
2195,David Torres,ESP,Valladolid,La Liga,2024,21.0,2003.0,8.7,7,4,7,0,0,3,6,50.0,3,10,9,1,4,11,37,0,DF,20-24,Defender,Spain,Europe
2195,David Torres,ESP,Valladolid,La Liga,2024,21.0,2003.0,8.7,7,4,7,0,0,3,6,50.0,3,10,9,1,4,11,37,0,DF,20-24,Defender,Spain,Europe
2195,David Torres,ESP,Valladolid,La Liga,2024,21.0,2003.0,8.7,7,4,7,0,0,3,6,50.0,3,10,9,1,4,11,37,0,DF,20-24,Defender,Spain,Europe
2195,David Torres,ESP,Valladolid,La Liga,2024,21.0,2003.0,8.7,7,4,7,0,0,3,6,50.0,3,10,9,1,4,11,37,0,DF,20-24,Defender,Spain,Europe
2196,Ferrán Torres,ESP,Barcelona,La Liga,2024,24.0,2000.0,5.7,5,3,1,2,2,1,3,33.3,2,5,0,5,1,6,1,0,"FW,MF",20-24,Forward,Spain,Europe
2197,Pau Torres,ESP,Aston Villa,Premier League,2024,27.0,1997.0,16.0,17,12,10,6,1,9,12,75.0,3,11,7,4,6,23,42,2,DF,25-29,Defender,Spain,Europe
2198,Lucas Torró,ESP,Osasuna,La Liga,2024,30.0,1994.0,16.5,39,23,12,27,0,19,38,50.0,19,23,4,19,25,64,37,3,MF,30-34,Midfielder,Spain,Europe
2205,Adama Traoré,ESP,Fulham,Premier League,2024,28.0,1996.0,9.4,9,5,6,2,1,3,8,37.5,5,5,0,5,1,10,4,1,"FW,MF",25-29,Forward,Spain,Europe
2205,Adama Traoré,ESP,Fulham,Premier League,2024,28.0,1996.0,9.4,9,5,6,2,1,3,8,37.5,5,5,0,5,1,10,4,1,"FW,MF",25-29,Forward,Spain,Europe
2205,Adama Traoré,ESP,Fulham,Premier League,2024,28.0,1996.0,9.4,9,5,6,2,1,3,8,37.5,5,5,0,5,1,10,4,1,"FW,MF",25-29,Forward,Spain,Europe
2205,Adama Traoré,ESP,Fulham,Premier League,2024,28.0,1996.0,9.4,9,5,6,2,1,3,8,37.5,5,5,0,5,1,10,4,1,"FW,MF",25-29,Forward,Spain,Europe
2205,Adama Traoré,ESP,Fulham,Premier League,2024,28.0,1996.0,9.4,9,5,6,2,1,3,8,37.5,5,5,0,5,1,10,4,1,"FW,MF",25-29,Forward,Spain,Europe
2205,Adama Traoré,ESP,Fulham,Premier League,2024,28.0,1996.0,9.4,9,5,6,2,1,3,8,37.5,5,5,0,5,1,10,4,1,"FW,MF",25-29,Forward,Spain,Europe
2205,Adama Traoré,ESP,Fulham,Premier League,2024,28.0,1996.0,9.4,9,5,6,2,1,3,8,37.5,5,5,0,5,1,10,4,1,"FW,MF",25-29,Forward,Spain,Europe
2205,Adama Traoré,ESP,Fulham,Premier League,2024,28.0,1996.0,9.4,9,5,6,2,1,3,8,37.5,5,5,0,5,1,10,4,1,"FW,MF",25-29,Forward,Spain,Europe
2205,Adama Traoré,ESP,Fulham,Premier League,2024,28.0,1996.0,9.4,9,5,6,2,1,3,8,37.5,5,5,0,5,1,10,4,1,"FW,MF",25-29,Forward,Spain,Europe
2205,Adama Traoré,ESP,Fulham,Premier League,2024,28.0,1996.0,9.4,9,5,6,2,1,3,8,37.5,5,5,0,5,1,10,4,1,"FW,MF",25-29,Forward,Spain,Europe
2205,Adama Traoré,ESP,Fulham,Premier League,2024,28.0,1996.0,9.4,9,5,6,2,1,3,8,37.5,5,5,0,5,1,10,4,1,"FW,MF",25-29,Forward,Spain,Europe
2205,Adama Traoré,ESP,Fulham,Premier League,2024,28.0,1996.0,9.4,9,5,6,2,1,3,8,37.5,5,5,0,5,1,10,4,1,"FW,MF",25-29,Forward,Spain,Europe
2205,Adama Traoré,ESP,Fulham,Premier League,2024,28.0,1996.0,9.4,9,5,6,2,1,3,8,37.5,5,5,0,5,1,10,4,1,"FW,MF",25-29,Forward,Spain,Europe
2205,Adama Traoré,ESP,Fulham,Premier League,2024,28.0,1996.0,9.4,9,5,6,2,1,3,8,37.5,5,5,0,5,1,10,4,1,"FW,MF",25-29,Forward,Spain,Europe
2205,Adama Traoré,ESP,Fulham,Premier League,2024,28.0,1996.0,9.4,9,5,6,2,1,3,8,37.5,5,5,0,5,1,10,4,1,"FW,MF",25-29,Forward,Spain,Europe
2205,Adama Traoré,ESP,Fulham,Premier League,2024,28.0,1996.0,9.4,9,5,6,2,1,3,8,37.5,5,5,0,5,1,10,4,1,"FW,MF",25-29,Forward,Spain,Europe
2221,Beñat Turrientes,ESP,Real Sociedad,La Liga,2024,22.0,2002.0,6.2,11,3,4,6,1,3,7,42.9,4,12,2,10,4,15,6,0,MF,20-24,Midfielder,Spain,Europe
2233,Kacper Urbanski,POL,Bologna,Serie A,2024,20.0,2004.0,2.7,5,2,4,0,1,4,6,66.7,2,5,1,4,2,7,5,0,MF,20-24,Midfielder,Poland,Europe
2237,Óscar Valentín,ESP,Rayo Vallecano,La Liga,2024,30.0,1994.0,13.2,36,28,14,14,8,20,40,50.0,20,23,3,20,18,54,38,0,MF,30-34,Midfielder,Spain,Europe
2238,Germán Valera,ESP,Valencia,La Liga,2024,22.0,2002.0,1.6,1,1,1,0,0,0,1,0.0,1,2,0,2,4,5,2,1,MF,20-24,Midfielder,Spain,Europe
2241,Jesús Vallejo,ESP,Real Madrid,La Liga,2024,27.0,1997.0,0.1,0,0,0,0,0,0,0,,0,0,0,0,0,0,2,0,DF,25-29,Defender,Spain,Europe
2255,José Luis García Vayá,ESP,Valencia,La Liga,2024,26.0,1998.0,11.9,20,12,7,9,4,7,15,46.7,8,14,5,9,6,26,16,0,MF,25-29,Midfielder,Spain,Europe
2256,Jesus Vazquez,ESP,Valencia,La Liga,2024,21.0,2003.0,7.2,16,13,8,6,2,5,12,41.7,7,14,5,9,5,21,22,0,DF,20-24,Defender,Spain,Europe
2257,Lucas Vázquez,ESP,Real Madrid,La Liga,2024,33.0,1991.0,9.8,27,16,17,7,3,12,25,48.0,13,6,1,5,4,31,13,0,DF,30-34,Defender,Spain,Europe
2261,Miloš Veljković,SRB,Werder Bremen,Bundesliga,2024,29.0,1995.0,4.5,2,1,1,0,1,1,5,20.0,4,6,5,1,1,3,17,0,DF,25-29,Defender,Serbia,Europe
2270,Mikel Vesga,ESP,Athletic Club,La Liga,2024,31.0,1993.0,4.4,9,5,2,7,0,4,12,33.3,8,6,0,6,7,16,6,0,MF,30-34,Midfielder,Spain,Europe
2274,Carlos Vicente,ESP,Alavés,La Liga,2024,25.0,1999.0,16.7,17,12,11,3,3,10,17,58.8,7,12,1,11,5,22,15,0,"FW,MF",25-29,Forward,Spain,Europe
2275,Pau Victor Delgado,ESP,Barcelona,La Liga,2024,23.0,2001.0,2.2,1,1,0,1,0,0,3,0.0,3,5,1,4,2,3,4,0,FW,20-24,Forward,Spain,Europe
2276,Nacho Vidal,ESP,Osasuna,La Liga,2024,29.0,1995.0,1.4,2,0,0,1,1,1,4,25.0,3,1,0,1,0,2,6,0,DF,25-29,Defender,Spain,Europe
2278,Fran Vieites,ESP,Betis,La Liga,2024,25.0,1999.0,3.0,0,0,0,0,0,0,0,,0,0,0,0,0,0,1,0,GK,25-29,Goalkeeper,Spain,Europe
2280,Asier Villalibre,ESP,Alavés,La Liga,2024,27.0,1997.0,2.4,0,0,0,0,0,0,0,,0,1,0,1,1,1,4,0,FW,25-29,Forward,Spain,Europe
2281,Iván Villar,ESP,Celta Vigo,La Liga,2024,27.0,1997.0,4.0,0,0,0,0,0,0,0,,0,0,0,0,0,0,3,0,GK,25-29,Goalkeeper,Spain,Europe
2284,Viti,ESP,Las Palmas,La Liga,2024,27.0,1997.0,10.2,34,25,19,12,3,11,16,68.8,5,14,3,11,17,51,29,0,DF,25-29,Defender,Spain,Europe
2288,Daniel Vivian,ESP,Athletic Club,La Liga,2024,25.0,1999.0,14.6,16,13,9,7,0,12,17,70.6,5,12,5,7,18,34,73,0,DF,25-29,Defender,Spain,Europe
2289,Dušan Vlahović,SRB,Juventus,Serie A,2024,24.0,2000.0,13.8,2,1,0,1,1,1,2,50.0,1,5,3,2,1,3,8,1,FW,20-24,Forward,Serbia,Europe
2290,Vanja Vlahović,SRB,Atalanta,Serie A,2024,20.0,2004.0,0.3,0,0,0,0,0,0,0,,0,0,0,0,0,0,0,0,"MF,FW",20-24,Midfielder,Serbia,Europe
2305,Sebastian Walukiewicz,POL,Torino,Serie A,2024,24.0,2000.0,10.1,15,8,8,5,2,10,15,66.7,5,13,3,10,13,28,33,0,DF,20-24,Defender,Poland,Europe
2306,Sebastian Walukiewicz,POL,Empoli,Serie A,2024,24.0,2000.0,2.0,1,0,1,0,0,0,1,0.0,1,3,3,0,1,2,15,0,DF,20-24,Defender,Poland,Europe
2327,Mateusz Wieteska,POL,Cagliari,Serie A,2024,27.0,1997.0,1.4,1,0,0,1,0,1,1,100.0,0,2,1,1,7,8,4,0,DF,25-29,Defender,Poland,Europe
2331,Nico Williams,ESP,Athletic Club,La Liga,2024,22.0,2002.0,13.8,23,14,8,9,6,8,21,38.1,13,11,0,11,5,28,5,0,FW,20-24,Forward,Spain,Europe
2351,Lamine Yamal,ESP,Barcelona,La Liga,2024,17.0,2007.0,14.2,22,16,2,10,10,6,13,46.2,7,7,0,7,9,31,3,0,FW,Under 20,Forward,Spain,Europe
2352,Daniel Yáñez,ESP,Real Madrid,La Liga,2024,17.0,2007.0,0.0,0,0,0,0,0,0,0,,0,0,0,0,0,0,0,0,FW,Under 20,Forward,Spain,Europe
2367,Miha Zajc,SVN,Toulouse,Ligue 1,2024,30.0,1994.0,1.5,1,1,0,0,1,1,2,50.0,1,0,0,0,2,3,3,0,MF,30-34,Midfielder,Slovenia,Europe
2369,Nicola Zalewski,POL,Roma,Serie A,2024,22.0,2002.0,5.6,7,5,2,2,3,2,7,28.6,5,5,1,4,3,10,6,2,"DF,FW",20-24,Defender,Poland,Europe
2377,Bryan Zaragoza,ESP,Osasuna,La Liga,2024,23.0,2001.0,11.7,11,8,8,2,1,4,16,25.0,12,7,0,7,0,11,8,0,"FW,MF",20-24,Forward,Spain,Europe
2379,Oier Zarraga,ESP,Udinese,Serie A,2024,25.0,1999.0,5.5,11,7,6,5,0,6,15,40.0,9,3,2,1,2,13,4,0,MF,25-29,Midfielder,Spain,Europe
2388,Piotr Zieliński,POL,Inter,Serie A,2024,30.0,1994.0,3.7,8,6,3,4,1,3,8,37.5,5,1,0,1,0,8,1,0,MF,30-34,Midfielder,Poland,Europe
2395,Igor Zubeldia,ESP,Real Sociedad,La Liga,2024,27.0,1997.0,15.4,21,16,13,7,1,12,20,60.0,8,22,14,8,16,37,55,2,DF,25-29,Defender,Spain,Europe
2396,Martín Zubimendi,ESP,Real Sociedad,La Liga,2024,25.0,1999.0,16.0,43,25,17,18,8,16,25,64.0,9,22,7,15,23,66,35,2,MF,25-29,Midfielder,Spain,Europe
2397,Martin Ødegaard,NOR,Arsenal,Premier League,2024,26.0,1998.0,9.1,11,6,4,5,2,2,13,15.4,11,2,0,2,1,12,1,0,MF,25-29,Midfielder,Norway,Europe
70,Mickaël Alphonse,GLP,Dijon,Ligue 1,2018,29.0,1989.0,6.3,10,5,6,1,3,3,4,75.0,1,3,1,2,9,19,30,0,DF,25-29,Defender,France,Europe
147,Ludovic Baal,GUF,Rennes,Ligue 1,2018,32.0,1986.0,1.4,4,3,3,1,0,0,0,,0,1,0,1,2,6,1,0,DF,30-34,Defender,French Guiana,
222,Claudio Beauvue,GLP,Caen,Ligue 1,2018,30.0,1988.0,16.7,18,11,7,9,2,1,14,7.1,13,11,2,9,10,28,21,0,"FW,MF",30-34,Forward,Guadeloupe,
267,Valon Berisha,KVX,Lazio,Serie A,2018,25.0,1993.0,2.2,8,5,1,6,1,4,6,66.7,2,6,0,6,4,12,3,0,"MF,FW",25-29,Midfielder,Sweden,Europe
366,Patrick Burner,MTQ,Nice,Ligue 1,2018,22.0,1996.0,15.0,36,23,22,10,4,16,34,47.1,18,15,5,10,31,67,40,0,DF,20-24,Defender,Martinique,
548,Alessio da Cruz,Cape Verde,Parma,Serie A,2018,21.0,1997.0,1.6,2,1,0,2,0,0,1,0.0,1,0,0,0,0,2,0,0,"FW,MF",20-24,Forward,Netherlands,Europe
599,Grégoire Defrel,MTQ,Sampdoria,Serie A,2018,27.0,1991.0,26.0,40,29,10,16,14,9,21,42.9,12,15,0,15,3,43,9,0,"FW,MF",25-29,Forward,France,Europe
1008,Florent Hadergjonaj,KVX,Huddersfield,Premier League,2018,24.0,1994.0,20.5,30,17,10,18,2,13,37,35.1,24,21,7,14,21,51,37,1,"DF,MF",20-24,Defender,Switzerland,Europe
1047,Christophe Hérelle,MTQ,Nice,Ligue 1,2018,25.0,1992.0,32.6,72,52,51,19,2,40,50,80.0,10,39,16,23,61,133,158,2,DF,25-29,Defender,France,Europe
1659,Hakim El Mokeddem,France,Toulouse,Ligue 1,2018,19.0,1999.0,0.3,1,1,1,0,0,0,1,0.0,1,0,0,0,0,1,1,0,"FW,MF",Under 20,Forward,France,Europe
1727,Florent Muslija,KVX,Hannover 96,Bundesliga,2018,20.0,1998.0,7.5,16,10,8,6,2,8,12,66.7,4,4,0,4,3,19,4,0,"MF,FW",20-24,Midfielder,Germany,Europe
1934,Matthias Phaeton,GLP,Guingamp,Ligue 1,2018,18.0,2000.0,0.6,1,1,0,1,0,0,0,,0,0,0,0,0,1,0,0,"FW,MF",Under 20,Forward,,
2037,Milot Rashica,KVX,Werder Bremen,Bundesliga,2018,22.0,1996.0,17.2,24,16,8,11,5,9,24,37.5,15,16,2,14,6,30,6,1,"FW,MF",20-24,Forward,Yugoslavia (Republic),
2056,Elvis Rexhbeçaj,KVX,Wolfsburg,Bundesliga,2018,20.0,1997.0,12.7,28,18,11,12,5,12,24,50.0,12,18,2,16,14,42,21,0,MF,20-24,Midfielder,,
2073,Kévin Rimane,GUF,Paris S-G,Ligue 1,2018,27.0,1991.0,0.1,0,0,0,0,0,0,0,,0,0,0,0,0,0,0,0,MF,25-29,Midfielder,French Guiana,
2237,Stanley Segarel,SMN,Amiens,Ligue 1,2018,24.0,1994.0,0.2,0,0,0,0,0,0,0,,0,0,0,0,0,0,0,0,FW,20-24,Forward,France,Europe
2563,Anthony Walongwa,DR Congo,Nantes,Ligue 1,2018,24.0,1993.0,1.0,0,0,0,0,0,0,0,,0,3,2,1,1,1,2,0,DF,20-24,Defender,France,Europe
2633,Arton Zekaj,KVX,Lille,Ligue 1,2018,18.0,2000.0,0.0,0,0,0,0,0,0,0,,0,0,0,0,0,0,0,0,FW,Under 20,Forward,Yugoslavia (Republic),
2635,Arber Zeneli,KVX,Reims,Ligue 1,2018,23.0,1995.0,9.0,8,6,3,2,3,0,10,0.0,10,3,0,3,2,10,3,1,FW,20-24,Forward,,
52,Josué Albert,GUF,Clermont Foot,Ligue 1,2021,29.0,1992.0,0.2,0,0,0,0,0,0,0,,0,0,0,0,1,1,2,0,DF,25-29,Defender,France,Europe
134,Fisnik Asllani,KVX,Hoffenheim,Bundesliga,2021,18.0,2002.0,0.1,0,0,0,0,0,0,1,0.0,1,0,0,0,0,0,0,0,"MF,FW",Under 20,Midfielder,,
294,Valon Berisha,KVX,Reims,Ligue 1,2021,28.0,1993.0,5.1,10,7,2,5,3,2,10,20.0,8,9,0,9,4,14,3,0,"MF,FW",25-29,Midfielder,Sweden,Europe
652,Grégoire Defrel,MTQ,Sassuolo,Serie A,2021,30.0,1991.0,15.1,15,9,4,8,3,6,16,37.5,10,11,1,10,4,19,11,0,FW,30-34,Forward,France,Europe
1051,Andrew Gravillon,GLP,Reims,Ligue 1,2021,23.0,1998.0,23.7,32,24,19,13,0,17,27,63.0,10,25,15,10,33,65,83,1,DF,20-24,Defender,,
1161,Christophe Hérelle,MTQ,Brest,Ligue 1,2021,28.0,1992.0,21.5,48,28,30,16,2,17,26,65.4,9,20,15,5,44,92,84,1,DF,25-29,Defender,France,Europe
1343,Atakan Karazor,Türkiye,Stuttgart,Bundesliga,2021,24.0,1996.0,21.1,48,24,18,27,3,18,36,50.0,18,37,14,23,34,82,47,0,MF,20-24,Midfielder,Germany,Europe
1626,Mickael Malsa,MTQ,Levante,La Liga,2021,25.0,1995.0,12.7,37,17,16,18,3,15,42,35.7,27,20,8,12,18,55,15,0,MF,25-29,Midfielder,,
1875,Vedat Muriqi,KVX,Lazio,Serie A,2021,27.0,1994.0,2.4,1,0,1,0,0,0,5,0.0,5,0,0,0,0,1,2,0,FW,25-29,Forward,Yugoslavia (Republic),
1876,Vedat Muriqi,KVX,Mallorca,La Liga,2021,27.0,1994.0,16.0,6,3,1,3,2,1,7,14.3,6,12,0,12,6,12,29,0,FW,25-29,Forward,Yugoslavia (Republic),
2219,Elba Rashani,KVX,Clermont Foot,Ligue 1,2021,28.0,1993.0,19.5,40,21,15,21,4,17,55,30.9,38,34,3,31,11,51,20,0,"FW,MF",25-29,Forward,,
2221,Milot Rashica,KVX,Norwich City,Premier League,2021,25.0,1996.0,24.8,31,19,12,12,7,11,30,36.7,19,22,3,19,15,46,23,0,"FW,MF",25-29,Forward,Yugoslavia (Republic),
2241,Elvis Rexhbeçaj,KVX,Bochum,Bundesliga,2021,23.0,1997.0,28.2,41,20,17,19,5,19,40,47.5,21,41,6,35,27,68,15,0,MF,20-24,Midfielder,,
2319,Amir Rrahmani,KVX,Napoli,Serie A,2021,27.0,1994.0,32.5,21,11,15,5,1,15,19,78.9,4,36,25,11,19,40,89,0,DF,25-29,Defender,Yugoslavia (Republic),
2364,Yoann Salmier,GUF,Troyes,Ligue 1,2021,28.0,1992.0,29.6,58,33,44,11,3,26,34,76.5,8,30,14,16,40,98,94,0,DF,25-29,Defender,France,Europe
2622,Jordan Tell,GLP,Clermont Foot,Ligue 1,2021,24.0,1997.0,3.2,5,5,0,3,2,1,4,25.0,3,3,0,3,0,5,1,0,FW,20-24,Forward,Guadeloupe,
2749,Jonathan Varane,MTQ,Lens,Ligue 1,2021,19.0,2001.0,0.0,0,0,0,0,0,0,0,,0,0,0,0,0,0,0,0,MF,Under 20,Midfielder,France,Europe
2805,Mërgim Vojvoda,KVX,Torino,Serie A,2021,26.0,1995.0,22.0,38,23,23,11,4,20,36,55.6,16,27,8,19,20,58,51,0,DF,25-29,Defender,Germany,Europe
2899,Arber Zeneli,KVX,Reims,Ligue 1,2021,26.0,1995.0,4.5,1,0,0,0,1,1,5,20.0,4,0,0,0,1,2,1,0,FW,25-29,Forward,,
2903,Edon Zhegrova,KVX,Lille,Ligue 1,2021,22.0,1999.0,5.3,14,5,2,8,4,5,6,83.3,1,4,1,3,2,16,2,0,"MF,FW",20-24,Midfielder,Germany,Europe
1104,Atakan Karazor,Türkiye,Stuttgart,Bundesliga,2024,28.0,1996.0,11.7,24,9,5,12,7,14,25,56.0,11,13,1,12,13,37,12,1,MF,25-29,Midfielder,Germany,Europe
1196,Rémy Labeau Lascary,GLP,Lens,Ligue 1,2024,21.0,2003.0,7.1,16,10,7,6,3,5,11,45.5,6,5,0,5,1,17,7,0,"FW,MF",20-24,Forward,Guadeloupe,
1239,Donovan Léon,GUF,Auxerre,Ligue 1,2024,32.0,1992.0,15.0,0,0,0,0,0,0,2,0.0,2,0,0,0,0,0,9,1,GK,30-34,Goalkeeper,French Guiana,
1274,Fer López,Spain,Celta Vigo,La Liga,2024,20.0,2004.0,0.5,3,1,0,3,0,0,1,0.0,1,1,0,1,1,4,0,0,FW,Unknown,Forward,Spain,Europe
1540,Arijanet Muric,KVX,Ipswich Town,Premier League,2024,26.0,1998.0,16.0,0,0,0,0,0,0,2,0.0,2,0,0,0,0,0,10,5,GK,25-29,Goalkeeper,Switzerland,Europe
1542,Vedat Muriqi,KVX,Mallorca,La Liga,2024,30.0,1994.0,11.0,1,0,0,1,0,0,1,0.0,1,1,0,1,4,5,20,0,FW,30-34,Forward,Yugoslavia (Republic),
1546,Florent Muslija,KVX,Freiburg,Bundesliga,2024,26.0,1998.0,1.9,5,4,3,1,1,2,2,100.0,0,0,0,0,1,6,1,0,"FW,MF",25-29,Forward,Germany,Europe
1843,Elvis Rexhbeçaj,KVX,Augsburg,Bundesliga,2024,27.0,1997.0,11.4,16,12,5,9,2,10,26,38.5,16,23,4,19,12,28,12,1,MF,25-29,Midfielder,,
1901,Amir Rrahmani,KVX,Napoli,Serie A,2024,30.0,1994.0,17.0,13,10,7,6,0,8,12,66.7,4,17,10,7,5,18,65,0,DF,30-34,Defender,Yugoslavia (Republic),
1941,Yoann Salmier,GUF,Le Havre,Ligue 1,2024,32.0,1992.0,7.6,11,6,7,3,1,7,8,87.5,1,11,7,4,6,17,49,0,DF,30-34,Defender,France,Europe
2004,Jérémy Sebas,MTQ,Strasbourg,Ligue 1,2024,21.0,2003.0,1.7,3,2,1,1,1,2,3,66.7,1,1,0,1,0,3,2,0,"FW,MF",20-24,Forward,Martinique,
2294,Mërgim Vojvoda,KVX,Torino,Serie A,2024,29.0,1995.0,9.3,15,7,5,7,3,7,14,50.0,7,12,3,9,5,20,19,1,DF,25-29,Defender,Germany,Europe
2387,Edon Zhegrova,KVX,Lille,Ligue 1,2024,25.0,1999.0,10.9,5,2,3,0,2,2,7,28.6,5,8,0,8,4,9,1,0,"FW,MF",25-29,Forward,Germany,Europe
