player_id,player,nation,squad,comp,season,age,born,ninety_mins_played,tackles,tackles_won,def_third_tackles,mid_third_tackles,att_third_tackles,dribblers_tackled,dribblers_challenged,tackle_pct,challenges_lost,blocks,shots_blocked,passes_blocked,interceptions,tackles_interceptions,clearances,errors,position,age_range,general_position,country,continent
199704,Yunis Abdelhamid,MAR,Reims,Ligue 1,2020,32.0,1987.0,32.1,59,37,36,23,0,26,42,61.9,16,34,15,19,61,120,132,0,DF,30-34,Defender,Morocco,Africa
238626,Laurent Abergel,FRA,Lorient,Ligue 1,2020,27.0,1993.0,32.9,145,84,64,69,12,54,162,33.3,108,64,6,58,46,191,12,0,MF,25-29,Midfielder,France,Europe
418658,Charles Abi,FRA,Saint-tienne,Ligue 1,2020,20.0,2000.0,10.1,8,2,5,0,3,3,12,25.0,9,6,2,4,4,12,5,0,"FW,MF",20-24,Forward,France,Europe
58178,David Abraham,ARG,Eint Frankfurt,Bundesliga,2020,34.0,1986.0,13.6,18,12,13,3,2,11,17,64.7,6,13,4,9,17,35,34,0,DF,30-34,Defender,Argentina,South America
331726,Tammy Abraham,ENG,Chelsea,Premier League,2020,22.0,1997.0,11.6,7,5,3,3,1,1,7,14.3,6,6,0,6,5,12,17,0,FW,20-24,Forward,England,Europe
332705,Tyler Adams,USA,RB Leipzig,Bundesliga,2020,21.0,1999.0,20.6,35,24,12,15,8,17,31,54.8,14,22,5,17,29,64,30,0,"MF,DF",20-24,Midfielder,United States,North America
125614,Sargis Adamyan,ARM,Hoffenheim,Bundesliga,2020,27.0,1993.0,5.3,9,4,4,3,2,7,14,50.0,7,2,0,2,6,15,1,0,"FW,MF",25-29,Forward,Armenia,Asia
258878,Tosin Adarabioyo,ENG,Fulham,Premier League,2020,22.0,1997.0,32.8,37,19,30,6,1,19,40,47.5,21,26,20,6,42,79,197,2,DF,20-24,Defender,England,Europe
395236,Yacine Adli,FRA,Bordeaux,Ligue 1,2020,20.0,2000.0,26.9,74,37,30,33,11,35,92,38.0,57,27,2,25,39,113,17,2,MF,20-24,Midfielder,France,Europe
393512,Felix Agu,GER,Werder Bremen,Bundesliga,2020,20.0,1999.0,7.8,20,9,10,9,1,10,18,55.6,8,14,3,11,12,32,18,0,DF,20-24,Defender,Germany,Europe
587458,Kevin Agudelo,COL,Spezia,Serie A,2020,21.0,1998.0,15.1,39,28,9,15,15,12,34,35.3,22,30,0,30,10,49,2,0,FW,20-24,Forward,Colombia,South America
361914,Nayef Aguerd,MAR,Rennes,Ligue 1,2020,24.0,1996.0,35.0,37,30,28,9,0,21,33,63.6,12,34,22,12,47,84,102,0,DF,20-24,Defender,Morocco,Africa
26399,Sergio Agero,ARG,Manchester City,Premier League,2020,32.0,1988.0,6.2,4,1,0,2,2,2,11,18.2,9,2,0,2,2,6,0,0,FW,30-34,Forward,Argentina,South America
203746,Ruben Aguilar,FRA,Monaco,Ligue 1,2020,27.0,1993.0,24.7,63,37,32,21,10,32,52,61.5,20,30,3,27,47,110,43,1,"DF,MF",25-29,Defender,France,Europe
236490,Ola Aina,NGA,Fulham,Premier League,2020,23.0,1996.0,29.6,37,20,22,7,8,21,43,48.8,22,22,6,16,45,82,94,2,DF,20-24,Defender,Nigeria,Africa
251912,Semi Ajayi,NGA,West Brom,Premier League,2020,26.0,1993.0,30.9,40,14,34,6,0,23,41,56.1,18,51,32,19,42,82,122,2,DF,25-29,Defender,Nigeria,Africa
283994,Ludovic Ajorque,FRA,Strasbourg,Ligue 1,2020,26.0,1994.0,33.0,30,18,6,18,6,7,31,22.6,24,14,5,9,11,41,54,0,FW,25-29,Forward,France,Europe
225015,Carlos Akapo,EQG,Cdiz,La Liga,2020,27.0,1993.0,9.6,18,14,14,4,0,10,18,55.6,8,16,3,13,19,37,33,0,DF,25-29,Defender,Equatorial Guinea,Africa
177476,Nathan Ak,NED,Manchester City,Premier League,2020,25.0,1995.0,8.9,10,5,3,6,1,3,4,75.0,1,2,1,1,9,19,23,0,DF,25-29,Defender,Netherlands,Europe
160241,Kevin Akpoguma,NGA,Hoffenheim,Bundesliga,2020,25.0,1995.0,13.2,18,12,11,6,1,8,14,57.1,6,28,15,13,13,31,32,2,DF,25-29,Defender,Nigeria,Africa
59016,David Alaba,AUT,Bayern Munich,Bundesliga,2020,28.0,1992.0,29.7,37,21,14,19,4,17,32,53.1,15,29,13,16,43,80,60,0,"DF,MF",25-29,Defender,Austria,Europe
193782,Lucas Alario,ARG,Leverkusen,Bundesliga,2020,27.0,1992.0,13.8,8,2,2,5,1,2,4,50.0,2,9,1,8,2,10,10,0,FW,25-29,Forward,Argentina,South America
353032,Omar Alderete,PAR,Hertha BSC,Bundesliga,2020,23.0,1996.0,14.4,16,10,11,5,0,7,16,43.8,9,14,10,4,21,37,61,1,DF,20-24,Defender,Paraguay,South America
314353,Trent Alexander-Arnold,ENG,Liverpool,Premier League,2020,21.0,1998.0,33.7,56,33,31,18,7,36,56,64.3,20,24,3,21,49,105,50,3,DF,20-24,Defender,England,Europe
1083070,Alisson,BRA,Liverpool,Premier League,2020,27.0,1992.0,33.0,3,2,3,0,0,3,4,75.0,1,0,0,0,2,5,26,7,GK,25-29,Goalkeeper,Brazil,South America
385271,Allan,BRA,Everton,Premier League,2020,29.0,1991.0,22.8,80,45,39,37,4,28,95,29.5,67,31,12,19,19,99,25,1,MF,25-29,Midfielder,Brazil,South America
207929,Dele Alli,ENG,Tottenham,Premier League,2020,24.0,1996.0,6.9,18,11,8,6,4,7,19,36.8,12,9,0,9,7,25,3,0,MF,20-24,Midfielder,England,Europe
476237,Steven Alzate,COL,Brighton,Premier League,2020,21.0,1998.0,10.0,17,8,10,4,3,6,15,40.0,9,8,1,7,8,25,10,0,MF,20-24,Midfielder,Colombia,South America
205503,Ibrahim Amadou,FRA,Angers,Ligue 1,2020,27.0,1993.0,16.7,39,26,18,19,2,15,38,39.5,23,14,4,10,23,62,25,0,MF,25-29,Midfielder,France,Europe
241229,Jordan Amavi,FRA,Marseille,Ligue 1,2020,26.0,1994.0,9.0,11,9,9,1,1,9,12,75.0,3,12,2,10,27,38,33,1,DF,25-29,Defender,France,Europe
232454,Nadiem Amiri,GER,Leverkusen,Bundesliga,2020,23.0,1996.0,21.0,12,7,4,8,0,7,33,21.2,26,18,3,15,12,24,7,0,MF,20-24,Midfielder,Germany,Europe
392771,Ethan Ampadu,WAL,Sheffield Utd,Premier League,2020,19.0,2000.0,23.2,57,36,31,24,2,20,46,43.5,26,40,19,21,49,106,87,3,"DF,MF",Under 20,Defender,Wales,Europe
147573,Sebastian Andersson,SWE,Kln,Bundesliga,2020,29.0,1991.0,12.5,3,2,0,3,0,1,8,12.5,7,10,3,7,2,5,9,0,FW,25-29,Forward,Sweden,Europe
84301,Benjamin Andr,FRA,Lille,Ligue 1,2020,29.0,1990.0,32.1,114,68,47,61,6,53,122,43.4,69,39,10,29,76,190,49,0,MF,25-29,Midfielder,France,Europe
55854,Cristian Ansaldi,ARG,Torino,Serie A,2020,33.0,1986.0,21.6,48,33,25,14,9,24,38,63.2,14,21,7,14,16,64,38,0,"DF,FW",30-34,Defender,Argentina,South America
193004,Waldemar Anton,GER,Stuttgart,Bundesliga,2020,24.0,1996.0,30.1,31,20,17,14,0,12,31,38.7,19,28,18,10,47,78,114,0,DF,20-24,Defender,Germany,Europe
395693,Houssem Aouar,ALG,Lyon,Ligue 1,2020,22.0,1998.0,19.8,17,12,0,13,4,8,25,32.0,17,17,1,16,17,34,4,0,"MF,FW",20-24,Midfielder,Algeria,Africa
569385,Adil Aouchiche,FRA,Saint-tienne,Ligue 1,2020,18.0,2002.0,19.2,38,20,12,17,9,13,49,26.5,36,15,1,14,10,48,6,0,"MF,FW",Under 20,Midfielder,France,Europe
89701,Charles Arnguiz,CHI,Leverkusen,Bundesliga,2020,31.0,1989.0,18.5,41,23,16,21,4,17,43,39.5,26,32,4,28,33,74,17,0,MF,30-34,Midfielder,Chile,South America
435485,Luiz Arajo,BRA,Lille,Ligue 1,2020,24.0,1996.0,16.6,38,25,12,18,8,8,28,28.6,20,23,1,22,11,49,3,0,MF,20-24,Midfielder,Brazil,South America
456080,Karim Aribi,ALG,Nmes,Ligue 1,2020,26.0,1994.0,3.3,2,2,0,1,1,0,5,0.0,5,1,0,1,0,2,3,0,FW,25-29,Forward,Algeria,Africa
130765,Stuart Armstrong,SCO,Southampton,Premier League,2020,28.0,1992.0,30.7,60,41,19,32,9,27,75,36.0,48,26,1,25,24,84,19,0,MF,25-29,Midfielder,Scotland,Europe
53536,Tolgay Arslan,GER,Udinese,Serie A,2020,29.0,1990.0,20.2,52,32,24,24,4,25,54,46.3,29,22,2,20,22,74,15,1,MF,25-29,Midfielder,Germany,Europe
63531,Kwadwo Asamoah,GHA,Cagliari,Serie A,2020,31.0,1988.0,2.5,4,3,2,2,0,2,3,66.7,1,5,1,4,4,8,2,1,"DF,MF",30-34,Defender,Ghana,Africa
423436,Santiago Ascacbar,ARG,Hertha BSC,Bundesliga,2020,23.0,1997.0,8.5,30,15,15,14,1,15,28,53.6,13,23,2,21,13,43,14,0,MF,20-24,Midfielder,Argentina,South America
263183,Roger Assal,CIV,Dijon,Ligue 1,2020,26.0,1993.0,9.2,10,8,3,5,2,4,12,33.3,8,7,3,4,2,12,2,0,"FW,MF",25-29,Forward,Ivory Coast,Africa
58864,Pierre-Emerick Aubameyang,GAB,Arsenal,Premier League,2020,31.0,1989.0,25.9,12,8,7,4,1,3,20,15.0,17,18,0,18,7,19,17,0,FW,30-34,Forward,Gabon,Africa
284595,Tommaso Augello,ITA,Sampdoria,Serie A,2020,25.0,1994.0,35.7,42,30,27,10,5,23,39,59.0,16,22,2,20,32,74,76,1,DF,25-29,Defender,Italy,Europe
127032,Serge Aurier,CIV,Tottenham,Premier League,2020,27.0,1992.0,17.8,55,33,33,17,5,15,40,37.5,25,28,5,23,19,74,44,3,DF,25-29,Defender,Ivory Coast,Africa
295313,Taiwo Awoniyi,NGA,Union Berlin,Bundesliga,2020,22.0,1997.0,15.1,5,3,2,3,0,1,14,7.1,13,9,0,9,3,8,4,0,FW,20-24,Forward,Nigeria,Africa
108354,Jordan Ayew,GHA,Crystal Palace,Premier League,2020,28.0,1991.0,23.3,38,26,8,16,14,16,44,36.4,28,28,2,26,16,54,12,0,"FW,MF",25-29,Forward,Ghana,Africa
67420,Luke Ayling,ENG,Leeds United,Premier League,2020,28.0,1991.0,37.8,108,61,69,30,9,49,87,56.3,38,53,36,17,36,144,96,5,DF,25-29,Defender,England,Europe
119235,Carlos Bacca,COL,Villarreal,La Liga,2020,33.0,1986.0,8.7,9,5,5,3,1,3,5,60.0,2,5,0,5,3,12,2,0,FW,30-34,Forward,Colombia,South America
463603,Benot Badiashile,FRA,Monaco,Ligue 1,2020,19.0,2001.0,31.9,24,17,15,9,0,13,28,46.4,15,21,12,9,58,82,102,4,DF,Under 20,Defender,France,Europe
387626,Leon Bailey,JAM,Leverkusen,Bundesliga,2020,22.0,1997.0,23.8,14,8,3,7,4,4,15,26.7,11,13,0,13,9,23,3,0,"FW,MF",20-24,Forward,Jamaica,North America
540664,Dilane Bakwa,FRA,Bordeaux,Ligue 1,2020,17.0,2002.0,0.6,2,2,1,1,0,0,1,0.0,1,2,0,2,1,3,0,0,"FW,MF",Under 20,Forward,France,Europe
238752,Keita Bald,SEN,Sampdoria,Serie A,2020,25.0,1995.0,13.3,9,6,2,6,1,4,10,40.0,6,10,1,9,0,9,3,0,FW,25-29,Forward,Senegal,Africa
146690,George Baldock,GRE,Sheffield Utd,Premier League,2020,27.0,1993.0,31.0,47,34,28,14,5,21,50,42.0,29,26,7,19,25,72,70,1,DF,25-29,Defender,Greece,Europe
39381,Gareth Bale,WAL,Tottenham,Premier League,2020,31.0,1989.0,10.2,17,10,4,9,4,7,14,50.0,7,13,2,11,8,25,16,0,FW,30-34,Forward,Wales,Europe
575998,Leonardo Balerdi,ARG,Marseille,Ligue 1,2020,21.0,1999.0,18.2,29,18,19,7,3,14,31,45.2,17,17,9,8,28,57,65,3,DF,20-24,Defender,Argentina,South America
296422,Fod Ballo-Tour,SEN,Monaco,Ligue 1,2020,23.0,1997.0,7.4,21,17,9,11,1,6,13,46.2,7,7,0,7,6,27,11,1,DF,20-24,Defender,Senegal,Africa
62351,Abdoulaye Bamba,CIV,Angers,Ligue 1,2020,30.0,1990.0,15.0,27,17,19,7,1,19,28,67.9,9,7,1,6,19,46,34,0,DF,30-34,Defender,Ivory Coast,Africa
292818,Jonathan Bamba,CIV,Lille,Ligue 1,2020,24.0,1996.0,33.2,45,23,15,19,11,24,84,28.6,60,24,2,22,24,69,15,0,MF,20-24,Midfielder,Ivory Coast,Africa
183334,Patrick Bamford,ENG,Leeds United,Premier League,2020,26.0,1993.0,33.9,21,9,2,11,8,8,27,29.6,19,14,4,10,10,31,37,0,FW,25-29,Forward,England,Europe
165873,Federico Barba,ITA,Benevento,Serie A,2020,26.0,1993.0,29.5,31,16,22,8,1,21,35,60.0,14,39,18,21,48,79,94,4,DF,25-29,Defender,Italy,Europe
255942,Nicol Barella,ITA,Inter,Serie A,2020,23.0,1997.0,32.2,58,31,23,29,6,23,72,31.9,49,29,4,25,26,84,14,0,MF,20-24,Midfielder,Italy,Europe
315332,Aymen Barkok,MAR,Eint Frankfurt,Bundesliga,2020,22.0,1998.0,10.9,29,15,11,9,9,10,31,32.3,21,15,1,14,10,39,9,1,"MF,DF",20-24,Midfielder,Morocco,Africa
63200,Ashley Barnes,ENG,Burnley,Premier League,2020,30.0,1989.0,14.8,12,6,2,6,4,3,13,23.1,10,14,2,12,5,17,11,0,FW,30-34,Forward,England,Europe
398065,Harvey Barnes,ENG,Leicester City,Premier League,2020,22.0,1997.0,21.6,19,9,11,3,5,5,22,22.7,17,16,3,13,8,27,11,0,"FW,MF",20-24,Forward,England,Europe
486624,Musa Barrow,GAM,Bologna,Serie A,2020,21.0,1998.0,32.5,26,10,8,10,8,10,25,40.0,15,37,2,35,11,37,15,0,"FW,MF",20-24,Forward,Gambia,Africa
67421,Kyle Bartley,ENG,West Brom,Premier League,2020,29.0,1991.0,28.7,27,16,14,10,3,11,23,47.8,12,50,35,15,38,65,159,1,DF,25-29,Defender,England,Europe
134883,Daniele Baselli,ITA,Torino,Serie A,2020,28.0,1992.0,4.4,12,7,3,6,3,6,10,60.0,4,2,0,2,9,21,5,0,MF,25-29,Midfielder,Italy,Europe
52495,Chris Basham,ENG,Sheffield Utd,Premier League,2020,32.0,1988.0,28.6,69,42,41,23,5,41,67,61.2,26,36,15,21,49,118,105,1,"DF,MF",30-34,Defender,England,Europe
334835,Toma Bai,CRO,Bordeaux,Ligue 1,2020,23.0,1996.0,28.9,33,22,15,16,2,16,58,27.6,42,21,5,16,32,65,42,1,MF,20-24,Midfielder,Croatia,Europe
315853,Alessandro Bastoni,ITA,Inter,Serie A,2020,21.0,1999.0,32.5,36,22,13,21,2,17,27,63.0,10,34,16,18,40,76,75,0,DF,20-24,Defender,Italy,Europe
257751,Simone Bastoni,ITA,Spezia,Serie A,2020,23.0,1996.0,16.9,50,29,26,22,2,27,52,51.9,25,19,1,18,16,66,31,0,DF,20-24,Defender,Italy,Europe
34787,Julian Baumgartlinger,AUT,Leverkusen,Bundesliga,2020,32.0,1988.0,11.9,43,20,14,26,3,16,31,51.6,15,12,0,12,12,55,10,1,MF,30-34,Midfielder,Austria,Europe
324278,Christoph Baumgartner,AUT,Hoffenheim,Bundesliga,2020,20.0,1999.0,26.3,44,31,13,24,7,14,51,27.5,37,40,8,32,24,68,24,0,"MF,FW",20-24,Midfielder,Austria,Europe
43256,Paul Baysse,FRA,Bordeaux,Ligue 1,2020,32.0,1988.0,29.0,35,18,21,13,1,16,21,76.2,5,33,24,9,52,87,123,1,DF,30-34,Defender,France,Europe
188888,Sheraldo Becker,SUR,Union Berlin,Bundesliga,2020,25.0,1995.0,12.3,5,4,2,2,1,3,5,60.0,2,4,0,4,6,11,7,0,"FW,MF",25-29,Forward,Suriname,South America
282349,Timo Becker,GER,Schalke 04,Bundesliga,2020,23.0,1997.0,18.2,34,23,28,6,0,16,25,64.0,9,18,4,14,22,56,58,0,DF,20-24,Defender,Germany,Europe
288255,Donny van de Beek,NED,Manchester Utd,Premier League,2020,23.0,1997.0,5.8,15,10,2,11,2,7,15,46.7,8,10,1,9,6,21,7,0,"MF,FW",20-24,Midfielder,Netherlands,Europe
21905,Valon Behrami,SUI,Genoa,Serie A,2020,35.0,1985.0,9.9,21,9,9,10,2,9,26,34.6,17,13,5,8,9,30,13,0,MF,35-39,Midfielder,Switzerland,Europe
111039,Ishak Belfodil,ALG,Hoffenheim,Bundesliga,2020,28.0,1992.0,6.6,3,2,0,0,3,0,2,0.0,2,1,0,1,1,4,3,0,"FW,MF",25-29,Forward,Algeria,Africa
61087,Karim Bellarabi,GER,Leverkusen,Bundesliga,2020,30.0,1990.0,8.9,12,10,3,4,5,4,17,23.5,13,12,0,12,12,24,4,0,"FW,MF",30-34,Forward,Germany,Europe
450050,Jean-Ricner Bellegarde,FRA,Strasbourg,Ligue 1,2020,22.0,1998.0,23.2,56,39,22,25,9,14,23,60.9,9,20,2,18,19,75,16,0,"MF,FW",20-24,Midfielder,France,Europe
581678,Jude Bellingham,ENG,Dortmund,Bundesliga,2020,17.0,2003.0,18.9,49,31,11,29,9,19,46,41.3,27,37,5,32,24,73,13,0,MF,Under 20,Midfielder,England,Europe
18900,Hatem Ben Arfa,FRA,Bordeaux,Ligue 1,2020,33.0,1987.0,18.9,11,7,1,7,3,2,9,22.2,7,3,0,3,2,13,0,0,"MF,FW",30-34,Midfielder,France,Europe
146854,Wissam Ben Yedder,FRA,Monaco,Ligue 1,2020,29.0,1990.0,29.0,18,9,2,10,6,3,13,23.1,10,16,0,16,13,31,3,0,FW,25-29,Forward,France,Europe
121402,Ahmad Benali,LBY,Crotone,Serie A,2020,28.0,1992.0,13.5,19,11,10,9,0,11,38,28.9,27,15,2,13,6,25,15,0,MF,25-29,Midfielder,Libya,Africa
29993,Sven Bender,GER,Leverkusen,Bundesliga,2020,31.0,1989.0,13.0,17,9,8,8,1,7,20,35.0,13,20,9,11,21,38,41,1,DF,30-34,Defender,Germany,Europe
92693,Daro Benedetto,ARG,Marseille,Ligue 1,2020,30.0,1990.0,17.5,6,4,1,4,1,5,13,38.5,8,9,2,7,3,9,17,0,FW,30-34,Forward,Argentina,South America
119085,Loris Benito,SUI,Bordeaux,Ligue 1,2020,28.0,1992.0,29.5,42,26,27,12,3,22,48,45.8,26,33,10,23,42,84,70,0,DF,25-29,Defender,Switzerland,Europe
351816,Ismal Bennacer,ALG,Milan,Serie A,2020,22.0,1997.0,14.7,39,18,17,21,1,15,32,46.9,17,10,1,9,20,59,12,0,MF,20-24,Midfielder,Algeria,Africa
290532,Sad Benrahma,ALG,West Ham,Premier League,2020,24.0,1995.0,15.5,24,15,8,11,5,8,28,28.6,20,10,0,10,8,32,8,0,"FW,MF",20-24,Forward,Algeria,Africa
344599,Yassine Benrahou,FRA,Nmes,Ligue 1,2020,21.0,1999.0,13.8,16,9,8,6,2,7,25,28.0,18,9,0,9,4,20,5,1,MF,20-24,Midfielder,France,Europe
284732,Ramy Bensebaini,ALG,Gladbach,Bundesliga,2020,25.0,1995.0,20.1,43,24,27,13,3,26,42,61.9,16,39,7,32,47,90,66,0,DF,25-29,Defender,Algeria,Africa
50201,Christian Benteke,BEL,Crystal Palace,Premier League,2020,29.0,1990.0,20.2,15,7,1,7,7,2,9,22.2,7,17,6,11,4,19,39,0,FW,25-29,Forward,Belgium,Europe
18922,Karim Benzema,FRA,Real Madrid,La Liga,2020,32.0,1987.0,32.2,8,6,4,2,2,5,15,33.3,10,9,2,7,8,16,24,0,FW,30-34,Forward,France,Europe
177843,Domenico Berardi,ITA,Sassuolo,Serie A,2020,25.0,1994.0,27.5,42,22,17,11,14,21,62,33.9,41,23,1,22,26,68,34,0,FW,25-29,Forward,Italy,Europe
197300,Federico Bernardeschi,ITA,Juventus,Serie A,2020,26.0,1994.0,10.8,9,4,3,5,1,4,20,20.0,16,6,2,4,14,23,7,1,"MF,DF",25-29,Midfielder,Italy,Europe
40611,Ryan Bertrand,ENG,Southampton,Premier League,2020,30.0,1989.0,28.9,60,32,26,27,7,30,48,62.5,18,19,1,18,30,90,41,1,DF,30-34,Defender,England,Europe
140757,Daniel Bessa,ITA,Hellas Verona,Serie A,2020,27.0,1993.0,6.8,15,8,3,11,1,6,14,42.9,8,5,1,4,2,17,0,0,MF,25-29,Midfielder,Italy,Europe
649016,El Bilal Tour,MLI,Reims,Ligue 1,2020,18.0,2001.0,13.8,22,12,3,16,3,8,18,44.4,10,8,3,5,6,28,10,1,FW,Under 20,Forward,Mali,Africa
124555,Cristiano Biraghi,ITA,Fiorentina,Serie A,2020,27.0,1992.0,31.1,42,23,19,15,8,27,45,60.0,18,23,9,14,27,69,56,3,DF,25-29,Defender,Italy,Europe
410425,Yves Bissouma,MLI,Brighton,Premier League,2020,23.0,1996.0,34.6,104,68,50,48,6,33,67,49.3,34,42,6,36,64,168,67,0,MF,20-24,Midfielder,Mali,Africa
93844,Leonardo Bittencourt,GER,Werder Bremen,Bundesliga,2020,26.0,1993.0,16.8,58,32,24,28,6,16,51,31.4,35,29,2,27,13,71,10,0,"MF,FW",25-29,Midfielder,Germany,Europe
288225,Ludovic Blas,FRA,Nantes,Ligue 1,2020,22.0,1997.0,31.0,58,30,18,37,3,23,54,42.6,31,33,4,29,21,79,19,0,"MF,FW",20-24,Midfielder,France,Europe
26485,Jrme Boateng,GER,Bayern Munich,Bundesliga,2020,31.0,1988.0,26.3,26,16,17,8,1,14,32,43.8,18,24,17,7,40,66,63,1,DF,30-34,Defender,Germany,Europe
344575,Antonin Bobichon,FRA,Angers,Ligue 1,2020,24.0,1995.0,10.1,23,14,10,8,5,9,15,60.0,6,4,1,3,2,25,1,0,"MF,FW",20-24,Midfielder,France,Europe
182574,Jean-Paul Botius,NED,Mainz 05,Bundesliga,2020,26.0,1994.0,22.9,42,28,13,15,14,17,47,36.2,30,37,3,34,33,75,14,0,"MF,FW",25-29,Midfielder,Netherlands,Europe
465717,Jayden Bogle,ENG,Sheffield Utd,Premier League,2020,20.0,2000.0,12.3,33,23,21,10,2,20,39,51.3,19,14,4,10,14,47,22,0,"DF,MF",20-24,Defender,England,Europe
412671,Quentin Boisgard,FRA,Lorient,Ligue 1,2020,23.0,1997.0,14.6,24,17,3,15,6,11,24,45.8,13,17,2,15,15,39,1,0,"MF,FW",20-24,Midfielder,France,Europe
142310,Willy Boly,CIV,Wolves,Premier League,2020,29.0,1991.0,20.9,33,20,26,7,0,13,24,54.2,11,18,12,6,32,65,84,1,DF,25-29,Defender,Ivory Coast,Africa
57280,Giacomo Bonaventura,ITA,Fiorentina,Serie A,2020,30.0,1989.0,25.1,34,19,16,13,5,16,53,30.2,37,26,2,24,39,73,12,0,MF,30-34,Midfielder,Italy,Europe
338629,Sebastiaan Bornauw,BEL,Kln,Bundesliga,2020,21.0,1999.0,23.1,29,20,25,4,0,14,25,56.0,11,33,26,7,40,69,104,0,DF,20-24,Defender,Belgium,Europe
361093,Sven Botman,NED,Lille,Ligue 1,2020,20.0,2000.0,36.8,31,21,18,12,1,14,26,53.8,12,31,21,10,57,88,126,2,DF,20-24,Defender,Netherlands,Europe
236045,Denis Bouanga,GAB,Saint-tienne,Ligue 1,2020,25.0,1994.0,30.2,52,28,22,24,6,16,58,27.6,42,32,3,29,20,72,36,0,"MF,FW",25-29,Midfielder,Gabon,Africa
560593,Hicham Boudaoui,ALG,Nice,Ligue 1,2020,20.0,1999.0,19.3,52,35,20,24,8,26,68,38.2,42,14,4,10,23,75,26,1,MF,20-24,Midfielder,Algeria,Africa
77826,Ryad Boudebouz,ALG,Saint-tienne,Ligue 1,2020,30.0,1990.0,7.2,9,4,1,7,1,4,8,50.0,4,3,0,3,5,14,5,0,"MF,FW",30-34,Midfielder,Algeria,Africa
346332,Nassim Boujellab,MAR,Schalke 04,Bundesliga,2020,21.0,1999.0,6.7,13,9,2,10,1,2,12,16.7,10,10,3,7,7,20,9,0,"MF,FW",20-24,Midfielder,Morocco,Africa
202318,Farid Boulaya,ALG,Metz,Ligue 1,2020,27.0,1993.0,31.3,24,16,4,17,3,13,51,25.5,38,19,3,16,12,36,7,0,"MF,FW",25-29,Midfielder,Algeria,Africa
266359,Benjamin Bourigeaud,FRA,Rennes,Ligue 1,2020,26.0,1994.0,28.4,40,23,17,16,7,21,71,29.6,50,37,1,36,19,59,25,0,"MF,FW",25-29,Midfielder,France,Europe
314875,Jarrod Bowen,ENG,West Ham,Premier League,2020,23.0,1996.0,28.5,26,15,12,7,7,10,29,34.5,19,19,1,18,22,48,10,0,"FW,MF",20-24,Forward,England,Europe
85585,John Boye,GHA,Metz,Ligue 1,2020,33.0,1987.0,33.8,58,34,43,13,2,31,54,57.4,23,36,20,16,80,138,146,1,DF,30-34,Defender,Ghana,Africa
334222,Lucas Boy,ARG,Elche,La Liga,2020,24.0,1996.0,29.9,47,31,13,27,7,10,49,20.4,39,37,2,35,19,66,21,0,FW,20-24,Forward,Argentina,South America
357796,Domagoj Bradari,CRO,Lille,Ligue 1,2020,20.0,1999.0,14.0,28,18,11,13,4,12,27,44.4,15,14,4,10,26,54,21,0,DF,20-24,Defender,Croatia,Europe
187492,Julian Brandt,GER,Dortmund,Bundesliga,2020,24.0,1996.0,16.6,27,14,13,9,5,12,43,27.9,31,25,1,24,17,44,7,1,"FW,MF",20-24,Forward,Germany,Europe
485960,Lilian Brassier,FRA,Brest,Ligue 1,2020,20.0,1999.0,10.7,19,10,12,4,3,7,11,63.6,4,13,6,7,23,42,38,1,DF,20-24,Defender,France,Europe
190338,Anthony Brianon,FRA,Nmes,Ligue 1,2020,25.0,1994.0,13.6,12,7,9,3,0,9,19,47.4,10,19,12,7,33,45,57,2,DF,25-29,Defender,France,Europe
18909,Jimmy Briand,FRA,Bordeaux,Ligue 1,2020,34.0,1985.0,6.3,7,3,3,2,2,1,1,100.0,0,2,0,2,1,8,3,0,FW,30-34,Forward,France,Europe
450417,Dylan Bronn,TUN,Metz,Ligue 1,2020,25.0,1995.0,37.9,57,37,38,19,0,24,44,54.5,20,31,14,17,44,101,112,0,DF,25-29,Defender,Tunisia,Africa
124732,John Brooks,USA,Wolfsburg,Bundesliga,2020,27.0,1993.0,30.8,47,29,33,14,0,30,54,55.6,24,35,10,25,55,102,134,0,DF,25-29,Defender,United States,North America
43984,Daniel Brosinski,GER,Mainz 05,Bundesliga,2020,32.0,1988.0,15.9,19,14,10,7,2,12,31,38.7,19,18,1,17,14,33,33,0,"DF,FW",30-34,Defender,Germany,Europe
293569,Josh Brownhill,ENG,Burnley,Premier League,2020,24.0,1995.0,31.3,45,27,9,29,7,15,44,34.1,29,33,11,22,69,114,39,0,MF,20-24,Midfielder,England,Europe
131109,Gastn Brugman,URU,Parma,Serie A,2020,27.0,1992.0,18.0,35,19,18,15,2,11,44,25.0,33,33,4,29,45,80,34,0,MF,25-29,Midfielder,Uruguay,South America
466268,Juan Brunetta,ARG,Parma,Serie A,2020,23.0,1997.0,5.3,2,2,0,2,0,1,6,16.7,5,5,0,5,1,3,2,0,"FW,MF",20-24,Forward,Argentina,South America
147038,Cdric Brunner,SUI,Arminia,Bundesliga,2020,26.0,1994.0,29.5,42,22,24,15,3,27,40,67.5,13,30,10,20,42,84,96,0,DF,25-29,Defender,Switzerland,Europe
194460,Joe Bryan,ENG,Fulham,Premier League,2020,26.0,1993.0,7.4,15,8,7,5,3,7,12,58.3,5,8,2,6,14,29,16,0,"DF,MF",25-29,Defender,England,Europe
214928,Kean Bryan,ENG,Sheffield Utd,Premier League,2020,23.0,1996.0,11.2,20,10,9,11,0,9,19,47.4,10,16,10,6,13,33,39,1,DF,20-24,Defender,England,Europe
46413,Ante Budimir,CRO,Osasuna,La Liga,2020,29.0,1991.0,18.1,20,12,2,11,7,4,15,26.7,11,17,4,13,2,22,17,1,FW,25-29,Forward,Croatia,Europe
337922,Esteban Burgos,ARG,Eibar,La Liga,2020,28.0,1992.0,12.3,7,6,4,3,0,1,5,20.0,4,8,7,1,23,30,54,2,DF,25-29,Defender,Argentina,South America
333647,Jonathan Burkardt,GER,Mainz 05,Bundesliga,2020,20.0,2000.0,15.3,27,13,15,10,2,11,19,57.9,8,20,3,17,8,35,15,0,"FW,MF",20-24,Forward,Germany,Europe
341317,Oliver Burke,SCO,Sheffield Utd,Premier League,2020,23.0,1997.0,14.1,16,8,6,9,1,5,24,20.8,19,24,0,24,2,18,6,0,FW,20-24,Forward,Scotland,Europe
134270,Dan Burn,ENG,Brighton,Premier League,2020,28.0,1992.0,22.9,50,26,33,14,3,27,53,50.9,26,30,7,23,31,81,75,0,DF,25-29,Defender,England,Europe
206912,Jimmy Cabot,FRA,Angers,Ligue 1,2020,26.0,1994.0,10.5,26,13,8,14,4,11,36,30.6,25,8,0,8,12,38,6,0,"FW,MF",25-29,Forward,France,Europe
27511,Gary Cahill,ENG,Crystal Palace,Premier League,2020,34.0,1985.0,20.0,13,9,10,3,0,7,11,63.6,4,27,22,5,13,26,88,0,DF,30-34,Defender,England,Europe
44686,Yannick Cahuzac,FRA,Lens,Ligue 1,2020,35.0,1985.0,25.0,26,12,12,10,4,9,27,33.3,18,18,5,13,33,59,72,0,MF,35-39,Midfielder,France,Europe
37834,Felipe Caicedo,ECU,Lazio,Serie A,2020,31.0,1988.0,10.3,10,7,4,4,2,1,8,12.5,7,7,0,7,4,14,2,0,FW,30-34,Forward,Ecuador,South America
123275,Tom Cairney,SCO,Fulham,Premier League,2020,29.0,1991.0,8.4,9,3,1,4,4,1,4,25.0,3,6,0,6,0,9,3,0,MF,25-29,Midfielder,Scotland,Europe
262523,Davide Calabria,ITA,Milan,Serie A,2020,23.0,1996.0,29.4,101,64,61,32,8,54,90,60.0,36,42,9,33,37,138,82,1,DF,20-24,Defender,Italy,Europe
126414,Hakan alhanolu,TUR,Milan,Serie A,2020,26.0,1994.0,29.0,26,7,3,17,6,7,28,25.0,21,21,6,15,15,41,24,1,"MF,FW",25-29,Midfielder,Turkey,Asia
553905,Kerim Calhanoglu,GER,Schalke 04,Bundesliga,2020,17.0,2002.0,3.3,3,3,1,1,1,0,3,0.0,3,4,0,4,7,10,6,0,DF,Under 20,Defender,Germany,Europe
38410,Daniel Caligiuri,ITA,Augsburg,Bundesliga,2020,32.0,1988.0,29.6,71,46,29,31,11,29,92,31.5,63,45,6,39,38,109,41,0,"MF,FW",30-34,Midfielder,Italy,Europe
284727,Jonathan Calleri,ARG,Osasuna,La Liga,2020,26.0,1993.0,17.2,15,6,2,4,9,3,17,17.6,14,18,2,16,1,16,10,1,FW,25-29,Forward,Argentina,South America
306024,Dominic Calvert-Lewin,ENG,Everton,Premier League,2020,23.0,1997.0,31.9,17,8,1,8,8,6,12,50.0,6,22,6,16,6,23,33,0,FW,20-24,Forward,England,Europe
640428,Eduardo Camavinga,FRA,Rennes,Ligue 1,2020,17.0,2002.0,26.7,98,58,39,48,11,38,77,49.4,39,36,2,34,23,121,15,1,MF,Under 20,Midfielder,France,Europe
119296,Emre Can,GER,Dortmund,Bundesliga,2020,26.0,1994.0,23.7,43,34,20,20,3,20,37,54.1,17,35,10,25,48,91,52,0,"DF,MF",25-29,Defender,Germany,Europe
182712,Joo Cancelo,POR,Manchester City,Premier League,2020,26.0,1994.0,25.5,68,41,42,19,7,43,83,51.8,40,23,2,21,41,109,33,2,"DF,MF",25-29,Defender,Portugal,Europe
25488,Antonio Candreva,ITA,Sampdoria,Serie A,2020,33.0,1987.0,27.8,28,19,17,9,2,21,53,39.6,32,24,3,21,9,37,27,1,MF,30-34,Midfielder,Italy,Europe
214532,Pierrick Capelle,FRA,Angers,Ligue 1,2020,33.0,1987.0,22.8,53,28,24,17,12,31,79,39.2,48,25,1,24,47,100,32,0,"MF,DF",30-34,Midfielder,France,Europe
63494,tienne Capoue,FRA,Villarreal,La Liga,2020,32.0,1988.0,13.2,20,10,14,6,0,8,18,44.4,10,7,1,6,20,40,23,0,MF,30-34,Midfielder,France,Europe
146752,Gianluca Caprari,ITA,Benevento,Serie A,2020,27.0,1993.0,20.7,16,11,5,5,6,6,31,19.4,25,19,1,18,18,34,8,0,"MF,FW",25-29,Midfielder,Italy,Europe
84765,Francesco Caputo,ITA,Sassuolo,Serie A,2020,32.0,1987.0,18.9,0,0,0,0,0,0,2,0.0,2,4,0,4,1,1,3,0,FW,30-34,Forward,Italy,Europe
342226,Irvin Cardona,FRA,Brest,Ligue 1,2020,22.0,1997.0,22.5,10,5,3,6,1,4,22,18.2,18,17,3,14,9,19,23,2,FW,20-24,Forward,France,Europe
140776,Yannick Carrasco,BEL,Atltico Madrid,La Liga,2020,26.0,1993.0,24.2,27,15,14,6,7,15,34,44.1,19,24,0,24,17,44,16,1,"DF,MF",25-29,Defender,Belgium,Europe
184672,Guido Carrillo,ARG,Elche,La Liga,2020,29.0,1991.0,11.1,9,8,1,7,1,2,8,25.0,6,2,1,1,4,13,14,0,FW,25-29,Forward,Argentina,South America
48066,Andy Carroll,ENG,Newcastle Utd,Premier League,2020,31.0,1989.0,4.4,3,1,1,1,1,1,8,12.5,7,1,0,1,0,3,14,0,FW,30-34,Forward,England,Europe
100131,William Carvalho,POR,Betis,La Liga,2020,28.0,1992.0,13.6,19,12,7,11,1,5,21,23.8,16,11,3,8,11,30,14,1,MF,25-29,Midfielder,Portugal,Europe
16306,Casemiro,BRA,Real Madrid,La Liga,2020,28.0,1992.0,32.2,84,49,50,30,4,33,73,45.2,40,50,17,33,70,154,62,0,MF,25-29,Midfielder,Brazil,South America
301236,Francesco Cassata,ITA,Genoa,Serie A,2020,23.0,1997.0,2.5,7,6,7,0,0,4,7,57.1,3,0,0,0,3,10,1,0,"DF,FW",20-24,Defender,Italy,Europe
262226,Timothy Castagne,BEL,Leicester City,Premier League,2020,24.0,1995.0,26.1,52,32,29,18,5,24,44,54.5,20,29,5,24,29,81,62,1,DF,20-24,Defender,Belgium,Europe
182875,Jean-Charles Castelletto,CMR,Nantes,Ligue 1,2020,25.0,1995.0,21.6,32,18,20,11,1,18,31,58.1,13,25,19,6,42,74,79,0,DF,25-29,Defender,Cameroon,Africa
28947,Gonzalo Castro,GER,Stuttgart,Bundesliga,2020,33.0,1987.0,19.2,21,7,6,9,6,8,23,34.8,15,16,3,13,8,29,12,0,MF,30-34,Midfielder,Germany,Europe
303116,Gaetano Castrovilli,ITA,Fiorentina,Serie A,2020,23.0,1997.0,25.9,33,19,15,11,7,11,42,26.2,31,25,2,23,34,67,14,0,MF,20-24,Midfielder,Italy,Europe
199733,Danilo Cataldi,ITA,Lazio,Serie A,2020,25.0,1994.0,6.3,7,2,1,5,1,4,18,22.2,14,3,1,2,9,16,7,0,MF,25-29,Midfielder,Italy,Europe
149716,Ivan Cavaleiro,POR,Fulham,Premier League,2020,26.0,1993.0,27.5,23,14,9,11,3,12,34,35.3,22,25,1,24,19,42,14,0,FW,25-29,Forward,Portugal,Europe
48280,Edinson Cavani,URU,Manchester Utd,Premier League,2020,33.0,1987.0,15.3,12,8,1,8,3,2,13,15.4,11,2,0,2,6,18,11,0,FW,30-34,Forward,Uruguay,South America
251075,Zeki elik,TUR,Lille,Ligue 1,2020,23.0,1997.0,26.5,72,33,30,30,12,44,81,54.3,37,32,6,26,38,110,52,0,DF,20-24,Defender,Turkey,Asia
384859,Fabien Centonze,FRA,Metz,Ligue 1,2020,24.0,1996.0,35.8,104,68,64,30,10,43,73,58.9,30,62,17,45,112,216,119,1,DF,20-24,Defender,France,Europe
102745,Luca Ceppitelli,ITA,Cagliari,Serie A,2020,30.0,1989.0,16.3,25,19,13,10,2,14,26,53.8,12,23,12,11,25,50,58,1,DF,30-34,Defender,Italy,Europe
197751,Alberto Cerri,ITA,Cagliari,Serie A,2020,24.0,1996.0,4.1,3,2,0,2,1,0,5,0.0,5,4,2,2,2,5,6,0,FW,20-24,Forward,Italy,Europe
216499,Fouad Chafik,MAR,Dijon,Ligue 1,2020,33.0,1986.0,18.0,39,24,29,8,2,16,35,45.7,19,19,10,9,21,60,41,0,DF,30-34,Defender,Morocco,Africa
346314,Trevoh Chalobah,ENG,Lorient,Ligue 1,2020,21.0,1999.0,24.9,45,26,32,13,0,24,50,48.0,26,20,7,13,69,114,56,0,"DF,MF",20-24,Defender,England,Europe
49723,Timothy Chandler,USA,Eint Frankfurt,Bundesliga,2020,30.0,1990.0,4.8,4,0,2,1,1,1,4,25.0,3,5,2,3,3,7,5,0,DF,30-34,Defender,United States,North America
93678,Gatan Charbonnier,FRA,Brest,Ligue 1,2020,31.0,1988.0,17.4,24,15,6,11,7,12,32,37.5,20,15,1,14,9,33,19,0,"MF,FW",30-34,Midfielder,France,Europe
250779,Brendan Chardonnet,FRA,Brest,Ligue 1,2020,25.0,1994.0,30.2,51,29,31,19,1,27,41,65.9,14,54,41,13,64,115,151,0,DF,25-29,Defender,France,Europe
118278,Xavier Chavalerin,FRA,Reims,Ligue 1,2020,29.0,1991.0,28.3,92,50,47,38,7,26,74,35.1,48,43,9,34,43,135,29,1,MF,25-29,Midfielder,France,Europe
98322,Denis Cheryshev,RUS,Valencia,La Liga,2020,29.0,1990.0,12.2,19,15,6,7,6,6,26,23.1,20,15,1,14,12,31,15,0,MF,25-29,Midfielder,Russia,Europe
341092,Federico Chiesa,ITA,Fiorentina,Serie A,2020,22.0,1997.0,2.7,6,2,2,2,2,3,8,37.5,5,3,1,2,1,7,3,0,DF,20-24,Defender,Italy,Europe
316125,Ben Chilwell,ENG,Chelsea,Premier League,2020,23.0,1996.0,25.4,42,22,16,22,4,15,33,45.5,18,28,3,25,24,66,58,0,DF,20-24,Defender,England,Europe
344830,Tahith Chong,NED,Werder Bremen,Bundesliga,2020,20.0,1999.0,4.3,11,6,1,9,1,4,8,50.0,4,4,0,4,5,16,1,0,"MF,FW",20-24,Midfielder,Netherlands,Europe
624037,Joris Chotard,FRA,Montpellier,Ligue 1,2020,18.0,2001.0,12.9,12,8,5,6,1,6,31,19.4,25,12,3,9,11,23,15,0,MF,Under 20,Midfielder,France,Europe
341501,Hamza Choudhury,ENG,Leicester City,Premier League,2020,22.0,1997.0,3.5,8,7,3,5,0,4,10,40.0,6,4,1,3,4,12,9,1,MF,20-24,Midfielder,England,Europe
401922,Samuel Chukwueze,NGA,Villarreal,La Liga,2020,21.0,1999.0,15.2,12,7,4,4,4,3,17,17.6,14,8,0,8,10,22,3,0,"MF,FW",20-24,Midfielder,Nigeria,Africa
33218,Luca Cigarini,ITA,Crotone,Serie A,2020,34.0,1986.0,10.3,26,14,11,12,3,12,28,42.9,16,10,1,9,12,38,9,0,MF,30-34,Midfielder,Italy,Europe
98240,Ciaran Clark,IRL,Newcastle Utd,Premier League,2020,30.0,1989.0,21.0,24,14,15,6,3,6,13,46.2,7,27,20,7,29,53,104,1,DF,30-34,Defender,Republic of Ireland,Europe
384593,Alexis Claude-Maurice,FRA,Nice,Ligue 1,2020,22.0,1998.0,21.2,40,19,17,14,9,14,48,29.2,34,16,2,14,14,54,3,0,"MF,FW",20-24,Midfielder,France,Europe
175639,Jonathan Clauss,FRA,Lens,Ligue 1,2020,27.0,1992.0,28.0,43,20,12,20,11,17,38,44.7,21,24,1,23,45,88,46,0,DF,25-29,Defender,France,Europe
85177,Nathaniel Clyne,ENG,Crystal Palace,Premier League,2020,29.0,1991.0,12.7,17,10,8,8,1,9,16,56.3,7,7,2,5,18,35,25,1,DF,25-29,Defender,England,Europe
128901,Conor Coady,ENG,Wolves,Premier League,2020,27.0,1993.0,36.7,35,23,25,10,0,19,35,54.3,16,40,32,8,27,62,134,2,DF,25-29,Defender,England,Europe
68390,Samus Coleman,IRL,Everton,Premier League,2020,31.0,1988.0,17.9,39,26,21,14,4,21,30,70.0,9,22,6,16,13,52,37,2,"DF,MF",30-34,Defender,Republic of Ireland,Europe
243714,Kingsley Coman,FRA,Bayern Munich,Bundesliga,2020,24.0,1996.0,19.5,14,8,6,7,1,2,21,9.5,19,22,0,22,4,18,3,0,"FW,MF",20-24,Forward,France,Europe
22386,Daniel Congr,FRA,Montpellier,Ligue 1,2020,35.0,1985.0,36.6,59,35,45,12,2,36,70,51.4,34,50,33,17,69,128,144,3,DF,35-39,Defender,France,Europe
75067,Liam Cooper,SCO,Leeds United,Premier League,2020,28.0,1991.0,24.3,68,45,39,27,2,37,59,62.7,22,39,32,7,61,129,70,1,DF,25-29,Defender,Scotland,Europe
102744,Sbastien Corchia,FRA,Nantes,Ligue 1,2020,29.0,1990.0,23.0,55,30,29,17,9,33,60,55.0,27,28,10,18,38,93,40,1,DF,25-29,Defender,France,Europe
266807,ngel Correa,ARG,Atltico Madrid,La Liga,2020,25.0,1995.0,26.6,38,21,10,23,5,15,45,33.3,30,18,1,17,22,60,16,0,"FW,MF",25-29,Forward,Argentina,South America
227081,Joaqun Correa,ARG,Lazio,Serie A,2020,25.0,1994.0,21.5,21,12,6,11,4,7,25,28.0,18,14,0,14,7,28,12,0,FW,25-29,Forward,Argentina,South America
367466,Thierry Correia,POR,Valencia,La Liga,2020,21.0,1999.0,23.7,47,27,32,10,5,21,43,48.8,22,24,6,18,42,89,63,1,DF,20-24,Defender,Portugal,Europe
173900,Hlder Costa,ANG,Leeds United,Premier League,2020,26.0,1994.0,12.8,25,11,12,5,8,11,32,34.4,21,11,0,11,3,28,5,1,"MF,FW",25-29,Midfielder,Angola,Africa
184935,Kalifa Coulibaly,MLI,Nantes,Ligue 1,2020,28.0,1991.0,10.9,3,1,0,1,2,2,8,25.0,6,3,1,2,2,5,12,0,FW,25-29,Forward,Mali,Africa
386552,Lassana Coulibaly,MLI,Angers,Ligue 1,2020,24.0,1996.0,18.7,78,41,33,34,11,39,75,52.0,36,29,4,25,33,111,17,0,MF,20-24,Midfielder,Mali,Africa
596240,Senou Coulibaly,MLI,Dijon,Ligue 1,2020,25.0,1994.0,21.5,33,21,23,10,0,12,24,50.0,12,18,12,6,30,63,89,0,DF,25-29,Defender,Mali,Africa
618425,Tanguy Coulibaly,FRA,Stuttgart,Bundesliga,2020,19.0,2001.0,16.7,26,15,10,7,9,11,23,47.8,12,20,0,20,10,36,11,0,"DF,FW",Under 20,Defender,France,Europe
80444,Philippe Coutinho,BRA,Barcelona,La Liga,2020,28.0,1992.0,7.3,8,6,2,5,1,3,9,33.3,6,7,0,7,2,10,1,0,"MF,FW",25-29,Midfielder,Brazil,South America
44136,Domenico Criscito,ITA,Genoa,Serie A,2020,33.0,1986.0,19.2,43,22,29,11,3,22,39,56.4,17,27,14,13,44,87,51,0,DF,30-34,Defender,Italy,Europe
199248,Bryan Cristante,ITA,Roma,Serie A,2020,25.0,1995.0,23.9,27,20,10,14,3,10,28,35.7,18,21,7,14,40,67,61,1,"DF,MF",25-29,Defender,Italy,Europe
91970,Juan Cuadrado,COL,Juventus,Serie A,2020,32.0,1988.0,24.2,43,25,22,15,6,29,60,48.3,31,16,2,14,43,86,22,2,"DF,MF",30-34,Defender,Colombia,South America
323872,Andrs Cubas,PAR,Nmes,Ligue 1,2020,24.0,1996.0,24.9,80,47,30,44,6,33,74,44.6,41,37,10,27,50,130,29,3,MF,20-24,Midfielder,Paraguay,South America
182889,Wylan Cyprien,FRA,Parma,Serie A,2020,25.0,1995.0,4.6,9,4,5,3,1,2,4,50.0,2,13,8,5,5,14,6,1,MF,25-29,Midfielder,France,Europe
84150,Rafael Czichos,GER,Kln,Bundesliga,2020,30.0,1990.0,25.1,48,24,33,13,2,23,42,54.8,19,25,9,16,53,101,109,0,DF,30-34,Defender,Germany,Europe
55769,Danilo D'Ambrosio,ITA,Inter,Serie A,2020,31.0,1988.0,7.8,15,9,6,7,2,6,15,40.0,9,9,7,2,4,19,15,0,DF,30-34,Defender,Italy,Europe
57370,Damien Da Silva,FRA,Rennes,Ligue 1,2020,32.0,1988.0,29.6,22,13,13,8,1,12,18,66.7,6,17,13,4,44,66,99,1,DF,30-34,Defender,France,Europe
357147,Diogo Dalot,POR,Milan,Serie A,2020,21.0,1999.0,12.1,32,17,23,6,3,17,34,50.0,17,18,5,13,25,57,42,0,DF,20-24,Defender,Portugal,Europe
322655,Flavius Daniliuc,AUT,Nice,Ligue 1,2020,19.0,2001.0,16.4,23,15,15,5,3,10,21,47.6,11,17,6,11,14,37,32,0,DF,Under 20,Defender,Austria,Europe
808509,Danilo,BRA,Juventus,Serie A,2020,29.0,1991.0,32.4,62,31,37,16,9,35,66,53.0,31,32,12,20,66,128,68,2,"DF,MF",25-29,Defender,Brazil,South America
62688,Scott Dann,ENG,Crystal Palace,Premier League,2020,33.0,1987.0,15.0,6,4,5,1,0,4,11,36.4,7,16,14,2,18,24,59,1,DF,30-34,Defender,England,Europe
16136,Dante,BRA,Nice,Ligue 1,2020,36.0,1983.0,8.6,10,5,6,4,0,3,7,42.9,4,6,4,2,10,20,20,0,DF,35-39,Defender,Brazil,South America
533738,Jonathan David,CAN,Lille,Ligue 1,2020,20.0,2000.0,26.2,17,10,5,5,7,9,24,37.5,15,19,1,18,3,20,9,0,FW,20-24,Forward,Canada,North America
424204,Alphonso Davies,CAN,Bayern Munich,Bundesliga,2020,19.0,2000.0,19.6,39,27,16,17,6,28,40,70.0,12,21,1,20,28,67,33,1,DF,Under 20,Defender,Canada,North America
412660,Keinan Davis,ENG,Aston Villa,Premier League,2020,22.0,1998.0,3.1,2,1,1,0,1,0,1,0.0,1,1,0,1,0,2,2,0,"FW,MF",20-24,Forward,England,Europe
88755,Kevin De Bruyne,BEL,Manchester City,Premier League,2020,29.0,1991.0,22.2,34,21,6,18,10,13,48,27.1,35,26,1,25,9,43,10,0,MF,25-29,Midfielder,Belgium,Europe
33571,Lorenzo De Silvestri,ITA,Bologna,Serie A,2020,32.0,1988.0,23.8,34,24,18,13,3,16,37,43.2,21,37,10,27,30,64,62,3,DF,30-34,Defender,Italy,Europe
57372,Lucas Deaux,FRA,Nmes,Ligue 1,2020,31.0,1988.0,19.5,47,32,20,22,5,16,49,32.7,33,20,3,17,20,67,30,4,"MF,DF",30-34,Midfielder,France,Europe
235931,Alessandro Deiola,ITA,Spezia,Serie A,2020,24.0,1995.0,4.0,6,3,2,3,1,5,13,38.5,8,3,1,2,3,9,1,0,MF,20-24,Midfielder,Italy,Europe
353399,Romain Del Castillo,FRA,Rennes,Ligue 1,2020,24.0,1996.0,7.2,30,11,5,14,11,5,25,20.0,20,6,0,6,3,33,4,1,"MF,FW",20-24,Midfielder,France,Europe
170961,Thomas Delaine,FRA,Metz,Ligue 1,2020,28.0,1992.0,19.8,32,18,19,11,2,20,35,57.1,15,22,5,17,24,56,30,1,"DF,FW",25-29,Defender,France,Europe
122797,Andy Delort,ALG,Montpellier,Ligue 1,2020,28.0,1991.0,27.6,12,7,1,9,2,8,18,44.4,10,11,1,10,4,16,34,0,FW,25-29,Forward,Algeria,Africa
288230,Ousmane Dembl,FRA,Barcelona,La Liga,2020,23.0,1997.0,19.7,14,9,4,9,1,6,17,35.3,11,10,0,10,9,23,3,1,FW,20-24,Forward,France,Europe
82070,Diego Demme,GER,Napoli,Serie A,2020,28.0,1991.0,17.7,56,32,26,22,8,23,63,36.5,40,14,1,13,11,67,15,1,MF,25-29,Midfielder,Germany,Europe
277114,Jason Denayer,BEL,Lyon,Ligue 1,2020,25.0,1995.0,29.0,25,16,16,9,0,6,13,46.2,7,36,25,11,27,52,91,1,DF,25-29,Defender,Belgium,Europe
243541,Deyverson,BRA,Alavs,La Liga,2020,29.0,1991.0,9.7,6,4,3,1,2,2,13,15.4,11,9,0,9,9,15,13,0,FW,25-29,Forward,Brazil,South America
45389,Samuel Di Carmine,ITA,Hellas Verona,Serie A,2020,31.0,1988.0,5.6,1,2,0,1,0,0,3,0.0,3,1,0,1,0,1,5,0,FW,30-34,Forward,Italy,Europe
169880,Giovanni Di Lorenzo,ITA,Napoli,Serie A,2020,26.0,1993.0,36.0,79,50,54,21,4,43,75,57.3,32,37,13,24,35,114,64,1,DF,25-29,Defender,Italy,Europe
532040,Giuseppe Di Serio,ITA,Benevento,Serie A,2020,19.0,2001.0,3.2,2,2,1,1,0,0,4,0.0,4,5,0,5,0,2,4,0,"FW,MF",Under 20,Forward,Italy,Europe
626913,Boulaye Dia,SEN,Reims,Ligue 1,2020,23.0,1996.0,32.6,23,12,3,11,9,4,22,18.2,18,19,5,14,12,35,37,1,"FW,MF",20-24,Forward,Senegal,Africa
395516,Moussa Diaby,FRA,Leverkusen,Bundesliga,2020,21.0,1999.0,26.5,10,6,4,5,1,6,20,30.0,14,11,0,11,12,22,5,0,"FW,MF",20-24,Forward,France,Europe
346289,Mouctar Diakhaby,GUI,Valencia,La Liga,2020,23.0,1996.0,23.1,16,8,10,6,0,8,12,66.7,4,28,21,7,27,43,102,1,DF,20-24,Defender,Guinea,Africa
342048,Grady Diangana,COD,West Brom,Premier League,2020,22.0,1998.0,13.7,35,19,19,9,7,19,43,44.2,24,16,2,14,16,51,9,0,"MF,FW",20-24,Midfielder,DR Congo,Africa
428954,Stphane Diarra,FRA,Lorient,Ligue 1,2020,21.0,1998.0,2.2,0,0,0,0,0,0,7,0.0,7,6,1,5,4,4,1,0,"MF,FW",20-24,Midfielder,France,Europe
258004,Rben Dias,POR,Manchester City,Premier League,2020,23.0,1997.0,31.6,24,13,13,8,3,4,16,25.0,12,31,23,8,35,59,92,0,DF,20-24,Defender,Portugal,Europe
490426,Krpin Diatta,SEN,Monaco,Ligue 1,2020,21.0,1999.0,4.3,4,3,1,1,2,1,3,33.3,2,5,1,4,4,8,1,0,"MF,DF",20-24,Midfielder,Senegal,Africa
314678,Brahim Daz,MAR,Milan,Serie A,2020,20.0,1999.0,13.6,18,10,7,7,4,10,23,43.5,13,10,0,10,2,20,2,0,"MF,FW",20-24,Midfielder,Morocco,Africa
57995,Daniel Didavi,GER,Stuttgart,Bundesliga,2020,30.0,1990.0,10.8,16,6,2,9,5,7,12,58.3,5,10,0,10,3,19,8,0,"MF,FW",30-34,Midfielder,Germany,Europe
175722,Eric Dier,ENG,Tottenham,Premier League,2020,26.0,1994.0,28.0,23,14,13,10,0,11,18,61.1,7,37,31,6,23,46,123,3,DF,25-29,Defender,England,Europe
198116,Federico Dimarco,ITA,Hellas Verona,Serie A,2020,22.0,1997.0,29.0,32,19,23,7,2,13,28,46.4,15,18,9,9,47,79,50,1,DF,20-24,Defender,Italy,Europe
536482,Junior Dina Ebimbe,FRA,Dijon,Ligue 1,2020,19.0,2000.0,23.8,38,25,14,19,5,15,45,33.3,30,17,1,16,14,52,9,0,"FW,MF",Under 20,Forward,France,Europe
272622,Issa Diop,FRA,West Ham,Premier League,2020,23.0,1997.0,15.3,20,14,12,8,0,7,18,38.9,11,32,22,10,22,42,59,0,DF,20-24,Defender,France,Europe
569389,Sofiane Diop,FRA,Monaco,Ligue 1,2020,20.0,2000.0,22.5,49,34,17,25,7,18,53,34.0,35,25,1,24,31,80,15,0,"MF,FW",20-24,Midfielder,France,Europe
386047,Axel Disasi,FRA,Monaco,Ligue 1,2020,22.0,1998.0,22.3,29,20,17,12,0,20,35,57.1,15,18,11,7,26,55,66,1,DF,20-24,Defender,France,Europe
183031,Koffi Djidji,CIV,Crotone,Serie A,2020,27.0,1992.0,16.9,39,28,30,8,1,10,20,50.0,10,35,20,15,28,67,73,0,DF,25-29,Defender,Ivory Coast,Africa
165513,Berat Djimsiti,ALB,Atalanta,Serie A,2020,27.0,1993.0,29.2,41,29,27,12,2,17,34,50.0,17,34,20,14,62,103,89,1,DF,25-29,Defender,Albania,Europe
497291,Nicols Domnguez,ARG,Bologna,Serie A,2020,22.0,1998.0,13.9,48,28,26,17,5,15,37,40.5,22,26,7,19,24,72,20,0,MF,20-24,Midfielder,Argentina,South America
127187,Abdoulaye Doucour,MLI,Everton,Premier League,2020,27.0,1993.0,27.1,52,32,25,19,8,14,43,32.6,29,24,7,17,39,91,31,1,MF,25-29,Midfielder,Mali,Africa
543387,Cheick Doucour,MLI,Lens,Ligue 1,2020,20.0,2000.0,29.2,87,47,40,42,5,32,65,49.2,33,20,4,16,52,139,26,1,MF,20-24,Midfielder,Mali,Africa
316137,Moussa Doumbia,MLI,Reims,Ligue 1,2020,25.0,1994.0,10.0,10,6,4,4,2,4,22,18.2,18,5,1,4,10,20,4,0,"MF,FW",25-29,Midfielder,Mali,Africa
53400,Dominick Drexler,GER,Kln,Bundesliga,2020,30.0,1990.0,13.7,36,26,15,18,3,12,30,40.0,18,5,1,4,14,50,15,0,"MF,FW",30-34,Midfielder,Germany,Europe
257376,Domingos Duarte,POR,Granada,La Liga,2020,25.0,1995.0,26.3,32,20,18,12,2,14,21,66.7,7,29,20,9,29,61,86,0,DF,25-29,Defender,Portugal,Europe
175323,scar Duarte,CRC,Levante,La Liga,2020,31.0,1989.0,22.9,22,13,17,5,0,10,18,55.6,8,23,15,8,36,58,97,1,DF,30-34,Defender,Costa Rica,North America
232418,Ondrej Duda,SVK,Kln,Bundesliga,2020,25.0,1994.0,28.2,36,14,13,18,5,8,39,20.5,31,28,2,26,19,55,20,0,"FW,MF",25-29,Forward,Slovakia,Europe
170321,Paul Dummett,WAL,Newcastle Utd,Premier League,2020,28.0,1991.0,13.9,16,7,11,5,0,13,21,61.9,8,12,7,5,16,32,74,0,DF,25-29,Defender,Wales,Europe
148153,Lewis Dunk,ENG,Brighton,Premier League,2020,28.0,1991.0,32.6,30,15,20,8,2,16,23,69.6,7,29,20,9,32,62,106,0,DF,25-29,Defender,England,Europe
396174,Jimmy Dunne,IRL,Burnley,Premier League,2020,22.0,1997.0,3.0,3,3,2,1,0,1,2,50.0,1,3,2,1,6,9,16,1,DF,20-24,Defender,Republic of Ireland,Europe
93922,Erik Durm,GER,Eint Frankfurt,Bundesliga,2020,28.0,1992.0,16.4,17,13,7,9,1,8,21,38.1,13,19,5,14,29,46,26,0,DF,25-29,Defender,Germany,Europe
206050,Paulo Dybala,ARG,Juventus,Serie A,2020,26.0,1993.0,12.6,14,8,3,4,7,2,14,14.3,12,15,0,15,1,15,1,0,FW,25-29,Forward,Argentina,South America
60990,Bruno Ecuele Manga,GAB,Dijon,Ligue 1,2020,32.0,1988.0,38.0,52,38,46,6,0,29,40,72.5,11,50,33,17,57,109,165,3,DF,30-34,Defender,Gabon,Africa
272812,Kingsley Ehizibue,NED,Kln,Bundesliga,2020,25.0,1995.0,12.6,32,19,22,9,1,10,17,58.8,7,19,5,14,18,50,42,0,DF,25-29,Defender,Netherlands,Europe
49275,Albin Ekdal,SWE,Sampdoria,Serie A,2020,31.0,1989.0,25.5,56,29,21,32,3,23,65,35.4,42,31,12,19,49,105,35,0,MF,30-34,Midfielder,Sweden,Europe
66333,Ahmed Elmohamady,EGY,Aston Villa,Premier League,2020,32.0,1987.0,9.3,17,13,12,4,1,9,14,64.3,5,6,3,3,17,34,26,0,DF,30-34,Defender,Egypt,Africa
160438,Mohamed Elneny,EGY,Arsenal,Premier League,2020,28.0,1992.0,17.2,14,6,7,7,0,7,28,25.0,21,11,4,7,24,38,20,2,MF,25-29,Midfielder,Egypt,Africa
192635,Nico Elvedi,SUI,Gladbach,Bundesliga,2020,23.0,1996.0,28.2,49,35,36,12,1,25,37,67.6,12,38,22,16,65,114,123,0,DF,20-24,Defender,Switzerland,Europe
176140,Rodrigo Ely,BRA,Alavs,La Liga,2020,26.0,1993.0,5.2,5,2,3,2,0,3,4,75.0,1,2,1,1,7,12,23,1,DF,25-29,Defender,Brazil,South America
237662,Breel Embolo,SUI,Gladbach,Bundesliga,2020,23.0,1997.0,16.0,15,10,1,13,1,0,6,0.0,6,16,1,15,8,23,8,0,"FW,MF",20-24,Forward,Switzerland,Europe
181778,Emerson,BRA,Betis,La Liga,2020,21.0,1999.0,33.2,91,52,62,25,4,43,78,55.1,35,33,6,27,61,152,102,2,DF,20-24,Defender,Brazil,South America
421726,Keita Endo,JPN,Union Berlin,Bundesliga,2020,22.0,1997.0,5.1,8,3,1,5,2,3,9,33.3,6,5,2,3,6,14,4,0,"MF,FW",20-24,Midfielder,Japan,Asia
146310,Wataru Endo,JPN,Stuttgart,Bundesliga,2020,27.0,1993.0,32.8,65,44,25,34,6,29,71,40.8,42,53,14,39,51,116,59,0,MF,25-29,Midfielder,Japan,Asia
69633,Christian Eriksen,DEN,Inter,Serie A,2020,28.0,1992.0,15.4,12,6,6,4,2,7,20,35.0,13,16,1,15,9,21,13,1,MF,25-29,Midfielder,Denmark,Europe
266795,Gonzalo Escalante,ARG,Lazio,Serie A,2020,27.0,1993.0,8.1,26,13,11,14,1,8,28,28.6,20,10,3,7,19,45,13,0,MF,25-29,Midfielder,Argentina,South America
311044,Alfonso Espino,URU,Cdiz,La Liga,2020,28.0,1992.0,28.9,92,48,63,28,1,43,85,50.6,42,30,5,25,41,133,74,0,DF,25-29,Defender,Uruguay,South America
552472,Nahuel Estvez,ARG,Spezia,Serie A,2020,24.0,1995.0,19.6,13,5,4,6,3,5,32,15.6,27,23,5,18,20,33,22,1,MF,20-24,Midfielder,Argentina,South America
349599,Pervis Estupin,ECU,Villarreal,La Liga,2020,22.0,1998.0,13.0,37,17,23,12,2,14,23,60.9,9,10,2,8,35,72,14,2,DF,20-24,Defender,Ecuador,South America
479999,Eberechi Eze,ENG,Crystal Palace,Premier League,2020,22.0,1998.0,28.4,27,14,11,13,3,16,35,45.7,19,19,3,16,24,51,9,1,MF,20-24,Midfielder,England,Europe
697714,Fabinho,BRA,Liverpool,Premier League,2020,26.0,1993.0,28.5,58,31,21,29,8,27,54,50.0,27,28,10,18,44,102,66,1,"DF,MF",25-29,Defender,Brazil,South America
61891,Fbio,BRA,Nantes,Ligue 1,2020,30.0,1990.0,16.7,62,37,37,23,2,35,61,57.4,26,29,8,21,37,99,49,0,DF,30-34,Defender,Brazil,South America
292808,Wout Faes,BEL,Reims,Ligue 1,2020,22.0,1998.0,32.2,35,22,26,9,0,20,39,51.3,19,40,31,9,68,103,144,1,DF,20-24,Defender,Belgium,Europe
555076,Romain Faivre,FRA,Brest,Ligue 1,2020,22.0,1998.0,32.1,54,27,26,23,5,21,54,38.9,33,30,0,30,30,84,18,0,"MF,FW",20-24,Midfielder,France,Europe
73926,Davide Faraoni,ITA,Hellas Verona,Serie A,2020,28.0,1991.0,32.1,62,33,36,19,7,28,51,54.9,23,48,17,31,49,111,83,1,DF,25-29,Defender,Italy,Europe
83877,Diego Farias,BRA,Spezia,Serie A,2020,30.0,1990.0,16.8,9,5,4,1,4,4,21,19.0,17,12,0,12,13,22,3,0,FW,30-34,Forward,Brazil,South America
78917,Julien Faussurier,FRA,Brest,Ligue 1,2020,33.0,1987.0,10.6,16,11,6,8,2,11,25,44.0,14,12,4,8,9,25,10,0,DF,30-34,Defender,France,Europe
340151,Andrea Favilli,ITA,Hellas Verona,Serie A,2020,23.0,1997.0,3.8,3,1,0,1,2,2,3,66.7,1,2,0,2,0,3,2,0,FW,20-24,Forward,Italy,Europe
45314,Federico Fazio,ARG,Roma,Serie A,2020,33.0,1987.0,4.5,3,2,3,0,0,3,4,75.0,1,3,3,0,7,10,18,1,DF,30-34,Defender,Argentina,South America
203496,Nabil Fekir,FRA,Betis,La Liga,2020,27.0,1993.0,29.1,45,23,9,22,14,7,43,16.3,36,31,2,29,8,53,2,0,"MF,FW",25-29,Midfielder,France,Europe
156501,Felipe,BRA,Atltico Madrid,La Liga,2020,31.0,1989.0,22.9,29,17,19,10,0,18,23,78.3,5,30,15,15,36,65,128,2,DF,30-34,Defender,Brazil,South America
462250,Joo Flix,POR,Atltico Madrid,La Liga,2020,20.0,1999.0,17.5,8,4,1,6,1,4,17,23.5,13,3,0,3,5,13,2,0,"FW,MF",20-24,Forward,Portugal,Europe
232895,Zinedine Ferhat,ALG,Nmes,Ligue 1,2020,27.0,1993.0,32.9,36,21,18,9,9,18,39,46.2,21,22,0,22,32,68,38,0,"FW,MF",25-29,Forward,Algeria,Africa
240306,Bruno Fernandes,POR,Manchester Utd,Premier League,2020,25.0,1994.0,34.4,57,30,16,29,12,26,100,26.0,74,38,0,38,26,83,29,0,MF,25-29,Midfielder,Portugal,Europe
247555,Edimilson Fernandes,SUI,Mainz 05,Bundesliga,2020,24.0,1996.0,9.3,8,4,4,4,0,4,7,57.1,3,12,4,8,29,37,25,0,"MF,FW",20-24,Midfielder,Switzerland,Europe
85475,Federico Fernndez,ARG,Newcastle Utd,Premier League,2020,31.0,1989.0,23.1,29,22,23,5,1,17,21,81.0,4,41,31,10,17,46,147,0,DF,30-34,Defender,Argentina,South America
389324,Fernandinho,BRA,Manchester City,Premier League,2020,35.0,1985.0,13.2,31,17,8,14,9,20,43,46.5,23,11,2,9,23,54,17,0,MF,35-39,Midfielder,Brazil,South America
550495,Fernando,BRA,Sevilla,La Liga,2020,33.0,1987.0,28.3,54,28,24,25,5,23,43,53.5,20,25,11,14,41,95,70,0,MF,30-34,Midfielder,Brazil,South America
93795,Facundo Ferreyra,ARG,Celta Vigo,La Liga,2020,29.0,1991.0,3.3,4,3,1,2,1,0,2,0.0,2,5,0,5,2,6,2,0,FW,25-29,Forward,Argentina,South America
118284,Jordan Ferri,FRA,Montpellier,Ligue 1,2020,28.0,1992.0,28.6,58,40,34,22,2,31,103,30.1,72,30,5,25,8,66,18,1,MF,25-29,Midfielder,France,Europe
374139,Junior Firpo,DOM,Barcelona,La Liga,2020,23.0,1996.0,3.2,1,1,1,0,0,0,1,0.0,1,5,3,2,4,5,7,0,"DF,MF",20-24,Defender,Dominican Republic,North America
54383,John Fleck,SCO,Sheffield Utd,Premier League,2020,28.0,1991.0,28.6,51,33,28,18,5,26,83,31.3,57,26,4,22,28,79,12,1,MF,25-29,Midfielder,Scotland,Europe
596881,Florian Flick,GER,Schalke 04,Bundesliga,2020,20.0,2000.0,4.0,10,7,4,6,0,7,16,43.8,9,4,3,1,7,17,5,1,MF,20-24,Midfielder,Germany,Europe
130365,Alessandro Florenzi,ITA,Paris S-G,Ligue 1,2020,29.0,1991.0,17.1,24,16,9,9,6,12,29,41.4,17,7,1,6,17,41,25,0,DF,25-29,Defender,Italy,Europe
406635,Phil Foden,ENG,Manchester City,Premier League,2020,20.0,2000.0,18.0,22,11,12,8,2,9,23,39.1,14,9,0,9,11,33,11,0,"FW,MF",20-24,Forward,England,Europe
182893,Seko Fofana,CIV,Lens,Ligue 1,2020,25.0,1995.0,25.7,16,8,3,10,3,4,26,15.4,22,16,5,11,34,50,23,1,MF,25-29,Midfielder,Ivory Coast,Africa
569598,Youssouf Fofana,FRA,Monaco,Ligue 1,2020,21.0,1999.0,31.9,90,51,31,51,8,42,82,51.2,40,43,7,36,34,124,14,2,MF,20-24,Midfielder,France,Europe
391376,Lamine Fomba,FRA,Nmes,Ligue 1,2020,22.0,1998.0,24.2,66,36,30,25,11,30,65,46.2,35,48,19,29,59,125,39,2,MF,20-24,Midfielder,France,Europe
44948,Fernando Forestieri,ITA,Udinese,Serie A,2020,30.0,1990.0,6.1,9,7,4,4,1,3,7,42.9,4,7,0,7,2,11,0,0,"FW,MF",30-34,Forward,Italy,Europe
111078,Emil Forsberg,SWE,RB Leipzig,Bundesliga,2020,28.0,1991.0,17.1,11,6,1,6,4,5,27,18.5,22,10,1,9,11,22,4,0,"FW,MF",25-29,Forward,Sweden,Europe
179635,Philipp Frster,GER,Stuttgart,Bundesliga,2020,25.0,1995.0,16.8,22,13,7,12,3,6,25,24.0,19,18,1,17,15,37,2,0,MF,25-29,Midfielder,Germany,Europe
276895,Steven Fortes,CPV,Lens,Ligue 1,2020,28.0,1992.0,15.9,33,20,20,10,3,16,22,72.7,6,25,10,15,27,60,52,0,DF,25-29,Defender,Cape Verde,Africa
170472,Dimitri Foulquier,FRA,Granada,La Liga,2020,27.0,1993.0,29.6,35,21,20,12,3,15,26,57.7,11,24,7,17,26,61,60,0,DF,25-29,Defender,France,Europe
386755,Gianluca Frabotta,ITA,Juventus,Serie A,2020,21.0,1999.0,7.7,7,4,5,0,2,5,12,41.7,7,9,1,8,14,21,15,0,"DF,MF",20-24,Defender,Italy,Europe
146795,Ryan Fraser,SCO,Newcastle Utd,Premier League,2020,26.0,1994.0,10.3,4,1,3,1,0,2,5,40.0,3,1,0,1,6,10,7,0,"FW,MF",25-29,Forward,Scotland,Europe
140191,Ryan Fredericks,ENG,West Ham,Premier League,2020,27.0,1992.0,6.3,9,5,5,4,0,3,7,42.9,4,6,2,4,11,20,20,0,"DF,FW",25-29,Defender,England,Europe
250013,Angelo Fulgini,FRA,Angers,Ligue 1,2020,23.0,1996.0,30.3,22,13,4,12,6,12,34,35.3,22,17,0,17,15,37,9,0,MF,20-24,Midfielder,France,Europe
75489,Niclas Fllkrug,GER,Werder Bremen,Bundesliga,2020,27.0,1993.0,9.7,7,3,2,4,1,1,13,7.7,12,10,4,6,3,10,13,0,FW,25-29,Forward,Germany,Europe
11111,Ramiro Funes Mori,ARG,Villarreal,La Liga,2020,29.0,1991.0,8.1,12,8,7,5,0,7,11,63.6,4,7,5,2,8,20,42,1,DF,25-29,Defender,Argentina,South America
351755,Darnell Furlong,ENG,West Brom,Premier League,2020,24.0,1995.0,32.6,45,27,27,12,6,21,44,47.7,23,39,16,23,49,94,90,0,DF,20-24,Defender,England,Europe
67639,Andrey Galabinov,BUL,Spezia,Serie A,2020,31.0,1988.0,4.8,2,1,1,1,0,1,3,33.3,2,2,0,2,0,2,5,0,FW,30-34,Forward,Bulgaria,Europe
488362,Conor Gallagher,ENG,West Brom,Premier League,2020,20.0,2000.0,28.1,81,41,30,39,12,29,97,29.9,68,47,8,39,27,108,31,0,MF,20-24,Midfielder,England,Europe
27389,Kvin Gameiro,FRA,Valencia,La Liga,2020,33.0,1987.0,12.0,7,4,3,2,2,3,11,27.3,8,10,0,10,0,7,3,0,FW,30-34,Forward,France,Europe
531949,Ignatius Ganago,CMR,Lens,Ligue 1,2020,21.0,1999.0,14.5,4,3,0,2,2,3,12,25.0,9,7,1,6,6,10,3,0,FW,20-24,Forward,Cameroon,Africa
463613,Yann Gboho,FRA,Rennes,Ligue 1,2020,19.0,2001.0,3.4,6,3,3,1,2,3,8,37.5,5,1,0,1,1,7,3,1,"MF,FW",Under 20,Midfielder,France,Europe
275423,Christian Gebauer,AUT,Arminia,Bundesliga,2020,26.0,1993.0,7.6,9,4,2,5,2,4,11,36.4,7,4,1,3,6,15,14,0,"MF,FW",25-29,Midfielder,Austria,Europe
251309,Dennis Geiger,GER,Hoffenheim,Bundesliga,2020,22.0,1998.0,7.3,13,10,3,8,2,5,8,62.5,3,10,0,10,3,16,0,0,MF,20-24,Midfielder,Germany,Europe
119277,Yannick Gerhardt,GER,Wolfsburg,Bundesliga,2020,26.0,1994.0,21.5,52,32,14,32,6,21,52,40.4,31,34,4,30,21,73,30,0,"MF,FW",25-29,Midfielder,Germany,Europe
60540,Valre Germain,FRA,Marseille,Ligue 1,2020,30.0,1990.0,9.5,8,6,2,4,2,3,11,27.3,8,7,2,5,11,19,22,0,"FW,MF",30-34,Forward,France,Europe
463620,Willem Geubbels,FRA,Monaco,Ligue 1,2020,18.0,2001.0,3.3,12,8,5,7,0,5,13,38.5,8,9,0,9,3,15,5,0,"MF,FW",Under 20,Midfielder,France,Europe
183720,Anwar El Ghazi,NED,Aston Villa,Premier League,2020,25.0,1995.0,17.9,16,13,6,7,3,7,23,30.4,16,11,0,11,6,22,11,0,FW,25-29,Forward,Netherlands,Europe
313477,Paolo Ghiglione,ITA,Genoa,Serie A,2020,23.0,1997.0,15.1,27,15,17,8,2,13,28,46.4,15,14,2,12,13,40,25,0,"DF,MF",20-24,Defender,Italy,Europe
429014,Morgan Gibbs-White,ENG,Wolves,Premier League,2020,20.0,2000.0,4.6,9,7,3,4,2,5,12,41.7,7,6,0,6,3,12,1,0,"MF,FW",20-24,Midfielder,England,Europe
270051,Andrei Girotto,BRA,Nantes,Ligue 1,2020,28.0,1992.0,29.6,65,41,50,15,0,39,70,55.7,31,34,15,19,59,124,103,0,"DF,MF",25-29,Defender,Brazil,South America
82442,Olivier Giroud,FRA,Chelsea,Premier League,2020,33.0,1986.0,8.3,4,2,0,1,3,1,7,14.3,6,4,1,3,5,9,10,0,FW,30-34,Forward,France,Europe
159471,Serge Gnabry,GER,Bayern Munich,Bundesliga,2020,25.0,1995.0,18.3,39,19,7,19,13,12,32,37.5,20,17,0,17,26,65,3,0,"FW,MF",25-29,Forward,Germany,Europe
343475,Ben Godfrey,ENG,Everton,Premier League,2020,22.0,1998.0,29.8,55,33,37,15,3,27,41,65.9,14,56,37,19,33,88,120,0,DF,20-24,Defender,England,Europe
54928,Diego Godn,URU,Cagliari,Serie A,2020,34.0,1986.0,27.9,60,32,51,9,0,24,39,61.5,15,41,24,17,56,116,117,0,DF,30-34,Defender,Uruguay,South America
92472,Akaki Gogia,GER,Union Berlin,Bundesliga,2020,28.0,1992.0,1.6,1,0,0,1,0,0,2,0.0,2,0,0,0,1,2,0,0,"FW,MF",25-29,Forward,Germany,Europe
293210,Amer Gojak,BIH,Torino,Serie A,2020,23.0,1997.0,5.3,1,0,1,0,0,1,7,14.3,6,5,0,5,3,4,1,0,"MF,FW",20-24,Midfielder,Bosnia and Herzegovina,Europe
263918,Aleksandr Golovin,RUS,Monaco,Ligue 1,2020,24.0,1996.0,11.9,28,16,6,18,4,8,39,20.5,31,21,0,21,11,39,3,0,"MF,FW",20-24,Midfielder,Russia,Europe
670710,Andr Gomes,POR,Everton,Premier League,2020,27.0,1993.0,17.4,35,23,16,16,3,17,58,29.3,41,19,1,18,10,45,12,1,MF,25-29,Midfielder,Portugal,Europe
20005,Papu Gmez,ARG,Atalanta,Serie A,2020,32.0,1988.0,7.4,3,2,2,1,0,2,8,25.0,6,8,1,7,1,4,1,0,"MF,FW",30-34,Midfielder,Argentina,South America
153084,Leon Goretzka,GER,Bayern Munich,Bundesliga,2020,25.0,1995.0,18.9,37,23,12,21,4,16,39,41.0,23,30,2,28,44,81,11,0,MF,25-29,Midfielder,Germany,Europe
418659,Amine Gouiri,ALG,Nice,Ligue 1,2020,20.0,2000.0,30.5,31,18,7,16,8,10,41,24.4,31,22,6,16,17,48,23,0,"FW,MF",20-24,Forward,Algeria,Africa
620313,Lucas Gourna-Douath,FRA,Saint-tienne,Ligue 1,2020,16.0,2003.0,14.7,32,22,18,11,3,15,28,53.6,13,10,0,10,24,56,18,0,MF,Under 20,Midfielder,France,Europe
106405,Jeffrey Gouweleeuw,NED,Augsburg,Bundesliga,2020,29.0,1991.0,31.5,36,20,24,11,1,16,33,48.5,17,37,18,19,69,105,149,2,DF,25-29,Defender,Netherlands,Europe
314183,Karlan Grant,ENG,West Brom,Premier League,2020,22.0,1997.0,12.5,5,3,3,2,0,2,4,50.0,2,7,0,7,5,10,17,0,"FW,MF",20-24,Forward,England,Europe
197473,Alberto Grassi,ITA,Parma,Serie A,2020,25.0,1995.0,13.1,30,11,14,13,3,8,29,27.6,21,22,9,13,26,56,32,0,"MF,DF",25-29,Midfielder,Italy,Europe
203460,Jack Grealish,ENG,Aston Villa,Premier League,2020,24.0,1995.0,24.3,31,14,8,16,7,15,24,62.5,9,20,3,17,12,43,5,3,"FW,MF",20-24,Forward,England,Europe
72479,Clment Grenier,FRA,Rennes,Ligue 1,2020,29.0,1991.0,12.0,20,8,9,8,3,7,31,22.6,24,7,0,7,5,25,3,0,"MF,FW",25-29,Midfielder,France,Europe
153555,Sebastian Griesbeck,GER,Union Berlin,Bundesliga,2020,29.0,1990.0,9.9,20,9,8,11,1,8,19,42.1,11,13,3,10,5,25,8,0,MF,25-29,Midfielder,Germany,Europe
125781,Antoine Griezmann,FRA,Barcelona,La Liga,2020,29.0,1991.0,28.9,37,22,10,18,9,12,40,30.0,28,20,1,19,12,49,11,0,"FW,MF",25-29,Forward,France,Europe
185077,Vincenzo Grifo,ITA,Freiburg,Bundesliga,2020,27.0,1993.0,25.7,18,7,6,7,5,14,34,41.2,20,13,0,13,27,45,18,1,"MF,FW",25-29,Midfielder,Italy,Europe
195736,Florian Grillitsch,AUT,Hoffenheim,Bundesliga,2020,24.0,1995.0,20.9,37,21,21,13,3,19,52,36.5,33,38,7,31,51,88,47,1,"MF,DF",20-24,Midfielder,Austria,Europe
58396,Christian Gro,GER,Werder Bremen,Bundesliga,2020,31.0,1989.0,16.3,44,28,17,25,2,15,37,40.5,22,12,2,10,24,68,37,0,"MF,DF",30-34,Midfielder,Germany,Europe
82873,Pascal Gro,GER,Brighton,Premier League,2020,29.0,1991.0,27.6,45,24,24,15,6,24,53,45.3,29,25,4,21,23,68,18,1,"MF,DF",25-29,Midfielder,Germany,Europe
20506,Andrs Guardado,MEX,Betis,La Liga,2020,33.0,1986.0,14.6,25,12,10,11,4,10,25,40.0,15,13,3,10,18,43,19,0,MF,30-34,Midfielder,Mexico,North America
225122,Gonalo Guedes,POR,Valencia,La Liga,2020,23.0,1996.0,25.4,18,12,8,7,3,10,45,22.2,35,24,1,23,8,26,7,0,"MF,FW",20-24,Midfielder,Portugal,Europe
500689,Evann Guessand,CIV,Nice,Ligue 1,2020,19.0,2001.0,0.3,0,0,0,0,0,0,1,0.0,1,1,1,0,1,1,1,0,FW,Under 20,Forward,Ivory Coast,Africa
545520,Kelyan Guessoum,FRA,Nmes,Ligue 1,2020,21.0,1999.0,12.5,13,7,11,1,1,11,16,68.8,5,8,6,2,24,37,51,0,DF,20-24,Defender,France,Europe
568701,Lamine Gueye,SEN,Metz,Ligue 1,2020,22.0,1998.0,16.2,18,9,4,11,3,7,24,29.2,17,7,2,5,21,39,5,0,"FW,MF",20-24,Forward,Senegal,Africa
485963,Pape Gueye,SEN,Marseille,Ligue 1,2020,21.0,1999.0,22.9,49,21,25,19,5,15,45,33.3,30,25,6,19,47,96,34,0,MF,20-24,Midfielder,Senegal,Africa
520624,Bruno Guimares,BRA,Lyon,Ligue 1,2020,22.0,1997.0,19.5,76,34,26,41,9,30,64,46.9,34,24,4,20,14,90,13,0,MF,20-24,Midfielder,Brazil,South America
270541,Serhou Guirassy,GUI,Rennes,Ligue 1,2020,24.0,1996.0,19.6,4,1,1,3,0,1,3,33.3,2,10,1,9,5,9,17,0,FW,20-24,Forward,Guinea,Africa
53622,lkay Gndoan,GER,Manchester City,Premier League,2020,29.0,1990.0,22.5,25,15,8,12,5,10,39,25.6,29,13,4,9,20,45,9,0,MF,25-29,Midfielder,Germany,Europe
93707,Christian Gnter,GER,Freiburg,Bundesliga,2020,27.0,1993.0,34.0,34,19,18,13,3,15,43,34.9,28,38,9,29,29,63,40,0,"DF,MF",25-29,Defender,Germany,Europe
241076,Emmanuel Gyasi,GHA,Spezia,Serie A,2020,26.0,1994.0,31.7,30,16,16,10,4,9,31,29.0,22,13,2,11,14,44,8,0,FW,25-29,Forward,Ghana,Africa
177779,Janik Haberer,GER,Freiburg,Bundesliga,2020,26.0,1994.0,5.4,7,4,4,3,0,3,15,20.0,12,4,1,3,7,14,9,0,"MF,FW",25-29,Midfielder,Germany,Europe
126281,Alexander Hack,GER,Mainz 05,Bundesliga,2020,26.0,1993.0,15.2,32,21,23,8,1,18,31,58.1,13,26,17,9,41,73,91,2,DF,25-29,Defender,Germany,Europe
223725,Munir El Haddadi,MAR,Sevilla,La Liga,2020,24.0,1995.0,9.4,12,8,5,5,2,2,12,16.7,10,6,0,6,5,17,6,0,FW,20-24,Forward,Morocco,Africa
42783,Andr Hahn,GER,Augsburg,Bundesliga,2020,29.0,1990.0,22.6,31,17,14,13,4,9,44,20.5,35,35,3,32,14,45,24,0,"FW,MF",25-29,Forward,Germany,Europe
402008,Amadou Haidara,MLI,RB Leipzig,Bundesliga,2020,22.0,1998.0,21.2,50,28,20,21,9,11,36,30.6,25,33,1,32,30,80,24,0,"MF,FW",20-24,Midfielder,Mali,Africa
398073,Achraf Hakimi,MAR,Inter,Serie A,2020,21.0,1998.0,29.6,53,32,23,19,11,23,48,47.9,25,31,1,30,22,75,23,1,DF,20-24,Defender,Morocco,Africa
203504,Pierre-Yves Hamel,FRA,Lorient,Ligue 1,2020,26.0,1994.0,9.4,15,8,3,9,3,1,6,16.7,5,12,1,11,10,25,6,0,FW,25-29,Forward,France,Europe
98349,Romain Hamouma,FRA,Saint-tienne,Ligue 1,2020,33.0,1987.0,19.7,12,7,5,6,1,4,24,16.7,20,17,1,16,7,19,11,0,"FW,MF",30-34,Forward,France,Europe
372711,Amine Harit,MAR,Schalke 04,Bundesliga,2020,23.0,1997.0,23.3,22,13,8,11,3,10,23,43.5,13,9,1,8,17,39,7,1,"MF,FW",20-24,Midfielder,Morocco,Africa
417346,Jack Harrison,ENG,Leeds United,Premier League,2020,23.0,1996.0,31.6,63,38,20,30,13,26,59,44.1,33,30,2,28,15,78,21,0,"MF,FW",20-24,Midfielder,England,Europe
275303,Hans Hateboer,NED,Atalanta,Serie A,2020,26.0,1994.0,19.6,28,17,12,14,2,13,23,56.5,10,8,1,7,17,45,9,0,DF,25-29,Defender,Netherlands,Europe
309400,Kai Havertz,GER,Chelsea,Premier League,2020,21.0,1999.0,16.9,18,9,6,10,2,6,27,22.2,21,25,0,25,4,22,22,1,"MF,FW",20-24,Midfielder,Germany,Europe
206225,Isaac Hayden,ENG,Newcastle Utd,Premier League,2020,25.0,1995.0,21.6,52,29,23,22,7,14,35,40.0,21,32,9,23,43,95,47,0,"MF,DF",25-29,Midfielder,England,Europe
50202,Eden Hazard,BEL,Real Madrid,La Liga,2020,29.0,1991.0,5.9,3,2,1,2,0,0,3,0.0,3,3,0,3,3,6,0,0,"FW,MF",25-29,Forward,Belgium,Europe
108537,Jonas Hector,GER,Kln,Bundesliga,2020,30.0,1990.0,14.3,34,22,8,21,5,15,35,42.9,20,24,5,19,19,53,20,1,"MF,FW",30-34,Midfielder,Germany,Europe
110036,Dominique Heintz,GER,Freiburg,Bundesliga,2020,26.0,1993.0,15.2,22,11,19,3,0,10,19,52.6,9,10,8,2,35,57,49,0,DF,25-29,Defender,Germany,Europe
148262,Jeff Hendrick,IRL,Newcastle Utd,Premier League,2020,28.0,1992.0,15.8,8,3,5,3,0,1,13,7.7,12,14,9,5,19,27,18,0,MF,25-29,Midfielder,Republic of Ireland,Europe
202591,Benjamin Henrichs,GER,RB Leipzig,Bundesliga,2020,23.0,1997.0,6.0,12,7,4,5,3,2,9,22.2,7,9,1,8,8,20,8,0,"DF,MF",20-24,Defender,Germany,Europe
691316,Luis Henrique,BRA,Marseille,Ligue 1,2020,18.0,2001.0,7.5,5,4,3,1,1,4,9,44.4,5,5,1,4,7,12,4,0,"FW,DF",Under 20,Forward,Brazil,South America
314912,Jrme Hergault,FRA,Lorient,Ligue 1,2020,34.0,1986.0,18.1,38,23,22,10,6,17,31,54.8,14,16,2,14,22,60,34,0,"DF,MF",30-34,Defender,France,Europe
281963,Lucas Hernndez,FRA,Bayern Munich,Bundesliga,2020,24.0,1996.0,17.7,41,31,16,17,8,17,31,54.8,14,24,6,18,19,60,38,0,DF,20-24,Defender,France,Europe
339808,Theo Hernndez,FRA,Milan,Serie A,2020,22.0,1997.0,32.6,48,29,22,21,5,19,38,50.0,19,29,6,23,34,82,64,5,DF,20-24,Defender,France,Europe
181768,Hernani,BRA,Parma,Serie A,2020,26.0,1994.0,24.3,51,25,21,27,3,29,66,43.9,37,35,4,31,31,82,40,1,MF,25-29,Midfielder,Brazil,South America
122043,Hctor Herrera,MEX,Atltico Madrid,La Liga,2020,30.0,1990.0,7.6,12,7,5,6,1,7,13,53.8,6,7,2,5,14,26,8,0,MF,30-34,Midfielder,Mexico,North America
378293,Yangel Herrera,VEN,Granada,La Liga,2020,22.0,1998.0,25.7,59,26,19,32,8,11,41,26.8,30,53,17,36,26,85,32,1,MF,20-24,Midfielder,Venezuela,South America
32711,Patrick Herrmann,GER,Gladbach,Bundesliga,2020,29.0,1991.0,9.7,9,6,4,3,2,2,14,14.3,12,16,0,16,10,19,8,0,"FW,MF",25-29,Forward,Germany,Europe
55099,Nicolas Hfler,GER,Freiburg,Bundesliga,2020,30.0,1990.0,30.3,54,28,16,31,7,23,59,39.0,36,34,10,24,66,120,41,2,MF,30-34,Midfielder,Germany,Europe
227085,Jonas Hofmann,GER,Gladbach,Bundesliga,2020,28.0,1992.0,20.2,26,20,12,12,2,10,53,18.9,43,27,2,25,27,53,9,0,"FW,MF",25-29,Forward,Germany,Europe
248999,Lucas Hler,GER,Freiburg,Bundesliga,2020,26.0,1994.0,23.2,36,24,13,19,4,12,32,37.5,20,19,2,17,16,52,14,0,"FW,MF",25-29,Forward,Germany,Europe
229006,Franck Honorat,FRA,Brest,Ligue 1,2020,23.0,1996.0,27.3,28,13,12,10,6,14,37,37.8,23,15,3,12,11,39,24,0,"MF,FW",20-24,Midfielder,France,Europe
231586,Jannes Horn,GER,Kln,Bundesliga,2020,23.0,1997.0,19.6,35,19,23,11,1,23,31,74.2,8,19,2,17,10,45,45,0,DF,20-24,Defender,Germany,Europe
85822,Florian Hbner,GER,Union Berlin,Bundesliga,2020,29.0,1991.0,5.8,10,5,7,3,0,7,15,46.7,8,7,3,4,13,23,21,0,DF,25-29,Defender,Germany,Europe
392768,Callum Hudson-Odoi,ENG,Chelsea,Premier League,2020,19.0,2000.0,11.8,23,15,11,7,5,8,21,38.1,13,15,1,14,6,29,6,0,"FW,DF",Under 20,Forward,England,Europe
203507,Adrien Hunou,FRA,Rennes,Ligue 1,2020,26.0,1994.0,6.5,6,3,2,2,2,2,8,25.0,6,7,0,7,1,7,2,0,"FW,MF",25-29,Forward,France,Europe
59699,Simone Iacoponi,ITA,Parma,Serie A,2020,33.0,1987.0,13.3,22,12,16,5,1,13,26,50.0,13,9,4,5,11,33,42,1,DF,30-34,Defender,Italy,Europe
520468,Iago,BRA,Augsburg,Bundesliga,2020,23.0,1997.0,17.3,37,27,21,13,3,17,29,58.6,12,17,5,12,22,59,55,0,DF,20-24,Defender,Brazil,South America
3455,Zlatan Ibrahimovi,SWE,Milan,Serie A,2020,38.0,1981.0,16.6,5,4,0,4,1,3,6,50.0,3,5,3,2,6,11,27,1,FW,35-39,Forward,Sweden,Europe
380350,Igor,BRA,Fiorentina,Serie A,2020,22.0,1998.0,13.0,15,9,9,6,0,7,12,58.3,5,17,9,8,23,38,34,0,DF,20-24,Defender,Brazil,South America
295330,Kelechi Iheanacho,NGA,Leicester City,Premier League,2020,23.0,1996.0,16.2,12,5,2,4,6,4,17,23.5,13,14,0,14,2,14,1,1,FW,20-24,Forward,Nigeria,Africa
40074,Stefan Ilsanker,AUT,Eint Frankfurt,Bundesliga,2020,31.0,1989.0,17.5,33,20,17,15,1,21,42,50.0,21,30,8,22,30,63,51,2,"MF,DF",30-34,Midfielder,Austria,Europe
134294,Danny Ings,ENG,Southampton,Premier League,2020,28.0,1992.0,24.1,22,13,3,16,3,12,28,42.9,16,39,2,37,3,25,27,1,FW,25-29,Forward,England,Europe
133964,Lorenzo Insigne,ITA,Napoli,Serie A,2020,29.0,1991.0,31.8,26,18,8,12,6,13,72,18.1,59,30,1,29,37,63,6,1,FW,25-29,Forward,Italy,Europe
98249,Takashi Inui,JPN,Eibar,La Liga,2020,32.0,1988.0,20.2,13,8,6,3,4,3,12,25.0,9,19,0,19,12,25,7,0,"MF,FW",30-34,Midfielder,Japan,Asia
349066,Alexander Isak,SWE,Real Sociedad,La Liga,2020,20.0,1999.0,26.0,9,5,0,3,6,3,8,37.5,5,17,1,16,3,12,7,0,FW,20-24,Forward,Sweden,Europe
242631,Alex Iwobi,NGA,Everton,Premier League,2020,24.0,1996.0,17.1,27,10,10,14,3,13,25,52.0,12,20,1,19,16,43,14,0,"FW,MF",20-24,Forward,Nigeria,Africa
32113,Armando Izzo,ITA,Torino,Serie A,2020,28.0,1992.0,22.3,30,16,13,13,4,13,33,39.4,20,22,9,13,53,83,62,0,DF,25-29,Defender,Italy,Europe
319301,Daniel James,WAL,Manchester Utd,Premier League,2020,22.0,1997.0,10.1,15,9,4,7,4,3,18,16.7,15,10,1,9,0,15,6,0,FW,20-24,Forward,Wales,Europe
196435,Saidy Janko,GAM,Valladolid,La Liga,2020,24.0,1995.0,13.6,19,10,12,5,2,8,14,57.1,6,9,1,8,18,37,47,0,DF,20-24,Defender,Gambia,Africa
177847,Adnan Januzaj,BEL,Real Sociedad,La Liga,2020,25.0,1995.0,11.3,9,8,0,6,3,3,8,37.5,5,7,2,5,3,12,4,0,"FW,MF",25-29,Forward,Belgium,Europe
20463,Corentin Jean,FRA,Lens,Ligue 1,2020,25.0,1995.0,6.4,4,3,1,1,2,0,5,0.0,5,4,0,4,2,6,2,0,"FW,MF",25-29,Forward,France,Europe
249157,Fredrik Jensen,FIN,Augsburg,Bundesliga,2020,22.0,1997.0,4.2,3,2,1,2,0,3,6,50.0,3,4,1,3,2,5,6,0,"FW,MF",20-24,Forward,Finland,Europe
363205,Gabriel Jesus,BRA,Manchester City,Premier League,2020,23.0,1997.0,22.9,17,6,5,5,7,11,28,39.3,17,16,0,16,15,32,5,0,FW,20-24,Forward,Brazil,South America
333241,Joelinton,BRA,Newcastle Utd,Premier League,2020,23.0,1996.0,22.0,33,21,7,21,5,14,37,37.8,23,30,2,28,9,42,24,0,"FW,MF",20-24,Forward,Brazil,South America
468002,Ben Johnson,ENG,West Ham,Premier League,2020,20.0,2000.0,5.8,11,5,5,3,3,7,9,77.8,2,5,1,4,11,22,9,0,"DF,FW",20-24,Defender,England,Europe
433188,Curtis Jones,ENG,Liverpool,Premier League,2020,19.0,2001.0,13.1,16,6,6,7,3,12,25,48.0,13,13,0,13,19,35,11,1,MF,Under 20,Midfielder,England,Europe
326330,Frenkie de Jong,NED,Barcelona,La Liga,2020,23.0,1997.0,35.0,44,27,21,19,4,15,35,42.9,20,20,4,16,38,82,29,2,"MF,DF",20-24,Midfielder,Netherlands,Europe
122155,Willian Jos,BRA,Wolves,Premier League,2020,28.0,1991.0,12.3,2,1,1,1,0,1,4,25.0,3,6,1,5,1,3,12,0,FW,25-29,Forward,Brazil,South America
340950,Diogo Jota,POR,Liverpool,Premier League,2020,23.0,1996.0,12.4,12,6,4,7,1,2,29,6.9,27,9,0,9,5,17,3,0,FW,20-24,Forward,Portugal,Europe
413220,James Justin,ENG,Leicester City,Premier League,2020,22.0,1998.0,23.0,61,37,38,18,5,20,41,48.8,21,36,10,26,30,91,58,1,DF,20-24,Defender,England,Europe
560725,Abdoul Kader Bamba,FRA,Nantes,Ligue 1,2020,26.0,1994.0,10.2,18,3,7,8,3,11,18,61.1,7,10,0,10,7,25,4,1,"FW,MF",25-29,Forward,France,Europe
384060,Tino Kadewere,ZIM,Lyon,Ligue 1,2020,24.0,1996.0,22.3,35,22,12,16,7,17,49,34.7,32,16,3,13,21,56,31,0,FW,20-24,Forward,Zimbabwe,Africa
106270,Florian Kainz,AUT,Kln,Bundesliga,2020,27.0,1992.0,5.0,4,2,0,4,0,2,8,25.0,6,7,0,7,3,7,3,0,"MF,FW",25-29,Midfielder,Austria,Europe
74297,Gal Kakuta,COD,Lens,Ligue 1,2020,29.0,1991.0,26.6,38,23,10,18,10,8,44,18.2,36,24,3,21,17,55,4,0,"MF,FW",25-29,Midfielder,DR Congo,Africa
369567,Sasa Kalajdzic,AUT,Stuttgart,Bundesliga,2020,23.0,1997.0,23.7,16,12,4,5,7,2,17,11.8,15,10,1,9,9,25,21,0,FW,20-24,Forward,Austria,Europe
424051,Samuel Kalu,NGA,Bordeaux,Ligue 1,2020,22.0,1997.0,10.7,21,12,11,8,2,4,13,30.8,9,14,0,14,9,30,2,0,"FW,MF",20-24,Forward,Nigeria,Africa
585949,Pierre Kalulu,FRA,Milan,Serie A,2020,20.0,2000.0,8.1,18,14,11,6,1,10,14,71.4,4,9,3,6,19,37,20,0,DF,20-24,Defender,France,Europe
356141,Daichi Kamada,JPN,Eint Frankfurt,Bundesliga,2020,23.0,1996.0,26.2,48,28,21,16,11,16,49,32.7,33,18,1,17,14,62,22,0,MF,20-24,Midfielder,Japan,Asia
394327,Boubacar Kamara,FRA,Marseille,Ligue 1,2020,20.0,1999.0,32.2,88,51,31,49,8,40,74,54.1,34,36,13,23,34,122,51,0,MF,20-24,Midfielder,France,Europe
290017,Hassane Kamara,CIV,Nice,Ligue 1,2020,26.0,1994.0,32.9,65,39,40,16,9,27,49,55.1,22,39,12,27,55,120,61,1,"DF,FW",25-29,Defender,Ivory Coast,Africa
132098,Harry Kane,ENG,Tottenham,Premier League,2020,27.0,1993.0,34.2,22,12,1,17,4,8,26,30.8,18,28,11,17,11,33,40,0,FW,25-29,Forward,England,Europe
225083,N'Golo Kant,FRA,Chelsea,Premier League,2020,29.0,1991.0,23.8,79,42,39,35,5,27,56,48.2,29,42,4,38,59,138,34,0,MF,25-29,Midfielder,France,Europe
324804,Yann Karamoh,FRA,Parma,Serie A,2020,22.0,1998.0,14.4,27,17,8,12,7,11,31,35.5,20,6,0,6,4,31,11,0,"FW,MF",20-24,Forward,France,Europe
469949,Noah Katterbach,GER,Kln,Bundesliga,2020,19.0,2001.0,12.3,18,11,11,6,1,13,21,61.9,8,7,3,4,23,41,22,0,"DF,MF",Under 20,Defender,Germany,Europe
302215,Naby Keta,GUI,Liverpool,Premier League,2020,25.0,1995.0,5.8,11,5,1,8,2,7,17,41.2,10,10,0,10,9,20,6,0,MF,25-29,Midfielder,Guinea,Africa
342039,Yannik Keitel,GER,Freiburg,Bundesliga,2020,20.0,2000.0,5.5,12,8,7,4,1,7,9,77.8,2,9,3,6,10,22,8,0,MF,20-24,Midfielder,Germany,Europe
281404,Kenedy,BRA,Granada,La Liga,2020,24.0,1996.0,16.3,22,12,10,7,5,5,25,20.0,20,21,4,17,26,48,15,1,"FW,MF",20-24,Forward,Brazil,South America
294808,Franck Kessi,CIV,Milan,Serie A,2020,23.0,1996.0,35.8,53,30,28,19,6,20,38,52.6,18,47,15,32,46,99,51,0,MF,20-24,Midfielder,Ivory Coast,Africa
270411,Saf-Eddine Khaoui,TUN,Marseille,Ligue 1,2020,25.0,1995.0,6.7,19,11,7,6,6,7,16,43.8,9,8,0,8,12,31,1,0,"FW,DF",25-29,Forward,Tunisia,Africa
103565,Wahbi Khazri,TUN,Saint-tienne,Ligue 1,2020,29.0,1991.0,13.1,24,15,12,7,5,12,24,50.0,12,10,1,9,4,28,11,0,FW,25-29,Forward,Tunisia,Africa
161056,Joshua Kimmich,GER,Bayern Munich,Bundesliga,2020,25.0,1995.0,24.4,40,28,16,19,5,10,53,18.9,43,25,5,20,36,76,19,0,MF,25-29,Midfielder,Germany,Europe
282041,Presnel Kimpembe,FRA,Paris S-G,Ligue 1,2020,24.0,1995.0,25.6,46,28,23,19,4,24,34,70.6,10,19,11,8,30,76,61,4,DF,20-24,Defender,France,Europe
60394,Philipp Klement,GER,Stuttgart,Bundesliga,2020,27.0,1992.0,4.7,7,3,6,0,1,3,7,42.9,4,9,2,7,6,13,7,0,"MF,FW",25-29,Midfielder,Germany,Europe
78147,Fabian Klos,GER,Arminia,Bundesliga,2020,32.0,1987.0,30.1,24,13,9,11,4,7,26,26.9,19,20,6,14,4,28,29,0,FW,30-34,Forward,Germany,Europe
215599,Lukas Klostermann,GER,RB Leipzig,Bundesliga,2020,24.0,1996.0,16.1,23,19,8,12,3,11,18,61.1,7,16,6,10,18,41,44,1,DF,20-24,Defender,Germany,Europe
429874,Ansgar Knauff,GER,Dortmund,Bundesliga,2020,18.0,2002.0,0.8,0,0,0,0,0,0,1,0.0,1,3,1,2,0,0,0,0,"MF,FW",Under 20,Midfielder,Germany,Europe
84085,Timothe Kolodziejczak,FRA,Saint-tienne,Ligue 1,2020,28.0,1991.0,22.6,28,15,23,5,0,19,27,70.4,8,24,15,9,36,64,80,1,DF,25-29,Defender,France,Europe
422850,Ghislain Konan,CIV,Reims,Ligue 1,2020,24.0,1995.0,29.0,57,32,35,17,5,32,56,57.1,24,25,11,14,30,87,67,0,DF,20-24,Defender,Ivory Coast,Africa
357119,Ibrahima Konat,FRA,RB Leipzig,Bundesliga,2020,21.0,1999.0,7.7,6,4,2,3,1,2,8,25.0,6,6,3,3,8,14,24,0,DF,20-24,Defender,France,Europe
127189,Geoffrey Kondogbia,CTA,Valencia,La Liga,2020,27.0,1993.0,4.9,16,9,9,4,3,7,19,36.8,12,6,1,5,8,24,8,0,MF,25-29,Midfielder,Central African Republic,Africa
57420,Lamine Kon,CIV,Strasbourg,Ligue 1,2020,31.0,1989.0,11.6,9,6,5,4,0,5,8,62.5,3,4,3,1,15,24,36,0,DF,30-34,Defender,Ivory Coast,Africa
413403,Ezri Konsa,ENG,Aston Villa,Premier League,2020,22.0,1997.0,35.5,25,13,18,6,1,9,13,69.2,4,53,47,6,29,54,162,1,DF,20-24,Defender,England,Europe
76277,Laurent Koscielny,FRA,Bordeaux,Ligue 1,2020,34.0,1985.0,24.6,29,17,18,11,0,16,24,66.7,8,44,34,10,54,83,115,1,DF,30-34,Defender,France,Europe
337725,Christian Kouam,CIV,Fiorentina,Serie A,2020,22.0,1997.0,11.1,9,4,2,4,3,4,12,33.3,8,9,1,8,5,14,4,0,FW,20-24,Forward,Ivory Coast,Africa
93128,Kalidou Koulibaly,SEN,Napoli,Serie A,2020,29.0,1991.0,24.5,36,24,25,7,4,19,32,59.4,13,46,26,20,29,65,64,2,DF,25-29,Defender,Senegal,Africa
411975,Jules Kound,FRA,Sevilla,La Liga,2020,21.0,1998.0,33.1,27,15,14,11,2,10,24,41.7,14,24,16,8,40,67,104,0,DF,20-24,Defender,France,Europe
66934,Cheikhou Kouyat,SEN,Crystal Palace,Premier League,2020,30.0,1989.0,34.7,58,37,44,12,2,25,43,58.1,18,42,26,16,32,90,125,2,DF,30-34,Defender,Senegal,Africa
184528,Emil Krafth,SWE,Newcastle Utd,Premier League,2020,25.0,1994.0,14.3,19,8,9,9,1,12,25,48.0,13,15,9,6,15,34,52,2,DF,25-29,Defender,Sweden,Europe
82097,Christoph Kramer,GER,Gladbach,Bundesliga,2020,29.0,1991.0,22.6,55,37,22,28,5,28,58,48.3,30,32,11,21,34,89,39,0,MF,25-29,Midfielder,Germany,Europe
358515,Jean-Philippe Krasso,CIV,Saint-tienne,Ligue 1,2020,23.0,1997.0,2.5,5,3,1,4,0,2,4,50.0,2,5,0,5,1,6,3,0,FW,20-24,Forward,Ivory Coast,Africa
31909,Toni Kroos,GER,Real Madrid,La Liga,2020,30.0,1990.0,23.5,42,22,15,15,12,11,44,25.0,33,26,6,20,15,57,10,3,MF,30-34,Midfielder,Germany,Europe
93604,Lukas Kbler,GER,Freiburg,Bundesliga,2020,27.0,1992.0,9.8,15,8,9,5,1,9,14,64.3,5,9,3,6,21,36,31,0,"DF,MF",25-29,Defender,Germany,Europe
405398,Takefusa Kubo,JPN,Villarreal,La Liga,2020,19.0,2001.0,3.3,1,1,0,0,1,1,5,20.0,4,2,0,2,1,2,2,0,"MF,FW",Under 20,Midfielder,Japan,Asia
74943,Juraj Kucka,SVK,Parma,Serie A,2020,33.0,1987.0,25.9,67,36,21,37,9,26,74,35.1,48,25,3,22,28,95,25,0,"MF,FW",30-34,Midfielder,Slovakia,Europe
431755,Dejan Kulusevski,SWE,Juventus,Serie A,2020,20.0,2000.0,21.4,33,19,12,10,11,14,43,32.6,29,22,0,22,9,42,2,1,"MF,FW",20-24,Midfielder,Sweden,Europe
334186,Fabian Kunze,GER,Arminia,Bundesliga,2020,22.0,1998.0,14.1,38,26,19,15,4,19,42,45.2,23,19,3,16,18,56,22,1,MF,20-24,Midfielder,Germany,Europe
287876,Antonino La Gumina,ITA,Sampdoria,Serie A,2020,24.0,1996.0,3.8,3,2,0,1,2,0,3,0.0,3,5,1,4,3,6,5,0,FW,20-24,Forward,Italy,Europe
181378,Gatan Laborde,FRA,Montpellier,Ligue 1,2020,26.0,1994.0,36.2,43,22,21,17,5,16,60,26.7,44,29,3,26,16,59,25,1,"FW,MF",25-29,Forward,France,Europe
93720,Alexandre Lacazette,FRA,Arsenal,Premier League,2020,29.0,1991.0,21.4,18,10,4,11,3,4,22,18.2,18,20,1,19,12,30,13,0,FW,25-29,Forward,France,Europe
223967,Konrad Laimer,AUT,RB Leipzig,Bundesliga,2020,23.0,1997.0,0.9,2,0,0,1,1,0,4,0.0,4,2,0,2,1,3,0,0,"DF,MF",20-24,Defender,Austria,Europe
85791,Stefan Lainer,AUT,Gladbach,Bundesliga,2020,27.0,1992.0,30.8,62,37,30,22,10,27,60,45.0,33,34,5,29,35,97,85,1,DF,25-29,Defender,Austria,Europe
174196,Kenny Lala,MAD,Strasbourg,Ligue 1,2020,28.0,1991.0,20.4,22,13,13,8,1,11,22,50.0,11,12,6,6,23,45,33,1,DF,25-29,Defender,Madagascar,Africa
43530,Adam Lallana,ENG,Brighton,Premier League,2020,32.0,1988.0,17.7,28,13,11,13,4,8,39,20.5,31,18,3,15,15,43,13,0,"MF,FW",30-34,Midfielder,England,Europe
504148,Tariq Lamptey,GHA,Brighton,Premier League,2020,19.0,2000.0,9.8,17,9,7,6,4,6,13,46.2,7,8,1,7,19,36,12,1,"DF,MF",Under 20,Defender,Ghana,Africa
130394,Gianluca Lapadula,PER,Benevento,Serie A,2020,30.0,1990.0,28.5,22,12,3,13,6,6,25,24.0,19,18,3,15,5,27,16,0,FW,30-34,Forward,Peru,South America
386057,Julien Laporte,FRA,Lorient,Ligue 1,2020,26.0,1993.0,29.5,65,39,48,16,1,42,74,56.8,32,34,23,11,65,130,125,0,DF,25-29,Defender,France,Europe
183318,Jamaal Lascelles,ENG,Newcastle Utd,Premier League,2020,26.0,1993.0,18.1,14,7,5,9,0,3,6,50.0,3,27,17,10,12,26,86,0,DF,25-29,Defender,England,Europe
93726,Paul Lasne,FRA,Brest,Ligue 1,2020,31.0,1989.0,18.7,46,26,25,19,2,17,40,42.5,23,25,5,20,47,93,17,2,MF,30-34,Midfielder,France,Europe
39025,Danny Latza,GER,Mainz 05,Bundesliga,2020,30.0,1989.0,20.0,43,26,12,19,12,23,70,32.9,47,39,3,36,27,70,23,0,MF,30-34,Midfielder,Germany,Europe
154199,Wesley Lautoa,NCL,Dijon,Ligue 1,2020,32.0,1987.0,17.9,36,20,20,13,3,11,37,29.7,26,17,8,9,29,65,33,1,"MF,DF",30-34,Midfielder,New Caledonia,Oceania
186368,Valentino Lazaro,AUT,Gladbach,Bundesliga,2020,24.0,1996.0,13.8,17,11,7,5,5,12,19,63.2,7,18,1,17,15,32,20,0,"DF,FW",20-24,Defender,Austria,Europe
737781,Jrmy Le Douaron,FRA,Brest,Ligue 1,2020,22.0,1998.0,9.1,15,10,9,4,2,7,21,33.3,14,14,1,13,8,23,11,0,"FW,MF",20-24,Forward,France,Europe
633992,Enzo Le Fe,FRA,Lorient,Ligue 1,2020,20.0,2000.0,20.2,51,28,23,23,5,27,73,37.0,46,30,6,24,25,76,10,0,MF,20-24,Midfielder,France,Europe
120651,Vincent Le Goff,FRA,Lorient,Ligue 1,2020,30.0,1989.0,25.6,42,29,16,24,2,18,49,36.7,31,27,5,22,44,86,44,0,DF,30-34,Defender,France,Europe
357164,Rafael Leo,POR,Milan,Serie A,2020,21.0,1999.0,21.4,13,6,4,7,2,6,15,40.0,9,17,0,17,4,17,14,1,FW,20-24,Forward,Portugal,Europe
377393,Pierre Lees-Melou,FRA,Nice,Ligue 1,2020,27.0,1993.0,22.9,67,39,33,31,3,25,83,30.1,58,50,14,36,29,96,31,1,MF,25-29,Midfielder,France,Europe
41414,Lucas Leiva,BRA,Lazio,Serie A,2020,33.0,1987.0,23.7,68,32,38,28,2,30,86,34.9,56,21,0,21,57,125,21,0,MF,30-34,Midfielder,Brazil,South America
127108,Florian Lejeune,FRA,Alavs,La Liga,2020,29.0,1991.0,33.5,43,32,36,7,0,21,35,60.0,14,38,24,14,51,94,149,1,DF,25-29,Defender,France,Europe
205562,Thomas Lemar,FRA,Atltico Madrid,La Liga,2020,24.0,1995.0,15.2,30,17,9,17,4,11,24,45.8,13,22,1,21,11,41,10,0,MF,20-24,Midfielder,France,Europe
56794,Fabien Lemoine,FRA,Lorient,Ligue 1,2020,33.0,1987.0,21.5,74,45,39,33,2,36,89,40.4,53,25,1,24,27,101,35,0,MF,30-34,Midfielder,France,Europe
182904,Clment Lenglet,FRA,Barcelona,La Liga,2020,25.0,1995.0,27.5,36,21,23,10,3,19,28,67.9,9,26,12,14,33,69,71,1,DF,25-29,Defender,France,Europe
159844,Christopher Lenz,GER,Union Berlin,Bundesliga,2020,25.0,1994.0,25.0,74,41,39,30,5,35,71,49.3,36,34,5,29,35,109,50,0,"DF,FW",25-29,Defender,Germany,Europe
160560,Gaetano Letizia,ITA,Benevento,Serie A,2020,30.0,1990.0,17.4,36,25,19,13,4,17,36,47.2,19,15,3,12,20,56,42,1,DF,30-34,Defender,Italy,Europe
314940,Dimitri Linard,FRA,Strasbourg,Ligue 1,2020,32.0,1988.0,20.3,39,27,17,19,3,24,55,43.6,31,23,1,22,18,57,10,0,MF,30-34,Midfielder,France,Europe
225657,Philipp Lienhart,AUT,Freiburg,Bundesliga,2020,24.0,1996.0,33.3,21,13,12,7,2,9,20,45.0,11,30,21,9,42,63,100,0,DF,20-24,Defender,Austria,Europe
557610,Isaac Lihadji,FRA,Lille,Ligue 1,2020,18.0,2002.0,2.2,11,4,2,6,3,4,5,80.0,1,5,1,4,1,12,0,1,"MF,FW",Under 20,Midfielder,France,Europe
184573,Victor Lindelf,SWE,Manchester Utd,Premier League,2020,26.0,1994.0,28.7,22,10,12,10,0,12,24,50.0,12,22,14,8,30,52,95,1,DF,25-29,Defender,Sweden,Europe
141660,Jesse Lingard,ENG,West Ham,Premier League,2020,27.0,1992.0,15.8,12,6,4,8,0,5,14,35.7,9,7,1,6,4,16,0,0,"MF,FW",25-29,Midfielder,England,Europe
348795,Giovani Lo Celso,ARG,Tottenham,Premier League,2020,24.0,1996.0,10.5,28,22,12,11,5,10,29,34.5,19,12,1,11,7,35,5,0,MF,20-24,Midfielder,Argentina,South America
346707,Sean Longstaff,ENG,Newcastle Utd,Premier League,2020,22.0,1997.0,15.7,31,14,13,15,3,18,42,42.9,24,26,5,21,19,50,14,2,MF,20-24,Midfielder,England,Europe
406040,Ademola Lookman,NGA,Fulham,Premier League,2020,22.0,1997.0,30.5,35,11,18,9,8,13,44,29.5,31,31,1,30,20,55,9,0,"FW,MF",20-24,Forward,Nigeria,Africa
316889,Hirving Lozano,MEX,Napoli,Serie A,2020,25.0,1995.0,21.8,29,18,10,13,6,10,36,27.8,26,37,1,36,18,47,14,0,FW,25-29,Forward,Mexico,North America
240274,Anderson Lucoqui,ANG,Arminia,Bundesliga,2020,23.0,1997.0,17.8,40,25,23,17,0,20,40,50.0,20,30,7,23,27,67,53,0,DF,20-24,Defender,Angola,Africa
125020,Jos Luis Palomino,ARG,Atalanta,Serie A,2020,30.0,1990.0,27.0,67,33,41,19,7,24,48,50.0,24,30,16,14,79,146,60,2,DF,30-34,Defender,Argentina,South America
46741,David Luiz,BRA,Arsenal,Premier League,2020,33.0,1987.0,15.5,12,9,5,7,0,4,4,100.0,0,16,9,7,16,28,50,2,DF,30-34,Defender,Brazil,South America
447661,Douglas Luiz,BRA,Aston Villa,Premier League,2020,22.0,1998.0,30.9,49,18,22,26,1,20,58,34.5,38,52,17,35,43,92,44,2,MF,20-24,Midfielder,Brazil,South America
96341,Romelu Lukaku,BEL,Inter,Serie A,2020,27.0,1993.0,32.0,11,1,1,6,4,6,14,42.9,8,11,1,10,3,14,34,0,FW,25-29,Forward,Belgium,Europe
278531,Sebastiano Luperto,ITA,Crotone,Serie A,2020,23.0,1996.0,20.9,38,20,28,8,2,16,27,59.3,11,17,7,10,27,65,74,1,DF,20-24,Defender,Italy,Europe
379807,Lyanco,BRA,Torino,Serie A,2020,23.0,1997.0,21.8,21,14,13,6,2,8,14,57.1,6,36,26,10,46,67,76,0,DF,20-24,Defender,Brazil,South America
534033,Alexis Mac Allister,ARG,Brighton,Premier League,2020,21.0,1998.0,12.4,26,12,6,16,4,11,38,28.9,27,25,4,21,9,35,4,0,"MF,FW",20-24,Midfielder,Argentina,South America
211251,Darwin Machs,VEN,Granada,La Liga,2020,27.0,1993.0,22.5,30,17,12,10,8,6,19,31.6,13,21,2,19,22,52,13,0,"FW,MF",25-29,Forward,Venezuela,South America
294057,James Maddison,ENG,Leicester City,Premier League,2020,23.0,1996.0,23.3,32,16,5,16,11,14,41,34.1,27,14,1,13,9,41,5,0,MF,20-24,Midfielder,England,Europe
435338,Gabriel Magalhes,BRA,Arsenal,Premier League,2020,22.0,1997.0,22.2,25,15,19,5,1,13,19,68.4,6,27,19,8,26,51,74,2,DF,20-24,Defender,Brazil,South America
66736,Lisandro Magalln,ARG,Crotone,Serie A,2020,26.0,1993.0,24.2,54,31,28,24,2,17,42,40.5,25,29,15,14,44,98,78,1,DF,25-29,Defender,Argentina,South America
353796,Giulio Maggiore,ITA,Spezia,Serie A,2020,22.0,1998.0,24.6,61,36,26,28,7,21,53,39.6,32,33,6,27,19,80,25,1,MF,20-24,Midfielder,Italy,Europe
310458,Giangiacomo Magnani,ITA,Hellas Verona,Serie A,2020,24.0,1995.0,16.8,26,15,14,9,3,9,16,56.3,7,25,16,9,44,70,105,1,DF,20-24,Defender,Italy,Europe
474662,Hugo Magnetti,FRA,Brest,Ligue 1,2020,22.0,1998.0,6.7,24,12,10,13,1,20,40,50.0,20,6,1,5,14,38,8,0,MF,20-24,Midfielder,France,Europe
177907,Harry Maguire,ENG,Manchester Utd,Premier League,2020,27.0,1993.0,33.9,29,17,19,10,0,18,29,62.1,11,28,23,5,60,89,122,4,DF,25-29,Defender,England,Europe
293944,Habib Maga,CIV,Metz,Ligue 1,2020,24.0,1996.0,29.9,81,52,36,40,5,42,85,49.4,43,37,6,31,49,130,36,0,MF,20-24,Midfielder,Ivory Coast,Africa
285845,Ainsley Maitland-Niles,ENG,Arsenal,Premier League,2020,22.0,1997.0,5.4,11,7,6,5,0,8,12,66.7,4,12,2,10,14,25,7,1,"MF,DF",20-24,Midfielder,England,Europe
453824,Josh Maja,NGA,Fulham,Premier League,2020,21.0,1998.0,9.0,7,4,0,3,4,4,10,40.0,6,3,1,2,4,11,1,0,FW,20-24,Forward,Nigeria,Africa
207877,Ruslan Malinovskyi,UKR,Atalanta,Serie A,2020,27.0,1993.0,20.8,19,8,2,13,4,8,23,34.8,15,16,1,15,2,21,4,0,"MF,FW",25-29,Midfielder,Ukraine,Europe
397486,Dennis Man,ROU,Parma,Serie A,2020,21.0,1998.0,7.8,12,6,6,4,2,6,21,28.6,15,5,0,5,2,14,6,0,"FW,MF",20-24,Forward,Romania,Europe
83132,Vincent Manceau,FRA,Angers,Ligue 1,2020,31.0,1989.0,25.7,42,27,23,17,2,30,63,47.6,33,23,2,21,35,77,61,0,DF,30-34,Defender,France,Europe
256448,Gianluca Mancini,ITA,Roma,Serie A,2020,24.0,1996.0,31.7,50,29,29,19,2,18,31,58.1,13,38,18,20,72,122,77,3,DF,20-24,Defender,Italy,Europe
80293,Assa Mandi,ALG,Betis,La Liga,2020,28.0,1991.0,26.6,30,17,20,10,0,10,16,62.5,6,21,13,8,39,69,90,0,DF,25-29,Defender,Algeria,Africa
308279,Rolando Mandragora,ITA,Udinese,Serie A,2020,23.0,1997.0,4.4,8,5,3,4,1,3,10,30.0,7,10,3,7,6,14,5,0,MF,20-24,Midfielder,Italy,Europe
200512,Sadio Man,SEN,Liverpool,Premier League,2020,28.0,1992.0,31.2,48,30,6,22,20,12,33,36.4,21,30,0,30,15,63,11,0,FW,25-29,Forward,Senegal,Africa
289592,Orel Mangala,BEL,Stuttgart,Bundesliga,2020,22.0,1998.0,23.4,27,15,13,11,3,17,28,60.7,11,27,10,17,26,53,30,0,MF,20-24,Midfielder,Belgium,Europe
18934,Thomas Mangani,FRA,Angers,Ligue 1,2020,33.0,1987.0,29.9,54,37,25,26,3,30,90,33.3,60,31,8,23,38,92,39,0,MF,30-34,Midfielder,France,Europe
357072,Faitout Maouassa,FRA,Rennes,Ligue 1,2020,22.0,1998.0,13.0,20,11,10,8,2,11,19,57.9,8,9,1,8,17,37,36,0,DF,20-24,Defender,France,Europe
209212,Solly March,ENG,Brighton,Premier League,2020,26.0,1994.0,18.6,49,23,24,15,10,18,34,52.9,16,30,5,25,22,71,30,0,"DF,MF",25-29,Defender,England,Europe
277167,Gian Marco Ferrari,ITA,Sassuolo,Serie A,2020,28.0,1992.0,33.5,32,20,15,14,3,10,23,43.5,13,46,37,9,50,82,100,1,DF,25-29,Defender,Italy,Europe
250845,Jos Mara Gimnez,URU,Atltico Madrid,La Liga,2020,25.0,1995.0,19.6,20,7,14,5,1,12,17,70.6,5,17,11,6,21,41,65,0,DF,25-29,Defender,Uruguay,South America
231025,Jordan Mari,FRA,Dijon,Ligue 1,2020,28.0,1991.0,15.9,34,17,9,23,2,23,56,41.1,33,14,5,9,23,57,12,2,MF,25-29,Midfielder,France,Europe
295183,Rzvan Marin,ROU,Cagliari,Serie A,2020,24.0,1996.0,32.9,54,33,26,22,6,27,53,50.9,26,29,10,19,29,83,15,0,MF,20-24,Midfielder,Romania,Europe
249730,Guillermo Maripn,CHI,Monaco,Ligue 1,2020,26.0,1994.0,23.2,26,11,17,9,0,15,27,55.6,12,18,11,7,27,53,66,1,DF,25-29,Defender,Chile,South America
124769,Luca Marrone,ITA,Crotone,Serie A,2020,30.0,1990.0,17.6,25,18,16,9,0,13,21,61.9,8,22,11,11,26,51,56,1,DF,30-34,Defender,Italy,Europe
655488,Gabriel Martinelli,BRA,Arsenal,Premier League,2020,19.0,2001.0,6.5,7,1,2,3,2,4,10,40.0,6,6,0,6,8,15,4,0,FW,Under 20,Forward,Brazil,South America
406625,Lautaro Martnez,ARG,Inter,Serie A,2020,22.0,1997.0,28.5,25,12,5,11,9,7,24,29.2,17,31,1,30,27,52,16,0,FW,20-24,Forward,Argentina,South America
373373,Lucas Martnez Quarta,ARG,Fiorentina,Serie A,2020,24.0,1996.0,16.5,32,20,17,11,4,18,41,43.9,23,27,9,18,39,71,48,0,DF,20-24,Defender,Argentina,South America
39909,Sylvain Marveaux,FRA,Lorient,Ligue 1,2020,34.0,1986.0,2.2,6,3,1,4,1,3,3,100.0,0,2,0,2,1,7,2,0,"MF,FW",30-34,Midfielder,France,Europe
142031,Omar Mascarell,EQG,Schalke 04,Bundesliga,2020,27.0,1993.0,19.6,41,24,15,19,7,21,54,38.9,33,40,14,26,37,78,32,1,MF,25-29,Midfielder,Equatorial Guinea,Africa
535834,Eliot Matazo,BEL,Monaco,Ligue 1,2020,18.0,2002.0,3.5,11,5,6,5,0,3,7,42.9,4,1,0,1,1,12,2,0,MF,Under 20,Midfielder,Belgium,Europe
217115,Neal Maupay,FRA,Brighton,Premier League,2020,23.0,1996.0,27.9,20,8,9,7,4,4,24,16.7,20,20,0,20,13,33,6,0,"FW,MF",20-24,Forward,France,Europe
272549,Tony Mauricio,FRA,Lens,Ligue 1,2020,26.0,1994.0,5.6,19,12,7,8,4,11,17,64.7,6,8,1,7,3,22,4,0,MF,25-29,Midfielder,France,Europe
340328,Stephy Mavididi,ENG,Montpellier,Ligue 1,2020,22.0,1998.0,22.6,18,5,7,10,1,8,23,34.8,15,12,0,12,14,32,6,0,"FW,MF",20-24,Forward,England,Europe
415912,Konstantinos Mavropanos,GRE,Stuttgart,Bundesliga,2020,22.0,1997.0,16.3,42,29,29,12,1,27,46,58.7,19,25,10,15,59,101,66,1,DF,20-24,Defender,Greece,Europe
342229,Kylian Mbapp,FRA,Paris S-G,Ligue 1,2020,21.0,1998.0,26.4,4,2,0,1,3,2,9,22.2,7,7,1,6,3,7,4,1,FW,20-24,Forward,France,Europe
207715,Ibrahima Mbaye,SEN,Bologna,Serie A,2020,25.0,1994.0,4.8,6,5,5,1,0,3,5,60.0,2,5,3,2,1,7,10,0,DF,25-29,Defender,Senegal,Africa
193116,John McGinn,SCO,Aston Villa,Premier League,2020,25.0,1994.0,37.0,61,37,23,31,7,27,84,32.1,57,38,6,32,43,104,23,2,MF,25-29,Midfielder,Scotland,Europe
35416,David McGoldrick,IRL,Sheffield Utd,Premier League,2020,32.0,1987.0,26.6,33,21,8,15,10,13,31,41.9,18,19,3,16,2,35,25,0,"FW,MF",30-34,Forward,Republic of Ireland,Europe
332697,Weston McKennie,USA,Juventus,Serie A,2020,21.0,1998.0,18.9,34,19,9,20,5,12,33,36.4,21,21,3,18,28,62,26,0,MF,20-24,Midfielder,United States,North America
584769,Dwight McNeil,ENG,Burnley,Premier League,2020,20.0,1999.0,34.1,47,24,24,18,5,18,56,32.1,38,44,6,38,32,79,32,1,MF,20-24,Midfielder,England,Europe
315969,Scott McTominay,SCO,Manchester Utd,Premier League,2020,23.0,1996.0,23.7,51,24,23,25,3,23,36,63.9,13,35,10,25,29,80,46,0,MF,20-24,Midfielder,Scotland,Europe
474800,Facundo Medina,ARG,Lens,Ligue 1,2020,21.0,1999.0,22.3,39,22,22,15,2,24,38,63.2,14,25,9,16,39,78,51,3,DF,20-24,Defender,Argentina,South America
74810,Ben Mee,ENG,Burnley,Premier League,2020,30.0,1989.0,29.9,32,15,16,14,2,14,29,48.3,15,54,45,9,43,75,148,2,DF,30-34,Defender,England,Europe
425400,Farid El Melali,ALG,Angers,Ligue 1,2020,23.0,1997.0,4.6,9,5,5,4,0,2,13,15.4,11,12,0,12,6,15,2,0,"FW,MF",20-24,Forward,Algeria,Africa
315862,Filippo Melegoni,ITA,Genoa,Serie A,2020,21.0,1999.0,4.3,7,6,2,5,0,3,6,50.0,3,5,0,5,5,12,8,0,"MF,DF",20-24,Midfielder,Italy,Europe
362842,Arthur Melo,BRA,Juventus,Serie A,2020,23.0,1996.0,12.9,17,9,7,10,0,12,31,38.7,19,6,1,5,18,35,9,1,MF,20-24,Midfielder,Brazil,South America
135617,Thiago Mendes,BRA,Lyon,Ligue 1,2020,28.0,1992.0,24.9,37,22,13,20,4,18,38,47.4,20,33,7,26,39,76,21,2,MF,25-29,Midfielder,Brazil,South America
157495,Benjamin Mendy,FRA,Manchester City,Premier League,2020,26.0,1994.0,10.6,13,9,1,8,4,5,21,23.8,16,12,5,7,5,18,14,1,DF,25-29,Defender,France,Europe
291417,Ferland Mendy,FRA,Real Madrid,La Liga,2020,25.0,1995.0,24.5,26,16,17,6,3,12,24,50.0,12,16,4,12,26,52,32,1,DF,25-29,Defender,France,Europe
111051,Nampalys Mendy,SEN,Leicester City,Premier League,2020,28.0,1992.0,16.2,26,17,18,6,2,7,20,35.0,13,12,1,11,14,40,8,0,MF,25-29,Midfielder,Senegal,Africa
28003,Lionel Messi,ARG,Barcelona,La Liga,2020,33.0,1987.0,33.6,18,10,3,9,6,6,17,35.3,11,12,0,12,6,24,0,2,"FW,MF",30-34,Forward,Argentina,South America
449151,Junior Messias,BRA,Crotone,Serie A,2020,29.0,1991.0,35.7,60,35,26,24,10,22,70,31.4,48,32,12,20,35,95,40,0,"MF,FW",25-29,Midfielder,Brazil,South America
100986,Thomas Meunier,BEL,Dortmund,Bundesliga,2020,28.0,1991.0,16.4,30,21,19,6,5,20,29,69.0,9,16,6,10,18,48,29,2,DF,25-29,Defender,Belgium,Europe
401530,der Milito,BRA,Real Madrid,La Liga,2020,22.0,1998.0,12.6,20,8,13,6,1,8,14,57.1,6,19,6,13,19,39,42,0,DF,20-24,Defender,Brazil,South America
569366,Enzo Millot,FRA,Monaco,Ligue 1,2020,18.0,2002.0,0.5,2,0,0,1,1,1,1,100.0,0,0,0,0,2,4,0,0,MF,Under 20,Midfielder,France,Europe
3333,James Milner,ENG,Liverpool,Premier League,2020,34.0,1986.0,11.9,26,19,9,14,3,11,33,33.3,22,30,3,27,14,40,16,1,"MF,DF",30-34,Midfielder,England,Europe
289446,Yerry Mina,COL,Everton,Premier League,2020,25.0,1994.0,21.5,21,14,17,4,0,8,12,66.7,4,30,23,7,24,45,110,1,DF,25-29,Defender,Colombia,South America
165793,Takumi Minamino,JPN,Southampton,Premier League,2020,25.0,1995.0,7.9,7,3,2,5,0,2,19,10.5,17,13,1,12,4,11,9,0,MF,25-29,Midfielder,Japan,Asia
253677,Tyrone Mings,ENG,Aston Villa,Premier League,2020,27.0,1993.0,35.5,32,16,23,7,2,16,24,66.7,8,59,40,19,41,73,172,3,DF,25-29,Defender,England,Europe
730893,Tyrick Mitchell,ENG,Crystal Palace,Premier League,2020,20.0,1999.0,19.0,64,35,48,9,7,23,40,57.5,17,29,10,19,21,85,62,1,DF,20-24,Defender,England,Europe
55735,Henrikh Mkhitaryan,ARM,Roma,Serie A,2020,31.0,1989.0,30.5,58,24,13,27,18,13,62,21.0,49,34,0,34,39,97,10,0,"MF,FW",30-34,Midfielder,Armenia,Asia
538874,Terem Moffi,NGA,Lorient,Ligue 1,2020,21.0,1999.0,23.0,13,8,0,8,5,4,19,21.1,15,5,2,3,4,17,8,0,FW,20-24,Forward,Nigeria,Africa
424042,Nahuel Molina,ARG,Udinese,Serie A,2020,22.0,1998.0,20.3,27,18,13,10,4,16,42,38.1,26,26,4,22,21,48,49,1,DF,20-24,Defender,Argentina,South America
163582,Salvatore Molina,ITA,Crotone,Serie A,2020,28.0,1992.0,25.7,39,22,18,14,7,29,45,64.4,16,30,8,22,17,56,41,0,"MF,DF",25-29,Midfielder,Italy,Europe
222859,Florent Mollet,FRA,Montpellier,Ligue 1,2020,28.0,1991.0,26.2,20,15,7,11,2,12,47,25.5,35,18,4,14,32,52,9,1,MF,25-29,Midfielder,France,Europe
238977,Gabriele Moncini,ITA,Benevento,Serie A,2020,24.0,1996.0,4.0,2,1,2,0,0,0,1,0.0,1,2,0,2,2,4,4,0,"FW,MF",20-24,Forward,Italy,Europe
127182,Thomas Monconduit,FRA,Lorient,Ligue 1,2020,29.0,1991.0,12.8,28,15,9,16,3,15,41,36.6,26,10,3,7,13,41,21,1,MF,25-29,Midfielder,France,Europe
110338,Luca Mora,ITA,Spezia,Serie A,2020,32.0,1988.0,1.3,3,1,1,2,0,2,4,50.0,2,2,1,1,0,3,2,0,MF,30-34,Midfielder,Italy,Europe
23960,Jrmy Morel,MAD,Lorient,Ligue 1,2020,36.0,1984.0,27.7,31,19,21,10,0,20,39,51.3,19,26,11,15,44,75,81,1,DF,35-39,Defender,Madagascar,Africa
617074,Ilaix Moriba,GUI,Barcelona,La Liga,2020,17.0,2003.0,6.0,14,6,5,7,2,5,10,50.0,5,16,1,15,5,19,4,1,MF,Under 20,Midfielder,Guinea,Africa
238639,Steve Mouni,BEN,Brest,Ligue 1,2020,25.0,1994.0,29.8,15,11,3,11,1,3,28,10.7,25,18,3,15,12,27,40,0,FW,25-29,Forward,Benin,Africa
77100,Lucas Moura,BRA,Tottenham,Premier League,2020,27.0,1992.0,15.7,32,16,12,16,4,8,29,27.6,21,12,0,12,18,50,10,0,"FW,MF",25-29,Forward,Brazil,South America
461906,Joo Moutinho,POR,Wolves,Premier League,2020,33.0,1986.0,28.1,75,40,34,35,6,35,91,38.5,56,18,3,15,47,122,28,0,MF,30-34,Midfielder,Portugal,Europe
348026,Nordi Mukiele,FRA,RB Leipzig,Bundesliga,2020,22.0,1997.0,18.6,44,30,14,28,2,21,37,56.8,16,33,1,32,23,67,33,2,DF,20-24,Defender,France,Europe
58358,Thomas Mller,GER,Bayern Munich,Bundesliga,2020,30.0,1989.0,29.7,49,22,11,23,15,24,73,32.9,49,43,3,40,21,70,18,1,MF,30-34,Midfielder,Germany,Europe
119228,Luis Muriel,COL,Atalanta,Serie A,2020,29.0,1991.0,16.0,20,9,4,8,8,9,26,34.6,17,17,0,17,7,27,4,0,FW,25-29,Forward,Colombia,South America
131102,Jeison Murillo,COL,Celta Vigo,La Liga,2020,28.0,1992.0,30.0,45,21,35,9,1,24,44,54.5,20,29,17,12,36,81,100,2,DF,25-29,Defender,Colombia,South America
199527,Jacob Murphy,ENG,Newcastle Utd,Premier League,2020,25.0,1995.0,18.1,39,24,25,12,2,24,49,49.0,25,27,3,24,14,53,29,0,"DF,MF",25-29,Defender,England,Europe
171399,Nicola Murru,ITA,Torino,Serie A,2020,25.0,1994.0,6.3,9,6,1,5,3,3,5,60.0,2,11,1,10,12,21,24,0,DF,25-29,Defender,Italy,Europe
503991,Yunus Musah,USA,Valencia,La Liga,2020,17.0,2002.0,17.0,21,18,12,3,6,8,24,33.3,16,20,0,20,15,36,12,1,MF,Under 20,Midfielder,United States,North America
580195,Jamal Musiala,GER,Bayern Munich,Bundesliga,2020,17.0,2003.0,9.8,20,12,5,7,8,7,22,31.8,15,17,2,15,14,34,3,0,"FW,MF",Under 20,Forward,Germany,Europe
127573,Phillipp Mwene,AUT,Mainz 05,Bundesliga,2020,26.0,1994.0,18.6,36,23,21,11,4,19,38,50.0,19,26,3,23,24,60,33,0,"DF,MF",25-29,Defender,Austria,Europe
315063,Nahitan Nndez,URU,Cagliari,Serie A,2020,24.0,1995.0,30.4,56,28,23,23,10,25,68,36.8,43,26,4,22,23,79,49,0,"MF,DF",20-24,Midfielder,Uruguay,South America
568702,Papa Ndiaga Yade,MTN,Metz,Ligue 1,2020,20.0,2000.0,11.1,15,8,9,2,4,7,20,35.0,13,9,0,9,4,19,6,0,"FW,MF",20-24,Forward,Mauritania,Africa
274839,Wilfred Ndidi,NGA,Leicester City,Premier League,2020,23.0,1996.0,24.2,96,63,45,44,7,26,66,39.4,40,38,11,27,61,157,55,0,"MF,DF",20-24,Midfielder,Nigeria,Africa
365108,Dan Ndoye,SUI,Nice,Ligue 1,2020,19.0,2000.0,6.1,7,6,3,4,0,1,8,12.5,7,4,0,4,7,14,4,0,"FW,MF",Under 20,Forward,Switzerland,Europe
54581,Ilija Nestorovski,MKD,Udinese,Serie A,2020,30.0,1990.0,7.8,6,4,2,3,1,2,13,15.4,11,5,0,5,1,7,7,0,"FW,MF",30-34,Forward,North Macedonia,Europe
524285,Luca Netz,GER,Hertha BSC,Bundesliga,2020,17.0,2003.0,3.4,14,8,12,2,0,6,17,35.3,11,3,0,3,6,20,8,0,"DF,FW",Under 20,Defender,Germany,Europe
278332,Florian Neuhaus,GER,Gladbach,Bundesliga,2020,23.0,1997.0,29.1,48,28,19,26,3,19,63,30.2,44,35,7,28,50,98,20,1,MF,20-24,Midfielder,Germany,Europe
225161,Rben Neves,POR,Wolves,Premier League,2020,23.0,1997.0,29.7,86,46,42,38,6,36,88,40.9,52,55,11,44,65,151,46,2,MF,20-24,Midfielder,Portugal,Europe
68290,Neymar,BRA,Paris S-G,Ligue 1,2020,28.0,1992.0,15.7,14,11,1,6,7,8,37,21.6,29,8,0,8,9,23,0,0,"MF,FW",25-29,Midfielder,Brazil,South America
469669,Yvan Neyou,CMR,Saint-tienne,Ligue 1,2020,23.0,1997.0,27.1,58,31,24,33,1,25,60,41.7,35,34,5,29,31,89,13,1,MF,20-24,Midfielder,Cameroon,Africa
448177,Jessic Ngankam,GER,Hertha BSC,Bundesliga,2020,20.0,2000.0,3.3,5,2,1,2,2,1,3,33.3,2,6,1,5,0,5,1,0,FW,20-24,Forward,Germany,Europe
205587,Opa Nguette,SEN,Metz,Ligue 1,2020,26.0,1994.0,12.6,15,8,2,8,5,3,10,30.0,7,14,2,12,1,16,1,0,"FW,MF",25-29,Forward,Senegal,Africa
490417,Ibrahima Niane,SEN,Metz,Ligue 1,2020,21.0,1999.0,7.4,1,1,0,0,1,1,2,50.0,1,3,0,3,0,1,8,0,FW,20-24,Forward,Senegal,Africa
152963,Florian Niederlechner,GER,Augsburg,Bundesliga,2020,29.0,1990.0,19.3,7,5,1,4,2,0,10,0.0,10,8,3,5,10,17,18,0,FW,25-29,Forward,Germany,Europe
216804,Joakim Nilsson,SWE,Arminia,Bundesliga,2020,26.0,1994.0,24.0,36,24,23,12,1,14,23,60.9,9,29,22,7,39,75,111,0,DF,25-29,Defender,Sweden,Europe
340324,Eddie Nketiah,ENG,Arsenal,Premier League,2020,21.0,1999.0,4.7,3,1,0,2,1,0,2,0.0,2,6,0,6,0,3,5,0,FW,20-24,Forward,England,Europe
344381,Christopher Nkunku,FRA,RB Leipzig,Bundesliga,2020,22.0,1997.0,21.0,16,11,3,7,6,8,18,44.4,10,27,1,26,9,25,14,0,"FW,MF",20-24,Forward,France,Europe
324811,Arnaud Nordin,FRA,Saint-tienne,Ligue 1,2020,22.0,1998.0,19.7,14,8,5,5,4,6,21,28.6,15,13,2,11,9,23,10,0,"MF,FW",20-24,Midfielder,France,Europe
111508,Allan Nyom,CMR,Getafe,La Liga,2020,32.0,1988.0,25.8,38,23,14,19,5,15,30,50.0,15,16,2,14,22,60,42,0,"MF,DF",30-34,Midfielder,Cameroon,Africa
101213,Pedro Obiang,EQG,Sassuolo,Serie A,2020,28.0,1992.0,16.3,35,22,17,15,3,12,35,34.3,23,26,7,19,22,57,27,0,MF,25-29,Midfielder,Equatorial Guinea,Africa
189441,Lucas Ocampos,ARG,Sevilla,La Liga,2020,26.0,1994.0,29.2,36,24,12,16,8,13,37,35.1,24,33,1,32,19,55,30,1,FW,25-29,Forward,Argentina,South America
48002,Angelo Ogbonna,ITA,West Ham,Premier League,2020,32.0,1988.0,27.7,26,13,20,5,1,9,17,52.9,8,25,11,14,30,56,119,0,DF,30-34,Defender,Italy,Europe
119234,Karim Onisiwo,AUT,Mainz 05,Bundesliga,2020,28.0,1992.0,20.5,31,20,7,15,9,14,23,60.9,9,20,1,19,5,36,12,0,"FW,MF",25-29,Forward,Austria,Europe
243589,Josh Onomah,ENG,Fulham,Premier League,2020,23.0,1997.0,4.2,11,8,1,6,4,0,5,0.0,5,4,2,2,2,13,1,0,MF,20-24,Midfielder,England,Europe
60890,Fabin Orellana,CHI,Valladolid,La Liga,2020,34.0,1986.0,23.8,33,19,12,14,7,12,55,21.8,43,18,0,18,15,48,9,0,"MF,FW",30-34,Midfielder,Chile,South America
148368,Divock Origi,BEL,Liverpool,Premier League,2020,25.0,1995.0,2.1,3,2,0,2,1,1,3,33.3,2,5,1,4,1,4,2,0,FW,25-29,Forward,Belgium,Europe
108650,Yuya Osako,JPN,Werder Bremen,Bundesliga,2020,30.0,1990.0,8.5,12,8,2,5,5,2,9,22.2,7,6,1,5,5,17,7,0,"MF,FW",30-34,Midfielder,Japan,Asia
218087,Ben Osborn,ENG,Sheffield Utd,Premier League,2020,25.0,1994.0,17.8,33,18,15,10,8,13,40,32.5,27,20,3,17,12,45,17,0,"MF,DF",25-29,Midfielder,England,Europe
358165,Yordan Osorio,VEN,Parma,Serie A,2020,26.0,1994.0,20.1,22,14,13,9,0,9,24,37.5,15,30,18,12,53,75,77,1,DF,25-29,Defender,Venezuela,South America
818495,Otvio,BRA,Bordeaux,Ligue 1,2020,26.0,1994.0,17.3,54,31,33,19,2,26,55,47.3,29,20,5,15,26,80,36,0,MF,25-29,Midfielder,Brazil,South America
221611,Paulo Otvio,BRA,Wolfsburg,Bundesliga,2020,25.0,1994.0,19.3,60,40,32,22,6,34,62,54.8,28,51,7,44,42,102,59,0,DF,25-29,Defender,Brazil,South America
184922,Ambroise Oyongo,CMR,Montpellier,Ligue 1,2020,29.0,1991.0,6.2,13,6,10,3,0,9,15,60.0,6,3,2,1,8,21,26,1,DF,25-29,Defender,Cameroon,Africa
244940,Salih zcan,TUR,Kln,Bundesliga,2020,22.0,1998.0,15.2,21,13,11,10,0,12,33,36.4,21,11,2,9,20,41,14,1,MF,20-24,Midfielder,Turkey,Asia
181547,Gonalo Pacincia,POR,Schalke 04,Bundesliga,2020,25.0,1994.0,8.3,8,3,4,1,3,4,16,25.0,12,4,1,3,1,9,3,0,FW,25-29,Forward,Portugal,Europe
126699,Vincent Pajot,FRA,Metz,Ligue 1,2020,29.0,1990.0,10.2,35,20,19,11,5,10,18,55.6,8,9,2,7,42,77,11,0,MF,25-29,Midfielder,France,Europe
139279,Nicolas Pallois,FRA,Nantes,Ligue 1,2020,32.0,1987.0,30.8,58,36,42,14,2,38,72,52.8,34,44,20,24,37,95,155,1,DF,30-34,Defender,France,Europe
12563,Goran Pandev,MKD,Genoa,Serie A,2020,37.0,1983.0,15.6,9,5,1,6,2,4,10,40.0,6,6,0,6,2,11,7,1,"FW,MF",35-39,Forward,North Macedonia,Europe
444523,Lucas Paquet,BRA,Lyon,Ligue 1,2020,22.0,1997.0,25.3,70,36,30,28,12,23,66,34.8,43,28,3,25,20,90,16,1,MF,20-24,Midfielder,Brazil,South America
166237,Leandro Paredes,ARG,Paris S-G,Ligue 1,2020,26.0,1994.0,14.5,30,18,12,15,3,19,39,48.7,20,17,5,12,17,47,13,1,MF,25-29,Midfielder,Argentina,South America
238981,Vittorio Parigini,ITA,Genoa,Serie A,2020,24.0,1996.0,0.6,5,2,4,0,1,0,1,0.0,1,0,0,0,0,5,0,0,"MF,DF",20-24,Midfielder,Italy,Europe
274461,Felix Passlack,GER,Dortmund,Bundesliga,2020,22.0,1998.0,4.0,9,6,4,2,3,4,8,50.0,4,11,1,10,3,12,2,0,DF,20-24,Defender,Germany,Europe
353366,Benjamin Pavard,FRA,Bayern Munich,Bundesliga,2020,24.0,1996.0,21.6,44,27,20,16,8,23,40,57.5,17,29,5,24,48,92,31,1,DF,20-24,Defender,France,Europe
64793,Leonardo Pavoletti,ITA,Cagliari,Serie A,2020,31.0,1988.0,17.6,7,3,2,5,0,1,20,5.0,19,4,2,2,4,11,32,0,FW,30-34,Forward,Italy,Europe
37647,Dimitri Payet,FRA,Marseille,Ligue 1,2020,33.0,1987.0,26.9,27,17,4,16,7,17,40,42.5,23,19,2,17,8,35,10,0,"FW,MF",30-34,Forward,France,Europe
876440,Joo Pedro,ITA,Cagliari,Serie A,2020,28.0,1992.0,36.1,13,6,2,6,5,2,27,7.4,25,32,6,26,13,26,28,0,"FW,MF",25-29,Forward,Italy,Europe
29594,Graziano Pell,ITA,Parma,Serie A,2020,35.0,1985.0,6.8,2,2,0,1,1,1,8,12.5,7,3,0,3,2,4,8,0,FW,35-39,Forward,Italy,Europe
286297,Lorenzo Pellegrini,ITA,Roma,Serie A,2020,24.0,1996.0,28.9,40,24,13,20,7,21,60,35.0,39,37,2,35,42,82,23,1,MF,20-24,Midfielder,Italy,Europe
494236,Andy Pelmard,FRA,Nice,Ligue 1,2020,20.0,2000.0,13.4,18,12,12,5,1,9,12,75.0,3,11,3,8,20,38,35,0,DF,20-24,Defender,France,Europe
343052,Nicolas Pp,CIV,Arsenal,Premier League,2020,25.0,1995.0,18.0,20,15,8,6,6,8,23,34.8,15,16,1,15,12,32,19,0,FW,25-29,Forward,Ivory Coast,Africa
203394,Andreas Pereira,BRA,Lazio,Serie A,2020,24.0,1996.0,6.0,5,0,1,3,1,2,12,16.7,10,6,0,6,1,6,4,0,"FW,MF",20-24,Forward,Brazil,South America
141050,Danilo Pereira,POR,Paris S-G,Ligue 1,2020,28.0,1991.0,15.9,21,11,6,11,4,6,14,42.9,8,14,6,8,29,50,33,4,"MF,DF",25-29,Midfielder,Portugal,Europe
314965,Pedro Pereira,POR,Crotone,Serie A,2020,22.0,1998.0,28.3,50,32,29,17,4,21,40,52.5,19,33,11,22,19,69,61,0,DF,20-24,Defender,Portugal,Europe
264116,Gastn Pereiro,URU,Cagliari,Serie A,2020,25.0,1995.0,3.0,3,1,2,1,0,1,2,50.0,1,2,0,2,1,4,2,1,"MF,DF",25-29,Midfielder,Uruguay,South America
69751,Jordi Alba,ESP,Barcelona,La Liga,2020,31.0,1989.0,33.6,45,30,22,16,7,24,52,46.2,28,21,2,19,49,94,48,0,"DF,FW",30-34,Defender,Spain,Europe
128220,Luis Alberto,ESP,Lazio,Serie A,2020,27.0,1992.0,29.1,43,24,15,19,9,15,73,20.5,58,41,2,39,13,56,11,1,MF,25-29,Midfielder,Spain,Europe
126716,Paco Alccer,ESP,Villarreal,La Liga,2020,26.0,1993.0,17.2,6,3,1,2,3,3,7,42.9,4,8,0,8,9,15,6,0,FW,25-29,Forward,Spain,Europe
60444,Thiago Alcntara,ESP,Liverpool,Premier League,2020,29.0,1991.0,20.6,61,36,20,30,11,17,49,34.7,32,26,0,26,30,91,14,0,MF,25-29,Midfielder,Spain,Europe
247250,Rubn Alcaraz,ESP,Valladolid,La Liga,2020,29.0,1991.0,24.1,54,29,32,21,1,30,80,37.5,50,35,8,27,31,85,28,0,MF,25-29,Midfielder,Spain,Europe
281755,Ivn Alejo,ESP,Cdiz,La Liga,2020,25.0,1995.0,9.2,14,10,8,4,2,4,23,17.4,19,14,1,13,3,17,10,0,"MF,FW",25-29,Midfielder,Spain,Europe
138935,Sergio lvarez,ESP,Eibar,La Liga,2020,28.0,1992.0,17.4,42,25,13,26,3,8,22,36.4,14,22,5,17,22,64,24,2,"MF,DF",25-29,Midfielder,Spain,Europe
255488,Yeray lvarez,ESP,Athletic Club,La Liga,2020,25.0,1995.0,21.6,19,12,11,8,0,9,21,42.9,12,12,5,7,53,72,73,0,DF,25-29,Defender,Spain,Europe
158704,Jon Ander Garrido,ESP,Cdiz,La Liga,2020,30.0,1989.0,8.9,18,10,8,7,3,10,26,38.5,16,12,4,8,14,32,13,0,MF,30-34,Midfielder,Spain,Europe
277179,Angelio,ESP,RB Leipzig,Bundesliga,2020,23.0,1997.0,24.0,31,19,10,18,3,13,24,54.2,11,22,1,21,30,61,40,0,"DF,FW",20-24,Defender,Spain,Europe
71548,Anaitz Arbilla,ESP,Eibar,La Liga,2020,33.0,1987.0,31.2,45,26,31,11,3,27,54,50.0,27,36,11,25,69,114,73,1,DF,30-34,Defender,Spain,Europe
537762,Sergio Arribas,ESP,Real Madrid,La Liga,2020,18.0,2001.0,1.5,3,1,2,1,0,1,3,33.3,2,2,0,2,4,7,2,0,"MF,FW",Under 20,Midfielder,Spain,Europe
72047,Iago Aspas,ESP,Celta Vigo,La Liga,2020,32.0,1987.0,31.8,11,3,2,7,2,2,23,8.7,21,25,2,23,16,27,21,0,FW,30-34,Forward,Spain,Europe
57500,Csar Azpilicueta,ESP,Chelsea,Premier League,2020,30.0,1989.0,24.3,53,28,22,24,7,19,37,51.4,18,30,5,25,28,81,62,2,DF,30-34,Defender,Spain,Europe
298575,Kike Barja,ESP,Osasuna,La Liga,2020,23.0,1997.0,15.9,10,5,6,1,3,5,24,20.8,19,10,1,9,16,26,8,0,"MF,FW",20-24,Midfielder,Spain,Europe
616369,Ander Barrenetxea,ESP,Real Sociedad,La Liga,2020,18.0,2001.0,14.5,29,19,5,18,6,9,24,37.5,15,20,0,20,6,35,8,0,"MF,FW",Under 20,Midfielder,Spain,Europe
289236,Jon Bautista,ESP,Real Sociedad,La Liga,2020,25.0,1995.0,4.1,5,3,0,2,3,0,3,0.0,3,3,1,2,2,7,4,0,FW,25-29,Forward,Spain,Europe
237164,Ihlas Bebou,TOG,Hoffenheim,Bundesliga,2020,26.0,1994.0,24.4,24,9,5,10,9,8,14,57.1,6,18,4,14,17,41,16,0,"FW,MF",25-29,Forward,Togo,Africa
243028,Jan Bednarek,POL,Southampton,Premier League,2020,24.0,1996.0,34.4,37,19,25,11,1,25,49,51.0,24,44,27,17,84,121,132,0,DF,20-24,Defender,Poland,Europe
191217,Hctor Bellern,ESP,Arsenal,Premier League,2020,25.0,1995.0,23.2,29,19,14,12,3,12,41,29.3,29,26,8,18,33,62,33,0,"DF,MF",25-29,Defender,Spain,Europe
423444,Fran Beltrn,ESP,Celta Vigo,La Liga,2020,21.0,1999.0,15.5,30,22,15,12,3,8,24,33.3,16,14,1,13,16,46,24,0,"MF,FW",20-24,Midfielder,Spain,Europe
61812,Yuri Berchiche,ESP,Athletic Club,La Liga,2020,30.0,1990.0,18.7,24,19,14,5,5,10,24,41.7,14,14,0,14,11,35,29,0,DF,30-34,Defender,Spain,Europe
338425,lex Berenguer,ESP,Torino,Serie A,2020,25.0,1995.0,1.5,2,0,0,0,2,2,5,40.0,3,2,0,2,0,2,1,0,MF,25-29,Midfielder,Spain,Europe
144143,Bartosz Bereszyski,POL,Sampdoria,Serie A,2020,28.0,1992.0,29.0,66,44,37,22,7,41,73,56.2,32,40,20,20,42,108,88,0,DF,25-29,Defender,Poland,Europe
333014,Sander Berge,NOR,Sheffield Utd,Premier League,2020,22.0,1998.0,12.4,16,7,8,5,3,7,15,46.7,8,11,2,9,4,20,18,0,MF,20-24,Midfielder,Norway,Europe
65230,Sergio Busquets,ESP,Barcelona,La Liga,2020,32.0,1988.0,28.0,63,35,21,29,13,27,76,35.5,49,27,4,23,53,116,18,2,MF,30-34,Midfielder,Spain,Europe
61253,Jos Callejn,ESP,Fiorentina,Serie A,2020,33.0,1987.0,7.4,10,7,0,6,4,5,9,55.6,4,4,1,3,4,14,5,0,"FW,MF",30-34,Forward,Spain,Europe
326416,Dani Calvo,ESP,Elche,La Liga,2020,26.0,1994.0,19.8,20,13,13,7,0,7,10,70.0,3,18,12,6,11,31,71,0,DF,25-29,Defender,Spain,Europe
120095,Jos Campaa,ESP,Levante,La Liga,2020,27.0,1993.0,8.3,14,6,3,6,5,5,14,35.7,9,2,0,2,13,27,4,0,MF,25-29,Midfielder,Spain,Europe
66106,Sergio Canales,ESP,Betis,La Liga,2020,29.0,1991.0,27.8,16,9,9,6,1,3,21,14.3,18,18,0,18,13,29,5,0,"MF,FW",25-29,Midfielder,Spain,Europe
197545,Ander Capa,ESP,Athletic Club,La Liga,2020,28.0,1992.0,23.7,37,18,22,13,2,18,37,48.6,19,21,8,13,25,62,57,0,DF,25-29,Defender,Spain,Europe
120705,Juan Carlos,ESP,Huesca,La Liga,2020,29.0,1991.0,3.2,5,3,4,1,0,2,15,13.3,13,7,0,7,1,6,1,0,"MF,FW",25-29,Midfielder,Spain,Europe
545647,Sergio Carreira,ESP,Celta Vigo,La Liga,2020,19.0,2000.0,2.9,3,0,2,1,0,1,1,100.0,0,2,0,2,1,4,7,0,DF,Under 20,Defender,Spain,Europe
195171,Samu Castillejo,ESP,Milan,Serie A,2020,25.0,1995.0,13.1,24,12,9,14,1,14,40,35.0,26,21,0,21,6,30,9,0,FW,25-29,Forward,Spain,Europe
319745,Dani Ceballos,ESP,Arsenal,Premier League,2020,23.0,1996.0,17.9,37,22,20,11,6,21,51,41.2,30,23,6,17,35,72,14,1,MF,20-24,Midfielder,Spain,Europe
193784,Carlos Clerc,ESP,Levante,La Liga,2020,28.0,1992.0,30.9,56,29,33,16,7,22,39,56.4,17,26,4,22,37,93,55,1,DF,25-29,Defender,Spain,Europe
71905,Coke,ESP,Levante,La Liga,2020,33.0,1987.0,9.3,24,10,14,7,3,14,27,51.9,13,13,1,12,14,38,27,0,DF,30-34,Defender,Spain,Europe
546212,Diego Costa,ESP,Atltico Madrid,La Liga,2020,31.0,1988.0,2.3,1,0,1,0,0,1,3,33.3,2,0,0,0,0,1,2,0,FW,30-34,Forward,Spain,Europe
157672,Vladimr Coufal,CZE,West Ham,Premier League,2020,27.0,1992.0,33.9,73,36,50,15,8,52,89,58.4,37,41,7,34,41,114,102,1,DF,25-29,Defender,Czech Republic,Europe
158764,Stuart Dallas,NIR,Leeds United,Premier League,2020,29.0,1991.0,37.9,74,45,46,22,6,30,88,34.1,58,41,3,38,44,118,52,1,"MF,DF",25-29,Midfielder,Northern Ireland,Europe
248732,Pawe Dawidowicz,POL,Hellas Verona,Serie A,2020,25.0,1995.0,20.7,42,28,30,10,2,14,24,58.3,10,28,19,9,27,69,62,1,DF,25-29,Defender,Poland,Europe
129476,Gerard Deulofeu,ESP,Udinese,Serie A,2020,26.0,1994.0,6.6,2,2,1,1,0,2,12,16.7,10,2,0,2,3,5,0,0,"FW,MF",25-29,Forward,Spain,Europe
58330,Vctor Daz,ESP,Granada,La Liga,2020,32.0,1988.0,9.2,21,10,13,6,2,10,19,52.6,9,14,8,6,16,37,39,0,DF,30-34,Defender,Spain,Europe
177046,Rubn Duarte,ESP,Alavs,La Liga,2020,24.0,1995.0,28.3,55,30,28,21,6,23,52,44.2,29,44,6,38,66,121,72,0,DF,20-24,Defender,Spain,Europe
229804,Aritz Elustondo,ESP,Real Sociedad,La Liga,2020,26.0,1994.0,20.9,30,16,21,7,2,18,22,81.8,4,12,5,7,15,45,63,0,DF,25-29,Defender,Spain,Europe
81988,Sergi Enrich,ESP,Eibar,La Liga,2020,30.0,1990.0,15.6,21,15,6,7,8,9,22,40.9,13,11,0,11,6,27,5,0,FW,30-34,Forward,Spain,Europe
531829,Dani Escriche,ESP,Huesca,La Liga,2020,22.0,1998.0,9.5,9,7,5,2,2,3,10,30.0,7,11,0,11,8,17,5,0,"FW,MF",20-24,Forward,Spain,Europe
93935,Sergio Escudero,ESP,Sevilla,La Liga,2020,30.0,1989.0,6.3,12,8,6,5,1,6,12,50.0,6,5,2,3,9,21,7,0,DF,30-34,Defender,Spain,Europe
42412,Jonny Evans,NIR,Leicester City,Premier League,2020,32.0,1988.0,27.5,25,12,22,2,1,14,20,70.0,6,8,3,5,46,71,98,1,DF,30-34,Defender,Northern Ireland,Europe
506248,Edu Expsito,ESP,Eibar,La Liga,2020,23.0,1996.0,27.3,51,30,16,31,4,20,66,30.3,46,25,4,21,22,73,17,0,MF,20-24,Midfielder,Spain,Europe
8806,Cesc Fbregas,ESP,Monaco,Ligue 1,2020,33.0,1987.0,9.7,20,12,6,9,5,9,22,40.9,13,11,1,10,13,33,3,0,"MF,FW",30-34,Midfielder,Spain,Europe
252667,Fali,ESP,Cdiz,La Liga,2020,26.0,1993.0,29.3,42,25,24,15,3,16,37,43.2,21,28,15,13,32,74,119,0,"DF,MF",25-29,Defender,Spain,Europe
59340,Iago Falque,ESP,Benevento,Serie A,2020,30.0,1990.0,4.0,4,2,2,2,0,1,6,16.7,5,4,1,3,0,4,1,0,"MF,FW",30-34,Midfielder,Spain,Europe
466810,Ansu Fati,ESP,Barcelona,La Liga,2020,17.0,2002.0,4.8,9,4,2,4,3,2,10,20.0,8,4,0,4,3,12,1,0,FW,Under 20,Forward,Spain,Europe
89733,lex Fernndez,ESP,Cdiz,La Liga,2020,27.0,1992.0,21.6,19,9,8,8,3,8,30,26.7,22,14,1,13,22,41,15,0,MF,25-29,Midfielder,Spain,Europe
71918,David Ferreiro,ESP,Huesca,La Liga,2020,32.0,1988.0,28.1,25,12,12,8,5,8,49,16.3,41,21,1,20,25,50,15,0,"MF,FW",30-34,Midfielder,Spain,Europe
149231,Fidel,ESP,Elche,La Liga,2020,30.0,1989.0,26.6,46,30,28,15,3,25,64,39.1,39,22,2,20,16,62,14,0,"MF,DF",30-34,Midfielder,Spain,Europe
357885,Pablo Fornals,ESP,West Ham,Premier League,2020,24.0,1996.0,28.6,44,26,14,24,6,11,73,15.1,62,43,1,42,36,80,9,0,"FW,MF",20-24,Forward,Spain,Europe
455181,Jorge de Frutos,ESP,Levante,La Liga,2020,23.0,1997.0,24.3,48,24,21,21,6,11,41,26.8,30,25,2,23,16,64,18,0,MF,20-24,Midfielder,Spain,Europe
448628,Javi Galn,ESP,Huesca,La Liga,2020,25.0,1994.0,34.1,88,54,47,35,6,46,72,63.9,26,30,4,26,39,127,61,0,DF,25-29,Defender,Spain,Europe
114060,Enric Gallego,ESP,Osasuna,La Liga,2020,33.0,1986.0,9.0,6,3,2,2,2,2,14,14.3,12,5,1,4,1,7,9,0,FW,30-34,Forward,Spain,Europe
261504,Aleix Garca,ESP,Eibar,La Liga,2020,23.0,1997.0,4.9,5,4,2,2,1,1,10,10.0,9,5,0,5,8,13,2,0,MF,20-24,Midfielder,Spain,Europe
67808,Borja Garca,ESP,Huesca,La Liga,2020,29.0,1990.0,12.4,13,7,4,6,3,6,12,50.0,6,12,0,12,10,23,4,1,"MF,FW",25-29,Midfielder,Spain,Europe
298589,David Garca,ESP,Osasuna,La Liga,2020,26.0,1994.0,35.0,26,17,13,13,0,13,24,54.2,11,36,19,17,59,85,171,0,DF,25-29,Defender,Spain,Europe
361238,Rubn Garca,ESP,Osasuna,La Liga,2020,27.0,1993.0,30.2,50,29,21,22,7,14,45,31.1,31,28,2,26,29,79,20,0,"MF,FW",25-29,Midfielder,Spain,Europe
60632,Theodor Gebre Selassie,CZE,Werder Bremen,Bundesliga,2020,33.0,1986.0,33.7,61,35,39,17,5,28,64,43.8,36,33,11,22,58,119,98,1,DF,30-34,Defender,Czech Republic,Europe
57935,lvaro Gimnez,ESP,Cdiz,La Liga,2020,29.0,1991.0,4.5,4,2,2,2,0,0,3,0.0,3,2,0,2,2,6,3,0,FW,25-29,Forward,Spain,Europe
46552,Kamil Glik,POL,Benevento,Serie A,2020,32.0,1988.0,35.6,44,24,33,10,1,25,53,47.2,28,37,31,6,62,106,153,0,DF,30-34,Defender,Poland,Europe
422460,Dani Gmez,ESP,Levante,La Liga,2020,22.0,1998.0,18.5,4,3,2,1,1,0,11,0.0,11,3,0,3,2,6,4,0,FW,20-24,Forward,Spain,Europe
175449,Moi Gmez,ESP,Villarreal,La Liga,2020,26.0,1994.0,28.5,21,12,6,8,7,14,35,40.0,21,20,3,17,11,32,16,0,"MF,FW",25-29,Midfielder,Spain,Europe
366930,Sergio Gmez,ESP,Huesca,La Liga,2020,19.0,2000.0,8.8,29,10,17,9,3,11,22,50.0,11,15,0,15,14,43,9,0,"MF,FW",Under 20,Midfielder,Spain,Europe
183647,lvaro Gonzlez,ESP,Marseille,Ligue 1,2020,30.0,1990.0,31.5,26,17,20,6,0,19,31,61.3,12,30,18,12,33,59,119,1,DF,30-34,Defender,Spain,Europe
188838,Bruno Gonzlez,ESP,Valladolid,La Liga,2020,30.0,1990.0,25.1,26,17,18,8,0,17,31,54.8,14,22,14,8,37,63,112,1,DF,30-34,Defender,Spain,Europe
873981,Diego Gonzlez,ESP,Elche,La Liga,2020,25.0,1995.0,14.2,11,7,7,3,1,5,11,45.5,6,16,9,7,20,31,49,1,DF,25-29,Defender,Spain,Europe
289255,Andoni Gorosabel,ESP,Real Sociedad,La Liga,2020,23.0,1996.0,26.5,76,43,45,20,11,27,64,42.2,37,25,4,21,23,99,42,0,DF,20-24,Defender,Spain,Europe
256429,Sergi Guardiola,ESP,Valladolid,La Liga,2020,29.0,1991.0,19.9,11,5,1,5,5,2,27,7.4,25,12,1,11,7,18,16,3,FW,25-29,Forward,Spain,Europe
74294,Nemanja Gudelj,SRB,Sevilla,La Liga,2020,28.0,1991.0,11.6,23,12,16,5,2,4,10,40.0,6,10,6,4,24,47,24,2,"MF,DF",25-29,Midfielder,Serbia,Europe
465967,Ander Guevara,ESP,Real Sociedad,La Liga,2020,23.0,1997.0,23.1,35,23,15,16,4,15,30,50.0,15,19,5,14,25,60,35,1,MF,20-24,Midfielder,Spain,Europe
495629,Hugo Guillamn,ESP,Valencia,La Liga,2020,20.0,2000.0,22.1,23,13,17,6,0,8,20,40.0,12,19,14,5,27,50,102,3,DF,20-24,Defender,Spain,Europe
289257,Jon Guridi,ESP,Real Sociedad,La Liga,2020,25.0,1995.0,9.2,19,9,10,6,3,8,22,36.4,14,8,1,7,10,29,9,0,MF,25-29,Midfielder,Spain,Europe
418560,Erling Haaland,NOR,Dortmund,Bundesliga,2020,20.0,2000.0,26.7,7,2,1,3,3,1,4,25.0,3,19,4,15,4,11,16,0,FW,20-24,Forward,Norway,Europe
91763,Pablo Hernndez,ESP,Leeds United,Premier League,2020,35.0,1985.0,4.7,5,3,2,1,2,5,16,31.3,11,2,0,2,0,5,0,1,MF,35-39,Midfielder,Spain,Europe
99343,Ander Herrera,ESP,Paris S-G,Ligue 1,2020,30.0,1989.0,20.6,53,35,17,26,10,30,77,39.0,47,31,5,26,31,84,22,1,MF,30-34,Midfielder,Spain,Europe
142027,Pablo Hervas,ESP,Valladolid,La Liga,2020,27.0,1993.0,13.4,19,12,7,9,3,9,26,34.6,17,6,0,6,11,30,8,0,"DF,MF",25-29,Defender,Spain,Europe
278359,Borja Iglesias,ESP,Betis,La Liga,2020,27.0,1993.0,15.7,1,1,0,0,1,1,8,12.5,7,7,2,5,3,4,9,0,FW,25-29,Forward,Spain,Europe
470794,Ivan Ili,SRB,Hellas Verona,Serie A,2020,19.0,2001.0,20.4,26,14,11,11,4,7,21,33.3,14,17,5,12,27,53,26,0,MF,Under 20,Midfielder,Serbia,Europe
85288,Isco,ESP,Real Madrid,La Liga,2020,28.0,1992.0,10.1,13,9,5,5,3,2,14,14.3,12,7,1,6,2,15,2,0,MF,25-29,Midfielder,Spain,Europe
337946,Jairo Izquierdo,ESP,Cdiz,La Liga,2020,26.0,1993.0,14.2,21,13,13,8,0,12,31,38.7,19,7,1,6,14,35,12,0,"MF,DF",25-29,Midfielder,Spain,Europe
319160,Jakub Jankto,CZE,Sampdoria,Serie A,2020,24.0,1996.0,26.8,28,17,14,7,7,11,35,31.4,24,16,1,15,24,52,34,0,MF,20-24,Midfielder,Czech Republic,Europe
7663,Joaqun,ESP,Betis,La Liga,2020,39.0,1981.0,14.3,9,3,1,5,3,4,12,33.3,8,8,0,8,17,26,11,0,"FW,MF",35-39,Forward,Spain,Europe
228761,Jony,ESP,Osasuna,La Liga,2020,29.0,1991.0,9.7,7,3,1,2,4,5,20,25.0,15,5,0,5,14,21,3,0,"MF,FW",25-29,Midfielder,Spain,Europe
263727,Joan Jordn,ESP,Sevilla,La Liga,2020,26.0,1994.0,26.7,52,28,17,29,6,17,76,22.4,59,22,3,19,27,79,25,0,MF,25-29,Midfielder,Spain,Europe
277533,Josan,ESP,Elche,La Liga,2020,30.0,1989.0,21.4,34,18,23,11,0,13,39,33.3,26,24,1,23,21,55,26,1,"MF,DF",30-34,Midfielder,Spain,Europe
81999,Joselu,ESP,Alavs,La Liga,2020,30.0,1990.0,33.6,27,14,6,15,6,8,28,28.6,20,26,3,23,15,42,58,1,FW,30-34,Forward,Spain,Europe
126737,Juanmi,ESP,Betis,La Liga,2020,27.0,1993.0,6.7,13,9,3,5,5,4,18,22.2,14,4,0,4,2,15,4,0,"FW,MF",25-29,Forward,Spain,Europe
53418,Kevin Kampl,SVN,RB Leipzig,Bundesliga,2020,29.0,1990.0,21.5,38,26,9,24,5,18,35,51.4,17,20,2,18,29,67,14,0,MF,25-29,Midfielder,Slovenia,Europe
74229,Koke,ESP,Atltico Madrid,La Liga,2020,28.0,1992.0,33.6,64,42,22,31,11,28,98,28.6,70,35,6,29,36,100,40,0,MF,25-29,Midfielder,Spain,Europe
46156,Aleksandar Kolarov,SRB,Inter,Serie A,2020,34.0,1985.0,4.3,4,4,0,4,0,1,2,50.0,1,2,0,2,7,11,8,0,DF,30-34,Defender,Serbia,Europe
176553,Aymeric Laporte,ESP,Manchester City,Premier League,2020,26.0,1994.0,14.9,13,6,10,3,0,7,11,63.6,4,12,7,5,11,24,28,0,DF,25-29,Defender,Spain,Europe
320271,Toni Lato,ESP,Valencia,La Liga,2020,22.0,1997.0,8.1,13,6,7,3,3,6,13,46.2,7,12,1,11,10,23,21,0,DF,20-24,Defender,Spain,Europe
70411,Darko Lazovi,SRB,Hellas Verona,Serie A,2020,29.0,1990.0,27.8,29,17,8,17,4,20,42,47.6,22,17,7,10,20,49,29,0,"DF,MF",25-29,Defender,Serbia,Europe
255501,Iigo Lekue,ESP,Athletic Club,La Liga,2020,27.0,1993.0,7.2,9,7,6,3,0,3,8,37.5,5,8,1,7,4,13,24,0,DF,25-29,Defender,Spain,Europe
145769,Sergio Len,ESP,Levante,La Liga,2020,31.0,1989.0,8.3,6,2,0,4,2,2,8,25.0,6,4,0,4,3,9,2,0,FW,30-34,Forward,Spain,Europe
346018,Jamal Lewis,NIR,Newcastle Utd,Premier League,2020,22.0,1998.0,20.4,37,20,23,13,1,16,38,42.1,22,21,7,14,11,48,44,1,DF,20-24,Defender,Northern Ireland,Europe
225873,Karol Linetty,POL,Torino,Serie A,2020,25.0,1995.0,20.4,38,28,13,19,6,16,45,35.6,29,19,5,14,15,53,7,0,MF,25-29,Midfielder,Poland,Europe
45383,Adrin Lpez,ESP,Osasuna,La Liga,2020,32.0,1988.0,5.3,3,3,0,1,2,1,5,20.0,4,3,0,3,0,3,3,0,"FW,MF",30-34,Forward,Spain,Europe
568158,Javi Lpez,ESP,Alavs,La Liga,2020,18.0,2002.0,2.8,5,5,3,2,0,2,3,66.7,1,2,0,2,3,8,3,1,"DF,MF",Under 20,Defender,Spain,Europe
192009,Unai Lpez,ESP,Athletic Club,La Liga,2020,24.0,1995.0,15.8,27,17,13,13,1,10,29,34.5,19,20,5,15,18,45,9,1,MF,20-24,Midfielder,Spain,Europe
252677,Jos Luis Morales,ESP,Levante,La Liga,2020,33.0,1987.0,27.1,18,10,7,9,2,8,36,22.2,28,17,0,17,11,29,11,0,"MF,FW",30-34,Midfielder,Spain,Europe
245056,Saa Luki,SRB,Torino,Serie A,2020,23.0,1996.0,23.4,32,13,11,18,3,15,50,30.0,35,23,5,18,17,49,17,0,MF,20-24,Midfielder,Serbia,Europe
251876,Pablo Maffeo,ESP,Huesca,La Liga,2020,23.0,1997.0,21.8,26,17,21,4,1,12,26,46.2,14,18,6,12,35,61,27,0,DF,20-24,Defender,Spain,Europe
124715,Nikola Maksimovi,SRB,Napoli,Serie A,2020,28.0,1991.0,13.4,18,9,11,6,1,9,18,50.0,9,15,6,9,21,39,49,3,DF,25-29,Defender,Serbia,Europe
225462,Jos Mari,ESP,Cdiz,La Liga,2020,32.0,1987.0,16.1,32,17,13,18,1,14,31,45.2,17,16,7,9,27,59,33,1,MF,30-34,Midfielder,Spain,Europe
212391,Roger Mart,ESP,Levante,La Liga,2020,29.0,1991.0,24.4,11,7,5,4,2,6,23,26.1,17,10,3,7,4,15,6,0,FW,25-29,Forward,Spain,Europe
158863,Iigo Martnez,ESP,Athletic Club,La Liga,2020,29.0,1991.0,28.0,22,15,16,6,0,9,27,33.3,18,17,7,10,28,50,96,0,DF,25-29,Defender,Spain,Europe
227961,Jaime Mata,ESP,Getafe,La Liga,2020,31.0,1988.0,22.6,12,7,1,3,8,3,18,16.7,15,13,2,11,6,18,16,0,FW,30-34,Forward,Spain,Europe
162056,Gonzalo Melero,ESP,Levante,La Liga,2020,26.0,1994.0,20.6,24,15,11,6,7,10,39,25.6,29,14,5,9,18,42,22,1,"MF,FW",25-29,Midfielder,Spain,Europe
309110,Brais Mndez,ESP,Celta Vigo,La Liga,2020,23.0,1997.0,29.7,59,31,23,27,9,16,65,24.6,49,27,2,25,32,91,34,0,"MF,FW",20-24,Midfielder,Spain,Europe
202984,Roque Mesa,ESP,Valladolid,La Liga,2020,31.0,1989.0,19.6,46,29,18,24,4,20,47,42.6,27,11,2,9,14,60,23,1,MF,30-34,Midfielder,Spain,Europe
413507,Nikola Milenkovi,SRB,Fiorentina,Serie A,2020,22.0,1997.0,33.7,49,29,33,14,2,21,33,63.6,12,42,33,9,44,93,122,1,DF,20-24,Defender,Serbia,Europe
191891,Arkadiusz Milik,POL,Marseille,Ligue 1,2020,26.0,1994.0,13.6,14,9,0,7,7,2,12,16.7,10,5,1,4,2,16,9,0,FW,25-29,Forward,Poland,Europe
266302,Sergej Milinkovi-Savi,SRB,Lazio,Serie A,2020,25.0,1995.0,30.5,59,40,20,30,9,27,84,32.1,57,52,12,40,33,92,47,0,MF,25-29,Midfielder,Serbia,Europe
281989,Luis Milla,ESP,Granada,La Liga,2020,25.0,1994.0,13.9,22,11,11,10,1,6,28,21.4,22,10,0,10,24,46,16,1,MF,25-29,Midfielder,Spain,Europe
225593,Pere Milla,ESP,Elche,La Liga,2020,27.0,1992.0,22.0,24,17,12,10,2,8,37,21.6,29,17,5,12,13,37,17,1,"FW,MF",25-29,Forward,Spain,Europe
255653,Santi Mina,ESP,Celta Vigo,La Liga,2020,24.0,1995.0,26.8,31,13,9,12,10,6,37,16.2,31,15,3,12,6,37,17,0,FW,20-24,Forward,Spain,Europe
331505,scar Mingueza,ESP,Barcelona,La Liga,2020,21.0,1999.0,21.1,52,33,28,17,7,30,53,56.6,23,19,6,13,20,72,48,2,DF,20-24,Defender,Spain,Europe
361254,Rafa Mir,ESP,Huesca,La Liga,2020,23.0,1997.0,32.0,15,9,4,4,7,7,22,31.8,15,14,2,12,15,30,25,0,FW,20-24,Forward,Spain,Europe
341227,Juan Miranda,ESP,Betis,La Liga,2020,20.0,2000.0,18.4,27,11,16,9,2,16,32,50.0,16,18,2,16,29,56,58,1,DF,20-24,Defender,Spain,Europe
51152,Aleksandar Mitrovi,SRB,Fulham,Premier League,2020,25.0,1994.0,15.6,7,4,0,3,4,2,8,25.0,6,12,3,9,3,10,8,0,FW,25-29,Forward,Serbia,Europe
57825,Jorge Molina,ESP,Granada,La Liga,2020,38.0,1982.0,17.9,11,4,3,5,3,8,22,36.4,14,5,1,4,3,14,19,0,FW,35-39,Forward,Spain,Europe
552425,Jon Moncayola,ESP,Osasuna,La Liga,2020,22.0,1998.0,29.6,61,36,27,23,11,24,67,35.8,43,27,9,18,23,84,38,0,MF,20-24,Midfielder,Spain,Europe
43003,Nacho Monreal,ESP,Real Sociedad,La Liga,2020,34.0,1986.0,23.1,31,19,17,11,3,7,20,35.0,13,14,3,11,31,62,43,0,DF,30-34,Defender,Spain,Europe
59551,ngel Montoro,ESP,Granada,La Liga,2020,32.0,1988.0,15.1,15,9,7,7,1,4,16,25.0,12,13,3,10,22,37,21,0,MF,30-34,Midfielder,Spain,Europe
455349,Jon Morcillo,ESP,Athletic Club,La Liga,2020,21.0,1998.0,15.1,16,9,3,6,7,7,30,23.3,23,9,0,9,15,31,11,0,"MF,FW",20-24,Midfielder,Spain,Europe
193098,lex Moreno,ESP,Betis,La Liga,2020,27.0,1993.0,19.8,42,26,25,12,5,20,43,46.5,23,18,4,14,35,77,48,0,DF,25-29,Defender,Spain,Europe
177467,Gerard Moreno,ESP,Villarreal,La Liga,2020,28.0,1992.0,29.7,24,15,8,10,6,7,34,20.6,27,17,4,13,15,39,26,0,FW,25-29,Forward,Spain,Europe
339816,Tete Morente,ESP,Elche,La Liga,2020,23.0,1996.0,22.4,31,17,17,9,5,9,39,23.1,30,20,0,20,13,44,28,0,"MF,FW",20-24,Midfielder,Spain,Europe
54235,Iker Muniain,ESP,Athletic Club,La Liga,2020,27.0,1992.0,21.6,20,7,4,10,6,6,24,25.0,18,15,0,15,11,31,4,0,"MF,FW",25-29,Midfielder,Spain,Europe
517842,Aihen Muoz,ESP,Real Sociedad,La Liga,2020,22.0,1997.0,13.4,23,16,15,5,3,11,19,57.9,8,12,2,10,10,33,31,0,DF,20-24,Defender,Spain,Europe
396334,Joaqun Muoz,ESP,Huesca,La Liga,2020,21.0,1999.0,0.5,0,0,0,0,0,0,2,0.0,2,0,0,0,1,1,0,0,FW,20-24,Forward,Spain,Europe
15956,Jess Navas,ESP,Sevilla,La Liga,2020,34.0,1985.0,31.4,27,21,15,11,1,15,22,68.2,7,10,3,7,37,64,62,1,DF,30-34,Defender,Spain,Europe
18644,lvaro Negredo,ESP,Cdiz,La Liga,2020,34.0,1985.0,24.4,11,5,3,4,4,5,11,45.5,6,7,2,5,3,14,19,0,FW,30-34,Forward,Spain,Europe
448844,Carlos Neva,ESP,Granada,La Liga,2020,24.0,1996.0,20.0,12,6,6,6,0,6,11,54.5,5,16,4,12,27,39,58,0,DF,20-24,Defender,Spain,Europe
148928,Sal guez,ESP,Atltico Madrid,La Liga,2020,25.0,1994.0,22.6,57,34,27,23,7,30,59,50.8,29,35,2,33,19,76,43,0,"MF,DF",25-29,Midfielder,Spain,Europe
520454,Nino,ESP,Elche,La Liga,2020,40.0,1980.0,3.2,0,0,0,0,0,0,1,0.0,1,1,0,1,0,0,0,0,"FW,MF",Over 40,Forward,Spain,Europe
70934,Nolito,ESP,Celta Vigo,La Liga,2020,33.0,1986.0,28.9,70,36,30,30,10,32,92,34.8,60,46,2,44,22,92,19,0,"MF,FW",30-34,Midfielder,Spain,Europe
73547,Oliver Norwood,NIR,Sheffield Utd,Premier League,2020,29.0,1991.0,24.7,49,22,16,28,5,21,72,29.2,51,29,12,17,36,85,51,1,MF,25-29,Midfielder,Northern Ireland,Europe
338285,Unai Nez,ESP,Athletic Club,La Liga,2020,23.0,1997.0,23.4,23,12,16,7,0,10,15,66.7,5,19,14,5,32,55,110,0,DF,20-24,Defender,Spain,Europe
280730,lvaro Odriozola,ESP,Real Madrid,La Liga,2020,24.0,1995.0,9.2,14,7,5,8,1,3,5,60.0,2,6,3,3,6,20,12,1,DF,20-24,Defender,Spain,Europe
293385,Dani Olmo,ESP,RB Leipzig,Bundesliga,2020,22.0,1998.0,24.4,23,14,6,13,4,4,23,17.4,19,15,0,15,13,36,21,0,MF,20-24,Midfielder,Spain,Europe
356197,Alfonso Pedraza,ESP,Villarreal,La Liga,2020,24.0,1996.0,23.3,35,19,16,11,8,11,31,35.5,20,21,5,16,34,69,47,1,DF,20-24,Defender,Spain,Europe
683840,Pedri,ESP,Barcelona,La Liga,2020,17.0,2002.0,26.8,44,27,16,16,12,17,71,23.9,54,46,1,45,33,77,7,0,MF,Under 20,Midfielder,Spain,Europe
1004741,Pedro,ESP,Roma,Serie A,2020,33.0,1987.0,17.7,22,14,6,11,5,7,35,20.0,28,10,0,10,9,31,2,1,"MF,FW",30-34,Midfielder,Spain,Europe
238868,Rubn Pea,ESP,Villarreal,La Liga,2020,29.0,1991.0,12.4,25,14,8,15,2,19,33,57.6,14,20,1,19,13,38,19,0,DF,25-29,Defender,Spain,Europe
99559,Alberto Perea,ESP,Cdiz,La Liga,2020,29.0,1990.0,17.2,28,17,12,10,6,9,35,25.7,26,26,1,25,21,49,9,0,MF,25-29,Midfielder,Spain,Europe
318523,Romain Perraud,FRA,Brest,Ligue 1,2020,22.0,1997.0,34.9,60,34,42,16,2,24,45,53.3,21,36,3,33,45,105,76,0,DF,20-24,Defender,France,Europe
199258,Andrea Petagna,ITA,Napoli,Serie A,2020,25.0,1995.0,10.7,2,0,0,2,0,2,7,28.6,5,4,0,4,1,3,7,0,FW,25-29,Forward,Italy,Europe
42936,Nils Petersen,GER,Freiburg,Bundesliga,2020,31.0,1988.0,14.5,11,7,2,6,3,3,21,14.3,18,25,1,24,9,20,28,0,FW,30-34,Forward,Germany,Europe
218067,Jacopo Petriccione,ITA,Crotone,Serie A,2020,25.0,1995.0,10.6,14,8,6,7,1,9,24,37.5,15,11,2,9,8,22,11,0,MF,25-29,Midfielder,Italy,Europe
113133,Germn Pezzella,ARG,Fiorentina,Serie A,2020,29.0,1991.0,30.5,34,20,22,12,0,18,32,56.3,14,26,14,12,36,70,109,1,DF,25-29,Defender,Argentina,South America
336960,Giuseppe Pezzella,ITA,Parma,Serie A,2020,22.0,1997.0,20.3,34,19,23,9,2,22,41,53.7,19,22,9,13,12,46,52,3,DF,20-24,Defender,Italy,Europe
351749,Kalvin Phillips,ENG,Leeds United,Premier League,2020,24.0,1995.0,27.0,74,38,38,29,7,26,62,41.9,36,49,14,35,45,119,53,3,MF,20-24,Midfielder,England,Europe
371814,Nathaniel Phillips,ENG,Liverpool,Premier League,2020,23.0,1997.0,16.2,22,14,15,7,0,11,24,45.8,13,17,14,3,20,42,81,0,DF,20-24,Defender,England,Europe
56067,Pablo Piatti,ARG,Elche,La Liga,2020,31.0,1989.0,4.0,8,6,3,3,2,3,12,25.0,9,5,0,5,2,10,1,0,"MF,FW",30-34,Midfielder,Argentina,South America
60583,Jrmy Pied,FRA,Lille,Ligue 1,2020,31.0,1989.0,3.5,7,0,3,3,1,4,9,44.4,5,3,1,2,6,13,8,0,DF,30-34,Defender,France,Europe
334221,Amos Pieper,GER,Arminia,Bundesliga,2020,22.0,1998.0,29.8,58,32,39,17,2,20,33,60.6,13,48,35,13,66,124,160,3,DF,20-24,Defender,Germany,Europe
410185,Ronal Pierre-Gabriel,FRA,Brest,Ligue 1,2020,22.0,1998.0,25.6,60,40,42,16,2,35,52,67.3,17,17,7,10,30,90,57,0,DF,20-24,Defender,France,Europe
43763,Erik Pieters,NED,Burnley,Premier League,2020,31.0,1988.0,14.1,30,21,18,9,3,19,39,48.7,20,30,9,21,12,42,34,0,"DF,MF",30-34,Defender,Netherlands,Europe
167329,Alassane Pla,FRA,Gladbach,Bundesliga,2020,27.0,1993.0,20.0,19,9,4,10,5,5,20,25.0,15,1,0,1,5,24,7,0,FW,25-29,Forward,France,Europe
392538,Tommaso Pobega,ITA,Spezia,Serie A,2020,21.0,1999.0,13.7,24,13,7,13,4,11,31,35.5,20,10,2,8,9,33,22,0,MF,20-24,Midfielder,Italy,Europe
122153,Paul Pogba,FRA,Manchester Utd,Premier League,2020,27.0,1993.0,21.1,36,26,15,16,5,11,33,33.3,22,24,2,22,26,62,37,0,"MF,FW",25-29,Midfielder,France,Europe
223974,Stefan Posch,AUT,Hoffenheim,Bundesliga,2020,23.0,1997.0,23.5,52,24,29,17,6,27,47,57.4,20,27,8,19,37,89,73,1,DF,20-24,Defender,Austria,Europe
157635,Yussuf Poulsen,DEN,RB Leipzig,Bundesliga,2020,26.0,1994.0,15.0,10,6,1,6,3,1,17,5.9,16,16,0,16,6,16,13,0,FW,25-29,Forward,Denmark,Europe
392763,Ian Poveda,ENG,Leeds United,Premier League,2020,20.0,2000.0,3.9,5,4,3,0,2,1,7,14.3,6,5,1,4,1,6,2,0,MF,20-24,Midfielder,England,Europe
122116,Nicolas de Prville,FRA,Bordeaux,Ligue 1,2020,29.0,1991.0,17.9,19,14,7,6,6,9,42,21.4,33,15,0,15,13,32,7,0,"FW,MF",25-29,Forward,France,Europe
234029,Grischa Prmel,GER,Union Berlin,Bundesliga,2020,25.0,1995.0,20.2,39,23,14,23,2,18,34,52.9,16,20,2,18,24,63,22,0,MF,25-29,Midfielder,Germany,Europe
215616,Erick Pulgar,CHI,Fiorentina,Serie A,2020,26.0,1994.0,22.2,41,18,17,23,1,22,49,44.9,27,24,10,14,41,82,45,1,MF,25-29,Midfielder,Chile,South America
315779,Christian Pulisic,USA,Chelsea,Premier League,2020,21.0,1998.0,19.3,19,11,8,10,1,8,21,38.1,13,25,2,23,12,31,9,0,"FW,MF",20-24,Forward,United States,North America
283528,Ignacio Pussetto,ARG,Udinese,Serie A,2020,24.0,1995.0,8.4,16,8,5,6,5,6,17,35.3,11,14,0,14,13,29,6,0,FW,20-24,Forward,Argentina,South America
22328,Fabio Quagliarella,ITA,Sampdoria,Serie A,2020,37.0,1983.0,24.5,12,8,4,4,4,2,19,10.5,17,14,1,13,7,19,10,0,FW,35-39,Forward,Italy,Europe
391719,Domingos Quina,POR,Granada,La Liga,2020,20.0,1999.0,3.8,5,5,1,3,1,3,6,50.0,3,8,0,8,2,7,0,0,MF,20-24,Midfielder,Portugal,Europe
182913,Adrien Rabiot,FRA,Juventus,Serie A,2020,25.0,1995.0,25.7,72,42,24,41,7,28,60,46.7,32,32,11,21,43,115,29,1,MF,25-29,Midfielder,France,Europe
205022,Rafinha,BRA,Paris S-G,Ligue 1,2020,27.0,1993.0,15.1,54,26,18,28,8,28,49,57.1,21,18,3,15,13,67,6,0,"MF,FW",25-29,Midfielder,Brazil,South America
123742,Gastn Ramrez,URU,Sampdoria,Serie A,2020,29.0,1990.0,10.8,31,15,10,17,4,8,27,29.6,19,19,3,16,4,35,13,0,"FW,MF",25-29,Forward,Uruguay,South America
646658,Aaron Ramsey,WAL,Juventus,Serie A,2020,29.0,1990.0,12.1,22,14,8,13,1,8,25,32.0,17,13,2,11,7,29,8,2,MF,25-29,Midfielder,Wales,Europe
503749,Jacob Ramsey,ENG,Aston Villa,Premier League,2020,19.0,2001.0,7.0,10,5,3,4,3,2,12,16.7,10,13,6,7,4,14,5,0,MF,Under 20,Midfielder,England,Europe
405885,Giacomo Raspadori,ITA,Sassuolo,Serie A,2020,20.0,2000.0,13.7,5,3,1,1,3,0,4,0.0,4,13,5,8,2,7,9,0,"FW,MF",20-24,Forward,Italy,Europe
187587,Ante Rebi,CRO,Milan,Serie A,2020,26.0,1993.0,19.7,26,9,4,8,14,8,37,21.6,29,21,1,20,7,33,17,0,FW,25-29,Forward,Croatia,Europe
129078,Nathan Redmond,ENG,Southampton,Premier League,2020,26.0,1994.0,19.3,30,17,14,12,4,8,24,33.3,16,24,2,22,11,41,9,0,"MF,FW",25-29,Midfielder,England,Europe
226973,Harrison Reed,ENG,Fulham,Premier League,2020,25.0,1995.0,25.0,63,38,28,28,7,29,73,39.7,44,34,11,23,50,113,31,1,MF,25-29,Midfielder,England,Europe
190786,Baptiste Reynet,FRA,Nmes,Ligue 1,2020,29.0,1990.0,38.0,2,1,2,0,0,2,4,50.0,2,1,0,1,1,3,9,2,GK,25-29,Goalkeeper,France,Europe
22068,Franck Ribry,FRA,Fiorentina,Serie A,2020,37.0,1983.0,23.9,24,11,4,9,11,5,29,17.2,24,11,2,9,3,27,1,0,FW,35-39,Forward,France,Europe
357662,Declan Rice,ENG,West Ham,Premier League,2020,21.0,1999.0,32.0,59,35,33,25,1,21,51,41.2,30,39,11,28,59,118,41,0,MF,20-24,Midfielder,England,Europe
75942,Toms Rincn,VEN,Torino,Serie A,2020,32.0,1988.0,31.6,68,38,27,33,8,36,71,50.7,35,32,7,25,31,99,44,0,MF,30-34,Midfielder,Venezuela,South America
74448,Andrea Rispoli,ITA,Crotone,Serie A,2020,31.0,1988.0,7.2,6,3,2,3,1,2,7,28.6,5,12,3,9,5,11,15,1,DF,30-34,Defender,Italy,Europe
61637,Emmanuel Rivire,FRA,Crotone,Serie A,2020,30.0,1990.0,7.1,2,1,2,0,0,0,3,0.0,3,5,1,4,1,3,0,0,FW,30-34,Forward,France,Europe
296986,Tyler Roberts,WAL,Leeds United,Premier League,2020,21.0,1999.0,14.9,15,13,1,11,3,5,22,22.7,17,17,2,15,9,24,12,0,"MF,FW",20-24,Midfielder,Wales,Europe
234803,Andrew Robertson,SCO,Liverpool,Premier League,2020,26.0,1994.0,37.6,46,34,23,18,5,28,57,49.1,29,39,9,30,21,67,79,1,DF,25-29,Defender,Scotland,Europe
349701,Antonee Robinson,USA,Fulham,Premier League,2020,22.0,1997.0,24.0,45,28,24,16,5,27,44,61.4,17,21,4,17,37,82,68,0,DF,20-24,Defender,United States,North America
183299,Callum Robinson,IRL,West Brom,Premier League,2020,25.0,1995.0,17.3,7,5,5,1,1,3,19,15.8,16,9,0,9,7,14,8,0,"FW,MF",25-29,Forward,Republic of Ireland,Europe
65976,Hal Robson-Kanu,WAL,West Brom,Premier League,2020,31.0,1989.0,6.2,2,1,1,0,1,0,1,0.0,1,2,0,2,2,4,7,0,FW,30-34,Forward,Wales,Europe
44466,Sebastian Rode,GER,Eint Frankfurt,Bundesliga,2020,29.0,1990.0,18.1,44,25,21,16,7,14,46,30.4,32,30,3,27,47,91,18,0,MF,25-29,Midfielder,Germany,Europe
342385,Guido Rodrguez,ARG,Betis,La Liga,2020,26.0,1994.0,31.8,98,56,52,40,6,40,85,47.1,45,52,14,38,68,166,58,2,MF,25-29,Midfielder,Argentina,South America
412363,Rodrygo,BRA,Real Madrid,La Liga,2020,19.0,2001.0,10.9,15,6,10,4,1,2,17,11.8,15,15,0,15,7,22,4,0,FW,Under 20,Forward,Brazil,South America
889683,Rogrio,BRA,Sassuolo,Serie A,2020,22.0,1998.0,20.9,26,13,19,5,2,19,27,70.4,8,26,5,21,31,57,53,0,DF,20-24,Defender,Brazil,South America
355915,Cristian Romero,ARG,Atalanta,Serie A,2020,22.0,1998.0,28.3,63,32,41,19,3,27,49,55.1,22,31,13,18,96,159,71,2,DF,20-24,Defender,Argentina,South America
8198,Cristiano Ronaldo,POR,Juventus,Serie A,2020,35.0,1985.0,31.1,6,3,1,3,2,3,15,20.0,12,11,3,8,5,11,15,1,FW,35-39,Forward,Portugal,Europe
61546,Facundo Roncaglia,ARG,Osasuna,La Liga,2020,33.0,1987.0,13.7,25,14,14,11,0,11,20,55.0,9,11,6,5,25,50,26,0,DF,30-34,Defender,Argentina,South America
332889,Valentin Rongier,FRA,Marseille,Ligue 1,2020,25.0,1994.0,21.0,93,59,31,55,7,43,85,50.6,42,32,2,30,28,121,21,1,MF,25-29,Midfielder,France,Europe
127076,Jrme Roussillon,FRA,Wolfsburg,Bundesliga,2020,27.0,1993.0,13.7,24,12,14,8,2,11,20,55.0,9,10,1,9,19,43,28,0,DF,25-29,Defender,France,Europe
81460,Nolan Roux,FRA,Nmes,Ligue 1,2020,32.0,1988.0,7.2,7,3,1,4,2,3,8,37.5,5,6,0,6,5,12,4,0,FW,30-34,Forward,France,Europe
525704,Nicol Rovella,ITA,Genoa,Serie A,2020,18.0,2001.0,13.2,29,16,15,11,3,9,32,28.1,23,11,0,11,20,49,19,1,MF,Under 20,Midfielder,Italy,Europe
86202,Antonio Rdiger,GER,Chelsea,Premier League,2020,27.0,1993.0,19.0,31,23,16,14,1,12,15,80.0,3,17,10,7,18,49,51,0,DF,25-29,Defender,Germany,Europe
87884,Mrio Rui,POR,Napoli,Serie A,2020,29.0,1991.0,18.5,24,13,17,6,1,17,33,51.5,16,17,4,13,28,52,29,1,DF,25-29,Defender,Portugal,Europe
111057,Idriss Saadi,ALG,Strasbourg,Ligue 1,2020,28.0,1992.0,1.4,0,0,0,0,0,0,2,0.0,2,0,0,0,0,0,0,0,"MF,FW",25-29,Midfielder,Algeria,Africa
135492,Youssouf Sabaly,SEN,Bordeaux,Ligue 1,2020,27.0,1993.0,32.3,47,33,24,17,6,27,45,60.0,18,31,8,23,49,96,57,2,DF,25-29,Defender,Senegal,Africa
381950,Alexis Saelemaekers,BEL,Milan,Serie A,2020,21.0,1999.0,22.4,43,26,20,18,5,19,60,31.7,41,29,1,28,25,68,6,0,FW,20-24,Forward,Belgium,Europe
433177,Bukayo Saka,ENG,Arsenal,Premier League,2020,18.0,2001.0,28.4,25,16,10,13,2,11,40,27.5,29,21,2,19,25,50,24,0,"FW,MF",Under 20,Forward,England,Europe
83002,Hiroki Sakai,JPN,Marseille,Ligue 1,2020,30.0,1990.0,26.5,81,48,34,35,12,39,51,76.5,12,21,5,16,54,135,65,0,DF,30-34,Defender,Japan,Asia
148455,Mohamed Salah,EGY,Liverpool,Premier League,2020,28.0,1992.0,34.2,18,9,4,4,10,7,16,43.8,9,10,0,10,1,19,10,1,FW,25-29,Forward,Egypt,Africa
495666,William Saliba,FRA,Nice,Ligue 1,2020,19.0,2001.0,20.0,15,9,8,5,2,5,6,83.3,1,17,16,1,26,41,80,2,DF,Under 20,Defender,France,Europe
563963,Mohammed Salisu,GHA,Southampton,Premier League,2020,21.0,1999.0,9.4,38,21,20,16,2,25,34,73.5,9,22,5,17,17,55,30,0,DF,20-24,Defender,Ghana,Africa
335147,Junior Sambia,FRA,Montpellier,Ligue 1,2020,23.0,1996.0,27.2,41,29,20,14,7,26,38,68.4,12,27,14,13,39,80,46,0,"DF,MF",20-24,Defender,France,Europe
80173,Frdric Sammaritano,FRA,Dijon,Ligue 1,2020,34.0,1986.0,12.6,15,10,9,5,1,9,26,34.6,17,6,0,6,9,24,3,0,"FW,MF",30-34,Forward,France,Europe
234523,Antonio Sanabria,PAR,Torino,Serie A,2020,24.0,1996.0,10.9,8,3,0,4,4,2,9,22.2,7,5,0,5,5,13,8,0,FW,20-24,Forward,Paraguay,South America
40433,Alexis Snchez,CHI,Inter,Serie A,2020,31.0,1988.0,12.7,14,8,4,4,6,5,18,27.8,13,11,0,11,7,21,1,1,FW,30-34,Forward,Chile,South America
401173,Jadon Sancho,ENG,Dortmund,Bundesliga,2020,20.0,2000.0,22.9,18,11,4,10,4,7,16,43.8,9,20,1,19,16,34,9,0,"FW,MF",20-24,Forward,England,Europe
79960,Alex Sandro,BRA,Juventus,Serie A,2020,29.0,1991.0,20.6,37,23,19,13,5,13,25,52.0,12,20,4,16,31,68,57,0,DF,25-29,Defender,Brazil,South America
192565,Leroy San,GER,Bayern Munich,Bundesliga,2020,24.0,1996.0,20.1,18,10,2,10,6,13,30,43.3,17,23,1,22,9,27,8,1,"FW,MF",20-24,Forward,Germany,Europe
126534,Salif San,SEN,Schalke 04,Bundesliga,2020,29.0,1990.0,11.9,17,9,9,7,1,13,23,56.5,10,25,13,12,25,42,66,0,DF,25-29,Defender,Senegal,Africa
82048,Nicola Sansone,ITA,Bologna,Serie A,2020,28.0,1991.0,13.0,22,11,7,12,3,10,31,32.3,21,15,0,15,9,31,7,0,"FW,MF",25-29,Forward,Italy,Europe
285323,Baptiste Santamaria,FRA,Angers,Ligue 1,2020,25.0,1995.0,3.0,9,6,3,5,1,2,7,28.6,5,4,0,4,7,16,8,0,MF,25-29,Midfielder,France,Europe
393325,Josh Sargent,USA,Werder Bremen,Bundesliga,2020,20.0,2000.0,27.8,32,19,13,13,6,13,27,48.1,14,39,4,35,17,49,36,0,"FW,MF",20-24,Forward,United States,North America
127156,Tji Savanier,FRA,Montpellier,Ligue 1,2020,28.0,1991.0,24.1,49,33,16,25,8,22,73,30.1,51,28,6,22,38,87,15,0,MF,25-29,Midfielder,France,Europe
315867,Gianluca Scamacca,ITA,Genoa,Serie A,2020,21.0,1999.0,15.0,19,10,6,7,6,7,19,36.8,12,21,4,17,9,28,12,0,FW,20-24,Forward,Italy,Europe
135343,Fabian Schr,SUI,Newcastle Utd,Premier League,2020,28.0,1991.0,13.8,13,4,8,5,0,7,19,36.8,12,19,12,7,27,40,52,1,DF,25-29,Defender,Switzerland,Europe
56762,Pasquale Schiattarella,ITA,Benevento,Serie A,2020,33.0,1987.0,25.0,37,22,25,12,0,19,47,40.4,28,19,5,14,32,69,29,2,MF,30-34,Midfielder,Italy,Europe
223979,Xaver Schlager,AUT,Wolfsburg,Bundesliga,2020,22.0,1997.0,29.2,66,40,20,38,8,22,68,32.4,46,50,6,44,54,120,38,0,MF,20-24,Midfielder,Austria,Europe
413843,Keven Schlotterbeck,GER,Freiburg,Bundesliga,2020,23.0,1997.0,18.4,31,10,16,15,0,10,23,43.5,13,26,18,8,36,67,89,2,DF,20-24,Defender,Germany,Europe
388198,Nico Schlotterbeck,GER,Union Berlin,Bundesliga,2020,20.0,1999.0,14.3,34,19,14,19,1,18,28,64.3,10,13,6,7,31,65,29,1,DF,20-24,Defender,Germany,Europe
70285,Jonathan Schmid,FRA,Freiburg,Bundesliga,2020,30.0,1990.0,26.6,37,19,17,13,7,16,30,53.3,14,26,10,16,28,65,38,0,"MF,DF",30-34,Midfielder,France,Europe
346853,Romano Schmid,AUT,Werder Bremen,Bundesliga,2020,20.0,2000.0,13.1,22,16,8,10,4,8,35,22.9,27,21,0,21,8,30,6,0,"MF,FW",20-24,Midfielder,Austria,Europe
118397,Alessandro Schpf,AUT,Schalke 04,Bundesliga,2020,26.0,1994.0,10.5,11,9,3,7,1,1,6,16.7,5,15,1,14,6,17,6,0,"FW,MF",25-29,Forward,Austria,Europe
373899,Jacopo Segre,ITA,Torino,Serie A,2020,23.0,1997.0,2.1,5,2,2,1,2,2,5,40.0,3,0,0,0,0,5,1,0,MF,20-24,Midfielder,Italy,Europe
178459,Davie Selke,GER,Werder Bremen,Bundesliga,2020,25.0,1995.0,9.0,3,2,1,1,1,0,6,0.0,6,3,2,1,1,4,7,0,FW,25-29,Forward,Germany,Europe
231572,Nlson Semedo,POR,Wolves,Premier League,2020,26.0,1993.0,33.1,85,48,53,23,9,42,72,58.3,30,30,10,20,41,126,78,2,"DF,MF",25-29,Defender,Portugal,Europe
216179,Stefano Sensi,ITA,Inter,Serie A,2020,24.0,1995.0,6.7,9,6,3,5,1,4,11,36.4,7,6,1,5,7,16,1,0,MF,20-24,Midfielder,Italy,Europe
261905,Suat Serdar,GER,Schalke 04,Bundesliga,2020,23.0,1997.0,21.7,55,35,18,33,4,17,52,32.7,35,29,4,25,23,78,21,0,MF,20-24,Midfielder,Germany,Europe
392775,Ryan Sessegnon,ENG,Hoffenheim,Bundesliga,2020,20.0,2000.0,17.5,47,25,26,13,8,15,34,44.1,19,26,3,23,30,77,46,0,"DF,FW",20-24,Defender,England,Europe
94529,Stephan El Shaarawy,ITA,Roma,Serie A,2020,27.0,1992.0,6.4,4,3,0,3,1,2,9,22.2,7,3,1,2,3,7,2,0,"MF,FW",25-29,Midfielder,Italy,Europe
49542,Billy Sharp,ENG,Sheffield Utd,Premier League,2020,34.0,1986.0,8.2,5,1,0,3,2,2,9,22.2,7,2,0,2,0,5,2,0,FW,30-34,Forward,England,Europe
183288,Luke Shaw,ENG,Manchester Utd,Premier League,2020,25.0,1995.0,29.5,44,28,21,16,7,21,36,58.3,15,34,9,25,20,64,44,2,DF,25-29,Defender,England,Europe
358166,Eldor Shomurodov,UZB,Genoa,Serie A,2020,25.0,1995.0,18.6,28,14,7,13,8,9,37,24.3,28,17,2,15,6,34,11,0,FW,25-29,Forward,Uzbekistan,Asia
161869,Djibril Sidib,FRA,Monaco,Ligue 1,2020,28.0,1992.0,22.0,58,34,26,29,3,37,52,71.2,15,20,5,15,50,108,37,2,DF,25-29,Defender,France,Europe
700646,Andr Silva,POR,Eint Frankfurt,Bundesliga,2020,24.0,1995.0,30.7,11,2,0,7,4,6,13,46.2,7,11,1,10,3,14,15,0,FW,20-24,Forward,Portugal,Europe
241641,Bernardo Silva,POR,Manchester City,Premier League,2020,25.0,1994.0,22.9,26,14,7,12,7,11,52,21.2,41,17,1,16,17,43,8,0,"MF,FW",25-29,Midfielder,Portugal,Europe
505653,Fbio Silva,POR,Wolves,Premier League,2020,18.0,2002.0,15.2,6,4,1,4,1,4,12,33.3,8,12,1,11,4,10,5,1,FW,Under 20,Forward,Portugal,Europe
294817,Thiago Silva,BRA,Chelsea,Premier League,2020,35.0,1984.0,21.5,20,12,11,8,1,14,21,66.7,7,21,13,8,33,53,86,1,DF,35-39,Defender,Brazil,South America
666234,Mohamed Simakan,FRA,Strasbourg,Ligue 1,2020,20.0,2000.0,17.9,32,22,21,6,5,9,18,50.0,9,17,11,6,31,63,41,0,DF,20-24,Defender,France,Europe
282388,Giovanni Simeone,ARG,Cagliari,Serie A,2020,25.0,1995.0,19.3,24,11,2,15,7,7,31,22.6,24,23,1,22,10,34,18,0,FW,25-29,Forward,Argentina,South America
274862,Moses Simon,NGA,Nantes,Ligue 1,2020,25.0,1995.0,25.8,27,14,11,9,7,17,36,47.2,19,24,1,23,15,42,15,1,"FW,MF",25-29,Forward,Nigeria,Africa
648779,Wilfried Singo,CIV,Torino,Serie A,2020,19.0,2000.0,20.6,29,14,16,6,7,17,33,51.5,16,13,3,10,29,58,40,0,DF,Under 20,Defender,Ivory Coast,Africa
372712,Ibrahima Sissoko,MLI,Strasbourg,Ligue 1,2020,22.0,1997.0,28.7,68,48,25,35,8,28,68,41.2,40,22,5,17,48,116,44,0,MF,20-24,Midfielder,Mali,Africa
46001,Moussa Sissoko,FRA,Tottenham,Premier League,2020,30.0,1989.0,17.6,22,16,19,3,0,8,20,40.0,12,11,4,7,23,45,25,0,MF,30-34,Midfielder,France,Europe
290587,Ellyes Skhiri,TUN,Kln,Bundesliga,2020,25.0,1995.0,30.9,83,48,44,31,8,33,65,50.8,32,49,13,36,82,165,38,2,MF,25-29,Midfielder,Tunisia,Africa
432982,Andreas Skov Olsen,DEN,Bologna,Serie A,2020,20.0,1999.0,13.1,19,10,11,4,4,11,21,52.4,10,15,0,15,3,22,25,0,"FW,DF",20-24,Forward,Denmark,Europe
93827,Steven Skrzybski,GER,Schalke 04,Bundesliga,2020,27.0,1992.0,4.7,5,4,0,5,0,1,7,14.3,6,13,1,12,5,10,1,1,"FW,DF",25-29,Forward,Germany,Europe
103427,Chris Smalling,ENG,Roma,Serie A,2020,30.0,1989.0,12.3,14,8,5,7,2,6,10,60.0,4,17,11,6,28,42,46,1,DF,30-34,Defender,England,Europe
392765,Emile Smith Rowe,ENG,Arsenal,Premier League,2020,20.0,2000.0,16.0,14,7,5,5,4,6,17,35.3,11,15,1,14,10,24,12,0,"MF,FW",20-24,Midfielder,England,Europe
112988,Cdric Soares,POR,Arsenal,Premier League,2020,28.0,1991.0,8.3,12,8,6,4,2,6,21,28.6,15,6,1,5,8,20,16,1,DF,25-29,Defender,Portugal,Europe
507486,Simon Sohm,SUI,Parma,Serie A,2020,19.0,2001.0,10.0,18,12,11,6,1,11,26,42.3,15,8,0,8,5,23,7,0,MF,Under 20,Midfielder,Switzerland,Europe
282694,Augusto Solari,ARG,Celta Vigo,La Liga,2020,28.0,1992.0,5.4,18,13,9,8,1,6,26,23.1,20,13,1,12,6,24,5,0,MF,25-29,Midfielder,Argentina,South America
546880,Brandon Soppy,FRA,Rennes,Ligue 1,2020,18.0,2002.0,6.2,21,15,16,5,0,10,16,62.5,6,3,0,3,6,27,12,0,DF,Under 20,Defender,France,Europe
293194,Borna Sosa,CRO,Stuttgart,Bundesliga,2020,22.0,1998.0,22.7,14,10,6,6,2,8,25,32.0,17,23,4,19,31,45,74,0,"DF,FW",20-24,Defender,Croatia,Europe
354726,Florian Sotoca,FRA,Lens,Ligue 1,2020,29.0,1990.0,26.8,31,20,3,20,8,6,22,27.3,16,27,0,27,9,40,24,0,FW,25-29,Forward,France,Europe
85000,Cebio Soukou,BEN,Arminia,Bundesliga,2020,27.0,1992.0,5.1,12,8,5,5,2,6,11,54.5,5,3,0,3,3,15,4,0,"FW,MF",25-29,Forward,Benin,Africa
344605,Boubakary Soumar,FRA,Lille,Ligue 1,2020,21.0,1999.0,21.3,44,29,16,25,3,14,29,48.3,15,14,6,8,39,83,21,0,MF,20-24,Midfielder,France,Europe
111058,Arnaud Souquet,FRA,Montpellier,Ligue 1,2020,28.0,1992.0,13.6,50,33,35,13,2,27,48,56.3,21,15,6,9,17,67,34,0,DF,25-29,Defender,France,Europe
212723,Djibril Sow,SUI,Eint Frankfurt,Bundesliga,2020,23.0,1997.0,24.2,58,33,19,32,7,18,41,43.9,23,31,8,23,51,109,17,0,MF,20-24,Midfielder,Switzerland,Europe
118689,Leonardo Spinazzola,ITA,Roma,Serie A,2020,27.0,1993.0,23.6,12,6,3,9,0,8,20,40.0,12,16,1,15,25,37,31,0,DF,25-29,Defender,Italy,Europe
162434,Niklas Stark,GER,Hertha BSC,Bundesliga,2020,25.0,1995.0,31.0,49,28,20,27,2,13,31,41.9,18,43,16,27,42,91,101,0,"DF,MF",25-29,Defender,Germany,Europe
195246,Pascal Stenzel,GER,Stuttgart,Bundesliga,2020,24.0,1996.0,14.2,33,14,15,17,1,22,50,44.0,28,19,4,15,26,59,39,1,DF,20-24,Defender,Germany,Europe
163744,Jack Stephens,ENG,Southampton,Premier League,2020,26.0,1994.0,17.1,34,19,19,15,0,17,38,44.7,21,25,14,11,28,62,64,2,DF,25-29,Defender,England,Europe
134425,Raheem Sterling,ENG,Manchester City,Premier League,2020,25.0,1994.0,28.2,21,10,5,12,4,5,12,41.7,7,15,0,15,15,36,4,0,FW,25-29,Forward,England,Europe
85706,Enda Stevens,IRL,Sheffield Utd,Premier League,2020,30.0,1990.0,30.0,59,26,32,19,8,33,58,56.9,25,41,12,29,22,81,81,1,DF,30-34,Defender,Republic of Ireland,Europe
48298,Lars Stindl,GER,Gladbach,Bundesliga,2020,31.0,1988.0,21.8,24,17,3,16,5,7,32,21.9,25,26,3,23,13,37,14,0,"MF,FW",30-34,Midfielder,Germany,Europe
106872,Kevin Stger,AUT,Mainz 05,Bundesliga,2020,26.0,1993.0,6.0,12,6,2,9,1,5,16,31.3,11,5,0,5,6,18,4,0,"MF,FW",25-29,Midfielder,Austria,Europe
186590,John Stones,ENG,Manchester City,Premier League,2020,26.0,1994.0,21.5,21,10,13,5,3,9,14,64.3,5,23,15,8,18,39,56,1,DF,25-29,Defender,England,Europe
57845,Tobias Strobl,GER,Augsburg,Bundesliga,2020,30.0,1990.0,20.5,21,10,12,9,0,10,30,33.3,20,21,8,13,28,49,27,0,MF,30-34,Midfielder,Germany,Europe
410708,Pascal Struijk,NED,Leeds United,Premier League,2020,20.0,1999.0,23.1,49,30,28,19,2,17,28,60.7,11,35,21,14,47,96,92,0,"DF,MF",20-24,Defender,Netherlands,Europe
76746,Damin Surez,URU,Getafe,La Liga,2020,32.0,1988.0,27.0,59,39,29,23,7,30,81,37.0,51,43,2,41,31,90,42,0,DF,30-34,Defender,Uruguay,South America
424784,Luis Surez,URU,Atltico Madrid,La Liga,2020,33.0,1987.0,27.9,11,7,0,4,7,3,12,25.0,9,7,0,7,5,16,13,0,FW,30-34,Forward,Uruguay,South America
166601,Niklas Sle,GER,Bayern Munich,Bundesliga,2020,24.0,1995.0,16.7,32,21,15,14,3,13,21,61.9,8,24,12,12,21,53,36,1,DF,20-24,Defender,Germany,Europe
220878,Issiaga Sylla,GUI,Lens,Ligue 1,2020,26.0,1994.0,12.4,28,20,11,17,0,11,21,52.4,10,13,3,10,16,44,21,0,"DF,MF",25-29,Defender,Guinea,Africa
39106,dm Szalai,HUN,Mainz 05,Bundesliga,2020,32.0,1987.0,8.1,7,6,3,2,2,2,8,25.0,6,4,1,3,2,9,4,0,FW,30-34,Forward,Hungary,Europe
196357,Jonathan Tah,GER,Leverkusen,Bundesliga,2020,24.0,1996.0,24.7,30,17,19,9,2,11,21,52.4,10,19,12,7,33,63,89,1,DF,20-24,Defender,Germany,Europe
564545,Edmond Tapsoba,BFA,Leverkusen,Bundesliga,2020,21.0,1999.0,29.5,54,28,35,18,1,21,45,46.7,24,55,29,26,48,102,96,0,DF,20-24,Defender,Burkina Faso,Africa
173504,James Tarkowski,ENG,Burnley,Premier League,2020,27.0,1992.0,36.0,66,39,52,11,3,25,49,51.0,24,54,42,12,44,110,163,1,DF,25-29,Defender,England,Europe
195633,Charlie Taylor,ENG,Burnley,Premier League,2020,26.0,1993.0,27.0,48,28,30,15,3,25,46,54.3,21,36,19,17,29,77,87,2,DF,25-29,Defender,England,Europe
591914,Warren Tchimbemb,CGO,Metz,Ligue 1,2020,22.0,1998.0,5.5,7,4,4,3,0,3,9,33.3,6,6,1,5,2,9,3,0,"MF,FW",20-24,Midfielder,Congo,Africa
413112,Aurlien Tchouamni,FRA,Monaco,Ligue 1,2020,20.0,2000.0,34.0,127,68,47,62,18,48,92,52.2,44,39,11,28,60,187,47,0,MF,20-24,Midfielder,France,Europe
340322,Nathan Tella,NGA,Southampton,Premier League,2020,21.0,1999.0,8.3,8,5,1,4,3,6,15,40.0,9,13,0,13,3,11,2,0,"FW,MF",20-24,Forward,Nigeria,Africa
255755,Alex Telles,BRA,Manchester Utd,Premier League,2020,27.0,1992.0,7.7,14,7,10,3,1,8,17,47.1,9,7,2,5,16,30,20,0,DF,25-29,Defender,Brazil,South America
331389,Andrs Tello,COL,Benevento,Serie A,2020,23.0,1996.0,4.6,9,6,8,0,1,5,20,25.0,15,8,1,7,6,15,6,0,"DF,MF",20-24,Defender,Colombia,South America
16873,Claudio Terzi,ITA,Spezia,Serie A,2020,36.0,1984.0,20.8,34,21,19,14,1,19,28,67.9,9,23,12,11,35,69,55,1,DF,35-39,Defender,Italy,Europe
207597,Cedric Teuchert,GER,Union Berlin,Bundesliga,2020,23.0,1997.0,8.4,7,5,2,4,1,3,16,18.8,13,12,0,12,5,12,6,0,"FW,MF",20-24,Forward,Germany,Europe
184892,Florian Thauvin,FRA,Marseille,Ligue 1,2020,27.0,1993.0,30.4,40,22,14,21,5,20,54,37.0,34,26,2,24,14,54,11,0,"FW,MF",25-29,Forward,France,Europe
472249,Jan Thielmann,GER,Kln,Bundesliga,2020,18.0,2002.0,11.4,11,6,1,8,2,5,9,55.6,4,10,1,9,9,20,2,0,"FW,MF",Under 20,Forward,Germany,Europe
290593,Sada Thioub,SEN,Angers,Ligue 1,2020,25.0,1995.0,14.0,17,14,7,6,4,7,23,30.4,16,10,0,10,9,26,3,0,"FW,MF",25-29,Forward,Senegal,Africa
505194,Luke Thomas,ENG,Leicester City,Premier League,2020,19.0,2001.0,10.8,23,14,11,5,7,14,21,66.7,7,15,2,13,17,40,21,0,DF,Under 20,Defender,England,Europe
57467,Romain Thomas,FRA,Angers,Ligue 1,2020,32.0,1988.0,33.6,47,25,34,11,2,20,35,57.1,15,35,20,15,50,97,138,0,DF,30-34,Defender,France,Europe
215977,Adrien Thomasson,FRA,Strasbourg,Ligue 1,2020,26.0,1993.0,29.2,36,17,8,16,12,12,58,20.7,46,44,5,39,22,58,2,0,"MF,FW",25-29,Midfielder,France,Europe
156779,Erik Thommy,GER,Stuttgart,Bundesliga,2020,25.0,1994.0,3.5,3,1,0,3,0,0,3,0.0,3,3,0,3,3,6,4,0,"MF,DF",25-29,Midfielder,Germany,Europe
463618,Khphren Thuram,FRA,Nice,Ligue 1,2020,19.0,2001.0,16.6,32,16,5,21,6,9,27,33.3,18,21,9,12,18,50,22,1,MF,Under 20,Midfielder,France,Europe
249565,Youri Tielemans,BEL,Leicester City,Premier League,2020,23.0,1997.0,37.3,86,45,32,38,16,45,108,41.7,63,35,8,27,46,132,20,1,MF,20-24,Midfielder,Belgium,Europe
300716,Kieran Tierney,SCO,Arsenal,Premier League,2020,23.0,1997.0,25.5,27,15,5,14,8,11,31,35.5,20,31,10,21,16,43,63,0,DF,20-24,Defender,Scotland,Europe
605184,Jean-Clair Todibo,FRA,Nice,Ligue 1,2020,20.0,1999.0,14.8,25,15,16,9,0,16,31,51.6,15,13,7,6,19,44,48,1,DF,20-24,Defender,France,Europe
315110,Karl Toko Ekambi,CMR,Lyon,Ligue 1,2020,27.0,1992.0,31.2,16,10,5,3,8,8,32,25.0,24,20,1,19,26,42,8,0,FW,25-29,Forward,Cameroon,Africa
190393,Corentin Tolisso,FRA,Bayern Munich,Bundesliga,2020,25.0,1994.0,8.7,19,19,4,11,4,9,29,31.0,20,15,2,13,6,25,8,0,MF,25-29,Midfielder,France,Europe
129674,Jeremy Toljan,GER,Sassuolo,Serie A,2020,25.0,1994.0,16.6,21,12,16,3,2,12,27,44.4,15,15,7,8,13,34,28,0,DF,25-29,Defender,Germany,Europe
72441,Rafael Toli,ITA,Atalanta,Serie A,2020,29.0,1990.0,28.2,51,23,21,26,4,26,48,54.2,22,37,7,30,33,84,66,0,DF,25-29,Defender,Italy,Europe
331560,Takehiro Tomiyasu,JPN,Bologna,Serie A,2020,21.0,1998.0,30.2,47,31,27,14,6,21,34,61.8,13,37,19,18,54,101,106,0,DF,20-24,Defender,Japan,Asia
397033,Sandro Tonali,ITA,Milan,Serie A,2020,20.0,2000.0,14.8,28,19,14,13,1,13,28,46.4,15,18,5,13,22,50,18,0,MF,20-24,Midfielder,Italy,Europe
111347,Lorenzo Tonelli,ITA,Sampdoria,Serie A,2020,30.0,1990.0,19.8,33,18,20,11,2,10,21,47.6,11,21,14,7,25,58,94,1,DF,30-34,Defender,Italy,Europe
159883,Ernesto Torregrossa,VEN,Sampdoria,Serie A,2020,28.0,1992.0,1.9,1,1,0,0,1,0,2,0.0,2,4,0,4,1,2,1,0,FW,25-29,Forward,Venezuela,South America
530902,Abdoulaye Tour,GUI,Nantes,Ligue 1,2020,26.0,1994.0,18.7,28,12,10,16,2,14,31,45.2,17,17,2,15,22,50,19,0,MF,25-29,Midfielder,Guinea,Africa
216181,Almamy Tour,MLI,Eint Frankfurt,Bundesliga,2020,24.0,1996.0,7.8,18,12,8,7,3,10,14,71.4,4,5,1,4,8,26,22,0,DF,20-24,Defender,Mali,Africa
353948,Lucas Tousart,FRA,Hertha BSC,Bundesliga,2020,23.0,1997.0,23.2,33,18,16,15,2,13,27,48.1,14,33,6,27,40,73,52,0,MF,20-24,Midfielder,France,Europe
146509,Conor Townsend,ENG,West Brom,Premier League,2020,27.0,1993.0,24.8,44,28,32,9,3,30,49,61.2,19,38,15,23,36,80,55,2,DF,25-29,Defender,England,Europe
297070,Hamari Traor,MLI,Rennes,Ligue 1,2020,28.0,1992.0,33.3,56,38,23,27,6,22,59,37.3,37,31,5,26,76,132,50,0,DF,25-29,Defender,Mali,Africa
57216,Ismal Traor,CIV,Angers,Ligue 1,2020,33.0,1986.0,33.3,32,14,23,9,0,20,37,54.1,17,27,13,14,40,72,107,0,DF,30-34,Defender,Ivory Coast,Africa
75921,Christopher Trimmel,AUT,Union Berlin,Bundesliga,2020,33.0,1987.0,28.6,50,25,28,18,4,28,54,51.9,26,32,7,25,50,100,99,0,"DF,FW",30-34,Defender,Austria,Europe
95810,Kieran Trippier,ENG,Atltico Madrid,La Liga,2020,29.0,1990.0,27.5,61,39,30,25,6,26,52,50.0,26,22,4,18,40,101,58,1,DF,25-29,Defender,England,Europe
144028,Leandro Trossard,BEL,Brighton,Premier League,2020,25.0,1994.0,29.0,33,14,11,16,6,10,36,27.8,26,34,2,32,26,59,7,1,"MF,FW",25-29,Midfielder,Belgium,Europe
654539,Adrien Truffert,FRA,Rennes,Ligue 1,2020,18.0,2001.0,21.7,38,18,18,12,8,13,24,54.2,11,26,5,21,18,56,38,1,"DF,MF",Under 20,Defender,France,Europe
73943,Alessandro Tuia,ITA,Benevento,Serie A,2020,30.0,1990.0,19.6,39,17,34,4,1,15,25,60.0,10,22,10,12,36,75,91,1,DF,30-34,Defender,Italy,Europe
188915,Naomichi Ueda,JPN,Nmes,Ligue 1,2020,25.0,1994.0,7.9,4,2,3,1,0,4,6,66.7,2,5,4,1,6,10,30,1,DF,25-29,Defender,Japan,Asia
126540,Samuel Umtiti,FRA,Barcelona,La Liga,2020,26.0,1993.0,7.2,5,1,3,2,0,1,2,50.0,1,11,6,5,9,14,15,0,DF,25-29,Defender,France,Europe
251106,Enes nal,TUR,Getafe,La Liga,2020,23.0,1997.0,14.6,11,3,0,8,3,4,15,26.7,11,11,0,11,2,13,14,0,FW,20-24,Forward,Turkey,Asia
344695,Dayot Upamecano,FRA,RB Leipzig,Bundesliga,2020,21.0,1998.0,25.9,37,30,18,19,0,14,20,70.0,6,25,14,11,33,70,74,2,DF,20-24,Defender,France,Europe
369081,Federico Valverde,URU,Real Madrid,La Liga,2020,22.0,1998.0,14.8,25,16,9,8,8,10,26,38.5,16,16,2,14,22,47,4,0,MF,20-24,Midfielder,Uruguay,South America
197838,Jamie Vardy,ENG,Leicester City,Premier League,2020,33.0,1987.0,31.6,18,12,1,8,9,2,15,13.3,13,14,5,9,4,22,32,0,FW,30-34,Forward,England,Europe
76163,Franco Vzquez,ARG,Sevilla,La Liga,2020,31.0,1989.0,1.8,5,1,0,3,2,1,5,20.0,4,2,1,1,1,6,1,0,"FW,MF",30-34,Forward,Argentina,South America
111195,Jol Veltman,NED,Brighton,Premier League,2020,28.0,1992.0,25.3,67,33,34,25,8,29,57,50.9,28,24,5,19,33,100,64,0,DF,25-29,Defender,Netherlands,Europe
130360,Simone Verdi,ITA,Torino,Serie A,2020,28.0,1992.0,18.0,19,12,10,6,3,6,19,31.6,13,8,0,8,8,27,2,2,"MF,FW",25-29,Midfielder,Italy,Europe
164771,Jordan Veretout,FRA,Roma,Serie A,2020,27.0,1993.0,22.8,20,12,8,12,0,9,33,27.3,24,14,3,11,14,34,21,3,MF,25-29,Midfielder,France,Europe
162961,Valerio Verre,ITA,Sampdoria,Serie A,2020,26.0,1994.0,11.1,11,7,2,7,2,4,19,21.1,15,14,2,12,9,20,3,0,"FW,MF",25-29,Forward,Italy,Europe
99331,Jannik Vestergaard,DEN,Southampton,Premier League,2020,27.0,1992.0,28.6,50,31,31,15,4,35,52,67.3,17,29,16,13,42,92,122,0,DF,25-29,Defender,Denmark,Europe
37666,Arturo Vidal,CHI,Inter,Serie A,2020,33.0,1987.0,12.6,27,14,8,13,6,12,41,29.3,29,23,3,20,29,56,11,0,MF,30-34,Midfielder,Chile,South America
287367,Luca Vignali,ITA,Spezia,Serie A,2020,24.0,1996.0,17.7,19,9,10,6,3,7,25,28.0,18,13,5,8,22,41,25,0,DF,20-24,Defender,Italy,Europe
394346,Emanuel Vignato,ITA,Bologna,Serie A,2020,19.0,2000.0,13.4,18,9,9,6,3,3,15,20.0,12,6,1,5,10,28,7,0,"FW,MF",Under 20,Forward,Italy,Europe
525287,Carlos Vincius,BRA,Tottenham,Premier League,2020,25.0,1995.0,3.4,3,1,2,1,0,1,1,100.0,0,0,0,0,2,5,5,0,FW,25-29,Forward,Brazil,South America
85393,Nicolas Viola,ITA,Benevento,Serie A,2020,30.0,1989.0,11.5,16,9,2,11,3,6,28,21.4,22,10,3,7,9,25,7,0,MF,30-34,Midfielder,Italy,Europe
586853,Vitinha,POR,Wolves,Premier League,2020,20.0,2000.0,5.8,7,3,2,5,0,3,8,37.5,5,3,0,3,3,10,1,0,MF,20-24,Midfielder,Portugal,Europe
94771,Andreas Voglsammer,GER,Arminia,Bundesliga,2020,28.0,1992.0,11.1,12,8,6,6,0,8,17,47.1,9,11,0,11,3,15,11,0,"FW,MF",25-29,Forward,Germany,Europe
82009,Kevin Volland,GER,Monaco,Ligue 1,2020,28.0,1992.0,30.8,33,16,11,19,3,8,34,23.5,26,23,0,23,4,37,4,0,"FW,MF",25-29,Forward,Germany,Europe
111196,Stefan de Vrij,NED,Inter,Serie A,2020,28.0,1992.0,30.4,28,16,15,12,1,15,24,62.5,9,24,18,6,41,69,95,0,DF,25-29,Defender,Netherlands,Europe
323954,Walace,BRA,Udinese,Serie A,2020,25.0,1995.0,22.8,50,23,28,19,3,21,60,35.0,39,36,3,33,34,84,23,0,MF,25-29,Midfielder,Brazil,South America
95424,Kyle Walker,ENG,Manchester City,Premier League,2020,30.0,1990.0,21.6,29,19,15,12,2,16,24,66.7,8,19,7,12,14,43,28,0,DF,30-34,Defender,England,Europe
341051,Kyle Walker-Peters,ENG,Southampton,Premier League,2020,23.0,1997.0,29.4,83,53,56,25,2,34,57,59.6,23,41,10,31,38,121,66,2,DF,20-24,Defender,England,Europe
477758,Aaron Wan-Bissaka,ENG,Manchester Utd,Premier League,2020,22.0,1997.0,34.0,88,54,53,29,6,32,45,71.1,13,65,17,48,62,150,84,2,DF,20-24,Defender,England,Europe
92572,Joel Ward,ENG,Crystal Palace,Premier League,2020,30.0,1989.0,25.1,43,25,29,14,0,24,42,57.1,18,27,8,19,41,84,87,2,DF,30-34,Defender,England,Europe
181579,James Ward-Prowse,ENG,Southampton,Premier League,2020,25.0,1994.0,38.0,75,49,30,41,4,29,70,41.4,41,36,4,32,42,117,60,0,MF,25-29,Midfielder,England,Europe
324358,Ollie Watkins,ENG,Aston Villa,Premier League,2020,24.0,1995.0,37.0,29,17,5,16,8,10,33,30.3,23,21,2,19,7,36,24,0,FW,20-24,Forward,England,Europe
370846,Timothy Weah,USA,Lille,Ligue 1,2020,20.0,2000.0,9.8,15,7,3,9,3,7,14,50.0,7,7,0,7,4,19,5,0,"FW,MF",20-24,Forward,United States,North America
212847,Adam Webster,ENG,Brighton,Premier League,2020,25.0,1995.0,28.8,29,16,15,10,4,12,25,48.0,13,29,16,13,47,76,92,3,DF,25-29,Defender,England,Europe
247652,Shon Weissman,ISR,Valladolid,La Liga,2020,24.0,1996.0,23.7,12,9,4,5,3,2,23,8.7,21,17,3,14,8,20,7,0,FW,20-24,Forward,Israel,Asia
67063,Danny Welbeck,ENG,Brighton,Premier League,2020,29.0,1990.0,17.2,12,6,2,6,4,7,19,36.8,12,17,0,17,7,19,13,0,FW,25-29,Forward,England,Europe
19305,Oscar Wendt,SWE,Gladbach,Bundesliga,2020,34.0,1985.0,13.9,12,6,2,9,1,4,12,33.3,8,18,4,14,14,26,23,0,DF,30-34,Defender,Sweden,Europe
170527,Timo Werner,GER,Chelsea,Premier League,2020,24.0,1996.0,28.9,20,9,6,11,3,7,43,16.3,36,23,1,22,8,28,8,0,"FW,MF",20-24,Forward,Germany,Europe
91317,Ashley Westwood,ENG,Burnley,Premier League,2020,30.0,1990.0,37.9,23,15,6,12,5,10,42,23.8,32,26,9,17,44,67,33,0,MF,30-34,Midfielder,England,Europe
335721,Ben White,ENG,Brighton,Premier League,2020,22.0,1997.0,35.5,49,26,21,24,4,24,57,42.1,33,46,22,24,62,111,56,0,"DF,MF",20-24,Defender,England,Europe
49499,Georginio Wijnaldum,NED,Liverpool,Premier League,2020,29.0,1990.0,32.7,23,7,6,14,3,7,31,22.6,24,18,3,15,26,49,18,1,MF,25-29,Midfielder,Netherlands,Europe
507700,Brandon Williams,ENG,Manchester Utd,Premier League,2020,19.0,2000.0,2.1,0,0,0,0,0,0,1,0.0,1,1,0,1,1,1,7,0,DF,Under 20,Defender,England,Europe
255508,Iaki Williams,GHA,Athletic Club,La Liga,2020,26.0,1994.0,26.5,11,7,0,4,7,2,14,14.3,12,13,1,12,5,16,22,0,FW,25-29,Forward,Ghana,Africa
55338,Willian,BRA,Arsenal,Premier League,2020,31.0,1988.0,15.6,13,7,6,6,1,6,16,37.5,10,13,0,13,8,21,8,0,FW,30-34,Forward,Brazil,South America
450826,Callum Wilson,ENG,Newcastle Utd,Premier League,2020,28.0,1992.0,23.2,12,5,1,6,5,2,12,16.7,10,10,3,7,7,19,14,0,FW,25-29,Forward,England,Europe
249126,Harry Winks,ENG,Tottenham,Premier League,2020,24.0,1996.0,9.6,16,9,11,5,0,5,20,25.0,15,16,4,12,11,27,12,1,MF,20-24,Midfielder,England,Europe
598577,Florian Wirtz,GER,Leverkusen,Bundesliga,2020,17.0,2003.0,24.7,35,18,8,22,5,11,37,29.7,26,27,1,26,9,44,8,0,MF,Under 20,Midfielder,Germany,Europe
388165,Yoane Wissa,COD,Lorient,Ligue 1,2020,23.0,1996.0,29.7,35,20,12,14,9,11,34,32.4,23,25,3,22,20,55,14,0,"MF,FW",20-24,Midfielder,DR Congo,Africa
35047,Axel Witsel,BEL,Dortmund,Bundesliga,2020,31.0,1989.0,12.6,18,12,6,11,1,8,16,50.0,8,13,3,10,22,40,13,0,MF,30-34,Midfielder,Belgium,Europe
321070,Hannes Wolf,AUT,Gladbach,Bundesliga,2020,21.0,1999.0,15.3,26,13,8,10,8,8,36,22.2,28,18,1,17,9,35,4,0,"MF,FW",20-24,Midfielder,Austria,Europe
455661,Nick Woltemade,GER,Werder Bremen,Bundesliga,2020,18.0,2002.0,1.6,3,2,1,1,1,2,4,50.0,2,1,0,1,0,3,0,0,"MF,FW",Under 20,Midfielder,Germany,Europe
108725,Chris Wood,NZL,Burnley,Premier League,2020,28.0,1991.0,30.5,12,7,2,4,6,5,18,27.8,13,14,3,11,1,13,21,0,FW,25-29,Forward,New Zealand,Oceania
111455,Granit Xhaka,SUI,Arsenal,Premier League,2020,27.0,1992.0,28.0,50,26,18,17,15,30,58,51.7,28,23,7,16,24,74,38,3,"MF,DF",25-29,Midfielder,Switzerland,Europe
235412,Jawad El Yamiq,MAR,Valladolid,La Liga,2020,28.0,1992.0,15.3,21,14,14,7,0,8,11,72.7,3,15,10,5,46,67,100,0,DF,25-29,Defender,Morocco,Africa
14086,Ashley Young,ENG,Inter,Serie A,2020,35.0,1985.0,15.8,15,7,8,4,3,3,13,23.1,10,13,0,13,6,21,31,0,DF,35-39,Defender,England,Europe
334526,Denis Zakaria,SUI,Gladbach,Bundesliga,2020,23.0,1996.0,15.8,30,15,12,15,3,11,20,55.0,9,20,7,13,23,53,29,1,"MF,DF",20-24,Midfielder,Switzerland,Europe
343945,Niccol Zanellato,ITA,Crotone,Serie A,2020,22.0,1998.0,18.2,24,14,16,6,2,13,36,36.1,23,19,5,14,16,40,12,2,MF,20-24,Midfielder,Italy,Europe
34344,Cristin Zapata,COL,Genoa,Serie A,2020,33.0,1986.0,10.8,18,12,11,7,0,10,14,71.4,4,15,11,4,15,33,56,0,DF,30-34,Defender,Colombia,South America
73794,Duvn Zapata,COL,Atalanta,Serie A,2020,29.0,1991.0,26.4,12,5,2,3,7,4,13,30.8,9,19,5,14,6,18,19,0,FW,25-29,Forward,Colombia,South America
173859,Davide Zappacosta,ITA,Genoa,Serie A,2020,28.0,1992.0,22.7,33,16,15,13,5,15,30,50.0,15,17,1,16,18,51,41,0,DF,25-29,Defender,Italy,Europe
96828,Simone Zaza,ITA,Torino,Serie A,2020,29.0,1991.0,16.6,15,9,4,6,5,6,20,30.0,14,14,0,14,3,18,5,1,FW,25-29,Forward,Italy,Europe
338032,Deyovaisio Zeefuik,NED,Hertha BSC,Bundesliga,2020,22.0,1998.0,10.1,13,9,8,3,2,8,19,42.1,11,15,3,12,12,25,36,0,"DF,FW",20-24,Defender,Netherlands,Europe
203853,Oleksandr Zinchenko,UKR,Manchester City,Premier League,2020,23.0,1996.0,16.4,25,15,12,9,4,14,24,58.3,10,17,4,13,23,48,28,0,DF,20-24,Defender,Ukraine,Europe
157509,Kurt Zouma,FRA,Chelsea,Premier League,2020,25.0,1994.0,22.5,16,10,8,6,2,4,8,50.0,4,13,9,4,28,44,93,0,DF,25-29,Defender,France,Europe
246968,Ayoze Prez,ESP,Leicester City,Premier League,2020,27.0,1993.0,14.8,32,15,6,20,6,13,48,27.1,35,28,0,28,10,42,7,0,"MF,FW",25-29,Midfielder,Spain,Europe
282810,Carles Prez,ESP,Roma,Serie A,2020,22.0,1998.0,8.6,9,4,3,6,0,6,31,19.4,25,9,0,9,6,15,1,0,"MF,FW",20-24,Midfielder,Spain,Europe
71579,Iigo Prez,ESP,Osasuna,La Liga,2020,32.0,1988.0,15.0,20,10,9,6,5,10,16,62.5,6,12,0,12,15,35,8,1,"MF,DF",30-34,Midfielder,Spain,Europe
527698,Kike Prez,ESP,Valladolid,La Liga,2020,23.0,1997.0,12.9,26,19,8,14,4,7,33,21.2,26,10,1,9,17,43,18,0,MF,20-24,Midfielder,Spain,Europe
422355,Jens Petter Hauge,NOR,Milan,Serie A,2020,20.0,1999.0,5.9,7,4,3,3,1,6,10,60.0,4,4,0,4,1,8,3,0,FW,20-24,Forward,Norway,Europe
18944,Gerard Piqu,ESP,Barcelona,La Liga,2020,33.0,1987.0,16.5,16,11,11,5,0,9,12,75.0,3,9,4,5,26,42,46,0,DF,30-34,Defender,Spain,Europe
221309,scar Plano,ESP,Valladolid,La Liga,2020,29.0,1991.0,28.0,42,24,24,12,6,14,46,30.4,32,35,6,29,34,76,43,0,"MF,FW",25-29,Midfielder,Spain,Europe
336747,Jorge Pombo,ESP,Cdiz,La Liga,2020,26.0,1994.0,5.8,7,3,3,2,2,1,8,12.5,7,2,0,2,2,9,3,0,"FW,MF",25-29,Forward,Spain,Europe
242497,Pere Pons,ESP,Alavs,La Liga,2020,27.0,1993.0,13.2,20,10,8,8,4,5,16,31.3,11,15,2,13,7,27,10,0,MF,25-29,Midfielder,Spain,Europe
99353,Portu,ESP,Real Sociedad,La Liga,2020,28.0,1992.0,24.3,18,8,4,10,4,7,36,19.4,29,24,2,22,8,26,5,0,"FW,MF",25-29,Forward,Spain,Europe
262365,Antonio Puertas,ESP,Granada,La Liga,2020,28.0,1992.0,24.1,27,13,9,12,6,10,32,31.3,22,24,5,19,12,39,25,0,"FW,MF",25-29,Forward,Spain,Europe
67546,Jorge Pulido,ESP,Huesca,La Liga,2020,29.0,1991.0,32.1,39,24,31,8,0,17,29,58.6,12,32,18,14,52,91,98,0,DF,25-29,Defender,Spain,Europe
413262,Dani Raba,ESP,Villarreal,La Liga,2020,24.0,1995.0,1.7,2,1,0,1,1,2,8,25.0,6,1,0,1,0,2,0,0,"MF,FW",20-24,Midfielder,Spain,Europe
245078,Nemanja Radonji,SRB,Marseille,Ligue 1,2020,24.0,1996.0,4.4,6,5,1,2,3,2,12,16.7,10,8,0,8,3,9,1,0,FW,20-24,Forward,Serbia,Europe
199369,Sandro Ramrez,ESP,Huesca,La Liga,2020,25.0,1995.0,14.3,13,9,3,8,2,4,11,36.4,7,11,1,10,10,23,2,0,FW,25-29,Forward,Spain,Europe
25557,Sergio Ramos,ESP,Real Madrid,La Liga,2020,34.0,1986.0,14.2,15,12,8,6,1,6,10,60.0,4,9,5,4,19,34,39,1,DF,30-34,Defender,Spain,Europe
268178,Arkadiusz Reca,POL,Crotone,Serie A,2020,25.0,1995.0,25.7,34,16,15,11,8,10,45,22.2,35,30,3,27,50,84,64,0,DF,25-29,Defender,Poland,Europe
282429,Sergio Reguiln,ESP,Tottenham,Premier League,2020,23.0,1996.0,24.9,47,25,30,13,4,23,48,47.9,25,39,7,32,32,79,50,1,DF,20-24,Defender,Spain,Europe
278837,Luis Rioja,ESP,Alavs,La Liga,2020,26.0,1993.0,23.2,21,14,11,7,3,7,39,17.9,32,23,1,22,20,41,30,0,"MF,FW",25-29,Midfielder,Spain,Europe
85370,Sergi Roberto,ESP,Barcelona,La Liga,2020,28.0,1992.0,10.5,9,6,5,2,2,7,13,53.8,6,12,6,6,10,19,20,0,"DF,FW",25-29,Defender,Spain,Europe
67548,Rubn Rochina,ESP,Levante,La Liga,2020,29.0,1991.0,15.6,38,28,12,23,3,12,35,34.3,23,22,2,20,22,60,7,0,MF,25-29,Midfielder,Spain,Europe
51510,ngel Rodrguez,ESP,Getafe,La Liga,2020,33.0,1987.0,15.3,7,4,1,4,2,1,16,6.3,15,7,0,7,2,9,8,0,"FW,MF",30-34,Forward,Spain,Europe
66100,Oriol Romeu,ESP,Southampton,Premier League,2020,28.0,1991.0,19.6,69,35,25,39,5,26,68,38.2,42,28,7,21,30,99,18,0,MF,25-29,Midfielder,Spain,Europe
378139,Aitor Ruibal,ESP,Betis,La Liga,2020,24.0,1996.0,17.7,32,18,14,14,4,10,35,28.6,25,26,0,26,11,43,8,0,"FW,MF",20-24,Forward,Spain,Europe
62920,Vctor Ruiz,ESP,Betis,La Liga,2020,31.0,1989.0,24.0,11,7,7,4,0,4,13,30.8,9,17,13,4,44,55,85,0,DF,30-34,Defender,Spain,Europe
571020,Oihan Sancet,ESP,Athletic Club,La Liga,2020,20.0,2000.0,11.5,8,2,3,4,1,2,7,28.6,5,4,0,4,5,13,7,0,"FW,MF",20-24,Forward,Spain,Europe
95963,Germn Snchez,ESP,Granada,La Liga,2020,33.0,1986.0,29.3,24,11,13,9,2,11,23,47.8,12,28,26,2,38,62,130,1,DF,30-34,Defender,Spain,Europe
63040,Oier Sanjurjo,ESP,Osasuna,La Liga,2020,34.0,1986.0,23.2,39,16,8,27,4,17,60,28.3,43,24,6,18,29,68,41,0,MF,30-34,Midfielder,Spain,Europe
74230,Pablo Sarabia,ESP,Paris S-G,Ligue 1,2020,28.0,1992.0,14.7,15,11,6,6,3,10,38,26.3,28,9,1,8,5,20,8,0,"FW,MF",25-29,Forward,Spain,Europe
242086,Patrik Schick,CZE,Leverkusen,Bundesliga,2020,24.0,1996.0,20.7,7,2,0,5,2,1,4,25.0,3,5,2,3,3,10,20,0,FW,20-24,Forward,Czech Republic,Europe
340867,Jaime Seoane,ESP,Huesca,La Liga,2020,23.0,1997.0,22.9,50,30,20,23,7,24,65,36.9,41,27,6,21,17,67,14,0,MF,20-24,Midfielder,Spain,Europe
86759,David Silva,ESP,Real Sociedad,La Liga,2020,34.0,1986.0,15.5,19,12,2,14,3,8,21,38.1,13,14,1,13,13,32,8,2,MF,30-34,Midfielder,Spain,Europe
372246,Carlos Soler,ESP,Valencia,La Liga,2020,23.0,1997.0,30.4,41,24,14,24,3,19,52,36.5,33,35,11,24,23,64,41,0,MF,20-24,Midfielder,Spain,Europe
349856,Son,ESP,Levante,La Liga,2020,26.0,1994.0,12.3,18,10,11,6,1,9,19,47.4,10,11,2,9,12,30,20,0,"DF,MF",25-29,Defender,Spain,Europe
487688,Alberto Soro,ESP,Granada,La Liga,2020,21.0,1999.0,4.4,7,2,2,4,1,4,10,40.0,6,7,0,7,1,8,2,0,"FW,MF",20-24,Forward,Spain,Europe
165007,Denis Surez,ESP,Celta Vigo,La Liga,2020,26.0,1994.0,31.7,64,32,22,30,12,21,94,22.3,73,30,2,28,22,86,15,2,MF,25-29,Midfielder,Spain,Europe
111961,Suso,ESP,Sevilla,La Liga,2020,26.0,1993.0,24.6,20,10,8,6,6,10,41,24.4,31,12,0,12,8,28,8,0,FW,25-29,Forward,Spain,Europe
238407,Alexander Srloth,NOR,RB Leipzig,Bundesliga,2020,24.0,1995.0,16.0,7,5,0,5,2,2,14,14.3,12,13,2,11,3,10,13,0,FW,20-24,Forward,Norway,Europe
290273,lvaro Tejero,ESP,Eibar,La Liga,2020,24.0,1996.0,1.2,1,1,0,0,1,1,3,33.3,2,1,0,1,3,4,6,0,DF,20-24,Defender,Spain,Europe
141834,Cristian Tello,ESP,Betis,La Liga,2020,28.0,1991.0,14.3,16,10,5,9,2,4,22,18.2,18,14,0,14,11,27,8,0,"FW,MF",25-29,Forward,Spain,Europe
226524,Morten Thorsby,NOR,Sampdoria,Serie A,2020,24.0,1996.0,29.4,76,42,32,36,8,20,60,33.3,40,51,16,35,25,101,30,0,MF,20-24,Midfielder,Norway,Europe
158795,David Timor,ESP,Getafe,La Liga,2020,30.0,1989.0,15.5,13,9,5,6,2,9,21,42.9,12,5,1,4,19,32,32,1,"MF,DF",30-34,Midfielder,Spain,Europe
214775,liver Torres,ESP,Sevilla,La Liga,2020,25.0,1994.0,15.6,34,22,13,15,6,19,53,35.8,34,15,0,15,15,49,9,0,"MF,FW",25-29,Midfielder,Spain,Europe
399776,Pau Torres,ESP,Villarreal,La Liga,2020,23.0,1997.0,33.0,17,11,10,5,2,11,18,61.1,7,33,25,8,23,40,111,1,DF,20-24,Defender,Spain,Europe
213670,Lucas Torr,ESP,Osasuna,La Liga,2020,26.0,1994.0,17.2,32,15,11,19,2,21,34,61.8,13,16,7,9,27,59,43,0,MF,25-29,Midfielder,Spain,Europe
364405,Adama Traor,ESP,Wolves,Premier League,2020,24.0,1996.0,29.4,28,16,11,13,4,13,21,61.9,8,23,1,22,7,35,12,1,"FW,MF",20-24,Forward,Spain,Europe
221316,Lucas Vzquez,ESP,Real Madrid,La Liga,2020,29.0,1991.0,20.5,61,37,30,22,9,22,52,42.3,30,14,1,13,19,80,31,1,"DF,FW",25-29,Defender,Spain,Europe
184779,Gonzalo Verd,ESP,Elche,La Liga,2020,31.0,1988.0,32.7,34,19,26,8,0,16,28,57.1,12,40,30,10,52,86,113,0,DF,30-34,Defender,Spain,Europe
216870,Nacho Vidal,ESP,Osasuna,La Liga,2020,25.0,1995.0,26.1,56,28,27,22,7,22,31,71.0,9,39,10,29,43,99,68,0,DF,25-29,Defender,Spain,Europe
337066,Toni Villa,ESP,Valladolid,La Liga,2020,25.0,1995.0,10.8,31,16,11,14,6,15,42,35.7,27,15,1,14,5,36,3,0,"MF,FW",25-29,Midfielder,Spain,Europe
251897,Asier Villalibre,ESP,Athletic Club,La Liga,2020,22.0,1997.0,17.7,3,2,0,2,1,2,8,25.0,6,4,0,4,2,5,16,0,FW,20-24,Forward,Spain,Europe
398163,Gonzalo Villar,ESP,Roma,Serie A,2020,22.0,1998.0,20.7,44,18,14,24,6,18,61,29.5,43,25,3,22,22,66,14,1,MF,20-24,Midfielder,Spain,Europe
357498,Duan Vlahovi,SRB,Fiorentina,Serie A,2020,20.0,2000.0,32.5,13,4,3,4,6,5,16,31.3,11,16,2,14,4,17,15,0,FW,20-24,Forward,Serbia,Europe
345458,Sebastian Walukiewicz,POL,Cagliari,Serie A,2020,20.0,2000.0,18.0,27,19,11,13,3,12,30,40.0,18,22,14,8,36,63,60,0,DF,20-24,Defender,Poland,Europe
181136,Piotr Zieliski,POL,Napoli,Serie A,2020,26.0,1994.0,28.0,18,10,8,7,3,7,20,35.0,13,23,4,19,18,36,12,0,MF,25-29,Midfielder,Poland,Europe
355628,Igor Zubeldia,ESP,Real Sociedad,La Liga,2020,23.0,1997.0,21.8,23,16,15,8,0,8,14,57.1,6,20,13,7,12,35,46,0,DF,20-24,Defender,Spain,Europe
393323,Brenden Aaronson,USA,Union Berlin,Bundesliga,2023,22.0,2000.0,14.1,32,18,13,13,6,16,32,50.0,16,26,1,25,2,34,4,0,"MF,FW",20-24,Midfielder,United States,North America
199704,Yunis Abdelhamid,MAR,Reims,Ligue 1,2023,35.0,1987.0,30.9,64,35,36,23,5,26,45,57.8,19,51,32,19,39,103,109,2,DF,35-39,Defender,Morocco,Africa
238626,Laurent Abergel,FRA,Lorient,Ligue 1,2023,30.0,1993.0,31.8,85,52,43,34,8,38,96,39.6,58,29,6,23,61,146,61,3,MF,30-34,Midfielder,France,Europe
393238,Zakaria Aboukhlal,MAR,Toulouse,Ligue 1,2023,23.0,2000.0,8.4,9,8,1,5,3,3,12,25.0,9,9,1,8,1,10,2,0,"MF,FW",20-24,Midfielder,Morocco,Africa
559979,Abdel Abqar,MAR,Alavs,La Liga,2023,24.0,1999.0,25.7,35,19,28,5,2,21,35,60.0,14,31,26,5,23,58,115,0,DF,20-24,Defender,Morocco,Africa
131075,Francesco Acerbi,ITA,Inter,Serie A,2023,35.0,1988.0,26.5,22,13,16,6,0,11,14,78.6,3,20,13,7,32,54,77,1,DF,35-39,Defender,Italy,Europe
607034,Akor Adams,NGA,Montpellier,Ligue 1,2023,23.0,2000.0,25.0,12,4,3,4,5,3,7,42.9,4,9,2,7,5,17,11,0,FW,20-24,Forward,Nigeria,Africa
452477,Junior Adamu,AUT,Freiburg,Bundesliga,2023,22.0,2001.0,1.2,5,1,1,2,2,1,2,50.0,1,1,0,1,0,5,2,0,"FW,MF",20-24,Forward,Austria,Europe
125614,Sargis Adamyan,ARM,Kln,Bundesliga,2023,30.0,1993.0,8.9,14,9,2,9,3,6,11,54.5,5,16,1,15,5,19,7,0,"FW,MF",30-34,Forward,Armenia,Asia
258878,Tosin Adarabioyo,ENG,Fulham,Premier League,2023,25.0,1997.0,18.0,21,11,16,5,0,12,21,57.1,9,16,11,5,25,46,80,0,DF,25-29,Defender,England,Europe
319900,Elijah Adebayo,ENG,Luton Town,Premier League,2023,25.0,1998.0,15.8,4,1,1,0,3,1,12,8.3,11,13,2,11,6,10,25,0,FW,25-29,Forward,England,Europe
496094,Karim Adeyemi,GER,Dortmund,Bundesliga,2023,21.0,2002.0,10.1,16,14,9,4,3,8,20,40.0,12,11,0,11,3,19,5,0,"FW,MF",20-24,Forward,Germany,Europe
658536,Simon Adingra,CIV,Brighton,Premier League,2023,21.0,2002.0,24.7,45,20,23,11,11,19,42,45.2,23,31,1,30,19,64,22,0,FW,20-24,Forward,Ivory Coast,Africa
532776,Amine Adli,MAR,Leverkusen,Bundesliga,2023,23.0,2000.0,10.0,16,7,2,10,4,7,17,41.2,10,10,2,8,6,22,5,0,"MF,FW",20-24,Midfielder,Morocco,Africa
395236,Yacine Adli,FRA,Milan,Serie A,2023,23.0,2000.0,15.6,34,17,17,13,4,13,35,37.1,22,22,8,14,20,54,15,1,MF,20-24,Midfielder,France,Europe
683895,Emmanuel Agbadou,CIV,Reims,Ligue 1,2023,26.0,1997.0,28.8,65,41,38,23,4,44,64,68.8,20,47,25,22,55,120,116,1,DF,25-29,Defender,Ivory Coast,Africa
361914,Nayef Aguerd,MAR,West Ham,Premier League,2023,27.0,1996.0,20.6,26,14,19,7,0,16,22,72.7,6,33,24,9,17,43,85,2,DF,25-29,Defender,Morocco,Africa
203746,Ruben Aguilar,FRA,Lens,Ligue 1,2023,30.0,1993.0,21.4,53,31,27,23,3,27,45,60.0,18,35,5,30,26,79,46,0,DF,30-34,Defender,France,Europe
538971,Naouirou Ahamada,FRA,Crystal Palace,Premier League,2023,21.0,2002.0,3.9,13,9,5,6,2,8,17,47.1,9,3,0,3,2,15,4,0,"MF,FW",20-24,Midfielder,France,Europe
236490,Ola Aina,NGA,Nott'ham Forest,Premier League,2023,26.0,1996.0,18.8,47,31,31,12,4,29,41,70.7,12,19,3,16,18,65,51,1,DF,25-29,Defender,Nigeria,Africa
283994,Ludovic Ajorque,FRA,Mainz 05,Bundesliga,2023,29.0,1994.0,15.1,3,2,1,2,0,2,11,18.2,9,6,2,4,4,7,11,0,FW,25-29,Forward,France,Europe
177476,Nathan Ak,NED,Manchester City,Premier League,2023,28.0,1995.0,22.7,26,16,15,8,3,13,20,65.0,7,17,2,15,14,40,54,0,DF,25-29,Defender,Netherlands,Europe
709969,Ilias Akhomach,MAR,Villarreal,La Liga,2023,19.0,2004.0,16.8,36,21,11,16,9,10,20,50.0,10,10,2,8,13,49,13,0,"MF,FW",Under 20,Midfielder,Morocco,Africa
748319,Carlos Alcaraz,ARG,Juventus,Serie A,2023,20.0,2002.0,4.2,6,6,0,6,0,5,10,50.0,5,5,2,3,5,11,4,0,MF,20-24,Midfielder,Argentina,South America
353032,Omar Alderete,PAR,Getafe,La Liga,2023,26.0,1996.0,24.4,28,21,15,13,0,19,35,54.3,16,30,18,12,13,41,111,0,DF,25-29,Defender,Paraguay,South America
314353,Trent Alexander-Arnold,ENG,Liverpool,Premier League,2023,24.0,1998.0,23.9,39,26,26,11,2,27,87,31.0,60,22,2,20,31,70,48,5,DF,20-24,Defender,England,Europe
456492,Faride Alidou,GER,Kln,Bundesliga,2023,22.0,2001.0,14.2,10,4,3,6,1,4,18,22.2,14,23,2,21,8,18,15,1,"FW,MF",20-24,Forward,Germany,Europe
872184,Tadeo Allende,ARG,Celta Vigo,La Liga,2023,24.0,1999.0,3.7,6,1,3,2,1,4,6,66.7,2,3,0,3,3,9,3,0,"MF,FW",20-24,Midfielder,Argentina,South America
646733,Jim Allevinah,GAB,Clermont Foot,Ligue 1,2023,28.0,1995.0,20.7,30,18,11,14,5,14,35,40.0,21,20,3,17,13,43,30,0,"MF,DF",25-29,Midfielder,Gabon,Africa
300532,Pontus Almqvist,SWE,Lecce,Serie A,2023,24.0,1999.0,23.4,45,29,16,22,7,23,51,45.1,28,21,2,19,14,59,10,0,"FW,MF",20-24,Forward,Sweden,Europe
401356,Edson lvarez,MEX,West Ham,Premier League,2023,25.0,1997.0,26.4,80,39,47,26,7,31,66,47.0,35,59,20,39,42,122,81,0,MF,25-29,Midfielder,Mexico,North America
577486,Gastn lvarez,URU,Getafe,La Liga,2023,23.0,2000.0,28.2,68,37,43,20,5,37,57,64.9,20,40,11,29,35,103,80,0,DF,20-24,Defender,Uruguay,South America
855134,Skelly Alvero,FRA,Lyon,Ligue 1,2023,21.0,2002.0,4.7,8,7,5,2,1,2,9,22.2,7,5,1,4,2,10,5,0,MF,20-24,Midfielder,France,Europe
1099726,Papa Amadou Diallo,SEN,Metz,Ligue 1,2023,19.0,2004.0,9.9,18,8,10,7,1,7,21,33.3,14,11,1,10,11,29,16,0,FW,Under 20,Forward,Senegal,Africa
377219,Selim Amallah,MAR,Valencia,La Liga,2023,26.0,1996.0,6.7,17,12,7,7,3,3,9,33.3,6,13,0,13,11,28,6,0,"FW,MF",25-29,Forward,Morocco,Africa
241229,Jordan Amavi,FRA,Brest,Ligue 1,2023,29.0,1994.0,1.0,1,1,0,1,0,1,3,33.3,2,2,1,1,3,4,2,0,DF,25-29,Defender,France,Europe
644676,Bruno Amione,ARG,Hellas Verona,Serie A,2023,21.0,2002.0,6.4,11,3,9,2,0,4,5,80.0,1,4,2,2,9,20,19,2,DF,20-24,Defender,Argentina,South America
260827,Joachim Andersen,DEN,Crystal Palace,Premier League,2023,27.0,1996.0,37.9,56,35,33,21,2,29,39,74.4,10,33,18,15,41,97,207,1,DF,25-29,Defender,Denmark,Europe
567576,Elliot Anderson,ENG,Newcastle Utd,Premier League,2023,20.0,2002.0,11.4,24,18,12,9,3,15,29,51.7,14,23,4,19,8,32,23,0,"MF,FW",20-24,Midfielder,England,Europe
159372,Felipe Anderson,BRA,Lazio,Serie A,2023,30.0,1993.0,30.8,78,45,32,33,13,34,90,37.8,56,45,3,42,27,105,23,0,"FW,MF",30-34,Forward,Brazil,South America
84301,Benjamin Andr,FRA,Lille,Ligue 1,2023,32.0,1990.0,28.6,89,49,39,45,5,43,81,53.1,38,34,5,29,35,124,60,0,MF,30-34,Midfielder,France,Europe
743598,ngelo,BRA,Strasbourg,Ligue 1,2023,18.0,2004.0,12.2,24,11,9,7,8,11,31,35.5,20,18,0,18,9,33,2,0,"FW,MF",Under 20,Forward,Brazil,South America
684210,Jaidon Anthony,ENG,Bournemouth,Premier League,2023,23.0,1999.0,1.7,3,1,1,0,2,1,7,14.3,6,3,0,3,1,4,3,0,FW,20-24,Forward,England,Europe
193004,Waldemar Anton,GER,Stuttgart,Bundesliga,2023,27.0,1996.0,32.1,39,25,21,16,2,23,42,54.8,19,33,20,13,40,79,150,1,DF,25-29,Defender,Germany,Europe
798687,Antony,BRA,Manchester Utd,Premier League,2023,23.0,2000.0,14.7,40,21,15,19,6,20,40,50.0,20,29,1,28,12,52,9,0,FW,20-24,Forward,Brazil,South America
289182,Christopher Antwi-Adjei,GHA,Bochum,Bundesliga,2023,29.0,1994.0,13.5,21,12,10,6,5,12,22,54.5,10,13,2,11,2,23,11,1,"FW,MF",25-29,Forward,Ghana,Africa
395693,Houssem Aouar,ALG,Roma,Serie A,2023,25.0,1998.0,8.4,16,11,4,10,2,3,12,25.0,9,5,0,5,4,20,2,1,"MF,FW",25-29,Midfielder,Algeria,Africa
874066,Oliver Arblaster,ENG,Sheffield Utd,Premier League,2023,19.0,2004.0,10.5,23,14,11,8,4,7,15,46.7,8,17,7,10,15,38,9,0,MF,Under 20,Midfielder,England,Europe
652275,Hkon Arnar Haraldsson,ISL,Lille,Ligue 1,2023,20.0,2003.0,14.3,12,8,4,7,1,5,21,23.8,16,7,2,5,3,15,5,0,"FW,MF",20-24,Forward,Iceland,Europe
977464,Arthur,BRA,Leverkusen,Bundesliga,2023,20.0,2003.0,2.0,4,3,2,0,2,2,2,100.0,0,1,1,0,0,4,7,0,DF,20-24,Defender,Brazil,South America
245744,Takuma Asano,JPN,Bochum,Bundesliga,2023,28.0,1994.0,22.1,17,6,2,9,6,7,23,30.4,16,17,3,14,4,21,11,0,"FW,MF",25-29,Forward,Japan,Asia
543771,Kristjan Asllani,ALB,Inter,Serie A,2023,21.0,2002.0,8.7,7,2,3,4,0,2,11,18.2,9,9,3,6,11,18,8,0,MF,20-24,Midfielder,Albania,Europe
375391,Joel Asoro,SWE,Metz,Ligue 1,2023,24.0,1999.0,9.4,13,9,7,6,0,3,10,30.0,7,7,1,6,6,19,9,0,"FW,MF",20-24,Forward,Sweden,Europe
855308,Arthur Atta,FRA,Metz,Ligue 1,2023,20.0,2003.0,10.3,18,14,8,7,3,8,19,42.1,11,13,3,10,10,28,23,0,"MF,FW",20-24,Midfielder,France,Europe
58864,Pierre-Emerick Aubameyang,GAB,Marseille,Ligue 1,2023,34.0,1989.0,29.1,22,14,4,11,7,7,26,26.9,19,30,5,25,9,31,26,0,FW,30-34,Forward,Gabon,Africa
284595,Tommaso Augello,ITA,Cagliari,Serie A,2023,28.0,1994.0,26.9,26,19,18,6,2,16,25,64.0,9,21,10,11,17,43,89,0,DF,25-29,Defender,Italy,Europe
585982,Carlos Augusto,BRA,Inter,Serie A,2023,24.0,1999.0,19.2,29,21,20,9,0,15,22,68.2,7,20,8,12,16,45,52,0,DF,20-24,Defender,Brazil,South America
127032,Serge Aurier,CIV,Nott'ham Forest,Premier League,2023,30.0,1992.0,9.3,20,14,9,11,0,5,11,45.5,6,10,3,7,9,29,36,1,"DF,MF",30-34,Defender,Ivory Coast,Africa
295313,Taiwo Awoniyi,NGA,Nott'ham Forest,Premier League,2023,25.0,1997.0,11.6,9,7,1,4,4,1,2,50.0,1,7,2,5,1,10,9,0,FW,25-29,Forward,Nigeria,Africa
45403,Andr Ayew,GHA,Le Havre,Ligue 1,2023,33.0,1989.0,12.3,15,11,7,6,2,6,9,66.7,3,8,3,5,2,17,11,0,FW,30-34,Forward,Ghana,Africa
108354,Jordan Ayew,GHA,Crystal Palace,Premier League,2023,31.0,1991.0,28.3,65,36,23,28,14,21,42,50.0,21,43,2,41,16,81,15,0,"FW,MF",30-34,Forward,Ghana,Africa
901019,Neil El Aynaoui,FRA,Lens,Ligue 1,2023,22.0,2001.0,17.4,37,20,13,20,4,20,46,43.5,26,20,6,14,32,69,21,1,MF,20-24,Midfielder,France,Europe
180337,Sardar Azmoun,IRN,Roma,Serie A,2023,28.0,1995.0,6.5,8,5,2,5,1,4,8,50.0,4,4,1,3,3,11,6,1,"FW,MF",25-29,Forward,Iran,Asia
310527,Paulo Azzi,BRA,Cagliari,Serie A,2023,29.0,1994.0,10.6,19,11,10,6,3,9,18,50.0,9,11,2,9,16,35,23,0,"DF,MF",25-29,Defender,Brazil,South America
531065,Oussama El Azzouzi,MAR,Bologna,Serie A,2023,22.0,2001.0,6.1,12,7,4,5,3,7,14,50.0,7,8,2,6,6,18,12,0,MF,20-24,Midfielder,Morocco,Africa
442805,Iddrisu Baba,GHA,Almera,La Liga,2023,27.0,1996.0,15.9,46,26,27,18,1,17,39,43.6,22,20,6,14,11,57,27,2,MF,25-29,Midfielder,Ghana,Africa
916920,Shavy Babicka,GAB,Toulouse,Ligue 1,2023,23.0,2000.0,4.1,11,8,2,7,2,2,5,40.0,3,6,1,5,0,11,2,0,"FW,MF",20-24,Forward,Gabon,Africa
463603,Benot Badiashile,FRA,Chelsea,Premier League,2023,22.0,2001.0,14.9,21,15,12,9,0,9,14,64.3,5,21,14,7,18,39,66,2,DF,20-24,Defender,France,Europe
238654,Jaime Bez,URU,Frosinone,Serie A,2023,28.0,1995.0,5.6,4,1,0,2,2,0,7,0.0,7,5,0,5,4,8,1,0,"FW,MF",25-29,Forward,Uruguay,South America
387626,Leon Bailey,JAM,Aston Villa,Premier League,2023,25.0,1997.0,23.0,13,7,7,4,2,5,20,25.0,15,18,1,17,9,22,6,0,"MF,FW",25-29,Midfielder,Jamaica,North America
540664,Dilane Bakwa,FRA,Strasbourg,Ligue 1,2023,20.0,2002.0,24.2,30,22,12,13,5,11,40,27.5,29,26,1,25,20,50,11,0,"FW,MF",20-24,Forward,France,Europe
641537,Tommaso Baldanzi,ITA,Empoli,Serie A,2023,20.0,2003.0,8.3,4,2,1,1,2,3,10,30.0,7,7,0,7,2,6,0,0,"MF,FW",20-24,Midfielder,Italy,Europe
575998,Leonardo Balerdi,ARG,Marseille,Ligue 1,2023,24.0,1999.0,25.2,79,50,55,23,1,49,67,73.1,18,38,15,23,51,130,91,0,DF,20-24,Defender,Argentina,South America
85295,Ivn Balliu,ALB,Rayo Vallecano,La Liga,2023,31.0,1992.0,31.9,44,31,20,24,0,22,39,56.4,17,27,11,16,29,73,66,1,DF,30-34,Defender,Albania,Europe
503770,Folarin Balogun,USA,Monaco,Ligue 1,2023,22.0,2001.0,18.8,12,4,3,8,1,5,13,38.5,8,10,0,10,3,15,4,0,FW,20-24,Forward,United States,North America
292818,Jonathan Bamba,CIV,Celta Vigo,La Liga,2023,27.0,1996.0,22.0,14,9,4,8,2,2,17,11.8,15,20,0,20,18,32,12,0,"MF,FW",25-29,Midfielder,Ivory Coast,Africa
1178475,Mohamed Bamba,CIV,Lorient,Ligue 1,2023,21.0,2001.0,12.6,14,9,3,8,3,4,10,40.0,6,7,1,6,2,16,3,0,FW,20-24,Forward,Ivory Coast,Africa
545538,Lameck Banda,ZAM,Lecce,Serie A,2023,22.0,2001.0,15.0,27,23,11,12,4,7,21,33.3,14,18,0,18,3,30,7,0,FW,20-24,Forward,Zambia,Africa
533916,Shandon Baptiste,GRN,Brentford,Premier League,2023,25.0,1998.0,2.5,4,4,2,2,0,1,5,20.0,4,5,1,4,3,7,6,0,MF,25-29,Midfielder,Grenada,North America
849410,Valentn Barco,ARG,Brighton,Premier League,2023,19.0,2004.0,3.4,11,5,4,5,2,6,8,75.0,2,3,0,3,4,15,3,1,"DF,FW",Under 20,Defender,Argentina,South America
255942,Nicol Barella,ITA,Inter,Serie A,2023,26.0,1997.0,31.6,46,30,17,20,9,19,63,30.2,44,31,1,30,10,56,12,1,MF,25-29,Midfielder,Italy,Europe
131978,Ross Barkley,ENG,Luton Town,Premier League,2023,29.0,1993.0,29.1,47,19,16,21,10,11,48,22.9,37,25,9,16,25,72,51,2,MF,25-29,Midfielder,England,Europe
315332,Aymen Barkok,MAR,Mainz 05,Bundesliga,2023,25.0,1998.0,3.6,9,5,2,6,1,3,6,50.0,3,7,0,7,2,11,1,0,"MF,FW",25-29,Midfielder,Morocco,Africa
398065,Harvey Barnes,ENG,Newcastle Utd,Premier League,2023,25.0,1997.0,8.9,6,1,3,2,1,1,2,50.0,1,1,0,1,5,11,3,0,"FW,MF",25-29,Forward,England,Europe
671915,Enzo Barrenechea,ARG,Frosinone,Serie A,2023,22.0,2001.0,31.2,65,42,28,29,8,28,70,40.0,42,47,12,35,27,92,61,2,MF,20-24,Midfielder,Argentina,South America
334835,Toma Bai,CRO,Salernitana,Serie A,2023,26.0,1996.0,12.9,20,13,10,9,1,10,27,37.0,17,18,6,12,14,34,29,0,MF,25-29,Midfielder,Croatia,Europe
461883,Calvin Bassey,NGA,Fulham,Premier League,2023,23.0,1999.0,25.6,49,29,33,15,1,21,29,72.4,8,32,11,21,28,77,84,4,DF,20-24,Defender,Nigeria,Africa
315853,Alessandro Bastoni,ITA,Inter,Serie A,2023,24.0,1999.0,25.2,46,33,31,12,3,26,40,65.0,14,25,11,14,23,69,48,1,DF,20-24,Defender,Italy,Europe
257751,Simone Bastoni,ITA,Empoli,Serie A,2023,26.0,1996.0,8.3,22,13,12,7,3,11,22,50.0,11,8,0,8,11,33,18,0,"MF,DF",25-29,Midfielder,Italy,Europe
324278,Christoph Baumgartner,AUT,RB Leipzig,Bundesliga,2023,23.0,1999.0,12.9,26,13,10,12,4,14,38,36.8,24,20,1,19,5,31,14,0,"MF,FW",20-24,Midfielder,Austria,Europe
153427,Beb,CPV,Rayo Vallecano,La Liga,2023,33.0,1990.0,2.4,2,2,1,1,0,1,5,20.0,4,1,0,1,0,2,0,0,"MF,FW",30-34,Midfielder,Cape Verde,Africa
273669,Adrian Beck,GER,Heidenheim,Bundesliga,2023,26.0,1997.0,10.8,22,13,8,12,2,9,24,37.5,15,17,0,17,4,26,15,0,"MF,FW",25-29,Midfielder,Germany,Europe
188888,Sheraldo Becker,SUR,Real Sociedad,La Liga,2023,28.0,1995.0,8.6,2,2,0,2,0,0,1,0.0,1,3,0,3,1,3,0,0,"FW,MF",25-29,Forward,Suriname,South America
117432,Kevin Behrens,GER,Wolfsburg,Bundesliga,2023,32.0,1991.0,6.8,2,1,0,1,1,0,2,0.0,2,9,0,9,3,5,6,0,FW,30-34,Forward,Germany,Europe
170966,Jrmie Bela,ANG,Clermont Foot,Ligue 1,2023,30.0,1993.0,2.3,1,1,0,1,0,1,3,33.3,2,1,0,1,0,1,1,0,"MF,FW",30-34,Midfielder,Angola,Africa
278166,Amari'i Bell,JAM,Luton Town,Premier League,2023,29.0,1994.0,19.1,50,33,30,19,1,22,35,62.9,13,33,15,18,25,75,60,1,DF,25-29,Defender,Jamaica,North America
82350,Stefan Bell,GER,Mainz 05,Bundesliga,2023,31.0,1991.0,7.4,8,8,7,1,0,4,8,50.0,4,7,5,2,6,14,30,0,DF,30-34,Defender,Germany,Europe
450050,Jean-Ricner Bellegarde,FRA,Wolves,Premier League,2023,25.0,1998.0,10.6,17,10,9,6,2,7,15,46.7,8,18,2,16,8,25,14,0,"MF,FW",25-29,Midfielder,France,Europe
581678,Jude Bellingham,ENG,Real Madrid,La Liga,2023,20.0,2003.0,25.7,42,34,14,18,10,12,36,33.3,24,55,5,50,21,63,17,0,MF,20-24,Midfielder,England,Europe
628366,Lucas Beltrn,ARG,Fiorentina,Serie A,2023,22.0,2001.0,18.8,27,14,4,18,5,11,20,55.0,9,29,3,26,2,29,11,0,"FW,MF",20-24,Forward,Argentina,South America
810895,Eliesse Ben Seghir,MAR,Monaco,Ligue 1,2023,18.0,2005.0,4.8,9,6,2,5,2,3,7,42.9,4,6,0,6,2,11,2,0,"MF,FW",Under 20,Midfielder,Morocco,Africa
146854,Wissam Ben Yedder,FRA,Monaco,Ligue 1,2023,32.0,1990.0,25.7,4,3,1,2,1,1,11,9.1,10,18,0,18,8,12,1,0,FW,30-34,Forward,France,Europe
351816,Ismal Bennacer,ALG,Milan,Serie A,2023,25.0,1997.0,12.8,29,19,11,16,2,11,22,50.0,11,12,4,8,12,41,9,2,MF,25-29,Midfielder,Algeria,Africa
290532,Sad Benrahma,ALG,West Ham,Premier League,2023,27.0,1995.0,6.9,8,4,5,3,0,4,15,26.7,11,8,0,8,5,13,7,0,"FW,MF",25-29,Forward,Algeria,Africa
245537,Nabil Bentaleb,ALG,Lille,Ligue 1,2023,28.0,1994.0,21.9,49,32,29,18,2,22,43,51.2,21,33,12,21,37,86,33,0,MF,25-29,Midfielder,Algeria,Africa
872171,Lucas Beraldo,BRA,Paris S-G,Ligue 1,2023,19.0,2003.0,11.2,22,14,14,8,0,10,25,40.0,15,15,6,9,20,42,25,0,DF,Under 20,Defender,Brazil,South America
177843,Domenico Berardi,ITA,Sassuolo,Serie A,2023,28.0,1994.0,15.9,17,8,7,9,1,2,21,9.5,19,17,0,17,13,30,9,0,FW,25-29,Forward,Italy,Europe
719646,Bernardo,BRA,Bochum,Bundesliga,2023,28.0,1995.0,32.5,99,58,56,35,8,45,69,65.2,24,66,30,36,55,154,120,1,DF,25-29,Defender,Brazil,South America
125685,Luke Berry,ENG,Luton Town,Premier League,2023,31.0,1992.0,3.6,7,2,2,4,1,2,3,66.7,1,6,1,5,0,7,3,0,"MF,DF",30-34,Midfielder,England,Europe
433984,Sam Beukema,NED,Bologna,Serie A,2023,24.0,1998.0,28.3,27,11,14,11,2,16,25,64.0,9,35,21,14,15,42,99,2,DF,20-24,Defender,Netherlands,Europe
649016,El Bilal Tour,MLI,Atalanta,Serie A,2023,21.0,2001.0,4.4,1,1,0,1,0,0,1,0.0,1,0,0,0,1,2,2,0,FW,20-24,Forward,Mali,Africa
320411,Philip Billing,DEN,Bournemouth,Premier League,2023,27.0,1996.0,15.5,33,16,7,22,4,9,27,33.3,18,31,5,26,20,53,28,1,MF,25-29,Midfielder,Denmark,Europe
124555,Cristiano Biraghi,ITA,Fiorentina,Serie A,2023,30.0,1992.0,26.2,47,28,20,24,3,28,52,53.8,24,30,5,25,14,61,43,0,DF,30-34,Defender,Italy,Europe
461019,Samuele Birindelli,ITA,Monza,Serie A,2023,24.0,1999.0,22.4,28,19,16,7,5,14,25,56.0,11,30,11,19,18,46,48,0,DF,20-24,Defender,Italy,Europe
822959,Tom Bischof,GER,Hoffenheim,Bundesliga,2023,18.0,2005.0,2.0,8,4,6,1,1,2,9,22.2,7,3,0,3,1,9,2,0,"MF,FW",Under 20,Midfielder,Germany,Europe
410425,Yves Bissouma,MLI,Tottenham,Premier League,2023,26.0,1996.0,23.0,80,52,32,36,12,41,61,67.2,20,28,5,23,37,117,43,3,MF,25-29,Midfielder,Mali,Africa
93844,Leonardo Bittencourt,GER,Werder Bremen,Bundesliga,2023,29.0,1993.0,17.5,42,18,20,17,5,15,39,38.5,24,18,1,17,13,55,6,0,MF,25-29,Midfielder,Germany,Europe
288225,Ludovic Blas,FRA,Rennes,Ligue 1,2023,25.0,1997.0,17.4,30,14,16,13,1,12,28,42.9,16,13,1,12,6,36,9,0,"FW,MF",25-29,Forward,France,Europe
236041,Alexis Blin,FRA,Lecce,Serie A,2023,26.0,1996.0,18.2,33,19,11,19,3,15,43,34.9,28,16,2,14,22,55,39,0,MF,25-29,Midfielder,France,Europe
12282,Daley Blind,NED,Girona,La Liga,2023,33.0,1990.0,33.0,47,21,33,13,1,29,47,61.7,18,37,19,18,21,68,113,0,DF,30-34,Defender,Netherlands,Europe
412932,Myron Boadu,NED,Monaco,Ligue 1,2023,22.0,2001.0,0.9,2,2,0,1,1,1,2,50.0,1,2,0,2,0,2,0,0,FW,20-24,Forward,Netherlands,Europe
465717,Jayden Bogle,ENG,Sheffield Utd,Premier League,2023,23.0,2000.0,31.0,66,36,43,21,2,35,70,50.0,35,42,11,31,32,98,97,0,DF,20-24,Defender,England,Europe
441515,Daniel Boloca,ROU,Sassuolo,Serie A,2023,24.0,1998.0,22.5,48,33,18,25,5,27,46,58.7,19,23,13,10,14,62,33,2,MF,20-24,Midfielder,Romania,Europe
142310,Willy Boly,CIV,Nott'ham Forest,Premier League,2023,32.0,1991.0,16.0,46,29,36,9,1,22,40,55.0,18,32,21,11,25,71,90,0,DF,30-34,Defender,Ivory Coast,Africa
57280,Giacomo Bonaventura,ITA,Fiorentina,Serie A,2023,33.0,1989.0,25.3,26,13,6,10,10,9,21,42.9,12,16,1,15,14,40,10,0,MF,30-34,Midfielder,Italy,Europe
241527,Federico Bonazzoli,ITA,Hellas Verona,Serie A,2023,26.0,1997.0,11.3,4,1,1,3,0,1,8,12.5,7,9,1,8,3,7,3,0,"FW,MF",25-29,Forward,Italy,Europe
659516,Warren Bondo,FRA,Monza,Serie A,2023,19.0,2003.0,16.4,29,22,16,10,3,13,17,76.5,4,13,3,10,6,35,13,0,MF,Under 20,Midfielder,France,Europe
656681,Victor Boniface,NGA,Leverkusen,Bundesliga,2023,22.0,2000.0,17.2,6,4,0,1,5,1,4,25.0,3,6,1,5,0,6,13,0,FW,20-24,Forward,Nigeria,Africa
557939,Neto Borges,BRA,Clermont Foot,Ligue 1,2023,26.0,1996.0,28.0,48,24,25,18,5,28,63,44.4,35,28,6,22,57,105,84,0,DF,25-29,Defender,Brazil,South America
338629,Sebastiaan Bornauw,BEL,Wolfsburg,Bundesliga,2023,24.0,1999.0,15.9,26,12,19,7,0,13,19,68.4,6,21,12,9,18,44,81,0,DF,20-24,Defender,Belgium,Europe
323831,Rafael Borr,COL,Werder Bremen,Bundesliga,2023,27.0,1995.0,11.0,10,7,2,4,4,5,16,31.3,11,8,2,6,2,12,10,0,FW,25-29,Forward,Colombia,South America
361093,Sven Botman,NED,Newcastle Utd,Premier League,2023,23.0,2000.0,15.3,20,13,14,6,0,8,13,61.5,5,20,16,4,9,29,61,3,DF,20-24,Defender,Netherlands,Europe
707242,Badredine Bouanani,ALG,Nice,Ligue 1,2023,18.0,2004.0,1.8,3,2,1,1,1,3,4,75.0,1,5,0,5,3,6,0,0,FW,Under 20,Forward,Algeria,Africa
560593,Hicham Boudaoui,ALG,Nice,Ligue 1,2023,23.0,1999.0,17.9,41,19,16,22,3,21,30,70.0,9,15,1,14,11,52,15,0,MF,20-24,Midfielder,Algeria,Africa
266359,Benjamin Bourigeaud,FRA,Rennes,Ligue 1,2023,29.0,1994.0,26.9,31,18,14,9,8,13,44,29.5,31,31,2,29,22,53,39,2,"MF,FW",25-29,Midfielder,France,Europe
562049,Edoardo Bove,ITA,Roma,Serie A,2023,21.0,2002.0,19.8,60,31,16,31,13,27,46,58.7,19,21,1,20,11,71,11,1,MF,20-24,Midfielder,Italy,Europe
314875,Jarrod Bowen,ENG,West Ham,Premier League,2023,26.0,1996.0,33.5,42,28,14,14,14,13,35,37.1,22,37,5,32,19,61,14,0,FW,25-29,Forward,England,Europe
334222,Lucas Boy,ARG,Granada,La Liga,2023,27.0,1996.0,28.2,50,25,14,25,11,14,34,41.2,20,35,5,30,10,60,46,0,FW,25-29,Forward,Argentina,South America
357796,Domagoj Bradari,CRO,Salernitana,Serie A,2023,23.0,1999.0,30.5,29,20,13,10,6,15,25,60.0,10,22,7,15,32,61,62,1,DF,20-24,Defender,Croatia,Europe
187492,Julian Brandt,GER,Dortmund,Bundesliga,2023,27.0,1996.0,24.7,17,14,8,8,1,10,27,37.0,17,20,3,17,8,25,18,0,"MF,FW",25-29,Midfielder,Germany,Europe
661053,Jarrad Branthwaite,ENG,Everton,Premier League,2023,21.0,2002.0,34.6,66,32,42,22,2,45,62,72.6,17,51,36,15,50,116,163,2,DF,20-24,Defender,England,Europe
485960,Lilian Brassier,FRA,Brest,Ligue 1,2023,23.0,1999.0,29.7,31,18,18,13,0,12,24,50.0,12,28,21,7,41,72,93,0,DF,20-24,Defender,France,Europe
973703,Brenner,BRA,Udinese,Serie A,2023,23.0,2000.0,2.1,8,7,1,5,2,4,7,57.1,3,2,0,2,0,8,2,0,"MF,FW",20-24,Midfielder,Brazil,South America
746739,Andre Brooks,ENG,Sheffield Utd,Premier League,2023,19.0,2003.0,10.4,22,13,7,11,4,9,21,42.9,12,13,1,12,14,36,20,0,"MF,DF",Under 20,Midfielder,England,Europe
277033,David Brooks,WAL,Bournemouth,Premier League,2023,26.0,1997.0,3.1,5,4,2,1,2,2,4,50.0,2,3,0,3,2,7,2,0,"FW,MF",25-29,Forward,Wales,Europe
124732,John Brooks,USA,Hoffenheim,Bundesliga,2023,30.0,1993.0,17.1,28,15,17,10,1,15,30,50.0,15,29,17,12,27,55,109,1,DF,30-34,Defender,United States,North America
406973,Moritz Broschinski,GER,Bochum,Bundesliga,2023,22.0,2000.0,13.9,11,7,2,5,4,2,8,25.0,6,11,2,9,0,11,6,0,FW,20-24,Forward,Germany,Europe
469958,Jacob Brown,SCO,Luton Town,Premier League,2023,25.0,1998.0,11.3,19,12,7,7,5,7,18,38.9,11,20,1,19,8,27,22,0,"MF,FW",25-29,Midfielder,Scotland,Europe
293569,Josh Brownhill,ENG,Burnley,Premier League,2023,27.0,1995.0,25.0,61,35,23,28,10,27,37,73.0,10,33,8,25,34,95,40,1,MF,25-29,Midfielder,England,Europe
293281,Jacob Bruun Larsen,DEN,Burnley,Premier League,2023,24.0,1998.0,13.9,9,4,4,3,2,7,21,33.3,14,16,2,14,7,16,23,0,"MF,FW",20-24,Midfielder,Denmark,Europe
638793,Tajon Buchanan,CAN,Inter,Serie A,2023,24.0,1999.0,1.8,1,1,0,0,1,1,2,50.0,1,1,0,1,0,1,4,0,DF,20-24,Defender,Canada,North America
46413,Ante Budimir,CRO,Osasuna,La Liga,2023,32.0,1991.0,27.1,21,15,2,11,8,5,14,35.7,9,19,5,14,5,26,18,0,FW,30-34,Forward,Croatia,Europe
983989,Facundo Buonanotte,ARG,Brighton,Premier League,2023,18.0,2004.0,15.2,42,22,13,22,7,14,44,31.8,30,22,3,19,8,50,5,0,"FW,MF",Under 20,Forward,Argentina,South America
386446,Alessandro Buongiorno,ITA,Torino,Serie A,2023,24.0,1999.0,28.1,70,39,43,24,3,24,34,70.6,10,20,12,8,69,139,131,0,DF,20-24,Defender,Italy,Europe
333647,Jonathan Burkardt,GER,Mainz 05,Bundesliga,2023,23.0,2000.0,17.1,12,8,2,6,4,4,11,36.4,7,16,3,13,3,15,2,0,"FW,MF",20-24,Forward,Germany,Europe
134270,Dan Burn,ENG,Newcastle Utd,Premier League,2023,31.0,1992.0,30.3,61,33,37,20,4,26,61,42.6,35,55,25,30,37,98,124,1,DF,30-34,Defender,England,Europe
258039,Aurlio Buta,POR,Eint Frankfurt,Bundesliga,2023,26.0,1997.0,19.4,40,25,19,16,5,21,38,55.3,17,24,5,19,15,55,36,0,"DF,MF",25-29,Defender,Portugal,Europe
113707,Rmy Cabella,FRA,Lille,Ligue 1,2023,33.0,1990.0,16.4,54,36,19,20,15,20,54,37.0,34,32,0,32,5,59,5,0,"FW,MF",30-34,Forward,France,Europe
469211,Liberato Cacace,NZL,Empoli,Serie A,2023,22.0,2000.0,21.2,40,24,24,13,3,24,38,63.2,14,23,6,17,19,59,56,0,DF,20-24,Defender,New Zealand,Oceania
453016,Anthony Caci,FRA,Mainz 05,Bundesliga,2023,26.0,1997.0,27.6,56,23,30,25,1,27,44,61.4,17,43,7,36,32,88,45,0,DF,25-29,Defender,France,Europe
687626,Moiss Caicedo,ECU,Chelsea,Premier League,2023,21.0,2001.0,31.8,91,46,38,42,11,36,60,60.0,24,59,25,34,37,128,44,4,MF,20-24,Midfielder,Ecuador,South America
123275,Tom Cairney,SCO,Fulham,Premier League,2023,32.0,1991.0,16.5,24,16,10,12,2,13,25,52.0,12,16,4,12,13,37,6,0,MF,30-34,Midfielder,Scotland,Europe
468066,Jens Cajuste,SWE,Napoli,Serie A,2023,23.0,1999.0,11.3,36,24,13,17,6,20,37,54.1,17,20,3,17,4,40,15,0,MF,20-24,Midfielder,Sweden,Europe
262523,Davide Calabria,ITA,Milan,Serie A,2023,26.0,1996.0,24.3,70,38,38,25,7,44,72,61.1,28,26,7,19,24,94,49,1,DF,25-29,Defender,Italy,Europe
88680,Luca Caldirola,ITA,Monza,Serie A,2023,32.0,1991.0,23.8,25,14,19,4,2,13,22,59.1,9,26,17,9,29,54,53,0,DF,30-34,Defender,Italy,Europe
126414,Hakan alhanolu,TUR,Inter,Serie A,2023,29.0,1994.0,28.4,66,33,29,29,8,32,49,65.3,17,29,13,16,24,90,22,0,MF,25-29,Midfielder,Turkey,Asia
306024,Dominic Calvert-Lewin,ENG,Everton,Premier League,2023,26.0,1997.0,24.1,13,6,2,6,5,2,15,13.3,13,14,4,10,4,17,38,0,FW,25-29,Forward,England,Europe
918969,Lamine Camara,SEN,Metz,Ligue 1,2023,19.0,2004.0,25.1,62,42,26,30,6,24,49,49.0,25,35,2,33,28,90,34,0,MF,Under 20,Midfielder,Senegal,Africa
543382,Mohamed Camara,MLI,Monaco,Ligue 1,2023,23.0,2000.0,11.5,35,21,10,20,5,15,29,51.7,14,8,2,6,11,46,7,0,MF,20-24,Midfielder,Mali,Africa
640428,Eduardo Camavinga,FRA,Real Madrid,La Liga,2023,20.0,2002.0,20.2,76,47,39,29,8,23,39,59.0,16,36,8,28,29,105,29,1,"MF,DF",20-24,Midfielder,France,Europe
459151,Nicol Cambiaghi,ITA,Empoli,Serie A,2023,22.0,2000.0,28.4,51,39,15,20,16,16,35,45.7,19,26,1,25,14,65,8,0,"FW,MF",20-24,Forward,Italy,Europe
459658,Andrea Cambiaso,ITA,Juventus,Serie A,2023,23.0,2000.0,26.4,47,30,23,15,9,25,43,58.1,18,28,3,25,11,58,26,1,"DF,FW",20-24,Defender,Italy,Europe
119296,Emre Can,GER,Dortmund,Bundesliga,2023,29.0,1994.0,21.7,63,45,37,23,3,28,48,58.3,20,30,7,23,22,85,41,2,"MF,DF",25-29,Midfielder,Germany,Europe
182712,Joo Cancelo,POR,Barcelona,La Liga,2023,29.0,1994.0,27.8,64,44,35,21,8,38,58,65.5,20,35,6,29,29,93,59,1,DF,25-29,Defender,Portugal,Europe
520530,Fali Cand,GNB,Metz,Ligue 1,2023,25.0,1998.0,20.5,40,19,31,9,0,20,35,57.1,15,41,28,13,20,60,107,1,DF,25-29,Defender,Guinea-Bissau,Africa
25488,Antonio Candreva,ITA,Salernitana,Serie A,2023,36.0,1987.0,30.6,18,13,8,8,2,9,25,36.0,16,9,0,9,7,25,23,0,"MF,FW",35-39,Midfielder,Italy,Europe
63494,tienne Capoue,FRA,Villarreal,La Liga,2023,35.0,1988.0,16.2,32,18,17,12,3,15,22,68.2,7,20,4,16,22,54,24,1,MF,35-39,Midfielder,France,Europe
84765,Francesco Caputo,ITA,Empoli,Serie A,2023,35.0,1987.0,14.1,2,0,0,0,2,0,1,0.0,1,4,0,4,1,3,3,0,FW,35-39,Forward,Italy,Europe
481834,Andrea Carboni,ITA,Monza,Serie A,2023,22.0,2001.0,16.5,38,22,24,12,2,20,31,64.5,11,23,13,10,17,55,56,1,DF,20-24,Defender,Italy,Europe
689505,Johnny Cardoso,USA,Betis,La Liga,2023,21.0,2001.0,14.8,48,29,19,24,5,22,33,66.7,11,20,5,15,32,80,31,0,MF,20-24,Midfielder,United States,North America
140776,Yannick Carrasco,BEL,Atltico Madrid,La Liga,2023,29.0,1993.0,2.5,4,4,3,1,0,2,7,28.6,5,2,0,2,1,5,6,0,DF,25-29,Defender,Belgium,Europe
100131,William Carvalho,POR,Betis,La Liga,2023,31.0,1992.0,7.6,20,12,11,7,2,10,16,62.5,6,8,1,7,8,28,9,1,MF,30-34,Midfielder,Portugal,Europe
389837,Nicol Casale,ITA,Lazio,Serie A,2023,25.0,1998.0,17.3,15,9,13,2,0,6,15,40.0,9,19,16,3,12,27,61,0,DF,25-29,Defender,Italy,Europe
16306,Casemiro,BRA,Manchester Utd,Premier League,2023,31.0,1992.0,22.0,83,56,43,32,8,51,106,48.1,55,74,33,41,18,101,71,1,"MF,DF",30-34,Midfielder,Brazil,South America
763182,Josu Casimir,FRA,Le Havre,Ligue 1,2023,21.0,2001.0,22.4,31,18,14,14,3,7,18,38.9,11,23,2,21,13,44,25,0,"FW,DF",20-24,Forward,France,Europe
398030,Giuseppe Caso,ITA,Frosinone,Serie A,2023,24.0,1998.0,4.6,4,3,2,0,2,2,3,66.7,1,0,0,0,0,4,0,0,"FW,MF",20-24,Forward,Italy,Europe
467632,Cristian Csseres Jr.,VEN,Toulouse,Ligue 1,2023,23.0,2000.0,21.6,70,34,31,33,6,29,61,47.5,32,34,4,30,27,97,33,1,MF,20-24,Midfielder,Venezuela,South America
262226,Timothy Castagne,BEL,Fulham,Premier League,2023,27.0,1995.0,29.3,49,24,23,16,10,26,44,59.1,18,38,10,28,38,87,69,1,DF,25-29,Defender,Belgium,Europe
182875,Jean-Charles Castelletto,CMR,Nantes,Ligue 1,2023,28.0,1995.0,27.4,34,26,22,10,2,18,29,62.1,11,19,10,9,32,66,81,0,DF,25-29,Defender,Cameroon,Africa
849520,Santiago Castro,ARG,Bologna,Serie A,2023,18.0,2004.0,2.7,2,1,0,1,1,1,3,33.3,2,1,0,1,1,3,1,0,FW,Under 20,Forward,Argentina,South America
303116,Gaetano Castrovilli,ITA,Fiorentina,Serie A,2023,26.0,1997.0,4.1,3,2,1,2,0,1,8,12.5,7,4,0,4,2,5,3,0,"FW,MF",25-29,Forward,Italy,Europe
199733,Danilo Cataldi,ITA,Lazio,Serie A,2023,28.0,1994.0,15.1,24,12,7,16,1,8,18,44.4,10,15,7,8,17,41,19,1,MF,25-29,Midfielder,Italy,Europe
149716,Ivan Cavaleiro,POR,Lille,Ligue 1,2023,29.0,1993.0,8.6,10,6,3,4,3,7,20,35.0,13,9,2,7,5,15,6,0,FW,25-29,Forward,Portugal,Europe
251075,Zeki elik,TUR,Roma,Serie A,2023,26.0,1997.0,7.5,23,16,10,10,3,14,25,56.0,11,12,5,7,8,31,25,0,DF,25-29,Defender,Turkey,Asia
197751,Alberto Cerri,ITA,Empoli,Serie A,2023,27.0,1996.0,6.1,3,3,1,1,1,2,5,40.0,3,3,1,2,3,6,7,0,FW,25-29,Forward,Italy,Europe
341110,Franco Cervi,ARG,Celta Vigo,La Liga,2023,29.0,1994.0,6.1,24,18,13,9,2,13,24,54.2,11,16,0,16,9,33,4,0,"MF,DF",25-29,Midfielder,Argentina,South America
346314,Trevoh Chalobah,ENG,Chelsea,Premier League,2023,24.0,1999.0,10.6,16,12,10,2,4,10,15,66.7,5,8,7,1,8,24,51,0,DF,20-24,Defender,England,Europe
250779,Brendan Chardonnet,FRA,Brest,Ligue 1,2023,28.0,1994.0,33.0,57,34,33,22,2,32,63,50.8,31,58,34,24,53,110,139,3,DF,25-29,Defender,France,Europe
521407,Walid Cheddira,MAR,Frosinone,Serie A,2023,25.0,1998.0,23.6,12,7,1,8,3,4,8,50.0,4,6,1,5,5,17,10,0,FW,25-29,Forward,Morocco,Africa
341092,Federico Chiesa,ITA,Juventus,Serie A,2023,25.0,1997.0,24.4,20,10,7,6,7,3,13,23.1,10,17,1,16,6,26,4,0,FW,25-29,Forward,Italy,Europe
316125,Ben Chilwell,ENG,Chelsea,Premier League,2023,26.0,1996.0,8.4,15,10,5,9,1,5,8,62.5,3,11,3,8,4,19,19,1,DF,25-29,Defender,England,Europe
724783,Tawanda Chirewa,ZIM,Wolves,Premier League,2023,19.0,2003.0,1.6,7,3,3,3,1,2,3,66.7,1,0,0,0,1,8,0,0,"MF,FW",Under 20,Midfielder,Zimbabwe,Africa
344830,Tahith Chong,NED,Luton Town,Premier League,2023,23.0,1999.0,22.0,36,22,19,13,4,15,33,45.5,18,30,6,24,8,44,11,1,"MF,FW",20-24,Midfielder,Netherlands,Europe
624037,Joris Chotard,FRA,Montpellier,Ligue 1,2023,21.0,2001.0,28.7,81,52,45,25,11,48,96,50.0,48,47,21,26,44,125,60,0,MF,20-24,Midfielder,France,Europe
196948,Andreas Christensen,DEN,Barcelona,La Liga,2023,27.0,1996.0,22.0,23,14,7,14,2,16,28,57.1,12,23,10,13,21,44,41,0,"DF,MF",25-29,Defender,Denmark,Europe
188077,Ryan Christie,SCO,Bournemouth,Premier League,2023,28.0,1995.0,32.3,86,44,34,35,17,39,92,42.4,53,52,11,41,52,138,53,1,MF,25-29,Midfielder,Scotland,Europe
659459,Carney Chukwuemeka,ENG,Chelsea,Premier League,2023,19.0,2003.0,2.5,6,4,3,3,0,1,3,33.3,2,1,1,0,0,6,1,0,"MF,FW",Under 20,Midfielder,England,Europe
401922,Samuel Chukwueze,NGA,Milan,Serie A,2023,24.0,1999.0,11.3,18,7,11,5,2,9,17,52.9,8,3,1,2,6,24,3,0,FW,20-24,Forward,Nigeria,Africa
525578,Path Ciss,SEN,Rayo Vallecano,La Liga,2023,29.0,1994.0,18.5,44,24,16,26,2,16,29,55.2,13,27,10,17,30,74,54,0,MF,25-29,Midfielder,Senegal,Africa
575693,Ibrahim Cissoko,NED,Toulouse,Ligue 1,2023,20.0,2003.0,2.7,4,3,3,1,0,1,3,33.3,2,3,0,3,1,5,0,0,"FW,MF",20-24,Forward,Netherlands,Europe
255838,Patrick Ciurria,ITA,Monza,Serie A,2023,28.0,1995.0,17.8,30,18,13,13,4,13,21,61.9,8,20,5,15,9,39,28,0,"DF,MF",25-29,Defender,Italy,Europe
184129,Jordan Clark,ENG,Luton Town,Premier League,2023,29.0,1993.0,14.5,30,17,14,11,5,11,39,28.2,28,24,3,21,11,41,15,1,MF,25-29,Midfielder,England,Europe
384593,Alexis Claude-Maurice,FRA,Nice,Ligue 1,2023,25.0,1998.0,5.6,12,5,3,6,3,1,5,20.0,4,4,1,3,5,17,7,0,MF,25-29,Midfielder,France,Europe
175639,Jonathan Clauss,FRA,Marseille,Ligue 1,2023,30.0,1992.0,23.0,47,20,22,19,6,26,49,53.1,23,17,3,14,36,83,46,0,DF,30-34,Defender,France,Europe
588426,Sal Coco,EQG,Las Palmas,La Liga,2023,24.0,1999.0,25.5,32,19,25,7,0,11,18,61.1,7,27,15,12,20,52,120,3,DF,20-24,Defender,Equatorial Guinea,Africa
469050,Nathan Collins,IRL,Brentford,Premier League,2023,22.0,2001.0,29.5,38,20,24,12,2,19,29,65.5,10,46,30,16,44,82,141,4,DF,20-24,Defender,Republic of Ireland,Europe
487843,Lorenzo Colombo,ITA,Monza,Serie A,2023,21.0,2002.0,15.1,17,12,3,9,5,8,14,57.1,6,18,5,13,0,17,14,0,FW,20-24,Forward,Italy,Europe
392959,Andrea Colpani,ITA,Monza,Serie A,2023,24.0,1999.0,29.5,25,15,6,13,6,11,20,55.0,9,11,4,7,14,39,14,0,"MF,FW",20-24,Midfielder,Italy,Europe
614258,Levi Colwill,ENG,Chelsea,Premier League,2023,20.0,2003.0,20.0,48,30,26,17,5,26,34,76.5,8,28,10,18,26,74,66,0,DF,20-24,Defender,England,Europe
243714,Kingsley Coman,FRA,Bayern Munich,Bundesliga,2023,27.0,1996.0,12.4,12,7,5,3,4,9,17,52.9,8,15,1,14,2,14,5,0,FW,25-29,Forward,France,Europe
298583,Eray Cmert,SUI,Nantes,Ligue 1,2023,25.0,1998.0,22.2,42,28,28,13,1,28,38,73.7,10,35,18,17,36,78,77,1,DF,25-29,Defender,Switzerland,Europe
249089,Lewis Cook,ENG,Bournemouth,Premier League,2023,26.0,1997.0,31.0,61,41,24,30,7,34,63,54.0,29,32,11,21,65,126,46,1,MF,25-29,Midfielder,England,Europe
660860,Diego Coppola,ITA,Hellas Verona,Serie A,2023,19.0,2003.0,18.2,36,22,25,9,2,20,33,60.6,13,26,9,17,27,63,89,1,DF,Under 20,Defender,Italy,Europe
568535,Theo Corbeanu,CAN,Granada,La Liga,2023,21.0,2002.0,2.0,5,2,2,3,0,1,3,33.3,2,3,0,3,3,8,2,0,"MF,FW",20-24,Midfielder,Canada,North America
266807,ngel Correa,ARG,Atltico Madrid,La Liga,2023,28.0,1995.0,17.0,22,15,3,11,8,5,17,29.4,12,13,0,13,2,24,6,0,"FW,MF",25-29,Forward,Argentina,South America
227081,Joaqun Correa,ARG,Marseille,Ligue 1,2023,28.0,1994.0,4.8,7,5,4,2,1,0,8,0.0,8,2,0,2,1,8,1,0,"FW,MF",25-29,Forward,Argentina,South America
367466,Thierry Correia,POR,Valencia,La Liga,2023,24.0,1999.0,23.9,63,35,39,20,4,28,49,57.1,21,39,16,23,33,96,61,0,DF,20-24,Defender,Portugal,Europe
85906,Danny da Costa,GER,Mainz 05,Bundesliga,2023,30.0,1993.0,9.2,18,9,9,7,2,9,19,47.4,10,17,4,13,16,34,24,0,DF,30-34,Defender,Germany,Europe
484988,Logan Costa,CPV,Toulouse,Ligue 1,2023,22.0,2001.0,29.4,40,24,31,9,0,15,24,62.5,9,42,27,15,23,63,120,1,DF,20-24,Defender,Cape Verde,Africa
386552,Lassana Coulibaly,MLI,Salernitana,Serie A,2023,27.0,1996.0,23.1,47,32,20,21,6,22,49,44.9,27,23,5,18,16,63,29,0,MF,25-29,Midfielder,Mali,Africa
618425,Tanguy Coulibaly,FRA,Montpellier,Ligue 1,2023,22.0,2001.0,6.9,13,11,8,4,1,4,9,44.4,5,11,1,10,2,15,2,0,"FW,MF",20-24,Forward,France,Europe
627228,Yan Couto,BRA,Girona,La Liga,2023,21.0,2002.0,24.9,45,34,25,14,6,20,40,50.0,20,14,2,12,10,55,31,1,"DF,FW",20-24,Defender,Brazil,South America
199248,Bryan Cristante,ITA,Roma,Serie A,2023,28.0,1995.0,36.5,72,41,33,28,11,28,50,56.0,22,36,6,30,25,97,55,2,"MF,DF",25-29,Midfielder,Italy,Europe
242606,Josh Cullen,IRL,Burnley,Premier League,2023,27.0,1996.0,22.9,42,29,15,22,5,26,46,56.5,20,31,19,12,15,57,26,1,MF,25-29,Midfielder,Republic of Ireland,Europe
55769,Danilo D'Ambrosio,ITA,Monza,Serie A,2023,34.0,1988.0,17.1,57,34,34,20,3,28,41,68.3,13,22,13,9,14,71,31,0,DF,30-34,Defender,Italy,Europe
620598,Ameen Al-Dakhil,BEL,Burnley,Premier League,2023,21.0,2002.0,11.7,12,5,4,7,1,1,10,10.0,9,13,6,7,12,24,38,2,DF,20-24,Defender,Belgium,Europe
538964,Thijs Dallinga,NED,Toulouse,Ligue 1,2023,22.0,2000.0,27.9,29,15,6,11,12,9,15,60.0,6,11,4,7,3,32,35,0,FW,20-24,Forward,Netherlands,Europe
357147,Diogo Dalot,POR,Manchester Utd,Premier League,2023,24.0,1999.0,35.3,81,51,58,12,11,51,74,68.9,23,44,16,28,37,118,111,0,DF,20-24,Defender,Portugal,Europe
808509,Danilo,BRA,Nott'ham Forest,Premier League,2023,22.0,2001.0,19.9,36,18,22,12,2,21,46,45.7,25,33,8,25,35,71,42,0,MF,20-24,Midfielder,Brazil,South America
355861,Arnaut Danjuma,NED,Everton,Premier League,2023,26.0,1997.0,6.6,6,4,2,3,1,1,4,25.0,3,4,0,4,3,9,0,0,"MF,FW",25-29,Midfielder,Netherlands,Europe
263236,Kevin Danso,AUT,Lens,Ligue 1,2023,24.0,1998.0,29.5,24,14,12,11,1,15,30,50.0,15,43,30,13,23,47,115,1,DF,20-24,Defender,Austria,Europe
16136,Dante,BRA,Nice,Ligue 1,2023,39.0,1983.0,31.6,62,30,44,16,2,38,52,73.1,14,43,22,21,37,99,77,2,DF,35-39,Defender,Brazil,South America
334213,Lukas Daschner,GER,Bochum,Bundesliga,2023,24.0,1998.0,6.0,9,4,2,3,4,4,9,44.4,5,7,0,7,2,11,2,0,"MF,FW",20-24,Midfielder,Germany,Europe
787232,David Datro Fofana,CIV,Burnley,Premier League,2023,20.0,2002.0,9.8,10,5,3,5,2,3,6,50.0,3,9,3,6,1,11,2,0,FW,20-24,Forward,Ivory Coast,Africa
533738,Jonathan David,CAN,Lille,Ligue 1,2023,23.0,2000.0,29.2,26,15,6,13,7,8,26,30.8,18,16,0,16,9,35,4,0,FW,20-24,Forward,Canada,North America
424204,Alphonso Davies,CAN,Bayern Munich,Bundesliga,2023,22.0,2000.0,22.9,47,24,29,13,5,30,53,56.6,23,30,4,26,26,73,49,1,DF,20-24,Defender,Canada,North America
257097,Ben Davies,WAL,Tottenham,Premier League,2023,30.0,1993.0,12.1,24,17,13,8,3,16,21,76.2,5,17,15,2,10,34,35,0,DF,30-34,Defender,Wales,Europe
854853,Tom Davies,ENG,Sheffield Utd,Premier League,2023,25.0,1998.0,2.5,10,5,4,3,3,3,9,33.3,6,2,1,1,3,13,6,1,MF,25-29,Midfielder,England,Europe
121477,Craig Dawson,ENG,Wolves,Premier League,2023,33.0,1990.0,24.5,30,20,23,6,1,22,34,64.7,12,51,39,12,16,46,120,1,DF,30-34,Defender,England,Europe
88755,Kevin De Bruyne,BEL,Manchester City,Premier League,2023,32.0,1991.0,13.6,14,9,1,5,8,7,20,35.0,13,5,0,5,4,18,4,0,MF,30-34,Midfielder,Belgium,Europe
435772,Charles De Ketelaere,BEL,Atalanta,Serie A,2023,22.0,2001.0,22.5,33,21,3,12,18,10,20,50.0,10,30,2,28,7,40,6,0,"FW,MF",20-24,Forward,Belgium,Europe
490384,Koni De Winter,BEL,Genoa,Serie A,2023,21.0,2002.0,26.4,44,25,26,13,5,21,31,67.7,10,30,10,20,21,65,78,0,DF,20-24,Defender,Belgium,Europe
235931,Alessandro Deiola,ITA,Cagliari,Serie A,2023,27.0,1995.0,17.9,33,19,13,16,4,18,47,38.3,29,16,6,10,9,42,37,0,MF,25-29,Midfielder,Italy,Europe
353399,Romain Del Castillo,FRA,Brest,Ligue 1,2023,27.0,1996.0,27.7,46,29,14,18,14,18,70,25.7,52,33,1,32,9,55,8,0,FW,25-29,Forward,France,Europe
170961,Thomas Delaine,FRA,Strasbourg,Ligue 1,2023,31.0,1992.0,22.7,38,19,29,8,1,20,42,47.6,22,18,2,16,17,55,51,0,"DF,MF",30-34,Defender,France,Europe
842425,Sacha Delaye,FRA,Montpellier,Ligue 1,2023,21.0,2002.0,1.4,7,2,2,2,3,1,6,16.7,5,2,0,2,0,7,1,0,"MF,FW",20-24,Midfielder,France,Europe
338635,Hannes Delcroix,BEL,Burnley,Premier League,2023,24.0,1999.0,6.5,10,6,6,4,0,3,4,75.0,1,9,3,6,9,19,26,0,DF,20-24,Defender,Belgium,Europe
288230,Ousmane Dembl,FRA,Paris S-G,Ligue 1,2023,26.0,1997.0,16.7,19,14,2,7,10,6,13,46.2,7,11,0,11,5,24,4,1,"MF,FW",25-29,Midfielder,France,Europe
539232,Jessy Deminguet,FRA,Strasbourg,Ligue 1,2023,25.0,1998.0,7.7,14,9,6,8,0,6,18,33.3,12,8,0,8,9,23,5,1,"MF,FW",25-29,Midfielder,France,Europe
541231,Sepp van den Berg,NED,Mainz 05,Bundesliga,2023,21.0,2001.0,31.5,38,23,20,15,3,15,26,57.7,11,66,36,30,43,81,159,2,DF,20-24,Defender,Netherlands,Europe
169880,Giovanni Di Lorenzo,ITA,Napoli,Serie A,2023,29.0,1993.0,35.9,58,36,26,26,6,32,68,47.1,36,43,16,27,24,82,45,0,DF,25-29,Defender,Italy,Europe
626913,Boulaye Dia,SEN,Salernitana,Serie A,2023,26.0,1996.0,12.7,4,2,2,2,0,1,3,33.3,2,5,0,5,3,7,7,0,"FW,MF",25-29,Forward,Senegal,Africa
395516,Moussa Diaby,FRA,Aston Villa,Premier League,2023,24.0,1999.0,24.2,12,5,5,4,3,4,22,18.2,18,8,1,7,9,21,6,0,"FW,MF",20-24,Forward,France,Europe
346289,Mouctar Diakhaby,GUI,Valencia,La Liga,2023,26.0,1996.0,11.9,18,11,9,9,0,11,13,84.6,2,17,7,10,11,29,62,0,"DF,MF",25-29,Defender,Guinea,Africa
463605,Bafod Diakit,FRA,Lille,Ligue 1,2023,22.0,2001.0,18.8,29,20,12,15,2,24,32,75.0,8,16,8,8,21,50,49,1,DF,20-24,Defender,France,Europe
847279,Oumar Diakit,CIV,Reims,Ligue 1,2023,19.0,2003.0,17.6,25,12,10,9,6,7,21,33.3,14,13,0,13,7,32,7,0,FW,Under 20,Forward,Ivory Coast,Africa
536835,Amad Diallo,CIV,Manchester Utd,Premier League,2023,21.0,2002.0,4.3,10,3,1,6,3,3,7,42.9,4,3,1,2,1,11,6,0,"FW,MF",20-24,Forward,Ivory Coast,Africa
876631,Habib Diarra,SEN,Strasbourg,Ligue 1,2023,19.0,2004.0,25.6,30,23,8,20,2,9,33,27.3,24,23,4,19,17,47,15,0,"MF,FW",Under 20,Midfielder,Senegal,Africa
694509,Moussa Diarra,MLI,Toulouse,Ligue 1,2023,22.0,2000.0,15.5,32,12,16,15,1,13,27,48.1,14,30,14,16,20,52,43,0,DF,20-24,Defender,Mali,Africa
258004,Rben Dias,POR,Manchester City,Premier League,2023,26.0,1997.0,28.4,39,20,14,21,4,19,26,73.1,7,32,17,15,30,69,77,0,DF,25-29,Defender,Portugal,Europe
314678,Brahim Daz,MAR,Real Madrid,La Liga,2023,23.0,1999.0,17.2,29,19,4,16,9,6,13,46.2,7,16,1,15,5,34,2,0,"FW,MF",20-24,Forward,Morocco,Africa
480692,Luis Daz,COL,Liverpool,Premier League,2023,26.0,1997.0,29.2,35,25,5,17,13,7,30,23.3,23,15,0,15,3,38,8,0,FW,25-29,Forward,Colombia,South America
822458,Bamba Dieng,SEN,Lorient,Ligue 1,2023,23.0,2000.0,6.1,3,3,0,3,0,1,3,33.3,2,3,0,3,0,3,7,0,FW,20-24,Forward,Senegal,Africa
126664,Lucas Digne,FRA,Aston Villa,Premier League,2023,30.0,1993.0,26.8,47,19,35,9,3,25,44,56.8,19,20,2,18,26,73,67,0,DF,30-34,Defender,France,Europe
198116,Federico Dimarco,ITA,Inter,Serie A,2023,25.0,1997.0,23.1,42,25,19,14,9,17,35,48.6,18,18,3,15,9,51,34,1,DF,25-29,Defender,Italy,Europe
536482,Junior Dina Ebimbe,FRA,Eint Frankfurt,Bundesliga,2023,22.0,2000.0,21.7,44,29,15,17,12,18,41,43.9,23,28,7,21,9,53,39,1,"MF,DF",20-24,Midfielder,France,Europe
645774,Eren Dinki,GER,Heidenheim,Bundesliga,2023,21.0,2001.0,29.4,32,18,16,13,3,19,48,39.6,29,40,4,36,12,44,21,0,"FW,MF",20-24,Forward,Germany,Europe
272622,Issa Diop,FRA,Fulham,Premier League,2023,26.0,1997.0,15.8,30,16,23,5,2,15,20,75.0,5,28,19,9,17,47,80,1,DF,25-29,Defender,France,Europe
569389,Sofiane Diop,FRA,Nice,Ligue 1,2023,23.0,2000.0,5.5,8,6,3,4,1,4,10,40.0,6,4,0,4,3,11,3,0,FW,20-24,Forward,France,Europe
711976,Andy Diouf,FRA,Lens,Ligue 1,2023,20.0,2003.0,14.6,28,19,12,11,5,14,22,63.6,8,13,3,10,3,31,5,1,MF,20-24,Midfielder,France,Europe
386047,Axel Disasi,FRA,Chelsea,Premier League,2023,25.0,1998.0,28.7,33,19,20,10,3,23,30,76.7,7,26,19,7,18,51,102,2,DF,25-29,Defender,France,Europe
627248,Lewis Dobbin,ENG,Everton,Premier League,2023,20.0,2003.0,2.6,9,7,3,5,1,5,9,55.6,4,5,1,4,1,10,0,0,MF,20-24,Midfielder,England,Europe
401529,Dod,BRA,Fiorentina,Serie A,2023,24.0,1998.0,5.8,5,3,1,4,0,2,5,40.0,3,2,0,2,5,10,11,0,DF,20-24,Defender,Brazil,South America
387047,Danilho Doekhi,NED,Union Berlin,Bundesliga,2023,25.0,1998.0,24.0,34,23,18,16,0,15,21,71.4,6,46,25,21,38,72,111,1,DF,25-29,Defender,Netherlands,Europe
567129,Josh Doig,SCO,Hellas Verona,Serie A,2023,21.0,2002.0,9.2,16,9,9,7,0,13,17,76.5,4,12,3,9,4,20,17,1,DF,20-24,Defender,Scotland,Europe
926952,Patrick Dorgu,DEN,Lecce,Serie A,2023,18.0,2004.0,17.4,43,22,22,17,4,22,34,64.7,12,16,5,11,9,52,45,2,"DF,MF",Under 20,Defender,Denmark,Europe
385394,Alberto Dossena,ITA,Cagliari,Serie A,2023,24.0,1998.0,33.1,55,35,43,12,0,32,48,66.7,16,50,27,23,45,100,172,2,DF,20-24,Defender,Italy,Europe
127187,Abdoulaye Doucour,MLI,Everton,Premier League,2023,30.0,1993.0,29.2,43,27,20,14,9,18,46,39.1,28,23,3,20,15,58,19,0,"FW,MF",30-34,Forward,Mali,Africa
543387,Cheick Doucour,MLI,Crystal Palace,Premier League,2023,23.0,2000.0,10.2,34,17,15,13,6,18,30,60.0,12,13,2,11,20,54,12,0,MF,20-24,Midfielder,Mali,Africa
802747,Sirin Doucour,MLI,Lorient,Ligue 1,2023,21.0,2002.0,4.7,8,6,0,4,4,3,3,100.0,0,4,0,4,1,9,6,0,FW,20-24,Forward,Mali,Africa
914562,Dsir Dou,FRA,Rennes,Ligue 1,2023,18.0,2005.0,18.1,32,18,11,14,7,10,33,30.3,23,30,1,29,14,46,8,0,"MF,FW",Under 20,Midfielder,France,Europe
608175,Alfie Doughty,ENG,Luton Town,Premier League,2023,23.0,1999.0,32.5,63,40,29,18,16,37,82,45.1,45,51,9,42,31,94,43,4,DF,20-24,Defender,England,Europe
671594,Kamory Doumbia,MLI,Brest,Ligue 1,2023,20.0,2003.0,9.8,28,18,8,10,10,10,29,34.5,19,14,0,14,9,37,6,0,MF,20-24,Midfielder,Mali,Africa
523318,Anastasios Douvikas,GRE,Celta Vigo,La Liga,2023,23.0,1999.0,10.1,15,7,2,6,7,3,8,37.5,5,6,3,3,2,17,9,0,FW,20-24,Forward,Greece,Europe
343537,Artem Dovbyk,UKR,Girona,La Liga,2023,26.0,1997.0,28.7,4,3,2,1,1,0,2,0.0,2,8,1,7,0,4,17,0,FW,25-29,Forward,Ukraine,Europe
120189,Nikola Dovedan,AUT,Heidenheim,Bundesliga,2023,29.0,1994.0,7.3,14,9,2,10,2,5,25,20.0,20,9,0,9,1,15,3,0,"MF,FW",25-29,Midfielder,Austria,Europe
820241,Damion Downs,USA,Kln,Bundesliga,2023,19.0,2004.0,2.0,1,1,1,0,0,1,2,50.0,1,1,0,1,0,1,1,0,"FW,MF",Under 20,Forward,United States,North America
433183,Tommy Doyle,ENG,Wolves,Premier League,2023,21.0,2001.0,13.6,26,13,11,10,5,14,23,60.9,9,22,9,13,12,38,18,0,MF,20-24,Midfielder,England,Europe
232418,Ondrej Duda,SVK,Hellas Verona,Serie A,2023,28.0,1994.0,27.3,59,39,17,35,7,31,52,59.6,21,29,12,17,26,85,21,0,MF,25-29,Midfielder,Slovakia,Europe
321528,Denzel Dumfries,NED,Inter,Serie A,2023,27.0,1996.0,18.2,22,13,9,11,2,9,23,39.1,14,15,6,9,12,34,33,1,DF,25-29,Defender,Netherlands,Europe
184894,Alfred Duncan,GHA,Fiorentina,Serie A,2023,30.0,1993.0,21.0,35,22,13,15,7,15,35,42.9,20,27,5,22,11,46,13,0,MF,30-34,Midfielder,Ghana,Africa
148153,Lewis Dunk,ENG,Brighton,Premier League,2023,31.0,1991.0,31.9,27,14,17,9,1,13,36,36.1,23,49,37,12,31,58,90,1,DF,30-34,Defender,England,Europe
649317,Jhon Durn,COL,Aston Villa,Premier League,2023,19.0,2003.0,5.3,6,5,3,1,2,1,6,16.7,5,6,0,6,1,7,10,0,"FW,MF",Under 20,Forward,Colombia,South America
206050,Paulo Dybala,ARG,Roma,Serie A,2023,29.0,1993.0,21.8,22,13,3,10,9,2,18,11.1,16,12,0,12,3,25,6,1,"FW,MF",25-29,Forward,Argentina,South America
309944,Tyronne Ebuehi,NGA,Empoli,Serie A,2023,27.0,1995.0,12.2,14,9,9,5,0,7,11,63.6,4,9,4,5,6,20,27,1,DF,25-29,Defender,Nigeria,Africa
607854,derson,BRA,Atalanta,Serie A,2023,24.0,1999.0,31.9,83,49,38,38,7,44,63,69.8,19,48,8,40,41,124,33,1,MF,20-24,Midfielder,Brazil,South America
272812,Kingsley Ehizibue,NED,Udinese,Serie A,2023,28.0,1995.0,10.6,22,14,16,4,2,11,18,61.1,7,21,3,18,8,30,36,0,DF,25-29,Defender,Netherlands,Europe
199953,Caleb Ekuban,GHA,Genoa,Serie A,2023,29.0,1994.0,12.6,8,4,2,4,2,5,9,55.6,4,11,3,8,1,9,7,0,FW,25-29,Forward,Ghana,Africa
583189,Anthony Elanga,SWE,Nott'ham Forest,Premier League,2023,21.0,2002.0,27.0,33,19,20,6,7,17,36,47.2,19,22,2,20,8,41,20,1,"FW,MF",20-24,Forward,Sweden,Europe
565822,Harvey Elliott,ENG,Liverpool,Premier League,2023,20.0,2003.0,15.0,27,17,8,14,5,10,31,32.3,21,27,0,27,6,33,7,0,"MF,FW",20-24,Midfielder,England,Europe
192635,Nico Elvedi,SUI,Gladbach,Bundesliga,2023,26.0,1996.0,27.6,33,18,22,10,1,18,24,75.0,6,40,25,15,43,76,150,2,DF,25-29,Defender,Switzerland,Europe
237662,Breel Embolo,SUI,Monaco,Ligue 1,2023,26.0,1997.0,2.0,3,3,0,2,1,1,4,25.0,3,1,0,1,1,4,2,0,FW,25-29,Forward,Switzerland,Europe
559328,Emanuel Emegha,NED,Strasbourg,Ligue 1,2023,20.0,2003.0,23.1,8,5,2,4,2,4,9,44.4,5,13,3,10,2,10,25,0,FW,20-24,Forward,Netherlands,Europe
181778,Emerson,BRA,Tottenham,Premier League,2023,24.0,1999.0,12.9,36,24,23,10,3,21,43,48.8,22,23,10,13,20,56,50,1,DF,20-24,Defender,Brazil,South America
660867,Julio Enciso,PAR,Brighton,Premier League,2023,19.0,2004.0,5.3,6,2,3,2,1,2,7,28.6,5,11,0,11,0,6,3,0,"MF,FW",Under 20,Midfielder,Paraguay,South America
146310,Wataru Endo,JPN,Liverpool,Premier League,2023,30.0,1993.0,19.1,48,28,11,31,6,20,61,32.8,41,24,2,22,20,68,31,3,MF,30-34,Midfielder,Japan,Asia
69633,Christian Eriksen,DEN,Manchester Utd,Premier League,2023,31.0,1992.0,12.7,18,13,5,10,3,12,33,36.4,21,17,6,11,4,22,13,0,MF,30-34,Midfielder,Denmark,Europe
266795,Gonzalo Escalante,ARG,Cdiz,La Liga,2023,30.0,1993.0,18.9,39,24,16,14,9,20,55,36.4,35,23,5,18,26,65,33,2,MF,30-34,Midfielder,Argentina,South America
311044,Alfonso Espino,URU,Rayo Vallecano,La Liga,2023,31.0,1992.0,27.9,67,45,43,22,2,30,82,36.6,52,26,4,22,40,107,63,0,DF,30-34,Defender,Uruguay,South America
349599,Pervis Estupin,ECU,Brighton,Premier League,2023,25.0,1998.0,13.8,26,13,12,11,3,14,30,46.7,16,14,4,10,21,47,20,0,DF,25-29,Defender,Ecuador,South America
479999,Eberechi Eze,ENG,Crystal Palace,Premier League,2023,25.0,1998.0,22.8,35,17,4,18,13,15,31,48.4,16,27,2,25,11,46,6,0,"MF,FW",25-29,Midfielder,England,Europe
724520,Abde Ezzalzouli,MAR,Barcelona,La Liga,2023,21.0,2001.0,0.8,1,1,0,0,1,0,1,0.0,1,1,0,1,0,1,0,0,"FW,MF",20-24,Forward,Morocco,Africa
633668,Giovanni Fabbian,ITA,Bologna,Serie A,2023,20.0,2003.0,11.7,17,10,9,7,1,7,12,58.3,5,5,2,3,7,24,11,0,"MF,FW",20-24,Midfielder,Italy,Europe
432090,Nicol Fagioli,ITA,Juventus,Serie A,2023,22.0,2001.0,4.9,5,3,1,3,1,3,7,42.9,4,3,0,3,4,9,1,0,MF,20-24,Midfielder,Italy,Europe
39152,Radamel Falcao,COL,Rayo Vallecano,La Liga,2023,37.0,1986.0,4.5,7,5,1,5,1,1,3,33.3,2,2,0,2,3,10,4,0,"FW,DF",35-39,Forward,Colombia,South America
73926,Davide Faraoni,ITA,Hellas Verona,Serie A,2023,31.0,1991.0,6.7,13,10,5,6,2,7,10,70.0,3,9,5,4,6,19,21,0,DF,30-34,Defender,Italy,Europe
782630,Khalil Fayad,FRA,Montpellier,Ligue 1,2023,19.0,2004.0,11.4,28,15,17,7,4,9,22,40.9,13,15,3,12,14,42,6,0,"FW,MF",Under 20,Forward,France,Europe
45314,Federico Fazio,ARG,Salernitana,Serie A,2023,36.0,1987.0,15.1,18,11,14,4,0,8,14,57.1,6,22,19,3,17,35,99,1,DF,35-39,Defender,Argentina,South America
691482,Jacopo Fazzini,ITA,Empoli,Serie A,2023,20.0,2003.0,13.7,49,25,27,13,9,30,53,56.6,23,21,3,18,12,61,18,0,MF,20-24,Midfielder,Italy,Europe
710004,Peter Federico,DOM,Valencia,La Liga,2023,21.0,2002.0,7.2,5,3,3,1,1,1,10,10.0,9,11,0,11,7,12,10,0,"MF,FW",20-24,Midfielder,Dominican Republic,North America
203496,Nabil Fekir,FRA,Betis,La Liga,2023,30.0,1993.0,11.7,15,10,5,7,3,5,10,50.0,5,9,0,9,7,22,3,0,"MF,FW",30-34,Midfielder,France,Europe
462250,Joo Flix,POR,Barcelona,La Liga,2023,23.0,1999.0,17.1,22,16,9,7,6,8,22,36.4,14,14,1,13,10,32,11,0,FW,20-24,Forward,Portugal,Europe
648046,Evan Ferguson,IRL,Brighton,Premier League,2023,18.0,2004.0,15.2,14,6,4,7,3,5,14,35.7,9,10,3,7,2,16,8,0,FW,Under 20,Forward,Republic of Ireland,Europe
428563,Lewis Ferguson,SCO,Bologna,Serie A,2023,23.0,1999.0,30.1,37,21,16,17,4,16,37,43.2,21,25,8,17,17,54,27,1,MF,20-24,Midfielder,Scotland,Europe
240306,Bruno Fernandes,POR,Manchester Utd,Premier League,2023,28.0,1994.0,34.6,68,38,27,25,16,30,88,34.1,58,49,6,43,27,95,50,2,"MF,FW",25-29,Midfielder,Portugal,Europe
648195,Enzo Fernndez,ARG,Chelsea,Premier League,2023,22.0,2001.0,24.5,50,22,22,18,10,27,65,41.5,38,36,13,23,17,67,28,0,MF,20-24,Midfielder,Argentina,South America
118284,Jordan Ferri,FRA,Montpellier,Ligue 1,2023,31.0,1992.0,22.6,36,22,16,17,3,20,67,29.9,47,19,1,18,13,49,23,0,MF,30-34,Midfielder,France,Europe
130365,Alessandro Florenzi,ITA,Milan,Serie A,2023,32.0,1991.0,19.2,43,21,26,12,5,26,48,54.2,22,16,9,7,20,63,25,1,DF,30-34,Defender,Italy,Europe
406635,Phil Foden,ENG,Manchester City,Premier League,2023,23.0,2000.0,31.7,31,20,11,10,10,13,31,41.9,18,30,0,30,13,44,18,1,"FW,MF",20-24,Forward,England,Europe
569598,Youssouf Fofana,FRA,Monaco,Ligue 1,2023,24.0,1999.0,30.0,61,39,19,36,6,30,66,45.5,36,35,7,28,37,98,31,1,MF,20-24,Midfielder,France,Europe
111078,Emil Forsberg,SWE,RB Leipzig,Bundesliga,2023,31.0,1991.0,5.2,7,3,2,5,0,5,12,41.7,7,7,0,7,0,7,5,0,"MF,FW",30-34,Midfielder,Sweden,Europe
179635,Philipp Frster,GER,Bochum,Bundesliga,2023,28.0,1995.0,4.3,9,5,3,4,2,2,6,33.3,4,3,0,3,7,16,3,0,"MF,FW",25-29,Midfielder,Germany,Europe
467623,Lyle Foster,RSA,Burnley,Premier League,2023,22.0,2000.0,21.1,19,10,5,6,8,6,17,35.3,11,13,3,10,3,22,34,0,"FW,MF",20-24,Forward,South Africa,Africa
170472,Dimitri Foulquier,FRA,Valencia,La Liga,2023,30.0,1993.0,20.5,39,22,22,13,4,18,26,69.2,8,10,1,9,16,55,49,1,"DF,MF",30-34,Defender,France,Europe
480763,Juan Foyth,ARG,Villarreal,La Liga,2023,25.0,1998.0,11.8,26,15,18,8,0,12,27,44.4,15,17,4,13,12,38,44,0,DF,25-29,Defender,Argentina,South America
394300,Davide Frattesi,ITA,Inter,Serie A,2023,23.0,1999.0,10.6,10,6,3,7,0,4,8,50.0,4,9,3,6,5,15,19,0,MF,20-24,Midfielder,Italy,Europe
503871,Morten Frendrup,DEN,Genoa,Serie A,2023,22.0,2001.0,34.9,133,72,47,70,16,55,91,60.4,36,55,14,41,51,184,42,1,MF,20-24,Midfielder,Denmark,Europe
484547,Jeremie Frimpong,NED,Leverkusen,Bundesliga,2023,22.0,2000.0,25.0,26,17,12,7,7,8,20,40.0,12,26,0,26,7,33,17,0,DF,20-24,Defender,Netherlands,Europe
272278,Chris Fhrich,GER,Stuttgart,Bundesliga,2023,25.0,1998.0,28.5,30,19,6,14,10,16,37,43.2,21,31,0,31,7,37,7,0,"FW,MF",25-29,Forward,Germany,Europe
250013,Angelo Fulgini,FRA,Lens,Ligue 1,2023,26.0,1996.0,15.3,23,14,6,13,4,11,19,57.9,8,22,1,21,8,31,11,0,MF,25-29,Midfielder,France,Europe
75489,Niclas Fllkrug,GER,Werder Bremen,Bundesliga,2023,30.0,1993.0,2.0,1,1,0,1,0,1,1,100.0,0,2,1,1,0,1,1,0,FW,30-34,Forward,Germany,Europe
358008,Gianluca Gaetano,ITA,Cagliari,Serie A,2023,23.0,2000.0,8.3,7,4,0,4,3,2,7,28.6,5,4,0,4,3,10,4,0,"FW,MF",20-24,Forward,Italy,Europe
434675,Cody Gakpo,NED,Liverpool,Premier League,2023,24.0,1999.0,18.3,27,17,8,14,5,8,25,32.0,17,21,4,17,14,41,7,0,"FW,MF",20-24,Forward,Netherlands,Europe
488362,Conor Gallagher,ENG,Chelsea,Premier League,2023,23.0,2000.0,34.8,85,52,37,31,17,33,77,42.9,44,50,11,39,43,128,34,0,MF,20-24,Midfielder,England,Europe
392516,Antonino Gallo,ITA,Lecce,Serie A,2023,23.0,2000.0,27.7,43,27,31,11,1,31,49,63.3,18,34,9,25,25,68,67,0,DF,20-24,Defender,Italy,Europe
121686,Cristian Gamboa,CRC,Bochum,Bundesliga,2023,33.0,1989.0,13.2,24,18,12,11,1,14,33,42.4,19,20,7,13,15,39,34,1,DF,30-34,Defender,Costa Rica,North America
27389,Kvin Gameiro,FRA,Strasbourg,Ligue 1,2023,36.0,1987.0,15.0,10,10,5,3,2,2,17,11.8,15,9,0,9,3,13,7,0,"FW,MF",35-39,Forward,France,Europe
192616,Ulisses Garcia,SUI,Marseille,Ligue 1,2023,27.0,1996.0,10.1,21,16,6,13,2,13,20,65.0,7,8,3,5,7,28,13,2,DF,25-29,Defender,Switzerland,Europe
811779,Alejandro Garnacho,ARG,Manchester Utd,Premier League,2023,19.0,2004.0,28.5,22,15,7,6,9,12,45,26.7,33,26,2,24,18,40,18,0,FW,Under 20,Forward,Argentina,South America
505219,James Garner,ENG,Everton,Premier League,2023,22.0,2001.0,33.4,83,44,32,38,13,35,82,42.7,47,45,14,31,45,128,47,1,MF,20-24,Midfielder,England,Europe
205677,Luca Garritano,ITA,Frosinone,Serie A,2023,29.0,1994.0,5.4,10,5,7,2,1,5,15,33.3,10,13,0,13,4,14,8,1,"MF,DF",25-29,Midfielder,Italy,Europe
72121,Johan Gastien,FRA,Clermont Foot,Ligue 1,2023,35.0,1988.0,25.1,43,22,18,21,4,23,81,28.4,58,31,9,22,36,79,24,4,MF,35-39,Midfielder,France,Europe
509022,Federico Gatti,ITA,Juventus,Serie A,2023,25.0,1998.0,29.3,33,19,16,16,1,19,24,79.2,5,26,15,11,19,52,90,1,DF,25-29,Defender,Italy,Europe
463613,Yann Gboho,FRA,Toulouse,Ligue 1,2023,22.0,2001.0,13.3,14,4,6,6,2,8,23,34.8,15,21,1,20,4,18,2,0,"MF,FW",20-24,Midfielder,France,Europe
337811,Francesco Gelli,ITA,Frosinone,Serie A,2023,26.0,1996.0,17.3,19,13,8,4,7,10,24,41.7,14,19,3,16,11,30,27,1,"MF,DF",25-29,Midfielder,Italy,Europe
569387,Valentin Gendrey,FRA,Lecce,Serie A,2023,23.0,2000.0,33.8,55,33,35,16,4,30,46,65.2,16,40,11,29,35,90,99,0,DF,20-24,Defender,France,Europe
470618,Denis Genreau,AUS,Toulouse,Ligue 1,2023,24.0,1999.0,5.2,12,9,6,6,0,8,15,53.3,7,8,1,7,6,18,8,0,"MF,FW",20-24,Midfielder,Australia,Oceania
119277,Yannick Gerhardt,GER,Wolfsburg,Bundesliga,2023,29.0,1994.0,18.1,31,20,16,12,3,9,32,28.1,23,15,2,13,7,38,35,0,"MF,DF",25-29,Midfielder,Germany,Europe
204294,Saman Ghoddos,IRN,Brentford,Premier League,2023,29.0,1993.0,8.2,28,19,19,7,2,17,31,54.8,14,9,2,7,5,33,12,0,DF,25-29,Defender,Iran,Asia
429014,Morgan Gibbs-White,ENG,Nott'ham Forest,Premier League,2023,23.0,2000.0,35.1,36,24,6,20,10,14,33,42.4,19,31,8,23,17,53,21,0,"MF,FW",20-24,Midfielder,England,Europe
276896,Samuel Gigot,FRA,Marseille,Ligue 1,2023,29.0,1993.0,19.2,33,22,16,13,4,13,19,68.4,6,28,18,10,25,58,93,1,DF,25-29,Defender,France,Europe
790992,Alfie Gilchrist,ENG,Chelsea,Premier League,2023,19.0,2003.0,2.3,4,0,4,0,0,2,5,40.0,3,6,3,3,3,7,11,0,DF,Under 20,Defender,England,Europe
423744,Billy Gilmour,SCO,Brighton,Premier League,2023,22.0,2001.0,23.6,26,16,14,10,2,11,35,31.4,24,23,9,14,11,37,14,1,MF,20-24,Midfielder,Scotland,Europe
227084,Benedikt Gimber,GER,Heidenheim,Bundesliga,2023,26.0,1997.0,22.5,40,24,25,14,1,19,35,54.3,16,27,17,10,16,56,101,1,DF,25-29,Defender,Germany,Europe
798929,Gvidas Gineitis,LTU,Torino,Serie A,2023,19.0,2004.0,6.0,11,7,3,8,0,4,7,57.1,3,10,4,6,4,15,9,1,MF,Under 20,Midfielder,Lithuania,Europe
82442,Olivier Giroud,FRA,Milan,Serie A,2023,36.0,1986.0,26.3,17,11,6,6,5,2,14,14.3,12,14,3,11,6,23,22,0,FW,35-39,Forward,France,Europe
670882,Jamie Gittens,ENG,Dortmund,Bundesliga,2023,18.0,2004.0,11.8,14,7,6,7,1,2,17,11.8,15,11,2,9,4,18,7,0,"FW,MF",Under 20,Forward,England,Europe
57598,Klaus Gjasula,ALB,Darmstadt 98,Bundesliga,2023,33.0,1989.0,15.1,44,22,18,25,1,17,30,56.7,13,26,14,12,19,63,42,2,"DF,MF",30-34,Defender,Albania,Europe
159471,Serge Gnabry,GER,Bayern Munich,Bundesliga,2023,28.0,1995.0,4.8,8,5,0,5,3,2,13,15.4,11,5,0,5,3,11,2,0,"FW,MF",25-29,Forward,Germany,Europe
343475,Ben Godfrey,ENG,Everton,Premier League,2023,25.0,1998.0,12.4,30,20,17,8,5,15,28,53.6,13,14,8,6,16,46,57,0,DF,25-29,Defender,England,Europe
263918,Aleksandr Golovin,RUS,Monaco,Ligue 1,2023,27.0,1996.0,23.9,42,30,14,22,6,15,42,35.7,27,37,3,34,21,63,14,0,"MF,FW",25-29,Midfielder,Russia,Europe
670710,Andr Gomes,POR,Everton,Premier League,2023,30.0,1993.0,5.6,7,4,2,3,2,3,13,23.1,10,10,1,9,3,10,4,1,"MF,FW",30-34,Midfielder,Portugal,Europe
392770,Angel Gomes,ENG,Lille,Ligue 1,2023,22.0,2000.0,28.6,26,13,4,15,7,14,32,43.8,18,23,6,17,18,44,28,1,MF,20-24,Midfielder,England,Europe
735570,Joo Gomes,BRA,Wolves,Premier League,2023,22.0,2001.0,29.4,128,74,67,49,12,44,99,44.4,55,51,8,43,18,146,29,2,MF,20-24,Midfielder,Brazil,South America
256178,Joe Gomez,ENG,Liverpool,Premier League,2023,26.0,1997.0,19.8,47,31,24,16,7,30,63,47.6,33,26,4,22,19,66,50,2,DF,25-29,Defender,England,Europe
503733,Anthony Gordon,ENG,Newcastle Utd,Premier League,2023,22.0,2001.0,32.1,55,34,16,28,11,22,64,34.4,42,27,0,27,7,62,7,0,FW,20-24,Forward,England,Europe
153084,Leon Goretzka,GER,Bayern Munich,Bundesliga,2023,28.0,1995.0,24.9,41,23,18,14,9,24,54,44.4,30,44,8,36,31,72,42,1,MF,25-29,Midfielder,Germany,Europe
418659,Amine Gouiri,ALG,Rennes,Ligue 1,2023,23.0,2000.0,23.0,20,10,4,11,5,8,19,42.1,11,18,1,17,14,34,12,0,"FW,MF",20-24,Forward,Algeria,Africa
106405,Jeffrey Gouweleeuw,NED,Augsburg,Bundesliga,2023,32.0,1991.0,28.8,35,23,13,17,5,16,25,64.0,9,44,24,20,35,70,108,0,DF,30-34,Defender,Netherlands,Europe
126557,Jonathan Gradit,FRA,Lens,Ligue 1,2023,30.0,1992.0,23.5,32,20,15,14,3,19,35,54.3,16,30,17,13,37,69,61,0,DF,30-34,Defender,France,Europe
432772,Samuel Grandsir,FRA,Le Havre,Ligue 1,2023,26.0,1996.0,6.7,16,12,5,9,2,8,18,44.4,10,4,0,4,3,19,3,1,"MF,FW",25-29,Midfielder,France,Europe
197473,Alberto Grassi,ITA,Empoli,Serie A,2023,28.0,1995.0,20.1,30,18,13,13,4,10,26,38.5,16,26,11,15,41,71,37,0,MF,25-29,Midfielder,Italy,Europe
203460,Jack Grealish,ENG,Manchester City,Premier League,2023,27.0,1995.0,11.2,13,8,6,7,0,6,12,50.0,6,13,2,11,6,19,5,0,"FW,MF",25-29,Forward,England,Europe
125781,Antoine Griezmann,FRA,Atltico Madrid,La Liga,2023,32.0,1991.0,29.4,33,19,14,14,5,15,41,36.6,26,34,3,31,10,43,23,1,"FW,MF",30-34,Forward,France,Europe
185077,Vincenzo Grifo,ITA,Freiburg,Bundesliga,2023,30.0,1993.0,25.8,31,20,14,11,6,14,31,45.2,17,22,1,21,15,46,20,0,"MF,FW",30-34,Midfielder,Italy,Europe
195736,Florian Grillitsch,AUT,Hoffenheim,Bundesliga,2023,27.0,1995.0,25.5,54,28,31,19,4,22,54,40.7,32,41,20,21,52,106,90,2,"DF,MF",25-29,Defender,Austria,Europe
58396,Christian Gro,GER,Werder Bremen,Bundesliga,2023,34.0,1989.0,8.9,21,16,11,9,1,11,25,44.0,14,17,6,11,13,34,28,1,"DF,MF",30-34,Defender,Germany,Europe
82873,Pascal Gro,GER,Brighton,Premier League,2023,32.0,1991.0,34.6,70,46,33,21,16,31,72,43.1,41,41,8,33,22,92,32,3,"MF,DF",30-34,Midfielder,Germany,Europe
700106,Brajan Gruda,GER,Mainz 05,Bundesliga,2023,19.0,2004.0,18.2,22,14,5,11,6,14,24,58.3,10,15,0,15,5,27,4,0,"MF,FW",Under 20,Midfielder,Germany,Europe
362108,Gabriel Gudmundsson,SWE,Lille,Ligue 1,2023,24.0,1999.0,14.1,22,16,7,13,2,12,20,60.0,8,14,3,11,15,37,25,0,"DF,FW",20-24,Defender,Sweden,Europe
225122,Gonalo Guedes,POR,Villarreal,La Liga,2023,26.0,1996.0,10.6,6,4,1,2,3,2,7,28.6,5,8,0,8,2,8,3,0,"FW,MF",25-29,Forward,Portugal,Europe
500689,Evann Guessand,CIV,Nice,Ligue 1,2023,22.0,2001.0,17.3,16,7,2,7,7,6,7,85.7,1,12,1,11,12,28,7,0,FW,20-24,Forward,Ivory Coast,Africa
485963,Pape Gueye,SEN,Marseille,Ligue 1,2023,24.0,1999.0,8.5,33,21,11,19,3,13,19,68.4,6,17,3,14,13,46,12,0,"MF,DF",20-24,Midfielder,Senegal,Africa
691786,Morgan Guilavogui,GUI,Lens,Ligue 1,2023,25.0,1998.0,6.3,21,10,4,12,5,5,11,45.5,6,11,2,9,4,25,7,0,"FW,MF",25-29,Forward,Guinea,Africa
520624,Bruno Guimares,BRA,Newcastle Utd,Premier League,2023,25.0,1997.0,36.3,88,53,45,32,11,40,77,51.9,37,52,14,38,35,123,20,0,MF,25-29,Midfielder,Brazil,South America
270541,Serhou Guirassy,GUI,Stuttgart,Bundesliga,2023,27.0,1996.0,24.5,6,3,1,4,1,2,5,40.0,3,8,1,7,6,12,29,0,FW,25-29,Forward,Guinea,Africa
93707,Christian Gnter,GER,Freiburg,Bundesliga,2023,30.0,1993.0,11.8,20,12,9,11,0,7,18,38.9,11,9,3,6,2,22,16,0,DF,30-34,Defender,Germany,Europe
241076,Emmanuel Gyasi,GHA,Empoli,Serie A,2023,29.0,1994.0,20.9,34,17,18,13,3,15,32,46.9,17,30,12,18,5,39,27,1,"DF,FW",25-29,Defender,Ghana,Africa
177779,Janik Haberer,GER,Union Berlin,Bundesliga,2023,29.0,1994.0,13.6,36,24,16,13,7,22,45,48.9,23,21,4,17,12,48,18,0,"MF,DF",25-29,Midfielder,Germany,Europe
223725,Munir El Haddadi,MAR,Las Palmas,La Liga,2023,27.0,1995.0,27.2,40,27,18,17,5,17,38,44.7,21,27,1,26,11,51,16,0,FW,25-29,Forward,Morocco,Africa
402008,Amadou Haidara,MLI,RB Leipzig,Bundesliga,2023,25.0,1998.0,17.0,42,27,24,16,2,23,41,56.1,18,28,6,22,21,63,37,0,MF,25-29,Midfielder,Mali,Africa
283127,Oualid El Hajjam,MAR,Le Havre,Ligue 1,2023,32.0,1991.0,4.4,8,7,5,2,1,2,9,22.2,7,5,1,4,6,14,10,0,"DF,MF",30-34,Defender,Morocco,Africa
398073,Achraf Hakimi,MAR,Paris S-G,Ligue 1,2023,24.0,1998.0,21.5,29,19,14,9,6,17,34,50.0,17,28,4,24,12,41,28,2,DF,20-24,Defender,Morocco,Africa
670858,Lewis Hall,ENG,Newcastle Utd,Premier League,2023,18.0,2004.0,8.7,28,18,17,10,1,17,28,60.7,11,17,2,15,12,40,22,1,DF,Under 20,Defender,England,Europe
322985,Gustavo Hamer,NED,Sheffield Utd,Premier League,2023,26.0,1997.0,32.3,39,21,17,15,7,16,59,27.1,43,33,9,24,29,68,35,0,MF,25-29,Midfielder,Netherlands,Europe
372711,Amine Harit,MAR,Marseille,Ligue 1,2023,26.0,1997.0,20.2,28,16,8,17,3,13,37,35.1,24,31,4,27,12,40,4,0,"MF,FW",25-29,Midfielder,Morocco,Africa
417346,Jack Harrison,ENG,Everton,Premier League,2023,26.0,1996.0,24.6,37,22,12,12,13,17,49,34.7,32,25,5,20,12,49,24,0,"MF,FW",25-29,Midfielder,England,Europe
416386,Abdou Harroui,NED,Frosinone,Serie A,2023,25.0,1998.0,11.3,23,11,11,11,1,8,16,50.0,8,19,3,16,5,28,8,0,"MF,FW",25-29,Midfielder,Netherlands,Europe
275303,Hans Hateboer,NED,Atalanta,Serie A,2023,29.0,1994.0,12.4,12,5,8,2,2,5,15,33.3,10,21,7,14,4,16,21,0,DF,25-29,Defender,Netherlands,Europe
309400,Kai Havertz,GER,Arsenal,Premier League,2023,24.0,1999.0,29.3,35,15,7,21,7,14,39,35.9,25,26,1,25,20,55,22,0,"MF,FW",20-24,Midfielder,Germany,Europe
576314,Jan Paul van Hecke,NED,Brighton,Premier League,2023,23.0,2000.0,26.3,47,26,25,19,3,27,45,60.0,18,49,27,22,30,77,76,4,DF,20-24,Defender,Netherlands,Europe
202591,Benjamin Henrichs,GER,RB Leipzig,Bundesliga,2023,26.0,1997.0,28.1,68,39,32,26,10,27,58,46.6,31,49,4,45,33,101,37,0,DF,25-29,Defender,Germany,Europe
281963,Lucas Hernndez,FRA,Paris S-G,Ligue 1,2023,27.0,1996.0,21.2,52,36,28,15,9,29,50,58.0,21,21,5,16,27,79,38,0,DF,25-29,Defender,France,Europe
339808,Theo Hernndez,FRA,Milan,Serie A,2023,25.0,1997.0,31.0,30,17,19,11,0,11,22,50.0,11,33,13,20,23,53,42,1,DF,25-29,Defender,France,Europe
378293,Yangel Herrera,VEN,Girona,La Liga,2023,25.0,1998.0,23.4,64,37,28,30,6,30,56,53.6,26,30,8,22,24,88,45,1,MF,25-29,Midfielder,Venezuela,South America
591949,Aaron Hickey,SCO,Brentford,Premier League,2023,21.0,2002.0,7.9,16,9,9,3,4,7,7,100.0,0,7,3,4,3,19,10,0,DF,20-24,Defender,Scotland,Europe
503075,Isak Hien,SWE,Hellas Verona,Serie A,2023,24.0,1999.0,9.6,17,10,10,7,0,10,19,52.6,9,12,5,7,7,24,33,1,DF,20-24,Defender,Sweden,Europe
659813,Piero Hincapi,ECU,Leverkusen,Bundesliga,2023,21.0,2002.0,16.5,35,22,14,17,4,13,17,76.5,4,18,7,11,13,48,43,0,DF,20-24,Defender,Ecuador,South America
867688,Jack Hinshelwood,ENG,Brighton,Premier League,2023,18.0,2005.0,9.7,14,5,7,4,3,5,13,38.5,8,6,2,4,14,28,18,0,DF,Under 20,Defender,England,Europe
55099,Nicolas Hfler,GER,Freiburg,Bundesliga,2023,33.0,1990.0,25.9,63,40,36,20,7,22,49,44.9,27,30,16,14,31,94,45,0,MF,30-34,Midfielder,Germany,Europe
227085,Jonas Hofmann,GER,Leverkusen,Bundesliga,2023,31.0,1992.0,24.5,20,14,6,9,5,10,24,41.7,14,18,0,18,8,28,6,0,MF,30-34,Midfielder,Germany,Europe
119037,Philipp Hofmann,GER,Bochum,Bundesliga,2023,30.0,1993.0,17.5,10,5,4,5,1,4,7,57.1,3,11,2,9,4,14,17,0,FW,30-34,Forward,Germany,Europe
248999,Lucas Hler,GER,Freiburg,Bundesliga,2023,29.0,1994.0,25.6,32,24,14,10,8,4,23,17.4,19,19,4,15,15,47,35,0,"FW,MF",25-29,Forward,Germany,Europe
54846,Fabian Holland,GER,Darmstadt 98,Bundesliga,2023,33.0,1990.0,20.4,47,26,18,21,8,20,37,54.1,17,22,12,10,24,71,29,0,"MF,DF",30-34,Midfielder,Germany,Europe
453870,Benedict Hollerbach,GER,Union Berlin,Bundesliga,2023,22.0,2001.0,14.2,17,11,5,7,5,7,22,31.8,15,28,0,28,4,21,3,0,"FW,MF",20-24,Forward,Germany,Europe
496745,Emil Holm,SWE,Atalanta,Serie A,2023,23.0,2000.0,10.5,28,19,17,9,2,16,36,44.4,20,25,3,22,7,35,25,0,DF,20-24,Defender,Sweden,Europe
190289,Gerrit Holtmann,PHI,Darmstadt 98,Bundesliga,2023,28.0,1995.0,4.4,8,5,3,4,1,7,10,70.0,3,7,0,7,2,10,4,1,"MF,FW",25-29,Midfielder,Philippines,Asia
229006,Franck Honorat,FRA,Gladbach,Bundesliga,2023,26.0,1996.0,26.1,25,13,13,10,2,11,20,55.0,9,22,3,19,9,34,35,1,"DF,FW",25-29,Defender,France,Europe
388160,Fraser Hornby,SCO,Darmstadt 98,Bundesliga,2023,23.0,1999.0,2.4,0,0,0,0,0,0,1,0.0,1,2,1,1,0,0,4,0,"FW,MF",20-24,Forward,Scotland,Europe
236981,Timo Hbers,GER,Kln,Bundesliga,2023,27.0,1996.0,30.9,68,47,51,14,3,49,80,61.3,31,54,28,26,63,131,168,1,DF,25-29,Defender,Germany,Europe
392768,Callum Hudson-Odoi,ENG,Nott'ham Forest,Premier League,2023,22.0,2000.0,20.6,18,8,4,5,9,7,28,25.0,21,16,1,15,7,25,12,1,"FW,MF",20-24,Forward,England,Europe
207014,Will Hughes,ENG,Crystal Palace,Premier League,2023,28.0,1995.0,21.0,61,33,30,20,11,24,48,50.0,24,36,14,22,21,82,25,0,MF,25-29,Midfielder,England,Europe
678479,Denis Huseinbasic,BIH,Kln,Bundesliga,2023,22.0,2001.0,18.1,38,18,17,15,6,20,31,64.5,11,26,1,25,13,51,14,0,MF,20-24,Midfielder,Bosnia and Herzegovina,Europe
200056,Elseid Hysaj,ALB,Lazio,Serie A,2023,29.0,1994.0,13.3,24,14,8,13,3,15,24,62.5,9,16,6,10,17,41,31,0,DF,25-29,Defender,Albania,Europe
520468,Iago,BRA,Augsburg,Bundesliga,2023,26.0,1997.0,18.0,36,17,22,10,4,17,33,51.5,16,39,8,31,18,54,43,0,DF,25-29,Defender,Brazil,South America
581672,Samuel Iling-Junior,ENG,Juventus,Serie A,2023,19.0,2003.0,9.0,23,13,9,11,3,11,18,61.1,7,17,5,12,6,29,19,0,"DF,MF",Under 20,Defender,England,Europe
134294,Danny Ings,ENG,West Ham,Premier League,2023,31.0,1992.0,4.5,6,2,0,6,0,4,13,30.8,9,4,1,3,3,9,7,0,FW,30-34,Forward,England,Europe
349066,Alexander Isak,SWE,Newcastle Utd,Premier League,2023,23.0,1999.0,25.1,5,0,2,1,2,2,8,25.0,6,16,1,15,6,11,13,0,FW,20-24,Forward,Sweden,Europe
462823,Gustav Isaksen,DEN,Lazio,Serie A,2023,22.0,2001.0,11.9,4,3,2,1,1,1,9,11.1,8,11,1,10,4,8,4,0,FW,20-24,Forward,Denmark,Europe
124028,Ismaily,BRA,Lille,Ligue 1,2023,33.0,1990.0,27.4,72,47,34,25,13,31,60,51.7,29,33,6,27,32,104,77,0,DF,30-34,Defender,Brazil,South America
355816,Ko Itakura,JPN,Gladbach,Bundesliga,2023,26.0,1997.0,17.7,34,21,17,15,2,16,26,61.5,10,32,18,14,22,56,62,0,"DF,MF",25-29,Defender,Japan,Asia
353892,Hiroki Ito,JPN,Stuttgart,Bundesliga,2023,24.0,1999.0,24.8,19,18,13,6,0,11,26,42.3,15,29,17,12,29,48,86,2,DF,20-24,Defender,Japan,Asia
348791,Junya Ito,JPN,Reims,Ligue 1,2023,30.0,1993.0,30.2,33,15,11,14,8,10,36,27.8,26,23,1,22,14,47,7,0,"FW,MF",30-34,Forward,Japan,Asia
32113,Armando Izzo,ITA,Monza,Serie A,2023,31.0,1992.0,18.3,27,17,17,9,1,16,27,59.3,11,20,16,4,27,54,49,1,DF,30-34,Defender,Italy,Europe
776890,Nicolas Jackson,SEN,Chelsea,Premier League,2023,22.0,2001.0,31.1,21,13,5,8,8,5,24,20.8,19,20,5,15,4,25,17,0,FW,20-24,Forward,Senegal,Africa
366045,Ablie Jallow,GAM,Metz,Ligue 1,2023,24.0,1998.0,10.2,8,5,2,3,3,3,5,60.0,2,4,0,4,8,16,3,0,"MF,FW",20-24,Midfielder,Gambia,Africa
270171,Vitaly Janelt,GER,Brentford,Premier League,2023,25.0,1998.0,33.9,63,38,29,25,9,32,64,50.0,32,35,9,26,36,99,64,3,"MF,DF",25-29,Midfielder,Germany,Europe
177847,Adnan Januzaj,BEL,Sevilla,La Liga,2023,28.0,1995.0,2.1,3,3,2,0,1,0,1,0.0,1,2,0,2,1,4,0,0,"FW,MF",25-29,Forward,Belgium,Europe
884072,Jeffinho,BRA,Lyon,Ligue 1,2023,23.0,1999.0,3.4,11,4,3,5,3,4,11,36.4,7,1,0,1,0,11,0,0,"FW,MF",20-24,Forward,Brazil,South America
249157,Fredrik Jensen,FIN,Augsburg,Bundesliga,2023,25.0,1997.0,14.9,23,11,9,8,6,14,28,50.0,14,30,1,29,12,35,21,0,"MF,FW",25-29,Midfielder,Finland,Europe
363205,Gabriel Jesus,BRA,Arsenal,Premier League,2023,26.0,1997.0,16.4,24,17,11,5,8,5,18,27.8,13,23,1,22,13,37,12,0,FW,25-29,Forward,Brazil,South America
121985,Juan Jesus,BRA,Napoli,Serie A,2023,32.0,1991.0,23.5,42,19,28,12,2,23,33,69.7,10,23,12,11,23,65,67,1,DF,30-34,Defender,Brazil,South America
876440,Joo Pedro,BRA,Brighton,Premier League,2023,21.0,2001.0,22.7,31,14,10,13,8,14,24,58.3,10,15,2,13,11,42,28,0,"FW,MF",20-24,Forward,Brazil,South America
333241,Joelinton,BRA,Newcastle Utd,Premier League,2023,26.0,1996.0,14.2,39,27,21,15,3,14,38,36.8,24,23,7,16,19,58,11,1,"MF,FW",25-29,Midfielder,Brazil,South America
468002,Ben Johnson,ENG,West Ham,Premier League,2023,23.0,2000.0,6.0,11,7,7,3,1,9,14,64.3,5,2,1,1,5,16,14,0,"DF,FW",20-24,Defender,England,Europe
433188,Curtis Jones,ENG,Liverpool,Premier League,2023,22.0,2001.0,13.0,27,14,12,12,3,10,23,43.5,13,22,0,22,7,34,8,0,MF,20-24,Midfielder,England,Europe
326330,Frenkie de Jong,NED,Barcelona,La Liga,2023,26.0,1997.0,18.2,43,26,14,23,6,8,19,42.1,11,18,8,10,14,57,28,1,MF,25-29,Midfielder,Netherlands,Europe
620477,Kaio Jorge,BRA,Frosinone,Serie A,2023,21.0,2002.0,9.0,6,4,0,1,5,3,4,75.0,1,6,0,6,1,7,0,0,FW,20-24,Forward,Brazil,South America
122155,Willian Jos,BRA,Betis,La Liga,2023,31.0,1991.0,21.9,7,3,1,2,4,2,5,40.0,3,8,2,6,2,9,15,0,FW,30-34,Forward,Brazil,South America
340950,Diogo Jota,POR,Liverpool,Premier League,2023,26.0,1996.0,12.7,23,13,6,13,4,10,23,43.5,13,9,1,8,7,30,4,0,FW,25-29,Forward,Portugal,Europe
1028162,Antoine Joujou,FRA,Le Havre,Ligue 1,2023,20.0,2003.0,8.7,20,12,7,7,6,11,21,52.4,10,11,2,9,7,27,5,0,"FW,MF",20-24,Forward,France,Europe
201737,Christopher Jullien,FRA,Montpellier,Ligue 1,2023,30.0,1993.0,13.7,16,12,11,5,0,6,17,35.3,11,25,20,5,12,28,106,2,DF,30-34,Defender,France,Europe
58995,Anthony Jung,GER,Werder Bremen,Bundesliga,2023,31.0,1991.0,28.7,37,23,21,14,2,18,33,54.5,15,39,17,22,24,61,102,0,DF,30-34,Defender,Germany,Europe
955357,Eli Junior Kroupi,FRA,Lorient,Ligue 1,2023,17.0,2006.0,12.0,7,4,2,2,3,1,9,11.1,8,6,0,6,10,17,5,0,"FW,MF",Under 20,Forward,France,Europe
911328,Mohamed Kaba,FRA,Lecce,Serie A,2023,21.0,2001.0,15.3,39,23,15,16,8,17,34,50.0,17,22,4,18,12,51,13,0,MF,20-24,Midfielder,France,Europe
361260,Ozan Kabak,TUR,Hoffenheim,Bundesliga,2023,23.0,2000.0,25.4,48,35,32,14,2,19,33,57.6,14,43,21,22,46,94,106,2,DF,20-24,Defender,Turkey,Asia
81512,Christian Kabasele,BEL,Udinese,Serie A,2023,32.0,1991.0,9.6,10,7,4,5,1,2,11,18.2,9,15,9,6,12,22,56,0,DF,30-34,Defender,Belgium,Europe
649452,Issa Kabor,BFA,Luton Town,Premier League,2023,22.0,2001.0,19.2,52,28,23,21,8,24,45,53.3,21,22,11,11,16,68,56,2,DF,20-24,Defender,Burkina Faso,Africa
560725,Abdoul Kader Bamba,FRA,Nantes,Ligue 1,2023,29.0,1994.0,6.8,10,7,2,5,3,5,15,33.3,10,4,0,4,4,14,4,1,"FW,MF",25-29,Forward,France,Europe
384060,Tino Kadewere,ZIM,Lyon,Ligue 1,2023,27.0,1996.0,3.3,1,1,0,1,0,1,5,20.0,4,3,1,2,5,6,7,0,"FW,MF",25-29,Forward,Zimbabwe,Africa
743589,Kaiky,BRA,Almera,La Liga,2023,19.0,2004.0,5.8,7,4,6,0,1,3,6,50.0,3,9,7,2,3,10,29,1,DF,Under 20,Defender,Brazil,South America
106270,Florian Kainz,AUT,Kln,Bundesliga,2023,30.0,1992.0,24.4,28,20,8,13,7,17,39,43.6,22,20,6,14,13,41,23,1,"MF,FW",30-34,Midfielder,Austria,Europe
585959,Arnaud Kalimuendo,FRA,Rennes,Ligue 1,2023,21.0,2002.0,23.8,5,4,2,2,1,2,5,40.0,3,13,2,11,4,9,4,0,FW,20-24,Forward,France,Europe
356141,Daichi Kamada,JPN,Lazio,Serie A,2023,26.0,1996.0,17.2,53,36,22,22,9,28,52,53.8,24,24,5,19,18,71,7,0,MF,25-29,Midfielder,Japan,Asia
394327,Boubacar Kamara,FRA,Aston Villa,Premier League,2023,23.0,1999.0,18.4,43,29,16,21,6,24,47,51.1,23,21,7,14,21,64,16,0,MF,20-24,Midfielder,France,Europe
290017,Hassane Kamara,CIV,Udinese,Serie A,2023,29.0,1994.0,24.7,45,32,26,13,6,25,38,65.8,13,29,2,27,26,71,66,0,DF,25-29,Defender,Ivory Coast,Africa
132098,Harry Kane,ENG,Bayern Munich,Bundesliga,2023,30.0,1993.0,31.5,13,9,4,4,5,6,18,33.3,12,12,4,8,6,19,14,0,FW,30-34,Forward,England,Europe
810093,Ayman Kari,FRA,Lorient,Ligue 1,2023,18.0,2004.0,9.9,18,14,9,9,0,12,19,63.2,7,19,2,17,6,24,9,1,MF,Under 20,Midfielder,France,Europe
286596,Emir Karic,AUT,Darmstadt 98,Bundesliga,2023,26.0,1997.0,19.8,45,27,23,14,8,21,33,63.6,12,42,11,31,13,58,43,0,DF,25-29,Defender,Austria,Europe
367992,Jesper Karlsson,SWE,Bologna,Serie A,2023,25.0,1998.0,3.8,3,3,2,1,0,2,8,25.0,6,4,0,4,4,7,1,0,FW,25-29,Forward,Sweden,Europe
298635,Grigoris Kastanos,CYP,Salernitana,Serie A,2023,25.0,1998.0,16.4,23,14,8,9,6,9,20,45.0,11,13,4,9,8,31,9,0,"MF,DF",25-29,Midfielder,Cyprus,Asia
816308,Panos Katseris,GRE,Lorient,Ligue 1,2023,22.0,2001.0,11.6,26,20,16,8,2,16,25,64.0,9,20,4,16,8,34,18,0,DF,20-24,Defender,Greece,Europe
364135,Moise Kean,ITA,Juventus,Serie A,2023,23.0,2000.0,7.3,7,4,3,2,2,1,3,33.3,2,4,1,3,2,9,5,0,FW,20-24,Forward,Italy,Europe
667967,Yassine Kechta,MAR,Le Havre,Ligue 1,2023,21.0,2002.0,20.5,46,24,24,19,3,31,73,42.5,42,20,3,17,23,69,16,1,MF,20-24,Midfielder,Morocco,Africa
342039,Yannik Keitel,GER,Freiburg,Bundesliga,2023,23.0,2000.0,10.2,20,15,14,5,1,10,15,66.7,5,17,8,9,12,32,44,3,"DF,MF",20-24,Defender,Germany,Europe
480116,Lloyd Kelly,ENG,Bournemouth,Premier League,2023,24.0,1998.0,17.3,24,19,10,9,5,14,25,56.0,11,22,12,10,13,37,67,0,DF,20-24,Defender,England,Europe
42072,Tobias Kempe,GER,Darmstadt 98,Bundesliga,2023,34.0,1989.0,15.0,20,13,9,8,3,8,24,33.3,16,16,4,12,9,29,12,0,MF,30-34,Midfielder,Germany,Europe
103565,Wahbi Khazri,TUN,Montpellier,Ligue 1,2023,32.0,1991.0,12.6,24,17,8,12,4,14,35,40.0,21,10,0,10,3,27,7,0,FW,30-34,Forward,Tunisia,Africa
763079,Abdukodir Khusanov,UZB,Lens,Ligue 1,2023,19.0,2004.0,9.0,21,12,13,8,0,9,17,52.9,8,13,8,5,13,34,32,2,DF,Under 20,Defender,Uzbekistan,Asia
161056,Joshua Kimmich,GER,Bayern Munich,Bundesliga,2023,28.0,1995.0,24.2,45,33,25,15,5,26,39,66.7,13,32,4,28,14,59,28,1,"MF,DF",25-29,Midfielder,Germany,Europe
346849,Christoph Klarer,AUT,Darmstadt 98,Bundesliga,2023,23.0,2000.0,26.2,37,22,30,4,3,24,36,66.7,12,31,20,11,21,58,94,1,DF,20-24,Defender,Austria,Europe
193033,Tim Kleindienst,GER,Heidenheim,Bundesliga,2023,27.0,1995.0,31.9,21,12,6,11,4,7,25,28.0,18,32,8,24,12,33,58,0,FW,25-29,Forward,Germany,Europe
215599,Lukas Klostermann,GER,RB Leipzig,Bundesliga,2023,27.0,1996.0,16.0,15,10,7,7,1,4,13,30.8,9,25,12,13,13,28,64,1,DF,25-29,Defender,Germany,Europe
330659,Justin Kluivert,NED,Bournemouth,Premier League,2023,24.0,1999.0,21.3,28,14,5,12,11,8,30,26.7,22,16,1,15,8,36,11,0,"MF,FW",20-24,Midfielder,Netherlands,Europe
429874,Ansgar Knauff,GER,Eint Frankfurt,Bundesliga,2023,21.0,2002.0,23.4,43,26,17,16,10,17,31,54.8,14,40,3,37,20,63,15,0,"MF,DF",20-24,Midfielder,Germany,Europe
118847,Dominik Kohr,GER,Mainz 05,Bundesliga,2023,29.0,1994.0,24.3,65,42,36,25,4,36,57,63.2,21,27,6,21,43,108,58,0,"DF,MF",25-29,Defender,Germany,Europe
745461,Luca Koleosho,ITA,Burnley,Premier League,2023,18.0,2004.0,10.8,7,4,2,5,0,2,10,20.0,8,13,0,13,2,9,0,0,"MF,FW",Under 20,Midfielder,Italy,Europe
357119,Ibrahima Konat,FRA,Liverpool,Premier League,2023,24.0,1999.0,17.5,36,22,22,13,1,18,24,75.0,6,18,12,6,20,56,51,1,DF,20-24,Defender,France,Europe
127189,Geoffrey Kondogbia,CTA,Marseille,Ligue 1,2023,30.0,1993.0,16.3,48,31,18,25,5,13,32,40.6,19,21,4,17,30,78,25,0,MF,30-34,Midfielder,Central African Republic,Africa
1178474,Amadou Kon,MLI,Reims,Ligue 1,2023,18.0,2005.0,5.3,13,8,11,2,0,6,10,60.0,4,8,3,5,10,23,10,0,MF,Under 20,Midfielder,Mali,Africa
413403,Ezri Konsa,ENG,Aston Villa,Premier League,2023,25.0,1997.0,34.1,54,32,28,23,3,23,27,85.2,4,36,20,16,28,82,73,3,DF,25-29,Defender,England,Europe
360518,Teun Koopmeiners,NED,Atalanta,Serie A,2023,25.0,1998.0,29.2,39,24,12,22,5,17,50,34.0,33,33,3,30,10,49,35,0,MF,25-29,Midfielder,Netherlands,Europe
644771,Odilon Kossounou,CIV,Leverkusen,Bundesliga,2023,22.0,2001.0,20.1,30,20,11,12,7,15,26,57.7,11,27,3,24,27,57,43,1,DF,20-24,Defender,Ivory Coast,Africa
337725,Christian Kouam,CIV,Fiorentina,Serie A,2023,25.0,1997.0,12.1,13,4,7,6,0,6,10,60.0,4,16,0,16,2,15,10,0,FW,25-29,Forward,Ivory Coast,Africa
481513,Koffi Kouao,CIV,Metz,Ligue 1,2023,25.0,1998.0,9.6,20,13,12,7,1,11,17,64.7,6,9,6,3,13,33,38,1,DF,25-29,Defender,Ivory Coast,Africa
411975,Jules Kound,FRA,Barcelona,La Liga,2023,24.0,1998.0,32.2,37,23,22,10,5,28,51,54.9,23,32,12,20,25,62,83,5,DF,20-24,Defender,France,Europe
66934,Cheikhou Kouyat,SEN,Nott'ham Forest,Premier League,2023,33.0,1989.0,2.4,8,5,3,3,2,1,4,25.0,3,4,1,3,2,10,10,0,MF,30-34,Midfielder,Senegal,Africa
203842,Viktor Kovalenko,UKR,Empoli,Serie A,2023,27.0,1996.0,6.8,5,2,2,2,1,2,8,25.0,6,12,2,10,1,6,7,0,MF,25-29,Midfielder,Ukraine,Europe
405687,Tom Krau,GER,Mainz 05,Bundesliga,2023,22.0,2001.0,15.0,57,33,22,31,4,21,58,36.2,37,33,4,29,17,74,28,0,MF,20-24,Midfielder,Germany,Europe
698259,Thomas Kristensen,DEN,Udinese,Serie A,2023,21.0,2002.0,23.3,35,24,25,10,0,21,33,63.6,12,29,20,9,29,64,118,0,DF,20-24,Defender,Denmark,Europe
31909,Toni Kroos,GER,Real Madrid,La Liga,2023,33.0,1990.0,23.6,53,34,19,25,9,24,59,40.7,35,22,4,18,17,70,11,1,MF,30-34,Midfielder,Germany,Europe
434433,Nikola Krstovi,MNE,Lecce,Serie A,2023,23.0,2000.0,26.4,17,6,3,9,5,6,10,60.0,4,12,4,8,4,21,22,0,FW,20-24,Forward,Montenegro,Europe
93604,Lukas Kbler,GER,Freiburg,Bundesliga,2023,30.0,1992.0,20.5,50,24,35,13,2,26,42,61.9,16,36,14,22,37,87,57,1,DF,30-34,Defender,Germany,Europe
405398,Takefusa Kubo,JPN,Real Sociedad,La Liga,2023,22.0,2001.0,23.9,26,17,15,6,5,9,23,39.1,14,21,2,19,11,37,8,1,"FW,MF",20-24,Forward,Japan,Asia
543499,Mohammed Kudus,GHA,West Ham,Premier League,2023,22.0,2000.0,27.6,65,47,27,27,11,20,40,50.0,20,25,0,25,11,76,9,1,"FW,MF",20-24,Forward,Ghana,Africa
431755,Dejan Kulusevski,SWE,Tottenham,Premier League,2023,23.0,2000.0,30.7,62,33,19,20,23,25,67,37.3,42,24,1,23,18,80,2,1,"FW,MF",20-24,Forward,Sweden,Europe
279570,Daler Kuzyaev,RUS,Le Havre,Ligue 1,2023,30.0,1993.0,23.2,34,19,11,13,10,15,43,34.9,28,18,5,13,22,56,18,1,MF,30-34,Midfielder,Russia,Europe
502670,Khvicha Kvaratskhelia,GEO,Napoli,Serie A,2023,22.0,2001.0,30.4,42,21,11,19,12,15,49,30.6,34,15,1,14,13,55,9,0,FW,20-24,Forward,Georgia,Asia
316575,Moritz-Broni Kwarteng,GHA,Bochum,Bundesliga,2023,25.0,1998.0,3.1,3,0,0,3,0,1,7,14.3,6,4,0,4,2,5,0,0,FW,25-29,Forward,Ghana,Africa
315762,Luca de la Torre,USA,Celta Vigo,La Liga,2023,25.0,1998.0,21.7,39,21,12,22,5,22,43,51.2,21,23,4,19,12,51,17,0,MF,25-29,Midfielder,United States,North America
181378,Gatan Laborde,FRA,Nice,Ligue 1,2023,29.0,1994.0,21.2,18,12,8,4,6,11,30,36.7,19,20,2,18,6,24,8,1,"FW,MF",25-29,Forward,France,Europe
93720,Alexandre Lacazette,FRA,Lyon,Ligue 1,2023,32.0,1991.0,25.5,19,12,8,9,2,5,17,29.4,12,22,3,19,8,27,9,0,FW,30-34,Forward,France,Europe
233782,Assa Ladouni,TUN,Union Berlin,Bundesliga,2023,26.0,1996.0,11.9,21,12,4,12,5,4,12,33.3,8,26,2,24,12,33,14,2,MF,25-29,Midfielder,Tunisia,Africa
223967,Konrad Laimer,AUT,Bayern Munich,Bundesliga,2023,26.0,1997.0,19.7,56,36,25,20,11,22,52,42.3,30,42,6,36,18,74,13,2,"DF,MF",25-29,Defender,Austria,Europe
174196,Kenny Lala,MAD,Brest,Ligue 1,2023,31.0,1991.0,33.0,78,51,39,28,11,30,56,53.6,26,27,6,21,28,106,75,1,DF,30-34,Defender,Madagascar,Africa
43530,Adam Lallana,ENG,Brighton,Premier League,2023,35.0,1988.0,9.4,8,3,4,4,0,0,4,0.0,4,2,1,1,3,11,1,0,"MF,FW",35-39,Midfielder,England,Europe
130394,Gianluca Lapadula,PER,Cagliari,Serie A,2023,33.0,1990.0,13.4,1,1,0,0,1,1,10,10.0,9,2,1,1,2,3,5,0,FW,30-34,Forward,Peru,South America
386057,Julien Laporte,FRA,Lorient,Ligue 1,2023,29.0,1993.0,20.2,23,14,15,7,1,16,36,44.4,20,36,26,10,11,34,116,1,DF,25-29,Defender,France,Europe
343463,Cyle Larin,CAN,Mallorca,La Liga,2023,28.0,1995.0,20.3,17,8,6,4,7,2,7,28.6,5,16,5,11,3,20,17,0,FW,25-29,Forward,Canada,North America
554251,Yasser Larouci,ALG,Sheffield Utd,Premier League,2023,22.0,2001.0,5.9,17,9,10,5,2,10,14,71.4,4,6,1,5,7,24,20,1,DF,20-24,Defender,Algeria,Africa
931838,Hugo Larsson,SWE,Eint Frankfurt,Bundesliga,2023,19.0,2004.0,21.0,32,18,18,10,4,15,28,53.6,13,34,7,27,29,61,30,1,MF,Under 20,Midfielder,Sweden,Europe
183318,Jamaal Lascelles,ENG,Newcastle Utd,Premier League,2023,29.0,1993.0,12.0,14,9,7,7,0,6,11,54.5,5,17,12,5,5,19,42,0,DF,25-29,Defender,England,Europe
186368,Valentino Lazaro,AUT,Torino,Serie A,2023,27.0,1996.0,22.2,18,11,7,9,2,13,19,68.4,6,14,1,13,8,26,29,0,"DF,MF",25-29,Defender,Austria,Europe
766412,Tho Le Bris,FRA,Lorient,Ligue 1,2023,20.0,2002.0,16.8,35,22,25,7,3,19,40,47.5,21,24,3,21,12,47,42,0,"DF,MF",20-24,Defender,France,Europe
737781,Jrmy Le Douaron,FRA,Brest,Ligue 1,2023,25.0,1998.0,18.0,21,10,7,9,5,11,26,42.3,15,14,1,13,2,23,10,0,FW,25-29,Forward,France,Europe
120651,Vincent Le Goff,FRA,Lorient,Ligue 1,2023,33.0,1989.0,6.0,5,0,4,0,1,4,8,50.0,4,11,3,8,3,8,10,0,"DF,MF",30-34,Defender,France,Europe
357164,Rafael Leo,POR,Milan,Serie A,2023,24.0,1999.0,27.9,16,10,3,8,5,8,13,61.5,5,15,1,14,9,25,19,0,FW,20-24,Forward,Portugal,Europe
377393,Pierre Lees-Melou,FRA,Brest,Ligue 1,2023,30.0,1993.0,28.0,96,67,51,41,4,49,129,38.0,80,61,11,50,43,139,64,3,MF,30-34,Midfielder,France,Europe
357156,Diogo Leite,POR,Union Berlin,Bundesliga,2023,24.0,1999.0,30.0,52,36,31,15,6,25,51,49.0,26,48,22,26,47,99,155,1,DF,20-24,Defender,Portugal,Europe
127108,Florian Lejeune,FRA,Rayo Vallecano,La Liga,2023,32.0,1991.0,37.0,39,25,26,11,2,19,30,63.3,11,33,18,15,23,62,155,1,DF,30-34,Defender,France,Europe
182904,Clment Lenglet,FRA,Aston Villa,Premier League,2023,28.0,1995.0,12.8,13,9,7,5,1,7,13,53.8,6,19,11,8,7,20,47,1,DF,25-29,Defender,France,Europe
585973,Johann Lepenant,FRA,Lyon,Ligue 1,2023,20.0,2002.0,2.8,4,3,2,2,0,1,8,12.5,7,5,0,5,4,8,0,0,MF,20-24,Midfielder,France,Europe
262980,Jefferson Lerma,COL,Crystal Palace,Premier League,2023,28.0,1994.0,26.7,42,25,15,23,4,19,40,47.5,21,31,12,19,36,78,72,0,"MF,DF",25-29,Midfielder,Colombia,South America
518505,Jamie Leweling,GER,Stuttgart,Bundesliga,2023,22.0,2001.0,16.9,18,10,4,6,8,5,17,29.4,12,21,1,20,5,23,13,0,"FW,MF",20-24,Forward,Germany,Europe
644401,Keane Lewis-Potter,ENG,Brentford,Premier League,2023,22.0,2001.0,16.0,17,7,5,11,1,7,15,46.7,8,10,2,8,7,24,23,0,"FW,DF",20-24,Forward,England,Europe
225657,Philipp Lienhart,AUT,Freiburg,Bundesliga,2023,27.0,1996.0,14.1,20,13,14,5,1,13,23,56.5,10,18,11,7,14,34,51,0,DF,25-29,Defender,Austria,Europe
184573,Victor Lindelf,SWE,Manchester Utd,Premier League,2023,29.0,1994.0,14.8,15,10,8,7,0,5,13,38.5,8,18,9,9,12,27,40,1,DF,25-29,Defender,Sweden,Europe
694928,Samuel Lino,BRA,Atltico Madrid,La Liga,2023,23.0,1999.0,23.1,61,34,32,17,12,35,70,50.0,35,37,1,36,14,75,27,0,"DF,MF",20-24,Defender,Brazil,South America
724106,Luca Lipani,ITA,Sassuolo,Serie A,2023,18.0,2005.0,4.3,9,7,4,3,2,3,11,27.3,8,9,2,7,6,15,7,0,MF,Under 20,Midfielder,Italy,Europe
287188,Dejan Ljubicic,AUT,Kln,Bundesliga,2023,25.0,1997.0,22.8,43,27,20,18,5,20,43,46.5,23,22,2,20,18,61,11,0,"MF,FW",25-29,Midfielder,Austria,Europe
249636,Gautier Lloris,FRA,Le Havre,Ligue 1,2023,28.0,1995.0,30.9,50,28,40,9,1,28,42,66.7,14,50,30,20,32,82,142,1,DF,25-29,Defender,France,Europe
348795,Giovani Lo Celso,ARG,Tottenham,Premier League,2023,27.0,1996.0,5.6,22,13,10,8,4,9,14,64.3,5,4,1,3,5,27,2,0,MF,25-29,Midfielder,Argentina,South America
192735,Stanislav Lobotka,SVK,Napoli,Serie A,2023,28.0,1994.0,36.5,61,39,18,30,13,24,60,40.0,36,30,8,22,30,91,29,0,MF,25-29,Midfielder,Slovakia,Europe
805908,Bradley Locko,FRA,Brest,Ligue 1,2023,21.0,2002.0,32.9,97,55,57,34,6,47,80,58.8,33,28,1,27,40,137,69,0,DF,20-24,Defender,France,Europe
207742,Tom Lockyer,WAL,Luton Town,Premier League,2023,28.0,1994.0,13.0,25,16,17,6,2,15,22,68.2,7,23,13,10,23,48,68,0,DF,25-29,Defender,Wales,Europe
202886,Ruben Loftus-Cheek,ENG,Milan,Serie A,2023,27.0,1996.0,23.0,28,18,7,14,7,15,27,55.6,12,24,12,12,9,37,10,1,MF,25-29,Midfielder,England,Europe
581781,Enzo Loiodice,FRA,Las Palmas,La Liga,2023,22.0,2000.0,19.9,62,35,15,34,13,20,42,47.6,22,20,2,18,12,74,16,1,MF,20-24,Midfielder,France,Europe
346707,Sean Longstaff,ENG,Newcastle Utd,Premier League,2023,25.0,1997.0,30.5,54,30,17,29,8,24,63,38.1,39,43,7,36,17,71,23,0,MF,25-29,Midfielder,England,Europe
406040,Ademola Lookman,NGA,Atalanta,Serie A,2023,25.0,1997.0,21.0,20,15,2,11,7,8,22,36.4,14,19,0,19,9,29,0,1,"FW,MF",25-29,Forward,Nigeria,Africa
649033,Dion Lopy,SEN,Almera,La Liga,2023,21.0,2002.0,21.3,62,37,36,20,6,17,44,38.6,27,23,5,18,15,77,22,2,MF,20-24,Midfielder,Senegal,Africa
111266,Anthony Losilla,FRA,Bochum,Bundesliga,2023,37.0,1986.0,28.6,63,37,15,40,8,23,51,45.1,28,37,8,29,25,88,51,0,MF,35-39,Midfielder,France,Europe
750904,Tom Louchet,FRA,Nice,Ligue 1,2023,20.0,2003.0,4.5,14,5,6,6,2,7,11,63.6,4,7,3,4,3,17,9,0,"MF,DF",20-24,Midfielder,France,Europe
572265,Lorenzo Lucca,ITA,Udinese,Serie A,2023,22.0,2000.0,28.8,19,11,4,11,4,5,20,25.0,15,18,3,15,3,22,36,1,FW,20-24,Forward,Italy,Europe
413565,Jhon Lucum,COL,Bologna,Serie A,2023,25.0,1998.0,24.6,48,29,31,17,0,27,36,75.0,9,32,17,15,16,64,68,2,DF,25-29,Defender,Colombia,South America
447661,Douglas Luiz,BRA,Aston Villa,Premier League,2023,25.0,1998.0,33.3,58,38,21,27,10,25,53,47.2,28,32,8,24,23,81,18,2,MF,25-29,Midfielder,Brazil,South America
96341,Romelu Lukaku,BEL,Roma,Serie A,2023,30.0,1993.0,29.3,6,5,1,2,3,2,4,50.0,2,7,1,6,0,6,19,1,FW,30-34,Forward,Belgium,Europe
618472,Castello Lukeba,FRA,RB Leipzig,Bundesliga,2023,20.0,2002.0,24.3,19,12,10,9,0,10,12,83.3,2,35,13,22,12,31,94,2,DF,20-24,Defender,France,Europe
278531,Sebastiano Luperto,ITA,Empoli,Serie A,2023,26.0,1996.0,37.8,37,26,25,10,2,15,24,62.5,9,46,35,11,32,69,157,1,DF,25-29,Defender,Italy,Europe
666547,Zito Luvumbo,ANG,Cagliari,Serie A,2023,21.0,2002.0,21.6,9,6,5,2,2,4,15,26.7,11,19,0,19,1,10,2,0,"FW,MF",20-24,Forward,Angola,Africa
338668,Senne Lynen,BEL,Werder Bremen,Bundesliga,2023,24.0,1999.0,20.0,64,38,33,27,4,30,70,42.9,40,41,8,33,41,105,56,0,MF,20-24,Midfielder,Belgium,Europe
1081219,Othmane Maamma,MAR,Montpellier,Ligue 1,2023,17.0,2005.0,1.0,3,3,2,0,1,1,1,100.0,0,3,0,3,0,3,0,0,FW,Under 20,Forward,Morocco,Africa
534033,Alexis Mac Allister,ARG,Liverpool,Premier League,2023,24.0,1998.0,28.9,99,55,35,50,14,59,125,47.2,66,65,8,57,35,134,25,1,MF,20-24,Midfielder,Argentina,South America
332560,Deiver Machado,COL,Lens,Ligue 1,2023,29.0,1993.0,12.5,24,18,10,10,4,15,20,75.0,5,13,2,11,7,31,8,0,DF,25-29,Defender,Colombia,South America
211251,Darwin Machs,VEN,Cdiz,La Liga,2023,30.0,1993.0,8.7,23,14,7,9,7,13,24,54.2,11,8,1,7,4,27,2,0,MF,30-34,Midfielder,Venezuela,South America
294057,James Maddison,ENG,Tottenham,Premier League,2023,26.0,1996.0,23.7,33,19,5,18,10,15,29,51.7,14,15,3,12,13,46,10,1,MF,25-29,Midfielder,England,Europe
503987,Noni Madueke,ENG,Chelsea,Premier League,2023,21.0,2002.0,11.7,16,10,8,4,4,11,34,32.4,23,11,0,11,4,20,14,0,FW,20-24,Forward,England,Europe
435338,Gabriel Magalhes,BRA,Arsenal,Premier League,2023,25.0,1997.0,33.8,48,28,24,22,2,17,22,77.3,5,44,33,11,31,79,100,1,DF,25-29,Defender,Brazil,South America
745181,Soungoutou Magassa,FRA,Monaco,Ligue 1,2023,19.0,2003.0,15.0,56,26,22,32,2,26,48,54.2,22,21,4,17,21,77,36,2,"DF,MF",Under 20,Defender,France,Europe
353796,Giulio Maggiore,ITA,Salernitana,Serie A,2023,25.0,1998.0,20.0,49,29,26,22,1,20,42,47.6,22,27,5,22,24,73,38,0,MF,25-29,Midfielder,Italy,Europe
310458,Giangiacomo Magnani,ITA,Hellas Verona,Serie A,2023,27.0,1995.0,27.2,33,18,23,10,0,15,25,60.0,10,50,28,22,45,78,118,0,DF,25-29,Defender,Italy,Europe
474662,Hugo Magnetti,FRA,Brest,Ligue 1,2023,25.0,1998.0,26.0,49,27,18,26,5,24,58,41.4,34,19,1,18,18,67,18,0,MF,25-29,Midfielder,France,Europe
594997,Yohann Magnin,FRA,Clermont Foot,Ligue 1,2023,26.0,1997.0,18.7,49,31,12,32,5,22,47,46.8,25,38,13,25,19,68,26,1,MF,25-29,Midfielder,France,Europe
807689,Frank Magri,CMR,Toulouse,Ligue 1,2023,23.0,1999.0,16.0,22,14,5,12,5,15,21,71.4,6,16,4,12,4,26,17,0,"FW,MF",20-24,Forward,Cameroon,Africa
177907,Harry Maguire,ENG,Manchester Utd,Premier League,2023,30.0,1993.0,18.4,24,17,14,10,0,12,22,54.5,10,33,24,9,25,49,83,1,DF,30-34,Defender,England,Europe
296397,Arne Maier,GER,Augsburg,Bundesliga,2023,24.0,1999.0,11.1,14,9,5,8,1,5,14,35.7,9,19,2,17,6,20,11,0,MF,20-24,Midfielder,Germany,Europe
335103,Linton Maina,GER,Kln,Bundesliga,2023,24.0,1999.0,21.1,18,15,11,5,2,9,28,32.1,19,12,1,11,6,24,12,0,"FW,MF",20-24,Forward,Germany,Europe
133731,Patrick Mainka,GER,Heidenheim,Bundesliga,2023,28.0,1994.0,34.0,85,49,58,24,3,38,74,51.4,36,66,32,34,49,134,158,1,DF,25-29,Defender,Germany,Europe
820374,Kobbie Mainoo,ENG,Manchester Utd,Premier League,2023,18.0,2005.0,21.4,47,27,20,16,11,21,45,46.7,24,20,12,8,22,69,30,1,MF,Under 20,Midfielder,England,Europe
285845,Ainsley Maitland-Niles,ENG,Lyon,Ligue 1,2023,25.0,1997.0,15.9,34,18,12,14,8,19,37,51.4,18,16,6,10,17,51,29,1,"DF,MF",25-29,Defender,England,Europe
322305,Jean-Victor Makengo,FRA,Lorient,Ligue 1,2023,25.0,1998.0,5.3,5,4,3,2,0,2,6,33.3,4,12,1,11,8,13,5,0,"MF,FW",25-29,Midfielder,France,Europe
460651,Antoine Makoumbou,CGO,Cagliari,Serie A,2023,25.0,1998.0,30.0,41,24,21,15,5,15,30,50.0,15,23,4,19,16,57,27,2,MF,25-29,Midfielder,Congo,Africa
830108,Julin Malatini,ARG,Werder Bremen,Bundesliga,2023,22.0,2001.0,6.7,18,13,12,3,3,16,24,66.7,8,8,1,7,13,31,26,0,DF,20-24,Defender,Argentina,South America
539134,Daniel Maldini,ITA,Monza,Serie A,2023,21.0,2001.0,3.7,3,2,0,2,1,3,6,50.0,3,2,0,2,2,5,1,0,"MF,FW",20-24,Midfielder,Italy,Europe
324377,Youssef Maleh,MAR,Empoli,Serie A,2023,24.0,1998.0,28.9,74,48,30,36,8,23,52,44.2,29,62,7,55,25,99,29,0,MF,20-24,Midfielder,Morocco,Africa
326029,Donyell Malen,NED,Dortmund,Bundesliga,2023,24.0,1999.0,19.8,11,7,5,3,3,2,6,33.3,4,11,4,7,2,13,8,0,"FW,MF",20-24,Forward,Netherlands,Europe
207877,Ruslan Malinovskyi,UKR,Genoa,Serie A,2023,30.0,1993.0,17.2,35,20,18,11,6,17,41,41.5,24,22,8,14,5,40,16,0,MF,30-34,Midfielder,Ukraine,Europe
392710,Lennard Maloney,USA,Heidenheim,Bundesliga,2023,23.0,1999.0,25.4,43,26,14,24,5,25,59,42.4,34,33,9,24,25,68,88,0,MF,20-24,Midfielder,United States,North America
256448,Gianluca Mancini,ITA,Roma,Serie A,2023,27.0,1996.0,31.9,34,20,21,11,2,11,27,40.7,16,38,26,12,36,70,77,1,DF,25-29,Defender,Italy,Europe
308279,Rolando Mandragora,ITA,Fiorentina,Serie A,2023,26.0,1997.0,17.6,26,11,8,13,5,10,22,45.5,12,14,3,11,9,35,18,1,MF,25-29,Midfielder,Italy,Europe
289592,Orel Mangala,BEL,Nott'ham Forest,Premier League,2023,25.0,1998.0,17.4,27,13,16,10,1,14,29,48.3,15,12,6,6,26,53,32,0,MF,25-29,Midfielder,Belgium,Europe
209212,Solly March,ENG,Brighton,Premier League,2023,29.0,1994.0,6.2,19,14,9,7,3,8,14,57.1,6,5,0,5,11,30,8,0,"FW,DF",25-29,Forward,England,Europe
277167,Gian Marco Ferrari,ITA,Sassuolo,Serie A,2023,31.0,1992.0,25.2,22,10,11,11,0,12,18,66.7,6,28,17,11,25,47,76,0,DF,30-34,Defender,Italy,Europe
250845,Jos Mara Gimnez,URU,Atltico Madrid,La Liga,2023,28.0,1995.0,14.7,18,10,10,7,1,5,16,31.3,11,16,12,4,10,28,95,0,DF,25-29,Defender,Uruguay,South America
295183,Rzvan Marin,ROU,Empoli,Serie A,2023,27.0,1996.0,20.2,40,22,13,23,4,19,29,65.5,10,16,4,12,6,46,30,2,MF,25-29,Midfielder,Romania,Europe
249730,Guillermo Maripn,CHI,Monaco,Ligue 1,2023,29.0,1994.0,19.6,22,8,15,6,1,10,27,37.0,17,26,13,13,30,52,106,4,DF,25-29,Defender,Chile,South America
445939,Omar Marmoush,EGY,Eint Frankfurt,Bundesliga,2023,24.0,1999.0,25.6,21,11,7,8,6,6,16,37.5,10,13,0,13,11,32,7,0,"FW,MF",20-24,Forward,Egypt,Africa
732507,Agustn Martegani,ARG,Salernitana,Serie A,2023,23.0,2000.0,8.1,13,7,7,3,3,6,18,33.3,12,4,1,3,4,17,7,1,MF,20-24,Midfielder,Argentina,South America
597000,Eric Martel,GER,Kln,Bundesliga,2023,21.0,2002.0,27.3,70,43,32,34,4,37,67,55.2,30,65,19,46,43,113,80,0,MF,20-24,Midfielder,Germany,Europe
127142,Jonas Martin,FRA,Brest,Ligue 1,2023,33.0,1990.0,13.4,43,27,17,24,2,21,36,58.3,15,16,2,14,9,52,28,2,MF,30-34,Midfielder,France,Europe
655488,Gabriel Martinelli,BRA,Arsenal,Premier League,2023,22.0,2001.0,22.4,30,24,9,12,9,13,32,40.6,19,23,1,22,5,35,9,1,FW,20-24,Forward,Brazil,South America
406625,Lautaro Martnez,ARG,Inter,Serie A,2023,25.0,1997.0,29.5,22,16,4,13,5,4,19,21.1,15,30,1,29,20,42,10,0,FW,25-29,Forward,Argentina,South America
373373,Lucas Martnez Quarta,ARG,Fiorentina,Serie A,2023,27.0,1996.0,25.5,75,47,43,28,4,36,54,66.7,18,38,14,24,30,105,69,4,DF,25-29,Defender,Argentina,South America
568693,Pape Matar Sarr,SEN,Tottenham,Premier League,2023,20.0,2002.0,23.0,34,24,11,17,6,15,36,41.7,21,21,5,16,31,65,28,1,MF,20-24,Midfielder,Senegal,Africa
535834,Eliot Matazo,BEL,Monaco,Ligue 1,2023,21.0,2002.0,1.1,3,1,0,3,0,2,4,50.0,2,1,1,0,3,6,0,0,MF,20-24,Midfielder,Belgium,Europe
420002,Jean-Philippe Mateta,FRA,Crystal Palace,Premier League,2023,26.0,1997.0,25.4,22,15,4,11,7,6,10,60.0,4,13,4,9,4,26,14,0,FW,25-29,Forward,France,Europe
315145,Azor Matusiwa,NED,Reims,Ligue 1,2023,25.0,1998.0,15.4,39,27,17,19,3,22,32,68.8,10,21,3,18,33,72,32,1,MF,25-29,Midfielder,Netherlands,Europe
860056,Aman Maurer,MAR,Clermont Foot,Ligue 1,2023,18.0,2004.0,0.6,1,1,1,0,0,1,3,33.3,2,0,0,0,0,1,0,0,"MF,FW",Under 20,Midfielder,Morocco,Africa
415912,Konstantinos Mavropanos,GRE,West Ham,Premier League,2023,25.0,1997.0,16.7,28,16,17,9,2,17,21,81.0,4,21,13,8,23,51,79,3,DF,25-29,Defender,Greece,Europe
1005240,Christian Mawissa,FRA,Toulouse,Ligue 1,2023,18.0,2005.0,12.4,22,15,14,4,4,9,23,39.1,14,22,11,11,22,44,41,1,DF,Under 20,Defender,France,Europe
340456,Noussair Mazraoui,MAR,Bayern Munich,Bundesliga,2023,25.0,1997.0,13.3,32,21,14,11,7,13,21,61.9,8,14,1,13,20,52,27,1,DF,25-29,Defender,Morocco,Africa
226025,Luca Mazzitelli,ITA,Frosinone,Serie A,2023,27.0,1995.0,24.6,45,23,15,24,6,26,49,53.1,23,23,7,16,19,64,62,0,MF,25-29,Midfielder,Italy,Europe
250153,Pasquale Mazzocchi,ITA,Salernitana,Serie A,2023,28.0,1995.0,14.1,25,19,14,10,1,16,29,55.2,13,14,6,8,5,30,31,0,DF,25-29,Defender,Italy,Europe
342229,Kylian Mbapp,FRA,Paris S-G,Ligue 1,2023,24.0,1998.0,24.0,4,1,1,1,2,4,9,44.4,5,4,0,4,2,6,2,0,FW,20-24,Forward,France,Europe
203348,Chancel Mbemba,COD,Marseille,Ligue 1,2023,28.0,1994.0,24.5,33,21,25,7,1,17,30,56.7,13,21,13,8,13,46,95,1,DF,25-29,Defender,DR Congo,Africa
413039,Bryan Mbeumo,CMR,Brentford,Premier League,2023,23.0,1999.0,21.8,15,10,6,6,3,5,19,26.3,14,26,2,24,7,22,13,0,FW,20-24,Forward,Cameroon,Africa
193116,John McGinn,SCO,Aston Villa,Premier League,2023,28.0,1994.0,33.3,59,35,18,34,7,32,77,41.6,45,33,4,29,21,80,21,0,"MF,FW",25-29,Midfielder,Scotland,Europe
332697,Weston McKennie,USA,Juventus,Serie A,2023,24.0,1998.0,28.8,48,29,31,11,6,17,27,63.0,10,28,7,21,18,66,69,0,"MF,DF",20-24,Midfielder,United States,North America
584769,Dwight McNeil,ENG,Everton,Premier League,2023,23.0,1999.0,32.1,44,27,16,14,14,24,55,43.6,31,44,7,37,22,66,37,0,"MF,FW",20-24,Midfielder,England,Europe
315969,Scott McTominay,SCO,Manchester Utd,Premier League,2023,26.0,1996.0,21.1,49,25,23,24,2,22,33,66.7,11,34,12,22,14,63,54,0,"MF,FW",25-29,Midfielder,Scotland,Europe
474800,Facundo Medina,ARG,Lens,Ligue 1,2023,24.0,1999.0,30.2,64,38,25,31,8,44,69,63.8,25,38,13,25,24,88,59,2,DF,20-24,Defender,Argentina,South America
74810,Ben Mee,ENG,Brentford,Premier League,2023,33.0,1989.0,14.1,26,15,12,12,2,17,22,77.3,5,21,13,8,13,39,63,1,DF,30-34,Defender,England,Europe
362842,Arthur Melo,BRA,Fiorentina,Serie A,2023,26.0,1996.0,22.1,45,30,17,24,4,26,42,61.9,16,27,3,24,18,63,8,0,MF,25-29,Midfielder,Brazil,South America
616341,Nuno Mendes,POR,Paris S-G,Ligue 1,2023,21.0,2002.0,3.0,5,5,4,1,0,4,7,57.1,3,4,0,4,4,9,2,0,DF,20-24,Defender,Portugal,Europe
552912,Bruno Mndez,URU,Granada,La Liga,2023,23.0,1999.0,14.8,36,17,19,12,5,21,37,56.8,16,24,6,18,26,62,45,0,DF,20-24,Defender,Uruguay,South America
891998,Antoine Mendy,FRA,Nice,Ligue 1,2023,19.0,2004.0,4.6,7,5,4,3,0,3,7,42.9,4,4,1,3,8,15,16,0,DF,Under 20,Defender,France,Europe
157495,Benjamin Mendy,FRA,Lorient,Ligue 1,2023,29.0,1994.0,7.9,3,1,2,1,0,1,5,20.0,4,8,2,6,7,10,20,0,DF,25-29,Defender,France,Europe
291417,Ferland Mendy,FRA,Real Madrid,La Liga,2023,28.0,1995.0,19.1,15,10,12,2,1,11,14,78.6,3,12,2,10,13,28,26,1,DF,25-29,Defender,France,Europe
649023,Formose Mendy,SEN,Lorient,Ligue 1,2023,22.0,2001.0,14.0,33,19,24,8,1,20,33,60.6,13,23,12,11,20,53,59,1,DF,20-24,Defender,Senegal,Africa
111051,Nampalys Mendy,SEN,Lens,Ligue 1,2023,31.0,1992.0,11.7,29,18,10,13,6,16,20,80.0,4,11,4,7,14,43,14,1,MF,30-34,Midfielder,Senegal,Africa
548470,Teden Mengi,ENG,Luton Town,Premier League,2023,21.0,2002.0,27.4,54,22,33,20,1,19,30,63.3,11,39,27,12,57,111,140,1,DF,20-24,Defender,England,Europe
557613,Quentin Merlin,FRA,Marseille,Ligue 1,2023,21.0,2002.0,7.8,13,12,7,5,1,8,20,40.0,12,4,0,4,6,19,14,0,DF,20-24,Defender,France,Europe
449151,Junior Messias,BRA,Genoa,Serie A,2023,32.0,1991.0,11.7,26,20,19,5,2,8,19,42.1,11,9,1,8,5,31,22,0,"MF,DF",30-34,Midfielder,Brazil,South America
100986,Thomas Meunier,BEL,Dortmund,Bundesliga,2023,31.0,1991.0,6.5,5,1,3,2,0,3,13,23.1,10,8,2,6,4,9,22,0,DF,30-34,Defender,Belgium,Europe
186988,Sven Michel,GER,Augsburg,Bundesliga,2023,33.0,1990.0,6.5,7,5,2,1,4,2,7,28.6,5,1,0,1,0,7,4,0,"FW,MF",30-34,Forward,Germany,Europe
729814,Georges Mikautadze,GEO,Metz,Ligue 1,2023,22.0,2000.0,19.4,4,3,1,2,1,0,9,0.0,9,11,0,11,8,12,3,0,FW,20-24,Forward,Georgia,Asia
922769,Lewis Miley,ENG,Newcastle Utd,Premier League,2023,17.0,2006.0,13.4,33,21,6,20,7,15,32,46.9,17,20,3,17,8,41,18,2,MF,Under 20,Midfielder,England,Europe
401530,der Milito,BRA,Real Madrid,La Liga,2023,25.0,1998.0,5.5,7,3,4,3,0,6,9,66.7,3,4,3,1,4,11,19,1,DF,25-29,Defender,Brazil,South America
569366,Enzo Millot,FRA,Stuttgart,Bundesliga,2023,21.0,2002.0,24.9,40,22,9,21,10,18,39,46.2,21,24,2,22,16,56,7,1,"MF,FW",20-24,Midfielder,France,Europe
3333,James Milner,ENG,Brighton,Premier League,2023,37.0,1986.0,8.6,20,14,9,10,1,9,14,64.3,5,9,0,9,8,28,16,0,"DF,MF",35-39,Defender,England,Europe
165793,Takumi Minamino,JPN,Monaco,Ligue 1,2023,28.0,1995.0,23.5,34,17,10,13,11,16,54,29.6,38,29,1,28,11,45,8,0,MF,25-29,Midfielder,Japan,Asia
982393,Lucas Mincarelli,FRA,Montpellier,Ligue 1,2023,19.0,2004.0,10.9,29,16,19,6,4,17,34,50.0,17,17,4,13,8,37,27,0,"DF,MF",Under 20,Defender,France,Europe
571607,Fabio Miretti,ITA,Juventus,Serie A,2023,19.0,2003.0,12.3,18,14,6,8,4,10,26,38.5,16,10,1,9,7,25,6,0,MF,Under 20,Midfielder,Italy,Europe
650993,Filippo Missori,ITA,Sassuolo,Serie A,2023,19.0,2004.0,3.0,6,3,2,4,0,4,11,36.4,7,3,2,1,4,10,8,0,DF,Under 20,Defender,Italy,Europe
730893,Tyrick Mitchell,ENG,Crystal Palace,Premier League,2023,23.0,1999.0,35.6,105,60,75,21,9,43,60,71.7,17,63,10,53,26,131,104,0,"DF,MF",20-24,Defender,England,Europe
504849,Kaoru Mitoma,JPN,Brighton,Premier League,2023,26.0,1997.0,16.5,13,6,3,7,3,5,19,26.3,14,15,1,14,5,18,12,0,FW,25-29,Forward,Japan,Asia
55735,Henrikh Mkhitaryan,ARM,Inter,Serie A,2023,34.0,1989.0,30.9,62,34,18,35,9,24,49,49.0,25,23,4,19,29,91,43,0,MF,30-34,Midfielder,Armenia,Asia
538874,Terem Moffi,NGA,Nice,Ligue 1,2023,24.0,1999.0,21.7,7,4,0,5,2,3,12,25.0,9,14,1,13,3,10,15,0,FW,20-24,Forward,Nigeria,Africa
462348,Mostafa Mohamed,EGY,Nantes,Ligue 1,2023,25.0,1997.0,22.2,21,14,7,11,3,6,28,21.4,22,21,5,16,12,33,29,0,FW,25-29,Forward,Egypt,Africa
262939,Johan Mojica,COL,Osasuna,La Liga,2023,30.0,1992.0,22.7,30,22,11,15,4,16,25,64.0,9,15,2,13,21,51,40,2,DF,30-34,Defender,Colombia,South America
424042,Nahuel Molina,ARG,Atltico Madrid,La Liga,2023,25.0,1998.0,20.6,38,22,16,18,4,26,54,48.1,28,19,3,16,9,47,36,1,DF,25-29,Defender,Argentina,South America
222859,Florent Mollet,FRA,Nantes,Ligue 1,2023,31.0,1991.0,23.1,18,11,8,6,4,10,31,32.3,21,18,5,13,13,31,17,0,"MF,FW",30-34,Midfielder,France,Europe
550116,Ilario Monterisi,ITA,Frosinone,Serie A,2023,21.0,2001.0,16.3,23,13,14,7,2,12,26,46.2,14,22,18,4,8,31,63,0,DF,20-24,Defender,Italy,Europe
655006,Diego Moreira,POR,Lyon,Ligue 1,2023,18.0,2004.0,3.0,0,0,0,0,0,0,3,0.0,3,3,0,3,2,2,5,0,"FW,MF",Under 20,Forward,Portugal,Europe
617074,Ilaix Moriba,GUI,Getafe,La Liga,2023,20.0,2003.0,6.7,20,11,3,11,6,4,9,44.4,5,3,1,2,4,24,10,0,"MF,FW",20-24,Midfielder,Guinea,Africa
316934,Nikola Moro,CRO,Bologna,Serie A,2023,25.0,1998.0,9.3,21,16,8,12,1,8,15,53.3,7,14,1,13,7,28,10,0,MF,25-29,Midfielder,Croatia,Europe
246963,Carlton Morris,ENG,Luton Town,Premier League,2023,27.0,1995.0,31.8,15,8,4,6,5,9,15,60.0,6,24,5,19,1,16,53,0,"FW,MF",25-29,Forward,England,Europe
716276,Yerson Mosquera,COL,Villarreal,La Liga,2023,22.0,2001.0,13.7,27,13,18,7,2,12,15,80.0,3,12,2,10,17,44,65,0,DF,20-24,Defender,Colombia,South America
347253,Dany Mota,POR,Monza,Serie A,2023,25.0,1998.0,22.8,13,7,2,5,6,8,17,47.1,9,4,1,3,2,15,18,0,"FW,MF",25-29,Forward,Portugal,Europe
427161,Lebo Mothiba,RSA,Strasbourg,Ligue 1,2023,27.0,1996.0,6.9,5,2,1,4,0,3,4,75.0,1,6,1,5,0,5,11,0,FW,25-29,Forward,South Africa,Africa
467720,Youssoufa Moukoko,GER,Dortmund,Bundesliga,2023,18.0,2004.0,6.9,4,1,2,2,0,3,7,42.9,4,4,1,3,2,6,4,0,FW,Under 20,Forward,Germany,Europe
238639,Steve Mouni,BEN,Brest,Ligue 1,2023,28.0,1994.0,19.7,8,7,0,3,5,3,11,27.3,8,13,3,10,2,10,18,0,FW,25-29,Forward,Benin,Africa
348026,Nordi Mukiele,FRA,Paris S-G,Ligue 1,2023,25.0,1997.0,8.8,12,8,6,5,1,8,15,53.3,7,17,4,13,14,26,28,0,DF,25-29,Defender,France,Europe
457422,Samuele Mulattieri,ITA,Sassuolo,Serie A,2023,22.0,2000.0,5.1,1,1,0,0,1,1,2,50.0,1,7,2,5,1,2,2,0,"FW,MF",20-24,Forward,Italy,Europe
438315,Andreas Mller,GER,Darmstadt 98,Bundesliga,2023,23.0,2000.0,3.9,14,9,8,5,1,4,9,44.4,5,5,2,3,4,18,5,0,MF,20-24,Midfielder,Germany,Europe
58358,Thomas Mller,GER,Bayern Munich,Bundesliga,2023,33.0,1989.0,18.4,26,16,5,10,11,13,35,37.1,22,22,0,22,3,29,6,0,"MF,FW",30-34,Midfielder,Germany,Europe
451801,Abdul Mumin,GHA,Rayo Vallecano,La Liga,2023,25.0,1998.0,18.8,19,10,13,4,2,8,10,80.0,2,27,19,8,22,41,82,1,DF,25-29,Defender,Ghana,Africa
735571,Rodrigo Muniz,BRA,Fulham,Premier League,2023,22.0,2001.0,17.7,7,3,1,5,1,1,6,16.7,5,9,3,6,6,13,20,0,FW,20-24,Forward,Brazil,South America
119228,Luis Muriel,COL,Atalanta,Serie A,2023,32.0,1991.0,4.5,3,2,0,2,1,1,1,100.0,0,4,0,4,1,4,0,0,"FW,MF",30-34,Forward,Colombia,South America
1005649,Murillo,BRA,Nott'ham Forest,Premier League,2023,21.0,2002.0,31.0,50,31,36,13,1,19,33,57.6,14,41,24,17,37,87,188,0,DF,20-24,Defender,Brazil,South America
199527,Jacob Murphy,ENG,Newcastle Utd,Premier League,2023,28.0,1995.0,13.2,20,10,8,4,8,12,26,46.2,14,17,0,17,6,26,16,0,"FW,DF",25-29,Forward,England,Europe
503991,Yunus Musah,USA,Milan,Serie A,2023,20.0,2002.0,16.4,25,14,15,6,4,8,15,53.3,7,18,4,14,10,35,16,1,"MF,FW",20-24,Midfielder,United States,North America
580195,Jamal Musiala,GER,Bayern Munich,Bundesliga,2023,20.0,2003.0,19.5,40,25,9,21,10,14,36,38.9,22,25,1,24,16,56,5,0,"MF,FW",20-24,Midfielder,Germany,Europe
1011200,Junior Mwanga,FRA,Strasbourg,Ligue 1,2023,20.0,2003.0,16.1,40,20,23,12,5,12,24,50.0,12,20,5,15,18,58,19,0,"MF,FW",20-24,Midfielder,France,Europe
127573,Phillipp Mwene,AUT,Mainz 05,Bundesliga,2023,29.0,1994.0,22.2,34,15,15,16,3,16,33,48.5,17,27,3,24,17,51,47,0,DF,25-29,Defender,Austria,Europe
404842,Vitaliy Mykolenko,UKR,Everton,Premier League,2023,24.0,1999.0,27.4,69,38,46,21,2,41,66,62.1,25,36,11,25,36,105,92,0,DF,20-24,Defender,Ukraine,Europe
342209,Kvin N'Doram,FRA,Metz,Ligue 1,2023,27.0,1996.0,17.8,31,22,20,9,2,17,38,44.7,21,17,8,9,27,58,38,0,MF,25-29,Midfielder,France,Europe
405397,Keito Nakamura,JPN,Reims,Ligue 1,2023,23.0,2000.0,15.3,28,11,9,10,9,17,37,45.9,20,15,2,13,6,34,7,0,"FW,MF",20-24,Forward,Japan,Asia
315063,Nahitan Nndez,URU,Cagliari,Serie A,2023,27.0,1995.0,26.0,59,40,27,23,9,27,64,42.2,37,25,2,23,19,78,32,0,"MF,DF",25-29,Midfielder,Uruguay,South America
735568,Natan,BRA,Napoli,Serie A,2023,22.0,2001.0,10.6,14,10,10,3,1,5,10,50.0,5,12,9,3,8,22,32,0,DF,20-24,Defender,Brazil,South America
623570,Iliman Ndiaye,SEN,Marseille,Ligue 1,2023,23.0,2000.0,18.0,21,18,5,11,5,11,29,37.9,18,14,2,12,6,27,6,0,"FW,MF",20-24,Forward,Senegal,Africa
365108,Dan Ndoye,SUI,Bologna,Serie A,2023,22.0,2000.0,19.7,30,15,17,11,2,17,39,43.6,22,20,1,19,10,40,14,0,"FW,MF",20-24,Forward,Switzerland,Europe
919620,Joseph Nduquidi,FRA,Metz,Ligue 1,2023,18.0,2004.0,8.3,11,4,6,3,2,1,9,11.1,8,11,3,8,11,22,15,1,"MF,DF",Under 20,Midfielder,France,Europe
122840,Loc Nego,HUN,Le Havre,Ligue 1,2023,32.0,1991.0,17.3,37,26,21,12,4,18,30,60.0,12,12,2,10,16,53,17,0,"DF,MF",30-34,Defender,Hungary,Europe
487465,Pedro Neto,POR,Wolves,Premier League,2023,23.0,2000.0,16.8,7,3,3,2,2,5,15,33.3,10,5,1,4,5,12,2,0,"FW,MF",20-24,Forward,Portugal,Europe
524285,Luca Netz,GER,Gladbach,Bundesliga,2023,20.0,2003.0,24.7,38,22,19,16,3,23,43,53.5,20,36,10,26,22,60,76,1,DF,20-24,Defender,Germany,Europe
278332,Florian Neuhaus,GER,Gladbach,Bundesliga,2023,26.0,1997.0,13.6,15,12,7,8,0,8,26,30.8,18,8,6,2,14,29,8,0,MF,25-29,Midfielder,Germany,Europe
358032,Cyril Ngonge,BEL,Hellas Verona,Serie A,2023,23.0,2000.0,15.9,14,9,5,3,6,5,14,35.7,9,7,1,6,4,18,10,0,"FW,MF",20-24,Forward,Belgium,Europe
354666,Shamar Nicholson,JAM,Clermont Foot,Ligue 1,2023,26.0,1997.0,16.5,6,2,0,4,2,1,4,25.0,3,6,2,4,0,6,15,0,FW,25-29,Forward,Jamaica,North America
596153,Justin Njinmah,GER,Werder Bremen,Bundesliga,2023,22.0,2000.0,11.3,5,1,2,2,1,3,9,33.3,6,9,1,8,2,7,6,0,FW,20-24,Forward,Germany,Europe
340324,Eddie Nketiah,ENG,Arsenal,Premier League,2023,24.0,1999.0,12.0,12,7,2,6,4,2,7,28.6,5,11,0,11,4,16,4,0,FW,20-24,Forward,England,Europe
591193,Niels Nkounkou,FRA,Eint Frankfurt,Bundesliga,2023,22.0,2000.0,14.5,54,30,34,17,3,29,64,45.3,35,30,2,28,16,70,30,0,"DF,MF",20-24,Defender,France,Europe
344381,Christopher Nkunku,FRA,Chelsea,Premier League,2023,25.0,1997.0,4.9,5,4,0,4,1,1,2,50.0,1,4,1,3,2,7,4,0,"FW,MF",25-29,Forward,France,Europe
406640,Felix Nmecha,GER,Dortmund,Bundesliga,2023,22.0,2000.0,11.3,19,13,7,8,4,11,22,50.0,11,18,5,13,11,30,19,0,MF,20-24,Midfielder,Germany,Europe
324811,Arnaud Nordin,FRA,Montpellier,Ligue 1,2023,25.0,1998.0,13.8,12,6,3,5,4,6,16,37.5,10,11,0,11,2,14,10,0,"FW,MF",25-29,Forward,France,Europe
457736,Tijjani Noslin,NED,Hellas Verona,Serie A,2023,24.0,1999.0,14.9,18,8,5,7,6,6,16,37.5,10,17,2,15,2,20,14,0,"FW,MF",20-24,Forward,Netherlands,Europe
560483,Randy Nteka,ANG,Rayo Vallecano,La Liga,2023,25.0,1997.0,6.4,11,4,1,6,4,4,10,40.0,6,6,1,5,2,13,11,1,"FW,MF",25-29,Forward,Angola,Africa
955070,Ernest Nuamah,GHA,Lyon,Ligue 1,2023,19.0,2003.0,20.4,28,14,18,6,4,12,38,31.6,26,15,1,14,8,36,9,0,"FW,MF",Under 20,Forward,Ghana,Africa
546543,Darwin Nez,URU,Liverpool,Premier League,2023,24.0,1999.0,22.7,22,12,2,10,10,11,23,47.8,12,18,6,12,3,25,9,0,FW,20-24,Forward,Uruguay,South America
349433,Fabian Nrnberger,BUL,Darmstadt 98,Bundesliga,2023,24.0,1999.0,16.8,29,22,22,6,1,22,41,53.7,19,11,1,10,17,46,26,0,"DF,MF",20-24,Defender,Bulgaria,Europe
148367,Christian Nrgaard,DEN,Brentford,Premier League,2023,29.0,1994.0,27.8,81,50,42,31,8,32,87,36.8,55,48,6,42,54,135,50,0,MF,25-29,Midfielder,Denmark,Europe
711544,Jake O'Brien,IRL,Lyon,Ligue 1,2023,22.0,2001.0,26.3,22,16,16,5,1,14,20,70.0,6,23,18,5,12,34,98,1,DF,20-24,Defender,Republic of Ireland,Europe
401320,Dara O'Shea,IRL,Burnley,Premier League,2023,24.0,1999.0,32.1,39,20,22,14,3,11,26,42.3,15,41,30,11,35,74,158,2,DF,20-24,Defender,Republic of Ireland,Europe
568333,Adam Obert,SVK,Cagliari,Serie A,2023,20.0,2002.0,10.5,17,9,8,8,1,8,17,47.1,9,13,7,6,21,38,41,1,DF,20-24,Defender,Slovakia,Europe
598765,Brian Ocampo,URU,Cdiz,La Liga,2023,24.0,1999.0,2.8,4,3,1,3,0,2,5,40.0,3,4,0,4,3,7,0,0,"MF,FW",20-24,Midfielder,Uruguay,South America
189441,Lucas Ocampos,ARG,Sevilla,La Liga,2023,29.0,1994.0,31.9,66,47,22,27,17,29,58,50.0,29,34,1,33,21,87,29,0,"FW,MF",25-29,Forward,Argentina,South America
345590,Jens Odgaard,DEN,Bologna,Serie A,2023,24.0,1999.0,4.8,4,4,1,1,2,1,3,33.3,2,9,0,9,1,5,3,0,"FW,MF",20-24,Forward,Denmark,Europe
743498,Wilson Odobert,FRA,Burnley,Premier League,2023,18.0,2004.0,23.3,17,13,8,5,4,6,22,27.3,16,26,2,24,6,23,14,0,"MF,FW",Under 20,Midfielder,France,Europe
392591,Chiedozie Ogbene,IRL,Luton Town,Premier League,2023,26.0,1997.0,22.2,17,10,10,7,0,12,22,54.5,10,14,3,11,7,24,34,2,"MF,DF",25-29,Midfielder,Republic of Ireland,Europe
91473,Florent Ogier,FRA,Clermont Foot,Ligue 1,2023,34.0,1989.0,10.5,19,9,13,6,0,11,18,61.1,7,25,19,6,9,28,35,3,DF,30-34,Defender,France,Europe
346890,Noah Okafor,SUI,Milan,Serie A,2023,23.0,2000.0,9.9,6,4,1,4,1,3,10,30.0,7,8,1,7,0,6,10,0,"FW,MF",20-24,Forward,Switzerland,Europe
461833,Caleb Okoli,ITA,Frosinone,Serie A,2023,22.0,2001.0,32.4,56,34,33,22,1,29,44,65.9,15,48,32,16,29,85,156,4,DF,20-24,Defender,Italy,Europe
453376,Joseph Okumu,KEN,Reims,Ligue 1,2023,26.0,1997.0,19.4,44,28,28,14,2,24,38,63.2,14,27,19,8,35,79,112,2,DF,25-29,Defender,Kenya,Africa
507344,Becir Omeragic,SUI,Montpellier,Ligue 1,2023,21.0,2002.0,25.7,48,29,31,13,4,20,33,60.6,13,51,29,22,27,75,65,0,"DF,MF",20-24,Defender,Switzerland,Europe
485706,Amadou Onana,BEL,Everton,Premier League,2023,21.0,2001.0,23.2,71,38,32,31,8,21,42,50.0,21,25,6,19,21,92,31,0,MF,20-24,Midfielder,Belgium,Europe
656441,Jean Onana,CMR,Marseille,Ligue 1,2023,23.0,2000.0,6.3,23,14,6,14,3,13,25,52.0,12,10,2,8,11,34,11,1,MF,20-24,Midfielder,Cameroon,Africa
119234,Karim Onisiwo,AUT,Mainz 05,Bundesliga,2023,31.0,1992.0,16.6,17,8,4,6,7,6,11,54.5,5,18,4,14,2,19,7,0,"FW,MF",30-34,Forward,Austria,Europe
305274,Fred Onyedinma,ENG,Luton Town,Premier League,2023,26.0,1996.0,4.5,10,6,7,3,0,5,12,41.7,7,3,0,3,1,11,13,0,"DF,MF",25-29,Defender,England,Europe
421637,Frank Onyeka,NGA,Brentford,Premier League,2023,25.0,1998.0,12.9,37,24,9,23,5,16,29,55.2,13,15,7,8,23,60,17,0,MF,25-29,Midfielder,Nigeria,Africa
368887,Los Openda,BEL,RB Leipzig,Bundesliga,2023,23.0,2000.0,30.0,3,3,0,1,2,0,6,0.0,6,19,3,16,5,8,14,0,FW,20-24,Forward,Belgium,Europe
1018259,Gift Orban,NGA,Lyon,Ligue 1,2023,21.0,2002.0,5.3,4,3,0,1,3,1,4,25.0,3,2,0,2,1,5,2,1,FW,20-24,Forward,Nigeria,Africa
118850,Ivan Ordets,UKR,Bochum,Bundesliga,2023,31.0,1992.0,20.9,19,14,11,6,2,10,17,58.8,7,41,29,12,31,50,130,0,DF,30-34,Defender,Ukraine,Europe
613393,Gaetano Oristanio,ITA,Cagliari,Serie A,2023,20.0,2002.0,12.3,20,10,5,14,1,5,17,29.4,12,11,0,11,9,29,8,0,"FW,MF",20-24,Forward,Italy,Europe
364409,Gabriel Osho,NGA,Luton Town,Premier League,2023,24.0,1998.0,20.5,41,22,21,19,1,16,27,59.3,11,37,20,17,31,72,92,0,DF,20-24,Defender,Nigeria,Africa
443331,Patrick Osterhage,GER,Bochum,Bundesliga,2023,23.0,2000.0,20.7,38,26,14,23,1,17,36,47.2,19,36,9,27,27,65,32,1,MF,20-24,Midfielder,Germany,Europe
609556,William Osula,DEN,Sheffield Utd,Premier League,2023,19.0,2003.0,8.7,2,2,1,0,1,1,2,50.0,1,3,1,2,2,4,9,0,FW,Under 20,Forward,Denmark,Europe
823231,Dango Ouattara,BFA,Bournemouth,Premier League,2023,21.0,2002.0,13.7,45,27,22,11,12,19,34,55.9,15,18,3,15,22,67,35,0,"FW,DF",20-24,Forward,Burkina Faso,Africa
947360,Kassoum Ouattara,FRA,Monaco,Ligue 1,2023,18.0,2004.0,7.1,17,12,8,5,4,9,20,45.0,11,11,0,11,13,30,20,0,"DF,FW",Under 20,Defender,France,Europe
400485,Adam Ounas,ALG,Lille,Ligue 1,2023,26.0,1996.0,4.6,4,3,2,2,0,2,7,28.6,5,2,0,2,6,10,1,0,FW,25-29,Forward,Algeria,Africa
804812,Anthony Oyono,GAB,Frosinone,Serie A,2023,22.0,2001.0,13.3,37,26,21,14,2,23,34,67.6,11,17,3,14,9,46,32,0,DF,20-24,Defender,Gabon,Africa
244940,Salih zcan,TUR,Dortmund,Bundesliga,2023,25.0,1998.0,13.2,20,12,11,8,1,10,18,55.6,8,28,3,25,17,37,18,1,MF,25-29,Midfielder,Turkey,Asia
615350,Cenk zkacar,TUR,Valencia,La Liga,2023,22.0,2000.0,17.8,26,15,22,4,0,15,23,65.2,8,18,7,11,18,44,84,1,DF,20-24,Defender,Turkey,Asia
661171,Willian Pacho,ECU,Eint Frankfurt,Bundesliga,2023,21.0,2001.0,33.0,62,37,38,23,1,31,53,58.5,22,51,22,29,47,109,152,2,DF,20-24,Defender,Ecuador,South America
181547,Gonalo Pacincia,POR,Bochum,Bundesliga,2023,28.0,1994.0,7.2,8,4,2,2,4,3,6,50.0,3,5,0,5,0,8,7,0,"FW,MF",25-29,Forward,Portugal,Europe
810411,Pablo Pagis,FRA,Lorient,Ligue 1,2023,20.0,2002.0,1.8,10,6,5,4,1,6,10,60.0,4,2,0,2,3,13,1,0,MF,20-24,Midfielder,France,Europe
401578,Exequiel Palacios,ARG,Leverkusen,Bundesliga,2023,24.0,1998.0,20.3,60,34,28,26,6,26,53,49.1,27,24,0,24,29,89,20,2,MF,20-24,Midfielder,Argentina,South America
257455,Joo Palhinha,POR,Fulham,Premier League,2023,28.0,1995.0,30.0,152,75,80,60,12,103,152,67.8,49,57,9,48,46,198,58,0,MF,25-29,Midfielder,Portugal,Europe
139279,Nicolas Pallois,FRA,Nantes,Ligue 1,2023,35.0,1987.0,17.7,34,19,21,11,2,19,35,54.3,16,37,26,11,26,60,111,0,DF,35-39,Defender,France,Europe
1064871,Joaqun Panichelli,ARG,Alavs,La Liga,2023,20.0,2002.0,2.5,3,3,1,1,1,1,2,50.0,1,1,0,1,1,4,4,0,"FW,MF",20-24,Forward,Argentina,South America
34322,Sokratis Papastathopoulos,GRE,Betis,La Liga,2023,35.0,1988.0,12.6,21,14,16,5,0,13,17,76.5,4,15,9,6,6,27,60,0,DF,35-39,Defender,Greece,Europe
444523,Lucas Paquet,BRA,West Ham,Premier League,2023,25.0,1997.0,29.1,71,48,38,26,7,25,52,48.1,27,28,1,27,21,92,28,2,"FW,MF",25-29,Forward,Brazil,South America
711517,Kevin Paredes,USA,Wolfsburg,Bundesliga,2023,20.0,2003.0,15.9,42,21,22,13,7,20,34,58.8,14,27,2,25,23,65,26,0,"FW,MF",20-24,Forward,United States,North America
166237,Leandro Paredes,ARG,Roma,Serie A,2023,29.0,1994.0,29.3,57,36,30,22,5,33,77,42.9,44,26,7,19,29,86,43,1,MF,25-29,Midfielder,Argentina,South America
547985,Fabiano Parisi,ITA,Fiorentina,Serie A,2023,22.0,2000.0,16.2,30,15,11,12,7,15,26,57.7,11,21,5,16,17,47,26,0,DF,20-24,Defender,Italy,Europe
230784,Thomas Partey,GHA,Arsenal,Premier League,2023,30.0,1993.0,8.8,14,11,9,4,1,5,10,50.0,5,9,3,6,11,25,9,0,"MF,DF",30-34,Midfielder,Ghana,Africa
274461,Felix Passlack,GER,Bochum,Bundesliga,2023,25.0,1998.0,10.7,21,14,9,10,2,14,24,58.3,10,13,2,11,10,31,21,0,DF,25-29,Defender,Germany,Europe
328658,Kristoffer Ajer,NOR,Brentford,Premier League,2023,25.0,1998.0,20.4,38,21,25,9,4,23,36,63.9,13,26,11,15,25,63,79,1,DF,25-29,Defender,Norway,Europe
355627,Sergio Akieme,ESP,Almera,La Liga,2023,25.0,1997.0,18.6,27,15,18,7,2,13,16,81.3,3,14,4,10,10,37,34,0,DF,25-29,Defender,Spain,Europe
128220,Luis Alberto,ESP,Lazio,Serie A,2023,30.0,1992.0,25.7,35,20,16,12,7,15,53,28.3,38,34,4,30,7,42,13,0,MF,30-34,Midfielder,Spain,Europe
247250,Rubn Alcaraz,ESP,Cdiz,La Liga,2023,32.0,1991.0,34.8,97,59,39,52,6,50,121,41.3,71,60,14,46,33,130,55,2,MF,30-34,Midfielder,Spain,Europe
281755,Ivn Alejo,ESP,Cdiz,La Liga,2023,28.0,1995.0,18.8,40,23,23,11,6,17,57,29.8,40,20,0,20,7,47,17,0,MF,25-29,Midfielder,Spain,Europe
284854,Carles Ale,ESP,Getafe,La Liga,2023,25.0,1998.0,11.3,24,8,7,14,3,10,24,41.7,14,14,3,11,4,28,13,0,MF,25-29,Midfielder,Spain,Europe
466801,Sergi Altimira,ESP,Betis,La Liga,2023,21.0,2001.0,6.3,15,8,8,6,1,11,23,47.8,12,12,1,11,9,24,10,0,MF,20-24,Midfielder,Spain,Europe
892929,Hugo lvarez,ESP,Celta Vigo,La Liga,2023,20.0,2003.0,8.5,14,9,8,3,3,9,20,45.0,11,4,1,3,5,19,9,0,"MF,DF",20-24,Midfielder,Spain,Europe
255488,Yeray lvarez,ESP,Athletic Club,La Liga,2023,28.0,1995.0,12.8,18,9,15,3,0,12,19,63.2,7,8,5,3,11,29,34,1,DF,25-29,Defender,Spain,Europe
277179,Angelio,ESP,Roma,Serie A,2023,26.0,1997.0,12.7,21,11,12,6,3,11,19,57.9,8,11,5,6,12,33,37,1,DF,25-29,Defender,Spain,Europe
488626,Jess Areso,ESP,Osasuna,La Liga,2023,24.0,1999.0,29.6,45,24,25,13,7,31,38,81.6,7,36,15,21,18,63,58,0,DF,20-24,Defender,Spain,Europe
537762,Sergio Arribas,ESP,Almera,La Liga,2023,21.0,2001.0,22.7,34,17,16,17,1,14,31,45.2,17,20,1,19,16,50,8,1,"MF,FW",20-24,Midfielder,Spain,Europe
72047,Iago Aspas,ESP,Celta Vigo,La Liga,2023,35.0,1987.0,30.1,11,6,4,6,1,1,15,6.7,14,23,3,20,10,21,8,0,FW,35-39,Forward,Spain,Europe
711969,Lorenz Assignon,TOG,Burnley,Premier League,2023,23.0,2000.0,13.7,35,17,18,13,4,14,27,51.9,13,22,7,15,19,54,43,1,DF,20-24,Defender,Togo,Africa
57500,Csar Azpilicueta,ESP,Atltico Madrid,La Liga,2023,33.0,1989.0,15.8,25,14,15,9,1,12,19,63.2,7,25,6,19,16,41,46,0,DF,30-34,Defender,Spain,Europe
636688,Alejandro Balde,ESP,Barcelona,La Liga,2023,19.0,2003.0,15.3,20,11,11,6,3,7,11,63.6,4,14,1,13,5,25,21,1,DF,Under 20,Defender,Spain,Europe
298575,Kike Barja,ESP,Osasuna,La Liga,2023,26.0,1997.0,3.4,6,2,2,2,2,3,8,37.5,5,2,1,1,2,8,2,0,"FW,MF",25-29,Forward,Spain,Europe
616369,Ander Barrenetxea,ESP,Real Sociedad,La Liga,2023,21.0,2001.0,15.9,32,21,7,16,9,10,26,38.5,16,18,1,17,6,38,5,0,"FW,MF",20-24,Forward,Spain,Europe
775605,Pablo Barrios,ESP,Atltico Madrid,La Liga,2023,20.0,2003.0,17.3,45,25,15,29,1,19,40,47.5,21,20,3,17,28,73,24,2,MF,20-24,Midfielder,Spain,Europe
237164,Ihlas Bebou,TOG,Hoffenheim,Bundesliga,2023,29.0,1994.0,18.2,22,12,10,8,4,8,16,50.0,8,13,2,11,14,36,15,0,"FW,DF",25-29,Forward,Togo,Africa
423444,Fran Beltrn,ESP,Celta Vigo,La Liga,2023,24.0,1999.0,27.0,56,32,22,23,11,24,63,38.1,39,28,2,26,18,74,34,0,MF,20-24,Midfielder,Spain,Europe
61812,Yuri Berchiche,ESP,Athletic Club,La Liga,2023,33.0,1990.0,21.4,33,25,13,14,6,19,33,57.6,14,28,9,19,20,53,62,0,DF,30-34,Defender,Spain,Europe
338425,lex Berenguer,ESP,Athletic Club,La Liga,2023,28.0,1995.0,17.7,23,14,9,9,5,7,24,29.2,17,23,0,23,5,28,13,0,FW,25-29,Forward,Spain,Europe
144143,Bartosz Bereszyski,POL,Empoli,Serie A,2023,31.0,1992.0,19.6,41,25,25,13,3,24,40,60.0,16,22,10,12,21,62,52,0,DF,30-34,Defender,Poland,Europe
333014,Sander Berge,NOR,Burnley,Premier League,2023,25.0,1998.0,33.4,76,46,35,36,5,34,58,58.6,24,49,20,29,23,99,60,2,MF,25-29,Midfielder,Norway,Europe
495621,Antonio Blanco,ESP,Alavs,La Liga,2023,23.0,2000.0,27.0,61,36,29,27,5,31,86,36.0,55,25,2,23,35,96,30,0,MF,20-24,Midfielder,Spain,Europe
661207,Oscar Bobb,NOR,Manchester City,Premier League,2023,20.0,2003.0,3.4,7,3,1,2,4,2,4,50.0,2,4,0,4,5,12,1,0,"FW,MF",20-24,Forward,Norway,Europe
624258,Conor Bradley,NIR,Liverpool,Premier League,2023,20.0,2003.0,8.4,33,25,14,12,7,24,38,63.2,14,17,1,16,10,43,14,0,DF,20-24,Defender,Northern Ireland,Europe
61253,Jos Callejn,ESP,Granada,La Liga,2023,36.0,1987.0,8.9,13,6,10,3,0,8,22,36.4,14,7,1,6,5,18,10,0,"MF,FW",35-39,Midfielder,Spain,Europe
505674,Sergio Camello,ESP,Rayo Vallecano,La Liga,2023,22.0,2001.0,18.5,16,5,3,10,3,6,15,40.0,9,10,2,8,3,19,15,0,FW,20-24,Forward,Spain,Europe
251845,Sergi Cans,ESP,Valencia,La Liga,2023,26.0,1997.0,13.7,23,13,7,11,5,10,24,41.7,14,14,2,12,11,34,9,0,"MF,FW",25-29,Midfielder,Spain,Europe
678406,Sergi Cardona,ESP,Las Palmas,La Liga,2023,24.0,1999.0,31.3,90,55,52,29,9,55,96,57.3,41,45,7,38,46,136,102,0,DF,20-24,Defender,Spain,Europe
195171,Samu Castillejo,ESP,Sassuolo,Serie A,2023,28.0,1995.0,6.0,12,10,5,5,2,7,19,36.8,12,16,1,15,1,13,3,0,"FW,MF",25-29,Forward,Spain,Europe
319745,Dani Ceballos,ESP,Real Madrid,La Liga,2023,26.0,1996.0,6.6,10,5,4,5,1,5,14,35.7,9,9,2,7,0,10,4,1,"MF,FW",25-29,Midfielder,Spain,Europe
423443,lex Centelles,ESP,Almera,La Liga,2023,25.0,1997.0,10.9,11,6,9,2,0,8,18,44.4,10,5,2,3,18,29,29,0,DF,25-29,Defender,Spain,Europe
596122,Pep Chavarra,ESP,Rayo Vallecano,La Liga,2023,25.0,1998.0,13.0,23,18,15,6,2,11,17,64.7,6,15,3,12,6,29,29,1,"DF,MF",25-29,Defender,Spain,Europe
380598,Santi Comesaa,ESP,Villarreal,La Liga,2023,26.0,1996.0,18.4,44,26,15,21,8,19,38,50.0,19,33,9,24,22,66,27,1,MF,25-29,Midfielder,Spain,Europe
65318,Jaume Costa,ESP,Mallorca,La Liga,2023,35.0,1988.0,18.7,38,22,23,10,5,18,29,62.1,11,14,4,10,16,54,35,0,DF,35-39,Defender,Spain,Europe
157672,Vladimr Coufal,CZE,West Ham,Premier League,2023,30.0,1992.0,34.8,64,41,50,12,2,38,75,50.7,37,49,15,34,43,107,97,0,DF,30-34,Defender,Czech Republic,Europe
494880,Jorge Cuenca,ESP,Villarreal,La Liga,2023,23.0,1999.0,21.8,42,29,26,10,6,19,30,63.3,11,26,15,11,21,63,114,0,DF,20-24,Defender,Spain,Europe
142021,Sergi Darder,ESP,Mallorca,La Liga,2023,29.0,1993.0,24.0,39,26,13,21,5,12,31,38.7,19,20,4,16,16,55,16,0,MF,25-29,Midfielder,Spain,Europe
248732,Pawe Dawidowicz,POL,Hellas Verona,Serie A,2023,28.0,1995.0,23.8,53,30,33,18,2,17,29,58.6,12,17,9,8,24,77,114,1,DF,25-29,Defender,Poland,Europe
1061282,Assane Diao,ESP,Betis,La Liga,2023,17.0,2005.0,11.6,20,12,5,9,6,6,17,35.3,11,22,4,18,7,27,7,0,FW,Under 20,Forward,Spain,Europe
221150,Djen,TOG,Getafe,La Liga,2023,31.0,1991.0,27.6,34,19,18,13,3,15,26,57.7,11,31,15,16,23,57,70,0,"DF,MF",30-34,Defender,Togo,Africa
177046,Rubn Duarte,ESP,Alavs,La Liga,2023,27.0,1995.0,20.9,39,20,21,16,2,21,31,67.7,10,21,6,15,23,62,69,0,DF,25-29,Defender,Spain,Europe
573775,Hugo Duro,ESP,Valencia,La Liga,2023,23.0,1999.0,33.1,16,8,5,8,3,9,29,31.0,20,24,5,19,5,21,27,0,FW,20-24,Forward,Spain,Europe
476836,Aron Dnnum,NOR,Toulouse,Ligue 1,2023,25.0,1998.0,17.7,16,10,3,8,5,7,22,31.8,15,13,0,13,8,24,16,1,"FW,MF",25-29,Forward,Norway,Europe
229804,Aritz Elustondo,ESP,Real Sociedad,La Liga,2023,29.0,1994.0,9.0,11,7,5,4,2,6,14,42.9,8,12,10,2,7,18,26,0,DF,25-29,Defender,Spain,Europe
252667,Fali,ESP,Cdiz,La Liga,2023,29.0,1993.0,28.3,41,26,29,11,1,21,36,58.3,15,38,24,14,27,68,120,0,DF,25-29,Defender,Spain,Europe
466810,Ansu Fati,ESP,Brighton,Premier League,2023,20.0,2002.0,5.8,5,3,1,2,2,1,11,9.1,10,8,0,8,3,8,3,0,"MF,FW",20-24,Midfielder,Spain,Europe
89733,lex Fernndez,ESP,Cdiz,La Liga,2023,30.0,1992.0,14.3,19,9,10,9,0,11,22,50.0,11,17,5,12,15,34,30,0,MF,30-34,Midfielder,Spain,Europe
216464,Carlos Fernndez,ESP,Real Sociedad,La Liga,2023,27.0,1996.0,4.5,11,7,3,6,2,0,2,0.0,2,4,0,4,0,11,5,0,FW,25-29,Forward,Spain,Europe
331496,Valery Fernndez,ESP,Girona,La Liga,2023,23.0,1999.0,5.6,11,9,4,7,0,6,8,75.0,2,6,1,5,1,12,4,0,"MF,FW",20-24,Midfielder,Spain,Europe
357885,Pablo Fornals,ESP,West Ham,Premier League,2023,27.0,1996.0,4.7,10,6,4,3,3,5,16,31.3,11,8,1,7,6,16,7,0,"MF,FW",25-29,Midfielder,Spain,Europe
455181,Jorge de Frutos,ESP,Rayo Vallecano,La Liga,2023,26.0,1997.0,17.2,19,8,5,8,6,7,22,31.8,15,12,0,12,7,26,18,0,"FW,MF",25-29,Forward,Spain,Europe
126751,Iigo Ruiz de Galarreta,ESP,Athletic Club,La Liga,2023,29.0,1993.0,23.2,49,31,15,26,8,24,49,49.0,25,18,5,13,12,61,17,0,MF,25-29,Midfielder,Spain,Europe
261504,Aleix Garca,ESP,Girona,La Liga,2023,26.0,1997.0,35.5,49,28,17,26,6,28,54,51.9,26,45,17,28,36,85,53,3,MF,25-29,Midfielder,Spain,Europe
1064403,lvaro Garca,ESP,Rayo Vallecano,La Liga,2023,30.0,1992.0,27.5,34,25,15,10,9,7,34,20.6,27,35,0,35,36,70,33,0,"FW,MF",30-34,Forward,Spain,Europe
298589,David Garca,ESP,Osasuna,La Liga,2023,29.0,1994.0,25.9,29,18,19,9,1,16,26,61.5,10,40,19,21,18,47,115,2,DF,25-29,Defender,Spain,Europe
361238,Rubn Garca,ESP,Osasuna,La Liga,2023,30.0,1993.0,17.2,32,18,8,17,7,13,33,39.4,20,23,3,20,12,44,23,0,"FW,MF",30-34,Forward,Spain,Europe
197122,Unai Garca,ESP,Osasuna,La Liga,2023,31.0,1992.0,6.2,12,9,9,2,1,5,10,50.0,5,7,1,6,8,20,18,0,DF,30-34,Defender,Spain,Europe
646740,Gavi,ESP,Barcelona,La Liga,2023,18.0,2004.0,10.5,39,21,20,14,5,18,36,50.0,18,19,3,16,8,47,16,1,"MF,FW",Under 20,Midfielder,Spain,Europe
537382,Bryan Gil,ESP,Tottenham,Premier League,2023,22.0,2001.0,2.3,1,0,0,0,1,1,4,25.0,3,3,0,3,3,4,4,0,"FW,MF",20-24,Forward,Spain,Europe
175449,Moi Gmez,ESP,Osasuna,La Liga,2023,29.0,1994.0,22.3,30,19,7,19,4,9,24,37.5,15,15,1,14,11,41,22,0,"MF,FW",25-29,Midfielder,Spain,Europe
834752,Unai Gmez,ESP,Athletic Club,La Liga,2023,20.0,2003.0,9.7,12,10,2,6,4,5,10,50.0,5,13,2,11,2,14,9,0,MF,20-24,Midfielder,Spain,Europe
289255,Andoni Gorosabel,ESP,Alavs,La Liga,2023,26.0,1996.0,31.7,62,42,40,17,5,38,75,50.7,37,24,8,16,28,90,69,0,DF,25-29,Defender,Spain,Europe
256429,Sergi Guardiola,ESP,Cdiz,La Liga,2023,32.0,1991.0,5.5,10,7,2,6,2,4,9,44.4,5,10,0,10,0,10,4,0,"FW,MF",30-34,Forward,Spain,Europe
74294,Nemanja Gudelj,SRB,Sevilla,La Liga,2023,31.0,1991.0,19.4,31,24,18,10,3,17,31,54.8,14,17,9,8,27,58,56,0,"DF,MF",30-34,Defender,Serbia,Europe
465967,Ander Guevara,ESP,Alavs,La Liga,2023,26.0,1997.0,32.6,59,32,28,25,6,31,64,48.4,33,34,12,22,13,72,46,1,MF,25-29,Midfielder,Spain,Europe
495629,Hugo Guillamn,ESP,Valencia,La Liga,2023,23.0,2000.0,14.6,24,15,7,14,3,11,17,64.7,6,8,3,5,12,36,25,2,MF,20-24,Midfielder,Spain,Europe
268670,Gerard Gumbau,ESP,Granada,La Liga,2023,28.0,1994.0,29.7,55,34,21,30,4,23,62,37.1,39,24,5,19,25,80,30,2,MF,25-29,Midfielder,Spain,Europe
289257,Jon Guridi,ESP,Alavs,La Liga,2023,28.0,1995.0,29.8,42,24,10,27,5,12,45,26.7,33,23,3,20,22,64,22,0,MF,25-29,Midfielder,Spain,Europe
340205,Gorka Guruzeta,ESP,Athletic Club,La Liga,2023,26.0,1996.0,24.6,34,23,6,25,3,9,30,30.0,21,36,2,34,17,51,23,0,FW,25-29,Forward,Spain,Europe
418560,Erling Haaland,NOR,Manchester City,Premier League,2023,23.0,2000.0,28.4,6,3,0,3,3,2,3,66.7,1,11,1,10,2,8,16,0,FW,20-24,Forward,Norway,Europe
422466,Javi Hernndez,ESP,Cdiz,La Liga,2023,25.0,1998.0,27.9,43,24,26,12,5,25,46,54.3,21,34,9,25,19,62,72,1,DF,25-29,Defender,Spain,Europe
99343,Ander Herrera,ESP,Athletic Club,La Liga,2023,33.0,1989.0,11.4,44,32,11,26,7,20,36,55.6,16,16,6,10,15,59,18,1,MF,30-34,Midfielder,Spain,Europe
237617,Cristian Herrera,ESP,Las Palmas,La Liga,2023,32.0,1991.0,1.8,1,1,0,1,0,1,2,50.0,1,1,0,1,0,1,2,0,"FW,MF",30-34,Forward,Spain,Europe
785353,Pablo Ibez,ESP,Osasuna,La Liga,2023,24.0,1998.0,12.8,18,9,5,7,6,5,21,23.8,16,26,3,23,9,27,17,0,MF,20-24,Midfielder,Spain,Europe
470794,Ivan Ili,SRB,Torino,Serie A,2023,22.0,2001.0,23.3,22,8,9,10,3,13,27,48.1,14,20,7,13,20,42,31,0,MF,20-24,Midfielder,Serbia,Europe
85288,Isco,ESP,Betis,La Liga,2023,31.0,1992.0,25.8,41,27,15,21,5,14,38,36.8,24,19,1,18,10,51,7,0,MF,30-34,Midfielder,Spain,Europe
319160,Jakub Jankto,CZE,Cagliari,Serie A,2023,27.0,1996.0,9.7,12,9,9,1,2,8,20,40.0,12,5,1,4,5,17,20,0,"MF,FW",25-29,Midfielder,Czech Republic,Europe
263727,Joan Jordn,ESP,Sevilla,La Liga,2023,29.0,1994.0,4.2,8,7,3,3,2,7,15,46.7,8,4,2,2,4,12,2,0,MF,25-29,Midfielder,Spain,Europe
81999,Joselu,ESP,Real Madrid,La Liga,2023,33.0,1990.0,18.7,6,3,1,4,1,0,7,0.0,7,11,1,10,6,12,11,0,FW,30-34,Forward,Spain,Europe
257462,Luka Jovi,SRB,Milan,Serie A,2023,25.0,1997.0,9.7,6,4,0,3,3,4,6,66.7,2,3,0,3,1,7,9,0,FW,25-29,Forward,Serbia,Europe
289167,Kamil Jwiak,POL,Granada,La Liga,2023,25.0,1998.0,6.3,13,10,4,6,3,9,17,52.9,8,4,0,4,2,15,6,0,MF,25-29,Midfielder,Poland,Europe
126737,Juanmi,ESP,Cdiz,La Liga,2023,30.0,1993.0,9.7,9,4,2,7,0,2,9,22.2,7,6,0,6,6,15,3,0,FW,30-34,Forward,Spain,Europe
500054,David Jursek,CZE,Hoffenheim,Bundesliga,2023,22.0,2000.0,5.5,14,11,13,1,0,7,17,41.2,10,7,2,5,3,17,22,1,DF,20-24,Defender,Czech Republic,Europe
53418,Kevin Kampl,SVN,RB Leipzig,Bundesliga,2023,32.0,1990.0,15.1,19,8,8,9,2,10,21,47.6,11,19,7,12,11,30,14,1,MF,30-34,Midfielder,Slovenia,Europe
425918,Jakub Kiwior,POL,Arsenal,Premier League,2023,23.0,2000.0,10.5,20,12,11,8,1,14,19,73.7,5,11,3,8,8,28,28,1,DF,20-24,Defender,Poland,Europe
74229,Koke,ESP,Atltico Madrid,La Liga,2023,31.0,1992.0,27.7,66,44,27,32,7,36,79,45.6,43,37,12,25,16,82,34,1,MF,30-34,Midfielder,Spain,Europe
208167,Dawid Kownacki,POL,Werder Bremen,Bundesliga,2023,26.0,1997.0,4.2,1,1,1,0,0,1,4,25.0,3,3,1,2,0,1,1,0,FW,25-29,Forward,Poland,Europe
337333,Alex Krl,CZE,Union Berlin,Bundesliga,2023,25.0,1998.0,15.2,19,14,7,10,2,8,20,40.0,12,15,4,11,11,30,30,0,MF,25-29,Midfielder,Czech Republic,Europe
623521,Juanmi Latasa,ESP,Getafe,La Liga,2023,22.0,2001.0,17.3,9,7,0,6,3,1,11,9.1,10,9,0,9,4,13,21,0,FW,20-24,Forward,Spain,Europe
320271,Toni Lato,ESP,Mallorca,La Liga,2023,25.0,1997.0,17.2,38,23,19,13,6,16,27,59.3,11,17,3,14,17,55,27,0,DF,25-29,Defender,Spain,Europe
70411,Darko Lazovi,SRB,Hellas Verona,Serie A,2023,32.0,1990.0,21.4,26,16,11,6,9,16,31,51.6,15,10,1,9,6,32,14,0,"FW,MF",30-34,Forward,Serbia,Europe
225873,Karol Linetty,POL,Torino,Serie A,2023,28.0,1995.0,20.6,30,21,9,20,1,9,29,31.0,20,24,8,16,23,53,27,1,MF,25-29,Midfielder,Poland,Europe
298975,Pol Lirola,ESP,Frosinone,Serie A,2023,25.0,1997.0,17.1,30,18,14,15,1,17,35,48.6,18,12,1,11,19,49,41,1,DF,25-29,Defender,Spain,Europe
710131,Diego Llorente,ESP,Roma,Serie A,2023,29.0,1993.0,24.1,31,19,20,10,1,11,24,45.8,13,40,27,13,22,53,79,0,DF,25-29,Defender,Spain,Europe
947431,David Lpez,ESP,Girona,La Liga,2023,33.0,1989.0,21.8,33,20,21,12,0,17,22,77.3,5,28,19,9,20,53,63,4,DF,30-34,Defender,Spain,Europe
891091,Diego Lpez,ESP,Valencia,La Liga,2023,21.0,2002.0,29.5,37,25,14,16,7,13,56,23.2,43,23,1,22,20,57,12,0,"MF,FW",20-24,Midfielder,Spain,Europe
568158,Javi Lpez,ESP,Alavs,La Liga,2023,21.0,2002.0,26.5,23,12,11,9,3,15,26,57.7,11,25,9,16,10,33,77,1,DF,20-24,Defender,Spain,Europe
192009,Unai Lpez,ESP,Rayo Vallecano,La Liga,2023,27.0,1995.0,23.4,48,24,18,23,7,21,53,39.6,32,24,3,21,16,64,15,2,MF,25-29,Midfielder,Spain,Europe
268429,Sandi Lovri,SVN,Udinese,Serie A,2023,25.0,1998.0,22.1,25,12,9,11,5,9,23,39.1,14,21,2,19,21,46,24,0,MF,25-29,Midfielder,Slovenia,Europe
252677,Jos Luis Morales,ESP,Villarreal,La Liga,2023,36.0,1987.0,11.6,5,3,1,4,0,3,13,23.1,10,9,1,8,7,12,4,0,"FW,MF",35-39,Forward,Spain,Europe
245056,Saa Luki,SRB,Fulham,Premier League,2023,26.0,1996.0,12.5,33,19,9,17,7,18,39,46.2,21,18,5,13,16,49,19,1,MF,25-29,Midfielder,Serbia,Europe
251876,Pablo Maffeo,ESP,Mallorca,La Liga,2023,26.0,1997.0,16.2,35,22,18,13,4,23,40,57.5,17,12,2,10,10,45,23,0,DF,25-29,Defender,Spain,Europe
96718,scar de Marcos,ESP,Athletic Club,La Liga,2023,34.0,1989.0,25.1,56,39,26,24,6,42,71,59.2,29,28,6,22,15,71,44,0,DF,30-34,Defender,Spain,Europe
634105,Alberto Mar,ESP,Valencia,La Liga,2023,22.0,2001.0,3.1,4,2,0,1,3,1,1,100.0,0,3,0,3,0,4,5,0,FW,20-24,Forward,Spain,Europe
210178,Pablo Mar,ESP,Monza,Serie A,2023,29.0,1993.0,29.1,41,25,34,7,0,22,34,64.7,12,40,25,15,37,78,115,1,DF,25-29,Defender,Spain,Europe
662261,Rafa Marn,ESP,Alavs,La Liga,2023,21.0,2002.0,27.1,32,20,23,9,0,14,27,51.9,13,34,21,13,33,65,129,2,DF,20-24,Defender,Spain,Europe
212391,Roger Mart,ESP,Cdiz,La Liga,2023,32.0,1991.0,15.1,12,6,1,9,2,2,7,28.6,5,16,1,15,7,19,4,0,FW,30-34,Forward,Spain,Europe
341278,Ivn Martn,ESP,Girona,La Liga,2023,24.0,1999.0,30.3,44,25,22,15,7,22,57,38.6,35,25,3,22,21,65,14,0,MF,20-24,Midfielder,Spain,Europe
158863,Iigo Martnez,ESP,Barcelona,La Liga,2023,32.0,1991.0,14.4,10,7,9,1,0,6,8,75.0,2,13,10,3,11,21,50,0,DF,30-34,Defender,Spain,Europe
227961,Jaime Mata,ESP,Getafe,La Liga,2023,34.0,1988.0,19.9,24,15,12,8,4,11,26,42.3,15,18,1,17,17,41,31,0,"FW,MF",30-34,Forward,Spain,Europe
298976,Borja Mayoral,ESP,Getafe,La Liga,2023,26.0,1997.0,23.9,9,5,2,2,5,5,22,22.7,17,7,0,7,4,13,16,0,FW,25-29,Forward,Spain,Europe
448344,scar Melendo,ESP,Granada,La Liga,2023,25.0,1997.0,12.5,14,6,4,10,0,4,12,33.3,8,13,0,13,5,19,4,1,"MF,FW",25-29,Midfielder,Spain,Europe
162056,Gonzalo Melero,ESP,Almera,La Liga,2023,29.0,1994.0,12.3,14,8,7,5,2,7,19,36.8,12,12,4,8,4,18,11,0,"MF,FW",25-29,Midfielder,Spain,Europe
309110,Brais Mndez,ESP,Real Sociedad,La Liga,2023,26.0,1997.0,26.8,42,28,13,20,9,15,43,34.9,28,23,4,19,12,54,21,0,"MF,FW",25-29,Midfielder,Spain,Europe
286779,Jorge Mer,ESP,Cdiz,La Liga,2023,26.0,1997.0,7.5,8,7,6,2,0,4,7,57.1,3,5,3,2,8,16,33,0,DF,25-29,Defender,Spain,Europe
413507,Nikola Milenkovi,SRB,Fiorentina,Serie A,2023,25.0,1997.0,27.9,41,21,24,14,3,22,36,61.1,14,22,14,8,27,68,95,1,DF,25-29,Defender,Serbia,Europe
191891,Arkadiusz Milik,POL,Juventus,Serie A,2023,29.0,1994.0,10.2,9,5,2,5,2,3,5,60.0,2,7,1,6,5,14,3,0,FW,25-29,Forward,Poland,Europe
281989,Luis Milla,ESP,Getafe,La Liga,2023,28.0,1994.0,23.5,57,33,19,28,10,28,47,59.6,19,20,1,19,32,89,10,0,MF,25-29,Midfielder,Spain,Europe
331505,scar Mingueza,ESP,Celta Vigo,La Liga,2023,24.0,1999.0,33.3,62,38,44,11,7,37,80,46.3,43,38,7,31,17,79,49,2,"DF,MF",20-24,Defender,Spain,Europe
70245,Ignasi Miquel,ESP,Granada,La Liga,2023,30.0,1992.0,33.2,47,30,39,6,2,23,40,57.5,17,32,16,16,45,92,132,4,DF,30-34,Defender,Spain,Europe
361254,Rafa Mir,ESP,Sevilla,La Liga,2023,26.0,1997.0,4.3,2,2,1,1,0,1,2,50.0,1,2,0,2,1,3,1,0,"FW,MF",25-29,Forward,Spain,Europe
341227,Juan Miranda,ESP,Betis,La Liga,2023,23.0,2000.0,20.6,38,24,21,13,4,17,31,54.8,14,31,6,25,19,57,62,0,DF,20-24,Defender,Spain,Europe
733576,Alberto Moleiro,ESP,Las Palmas,La Liga,2023,19.0,2003.0,20.0,15,6,4,7,4,6,30,20.0,24,11,0,11,7,22,10,0,"FW,MF",Under 20,Forward,Spain,Europe
552425,Jon Moncayola,ESP,Osasuna,La Liga,2023,25.0,1998.0,20.0,27,18,14,10,3,17,42,40.5,25,31,5,26,15,42,21,0,MF,25-29,Midfielder,Spain,Europe
568149,Alberto Moreno,ESP,Villarreal,La Liga,2023,31.0,1992.0,16.5,31,21,19,10,2,10,30,33.3,20,12,2,10,24,55,33,0,DF,30-34,Defender,Spain,Europe
193098,lex Moreno,ESP,Aston Villa,Premier League,2023,30.0,1993.0,11.5,18,12,18,0,0,12,19,63.2,7,11,2,9,13,31,37,0,DF,30-34,Defender,Spain,Europe
177467,Gerard Moreno,ESP,Villarreal,La Liga,2023,31.0,1992.0,24.6,25,12,10,7,8,11,25,44.0,14,24,7,17,9,34,24,0,FW,30-34,Forward,Spain,Europe
646750,Cristhian Mosquera,ESP,Valencia,La Liga,2023,19.0,2004.0,34.2,57,34,36,18,3,25,39,64.1,14,42,23,19,36,93,137,2,DF,Under 20,Defender,Spain,Europe
54235,Iker Muniain,ESP,Athletic Club,La Liga,2023,30.0,1992.0,6.6,5,1,2,3,0,1,3,33.3,2,4,1,3,0,5,0,0,"MF,FW",30-34,Midfielder,Spain,Europe
517842,Aihen Muoz,ESP,Real Sociedad,La Liga,2023,25.0,1997.0,12.5,36,21,20,10,6,24,35,68.6,11,16,8,8,9,45,33,0,DF,25-29,Defender,Spain,Europe
710677,Iker Muoz,ESP,Osasuna,La Liga,2023,20.0,2002.0,20.6,32,18,13,17,2,15,31,48.4,16,16,5,11,11,43,50,0,MF,20-24,Midfielder,Spain,Europe
15956,Jess Navas,ESP,Sevilla,La Liga,2023,37.0,1985.0,22.3,37,27,21,14,2,22,40,55.0,18,15,7,8,22,59,48,0,DF,35-39,Defender,Spain,Europe
148928,Sal guez,ESP,Atltico Madrid,La Liga,2023,28.0,1994.0,15.3,64,39,29,29,6,30,49,61.2,19,36,9,27,14,78,56,0,MF,25-29,Midfielder,Spain,Europe
73547,Oliver Norwood,NIR,Sheffield Utd,Premier League,2023,32.0,1991.0,16.0,41,26,18,18,5,20,47,42.6,27,24,9,15,21,62,39,0,MF,30-34,Midfielder,Northern Ireland,Europe
338285,Unai Nez,ESP,Celta Vigo,La Liga,2023,26.0,1997.0,31.1,51,28,30,19,2,23,49,46.9,26,38,24,14,52,103,153,3,DF,25-29,Defender,Spain,Europe
293385,Dani Olmo,ESP,RB Leipzig,Bundesliga,2023,25.0,1998.0,16.1,26,18,14,8,4,10,22,45.5,12,7,0,7,13,39,12,1,MF,25-29,Midfielder,Spain,Europe
711996,Warmed Omari,COM,Rennes,Ligue 1,2023,23.0,2000.0,23.0,32,19,23,7,2,16,28,57.1,12,30,20,10,33,65,77,2,DF,20-24,Defender,Comoros,Africa
634131,Aimar Oroz,ESP,Osasuna,La Liga,2023,21.0,2001.0,26.0,43,26,18,20,5,13,37,35.1,24,27,2,25,16,59,11,0,MF,20-24,Midfielder,Spain,Europe
580560,Jon Pacheco,ESP,Real Sociedad,La Liga,2023,22.0,2001.0,17.0,25,15,21,4,0,14,22,63.6,8,17,6,11,10,35,53,1,DF,20-24,Defender,Spain,Europe
591916,Aitor Paredes,ESP,Athletic Club,La Liga,2023,23.0,2000.0,30.0,20,11,11,9,0,7,14,50.0,7,23,11,12,33,53,104,0,DF,20-24,Defender,Spain,Europe
674612,Youssouf Ndayishimiye,BDI,Nice,Ligue 1,2023,24.0,1998.0,19.0,31,20,17,12,2,12,23,52.2,11,19,11,8,12,43,47,1,"MF,DF",20-24,Midfielder,Burundi,Africa
353366,Benjamin Pavard,FRA,Inter,Serie A,2023,27.0,1996.0,18.6,34,21,21,11,2,20,24,83.3,4,25,15,10,32,66,44,1,DF,25-29,Defender,France,Europe
792380,Aleksandar Pavlovic,GER,Bayern Munich,Bundesliga,2023,19.0,2004.0,13.6,28,16,10,14,4,17,33,51.5,16,13,3,10,17,45,12,0,MF,Under 20,Midfielder,Germany,Europe
364133,Pietro Pellegri,ITA,Torino,Serie A,2023,22.0,2001.0,8.4,5,1,1,4,0,1,5,20.0,4,4,1,3,2,7,3,0,FW,20-24,Forward,Italy,Europe
286297,Lorenzo Pellegrini,ITA,Roma,Serie A,2023,27.0,1996.0,20.7,35,20,14,16,5,17,51,33.3,34,28,5,23,20,55,22,0,MF,25-29,Midfielder,Italy,Europe
346567,Luca Pellegrini,ITA,Lazio,Serie A,2023,24.0,1999.0,8.7,18,13,7,10,1,9,17,52.9,8,7,3,4,9,27,20,0,DF,20-24,Defender,Italy,Europe
494236,Andy Pelmard,FRA,Clermont Foot,Ligue 1,2023,23.0,2000.0,33.2,51,38,41,9,1,32,40,80.0,8,37,20,17,33,84,99,2,DF,20-24,Defender,France,Europe
203394,Andreas Pereira,BRA,Fulham,Premier League,2023,27.0,1996.0,29.0,25,12,4,12,9,11,41,26.8,30,16,2,14,4,29,12,0,MF,25-29,Midfielder,Brazil,South America
141050,Danilo Pereira,POR,Paris S-G,Ligue 1,2023,31.0,1991.0,22.2,22,12,14,6,2,9,17,52.9,8,29,26,3,23,45,100,1,DF,30-34,Defender,Portugal,Europe
668547,Mximo Perrone,ARG,Las Palmas,La Liga,2023,20.0,2003.0,18.0,42,21,17,22,3,19,39,48.7,20,27,4,23,24,66,21,0,MF,20-24,Midfielder,Argentina,South America
199258,Andrea Petagna,ITA,Cagliari,Serie A,2023,28.0,1995.0,11.1,4,2,1,0,3,1,2,50.0,1,6,3,3,1,5,4,0,FW,25-29,Forward,Italy,Europe
113133,Germn Pezzella,ARG,Betis,La Liga,2023,32.0,1991.0,30.7,34,24,24,10,0,23,38,60.5,15,31,18,13,31,65,150,0,DF,30-34,Defender,Argentina,South America
336960,Giuseppe Pezzella,ITA,Empoli,Serie A,2023,25.0,1997.0,12.1,25,14,19,5,1,20,28,71.4,8,17,6,11,2,27,35,0,DF,25-29,Defender,Italy,Europe
232463,Luca Pfeiffer,GER,Darmstadt 98,Bundesliga,2023,26.0,1996.0,18.0,11,6,2,6,3,5,11,45.5,6,5,1,4,2,13,21,0,"FW,MF",25-29,Forward,Germany,Europe
191359,Florian Pick,GER,Heidenheim,Bundesliga,2023,27.0,1995.0,3.6,4,4,3,0,1,2,3,66.7,1,2,0,2,2,6,2,0,"MF,FW",25-29,Midfielder,Germany,Europe
674806,Santiago Pierotti,ARG,Lecce,Serie A,2023,22.0,2001.0,2.2,8,8,2,5,1,2,8,25.0,6,5,0,5,1,9,0,0,"MF,FW",20-24,Midfielder,Argentina,South America
534084,Niccol Pierozzi,ITA,Salernitana,Serie A,2023,21.0,2001.0,9.7,17,11,13,4,0,11,22,50.0,11,24,7,17,11,28,36,0,DF,20-24,Defender,Italy,Europe
315865,Andrea Pinamonti,ITA,Sassuolo,Serie A,2023,24.0,1999.0,34.2,13,8,1,6,6,5,22,22.7,17,19,2,17,1,14,40,0,FW,20-24,Forward,Italy,Europe
442248,Ethan Pinnock,JAM,Brentford,Premier League,2023,30.0,1993.0,28.0,35,23,22,13,0,9,20,45.0,11,40,24,16,43,78,170,3,DF,30-34,Defender,Jamaica,North America
167329,Alassane Pla,FRA,Gladbach,Bundesliga,2023,30.0,1993.0,21.3,17,7,5,8,4,7,15,46.7,8,11,0,11,2,19,6,0,"FW,MF",30-34,Forward,France,Europe
392538,Tommaso Pobega,ITA,Milan,Serie A,2023,24.0,1999.0,3.5,16,9,11,5,0,6,13,46.2,7,10,2,8,6,22,7,0,MF,20-24,Midfielder,Italy,Europe
60957,Sebastian Polter,GER,Darmstadt 98,Bundesliga,2023,32.0,1991.0,5.0,1,0,1,0,0,0,1,0.0,1,5,1,4,0,1,4,0,FW,30-34,Forward,Germany,Europe
569390,Julien Ponceau,FRA,Lorient,Ligue 1,2023,22.0,2000.0,24.9,32,15,12,14,6,9,30,30.0,21,22,1,21,19,51,20,0,MF,20-24,Midfielder,France,Europe
223974,Stefan Posch,AUT,Bologna,Serie A,2023,26.0,1997.0,26.8,77,46,35,38,4,49,88,55.7,39,27,8,19,18,95,72,0,DF,25-29,Defender,Austria,Europe
157635,Yussuf Poulsen,DEN,RB Leipzig,Bundesliga,2023,29.0,1994.0,13.5,13,8,1,9,3,4,14,28.6,10,13,3,10,4,17,15,0,FW,25-29,Forward,Denmark,Europe
234029,Grischa Prmel,GER,Hoffenheim,Bundesliga,2023,28.0,1995.0,23.8,32,18,11,15,6,14,32,43.8,18,22,6,16,22,54,36,0,MF,25-29,Midfielder,Germany,Europe
315779,Christian Pulisic,USA,Milan,Serie A,2023,24.0,1998.0,28.9,35,26,14,11,10,17,30,56.7,13,20,1,19,10,45,10,1,"FW,MF",20-24,Forward,United States,North America
632349,Jarell Quansah,ENG,Liverpool,Premier League,2023,20.0,2003.0,13.2,25,22,17,7,1,14,20,70.0,6,16,8,8,17,42,39,1,DF,20-24,Defender,England,Europe
182913,Adrien Rabiot,FRA,Juventus,Serie A,2023,28.0,1995.0,29.5,58,39,22,30,6,30,45,66.7,15,26,6,20,25,83,34,0,MF,25-29,Midfielder,France,Europe
418571,Hamza Rafia,TUN,Lecce,Serie A,2023,24.0,1999.0,13.4,44,31,13,27,4,13,30,43.3,17,27,1,26,11,55,13,0,MF,20-24,Midfielder,Tunisia,Africa
442703,Ylber Ramadani,ALB,Lecce,Serie A,2023,27.0,1996.0,33.0,68,41,32,29,7,37,96,38.5,59,54,13,41,44,112,44,0,MF,25-29,Midfielder,Albania,Europe
518644,Largie Ramazani,BEL,Almera,La Liga,2023,22.0,2001.0,17.3,12,7,5,6,1,6,26,23.1,20,16,2,14,34,46,10,0,"FW,MF",20-24,Forward,Belgium,Europe
550550,Gonalo Ramos,POR,Paris S-G,Ligue 1,2023,22.0,2001.0,15.8,25,15,4,12,9,6,20,30.0,14,12,2,10,5,30,16,0,FW,20-24,Forward,Portugal,Europe
646658,Aaron Ramsey,ENG,Burnley,Premier League,2023,20.0,2003.0,5.9,17,14,7,5,5,8,16,50.0,8,11,2,9,1,18,10,0,"MF,FW",20-24,Midfielder,England,Europe
503749,Jacob Ramsey,ENG,Aston Villa,Premier League,2023,22.0,2001.0,9.5,16,8,7,6,3,5,15,33.3,10,15,2,13,3,19,8,0,"FW,MF",20-24,Forward,England,Europe
346561,Luca Ranieri,ITA,Fiorentina,Serie A,2023,24.0,1999.0,22.9,14,10,11,1,2,8,13,61.5,5,25,11,14,29,43,64,0,DF,20-24,Defender,Italy,Europe
489611,Filippo Ranocchia,ITA,Empoli,Serie A,2023,22.0,2001.0,5.3,16,11,7,9,0,7,16,43.8,9,9,1,8,3,19,14,0,"MF,DF",20-24,Midfielder,Italy,Europe
405885,Giacomo Raspadori,ITA,Napoli,Serie A,2023,23.0,2000.0,17.6,21,10,6,10,5,6,15,40.0,9,15,1,14,3,24,7,0,"FW,MF",20-24,Forward,Italy,Europe
318204,David Raum,GER,RB Leipzig,Bundesliga,2023,25.0,1998.0,30.4,58,35,24,29,5,34,58,58.6,24,51,9,42,27,85,82,2,DF,25-29,Defender,Germany,Europe
145466,Tim Ream,USA,Fulham,Premier League,2023,35.0,1987.0,16.7,20,9,13,5,2,9,18,50.0,9,23,15,8,25,45,61,2,DF,35-39,Defender,United States,North America
226973,Harrison Reed,ENG,Fulham,Premier League,2023,28.0,1995.0,14.7,29,18,9,17,3,13,31,41.9,18,19,9,10,11,40,24,0,MF,25-29,Midfielder,England,Europe
460939,Tijjani Reijnders,NED,Milan,Serie A,2023,25.0,1998.0,31.3,46,25,10,31,5,21,43,48.8,22,26,8,18,18,64,26,0,MF,25-29,Midfielder,Netherlands,Europe
467992,Samuele Ricci,ITA,Torino,Serie A,2023,21.0,2001.0,26.6,33,18,17,12,4,15,23,65.2,8,21,3,18,27,60,25,0,MF,20-24,Midfielder,Italy,Europe
357662,Declan Rice,ENG,Arsenal,Premier League,2023,24.0,1999.0,35.8,83,51,37,38,8,32,57,56.1,25,37,11,26,44,127,52,0,MF,20-24,Midfielder,England,Europe
578539,Chris Richards,USA,Crystal Palace,Premier League,2023,23.0,2000.0,23.3,46,28,21,22,3,20,30,66.7,10,32,12,20,27,73,109,0,"DF,MF",20-24,Defender,United States,North America
893675,Amir Richardson,MAR,Reims,Ligue 1,2023,21.0,2002.0,15.0,33,23,12,18,3,10,22,45.5,12,26,5,21,15,48,30,0,MF,20-24,Midfielder,Morocco,Africa
692070,Clemens Riedel,GER,Darmstadt 98,Bundesliga,2023,20.0,2003.0,8.4,22,13,16,5,1,15,24,62.5,9,11,3,8,11,33,26,0,DF,20-24,Defender,Germany,Europe
507341,Fabian Rieder,SUI,Rennes,Ligue 1,2023,21.0,2002.0,4.1,13,7,2,9,2,6,11,54.5,5,3,1,2,5,18,2,0,MF,20-24,Midfielder,Switzerland,Europe
457221,Lucas Robertone,ARG,Almera,La Liga,2023,26.0,1997.0,26.5,61,33,28,23,10,25,50,50.0,25,43,9,34,51,112,43,0,MF,25-29,Midfielder,Argentina,South America
234803,Andrew Robertson,SCO,Liverpool,Premier League,2023,29.0,1994.0,18.8,35,24,21,11,3,26,43,60.5,17,20,6,14,13,48,40,0,DF,25-29,Defender,Scotland,Europe
349701,Antonee Robinson,USA,Fulham,Premier League,2023,25.0,1997.0,36.3,93,58,60,26,7,52,110,47.3,58,56,8,48,80,173,117,3,DF,25-29,Defender,United States,North America
128909,Jack Robinson,ENG,Sheffield Utd,Premier League,2023,29.0,1993.0,32.1,43,28,29,14,0,25,39,64.1,14,49,33,16,33,76,132,2,DF,25-29,Defender,England,Europe
342385,Guido Rodrguez,ARG,Betis,La Liga,2023,29.0,1994.0,20.5,53,30,21,24,8,34,55,61.8,21,27,6,21,29,82,44,0,MF,25-29,Midfielder,Argentina,South America
412363,Rodrygo,BRA,Real Madrid,La Liga,2023,22.0,2001.0,26.4,16,15,2,9,5,5,19,26.3,14,14,0,14,8,24,6,0,FW,20-24,Forward,Brazil,South America
889683,Rogrio,BRA,Wolfsburg,Bundesliga,2023,25.0,1998.0,10.1,14,6,7,5,2,10,14,71.4,4,16,5,11,5,19,23,1,DF,25-29,Defender,Brazil,South America
503743,Morgan Rogers,ENG,Aston Villa,Premier League,2023,21.0,2002.0,7.1,8,1,3,2,3,2,11,18.2,9,11,0,11,3,11,11,0,"MF,FW",20-24,Midfielder,England,Europe
197747,Alessio Romagnoli,ITA,Lazio,Serie A,2023,28.0,1995.0,26.8,25,18,14,11,0,16,24,66.7,8,29,17,12,29,54,115,0,DF,25-29,Defender,Italy,Europe
355915,Cristian Romero,ARG,Tottenham,Premier League,2023,25.0,1998.0,31.0,66,40,35,25,6,32,44,72.7,12,46,22,24,44,110,106,1,DF,25-29,Defender,Argentina,South America
332889,Valentin Rongier,FRA,Marseille,Ligue 1,2023,28.0,1994.0,9.5,23,12,9,12,2,14,26,53.8,12,16,4,12,15,38,18,0,MF,25-29,Midfielder,France,Europe
943837,Vitor Roque,BRA,Barcelona,La Liga,2023,18.0,2005.0,3.6,3,2,2,0,1,0,2,0.0,2,3,0,3,0,3,5,0,FW,Under 20,Forward,Brazil,South America
370791,Pablo Rosario,NED,Nice,Ligue 1,2023,26.0,1997.0,22.3,36,25,15,16,5,23,34,67.6,11,27,13,14,29,65,39,0,"MF,DF",25-29,Midfielder,Netherlands,Europe
690799,Anthony Rouault,FRA,Stuttgart,Bundesliga,2023,22.0,2001.0,11.2,21,12,14,5,2,13,21,61.9,8,14,8,6,8,29,28,0,DF,20-24,Defender,France,Europe
127076,Jrme Roussillon,FRA,Union Berlin,Bundesliga,2023,30.0,1993.0,8.4,16,9,6,7,3,8,12,66.7,4,13,4,9,5,21,26,0,DF,30-34,Defender,France,Europe
525704,Nicol Rovella,ITA,Lazio,Serie A,2023,21.0,2001.0,14.6,46,28,25,17,4,16,36,44.4,20,27,6,21,23,69,29,0,MF,20-24,Midfielder,Italy,Europe
244338,Pelly Ruddock Mpanzu,COD,Luton Town,Premier League,2023,30.0,1993.0,12.2,13,5,6,6,1,5,9,55.6,4,15,7,8,9,22,16,3,MF,30-34,Midfielder,DR Congo,Africa
86202,Antonio Rdiger,GER,Real Madrid,La Liga,2023,30.0,1993.0,30.1,26,15,18,4,4,16,20,80.0,4,27,20,7,11,37,89,0,DF,30-34,Defender,Germany,Europe
87884,Mrio Rui,POR,Napoli,Serie A,2023,32.0,1991.0,13.4,27,15,17,5,5,14,21,66.7,7,17,2,15,15,42,19,0,DF,30-34,Defender,Portugal,Europe
381187,Emmanuel Sabbi,USA,Le Havre,Ligue 1,2023,25.0,1997.0,17.6,38,19,15,15,8,16,39,41.0,23,26,2,24,19,57,7,0,"FW,MF",25-29,Forward,United States,North America
167491,Stefano Sabelli,ITA,Genoa,Serie A,2023,30.0,1993.0,27.0,50,24,28,19,3,15,46,32.6,31,27,6,21,23,73,35,0,DF,30-34,Defender,Italy,Europe
337715,Umar Sadiq,NGA,Real Sociedad,La Liga,2023,26.0,1997.0,12.0,15,10,2,8,5,4,8,50.0,4,9,0,9,0,15,10,0,FW,25-29,Forward,Nigeria,Africa
381950,Alexis Saelemaekers,BEL,Bologna,Serie A,2023,24.0,1999.0,21.0,32,22,13,14,5,12,27,44.4,15,13,1,12,13,45,10,1,"FW,MF",20-24,Forward,Belgium,Europe
524925,Modibo Sagnan,MLI,Montpellier,Ligue 1,2023,24.0,1999.0,11.7,34,22,23,9,2,15,25,60.0,10,13,9,4,15,49,67,0,DF,20-24,Defender,Mali,Africa
182916,Wesley Sad,FRA,Lens,Ligue 1,2023,28.0,1995.0,11.3,8,4,1,2,5,2,9,22.2,7,4,0,4,4,12,3,0,"FW,MF",25-29,Forward,France,Europe
537127,Tho Sainte-Luce,FRA,Montpellier,Ligue 1,2023,24.0,1998.0,3.8,17,7,10,6,1,11,19,57.9,8,9,4,5,3,20,15,0,DF,20-24,Defender,France,Europe
433177,Bukayo Saka,ENG,Arsenal,Premier League,2023,21.0,2001.0,32.4,66,35,22,24,20,26,59,44.1,33,43,2,41,15,81,24,1,FW,20-24,Forward,England,Europe
928323,Ibrahim Salah,MAR,Rennes,Ligue 1,2023,21.0,2001.0,5.8,15,7,5,6,4,11,18,61.1,7,4,0,4,10,25,5,0,"FW,MF",20-24,Forward,Morocco,Africa
148455,Mohamed Salah,EGY,Liverpool,Premier League,2023,31.0,1992.0,28.2,17,11,1,8,8,6,21,28.6,15,19,1,18,2,19,1,0,FW,30-34,Forward,Egypt,Africa
495666,William Saliba,FRA,Arsenal,Premier League,2023,22.0,2001.0,38.0,41,26,28,12,1,20,27,74.1,7,32,17,15,29,70,81,3,DF,20-24,Defender,France,Europe
563963,Mohammed Salisu,GHA,Monaco,Ligue 1,2023,24.0,1999.0,11.5,27,12,11,13,3,17,26,65.4,9,21,12,9,22,49,44,0,DF,20-24,Defender,Ghana,Africa
381967,Albert Sambi Lokonga,BEL,Luton Town,Premier League,2023,23.0,1999.0,14.5,29,18,14,12,3,17,24,70.8,7,23,13,10,11,40,14,0,MF,20-24,Midfielder,Belgium,Europe
335147,Junior Sambia,FRA,Salernitana,Serie A,2023,26.0,1996.0,11.5,12,5,8,1,3,6,11,54.5,5,15,7,8,11,23,28,0,"DF,MF",25-29,Defender,France,Europe
234523,Antonio Sanabria,PAR,Torino,Serie A,2023,27.0,1996.0,23.7,18,15,5,9,4,4,9,44.4,5,7,1,6,6,24,12,0,"FW,MF",25-29,Forward,Paraguay,South America
40433,Alexis Snchez,CHI,Inter,Serie A,2023,34.0,1988.0,8.5,7,6,0,5,2,1,4,25.0,3,4,1,3,1,8,3,0,"FW,MF",30-34,Forward,Chile,South America
79960,Alex Sandro,BRA,Juventus,Serie A,2023,32.0,1991.0,8.0,13,7,7,6,0,4,5,80.0,1,13,7,6,15,28,23,0,DF,30-34,Defender,Brazil,South America
1111776,Ibou San,SEN,Metz,Ligue 1,2023,18.0,2005.0,1.4,6,4,2,1,3,2,2,100.0,0,3,0,3,1,7,2,0,"MF,FW",Under 20,Midfielder,Senegal,Africa
192565,Leroy San,GER,Bayern Munich,Bundesliga,2023,27.0,1996.0,23.7,15,8,6,6,3,4,19,21.1,15,12,0,12,7,22,3,0,FW,25-29,Forward,Germany,Europe
768380,Arouna Sangante,SEN,Le Havre,Ligue 1,2023,21.0,2002.0,29.9,53,33,27,23,3,24,40,60.0,16,35,18,17,66,119,93,2,DF,20-24,Defender,Senegal,Africa
174094,Morgan Sanson,FRA,Nice,Ligue 1,2023,28.0,1994.0,21.8,26,19,12,7,7,12,31,38.7,19,34,5,29,20,46,16,0,MF,25-29,Midfielder,France,Europe
82048,Nicola Sansone,ITA,Lecce,Serie A,2023,31.0,1991.0,8.5,11,6,6,2,3,5,16,31.3,11,7,1,6,4,15,5,2,"FW,MF",30-34,Forward,Italy,Europe
285323,Baptiste Santamaria,FRA,Rennes,Ligue 1,2023,28.0,1995.0,21.4,52,33,21,25,6,29,46,63.0,17,15,6,9,34,86,33,1,MF,25-29,Midfielder,France,Europe
816580,Tiago Santos,POR,Lille,Ligue 1,2023,21.0,2002.0,26.3,63,42,31,19,13,30,52,57.7,22,24,5,19,15,78,37,0,DF,20-24,Defender,Portugal,Europe
190685,Bouna Sarr,SEN,Bayern Munich,Bundesliga,2023,31.0,1992.0,1.2,2,0,1,1,0,2,2,100.0,0,3,0,3,0,2,1,0,DF,30-34,Defender,Senegal,Africa
127156,Tji Savanier,FRA,Montpellier,Ligue 1,2023,31.0,1991.0,30.7,37,20,16,15,6,14,63,22.2,49,36,8,28,33,70,28,1,MF,30-34,Midfielder,France,Europe
504153,Joe Scally,USA,Gladbach,Bundesliga,2023,20.0,2002.0,24.8,41,28,21,17,3,23,40,57.5,17,31,11,20,18,59,78,2,DF,20-24,Defender,United States,North America
571604,Giorgio Scalvini,ITA,Atalanta,Serie A,2023,19.0,2003.0,28.3,53,33,29,19,5,19,40,47.5,21,44,17,27,59,112,71,0,DF,Under 20,Defender,Italy,Europe
315867,Gianluca Scamacca,ITA,Atalanta,Serie A,2023,24.0,1999.0,16.1,15,9,4,5,6,7,14,50.0,7,7,1,6,4,19,9,0,FW,20-24,Forward,Italy,Europe
473050,Kevin Schade,GER,Brentford,Premier League,2023,21.0,2001.0,3.7,3,1,1,2,0,0,5,0.0,5,2,0,2,1,4,4,0,"FW,MF",20-24,Forward,Germany,Europe
454863,Andrs Schfer,HUN,Union Berlin,Bundesliga,2023,24.0,1999.0,13.5,29,16,9,15,5,11,20,55.0,9,25,4,21,20,49,25,0,MF,20-24,Midfielder,Hungary,Europe
135343,Fabian Schr,SUI,Newcastle Utd,Premier League,2023,31.0,1991.0,33.9,42,24,27,13,2,18,40,45.0,22,50,38,12,36,78,133,1,DF,30-34,Defender,Switzerland,Europe
223979,Xaver Schlager,AUT,RB Leipzig,Bundesliga,2023,25.0,1997.0,27.5,81,50,35,38,8,21,53,39.6,32,41,8,33,19,100,27,0,MF,25-29,Midfielder,Austria,Europe
413843,Keven Schlotterbeck,GER,Bochum,Bundesliga,2023,26.0,1997.0,24.3,42,22,26,14,2,25,30,83.3,5,33,23,10,33,75,104,2,DF,25-29,Defender,Germany,Europe
388198,Nico Schlotterbeck,GER,Dortmund,Bundesliga,2023,23.0,1999.0,31.8,70,50,36,27,7,41,65,63.1,24,52,25,27,45,115,101,3,DF,20-24,Defender,Germany,Europe
346853,Romano Schmid,AUT,Werder Bremen,Bundesliga,2023,23.0,2000.0,28.9,35,20,7,22,6,14,46,30.4,32,36,7,29,11,46,17,2,"MF,FW",20-24,Midfielder,Austria,Europe
275249,Niklas Schmidt,GER,Toulouse,Ligue 1,2023,25.0,1998.0,14.1,36,21,13,19,4,16,33,48.5,17,14,7,7,4,40,13,0,MF,25-29,Midfielder,Germany,Europe
160968,Benno Schmitz,GER,Kln,Bundesliga,2023,28.0,1994.0,12.8,27,15,20,7,0,17,34,50.0,17,19,4,15,7,34,29,0,DF,25-29,Defender,Germany,Europe
94148,Fabian Schnellhardt,GER,Darmstadt 98,Bundesliga,2023,29.0,1994.0,2.6,4,1,2,1,1,1,3,33.3,2,1,0,1,4,8,5,0,MF,25-29,Midfielder,Germany,Europe
581357,Jan Schppner,GER,Heidenheim,Bundesliga,2023,24.0,1999.0,22.2,48,26,26,20,2,21,42,50.0,21,37,7,30,26,74,57,0,MF,20-24,Midfielder,Germany,Europe
418543,Perr Schuurs,NED,Torino,Serie A,2023,23.0,1999.0,8.6,20,12,11,8,1,3,9,33.3,6,10,2,8,9,29,23,0,DF,20-24,Defender,Netherlands,Europe
855256,Alex Scott,ENG,Bournemouth,Premier League,2023,19.0,2003.0,11.3,24,15,8,10,6,12,28,42.9,16,14,4,10,12,36,18,2,MF,Under 20,Midfielder,England,Europe
551752,Demba Seck,SEN,Torino,Serie A,2023,22.0,2001.0,4.7,5,3,1,4,0,3,4,75.0,1,1,0,1,1,6,0,0,MF,20-24,Midfielder,Senegal,Africa
178459,Davie Selke,GER,Kln,Bundesliga,2023,28.0,1995.0,14.1,4,2,1,3,0,0,2,0.0,2,5,3,2,0,4,20,0,FW,25-29,Forward,Germany,Europe
231572,Nlson Semedo,POR,Wolves,Premier League,2023,29.0,1993.0,34.3,79,48,52,19,8,38,64,59.4,26,44,8,36,36,115,85,1,"DF,MF",25-29,Defender,Portugal,Europe
583255,Antoine Semenyo,GHA,Bournemouth,Premier League,2023,23.0,2000.0,23.4,24,17,7,9,8,9,27,33.3,18,39,2,37,6,30,21,0,FW,20-24,Forward,Ghana,Africa
261905,Suat Serdar,GER,Hellas Verona,Serie A,2023,26.0,1997.0,18.4,51,39,24,23,4,22,45,48.9,23,29,7,22,20,71,25,1,MF,25-29,Midfielder,Germany,Europe
448028,Kevin Sessa,GER,Heidenheim,Bundesliga,2023,23.0,2000.0,11.2,17,10,9,6,2,7,16,43.8,9,12,1,11,4,21,17,0,"MF,FW",20-24,Midfielder,Germany,Europe
94529,Stephan El Shaarawy,ITA,Roma,Serie A,2023,30.0,1992.0,19.3,21,13,14,4,3,6,15,40.0,9,11,4,7,13,34,15,2,"FW,DF",30-34,Forward,Italy,Europe
358166,Eldor Shomurodov,UZB,Cagliari,Serie A,2023,28.0,1995.0,10.4,11,4,2,6,3,6,10,60.0,4,5,0,5,4,15,4,0,"FW,MF",25-29,Forward,Uzbekistan,Asia
280387,Vincent Sierro,SUI,Toulouse,Ligue 1,2023,27.0,1995.0,25.1,41,24,15,20,6,27,77,35.1,50,37,13,24,27,68,33,0,MF,25-29,Midfielder,Switzerland,Europe
548348,Kiliann Sildillia,FRA,Freiburg,Bundesliga,2023,21.0,2002.0,20.1,43,19,28,8,7,26,42,61.9,16,33,15,18,22,65,64,0,DF,20-24,Defender,France,Europe
700646,Andr Silva,POR,Real Sociedad,La Liga,2023,27.0,1995.0,8.1,2,2,0,0,2,0,4,0.0,4,3,0,3,1,3,3,0,FW,25-29,Forward,Portugal,Europe
241641,Bernardo Silva,POR,Manchester City,Premier League,2023,28.0,1994.0,28.6,51,23,13,25,13,25,57,43.9,32,32,4,28,17,68,15,1,"MF,FW",25-29,Midfielder,Portugal,Europe
505653,Fbio Silva,POR,Wolves,Premier League,2023,21.0,2002.0,2.9,7,4,3,4,0,2,3,66.7,1,1,0,1,2,9,0,0,FW,20-24,Forward,Portugal,Europe
294817,Thiago Silva,BRA,Chelsea,Premier League,2023,38.0,1984.0,28.1,29,15,22,6,1,20,34,58.8,14,33,24,9,26,55,153,4,DF,35-39,Defender,Brazil,South America
666234,Mohamed Simakan,FRA,RB Leipzig,Bundesliga,2023,23.0,2000.0,23.8,48,29,28,19,1,32,44,72.7,12,36,14,22,29,77,69,0,DF,20-24,Defender,France,Europe
282388,Giovanni Simeone,ARG,Napoli,Serie A,2023,28.0,1995.0,8.9,12,4,1,3,8,3,12,25.0,9,11,0,11,1,13,7,0,FW,25-29,Forward,Argentina,South America
742201,Giuliano Simeone,ARG,Alavs,La Liga,2023,20.0,2002.0,7.0,7,5,2,3,2,5,17,29.4,12,10,0,10,5,12,3,0,FW,20-24,Forward,Argentina,South America
274862,Moses Simon,NGA,Nantes,Ligue 1,2023,28.0,1995.0,19.9,7,5,2,5,0,2,8,25.0,6,9,1,8,3,10,5,1,"FW,MF",25-29,Forward,Nigeria,Africa
566931,Xavi Simons,NED,RB Leipzig,Bundesliga,2023,20.0,2003.0,29.5,30,17,10,11,9,15,31,48.4,16,23,0,23,16,46,4,0,MF,20-24,Midfielder,Netherlands,Europe
648779,Wilfried Singo,CIV,Monaco,Ligue 1,2023,22.0,2000.0,24.3,34,25,18,14,2,17,26,65.4,9,27,14,13,51,85,81,2,DF,20-24,Defender,Ivory Coast,Africa
512385,Luis Sinisterra,COL,Bournemouth,Premier League,2023,24.0,1999.0,7.8,23,12,9,10,4,9,16,56.3,7,18,0,18,8,31,4,0,"FW,MF",20-24,Forward,Colombia,South America
372712,Ibrahima Sissoko,MLI,Strasbourg,Ligue 1,2023,25.0,1997.0,18.2,47,33,13,25,9,23,30,76.7,7,21,8,13,19,66,30,0,MF,25-29,Midfielder,Mali,Africa
46001,Moussa Sissoko,FRA,Nantes,Ligue 1,2023,33.0,1989.0,20.2,27,16,13,8,6,12,25,48.0,13,8,2,6,12,39,31,0,MF,30-34,Midfielder,France,Europe
287920,Tim Skarke,GER,Darmstadt 98,Bundesliga,2023,26.0,1996.0,26.7,26,16,12,10,4,10,28,35.7,18,25,2,23,6,32,20,0,"FW,DF",25-29,Forward,Germany,Europe
290587,Ellyes Skhiri,TUN,Eint Frankfurt,Bundesliga,2023,28.0,1995.0,24.1,44,24,18,19,7,19,36,52.8,17,33,4,29,39,83,47,2,MF,25-29,Midfielder,Tunisia,Africa
406638,Oliver Skipp,ENG,Tottenham,Premier League,2023,22.0,2000.0,7.9,18,12,9,6,3,11,18,61.1,7,12,1,11,3,21,9,0,"MF,DF",20-24,Midfielder,England,Europe
567309,Naatan Skytt,FIN,Toulouse,Ligue 1,2023,21.0,2002.0,1.3,4,4,2,1,1,1,1,100.0,0,0,0,0,0,4,0,0,"MF,FW",20-24,Midfielder,Finland,Europe
103427,Chris Smalling,ENG,Roma,Serie A,2023,33.0,1989.0,4.3,1,1,1,0,0,1,4,25.0,3,6,5,1,5,6,8,0,DF,30-34,Defender,England,Europe
392765,Emile Smith Rowe,ENG,Arsenal,Premier League,2023,23.0,2000.0,3.9,4,1,2,2,0,2,4,50.0,2,3,1,2,3,7,1,0,MF,20-24,Midfielder,England,Europe
913495,Emran Soglo,ENG,Marseille,Ligue 1,2023,18.0,2005.0,1.2,2,1,0,2,0,1,3,33.3,2,6,0,6,1,3,3,0,"MF,DF",Under 20,Midfielder,England,Europe
258889,Dominic Solanke,ENG,Bournemouth,Premier League,2023,25.0,1997.0,36.9,23,11,3,13,7,10,29,34.5,19,24,5,19,7,30,43,0,FW,25-29,Forward,England,Europe
354726,Florian Sotoca,FRA,Lens,Ligue 1,2023,32.0,1990.0,28.9,33,22,9,21,3,17,38,44.7,21,41,4,37,20,53,34,0,"MF,FW",30-34,Midfielder,France,Europe
568698,Issa Soumar,SEN,Le Havre,Ligue 1,2023,22.0,2000.0,2.6,2,0,2,0,0,0,4,0.0,4,0,0,0,0,2,2,0,"FW,MF",20-24,Forward,Senegal,Africa
212723,Djibril Sow,SUI,Sevilla,La Liga,2023,26.0,1997.0,16.2,28,21,15,8,5,9,25,36.0,16,20,3,17,17,45,8,1,MF,25-29,Midfielder,Switzerland,Europe
118689,Leonardo Spinazzola,ITA,Roma,Serie A,2023,30.0,1993.0,14.6,15,7,10,5,0,8,18,44.4,10,8,2,6,3,18,15,0,DF,30-34,Defender,Italy,Europe
344069,Anton Stach,GER,Hoffenheim,Bundesliga,2023,24.0,1998.0,25.8,73,42,40,27,6,33,63,52.4,30,38,12,26,72,145,67,1,MF,20-24,Midfielder,Germany,Europe
289835,Jens Stage,DEN,Werder Bremen,Bundesliga,2023,26.0,1996.0,25.9,52,22,21,23,8,18,50,36.0,32,42,23,19,23,75,55,0,MF,25-29,Midfielder,Denmark,Europe
258987,Carl Starfelt,SWE,Celta Vigo,La Liga,2023,28.0,1995.0,24.6,36,30,30,5,1,19,28,67.9,9,35,28,7,34,70,159,2,DF,25-29,Defender,Sweden,Europe
162434,Niklas Stark,GER,Werder Bremen,Bundesliga,2023,28.0,1995.0,12.1,26,15,13,11,2,12,18,66.7,6,14,7,7,19,45,61,1,DF,25-29,Defender,Germany,Europe
195246,Pascal Stenzel,GER,Stuttgart,Bundesliga,2023,27.0,1996.0,11.8,18,8,7,9,2,10,30,33.3,20,22,8,14,15,33,26,0,DF,25-29,Defender,Germany,Europe
507345,Leonidas Stergiou,SUI,Stuttgart,Bundesliga,2023,21.0,2002.0,6.6,15,8,7,7,1,9,13,69.2,4,8,1,7,5,20,13,0,DF,20-24,Defender,Switzerland,Europe
134425,Raheem Sterling,ENG,Chelsea,Premier League,2023,28.0,1994.0,22.0,21,10,7,8,6,12,26,46.2,14,13,0,13,13,34,9,1,"FW,MF",25-29,Forward,England,Europe
106872,Kevin Stger,AUT,Bochum,Bundesliga,2023,29.0,1993.0,29.6,49,30,21,21,7,25,63,39.7,38,46,4,42,19,68,18,0,MF,25-29,Midfielder,Austria,Europe
186590,John Stones,ENG,Manchester City,Premier League,2023,29.0,1994.0,11.8,2,1,1,0,1,0,3,0.0,3,11,7,4,10,12,21,0,"DF,MF",25-29,Defender,England,Europe
457673,Gabriel Strefezza,BRA,Lecce,Serie A,2023,26.0,1997.0,12.4,24,17,8,7,9,14,20,70.0,6,17,0,17,7,31,11,0,FW,25-29,Forward,Brazil,South America
59323,Cristhian Stuani,URU,Girona,La Liga,2023,36.0,1986.0,8.9,14,11,4,6,4,4,7,57.1,3,9,2,7,5,19,13,0,FW,35-39,Forward,Uruguay,South America
76746,Damin Surez,URU,Getafe,La Liga,2023,35.0,1988.0,14.4,36,21,16,16,4,26,45,57.8,19,13,3,10,10,46,31,0,DF,35-39,Defender,Uruguay,South America
385105,Gabriel Suazo,CHI,Toulouse,Ligue 1,2023,25.0,1997.0,26.2,66,32,40,19,7,38,86,44.2,48,37,4,33,26,92,33,0,DF,25-29,Defender,Chile,South America
295331,Isaac Success,NGA,Udinese,Serie A,2023,27.0,1996.0,9.8,6,4,0,5,1,1,3,33.3,2,6,1,5,2,8,11,0,"FW,MF",25-29,Forward,Nigeria,Africa
166601,Niklas Sle,GER,Dortmund,Bundesliga,2023,27.0,1995.0,16.8,18,10,14,3,1,11,16,68.8,5,25,14,11,25,43,58,2,DF,25-29,Defender,Germany,Europe
982267,Ibrahim Sulemana,GHA,Cagliari,Serie A,2023,20.0,2003.0,14.9,36,14,15,15,6,17,27,63.0,10,24,5,19,7,43,23,0,MF,20-24,Midfielder,Ghana,Africa
764859,Williot Swedberg,SWE,Celta Vigo,La Liga,2023,19.0,2004.0,4.9,9,4,3,6,0,5,8,62.5,3,11,1,10,0,9,4,0,"FW,MF",Under 20,Forward,Sweden,Europe
220878,Issiaga Sylla,GUI,Montpellier,Ligue 1,2023,29.0,1994.0,16.2,28,17,20,6,2,16,34,47.1,18,21,7,14,23,51,53,0,"DF,FW",25-29,Defender,Guinea,Africa
451276,Dominik Szoboszlai,HUN,Liverpool,Premier League,2023,22.0,2000.0,23.4,32,19,12,12,8,16,50,32.0,34,37,2,35,15,47,16,1,MF,20-24,Midfielder,Hungary,Europe
131225,Nicols Tagliafico,ARG,Lyon,Ligue 1,2023,30.0,1992.0,23.6,54,34,23,22,9,22,49,44.9,27,25,8,17,28,82,43,0,DF,30-34,Defender,Argentina,South America
196357,Jonathan Tah,GER,Leverkusen,Bundesliga,2023,27.0,1996.0,29.2,19,9,10,7,2,5,16,31.3,11,28,23,5,23,42,97,1,DF,25-29,Defender,Germany,Europe
496706,Montassar Talbi,TUN,Lorient,Ligue 1,2023,25.0,1998.0,24.5,38,22,23,13,2,19,32,59.4,13,39,23,16,32,70,114,0,DF,25-29,Defender,Tunisia,Africa
564545,Edmond Tapsoba,BFA,Leverkusen,Bundesliga,2023,24.0,1999.0,23.2,34,25,17,15,2,17,24,70.8,7,21,10,11,24,58,52,3,DF,20-24,Defender,Burkina Faso,Africa
173504,James Tarkowski,ENG,Everton,Premier League,2023,30.0,1992.0,38.0,61,42,46,14,1,27,48,56.3,21,82,56,26,56,117,191,2,DF,30-34,Defender,England,Europe
535955,Nuno Tavares,POR,Nott'ham Forest,Premier League,2023,23.0,2000.0,5.1,11,7,9,1,1,8,9,88.9,1,6,0,6,1,12,21,0,DF,20-24,Defender,Portugal,Europe
195633,Charlie Taylor,ENG,Burnley,Premier League,2023,29.0,1993.0,25.9,35,20,19,14,2,17,35,48.6,18,27,11,16,19,54,78,0,DF,25-29,Defender,England,Europe
607226,Loum Tchaouna,FRA,Salernitana,Serie A,2023,19.0,2003.0,23.3,20,10,5,13,2,10,20,50.0,10,20,1,19,4,24,16,1,"FW,MF",Under 20,Forward,France,Europe
842338,Enzo Tchato,CMR,Montpellier,Ligue 1,2023,20.0,2002.0,12.5,26,17,18,4,4,11,25,44.0,14,20,7,13,11,37,25,0,DF,20-24,Defender,Cameroon,Africa
413112,Aurlien Tchouamni,FRA,Real Madrid,La Liga,2023,23.0,2000.0,22.1,38,23,19,17,2,9,18,50.0,9,21,13,8,28,66,52,1,"MF,DF",20-24,Midfielder,France,Europe
340322,Nathan Tella,NGA,Leverkusen,Bundesliga,2023,24.0,1999.0,9.1,13,8,6,5,2,5,10,50.0,5,10,0,10,3,16,8,0,"DF,MF",20-24,Defender,Nigeria,Africa
533568,Nahuel Tenaglia,ARG,Alavs,La Liga,2023,27.0,1996.0,12.7,29,19,22,4,3,16,28,57.1,12,14,8,6,12,41,59,0,DF,25-29,Defender,Argentina,South America
206746,Kenny Tete,NED,Fulham,Premier League,2023,27.0,1995.0,9.6,27,17,19,6,2,11,19,57.9,8,10,3,7,16,43,35,0,DF,25-29,Defender,Netherlands,Europe
306382,Benjamin Tetteh,GHA,Metz,Ligue 1,2023,26.0,1997.0,3.1,6,6,1,5,0,4,7,57.1,3,0,0,0,0,6,1,0,"FW,MF",25-29,Forward,Ghana,Africa
409153,Teddy Teuma,MLT,Reims,Ligue 1,2023,29.0,1993.0,23.5,54,36,19,21,14,25,62,40.3,37,33,4,29,20,74,6,0,MF,25-29,Midfielder,Malta,Europe
184892,Florian Thauvin,FRA,Udinese,Serie A,2023,30.0,1993.0,19.0,7,4,2,4,1,4,13,30.8,9,9,1,8,3,10,2,0,FW,30-34,Forward,France,Europe
368891,Arthur Theate,BEL,Rennes,Ligue 1,2023,23.0,2000.0,25.5,30,17,19,6,5,24,37,64.9,13,40,23,17,31,61,90,2,DF,20-24,Defender,Belgium,Europe
31599,Norman Theuerkauf,GER,Heidenheim,Bundesliga,2023,36.0,1987.0,14.0,24,16,13,7,4,13,22,59.1,9,16,6,10,14,38,21,0,"MF,DF",35-39,Midfielder,Germany,Europe
472249,Jan Thielmann,GER,Kln,Bundesliga,2023,21.0,2002.0,17.5,28,18,13,9,6,12,24,50.0,12,31,6,25,8,36,28,0,"FW,DF",20-24,Forward,Germany,Europe
505194,Luke Thomas,ENG,Sheffield Utd,Premier League,2023,22.0,2001.0,10.2,20,9,13,6,1,8,14,57.1,6,23,5,18,10,30,27,0,DF,20-24,Defender,England,Europe
215977,Adrien Thomasson,FRA,Lens,Ligue 1,2023,29.0,1993.0,13.3,25,14,4,16,5,11,34,32.4,23,14,0,14,9,34,10,1,MF,25-29,Midfielder,France,Europe
463618,Khphren Thuram,FRA,Nice,Ligue 1,2023,22.0,2001.0,23.4,42,29,13,23,6,20,40,50.0,20,21,10,11,18,60,37,0,MF,20-24,Midfielder,France,Europe
249565,Youri Tielemans,BEL,Aston Villa,Premier League,2023,26.0,1997.0,18.0,41,20,17,18,6,16,40,40.0,24,23,3,20,15,56,9,0,"MF,FW",25-29,Midfielder,Belgium,Europe
288340,Phillip Tietz,GER,Augsburg,Bundesliga,2023,26.0,1997.0,26.5,23,14,7,13,3,6,15,40.0,9,17,3,14,6,29,35,0,FW,25-29,Forward,Germany,Europe
296879,Steffen Tigges,GER,Kln,Bundesliga,2023,25.0,1998.0,8.1,10,6,4,5,1,3,7,42.9,4,4,2,2,1,11,12,0,FW,25-29,Forward,Germany,Europe
605184,Jean-Clair Todibo,FRA,Nice,Ligue 1,2023,23.0,1999.0,29.5,58,28,35,17,6,34,56,60.7,22,34,15,19,38,96,97,1,DF,20-24,Defender,France,Europe
198516,Harry Toffolo,ENG,Nott'ham Forest,Premier League,2023,27.0,1995.0,16.2,26,14,20,6,0,15,24,62.5,9,34,13,21,14,40,49,0,DF,25-29,Defender,England,Europe
569031,Umut Tohumcu,GER,Hoffenheim,Bundesliga,2023,18.0,2004.0,11.2,16,12,9,7,0,6,19,31.6,13,11,1,10,6,22,12,0,MF,Under 20,Midfielder,Germany,Europe
190393,Corentin Tolisso,FRA,Lyon,Ligue 1,2023,28.0,1994.0,19.3,33,21,13,11,9,14,33,42.4,19,26,9,17,10,43,18,0,MF,25-29,Midfielder,France,Europe
129674,Jeremy Toljan,GER,Sassuolo,Serie A,2023,28.0,1994.0,23.1,13,10,8,4,1,9,15,60.0,6,17,5,12,16,29,49,1,DF,25-29,Defender,Germany,Europe
616344,Tiago Toms,POR,Wolfsburg,Bundesliga,2023,21.0,2002.0,11.5,5,2,3,0,2,1,6,16.7,5,13,0,13,3,8,9,0,"FW,MF",20-24,Forward,Portugal,Europe
331560,Takehiro Tomiyasu,JPN,Arsenal,Premier League,2023,24.0,1998.0,12.8,20,9,15,4,1,11,18,61.1,7,10,4,6,18,38,33,0,DF,20-24,Defender,Japan,Asia
303254,Fikayo Tomori,ENG,Milan,Serie A,2023,25.0,1997.0,23.6,42,24,29,10,3,18,29,62.1,11,34,23,11,26,68,75,1,DF,25-29,Defender,England,Europe
397033,Sandro Tonali,ITA,Newcastle Utd,Premier League,2023,23.0,2000.0,4.9,7,7,4,2,1,3,9,33.3,6,3,0,3,2,9,4,0,MF,20-24,Midfielder,Italy,Europe
251664,Ivan Toney,ENG,Brentford,Premier League,2023,27.0,1996.0,16.1,15,5,2,7,6,6,14,42.9,8,5,1,4,10,25,18,0,FW,25-29,Forward,England,Europe
530902,Abdoulaye Tour,GUI,Le Havre,Ligue 1,2023,29.0,1994.0,25.4,47,28,22,22,3,30,60,50.0,30,30,8,22,25,72,33,0,MF,25-29,Midfielder,Guinea,Africa
353948,Lucas Tousart,FRA,Union Berlin,Bundesliga,2023,26.0,1997.0,17.5,35,20,14,17,4,17,37,45.9,20,32,9,23,25,60,41,0,MF,25-29,Midfielder,France,Europe
852024,Bnie Traor,CIV,Sheffield Utd,Premier League,2023,20.0,2002.0,4.3,4,2,1,2,1,0,4,0.0,4,4,1,3,1,5,1,0,"FW,MF",20-24,Forward,Ivory Coast,Africa
649020,Boubacar Traor,MLI,Wolves,Premier League,2023,21.0,2001.0,9.1,35,23,16,17,2,9,21,42.9,12,12,2,10,5,40,7,0,MF,20-24,Midfielder,Mali,Africa
297070,Hamari Traor,MLI,Real Sociedad,La Liga,2023,31.0,1992.0,25.5,44,19,24,17,3,25,43,58.1,18,27,8,19,24,68,59,2,DF,30-34,Defender,Mali,Africa
57216,Ismal Traor,CIV,Metz,Ligue 1,2023,36.0,1986.0,24.7,19,12,13,6,0,8,21,38.1,13,33,20,13,30,49,86,0,DF,35-39,Defender,Ivory Coast,Africa
388294,Omar Traor,GER,Heidenheim,Bundesliga,2023,25.0,1998.0,27.5,60,33,33,21,6,32,56,57.1,24,32,7,25,40,100,54,1,DF,25-29,Defender,Germany,Europe
75921,Christopher Trimmel,AUT,Union Berlin,Bundesliga,2023,36.0,1987.0,18.3,23,15,12,10,1,13,33,39.4,20,16,3,13,13,36,57,0,DF,35-39,Defender,Austria,Europe
95810,Kieran Trippier,ENG,Newcastle Utd,Premier League,2023,32.0,1990.0,24.8,57,27,30,16,11,37,77,48.1,40,41,8,33,24,81,57,3,DF,30-34,Defender,England,Europe
144028,Leandro Trossard,BEL,Arsenal,Premier League,2023,28.0,1994.0,18.3,27,16,8,9,10,9,25,36.0,16,27,1,26,8,35,6,0,"FW,MF",25-29,Forward,Belgium,Europe
654539,Adrien Truffert,FRA,Rennes,Ligue 1,2023,21.0,2001.0,23.8,39,21,23,10,6,25,40,62.5,15,31,5,26,19,58,49,0,DF,20-24,Defender,France,Europe
546213,Tuta,BRA,Eint Frankfurt,Bundesliga,2023,24.0,1999.0,28.9,63,33,38,19,6,39,59,66.1,20,29,12,17,36,99,99,0,DF,20-24,Defender,Brazil,South America
556385,Destiny Udogie,ITA,Tottenham,Premier League,2023,20.0,2002.0,26.6,68,33,41,16,11,27,49,55.1,22,27,8,19,37,105,80,5,DF,20-24,Defender,Italy,Europe
339314,Deniz Undav,GER,Stuttgart,Bundesliga,2023,27.0,1996.0,23.2,28,13,6,8,14,4,15,26.7,11,17,0,17,6,34,5,0,"FW,MF",25-29,Forward,Germany,Europe
344695,Dayot Upamecano,FRA,Bayern Munich,Bundesliga,2023,24.0,1998.0,19.6,34,21,21,11,2,15,29,51.7,14,19,7,12,19,53,56,3,DF,20-24,Defender,France,Europe
315289,Myrto Uzuni,ALB,Granada,La Liga,2023,28.0,1995.0,27.2,18,14,8,7,3,6,27,22.2,21,19,3,16,4,22,7,0,FW,25-29,Forward,Albania,Europe
448258,Josha Vagnoman,GER,Stuttgart,Bundesliga,2023,22.0,2000.0,13.1,28,18,15,11,2,15,30,50.0,15,11,5,6,2,30,16,1,DF,20-24,Defender,Germany,Europe
445126,Emanuele Valeri,ITA,Frosinone,Serie A,2023,24.0,1998.0,13.1,19,16,10,5,4,10,21,47.6,11,14,3,11,9,28,22,0,DF,20-24,Defender,Italy,Europe
369081,Federico Valverde,URU,Real Madrid,La Liga,2023,25.0,1998.0,32.3,47,34,22,13,12,24,42,57.1,18,39,2,37,43,90,40,0,MF,25-29,Midfielder,Uruguay,South America
139208,Virgil van Dijk,NED,Liverpool,Premier League,2023,32.0,1991.0,35.3,40,23,24,13,3,12,14,85.7,2,47,34,13,39,79,144,0,DF,30-34,Defender,Netherlands,Europe
789082,Vanderson,BRA,Monaco,Ligue 1,2023,22.0,2001.0,18.2,60,41,20,30,10,32,70,45.7,38,29,2,27,35,95,37,1,DF,20-24,Defender,Brazil,South America
532937,Johan Vsquez,MEX,Genoa,Serie A,2023,24.0,1998.0,31.7,51,33,38,11,2,32,50,64.0,18,50,26,24,45,96,113,0,DF,20-24,Defender,Mexico,North America
111195,Jol Veltman,NED,Brighton,Premier League,2023,31.0,1992.0,17.6,54,41,32,17,5,39,58,67.2,19,17,7,10,18,72,57,1,DF,30-34,Defender,Netherlands,Europe
240219,Lorenzo Venuti,ITA,Lecce,Serie A,2023,28.0,1995.0,4.0,6,4,5,1,0,6,10,60.0,4,4,3,1,5,11,14,0,DF,25-29,Defender,Italy,Europe
164771,Jordan Veretout,FRA,Marseille,Ligue 1,2023,30.0,1993.0,24.3,38,22,19,13,6,18,39,46.2,21,20,4,16,13,51,25,0,MF,30-34,Midfielder,France,Europe
409517,Yorbe Vertessen,BEL,Union Berlin,Bundesliga,2023,22.0,2001.0,6.6,3,2,0,3,0,1,4,25.0,3,8,0,8,1,4,3,0,"FW,MF",20-24,Forward,Belgium,Europe
650966,Samuele Vignato,ITA,Monza,Serie A,2023,19.0,2004.0,3.8,6,4,2,3,1,2,3,66.7,1,2,0,2,1,7,1,0,"MF,FW",Under 20,Midfielder,Italy,Europe
673071,Oscar Vilhelmsson,SWE,Darmstadt 98,Bundesliga,2023,19.0,2003.0,15.3,13,6,3,7,3,7,10,70.0,3,15,5,10,3,16,19,0,"FW,MF",Under 20,Forward,Sweden,Europe
525287,Carlos Vincius,BRA,Fulham,Premier League,2023,28.0,1995.0,3.5,3,2,0,1,2,0,4,0.0,4,4,0,4,0,3,1,0,FW,25-29,Forward,Brazil,South America
85393,Nicolas Viola,ITA,Cagliari,Serie A,2023,33.0,1989.0,13.4,13,9,2,8,3,7,17,41.2,10,9,0,9,2,15,6,0,"MF,FW",30-34,Midfielder,Italy,Europe
586853,Vitinha,POR,Genoa,Serie A,2023,23.0,2000.0,3.2,2,2,1,0,1,1,2,50.0,1,2,0,2,0,2,2,0,"FW,MF",20-24,Forward,Portugal,Europe
834898,Vitinho,BRA,Burnley,Premier League,2023,24.0,1999.0,25.7,64,34,36,22,6,43,86,50.0,43,44,6,38,12,76,47,4,"DF,MF",20-24,Defender,Brazil,South America
293200,Nikola Vlai,CRO,Torino,Serie A,2023,25.0,1997.0,29.0,28,16,6,14,8,4,30,13.3,26,26,7,19,11,39,16,0,"MF,FW",25-29,Midfielder,Croatia,Europe
82009,Kevin Volland,GER,Union Berlin,Bundesliga,2023,31.0,1992.0,14.9,22,9,8,8,6,8,20,40.0,12,8,0,8,6,28,12,0,"FW,MF",30-34,Forward,Germany,Europe
746891,Cristian Volpato,ITA,Sassuolo,Serie A,2023,19.0,2003.0,7.2,16,8,9,6,1,9,25,36.0,16,7,0,7,1,17,5,0,"MF,FW",Under 20,Midfielder,Italy,Europe
503881,Aster Vranckx,BEL,Wolfsburg,Bundesliga,2023,20.0,2002.0,12.8,32,15,11,11,10,15,28,53.6,13,17,6,11,14,46,29,0,MF,20-24,Midfielder,Belgium,Europe
111196,Stefan de Vrij,NED,Inter,Serie A,2023,31.0,1992.0,17.6,18,13,13,4,1,8,15,53.3,7,22,10,12,24,42,51,0,DF,30-34,Defender,Netherlands,Europe
323954,Walace,BRA,Udinese,Serie A,2023,28.0,1995.0,36.0,66,43,40,26,0,36,77,46.8,41,43,6,37,43,109,66,1,MF,25-29,Midfielder,Brazil,South America
196095,Luca Waldschmidt,GER,Kln,Bundesliga,2023,27.0,1996.0,12.7,19,12,4,12,3,5,16,31.3,11,18,3,15,6,25,8,1,"MF,FW",25-29,Midfielder,Germany,Europe
95424,Kyle Walker,ENG,Manchester City,Premier League,2023,33.0,1990.0,30.7,38,24,19,17,2,19,39,48.7,20,19,6,13,27,65,40,1,DF,30-34,Defender,England,Europe
477758,Aaron Wan-Bissaka,ENG,Manchester Utd,Premier League,2023,25.0,1997.0,19.8,42,25,18,20,4,19,26,73.1,7,29,15,14,41,83,68,1,DF,25-29,Defender,England,Europe
181579,James Ward-Prowse,ENG,West Ham,Premier League,2023,28.0,1994.0,33.3,45,29,14,23,8,18,44,40.9,26,31,9,22,38,83,49,0,MF,25-29,Midfielder,England,Europe
324358,Ollie Watkins,ENG,Aston Villa,Premier League,2023,27.0,1995.0,35.7,12,7,0,5,7,5,11,45.5,6,26,4,22,4,16,20,0,FW,25-29,Forward,England,Europe
370846,Timothy Weah,USA,Juventus,Serie A,2023,23.0,2000.0,14.0,27,20,16,8,3,15,20,75.0,5,12,1,11,5,32,15,0,"DF,FW",20-24,Defender,United States,North America
196792,Julian Weigl,GER,Gladbach,Bundesliga,2023,27.0,1995.0,30.7,66,40,28,32,6,41,67,61.2,26,47,14,33,48,114,61,1,MF,25-29,Midfielder,Germany,Europe
392163,Noah Weihaupt,GER,Freiburg,Bundesliga,2023,21.0,2001.0,8.4,9,4,6,0,3,5,11,45.5,6,8,1,7,8,17,12,0,"DF,FW",20-24,Defender,Germany,Europe
67063,Danny Welbeck,ENG,Brighton,Premier League,2023,32.0,1990.0,18.8,35,17,9,17,9,10,17,58.8,7,12,0,12,9,44,17,1,"FW,MF",30-34,Forward,England,Europe
744149,Adam Wharton,ENG,Crystal Palace,Premier League,2023,19.0,2004.0,14.4,48,32,18,22,8,23,46,50.0,23,17,3,14,20,68,24,1,MF,Under 20,Midfielder,England,Europe
335721,Ben White,ENG,Arsenal,Premier League,2023,25.0,1997.0,33.2,48,28,20,22,6,26,58,44.8,32,48,22,26,32,80,77,1,DF,25-29,Defender,England,Europe
168989,Silvan Widmer,SUI,Mainz 05,Bundesliga,2023,30.0,1993.0,13.8,23,10,12,8,3,17,28,60.7,11,18,5,13,16,39,37,0,DF,30-34,Defender,Switzerland,Europe
255508,Iaki Williams,GHA,Athletic Club,La Liga,2023,29.0,1994.0,31.6,24,17,6,8,10,13,34,38.2,21,42,8,34,14,38,29,0,FW,25-29,Forward,Ghana,Africa
503680,Neco Williams,WAL,Nott'ham Forest,Premier League,2023,22.0,2001.0,18.2,69,40,42,18,9,35,56,62.5,21,44,13,31,22,91,53,0,DF,20-24,Defender,Wales,Europe
55338,Willian,BRA,Fulham,Premier League,2023,34.0,1988.0,22.8,18,11,6,7,5,3,21,14.3,18,13,0,13,9,27,12,1,FW,30-34,Forward,Brazil,South America
340329,Joe Willock,ENG,Newcastle Utd,Premier League,2023,23.0,1999.0,4.7,13,7,7,6,0,4,11,36.4,7,7,0,7,1,14,1,0,MF,20-24,Midfielder,England,Europe
450826,Callum Wilson,ENG,Newcastle Utd,Premier League,2023,31.0,1992.0,11.0,5,3,0,2,3,0,4,0.0,4,6,0,6,2,7,4,0,FW,30-34,Forward,England,Europe
279455,Harry Wilson,WAL,Fulham,Premier League,2023,26.0,1997.0,18.0,21,14,9,8,4,11,28,39.3,17,27,3,24,10,31,12,0,FW,25-29,Forward,Wales,Europe
576121,Josh Wilson-Esbrand,ENG,Reims,Ligue 1,2023,20.0,2002.0,5.1,5,4,2,3,0,2,8,25.0,6,5,2,3,6,11,7,0,"DF,MF",20-24,Defender,England,Europe
533295,Patrick Wimmer,AUT,Wolfsburg,Bundesliga,2023,22.0,2001.0,6.5,14,5,5,5,4,8,18,44.4,10,14,0,14,3,17,7,0,"FW,MF",20-24,Forward,Austria,Europe
391004,Jonas Wind,DEN,Wolfsburg,Bundesliga,2023,24.0,1999.0,29.5,13,10,4,6,3,7,17,41.2,10,13,4,9,3,16,21,0,FW,20-24,Forward,Denmark,Europe
598577,Florian Wirtz,GER,Leverkusen,Bundesliga,2023,20.0,2003.0,26.4,27,18,7,14,6,9,29,31.0,20,36,2,34,9,36,3,0,MF,20-24,Midfielder,Germany,Europe
388165,Yoane Wissa,COD,Brentford,Premier League,2023,26.0,1996.0,27.7,28,16,13,10,5,5,20,25.0,15,24,3,21,9,37,15,0,FW,25-29,Forward,DR Congo,Africa
35047,Axel Witsel,BEL,Atltico Madrid,La Liga,2023,34.0,1989.0,30.9,35,21,23,12,0,17,24,70.8,7,40,21,19,16,51,119,0,DF,30-34,Defender,Belgium,Europe
455661,Nick Woltemade,GER,Werder Bremen,Bundesliga,2023,21.0,2002.0,13.2,34,23,7,20,7,15,21,71.4,6,12,0,12,5,39,17,0,"FW,MF",20-24,Forward,Germany,Europe
108725,Chris Wood,NZL,Nott'ham Forest,Premier League,2023,31.0,1991.0,20.1,7,4,1,4,2,3,9,33.3,6,11,3,8,1,8,26,0,FW,30-34,Forward,New Zealand,Oceania
169801,Cauley Woodrow,ENG,Luton Town,Premier League,2023,28.0,1994.0,4.7,16,10,8,4,4,9,16,56.3,7,7,1,6,1,17,14,0,"FW,MF",25-29,Forward,England,Europe
572326,Christopher Wooh,CMR,Rennes,Ligue 1,2023,21.0,2001.0,15.4,18,12,12,6,0,8,15,53.3,7,19,9,10,18,36,51,0,DF,20-24,Defender,Cameroon,Africa
111455,Granit Xhaka,SUI,Leverkusen,Bundesliga,2023,30.0,1992.0,31.3,29,21,11,14,4,9,30,30.0,21,29,8,21,19,48,42,0,MF,30-34,Midfielder,Switzerland,Europe
425902,Ryan Yates,ENG,Nott'ham Forest,Premier League,2023,25.0,1997.0,22.1,66,39,39,21,6,19,34,55.9,15,42,15,27,21,87,44,1,MF,25-29,Midfielder,England,Europe
589737,Kelvin Yeboah,ITA,Montpellier,Ligue 1,2023,23.0,2000.0,3.1,4,2,2,2,0,1,3,33.3,2,3,2,1,1,5,3,0,FW,20-24,Forward,Italy,Europe
672803,Bertu Yldrm,TUR,Rennes,Ligue 1,2023,21.0,2002.0,5.2,7,5,2,3,2,3,8,37.5,5,8,0,8,0,7,4,0,FW,20-24,Forward,Turkey,Asia
845654,Kenan Yldz,TUR,Juventus,Serie A,2023,18.0,2005.0,10.6,13,9,5,6,2,4,8,50.0,4,6,0,6,1,14,4,0,"FW,MF",Under 20,Forward,Turkey,Asia
717118,Darlin Yongwa,CMR,Lorient,Ligue 1,2023,22.0,2000.0,12.9,30,23,17,11,2,14,25,56.0,11,14,2,12,15,45,36,0,DF,20-24,Defender,Cameroon,Africa
923831,Leny Yoro,FRA,Lille,Ligue 1,2023,17.0,2005.0,29.7,36,25,27,7,2,17,31,54.8,14,20,14,6,36,72,97,1,DF,Under 20,Defender,France,Europe
14086,Ashley Young,ENG,Everton,Premier League,2023,38.0,1985.0,25.3,53,38,28,19,6,30,54,55.6,24,24,6,18,22,75,50,3,"DF,MF",35-39,Defender,England,Europe
344598,Dan-Axel Zagadou,FRA,Stuttgart,Bundesliga,2023,24.0,1999.0,16.1,21,14,16,5,0,4,8,50.0,4,23,18,5,20,41,78,1,DF,20-24,Defender,France,Europe
810092,Warren Zare-Emery,FRA,Paris S-G,Ligue 1,2023,17.0,2006.0,21.8,51,28,18,24,9,28,51,54.9,23,32,8,24,15,66,22,2,"MF,DF",Under 20,Midfielder,France,Europe
334526,Denis Zakaria,SUI,Monaco,Ligue 1,2023,26.0,1996.0,23.7,38,27,11,20,7,12,30,40.0,18,39,13,26,47,85,41,0,"MF,DF",25-29,Midfielder,Switzerland,Europe
555143,Arsen Zakharyan,RUS,Real Sociedad,La Liga,2023,20.0,2003.0,13.6,22,15,8,11,3,9,22,40.9,13,16,0,16,4,26,10,0,"MF,FW",20-24,Midfielder,Russia,Europe
392085,Nicol Zaniolo,ITA,Aston Villa,Premier League,2023,24.0,1999.0,9.3,19,9,10,7,2,9,17,52.9,8,13,0,13,1,20,11,0,"FW,MF",20-24,Forward,Italy,Europe
73794,Duvn Zapata,COL,Torino,Serie A,2023,32.0,1991.0,32.0,18,7,9,2,7,3,12,25.0,9,20,6,14,7,25,26,0,FW,30-34,Forward,Colombia,South America
392569,Gabriele Zappa,ITA,Cagliari,Serie A,2023,23.0,1999.0,28.5,54,31,29,16,9,29,41,70.7,12,29,5,24,20,74,75,2,DF,20-24,Defender,Italy,Europe
173859,Davide Zappacosta,ITA,Atalanta,Serie A,2023,31.0,1992.0,20.7,30,20,15,10,5,16,34,47.1,18,29,4,25,5,35,19,0,DF,30-34,Defender,Italy,Europe
491296,Anass Zaroury,MAR,Burnley,Premier League,2023,22.0,2000.0,1.7,1,0,1,0,0,0,4,0.0,4,2,0,2,0,1,1,1,"FW,MF",20-24,Forward,Morocco,Africa
633530,Jordan Zemura,ZIM,Udinese,Serie A,2023,23.0,1999.0,11.5,24,16,13,7,4,11,19,57.9,8,5,1,4,13,37,21,0,DF,20-24,Defender,Zimbabwe,Africa
433584,Alessio Zerbin,ITA,Monza,Serie A,2023,24.0,1999.0,7.6,18,10,13,2,3,4,13,30.8,9,16,3,13,3,21,5,0,"DF,FW",20-24,Defender,Italy,Europe
77812,Christoph Zimmermann,GER,Darmstadt 98,Bundesliga,2023,30.0,1993.0,13.6,33,21,26,7,0,19,39,48.7,20,21,14,7,21,54,66,1,DF,30-34,Defender,Germany,Europe
203853,Oleksandr Zinchenko,UKR,Arsenal,Premier League,2023,26.0,1996.0,19.1,50,30,19,24,7,35,52,67.3,17,18,3,15,20,70,26,2,DF,25-29,Defender,Ukraine,Europe
435648,Joshua Zirkzee,NED,Bologna,Serie A,2023,22.0,2001.0,30.7,32,20,8,15,9,13,24,54.2,11,25,2,23,3,35,36,0,FW,20-24,Forward,Netherlands,Europe
392966,Nadir Zortea,ITA,Frosinone,Serie A,2023,24.0,1999.0,14.0,21,14,8,13,0,10,22,45.5,12,13,5,8,4,25,29,1,DF,20-24,Defender,Italy,Europe
157509,Kurt Zouma,FRA,West Ham,Premier League,2023,28.0,1994.0,31.5,23,17,14,9,0,10,16,62.5,6,38,28,10,29,52,160,0,DF,25-29,Defender,France,Europe
892973,Lovro Zvonarek,CRO,Bayern Munich,Bundesliga,2023,18.0,2005.0,1.8,0,0,0,0,0,0,5,0.0,5,3,0,3,0,0,2,0,"FW,MF",Under 20,Forward,Croatia,Europe
356197,Alfonso Pedraza,ESP,Villarreal,La Liga,2023,27.0,1996.0,12.4,25,9,18,5,2,9,17,52.9,8,16,7,9,13,38,19,0,DF,25-29,Defender,Spain,Europe
683840,Pedri,ESP,Barcelona,La Liga,2023,20.0,2002.0,16.4,33,24,16,13,4,8,27,29.6,19,27,3,24,14,47,10,0,"MF,FW",20-24,Midfielder,Spain,Europe
1004741,Pedro,ESP,Lazio,Serie A,2023,36.0,1987.0,9.1,16,12,5,7,4,3,12,25.0,9,16,2,14,3,19,1,0,"FW,MF",35-39,Forward,Spain,Europe
501418,Adri Pedrosa,ESP,Sevilla,La Liga,2023,25.0,1998.0,19.5,46,26,28,14,4,23,34,67.6,11,26,6,20,15,61,54,0,DF,25-29,Defender,Spain,Europe
534379,Pejio,ESP,Las Palmas,La Liga,2023,27.0,1996.0,5.6,12,8,3,6,3,6,18,33.3,12,4,0,4,2,14,5,0,FW,25-29,Forward,Spain,Europe
238868,Rubn Pea,ESP,Osasuna,La Liga,2023,32.0,1991.0,23.2,47,25,22,18,7,20,49,40.8,29,37,8,29,30,77,39,3,"DF,FW",30-34,Defender,Spain,Europe
246968,Ayoze Prez,ESP,Betis,La Liga,2023,30.0,1993.0,25.5,59,32,16,33,10,21,49,42.9,28,42,4,38,22,81,18,0,FW,30-34,Forward,Spain,Europe
282810,Carles Prez,ESP,Celta Vigo,La Liga,2023,25.0,1998.0,8.6,13,5,6,5,2,7,18,38.9,11,14,1,13,5,18,8,0,"MF,DF",25-29,Midfielder,Spain,Europe
527698,Kike Prez,ESP,Rayo Vallecano,La Liga,2023,26.0,1997.0,9.3,27,11,11,15,1,11,23,47.8,12,11,0,11,8,35,6,0,"MF,FW",25-29,Midfielder,Spain,Europe
553875,Pedro Porro,ESP,Tottenham,Premier League,2023,23.0,1999.0,34.3,91,63,43,34,14,62,120,51.7,58,63,18,45,34,125,102,3,DF,20-24,Defender,Spain,Europe
99353,Portu,ESP,Getafe,La Liga,2023,31.0,1992.0,1.1,5,3,4,0,1,5,6,83.3,1,0,0,0,0,5,0,0,FW,30-34,Forward,Spain,Europe
625047,Beat Prados,ESP,Athletic Club,La Liga,2023,22.0,2001.0,16.1,45,28,11,23,11,23,42,54.8,19,32,5,27,23,68,27,0,"MF,DF",20-24,Midfielder,Spain,Europe
177452,Abdn Prats,ESP,Mallorca,La Liga,2023,30.0,1992.0,14.1,6,4,2,2,2,3,5,60.0,2,6,3,3,2,8,12,0,"FW,MF",30-34,Forward,Spain,Europe
262365,Antonio Puertas,ESP,Granada,La Liga,2023,31.0,1992.0,8.1,12,8,6,5,1,6,15,40.0,9,5,0,5,6,18,4,0,"MF,FW",30-34,Midfielder,Spain,Europe
245078,Nemanja Radonji,SRB,Torino,Serie A,2023,27.0,1996.0,4.2,1,1,0,0,1,1,3,33.3,2,3,0,3,0,1,0,0,"MF,FW",25-29,Midfielder,Serbia,Europe
282672,Benito Ramrez,ESP,Las Palmas,La Liga,2023,28.0,1995.0,4.3,5,3,2,3,0,3,6,50.0,3,7,1,6,3,8,0,0,"FW,MF",25-29,Forward,Spain,Europe
199369,Sandro Ramrez,ESP,Las Palmas,La Liga,2023,28.0,1995.0,20.1,12,8,4,6,2,6,15,40.0,9,13,1,12,4,16,14,1,FW,25-29,Forward,Spain,Europe
538810,Chris Ramos,ESP,Cdiz,La Liga,2023,26.0,1997.0,29.0,28,15,9,15,4,8,27,29.6,19,23,7,16,9,37,44,0,"FW,MF",25-29,Forward,Spain,Europe
25557,Sergio Ramos,ESP,Sevilla,La Liga,2023,37.0,1986.0,28.0,45,30,32,11,2,27,40,67.5,13,35,30,5,41,86,156,0,DF,35-39,Defender,Spain,Europe
249513,Diego Rico,ESP,Getafe,La Liga,2023,30.0,1993.0,28.2,64,48,32,23,9,41,76,53.9,35,25,8,17,41,105,76,0,DF,30-34,Defender,Spain,Europe
278837,Luis Rioja,ESP,Alavs,La Liga,2023,29.0,1993.0,27.8,27,19,10,12,5,14,43,32.6,29,28,1,27,16,43,28,0,"FW,MF",25-29,Forward,Spain,Europe
461617,Rodrigo Riquelme,ESP,Atltico Madrid,La Liga,2023,23.0,2000.0,17.0,30,19,18,4,8,18,46,39.1,28,19,0,19,9,39,20,0,"DF,MF",20-24,Defender,Spain,Europe
85370,Sergi Roberto,ESP,Barcelona,La Liga,2023,31.0,1992.0,9.6,15,10,4,10,1,3,11,27.3,8,7,2,5,8,23,7,1,"MF,DF",30-34,Midfielder,Spain,Europe
834470,Dani Rodrguez,ESP,Mallorca,La Liga,2023,35.0,1988.0,29.1,47,24,21,20,6,21,45,46.7,24,34,5,29,15,62,21,0,MF,35-39,Midfielder,Spain,Europe
566574,Kirian Rodrguez,ESP,Las Palmas,La Liga,2023,27.0,1996.0,35.7,52,32,22,25,5,24,67,35.8,43,39,3,36,28,80,23,1,MF,25-29,Midfielder,Spain,Europe
709372,Carlos Romero,ESP,Villarreal,La Liga,2023,21.0,2001.0,2.9,11,5,8,1,2,7,12,58.3,5,3,0,3,1,12,11,0,DF,20-24,Defender,Spain,Europe
687609,Isaac Romero,ESP,Sevilla,La Liga,2023,23.0,2000.0,11.5,6,3,2,2,2,5,9,55.6,4,12,0,12,0,6,11,0,FW,20-24,Forward,Spain,Europe
66100,Oriol Romeu,ESP,Barcelona,La Liga,2023,31.0,1991.0,10.4,34,20,17,14,3,13,24,54.2,11,12,2,10,10,44,18,0,MF,30-34,Midfielder,Spain,Europe
378139,Aitor Ruibal,ESP,Betis,La Liga,2023,27.0,1996.0,11.3,46,27,28,13,5,32,59,54.2,27,12,1,11,14,60,33,1,"DF,FW",25-29,Defender,Spain,Europe
394694,Sergio Ruiz,ESP,Granada,La Liga,2023,28.0,1994.0,27.7,83,46,43,36,4,38,84,45.2,46,24,6,18,28,111,43,1,MF,25-29,Midfielder,Spain,Europe
370789,Julian Ryerson,NOR,Dortmund,Bundesliga,2023,25.0,1997.0,19.6,41,23,26,11,4,27,47,57.4,20,31,7,24,10,51,35,3,DF,25-29,Defender,Norway,Europe
766583,Kike Salas,ESP,Sevilla,La Liga,2023,21.0,2002.0,17.8,41,23,26,12,3,22,36,61.1,14,25,14,11,26,67,91,1,DF,20-24,Defender,Spain,Europe
307519,Fede San Emeterio,ESP,Cdiz,La Liga,2023,26.0,1997.0,1.7,3,2,2,1,0,1,4,25.0,3,3,2,1,2,5,1,0,MF,25-29,Midfielder,Spain,Europe
571020,Oihan Sancet,ESP,Athletic Club,La Liga,2023,23.0,2000.0,21.9,19,11,3,10,6,8,21,38.1,13,5,1,4,10,29,5,0,MF,20-24,Midfielder,Spain,Europe
513031,Antonio Snchez,ESP,Mallorca,La Liga,2023,26.0,1997.0,16.1,25,11,13,10,2,11,32,34.4,21,24,5,19,13,38,13,0,MF,25-29,Midfielder,Spain,Europe
676042,Juanlu Snchez,ESP,Sevilla,La Liga,2023,19.0,2003.0,13.1,56,35,34,18,4,34,58,58.6,24,24,7,17,12,68,36,0,DF,Under 20,Defender,Spain,Europe
74230,Pablo Sarabia,ESP,Wolves,Premier League,2023,31.0,1992.0,19.4,20,13,8,8,4,12,36,33.3,24,17,1,16,10,30,9,0,"MF,FW",30-34,Midfielder,Spain,Europe
242086,Patrik Schick,CZE,Leverkusen,Bundesliga,2023,27.0,1996.0,11.8,6,4,0,3,3,1,5,20.0,4,2,0,2,1,7,7,0,FW,25-29,Forward,Czech Republic,Europe
237499,Aleksandar Sedlar,SRB,Alavs,La Liga,2023,31.0,1991.0,10.5,14,10,10,4,0,10,16,62.5,6,8,4,4,13,27,43,0,DF,30-34,Defender,Serbia,Europe
85383,Rubn Sobrino,ESP,Cdiz,La Liga,2023,31.0,1992.0,18.3,52,28,18,26,8,22,51,43.1,29,26,2,24,16,68,18,0,"MF,FW",30-34,Midfielder,Spain,Europe
372246,Carlos Soler,ESP,Paris S-G,Ligue 1,2023,26.0,1997.0,12.1,15,10,9,2,4,6,21,28.6,15,10,3,7,5,20,11,1,"MF,DF",25-29,Midfielder,Spain,Europe
892221,Hugo Sotelo,ESP,Celta Vigo,La Liga,2023,19.0,2003.0,8.0,19,17,3,13,3,8,20,40.0,12,7,1,6,2,21,5,0,MF,Under 20,Midfielder,Spain,Europe
429983,Jrgen Strand Larsen,NOR,Celta Vigo,La Liga,2023,23.0,2000.0,31.8,21,11,1,15,5,8,38,21.1,30,15,1,14,5,26,17,0,FW,20-24,Forward,Norway,Europe
111961,Suso,ESP,Sevilla,La Liga,2023,29.0,1993.0,16.9,24,17,14,8,2,8,28,28.6,20,9,0,9,5,29,4,0,"MF,FW",25-29,Midfielder,Spain,Europe
238407,Alexander Srloth,NOR,Villarreal,La Liga,2023,27.0,1995.0,27.7,6,3,1,2,3,2,6,33.3,4,9,4,5,0,6,26,0,FW,25-29,Forward,Norway,Europe
226524,Morten Thorsby,NOR,Genoa,Serie A,2023,27.0,1996.0,12.9,19,11,9,8,2,7,14,50.0,7,21,5,16,4,23,20,0,MF,25-29,Midfielder,Norway,Europe
564785,Kristian Thorstvedt,NOR,Sassuolo,Serie A,2023,24.0,1999.0,26.6,40,22,7,28,5,22,44,50.0,22,25,9,16,21,61,36,0,MF,20-24,Midfielder,Norway,Europe
720038,Pablo Torre,ESP,Girona,La Liga,2023,20.0,2003.0,7.8,5,2,0,5,0,4,10,40.0,6,10,2,8,4,9,6,1,"MF,FW",20-24,Midfielder,Spain,Europe
214775,liver Torres,ESP,Sevilla,La Liga,2023,28.0,1994.0,18.0,37,22,17,15,5,22,57,38.6,35,40,4,36,6,43,6,0,MF,25-29,Midfielder,Spain,Europe
399776,Pau Torres,ESP,Aston Villa,Premier League,2023,26.0,1997.0,27.4,29,18,17,11,1,14,30,46.7,16,28,12,16,14,43,75,0,DF,25-29,Defender,Spain,Europe
213670,Lucas Torr,ESP,Osasuna,La Liga,2023,29.0,1994.0,19.9,25,15,11,8,6,11,28,39.3,17,10,2,8,33,58,37,0,MF,25-29,Midfielder,Spain,Europe
364405,Adama Traor,ESP,Fulham,Premier League,2023,27.0,1996.0,4.2,4,3,1,2,1,3,6,50.0,3,2,0,2,1,5,2,0,"FW,MF",25-29,Forward,Spain,Europe
634431,Beat Turrientes,ESP,Real Sociedad,La Liga,2023,21.0,2002.0,18.7,31,17,6,20,5,13,30,43.3,17,19,8,11,6,37,17,0,MF,20-24,Midfielder,Spain,Europe
699442,Kacper Urbanski,POL,Bologna,Serie A,2023,18.0,2004.0,10.3,16,10,5,10,1,6,13,46.2,7,15,1,14,4,20,14,0,"MF,FW",Under 20,Midfielder,Poland,Europe
517753,scar Valentn,ESP,Rayo Vallecano,La Liga,2023,28.0,1994.0,29.9,107,66,39,62,6,46,101,45.5,55,62,10,52,35,142,52,1,MF,25-29,Midfielder,Spain,Europe
221315,Kevin Vzquez,ESP,Celta Vigo,La Liga,2023,30.0,1993.0,7.8,15,13,7,7,1,12,21,57.1,9,11,3,8,5,20,25,0,DF,30-34,Defender,Spain,Europe
221316,Lucas Vzquez,ESP,Real Madrid,La Liga,2023,32.0,1991.0,15.8,37,25,22,14,1,18,25,72.0,7,27,5,22,12,49,36,0,DF,30-34,Defender,Spain,Europe
540536,Carlos Vicente,ESP,Alavs,La Liga,2023,24.0,1999.0,12.4,16,6,7,7,2,10,25,40.0,15,4,0,4,4,20,9,0,FW,20-24,Forward,Spain,Europe
216870,Nacho Vidal,ESP,Osasuna,La Liga,2023,28.0,1995.0,1.1,5,4,2,2,1,2,5,40.0,3,2,0,2,0,5,6,0,"DF,FW",25-29,Defender,Spain,Europe
153238,Jonathan Viera,ESP,Las Palmas,La Liga,2023,33.0,1989.0,6.9,6,3,1,2,3,1,9,11.1,8,0,0,0,0,6,1,0,"MF,FW",30-34,Midfielder,Spain,Europe
251897,Asier Villalibre,ESP,Athletic Club,La Liga,2023,25.0,1997.0,5.7,2,1,0,0,2,2,2,100.0,0,2,1,1,0,2,6,0,FW,25-29,Forward,Spain,Europe
398163,Gonzalo Villar,ESP,Granada,La Liga,2023,25.0,1998.0,20.0,51,33,26,20,5,26,41,63.4,15,32,10,22,6,57,26,1,MF,25-29,Midfielder,Spain,Europe
357498,Duan Vlahovi,SRB,Juventus,Serie A,2023,23.0,2000.0,25.6,9,5,0,6,3,4,11,36.4,7,4,2,2,1,10,11,0,FW,20-24,Forward,Serbia,Europe
345458,Sebastian Walukiewicz,POL,Empoli,Serie A,2023,23.0,2000.0,22.8,39,28,33,6,0,28,41,68.3,13,50,31,19,15,54,121,0,DF,20-24,Defender,Poland,Europe
709187,Nico Williams,ESP,Athletic Club,La Liga,2023,21.0,2002.0,25.1,31,12,9,15,7,13,36,36.1,23,18,2,16,3,34,4,1,FW,20-24,Forward,Spain,Europe
937958,Lamine Yamal,ESP,Barcelona,La Liga,2023,16.0,2007.0,24.5,61,37,32,15,14,18,48,37.5,30,32,0,32,19,80,11,0,FW,Under 20,Forward,Spain,Europe
550108,Nicola Zalewski,POL,Roma,Serie A,2023,21.0,2002.0,10.8,20,14,10,9,1,8,22,36.4,14,12,4,8,9,29,17,0,"DF,FW",20-24,Defender,Poland,Europe
713644,Bryan Zaragoza,ESP,Granada,La Liga,2023,22.0,2001.0,18.2,18,9,8,6,4,8,23,34.8,15,9,0,9,3,21,3,0,"MF,FW",20-24,Midfielder,Spain,Europe
524010,Oier Zarraga,ESP,Udinese,Serie A,2023,24.0,1999.0,4.5,3,3,2,1,0,1,5,20.0,4,5,2,3,5,8,16,1,MF,20-24,Midfielder,Spain,Europe
181136,Piotr Zieliski,POL,Napoli,Serie A,2023,29.0,1994.0,21.4,23,15,6,13,4,12,24,50.0,12,12,1,11,9,32,15,0,MF,25-29,Midfielder,Poland,Europe
387234,Szymon urkowski,POL,Empoli,Serie A,2023,25.0,1997.0,9.6,15,6,5,8,2,5,15,33.3,10,5,1,4,6,21,11,0,MF,25-29,Midfielder,Poland,Europe
145115,Valon Berisha,KVX,Reims,Ligue 1,2020,27.0,1993.0,18.3,40,23,19,17,4,11,47,23.4,36,14,2,12,25,65,21,1,MF,25-29,Midfielder,Sweden,Europe
163222,Grgoire Defrel,MTQ,Sassuolo,Serie A,2020,29.0,1991.0,14.8,13,8,5,5,3,5,13,38.5,8,9,0,9,7,20,5,0,"MF,FW",25-29,Midfielder,France,Europe
283141,Blendi Idrizi,KVX,Schalke 04,Bundesliga,2020,22.0,1998.0,2.6,8,4,1,6,1,1,1,100.0,0,6,2,4,3,11,1,0,MF,20-24,Midfielder,Germany,Europe
232320,Atakan Karazor,Trkiye,Stuttgart,Bundesliga,2020,23.0,1996.0,11.5,20,12,12,7,1,13,22,59.1,9,18,8,10,21,41,50,2,"DF,MF",20-24,Defender,Germany,Europe
336125,Mrgim Vojvoda,KVX,Torino,Serie A,2020,25.0,1995.0,15.1,24,14,18,5,1,12,22,54.5,10,19,4,15,18,42,35,1,"DF,FW",25-29,Defender,Germany,Europe
163222,Grgoire Defrel,MTQ,Sassuolo,Serie A,2023,32.0,1991.0,8.4,17,8,7,5,5,7,15,46.7,8,10,0,10,3,20,9,0,"FW,MF",30-34,Forward,France,Europe
232320,Atakan Karazor,Trkiye,Stuttgart,Bundesliga,2023,26.0,1996.0,29.1,72,44,23,38,11,29,60,48.3,31,37,8,29,27,99,43,0,MF,25-29,Midfielder,Germany,Europe
337036,Florent Muslija,KVX,Freiburg,Bundesliga,2023,25.0,1998.0,1.2,5,4,3,2,0,2,5,40.0,3,1,0,1,0,5,2,0,"MF,FW",25-29,Midfielder,Germany,Europe
351843,Yoann Salmier,GUF,Le Havre,Ligue 1,2023,30.0,1992.0,17.4,22,10,13,6,3,13,20,65.0,7,21,15,6,21,43,57,0,DF,30-34,Defender,France,Europe
336125,Mrgim Vojvoda,KVX,Torino,Serie A,2023,28.0,1995.0,15.3,17,8,7,6,4,11,16,68.8,5,12,2,10,13,30,28,0,DF,25-29,Defender,Germany,Europe
496857,Edon Zhegrova,KVX,Lille,Ligue 1,2023,24.0,1999.0,25.4,32,18,9,15,8,14,36,38.9,22,17,1,16,8,40,8,0,FW,20-24,Forward,Germany,Europe
199704,Yunis Abdelhamid,MAR,Reims,Ligue 1,2019,31.0,1987.0,28.0,46,33,29,15,2,17,30,56.7,13,26,14,12,47,93,99,1,DF,30-34,Defender,Morocco,Africa
356118,Suleiman Abdullahi,NGA,Union Berlin,Bundesliga,2019,22.0,1996.0,1.7,0,0,0,0,0,0,3,0.0,3,2,1,1,1,1,1,0,"FW,MF",20-24,Forward,Nigeria,Africa
58178,David Abraham,ARG,Eint Frankfurt,Bundesliga,2019,33.0,1986.0,18.8,21,14,16,4,1,15,32,46.9,17,27,11,16,25,46,61,1,DF,30-34,Defender,Argentina,South America
331726,Tammy Abraham,ENG,Chelsea,Premier League,2019,21.0,1997.0,24.6,8,4,2,5,1,3,14,21.4,11,20,2,18,6,14,27,0,FW,20-24,Forward,England,Europe
66005,Amir Abrashi,ALB,Freiburg,Bundesliga,2019,29.0,1990.0,7.4,16,8,7,8,1,10,19,52.6,9,18,3,15,7,23,16,2,MF,25-29,Midfielder,Albania,Europe
131075,Francesco Acerbi,ITA,Lazio,Serie A,2019,31.0,1988.0,35.1,59,29,42,12,5,14,20,70.0,6,40,27,13,42,101,109,1,DF,30-34,Defender,Italy,Europe
332705,Tyler Adams,USA,RB Leipzig,Bundesliga,2019,20.0,1999.0,10.6,22,15,13,8,1,12,25,48.0,13,16,1,15,14,36,14,0,"MF,DF",20-24,Midfielder,United States,North America
125614,Sargis Adamyan,ARM,Hoffenheim,Bundesliga,2019,26.0,1993.0,8.3,11,7,3,6,2,3,21,14.3,18,8,1,7,2,13,4,0,"FW,MF",25-29,Forward,Armenia,Asia
337716,Claud Adjapong,ITA,Hellas Verona,Serie A,2019,21.0,1998.0,2.6,5,3,4,1,0,2,3,66.7,1,4,3,1,3,8,7,0,DF,20-24,Defender,Italy,Europe
395236,Yacine Adli,FRA,Bordeaux,Ligue 1,2019,19.0,2000.0,11.3,22,14,4,15,3,11,34,32.4,23,10,0,10,8,30,3,0,MF,Under 20,Midfielder,France,Europe
361914,Nayef Aguerd,MAR,Dijon,Ligue 1,2019,23.0,1996.0,10.6,13,9,7,5,1,8,12,66.7,4,11,11,0,18,31,54,0,DF,20-24,Defender,Morocco,Africa
26399,Sergio Agero,ARG,Manchester City,Premier League,2019,31.0,1988.0,16.1,7,4,0,4,3,1,8,12.5,7,9,1,8,3,10,2,0,FW,30-34,Forward,Argentina,South America
203746,Ruben Aguilar,FRA,Monaco,Ligue 1,2019,26.0,1993.0,11.9,36,22,19,15,2,19,28,67.9,9,6,2,4,11,47,21,0,DF,25-29,Defender,France,Europe
178313,Jean-Eudes Aholou,CIV,Saint-tienne,Ligue 1,2019,25.0,1994.0,7.0,16,12,2,11,3,3,9,33.3,6,6,1,5,15,31,10,0,MF,25-29,Midfielder,Ivory Coast,Africa
358250,Joseph Aidoo,GHA,Celta Vigo,La Liga,2019,23.0,1995.0,27.8,43,27,30,11,2,13,27,48.1,14,31,14,17,45,88,124,3,DF,20-24,Defender,Ghana,Africa
236490,Ola Aina,NGA,Torino,Serie A,2019,22.0,1996.0,23.1,45,24,23,18,4,17,37,45.9,20,24,6,18,41,86,61,0,DF,20-24,Defender,Nigeria,Africa
283994,Ludovic Ajorque,FRA,Strasbourg,Ligue 1,2019,25.0,1994.0,22.9,15,10,2,10,3,2,13,15.4,11,11,0,11,2,17,20,0,FW,25-29,Forward,France,Europe
177476,Nathan Ak,NED,Bournemouth,Premier League,2019,24.0,1995.0,27.8,31,21,23,8,0,14,23,60.9,9,40,29,11,36,67,152,0,DF,20-24,Defender,Netherlands,Europe
247459,Chadrac Akolo,COD,Amiens,Ligue 1,2019,24.0,1995.0,6.0,16,8,8,6,2,5,12,41.7,7,6,1,5,5,21,5,0,"FW,MF",20-24,Forward,DR Congo,Africa
59016,David Alaba,AUT,Bayern Munich,Bundesliga,2019,27.0,1992.0,27.8,30,17,14,15,1,16,25,64.0,9,19,10,9,29,59,40,0,DF,25-29,Defender,Austria,Europe
434358,Sofiane Alakouch,MAR,Nmes,Ligue 1,2019,21.0,1998.0,15.6,45,26,25,13,7,25,48,52.1,23,13,2,11,23,68,39,3,DF,20-24,Defender,Morocco,Africa
193782,Lucas Alario,ARG,Leverkusen,Bundesliga,2019,26.0,1992.0,13.0,6,3,0,4,2,1,8,12.5,7,12,2,10,1,7,9,0,FW,25-29,Forward,Argentina,South America
314353,Trent Alexander-Arnold,ENG,Liverpool,Premier League,2019,20.0,1998.0,35.3,55,34,35,17,3,36,78,46.2,42,27,9,18,45,100,84,3,DF,20-24,Defender,England,Europe
193130,Rachid Alioui,MAR,Angers,Ligue 1,2019,27.0,1992.0,17.4,8,5,0,7,1,2,13,15.4,11,3,0,3,2,10,9,0,FW,25-29,Forward,Morocco,Africa
385271,Allan,BRA,Napoli,Serie A,2019,28.0,1991.0,14.2,50,27,20,21,9,18,54,33.3,36,19,3,16,16,66,11,1,MF,25-29,Midfielder,Brazil,South America
207929,Dele Alli,ENG,Tottenham,Premier League,2019,23.0,1996.0,20.5,34,16,11,20,3,13,37,35.1,24,35,3,32,17,51,17,2,"MF,FW",20-24,Midfielder,England,Europe
476237,Steven Alzate,COL,Brighton,Premier League,2019,20.0,1998.0,13.2,33,19,20,11,2,17,27,63.0,10,18,3,15,14,47,13,0,"MF,DF",20-24,Midfielder,Colombia,South America
205503,Ibrahim Amadou,FRA,Norwich City,Premier League,2019,26.0,1993.0,8.4,18,11,9,8,1,3,11,27.3,8,8,5,3,16,34,55,1,"DF,MF",25-29,Defender,France,Europe
137841,Romain Amalfitano,FRA,Dijon,Ligue 1,2019,29.0,1989.0,18.8,43,27,18,21,4,21,61,34.4,40,23,9,14,36,79,14,2,MF,25-29,Midfielder,France,Europe
241229,Jordan Amavi,FRA,Marseille,Ligue 1,2019,25.0,1994.0,24.0,55,29,31,19,5,31,64,48.4,33,27,6,21,56,111,97,0,DF,25-29,Defender,France,Europe
344072,Kelvin Amian,FRA,Toulouse,Ligue 1,2019,21.0,1998.0,18.1,27,21,21,5,1,14,25,56.0,11,14,7,7,18,45,56,0,DF,20-24,Defender,France,Europe
232454,Nadiem Amiri,GER,Leverkusen,Bundesliga,2019,22.0,1996.0,20.6,26,16,7,15,4,16,34,47.1,18,12,2,10,14,40,8,1,"MF,FW",20-24,Midfielder,Germany,Europe
260827,Joachim Andersen,DEN,Lyon,Ligue 1,2019,23.0,1996.0,17.0,17,9,15,2,0,7,19,36.8,12,16,12,4,10,27,74,2,DF,20-24,Defender,Denmark,Europe
159372,Felipe Anderson,BRA,West Ham,Premier League,2019,26.0,1993.0,16.6,46,32,20,21,5,11,47,23.4,36,19,1,18,22,68,11,0,"MF,FW",25-29,Midfielder,Brazil,South America
147573,Sebastian Andersson,SWE,Union Berlin,Bundesliga,2019,28.0,1991.0,29.8,20,10,0,12,8,4,19,21.1,15,19,3,16,5,25,36,0,FW,25-29,Forward,Sweden,Europe
84301,Benjamin Andr,FRA,Lille,Ligue 1,2019,28.0,1990.0,22.8,72,44,31,35,6,29,74,39.2,45,32,9,23,59,131,40,1,MF,25-29,Midfielder,France,Europe
55854,Cristian Ansaldi,ARG,Torino,Serie A,2019,32.0,1986.0,19.6,37,25,24,7,6,19,34,55.9,15,23,3,20,14,51,20,4,"DF,MF",30-34,Defender,Argentina,South America
289182,Christopher Antwi-Adjei,GHA,Paderborn 07,Bundesliga,2019,25.0,1994.0,27.4,25,16,13,9,3,9,33,27.3,24,29,2,27,15,40,14,0,"MF,FW",25-29,Midfielder,Ghana,Africa
395693,Houssem Aouar,ALG,Lyon,Ligue 1,2019,21.0,1998.0,21.7,28,12,6,18,4,10,35,28.6,25,15,1,14,13,41,11,0,"MF,FW",20-24,Midfielder,Algeria,Africa
89701,Charles Arnguiz,CHI,Leverkusen,Bundesliga,2019,30.0,1989.0,23.5,56,37,19,29,8,27,74,36.5,47,27,6,21,22,78,21,1,MF,30-34,Midfielder,Chile,South America
435485,Luiz Arajo,BRA,Lille,Ligue 1,2019,23.0,1996.0,9.2,20,11,3,8,9,5,31,16.1,26,14,0,14,4,24,6,0,"FW,MF",20-24,Forward,Brazil,South America
120443,Santiago Arias,COL,Atltico Madrid,La Liga,2019,27.0,1992.0,12.0,36,24,20,12,4,10,18,55.6,8,12,7,5,19,55,20,1,DF,25-29,Defender,Colombia,South America
130765,Stuart Armstrong,SCO,Southampton,Premier League,2019,27.0,1992.0,19.1,32,19,19,11,2,9,38,23.7,29,22,4,18,11,43,23,1,MF,25-29,Midfielder,Scotland,Europe
63531,Kwadwo Asamoah,GHA,Inter,Serie A,2019,30.0,1988.0,7.1,10,8,4,5,1,6,14,42.9,8,8,1,7,9,19,13,0,"DF,FW",30-34,Defender,Ghana,Africa
263183,Roger Assal,CIV,Legans,La Liga,2019,25.0,1993.0,5.9,3,2,1,0,2,1,9,11.1,8,8,0,8,0,3,1,0,"FW,MF",25-29,Forward,Ivory Coast,Africa
58864,Pierre-Emerick Aubameyang,GAB,Arsenal,Premier League,2019,30.0,1989.0,34.8,31,19,10,12,9,12,51,23.5,39,39,1,38,14,45,16,0,FW,30-34,Forward,Gabon,Africa
264956,Jean-Kvin Augustin,FRA,Monaco,Ligue 1,2019,22.0,1997.0,3.0,3,0,1,2,0,1,6,16.7,5,2,0,2,3,6,0,0,FW,20-24,Forward,France,Europe
127032,Serge Aurier,CIV,Tottenham,Premier League,2019,26.0,1992.0,30.0,93,69,58,27,8,39,69,56.5,30,38,6,32,47,140,98,2,DF,25-29,Defender,Ivory Coast,Africa
295313,Taiwo Awoniyi,NGA,Mainz 05,Bundesliga,2019,21.0,1997.0,5.4,2,0,0,2,0,0,4,0.0,4,4,2,2,2,4,3,0,"FW,MF",20-24,Forward,Nigeria,Africa
372713,Florian Ay,FRA,Brescia,Serie A,2019,22.0,1997.0,15.3,17,9,9,5,3,6,13,46.2,7,17,2,15,4,21,18,1,"FW,MF",20-24,Forward,France,Europe
108354,Jordan Ayew,GHA,Crystal Palace,Premier League,2019,27.0,1991.0,35.0,48,30,10,22,16,17,49,34.7,32,29,4,25,15,63,21,0,FW,25-29,Forward,Ghana,Africa
131667,Ramon Azeez,NGA,Granada,La Liga,2019,26.0,1992.0,15.1,11,8,2,8,1,7,19,36.8,12,8,2,6,19,30,11,1,MF,25-29,Midfielder,Nigeria,Africa
442805,Iddrisu Baba,GHA,Mallorca,La Liga,2019,23.0,1996.0,32.3,59,37,26,29,4,20,70,28.6,50,31,8,23,39,98,42,0,MF,20-24,Midfielder,Ghana,Africa
119235,Carlos Bacca,COL,Villarreal,La Liga,2019,32.0,1986.0,7.6,5,1,1,2,2,2,6,33.3,4,4,0,4,0,5,7,0,FW,30-34,Forward,Colombia,South America
463603,Benot Badiashile,FRA,Monaco,Ligue 1,2019,18.0,2001.0,15.7,18,12,12,5,1,6,12,50.0,6,20,11,9,27,45,57,1,DF,Under 20,Defender,France,Europe
4018,Daniel Baier,GER,Augsburg,Bundesliga,2019,35.0,1984.0,21.6,33,17,14,14,5,15,43,34.9,28,19,7,12,58,91,27,0,MF,35-39,Midfielder,Germany,Europe
387626,Leon Bailey,JAM,Leverkusen,Bundesliga,2019,21.0,1997.0,12.1,6,3,1,5,0,6,16,37.5,10,9,0,9,8,14,3,0,"FW,MF",20-24,Forward,Jamaica,North America
198589,Lewis Baker,ENG,Dsseldorf,Bundesliga,2019,24.0,1995.0,6.1,8,5,6,2,0,2,10,20.0,8,5,2,3,2,10,5,0,MF,20-24,Midfielder,England,Europe
238752,Keita Bald,SEN,Monaco,Ligue 1,2019,24.0,1995.0,9.5,6,5,1,1,4,3,9,33.3,6,4,1,3,2,8,7,1,"FW,MF",20-24,Forward,Senegal,Africa
146690,George Baldock,GRE,Sheffield Utd,Premier League,2019,26.0,1993.0,38.0,62,43,35,17,10,27,47,57.4,20,26,3,23,34,96,83,3,DF,25-29,Defender,Greece,Europe
39381,Gareth Bale,WAL,Real Madrid,La Liga,2019,30.0,1989.0,12.1,9,5,5,2,2,3,14,21.4,11,8,2,6,6,15,9,0,"FW,MF",30-34,Forward,Wales,Europe
296422,Fod Ballo-Tour,SEN,Monaco,Ligue 1,2019,22.0,1997.0,18.7,36,25,21,11,4,17,32,53.1,15,10,1,9,24,60,45,0,DF,20-24,Defender,Senegal,Africa
5348,Florent Balmont,FRA,Dijon,Ligue 1,2019,39.0,1980.0,4.5,12,6,5,7,0,7,12,58.3,5,6,0,6,1,13,3,0,MF,35-39,Midfielder,France,Europe
292818,Jonathan Bamba,CIV,Lille,Ligue 1,2019,23.0,1996.0,21.5,12,6,5,5,2,7,29,24.1,22,19,3,16,16,28,8,2,"FW,MF",20-24,Forward,Ivory Coast,Africa
12249,ver Banega,ARG,Sevilla,La Liga,2019,31.0,1988.0,27.5,43,28,16,18,9,21,70,30.0,49,19,1,18,15,58,5,0,MF,30-34,Midfielder,Argentina,South America
165873,Federico Barba,ITA,Valladolid,La Liga,2019,25.0,1993.0,5.0,12,6,10,2,0,7,9,77.8,2,5,2,3,8,20,12,0,DF,25-29,Defender,Italy,Europe
273438,Danilo Barbosa,BRA,Nice,Ligue 1,2019,23.0,1996.0,12.5,28,21,17,9,2,13,29,44.8,16,21,6,15,20,48,38,0,"DF,MF",20-24,Defender,Brazil,South America
15773,Phil Bardsley,SCO,Burnley,Premier League,2019,34.0,1985.0,21.0,49,36,16,24,9,24,37,64.9,13,24,11,13,30,79,73,0,DF,30-34,Defender,Scotland,Europe
255942,Nicol Barella,ITA,Inter,Serie A,2019,22.0,1997.0,22.4,36,21,14,15,7,8,37,21.6,29,20,5,15,14,50,14,0,MF,20-24,Midfielder,Italy,Europe
39828,Antonino Barill,ITA,Parma,Serie A,2019,31.0,1988.0,18.8,43,31,22,19,2,16,45,35.6,29,26,8,18,17,60,32,0,MF,30-34,Midfielder,Italy,Europe
131978,Ross Barkley,ENG,Chelsea,Premier League,2019,25.0,1993.0,12.3,16,9,6,6,4,5,18,27.8,13,7,2,5,7,23,7,0,MF,25-29,Midfielder,England,Europe
63200,Ashley Barnes,ENG,Burnley,Premier League,2019,29.0,1989.0,15.0,10,5,3,5,2,3,9,33.3,6,7,2,5,6,16,9,0,FW,25-29,Forward,England,Europe
398065,Harvey Barnes,ENG,Leicester City,Premier League,2019,21.0,1997.0,23.1,16,11,7,7,2,5,23,21.7,18,13,3,10,8,24,6,1,"MF,FW",20-24,Midfielder,England,Europe
241889,Antonio Barreca,ITA,Genoa,Serie A,2019,24.0,1995.0,12.2,10,7,5,3,2,4,5,80.0,1,12,7,5,1,11,22,0,"DF,FW",20-24,Defender,Italy,Europe
486624,Musa Barrow,GAM,Bologna,Serie A,2019,20.0,1998.0,15.0,20,13,11,7,2,6,20,30.0,14,15,0,15,5,25,11,0,"FW,MF",20-24,Forward,Gambia,Africa
36207,Fin Bartels,GER,Werder Bremen,Bundesliga,2019,32.0,1987.0,3.8,9,5,4,4,1,3,12,25.0,9,3,1,2,1,10,1,0,"MF,FW",30-34,Midfielder,Germany,Europe
134883,Daniele Baselli,ITA,Torino,Serie A,2019,27.0,1992.0,14.2,43,23,17,19,7,13,40,32.5,27,20,4,16,25,68,25,0,MF,25-29,Midfielder,Italy,Europe
334835,Toma Bai,CRO,Bordeaux,Ligue 1,2019,22.0,1996.0,11.0,26,22,9,16,1,12,27,44.4,15,14,2,12,9,35,12,1,MF,20-24,Midfielder,Croatia,Europe
315853,Alessandro Bastoni,ITA,Inter,Serie A,2019,20.0,1999.0,21.3,32,17,14,11,7,15,24,62.5,9,18,9,9,26,58,54,0,DF,20-24,Defender,Italy,Europe
34787,Julian Baumgartlinger,AUT,Leverkusen,Bundesliga,2019,31.0,1988.0,19.9,42,21,15,21,6,18,42,42.9,24,37,4,33,20,62,16,1,MF,30-34,Midfielder,Austria,Europe
324278,Christoph Baumgartner,AUT,Hoffenheim,Bundesliga,2019,19.0,1999.0,16.6,32,17,15,16,1,10,37,27.0,27,25,1,24,8,40,13,0,"MF,FW",Under 20,Midfielder,Austria,Europe
283001,Noah Joel Sarenren Bazee,NGA,Augsburg,Bundesliga,2019,22.0,1996.0,4.2,4,3,0,4,0,1,4,25.0,3,2,1,1,5,9,4,0,FW,20-24,Forward,Nigeria,Africa
188888,Sheraldo Becker,SUR,Union Berlin,Bundesliga,2019,24.0,1995.0,6.0,2,1,2,0,0,1,3,33.3,2,1,0,1,0,2,1,0,"MF,FW",20-24,Midfielder,Suriname,South America
282349,Timo Becker,GER,Schalke 04,Bundesliga,2019,22.0,1997.0,3.7,10,9,3,6,1,5,9,55.6,4,6,1,5,3,13,8,0,"DF,MF",20-24,Defender,Germany,Europe
21905,Valon Behrami,SUI,Genoa,Serie A,2019,34.0,1985.0,12.3,34,26,13,17,4,8,32,25.0,24,25,10,15,9,43,16,0,MF,30-34,Midfielder,Switzerland,Europe
111039,Ishak Belfodil,ALG,Hoffenheim,Bundesliga,2019,27.0,1992.0,3.0,0,0,0,0,0,0,1,0.0,1,0,0,0,0,0,2,0,"FW,MF",25-29,Forward,Algeria,Africa
138055,Haris Belkebla,ALG,Brest,Ligue 1,2019,25.0,1994.0,20.2,44,24,17,17,10,10,28,35.7,18,25,5,20,53,97,21,2,MF,25-29,Midfielder,Algeria,Africa
61087,Karim Bellarabi,GER,Leverkusen,Bundesliga,2019,29.0,1990.0,15.8,19,11,9,7,3,9,28,32.1,19,16,0,16,10,29,4,0,"FW,DF",25-29,Forward,Germany,Europe
450050,Jean-Ricner Bellegarde,FRA,Strasbourg,Ligue 1,2019,21.0,1998.0,16.6,40,27,18,19,3,13,21,61.9,8,16,3,13,22,62,6,0,MF,20-24,Midfielder,France,Europe
146854,Wissam Ben Yedder,FRA,Monaco,Ligue 1,2019,28.0,1990.0,24.0,22,16,2,12,8,8,19,42.1,11,12,0,12,4,26,1,0,FW,25-29,Forward,France,Europe
30059,Lars Bender,GER,Leverkusen,Bundesliga,2019,30.0,1989.0,15.3,42,26,17,20,5,19,38,50.0,19,32,6,26,24,66,30,0,"DF,MF",30-34,Defender,Germany,Europe
29993,Sven Bender,GER,Leverkusen,Bundesliga,2019,30.0,1989.0,30.3,53,34,29,17,7,23,48,47.9,25,42,13,29,67,120,88,2,DF,30-34,Defender,Germany,Europe
92693,Daro Benedetto,ARG,Marseille,Ligue 1,2019,29.0,1990.0,23.3,12,9,0,9,3,3,18,16.7,15,15,2,13,3,15,23,1,FW,25-29,Forward,Argentina,South America
119085,Loris Benito,SUI,Bordeaux,Ligue 1,2019,27.0,1992.0,21.1,40,25,23,11,6,16,43,37.2,27,14,5,9,29,69,58,1,DF,25-29,Defender,Switzerland,Europe
351816,Ismal Bennacer,ALG,Milan,Serie A,2019,21.0,1997.0,27.6,67,47,21,34,12,29,73,39.7,44,25,7,18,54,121,15,2,MF,20-24,Midfielder,Algeria,Africa
284732,Ramy Bensebaini,ALG,Gladbach,Bundesliga,2019,24.0,1995.0,16.1,33,17,17,12,4,18,31,58.1,13,24,4,20,38,71,49,0,DF,20-24,Defender,Algeria,Africa
50201,Christian Benteke,BEL,Crystal Palace,Premier League,2019,28.0,1990.0,14.0,9,5,1,6,2,0,10,0.0,10,11,4,7,4,13,28,1,FW,25-29,Forward,Belgium,Europe
18922,Karim Benzema,FRA,Real Madrid,La Liga,2019,31.0,1987.0,34.9,18,8,3,11,4,2,16,12.5,14,16,4,12,7,25,30,1,FW,30-34,Forward,France,Europe
177843,Domenico Berardi,ITA,Sassuolo,Serie A,2019,24.0,1994.0,27.7,32,16,19,8,5,13,59,22.0,46,31,3,28,33,65,27,0,FW,20-24,Forward,Italy,Europe
197300,Federico Bernardeschi,ITA,Juventus,Serie A,2019,25.0,1994.0,17.5,13,5,4,5,4,5,25,20.0,20,11,0,11,13,26,12,1,"MF,FW",25-29,Midfielder,Italy,Europe
719646,Bernardo,BRA,Brighton,Premier League,2019,24.0,1995.0,7.5,27,16,12,9,6,13,17,76.5,4,7,3,4,6,33,24,0,"DF,MF",20-24,Defender,Brazil,South America
40611,Ryan Bertrand,ENG,Southampton,Premier League,2019,29.0,1989.0,30.5,47,29,22,15,10,26,58,44.8,32,27,12,15,37,84,31,1,DF,25-29,Defender,England,Europe
320411,Philip Billing,DEN,Bournemouth,Premier League,2019,23.0,1996.0,28.1,72,46,30,37,5,17,65,26.2,48,59,16,43,66,138,97,1,MF,20-24,Midfielder,Denmark,Europe
124555,Cristiano Biraghi,ITA,Inter,Serie A,2019,26.0,1992.0,17.5,22,6,10,8,4,10,24,41.7,14,21,7,14,13,35,41,0,DF,25-29,Defender,Italy,Europe
163216,Dimitri Bisoli,ITA,Brescia,Serie A,2019,25.0,1994.0,23.9,64,35,34,20,10,30,49,61.2,19,41,7,34,25,89,49,0,MF,25-29,Midfielder,Italy,Europe
410425,Yves Bissouma,MLI,Brighton,Premier League,2019,22.0,1996.0,14.0,49,38,24,22,3,17,40,42.5,23,18,2,16,21,70,23,0,MF,20-24,Midfielder,Mali,Africa
288225,Ludovic Blas,FRA,Nantes,Ligue 1,2019,21.0,1997.0,20.5,26,18,7,15,4,5,26,19.2,21,17,1,16,14,40,11,0,"FW,MF",20-24,Forward,France,Europe
75446,Pablo de Blasis,ARG,Eibar,La Liga,2019,31.0,1988.0,17.8,41,32,22,13,6,30,63,47.6,33,13,0,13,24,65,21,0,"DF,MF",30-34,Defender,Argentina,South America
16922,Kevin-Prince Boateng,GHA,Fiorentina,Serie A,2019,32.0,1987.0,6.7,3,1,0,2,1,2,8,25.0,6,3,0,3,1,4,7,0,FW,30-34,Forward,Ghana,Africa
20778,Adam Bodzek,GER,Dsseldorf,Bundesliga,2019,33.0,1985.0,22.4,42,26,21,20,1,14,46,30.4,32,34,11,23,25,67,39,0,MF,30-34,Midfielder,Germany,Europe
182574,Jean-Paul Botius,NED,Mainz 05,Bundesliga,2019,25.0,1994.0,25.2,63,33,21,31,11,20,57,35.1,37,38,1,37,26,89,6,0,MF,25-29,Midfielder,Netherlands,Europe
412671,Quentin Boisgard,FRA,Toulouse,Ligue 1,2019,22.0,1997.0,12.7,31,19,10,14,7,14,35,40.0,21,11,0,11,12,43,4,1,"MF,FW",20-24,Midfielder,France,Europe
142310,Willy Boly,CIV,Wolves,Premier League,2019,28.0,1991.0,22.0,57,33,36,21,0,25,43,58.1,18,28,11,17,39,96,108,3,DF,25-29,Defender,Ivory Coast,Africa
57280,Giacomo Bonaventura,ITA,Milan,Serie A,2019,29.0,1989.0,14.9,16,9,5,6,5,5,17,29.4,12,8,3,5,7,23,10,0,"MF,FW",25-29,Midfielder,Italy,Europe
241527,Federico Bonazzoli,ITA,Sampdoria,Serie A,2019,22.0,1997.0,8.3,7,5,1,4,2,0,7,0.0,7,3,0,3,5,12,2,0,FW,20-24,Forward,Italy,Europe
247377,Kevin Bonifazi,ITA,Torino,Serie A,2019,23.0,1996.0,2.7,9,8,6,3,0,5,6,83.3,1,3,2,1,5,14,10,0,DF,20-24,Defender,Italy,Europe
338629,Sebastiaan Bornauw,BEL,Kln,Bundesliga,2019,20.0,1999.0,27.2,37,24,24,12,1,20,39,51.3,19,32,12,20,42,79,99,0,DF,20-24,Defender,Belgium,Europe
293592,Brandon Borrello,AUS,Freiburg,Bundesliga,2019,24.0,1995.0,3.3,10,4,6,4,0,4,10,40.0,6,7,1,6,1,11,1,0,"MF,FW",20-24,Midfielder,Australia,Oceania
236045,Denis Bouanga,GAB,Saint-tienne,Ligue 1,2019,24.0,1994.0,22.7,45,34,10,25,10,20,55,36.4,35,30,0,30,10,55,15,0,"FW,MF",20-24,Forward,Gabon,Africa
560593,Hicham Boudaoui,ALG,Nice,Ligue 1,2019,19.0,1999.0,5.4,20,10,6,11,3,9,23,39.1,14,10,3,7,13,33,7,0,"MF,FW",Under 20,Midfielder,Algeria,Africa
77826,Ryad Boudebouz,ALG,Saint-tienne,Ligue 1,2019,29.0,1990.0,17.7,25,16,9,14,2,8,25,32.0,17,14,1,13,7,32,5,0,"MF,FW",25-29,Midfielder,Algeria,Africa
202318,Farid Boulaya,ALG,Metz,Ligue 1,2019,26.0,1993.0,9.1,14,10,7,4,3,7,19,36.8,12,5,0,5,6,20,3,0,FW,25-29,Forward,Algeria,Africa
266359,Benjamin Bourigeaud,FRA,Rennes,Ligue 1,2019,25.0,1994.0,21.1,40,12,18,20,2,17,68,25.0,51,38,7,31,20,60,25,0,MF,25-29,Midfielder,France,Europe
314875,Jarrod Bowen,ENG,West Ham,Premier League,2019,22.0,1996.0,10.2,19,15,7,9,3,4,17,23.5,13,6,0,6,16,35,8,0,"FW,MF",20-24,Forward,England,Europe
85585,John Boye,GHA,Metz,Ligue 1,2019,32.0,1987.0,23.5,30,19,25,5,0,19,32,59.4,13,31,18,13,31,61,116,0,DF,30-34,Defender,Ghana,Africa
187492,Julian Brandt,GER,Dortmund,Bundesliga,2019,23.0,1996.0,24.5,48,33,15,21,12,25,55,45.5,30,35,2,33,16,64,10,1,"MF,FW",20-24,Midfielder,Germany,Europe
190338,Anthony Brianon,FRA,Nmes,Ligue 1,2019,24.0,1994.0,19.3,29,19,20,9,0,17,34,50.0,17,22,16,6,39,68,80,0,DF,20-24,Defender,France,Europe
18909,Jimmy Briand,FRA,Bordeaux,Ligue 1,2019,33.0,1985.0,16.9,12,8,5,4,3,3,13,23.1,10,8,4,4,6,18,12,0,FW,30-34,Forward,France,Europe
450417,Dylan Bronn,TUN,Metz,Ligue 1,2019,24.0,1995.0,9.0,7,5,6,1,0,4,7,57.1,3,11,9,2,6,13,42,0,DF,20-24,Defender,Tunisia,Africa
277033,David Brooks,WAL,Bournemouth,Premier League,2019,22.0,1997.0,5.6,5,5,1,2,2,2,14,14.3,12,5,1,4,2,7,1,0,"MF,FW",20-24,Midfielder,Wales,Europe
124732,John Brooks,USA,Wolfsburg,Bundesliga,2019,26.0,1993.0,24.7,38,27,27,9,2,24,49,49.0,25,31,12,19,41,79,93,0,DF,25-29,Defender,United States,North America
43984,Daniel Brosinski,GER,Mainz 05,Bundesliga,2019,31.0,1988.0,19.0,40,27,13,23,4,15,34,44.1,19,16,2,14,14,54,58,0,DF,30-34,Defender,Germany,Europe
131109,Gastn Brugman,URU,Parma,Serie A,2019,26.0,1992.0,16.2,47,24,25,15,7,19,46,41.3,27,33,15,18,27,74,19,2,MF,25-29,Midfielder,Uruguay,South America
46413,Ante Budimir,CRO,Mallorca,La Liga,2019,28.0,1991.0,30.7,31,15,4,22,5,7,29,24.1,22,21,4,17,8,39,29,0,FW,25-29,Forward,Croatia,Europe
337922,Esteban Burgos,ARG,Eibar,La Liga,2019,27.0,1992.0,12.4,11,9,9,2,0,5,9,55.6,4,11,6,5,17,28,66,2,DF,25-29,Defender,Argentina,South America
49239,Guido Burgstaller,AUT,Schalke 04,Bundesliga,2019,30.0,1989.0,13.7,7,3,0,5,2,4,15,26.7,11,12,3,9,4,11,10,0,FW,30-34,Forward,Austria,Europe
333647,Jonathan Burkardt,GER,Mainz 05,Bundesliga,2019,19.0,2000.0,2.8,9,4,2,5,2,3,8,37.5,5,6,1,5,0,9,1,0,"FW,MF",Under 20,Forward,Germany,Europe
341317,Oliver Burke,SCO,Alavs,La Liga,2019,22.0,1997.0,15.9,19,14,8,9,2,10,23,43.5,13,24,0,24,8,27,16,0,"MF,FW",20-24,Midfielder,Scotland,Europe
236953,Sam Byram,ENG,Norwich City,Premier League,2019,25.0,1993.0,14.4,40,22,24,11,5,18,37,48.6,19,16,8,8,26,66,73,0,DF,25-29,Defender,England,Europe
29434,Yohan Cabaye,FRA,Saint-tienne,Ligue 1,2019,33.0,1986.0,9.5,29,18,11,14,4,14,25,56.0,11,10,0,10,22,51,7,1,MF,30-34,Midfielder,France,Europe
453016,Anthony Caci,FRA,Strasbourg,Ligue 1,2019,22.0,1997.0,7.7,29,17,19,9,1,8,17,47.1,9,15,5,10,19,48,15,1,DF,20-24,Defender,France,Europe
27511,Gary Cahill,ENG,Crystal Palace,Premier League,2019,33.0,1985.0,24.1,15,8,11,4,0,7,15,46.7,8,34,25,9,18,33,114,1,DF,30-34,Defender,England,Europe
37834,Felipe Caicedo,ECU,Lazio,Serie A,2019,30.0,1988.0,15.6,17,10,4,7,6,2,11,18.2,9,9,1,8,4,21,2,0,FW,30-34,Forward,Ecuador,South America
240897,Arturo Calabresi,ITA,Amiens,Ligue 1,2019,23.0,1996.0,20.9,53,33,29,20,4,33,75,44.0,42,24,11,13,29,82,60,0,DF,20-24,Defender,Italy,Europe
262523,Davide Calabria,ITA,Milan,Serie A,2019,22.0,1996.0,18.0,52,33,28,22,2,17,41,41.5,24,23,5,18,21,73,47,1,DF,20-24,Defender,Italy,Europe
126414,Hakan alhanolu,TUR,Milan,Serie A,2019,25.0,1994.0,30.0,42,21,15,21,6,12,35,34.3,23,26,2,24,26,68,26,1,"MF,FW",25-29,Midfielder,Turkey,Asia
38410,Daniel Caligiuri,ITA,Schalke 04,Bundesliga,2019,31.0,1988.0,25.5,58,37,18,25,15,27,74,36.5,47,67,6,61,25,83,39,0,"MF,FW",30-34,Midfielder,Italy,Europe
284727,Jonathan Calleri,ARG,Espanyol,La Liga,2019,25.0,1993.0,20.1,12,8,6,4,2,3,24,12.5,21,11,3,8,7,19,22,0,FW,25-29,Forward,Argentina,South America
306024,Dominic Calvert-Lewin,ENG,Everton,Premier League,2019,22.0,1997.0,29.2,7,5,1,4,2,1,10,10.0,9,15,2,13,6,13,36,0,FW,20-24,Forward,England,Europe
640428,Eduardo Camavinga,FRA,Rennes,Ligue 1,2019,16.0,2002.0,23.4,105,64,45,56,4,48,96,50.0,48,26,8,18,34,139,35,0,MF,Under 20,Midfielder,France,Europe
119296,Emre Can,GER,Juventus,Serie A,2019,25.0,1994.0,3.2,10,7,5,3,2,3,10,30.0,7,4,0,4,2,12,3,0,MF,25-29,Midfielder,Germany,Europe
182712,Joo Cancelo,POR,Manchester City,Premier League,2019,25.0,1994.0,13.4,40,24,21,12,7,24,40,60.0,16,9,2,7,21,61,18,0,DF,25-29,Defender,Portugal,Europe
25488,Antonio Candreva,ITA,Inter,Serie A,2019,32.0,1987.0,22.1,11,6,9,1,1,7,29,24.1,22,26,10,16,14,25,33,1,DF,30-34,Defender,Italy,Europe
214532,Pierrick Capelle,FRA,Angers,Ligue 1,2019,32.0,1987.0,19.4,42,32,18,16,8,16,48,33.3,32,17,3,14,21,63,28,0,"MF,DF",30-34,Midfielder,France,Europe
63494,tienne Capoue,FRA,Watford,Premier League,2019,31.0,1988.0,29.2,75,40,38,30,7,37,85,43.5,48,30,11,19,68,143,61,0,MF,30-34,Midfielder,France,Europe
146752,Gianluca Caprari,ITA,Sampdoria,Serie A,2019,26.0,1993.0,7.4,9,7,1,6,2,4,13,30.8,9,5,0,5,7,16,1,0,"FW,MF",25-29,Forward,Italy,Europe
84765,Francesco Caputo,ITA,Sassuolo,Serie A,2019,31.0,1987.0,32.6,7,4,3,2,2,3,11,27.3,8,15,0,15,1,8,8,0,FW,30-34,Forward,Italy,Europe
342226,Irvin Cardona,FRA,Brest,Ligue 1,2019,21.0,1997.0,16.1,13,8,5,6,2,9,32,28.1,23,8,0,8,1,14,7,0,"FW,MF",20-24,Forward,France,Europe
140776,Yannick Carrasco,BEL,Atltico Madrid,La Liga,2019,25.0,1993.0,7.0,11,7,4,4,3,7,21,33.3,14,9,0,9,5,16,2,0,"MF,FW",25-29,Midfielder,Belgium,Europe
184672,Guido Carrillo,ARG,Legans,La Liga,2019,28.0,1991.0,13.5,13,10,3,6,4,2,14,14.3,12,9,1,8,3,16,22,0,FW,25-29,Forward,Argentina,South America
48066,Andy Carroll,ENG,Newcastle Utd,Premier League,2019,30.0,1989.0,7.0,5,3,3,2,0,2,8,25.0,6,2,1,1,2,7,24,1,FW,30-34,Forward,England,Europe
100131,William Carvalho,POR,Betis,La Liga,2019,27.0,1992.0,9.9,7,4,4,2,1,4,14,28.6,10,7,5,2,4,11,8,1,MF,25-29,Midfielder,Portugal,Europe
16306,Casemiro,BRA,Real Madrid,La Liga,2019,27.0,1992.0,34.3,96,60,43,45,8,39,99,39.4,60,53,10,43,68,164,72,0,MF,25-29,Midfielder,Brazil,South America
301236,Francesco Cassata,ITA,Genoa,Serie A,2019,22.0,1997.0,16.2,20,10,12,5,3,9,30,30.0,21,12,2,10,11,31,11,0,MF,20-24,Midfielder,Italy,Europe
262226,Timothy Castagne,BEL,Atalanta,Serie A,2019,23.0,1995.0,19.7,31,20,9,16,6,13,25,52.0,12,34,5,29,17,48,23,0,DF,20-24,Defender,Belgium,Europe
182875,Jean-Charles Castelletto,CMR,Brest,Ligue 1,2019,24.0,1995.0,20.4,18,9,13,5,0,9,18,50.0,9,20,16,4,33,51,87,1,DF,20-24,Defender,Cameroon,Africa
303116,Gaetano Castrovilli,ITA,Fiorentina,Serie A,2019,22.0,1997.0,29.7,59,31,25,23,11,18,53,34.0,35,29,2,27,15,74,31,1,MF,20-24,Midfielder,Italy,Europe
199733,Danilo Cataldi,ITA,Lazio,Serie A,2019,24.0,1994.0,6.6,17,11,10,5,2,10,20,50.0,10,7,1,6,13,30,10,0,MF,20-24,Midfielder,Italy,Europe
48280,Edinson Cavani,URU,Paris S-G,Ligue 1,2019,32.0,1987.0,6.7,5,1,0,2,3,0,3,0.0,3,7,0,7,1,6,2,0,FW,30-34,Forward,Uruguay,South America
251075,Zeki elik,TUR,Lille,Ligue 1,2019,22.0,1997.0,23.0,53,28,18,28,7,27,60,45.0,33,24,4,20,26,79,39,0,DF,20-24,Defender,Turkey,Asia
384859,Fabien Centonze,FRA,Metz,Ligue 1,2019,23.0,1996.0,28.0,76,49,53,22,1,34,57,59.6,23,30,11,19,59,135,98,0,DF,20-24,Defender,France,Europe
102745,Luca Ceppitelli,ITA,Cagliari,Serie A,2019,29.0,1989.0,13.8,22,15,16,6,0,6,11,54.5,5,23,17,6,23,45,66,2,DF,25-29,Defender,Italy,Europe
197751,Alberto Cerri,ITA,SPAL,Serie A,2019,23.0,1996.0,4.7,2,1,0,2,0,1,3,33.3,2,1,0,1,0,2,3,0,FW,20-24,Forward,Italy,Europe
216499,Fouad Chafik,MAR,Dijon,Ligue 1,2019,32.0,1986.0,17.0,32,21,22,7,3,17,36,47.2,19,12,5,7,26,58,36,0,DF,30-34,Defender,Morocco,Africa
215118,Calum Chambers,ENG,Arsenal,Premier League,2019,24.0,1995.0,12.2,26,10,12,8,6,11,16,68.8,5,13,7,6,16,42,43,1,DF,20-24,Defender,England,Europe
213614,Jhon Chancellor,VEN,Brescia,Serie A,2019,27.0,1992.0,24.9,30,14,22,8,0,11,22,50.0,11,34,29,5,34,64,145,3,DF,25-29,Defender,Venezuela,South America
49723,Timothy Chandler,USA,Eint Frankfurt,Bundesliga,2019,29.0,1990.0,13.6,22,10,9,8,5,9,16,56.3,7,9,4,5,13,35,21,0,"DF,MF",25-29,Defender,United States,North America
93678,Gatan Charbonnier,FRA,Brest,Ligue 1,2019,30.0,1988.0,22.9,36,16,11,11,14,10,35,28.6,25,19,6,13,7,43,33,1,"FW,MF",30-34,Forward,France,Europe
486078,Charles,BRA,Eibar,La Liga,2019,35.0,1984.0,14.5,10,5,0,6,4,4,22,18.2,18,7,2,5,7,17,6,0,FW,35-39,Forward,Brazil,South America
118278,Xavier Chavalerin,FRA,Reims,Ligue 1,2019,28.0,1991.0,23.9,71,52,29,33,9,19,49,38.8,30,23,8,15,36,107,36,0,MF,25-29,Midfielder,France,Europe
98322,Denis Cheryshev,RUS,Valencia,La Liga,2019,28.0,1990.0,10.3,16,9,5,4,7,3,17,17.6,14,15,1,14,7,23,10,0,"MF,FW",25-29,Midfielder,Russia,Europe
29260,Giorgio Chiellini,ITA,Juventus,Serie A,2019,34.0,1984.0,2.2,3,0,3,0,0,1,1,100.0,0,2,2,0,1,4,9,0,DF,30-34,Defender,Italy,Europe
341092,Federico Chiesa,ITA,Fiorentina,Serie A,2019,21.0,1997.0,29.3,38,22,13,15,10,10,52,19.2,42,19,0,19,6,44,6,0,"FW,DF",20-24,Forward,Italy,Europe
316125,Ben Chilwell,ENG,Leicester City,Premier League,2019,22.0,1996.0,26.4,43,26,28,13,2,23,52,44.2,29,30,6,24,28,71,68,2,DF,20-24,Defender,England,Europe
624037,Joris Chotard,FRA,Montpellier,Ligue 1,2019,17.0,2001.0,13.9,30,18,13,17,0,15,35,42.9,20,12,5,7,20,50,12,1,MF,Under 20,Midfielder,France,Europe
341501,Hamza Choudhury,ENG,Leicester City,Premier League,2019,21.0,1997.0,9.9,17,8,7,8,2,3,25,12.0,22,15,6,9,24,41,13,0,MF,20-24,Midfielder,England,Europe
196948,Andreas Christensen,DEN,Chelsea,Premier League,2019,23.0,1996.0,19.5,38,21,25,12,1,15,21,71.4,6,12,8,4,29,67,56,0,DF,20-24,Defender,Denmark,Europe
401922,Samuel Chukwueze,NGA,Villarreal,La Liga,2019,20.0,1999.0,22.8,23,14,12,6,5,13,30,43.3,17,15,1,14,10,33,14,1,"FW,MF",20-24,Forward,Nigeria,Africa
33218,Luca Cigarini,ITA,Cagliari,Serie A,2019,33.0,1986.0,17.8,37,20,23,13,1,16,40,40.0,24,28,10,18,20,57,29,0,MF,30-34,Midfielder,Italy,Europe
337381,Andrea Cistana,ITA,Brescia,Serie A,2019,22.0,1997.0,20.4,20,8,13,7,0,6,17,35.3,11,38,34,4,33,53,96,1,DF,20-24,Defender,Italy,Europe
98240,Ciaran Clark,IRL,Newcastle Utd,Premier League,2019,29.0,1989.0,13.2,20,12,18,2,0,9,15,60.0,6,18,14,4,11,31,82,0,DF,25-29,Defender,Republic of Ireland,Europe
384593,Alexis Claude-Maurice,FRA,Nice,Ligue 1,2019,21.0,1998.0,18.1,26,16,8,11,7,13,35,37.1,22,20,4,16,11,37,4,0,"FW,MF",20-24,Forward,France,Europe
73484,Tom Cleverley,ENG,Watford,Premier League,2019,29.0,1989.0,10.8,28,15,8,14,6,9,36,25.0,27,13,1,12,10,38,15,0,MF,25-29,Midfielder,England,Europe
68390,Samus Coleman,IRL,Everton,Premier League,2019,30.0,1988.0,20.4,42,31,24,14,4,19,25,76.0,6,21,9,12,24,66,43,1,DF,30-34,Defender,Republic of Ireland,Europe
254934,Jamilu Collins,NGA,Paderborn 07,Bundesliga,2019,24.0,1994.0,29.6,69,43,44,21,4,37,62,59.7,25,53,19,34,70,139,91,1,DF,20-24,Defender,Nigeria,Africa
243714,Kingsley Coman,FRA,Bayern Munich,Bundesliga,2019,23.0,1996.0,16.7,19,11,6,7,6,12,27,44.4,15,9,0,9,4,23,3,0,"FW,MF",20-24,Forward,France,Europe
22386,Daniel Congr,FRA,Montpellier,Ligue 1,2019,34.0,1985.0,21.6,37,27,20,16,1,18,38,47.4,20,8,7,1,47,84,66,1,DF,30-34,Defender,France,Europe
249089,Lewis Cook,ENG,Bournemouth,Premier League,2019,22.0,1997.0,15.0,27,14,15,9,3,10,47,21.3,37,17,5,12,17,44,17,1,"MF,FW",20-24,Midfielder,England,Europe
90836,Steve Cook,ENG,Bournemouth,Premier League,2019,28.0,1991.0,27.0,22,11,18,4,0,8,20,40.0,12,32,23,9,44,66,153,1,DF,25-29,Defender,England,Europe
74869,Francis Coquelin,FRA,Valencia,La Liga,2019,28.0,1991.0,21.2,37,21,25,11,1,16,38,42.1,22,19,9,10,38,75,25,0,MF,25-29,Midfielder,France,Europe
154171,Benjamin Corgnet,FRA,Strasbourg,Ligue 1,2019,32.0,1987.0,2.9,1,1,1,0,0,1,3,33.3,2,2,0,2,2,3,3,0,"MF,FW",30-34,Midfielder,France,Europe
40613,Jack Cork,ENG,Burnley,Premier League,2019,30.0,1989.0,29.0,35,24,10,20,5,12,62,19.4,50,34,12,22,28,63,49,0,MF,30-34,Midfielder,England,Europe
266807,ngel Correa,ARG,Atltico Madrid,La Liga,2019,24.0,1995.0,22.9,25,9,7,9,9,9,36,25.0,27,23,5,18,14,39,21,0,"MF,FW",20-24,Midfielder,Argentina,South America
227081,Joaqun Correa,ARG,Lazio,Serie A,2019,24.0,1994.0,22.2,13,7,3,7,3,5,24,20.8,19,5,1,4,7,20,10,0,FW,20-24,Forward,Argentina,South America
85906,Danny da Costa,GER,Eint Frankfurt,Bundesliga,2019,26.0,1993.0,15.4,26,17,14,8,4,6,16,37.5,10,16,1,15,15,41,26,0,"DF,FW",25-29,Defender,Germany,Europe
75615,Douglas Costa,BRA,Juventus,Serie A,2019,28.0,1990.0,8.9,2,1,1,1,0,1,12,8.3,11,7,0,7,5,7,5,0,"FW,MF",25-29,Forward,Brazil,South America
184935,Kalifa Coulibaly,MLI,Nantes,Ligue 1,2019,27.0,1991.0,18.0,11,7,0,5,6,3,5,60.0,2,3,1,2,6,17,32,0,FW,25-29,Forward,Mali,Africa
60525,Yoann Court,FRA,Brest,Ligue 1,2019,29.0,1990.0,16.3,48,26,28,17,3,20,64,31.3,44,21,0,21,15,63,14,0,"FW,MF",25-29,Forward,France,Europe
80444,Philippe Coutinho,BRA,Bayern Munich,Bundesliga,2019,27.0,1992.0,15.7,21,15,1,13,7,2,13,15.4,11,9,2,7,6,27,0,0,"MF,FW",25-29,Midfielder,Brazil,South America
44136,Domenico Criscito,ITA,Genoa,Serie A,2019,32.0,1986.0,22.8,53,33,34,12,7,24,56,42.9,32,25,13,12,53,106,81,1,DF,30-34,Defender,Italy,Europe
199248,Bryan Cristante,ITA,Roma,Serie A,2019,24.0,1995.0,18.0,25,15,6,14,5,8,27,29.6,19,13,4,9,22,47,23,0,MF,20-24,Midfielder,Italy,Europe
91970,Juan Cuadrado,COL,Juventus,Serie A,2019,31.0,1988.0,29.5,67,43,32,28,7,35,62,56.5,27,22,8,14,35,102,47,0,"DF,FW",30-34,Defender,Colombia,South America
265078,Patrick Cutrone,ITA,Wolves,Premier League,2019,21.0,1998.0,3.3,4,2,2,1,1,1,5,20.0,4,1,1,0,2,6,1,0,FW,20-24,Forward,Italy,Europe
182889,Wylan Cyprien,FRA,Nice,Ligue 1,2019,24.0,1995.0,19.7,17,11,5,12,0,7,27,25.9,20,8,2,6,19,36,16,3,MF,20-24,Midfielder,France,Europe
84150,Rafael Czichos,GER,Kln,Bundesliga,2019,29.0,1990.0,24.5,43,34,26,16,1,22,45,48.9,23,24,13,11,35,78,110,1,DF,25-29,Defender,Germany,Europe
55769,Danilo D'Ambrosio,ITA,Inter,Serie A,2019,30.0,1988.0,15.6,30,16,16,12,2,16,33,48.5,17,15,4,11,14,44,25,0,DF,30-34,Defender,Italy,Europe
57370,Damien Da Silva,FRA,Rennes,Ligue 1,2019,31.0,1988.0,24.9,27,14,20,5,2,10,19,52.6,9,21,13,8,26,53,143,1,DF,30-34,Defender,France,Europe
808509,Danilo,BRA,Juventus,Serie A,2019,28.0,1991.0,16.0,30,20,16,12,2,18,30,60.0,12,12,3,9,26,56,44,0,DF,25-29,Defender,Brazil,South America
355861,Arnaut Danjuma,NED,Bournemouth,Premier League,2019,22.0,1997.0,7.0,4,2,3,1,0,1,4,25.0,3,2,0,2,8,12,4,1,MF,20-24,Midfielder,Netherlands,Europe
62688,Scott Dann,ENG,Crystal Palace,Premier League,2019,32.0,1987.0,14.1,8,4,7,1,0,8,14,57.1,6,9,7,2,14,22,67,0,DF,30-34,Defender,England,Europe
16136,Dante,BRA,Nice,Ligue 1,2019,35.0,1983.0,21.0,34,21,24,10,0,17,25,68.0,8,27,16,11,26,60,79,0,DF,35-39,Defender,Brazil,South America
424204,Alphonso Davies,CAN,Bayern Munich,Bundesliga,2019,18.0,2000.0,24.8,70,43,35,24,11,38,58,65.5,20,35,6,29,31,101,51,0,DF,Under 20,Defender,Canada,North America
257097,Ben Davies,WAL,Tottenham,Premier League,2019,26.0,1993.0,15.9,28,15,13,11,4,7,21,33.3,14,28,12,16,22,50,47,0,DF,25-29,Defender,Wales,Europe
854853,Tom Davies,ENG,Everton,Premier League,2019,21.0,1998.0,22.5,38,17,12,22,4,17,55,30.9,38,12,4,8,35,73,28,0,MF,20-24,Midfielder,England,Europe
412660,Keinan Davis,ENG,Aston Villa,Premier League,2019,21.0,1998.0,6.1,1,1,0,1,0,0,3,0.0,3,4,0,4,0,1,3,0,FW,20-24,Forward,England,Europe
121477,Craig Dawson,ENG,Watford,Premier League,2019,29.0,1990.0,26.2,29,18,16,13,0,17,31,54.8,14,41,32,9,34,63,116,0,DF,25-29,Defender,England,Europe
88755,Kevin De Bruyne,BEL,Manchester City,Premier League,2019,28.0,1991.0,31.0,45,24,8,20,17,18,66,27.3,48,26,4,22,18,63,24,2,MF,25-29,Midfielder,Belgium,Europe
56830,Sebastien De Maio,FRA,Udinese,Serie A,2019,32.0,1987.0,16.7,18,11,11,7,0,7,11,63.6,4,28,20,8,32,50,86,2,DF,30-34,Defender,France,Europe
33571,Lorenzo De Silvestri,ITA,Torino,Serie A,2019,31.0,1988.0,24.9,15,8,4,7,4,11,27,40.7,16,20,7,13,19,34,72,0,DF,30-34,Defender,Italy,Europe
57372,Lucas Deaux,FRA,Nmes,Ligue 1,2019,30.0,1988.0,14.8,49,26,16,29,4,16,45,35.6,29,20,4,16,15,64,19,0,MF,30-34,Midfielder,France,Europe
65477,Troy Deeney,ENG,Watford,Premier League,2019,31.0,1988.0,24.7,19,12,6,10,3,6,29,20.7,23,13,1,12,11,30,27,0,FW,30-34,Forward,England,Europe
353399,Romain Del Castillo,FRA,Rennes,Ligue 1,2019,23.0,1996.0,13.8,20,14,5,11,4,6,27,22.2,21,12,2,10,7,27,7,0,"FW,MF",20-24,Forward,France,Europe
170961,Thomas Delaine,FRA,Metz,Ligue 1,2019,27.0,1992.0,13.9,25,16,18,6,1,12,21,57.1,9,17,1,16,15,40,28,0,DF,25-29,Defender,France,Europe
122797,Andy Delort,ALG,Montpellier,Ligue 1,2019,27.0,1991.0,25.3,28,18,11,9,8,7,27,25.9,20,21,6,15,3,31,10,0,FW,25-29,Forward,Algeria,Africa
229004,Moussa Dembl,FRA,Lyon,Ligue 1,2019,23.0,1996.0,24.3,12,7,2,5,5,4,14,28.6,10,14,3,11,5,17,31,0,FW,20-24,Forward,France,Europe
288230,Ousmane Dembl,FRA,Barcelona,La Liga,2019,22.0,1997.0,4.0,2,2,1,1,0,2,5,40.0,3,4,0,4,0,2,0,1,FW,20-24,Forward,France,Europe
82070,Diego Demme,GER,Napoli,Serie A,2019,27.0,1991.0,10.0,18,8,14,3,1,8,23,34.8,15,9,1,8,8,26,9,0,MF,25-29,Midfielder,Germany,Europe
277114,Jason Denayer,BEL,Lyon,Ligue 1,2019,24.0,1995.0,23.7,17,13,12,5,0,10,14,71.4,4,32,29,3,20,37,83,0,DF,20-24,Defender,Belgium,Europe
324282,Fabio Depaoli,ITA,Sampdoria,Serie A,2019,22.0,1997.0,20.6,41,28,26,10,5,17,31,54.8,14,29,3,26,16,57,39,0,"MF,DF",20-24,Midfielder,Italy,Europe
29962,Daniele Dessena,ITA,Brescia,Serie A,2019,32.0,1987.0,20.8,21,11,5,14,2,6,25,24.0,19,11,1,10,11,32,21,0,MF,30-34,Midfielder,Italy,Europe
243541,Deyverson,BRA,Getafe,La Liga,2019,28.0,1991.0,2.3,0,0,0,0,0,0,1,0.0,1,2,1,1,0,0,5,0,FW,25-29,Forward,Brazil,South America
45389,Samuel Di Carmine,ITA,Hellas Verona,Serie A,2019,30.0,1988.0,14.4,2,1,0,0,2,0,8,0.0,8,3,0,3,1,3,10,0,"FW,MF",30-34,Forward,Italy,Europe
38607,Federico Di Francesco,ITA,SPAL,Serie A,2019,25.0,1994.0,12.0,11,5,2,6,3,3,15,20.0,12,9,1,8,3,14,2,1,FW,25-29,Forward,Italy,Europe
169880,Giovanni Di Lorenzo,ITA,Napoli,Serie A,2019,25.0,1993.0,33.0,59,35,27,19,13,32,61,52.5,29,27,11,16,28,87,54,0,DF,25-29,Defender,Italy,Europe
626913,Boulaye Dia,SEN,Reims,Ligue 1,2019,22.0,1996.0,20.1,15,9,7,6,2,3,10,30.0,7,9,2,7,7,22,16,0,FW,20-24,Forward,Senegal,Africa
395516,Moussa Diaby,FRA,Leverkusen,Bundesliga,2019,20.0,1999.0,19.7,10,8,3,7,0,5,15,33.3,10,6,0,6,9,19,4,0,"FW,MF",20-24,Forward,France,Europe
346289,Mouctar Diakhaby,GUI,Valencia,La Liga,2019,22.0,1996.0,16.0,11,8,7,3,1,5,8,62.5,3,17,15,2,11,22,73,0,DF,20-24,Defender,Guinea,Africa
463605,Bafod Diakit,FRA,Toulouse,Ligue 1,2019,18.0,2001.0,15.2,23,19,15,8,0,7,13,53.8,6,18,9,9,20,43,75,0,DF,Under 20,Defender,France,Europe
229005,Abdou Diallo,SEN,Paris S-G,Ligue 1,2019,23.0,1996.0,13.3,20,11,9,10,1,8,14,57.1,6,9,5,4,10,30,32,0,DF,20-24,Defender,Senegal,Africa
344888,Habib Diallo,SEN,Metz,Ligue 1,2019,24.0,1995.0,24.4,2,1,0,2,0,0,6,0.0,6,6,5,1,4,6,43,0,FW,20-24,Forward,Senegal,Africa
413032,Ibrahima Diallo,FRA,Brest,Ligue 1,2019,20.0,1999.0,17.3,38,24,15,22,1,12,29,41.4,17,9,2,7,23,61,16,3,MF,20-24,Midfielder,France,Europe
314678,Brahim Daz,MAR,Real Madrid,La Liga,2019,19.0,1999.0,0.7,1,0,0,1,0,0,2,0.0,2,2,0,2,0,1,0,0,FW,Under 20,Forward,Morocco,Africa
410059,Bakaye Dibassy,MLI,Amiens,Ligue 1,2019,29.0,1989.0,20.8,26,14,17,8,1,15,20,75.0,5,29,18,11,37,63,78,2,DF,25-29,Defender,Mali,Africa
175722,Eric Dier,ENG,Tottenham,Premier League,2019,25.0,1994.0,14.9,21,12,10,10,1,10,20,50.0,10,14,9,5,21,42,65,0,"DF,MF",25-29,Defender,England,Europe
126664,Lucas Digne,FRA,Everton,Premier League,2019,26.0,1993.0,33.7,73,49,49,19,5,33,68,48.5,35,39,10,29,42,115,108,0,DF,25-29,Defender,France,Europe
126683,Tristan Dingom,CMR,Reims,Ligue 1,2019,28.0,1991.0,9.9,10,4,3,6,1,2,12,16.7,10,6,0,6,6,16,1,0,MF,25-29,Midfielder,Cameroon,Africa
272622,Issa Diop,FRA,West Ham,Premier League,2019,22.0,1997.0,30.7,27,15,18,9,0,16,25,64.0,9,37,21,16,47,74,166,2,DF,20-24,Defender,France,Europe
287635,Assane Diouss,SEN,Saint-tienne,Ligue 1,2019,21.0,1997.0,1.3,1,1,0,1,0,0,3,0.0,3,0,0,0,0,1,2,0,MF,20-24,Midfielder,Senegal,Africa
386047,Axel Disasi,FRA,Reims,Ligue 1,2019,21.0,1998.0,27.0,32,21,18,13,1,17,27,63.0,10,29,24,5,26,58,97,0,DF,20-24,Defender,France,Europe
165513,Berat Djimsiti,ALB,Atalanta,Serie A,2019,26.0,1993.0,30.9,42,23,17,23,2,22,39,56.4,17,21,14,7,49,91,92,0,DF,25-29,Defender,Albania,Europe
234006,Keagan Dolly,RSA,Montpellier,Ligue 1,2019,26.0,1993.0,1.6,6,3,1,3,2,2,5,40.0,3,1,0,1,1,7,0,0,MF,25-29,Midfielder,South Africa,Africa
497291,Nicols Domnguez,ARG,Bologna,Serie A,2019,21.0,1998.0,7.8,21,14,15,5,1,7,18,38.9,11,12,2,10,12,33,7,0,MF,20-24,Midfielder,Argentina,South America
88684,Giulio Donati,ITA,Lecce,Serie A,2019,29.0,1990.0,19.6,32,21,22,8,2,15,28,53.6,13,19,10,9,25,57,42,0,DF,25-29,Defender,Italy,Europe
243606,Anastasios Donis,GRE,Reims,Ligue 1,2019,22.0,1996.0,6.8,3,2,2,1,0,1,9,11.1,8,2,0,2,1,4,3,0,FW,20-24,Forward,Greece,Europe
130485,Alfredo Donnarumma,ITA,Brescia,Serie A,2019,28.0,1990.0,18.7,17,9,3,9,5,6,18,33.3,12,7,0,7,5,22,1,0,FW,25-29,Forward,Italy,Europe
127187,Abdoulaye Doucour,MLI,Watford,Premier League,2019,26.0,1993.0,35.1,64,30,29,29,6,16,57,28.1,41,46,8,38,31,95,32,0,MF,25-29,Midfielder,Mali,Africa
316137,Moussa Doumbia,MLI,Reims,Ligue 1,2019,24.0,1994.0,19.1,16,8,5,6,5,7,24,29.2,17,14,1,13,9,25,5,0,"FW,MF",20-24,Forward,Mali,Africa
53400,Dominick Drexler,GER,Kln,Bundesliga,2019,29.0,1990.0,17.6,34,25,12,19,3,8,32,25.0,24,11,5,6,26,60,11,0,"MF,FW",25-29,Midfielder,Germany,Europe
257376,Domingos Duarte,POR,Granada,La Liga,2019,24.0,1995.0,34.3,30,19,24,5,1,11,20,55.0,9,34,24,10,34,64,153,1,DF,20-24,Defender,Portugal,Europe
175323,scar Duarte,CRC,Levante,La Liga,2019,30.0,1989.0,5.4,12,3,11,1,0,3,4,75.0,1,7,6,1,6,18,29,0,DF,30-34,Defender,Costa Rica,North America
232418,Ondrej Duda,SVK,Norwich City,Premier League,2019,24.0,1994.0,8.0,18,11,9,6,3,7,16,43.8,9,10,2,8,6,24,8,0,MF,20-24,Midfielder,Slovakia,Europe
119269,Shane Duffy,IRL,Brighton,Premier League,2019,27.0,1992.0,13.8,18,9,14,4,0,6,17,35.3,11,13,7,6,21,39,72,0,DF,25-29,Defender,Republic of Ireland,Europe
170321,Paul Dummett,WAL,Newcastle Utd,Premier League,2019,27.0,1991.0,13.6,27,17,19,7,1,21,27,77.8,6,23,9,14,23,50,69,0,DF,25-29,Defender,Wales,Europe
184894,Alfred Duncan,GHA,Fiorentina,Serie A,2019,26.0,1993.0,9.9,12,9,11,1,0,2,19,10.5,17,4,0,4,5,17,12,0,MF,25-29,Midfielder,Ghana,Africa
148153,Lewis Dunk,ENG,Brighton,Premier League,2019,27.0,1991.0,35.9,40,24,23,17,0,15,34,44.1,19,55,33,22,55,95,125,2,DF,25-29,Defender,England,Europe
93922,Erik Durm,GER,Eint Frankfurt,Bundesliga,2019,27.0,1992.0,5.7,13,6,9,2,2,9,17,52.9,8,11,2,9,3,16,11,0,"DF,FW",25-29,Defender,Germany,Europe
206050,Paulo Dybala,ARG,Juventus,Serie A,2019,25.0,1993.0,23.9,19,10,6,9,4,9,39,23.1,30,15,0,15,13,32,3,0,"FW,MF",25-29,Forward,Argentina,South America
340070,Simone Edera,ITA,Torino,Serie A,2019,22.0,1997.0,4.4,13,5,3,7,3,2,12,16.7,10,1,0,1,1,14,3,0,"MF,FW",20-24,Midfielder,Italy,Europe
121324,John Egan,IRL,Sheffield Utd,Premier League,2019,26.0,1992.0,35.4,44,27,34,10,0,25,45,55.6,20,39,27,12,58,102,171,4,DF,25-29,Defender,Republic of Ireland,Europe
251303,Johannes Eggestein,GER,Werder Bremen,Bundesliga,2019,21.0,1998.0,5.7,8,6,2,2,4,3,12,25.0,9,6,0,6,2,10,4,0,"MF,FW",20-24,Midfielder,Germany,Europe
272812,Kingsley Ehizibue,NED,Kln,Bundesliga,2019,24.0,1995.0,25.9,79,53,44,30,5,33,53,62.3,20,28,8,20,39,118,79,1,DF,20-24,Defender,Netherlands,Europe
49275,Albin Ekdal,SWE,Sampdoria,Serie A,2019,30.0,1989.0,26.5,51,25,18,31,2,24,68,35.3,44,35,14,21,33,84,46,1,MF,30-34,Midfielder,Sweden,Europe
66333,Ahmed Elmohamady,EGY,Aston Villa,Premier League,2019,31.0,1987.0,11.5,19,9,10,7,2,10,21,47.6,11,11,5,6,13,32,25,1,DF,30-34,Defender,Egypt,Africa
192635,Nico Elvedi,SUI,Gladbach,Bundesliga,2019,22.0,1996.0,29.1,45,27,37,8,0,19,38,50.0,19,32,15,17,62,107,112,0,DF,20-24,Defender,Switzerland,Europe
176140,Rodrigo Ely,BRA,Alavs,La Liga,2019,25.0,1993.0,23.6,22,13,15,7,0,13,29,44.8,16,23,19,4,32,54,116,0,DF,25-29,Defender,Brazil,South America
237662,Breel Embolo,SUI,Gladbach,Bundesliga,2019,22.0,1997.0,17.2,22,11,2,15,5,4,15,26.7,11,12,1,11,8,30,5,0,"FW,MF",20-24,Forward,Switzerland,Europe
181778,Emerson,BRA,Betis,La Liga,2019,20.0,1999.0,31.5,74,46,49,19,6,36,79,45.6,43,30,9,21,31,105,57,1,DF,20-24,Defender,Brazil,South America
69633,Christian Eriksen,DEN,Tottenham,Premier League,2019,27.0,1992.0,12.2,19,9,10,8,1,7,24,29.2,17,10,1,9,12,31,16,0,"MF,FW",25-29,Midfielder,Denmark,Europe
266795,Gonzalo Escalante,ARG,Eibar,La Liga,2019,26.0,1993.0,18.6,41,22,15,17,9,24,41,58.5,17,22,4,18,29,70,14,0,MF,25-29,Midfielder,Argentina,South America
64598,Bernardo Espinosa,COL,Espanyol,La Liga,2019,30.0,1989.0,25.1,24,16,18,4,2,16,28,57.1,12,19,11,8,24,48,108,2,DF,30-34,Defender,Colombia,South America
538918,Sebastiano Esposito,ITA,Inter,Serie A,2019,17.0,2002.0,2.2,3,2,0,2,1,0,5,0.0,5,3,0,3,3,6,1,0,FW,Under 20,Forward,Italy,Europe
45662,Alexander Esswein,GER,Hertha BSC,Bundesliga,2019,29.0,1990.0,2.4,6,4,4,2,0,3,8,37.5,5,8,1,7,7,13,7,1,"FW,MF",25-29,Forward,Germany,Europe
349599,Pervis Estupin,ECU,Osasuna,La Liga,2019,21.0,1998.0,33.1,84,45,53,27,4,42,77,54.5,35,30,7,23,58,142,61,6,DF,20-24,Defender,Ecuador,South America
697714,Fabinho,BRA,Liverpool,Premier League,2019,25.0,1993.0,23.1,62,35,20,35,7,26,67,38.8,41,25,2,23,34,96,19,1,MF,25-29,Midfielder,Brazil,South America
70689,Filippo Falco,ITA,Lecce,Serie A,2019,27.0,1992.0,22.4,13,7,4,5,4,5,18,27.8,13,11,1,10,2,15,1,0,"FW,MF",25-29,Forward,Italy,Europe
167796,Paolo Farag,ITA,Cagliari,Serie A,2019,26.0,1993.0,14.9,41,28,21,15,5,23,46,50.0,23,18,9,9,10,51,58,0,"DF,MF",25-29,Defender,Italy,Europe
73926,Davide Faraoni,ITA,Hellas Verona,Serie A,2019,27.0,1991.0,35.9,67,37,43,19,5,30,67,44.8,37,50,15,35,36,103,115,0,DF,25-29,Defender,Italy,Europe
83877,Diego Farias,BRA,Lecce,Serie A,2019,29.0,1990.0,9.2,9,6,3,5,1,5,18,27.8,13,7,0,7,4,13,4,0,"MF,FW",25-29,Midfielder,Brazil,South America
78917,Julien Faussurier,FRA,Brest,Ligue 1,2019,32.0,1987.0,22.0,36,22,23,13,0,21,53,39.6,32,22,7,15,33,69,46,1,DF,30-34,Defender,France,Europe
340151,Andrea Favilli,ITA,Genoa,Serie A,2019,22.0,1997.0,7.3,8,7,2,3,3,4,11,36.4,7,5,1,4,0,8,7,0,FW,20-24,Forward,Italy,Europe
45314,Federico Fazio,ARG,Roma,Serie A,2019,32.0,1987.0,13.5,19,11,12,6,1,6,11,54.5,5,8,6,2,19,38,52,0,DF,30-34,Defender,Argentina,South America
203496,Nabil Fekir,FRA,Betis,La Liga,2019,26.0,1993.0,29.3,41,26,14,19,8,12,37,32.4,25,27,3,24,10,51,3,0,"MF,FW",25-29,Midfielder,France,Europe
156501,Felipe,BRA,Atltico Madrid,La Liga,2019,30.0,1989.0,23.4,27,19,21,6,0,14,24,58.3,10,18,13,5,40,67,130,0,DF,30-34,Defender,Brazil,South America
573907,Luiz Felipe,ITA,Lazio,Serie A,2019,22.0,1997.0,22.5,42,24,24,15,3,19,32,59.4,13,39,30,9,41,83,69,2,DF,20-24,Defender,Italy,Europe
462250,Joo Flix,POR,Atltico Madrid,La Liga,2019,19.0,1999.0,19.4,9,3,3,3,3,4,14,28.6,10,4,0,4,10,19,4,1,"FW,MF",Under 20,Forward,Portugal,Europe
232895,Zinedine Ferhat,ALG,Nmes,Ligue 1,2019,26.0,1993.0,25.0,26,16,5,16,5,15,46,32.6,31,15,3,12,16,42,18,0,"FW,MF",25-29,Forward,Algeria,Africa
240306,Bruno Fernandes,POR,Manchester Utd,Premier League,2019,24.0,1994.0,13.2,22,12,9,9,4,5,38,13.2,33,6,0,6,11,33,16,0,MF,20-24,Midfielder,Portugal,Europe
247555,Edimilson Fernandes,SUI,Mainz 05,Bundesliga,2019,23.0,1996.0,16.5,33,20,12,15,6,15,33,45.5,18,17,9,8,32,65,47,1,"MF,DF",20-24,Midfielder,Switzerland,Europe
85475,Federico Fernndez,ARG,Newcastle Utd,Premier League,2019,30.0,1989.0,29.1,42,25,30,10,2,23,46,50.0,23,41,28,13,24,66,190,2,DF,30-34,Defender,Argentina,South America
259930,Gabriel Fernndez,URU,Celta Vigo,La Liga,2019,25.0,1994.0,6.2,1,0,0,1,0,1,3,33.3,2,5,1,4,2,3,2,0,"FW,MF",25-29,Forward,Uruguay,South America
389324,Fernandinho,BRA,Manchester City,Premier League,2019,34.0,1985.0,26.6,50,35,32,16,2,29,48,60.4,19,28,16,12,25,75,82,0,DF,30-34,Defender,Brazil,South America
550495,Fernando,BRA,Sevilla,La Liga,2019,32.0,1987.0,29.5,62,33,37,24,1,34,58,58.6,24,38,15,23,67,129,73,1,MF,30-34,Midfielder,Brazil,South America
197491,Alex Ferrari,ITA,Sampdoria,Serie A,2019,25.0,1994.0,11.2,18,13,13,5,0,7,12,58.3,5,13,8,5,12,30,31,0,DF,25-29,Defender,Italy,Europe
93795,Facundo Ferreyra,ARG,Espanyol,La Liga,2019,28.0,1991.0,6.4,9,4,4,5,0,3,10,30.0,7,4,0,4,2,11,5,0,"FW,MF",25-29,Forward,Argentina,South America
118284,Jordan Ferri,FRA,Montpellier,Ligue 1,2019,27.0,1992.0,12.8,22,13,7,12,3,13,44,29.5,31,9,0,9,10,32,10,0,MF,25-29,Midfielder,France,Europe
374139,Junior Firpo,DOM,Barcelona,La Liga,2019,22.0,1996.0,11.3,23,15,12,8,3,11,17,64.7,6,15,3,12,17,40,12,1,DF,20-24,Defender,Dominican Republic,North America
54383,John Fleck,SCO,Sheffield Utd,Premier League,2019,27.0,1991.0,28.0,36,25,13,14,9,22,64,34.4,42,25,3,22,24,60,26,0,MF,25-29,Midfielder,Scotland,Europe
30638,Sergio Floccari,ITA,SPAL,Serie A,2019,37.0,1981.0,10.5,8,3,3,1,4,0,13,0.0,13,9,1,8,5,13,1,0,FW,35-39,Forward,Italy,Europe
130365,Alessandro Florenzi,ITA,Roma,Serie A,2019,28.0,1991.0,11.1,14,11,8,4,2,7,20,35.0,13,9,3,6,16,30,19,0,"DF,FW",25-29,Defender,Italy,Europe
406635,Phil Foden,ENG,Manchester City,Premier League,2019,19.0,2000.0,10.0,14,10,4,6,4,6,19,31.6,13,5,0,5,6,20,2,0,"FW,MF",Under 20,Forward,England,Europe
182893,Seko Fofana,CIV,Udinese,Serie A,2019,24.0,1995.0,25.0,17,12,8,8,1,9,35,25.7,26,20,1,19,17,34,19,0,MF,20-24,Midfielder,Ivory Coast,Africa
475411,Wesley Fofana,FRA,Saint-tienne,Ligue 1,2019,18.0,2000.0,13.5,25,15,16,9,0,12,18,66.7,6,10,5,5,36,61,55,4,DF,Under 20,Defender,France,Europe
569598,Youssouf Fofana,FRA,Strasbourg,Ligue 1,2019,20.0,1999.0,11.2,25,17,10,12,3,13,30,43.3,17,11,0,11,14,39,7,0,MF,20-24,Midfielder,France,Europe
391376,Lamine Fomba,FRA,Nmes,Ligue 1,2019,21.0,1998.0,15.3,65,31,20,37,8,21,43,48.8,22,29,4,25,25,90,11,1,MF,20-24,Midfielder,France,Europe
111078,Emil Forsberg,SWE,RB Leipzig,Bundesliga,2019,27.0,1991.0,12.7,16,10,5,8,3,6,26,23.1,20,15,0,15,5,21,3,0,MF,25-29,Midfielder,Sweden,Europe
13572,Ben Foster,ENG,Watford,Premier League,2019,36.0,1983.0,38.0,1,0,1,0,0,1,3,33.3,2,1,0,1,0,1,16,2,GK,35-39,Goalkeeper,England,Europe
146795,Ryan Fraser,SCO,Bournemouth,Premier League,2019,25.0,1994.0,23.0,12,6,5,5,2,7,22,31.8,15,15,3,12,15,27,24,0,"MF,FW",25-29,Midfielder,Scotland,Europe
6636,Christian Fuchs,AUT,Leicester City,Premier League,2019,33.0,1986.0,8.6,14,9,8,6,0,8,19,42.1,11,8,3,5,17,31,33,1,DF,30-34,Defender,Austria,Europe
250013,Angelo Fulgini,FRA,Angers,Ligue 1,2019,22.0,1996.0,17.5,28,18,8,15,5,12,23,52.2,11,6,1,5,19,47,10,0,MF,20-24,Midfielder,France,Europe
75489,Niclas Fllkrug,GER,Werder Bremen,Bundesliga,2019,26.0,1993.0,4.5,2,2,1,1,0,1,3,33.3,2,3,0,3,3,5,6,0,FW,25-29,Forward,Germany,Europe
27389,Kvin Gameiro,FRA,Valencia,La Liga,2019,32.0,1987.0,17.6,17,9,7,6,4,5,21,23.8,16,10,1,9,5,22,5,0,FW,30-34,Forward,France,Europe
531949,Ignatius Ganago,CMR,Nice,Ligue 1,2019,20.0,1999.0,13.8,10,6,4,3,3,3,18,16.7,15,8,1,7,4,14,13,0,"FW,MF",20-24,Forward,Cameroon,Africa
463613,Yann Gboho,FRA,Rennes,Ligue 1,2019,18.0,2001.0,2.5,2,2,1,0,1,0,2,0.0,2,1,0,1,1,3,0,0,FW,Under 20,Forward,France,Europe
19112,Christian Gentner,GER,Union Berlin,Bundesliga,2019,33.0,1985.0,27.1,53,28,16,32,5,22,73,30.1,51,46,8,38,54,107,50,0,MF,30-34,Midfielder,Germany,Europe
119277,Yannick Gerhardt,GER,Wolfsburg,Bundesliga,2019,25.0,1994.0,9.2,28,18,7,15,6,8,21,38.1,13,11,3,8,12,40,9,0,MF,25-29,Midfielder,Germany,Europe
60540,Valre Germain,FRA,Marseille,Ligue 1,2019,29.0,1990.0,15.0,22,12,6,11,5,6,31,19.4,25,16,3,13,8,30,26,0,FW,25-29,Forward,France,Europe
183720,Anwar El Ghazi,NED,Aston Villa,Premier League,2019,24.0,1995.0,22.8,20,11,12,5,3,8,26,30.8,18,10,1,9,13,33,16,1,"FW,MF",20-24,Forward,Netherlands,Europe
313477,Paolo Ghiglione,ITA,Genoa,Serie A,2019,22.0,1997.0,19.1,31,16,15,13,3,18,35,51.4,17,17,2,15,9,40,42,1,"DF,FW",20-24,Defender,Italy,Europe
204294,Saman Ghoddos,IRN,Amiens,Ligue 1,2019,25.0,1993.0,2.6,2,2,0,1,1,1,2,50.0,1,5,0,5,2,4,3,0,FW,25-29,Forward,Iran,Asia
72792,Niko Gieelmann,GER,Dsseldorf,Bundesliga,2019,27.0,1991.0,22.9,46,31,31,11,4,22,45,48.9,23,23,6,17,27,73,55,1,DF,25-29,Defender,Germany,Europe
79501,Daniel Ginczek,GER,Wolfsburg,Bundesliga,2019,28.0,1991.0,8.5,4,3,3,1,0,1,11,9.1,10,3,1,2,1,5,3,0,FW,25-29,Forward,Germany,Europe
270051,Andrei Girotto,BRA,Nantes,Ligue 1,2019,27.0,1992.0,24.2,76,53,45,29,2,39,71,54.9,32,32,17,15,34,110,111,1,DF,25-29,Defender,Brazil,South America
82442,Olivier Giroud,FRA,Chelsea,Premier League,2019,32.0,1986.0,11.0,8,3,2,5,1,1,11,9.1,10,14,1,13,2,10,13,0,FW,30-34,Forward,France,Europe
57598,Klaus Gjasula,ALB,Paderborn 07,Bundesliga,2019,29.0,1989.0,25.3,69,39,30,35,4,30,61,49.2,31,33,6,27,32,101,50,2,MF,25-29,Midfielder,Albania,Europe
159471,Serge Gnabry,GER,Bayern Munich,Bundesliga,2019,24.0,1995.0,24.4,36,16,4,19,13,9,29,31.0,20,17,0,17,16,52,2,1,"FW,MF",20-24,Forward,Germany,Europe
378954,Joris Gnagnon,FRA,Rennes,Ligue 1,2019,22.0,1997.0,14.2,16,13,14,2,0,10,11,90.9,1,21,17,4,18,34,61,0,DF,20-24,Defender,France,Europe
343475,Ben Godfrey,ENG,Norwich City,Premier League,2019,21.0,1998.0,29.4,22,14,18,3,1,10,18,55.6,8,41,37,4,25,47,152,3,DF,20-24,Defender,England,Europe
54928,Diego Godn,URU,Inter,Serie A,2019,33.0,1986.0,18.1,38,29,19,16,3,18,32,56.3,14,17,7,10,45,83,60,1,DF,30-34,Defender,Uruguay,South America
242940,Edoardo Goldaniga,ITA,Genoa,Serie A,2019,25.0,1993.0,8.7,4,3,3,1,0,2,5,40.0,3,11,6,5,18,22,25,1,DF,25-29,Defender,Italy,Europe
263918,Aleksandr Golovin,RUS,Monaco,Ligue 1,2019,23.0,1996.0,22.9,49,27,17,26,6,14,69,20.3,55,28,0,28,31,80,22,0,MF,20-24,Midfielder,Russia,Europe
20005,Papu Gmez,ARG,Atalanta,Serie A,2019,31.0,1988.0,31.6,27,13,5,13,9,13,45,28.9,32,24,0,24,17,44,6,1,"MF,FW",30-34,Midfielder,Argentina,South America
77108,Jrme Gondorf,GER,Freiburg,Bundesliga,2019,31.0,1988.0,1.3,9,6,7,1,1,3,6,50.0,3,3,2,1,0,9,2,0,MF,30-34,Midfielder,Germany,Europe
503733,Anthony Gordon,ENG,Everton,Premier League,2019,18.0,2001.0,4.9,11,7,5,6,0,5,15,33.3,10,6,2,4,8,19,4,0,"MF,FW",Under 20,Midfielder,England,Europe
153084,Leon Goretzka,GER,Bayern Munich,Bundesliga,2019,24.0,1995.0,16.8,28,15,7,18,3,10,32,31.3,22,18,2,16,24,52,8,0,MF,20-24,Midfielder,Germany,Europe
44983,Dan Gosling,ENG,Bournemouth,Premier League,2019,29.0,1990.0,14.0,26,10,14,9,3,6,27,22.2,21,31,11,20,20,46,26,0,MF,25-29,Midfielder,England,Europe
432772,Samuel Grandsir,FRA,Brest,Ligue 1,2019,22.0,1996.0,16.6,34,22,13,16,5,11,30,36.7,19,9,0,9,14,48,5,0,"FW,MF",20-24,Forward,France,Europe
197473,Alberto Grassi,ITA,Parma,Serie A,2019,24.0,1995.0,7.1,10,4,7,3,0,5,13,38.5,8,5,2,3,19,29,9,1,MF,20-24,Midfielder,Italy,Europe
292417,Demarai Gray,JAM,Leicester City,Premier League,2019,23.0,1996.0,6.9,12,6,6,6,0,6,12,50.0,6,7,0,7,5,17,4,0,"MF,FW",20-24,Midfielder,Jamaica,North America
203460,Jack Grealish,ENG,Aston Villa,Premier League,2019,23.0,1995.0,35.9,29,19,12,12,5,13,34,38.2,21,33,12,21,22,51,22,1,"FW,MF",20-24,Forward,England,Europe
72479,Clment Grenier,FRA,Rennes,Ligue 1,2019,28.0,1991.0,9.3,21,12,6,15,0,11,40,27.5,29,7,2,5,7,28,16,0,MF,25-29,Midfielder,France,Europe
125781,Antoine Griezmann,FRA,Barcelona,La Liga,2019,28.0,1991.0,28.3,33,18,12,11,10,9,34,26.5,25,22,3,19,12,45,20,1,FW,25-29,Forward,France,Europe
195736,Florian Grillitsch,AUT,Hoffenheim,Bundesliga,2019,23.0,1995.0,26.8,59,29,34,24,1,29,61,47.5,32,33,6,27,49,108,41,1,"MF,DF",20-24,Midfielder,Austria,Europe
82873,Pascal Gro,GER,Brighton,Premier League,2019,28.0,1991.0,20.0,36,13,8,21,7,14,39,35.9,25,25,3,22,9,45,7,0,"MF,FW",25-29,Midfielder,Germany,Europe
20506,Andrs Guardado,MEX,Betis,La Liga,2019,32.0,1986.0,22.7,30,14,15,11,4,15,41,36.6,26,15,4,11,18,48,22,1,MF,30-34,Midfielder,Mexico,North America
225122,Gonalo Guedes,POR,Valencia,La Liga,2019,22.0,1996.0,14.1,19,11,11,7,1,9,32,28.1,23,10,1,9,7,26,1,0,"MF,FW",20-24,Midfielder,Portugal,Europe
93704,Josuha Guilavogui,FRA,Wolfsburg,Bundesliga,2019,28.0,1990.0,22.9,41,26,17,23,1,10,30,33.3,20,35,9,26,45,86,64,2,"MF,DF",25-29,Midfielder,France,Europe
270541,Serhou Guirassy,GUI,Amiens,Ligue 1,2019,23.0,1996.0,21.3,7,3,1,4,2,2,7,28.6,5,13,6,7,4,11,21,0,FW,20-24,Forward,Guinea,Africa
93707,Christian Gnter,GER,Freiburg,Bundesliga,2019,26.0,1993.0,33.7,25,11,17,7,1,12,35,34.3,23,29,13,16,14,39,40,0,DF,25-29,Defender,Germany,Europe
177779,Janik Haberer,GER,Freiburg,Bundesliga,2019,25.0,1994.0,19.1,26,18,8,14,4,12,45,26.7,33,25,4,21,25,51,23,0,"MF,FW",25-29,Midfielder,Germany,Europe
126281,Alexander Hack,GER,Mainz 05,Bundesliga,2019,25.0,1993.0,8.9,26,10,19,6,1,16,27,59.3,11,20,9,11,23,49,60,1,DF,25-29,Defender,Germany,Europe
223725,Munir El Haddadi,MAR,Sevilla,La Liga,2019,23.0,1995.0,13.9,19,17,6,11,2,4,21,19.0,17,8,0,8,7,26,8,0,FW,20-24,Forward,Morocco,Africa
42783,Andr Hahn,GER,Augsburg,Bundesliga,2019,28.0,1990.0,7.8,15,9,7,5,3,5,21,23.8,16,23,5,18,13,28,14,0,"FW,MF",25-29,Forward,Germany,Europe
402008,Amadou Haidara,MLI,RB Leipzig,Bundesliga,2019,21.0,1998.0,8.4,26,16,7,17,2,10,24,41.7,14,14,2,12,8,34,10,1,MF,20-24,Midfielder,Mali,Africa
398073,Achraf Hakimi,MAR,Dortmund,Bundesliga,2019,20.0,1998.0,30.2,60,41,38,14,8,27,64,42.2,37,26,2,24,30,90,27,2,"DF,MF",20-24,Defender,Morocco,Africa
98349,Romain Hamouma,FRA,Saint-tienne,Ligue 1,2019,32.0,1987.0,9.6,12,9,1,5,6,2,12,16.7,10,12,0,12,0,12,4,0,"FW,MF",30-34,Forward,France,Europe
121385,Grant Hanley,SCO,Norwich City,Premier League,2019,27.0,1991.0,14.0,24,15,17,7,0,8,14,57.1,6,25,18,7,31,55,77,1,DF,25-29,Defender,Scotland,Europe
372711,Amine Harit,MAR,Schalke 04,Bundesliga,2019,22.0,1997.0,23.4,16,7,8,5,3,6,25,24.0,19,13,0,13,7,23,2,1,"MF,FW",20-24,Midfielder,Morocco,Africa
275303,Hans Hateboer,NED,Atalanta,Serie A,2019,25.0,1994.0,26.2,36,23,20,9,7,18,38,47.4,20,22,7,15,10,46,32,1,DF,25-29,Defender,Netherlands,Europe
233124,Kortney Hause,ENG,Aston Villa,Premier League,2019,24.0,1995.0,17.2,21,9,15,5,1,8,15,53.3,7,27,19,8,20,41,98,4,DF,20-24,Defender,England,Europe
309400,Kai Havertz,GER,Leverkusen,Bundesliga,2019,20.0,1999.0,27.3,21,15,5,10,6,6,39,15.4,33,22,0,22,2,23,22,0,"MF,FW",20-24,Midfielder,Germany,Europe
206225,Isaac Hayden,ENG,Newcastle Utd,Premier League,2019,24.0,1995.0,24.7,55,27,33,17,5,20,50,40.0,30,24,7,17,38,93,38,0,MF,20-24,Midfielder,England,Europe
50202,Eden Hazard,BEL,Real Madrid,La Liga,2019,28.0,1991.0,12.0,7,3,2,3,2,3,15,20.0,12,5,0,5,6,13,0,0,"FW,MF",25-29,Forward,Belgium,Europe
108537,Jonas Hector,GER,Kln,Bundesliga,2019,29.0,1990.0,27.0,76,49,37,34,5,24,75,32.0,51,44,10,34,46,122,38,1,"MF,DF",25-29,Midfielder,Germany,Europe
110036,Dominique Heintz,GER,Freiburg,Bundesliga,2019,25.0,1993.0,27.0,47,30,40,6,1,17,43,39.5,26,38,25,13,41,88,131,1,DF,25-29,Defender,Germany,Europe
148262,Jeff Hendrick,IRL,Burnley,Premier League,2019,27.0,1992.0,21.5,18,10,7,8,3,7,27,25.9,20,21,8,13,20,38,20,0,MF,25-29,Midfielder,Republic of Ireland,Europe
16311,Rouwen Hennings,GER,Dsseldorf,Bundesliga,2019,31.0,1987.0,27.3,11,5,2,7,2,3,18,16.7,15,12,0,12,2,13,33,0,FW,30-34,Forward,Germany,Europe
202591,Benjamin Henrichs,GER,Monaco,Ligue 1,2019,22.0,1997.0,9.9,26,20,16,9,1,14,33,42.4,19,19,4,15,14,40,18,0,"DF,MF",20-24,Defender,Germany,Europe
281963,Lucas Hernndez,FRA,Bayern Munich,Bundesliga,2019,23.0,1996.0,10.2,18,9,13,3,2,9,15,60.0,6,6,1,5,15,33,17,0,DF,20-24,Defender,France,Europe
339808,Theo Hernndez,FRA,Milan,Serie A,2019,21.0,1997.0,31.3,56,39,32,18,6,33,53,62.3,20,34,6,28,43,99,62,2,DF,20-24,Defender,France,Europe
181768,Hernani,BRA,Parma,Serie A,2019,25.0,1994.0,26.9,61,31,25,31,5,30,112,26.8,82,53,11,42,50,111,51,1,MF,25-29,Midfielder,Brazil,South America
122043,Hctor Herrera,MEX,Atltico Madrid,La Liga,2019,29.0,1990.0,12.5,31,21,9,18,4,13,32,40.6,19,16,7,9,17,48,13,2,MF,25-29,Midfielder,Mexico,North America
378293,Yangel Herrera,VEN,Granada,La Liga,2019,21.0,1998.0,26.3,88,49,25,53,10,36,80,45.0,44,38,9,29,34,122,28,0,MF,20-24,Midfielder,Venezuela,South America
32711,Patrick Herrmann,GER,Gladbach,Bundesliga,2019,28.0,1991.0,16.1,24,11,8,10,6,5,16,31.3,11,21,4,17,11,35,8,0,"FW,MF",25-29,Forward,Germany,Europe
39153,Gonzalo Higuan,ARG,Juventus,Serie A,2019,31.0,1987.0,20.7,13,7,2,6,5,4,31,12.9,27,12,0,12,6,19,14,0,FW,30-34,Forward,Argentina,South America
55099,Nicolas Hfler,GER,Freiburg,Bundesliga,2019,29.0,1990.0,30.9,65,40,31,28,6,22,64,34.4,42,58,18,40,71,136,59,3,MF,25-29,Midfielder,Germany,Europe
248999,Lucas Hler,GER,Freiburg,Bundesliga,2019,25.0,1994.0,27.6,35,15,11,16,8,11,46,23.9,35,30,9,21,12,47,38,0,"FW,MF",25-29,Forward,Germany,Europe
190289,Gerrit Holtmann,PHI,Paderborn 07,Bundesliga,2019,24.0,1995.0,11.8,24,14,14,6,4,15,37,40.5,22,21,1,20,6,30,8,0,"MF,DF",20-24,Midfielder,Philippines,Asia
229006,Franck Honorat,FRA,Saint-tienne,Ligue 1,2019,22.0,1996.0,9.4,16,11,7,8,1,8,23,34.8,15,12,1,11,5,21,13,1,"FW,DF",20-24,Forward,France,Europe
61653,Conor Hourihane,IRL,Aston Villa,Premier League,2019,28.0,1991.0,17.0,16,10,4,8,4,10,25,40.0,15,19,4,15,9,25,31,0,MF,25-29,Midfielder,Republic of Ireland,Europe
52348,Benjamin Hbner,GER,Hoffenheim,Bundesliga,2019,30.0,1989.0,23.0,42,26,33,9,0,23,45,51.1,22,18,13,5,30,72,98,2,DF,30-34,Defender,Germany,Europe
85822,Florian Hbner,GER,Union Berlin,Bundesliga,2019,28.0,1991.0,9.4,16,14,12,4,0,7,17,41.2,10,11,7,4,16,32,39,0,DF,25-29,Defender,Germany,Europe
392768,Callum Hudson-Odoi,ENG,Chelsea,Premier League,2019,18.0,2000.0,9.6,10,4,4,5,1,1,7,14.3,6,9,0,9,5,15,4,1,"FW,MF",Under 20,Forward,England,Europe
207014,Will Hughes,ENG,Watford,Premier League,2019,24.0,1995.0,25.0,75,47,24,41,10,25,67,37.3,42,48,8,40,37,112,28,0,MF,20-24,Midfielder,England,Europe
10503,Uwe Hnemeier,GER,Paderborn 07,Bundesliga,2019,33.0,1986.0,13.4,20,15,9,11,0,10,20,50.0,10,22,12,10,24,44,63,0,DF,30-34,Defender,Germany,Europe
203507,Adrien Hunou,FRA,Rennes,Ligue 1,2019,25.0,1994.0,13.4,21,18,5,11,5,4,21,19.0,17,16,1,15,5,26,5,0,"FW,MF",25-29,Forward,France,Europe
200056,Elseid Hysaj,ALB,Napoli,Serie A,2019,25.0,1994.0,16.5,18,9,13,4,1,12,26,46.2,14,16,3,13,24,42,26,0,DF,25-29,Defender,Albania,Europe
59699,Simone Iacoponi,ITA,Parma,Serie A,2019,32.0,1987.0,33.9,49,25,36,12,1,26,42,61.9,16,37,29,8,35,84,140,2,DF,30-34,Defender,Italy,Europe
520468,Iago,BRA,Augsburg,Bundesliga,2019,22.0,1997.0,7.5,19,12,12,7,0,9,18,50.0,9,6,2,4,14,33,27,0,"DF,MF",20-24,Defender,Brazil,South America
3455,Zlatan Ibrahimovi,SWE,Milan,Serie A,2019,37.0,1981.0,15.1,5,1,0,2,3,1,13,7.7,12,4,3,1,5,10,21,0,FW,35-39,Forward,Sweden,Europe
295330,Kelechi Iheanacho,NGA,Leicester City,Premier League,2019,22.0,1996.0,10.7,3,1,1,2,0,1,9,11.1,8,8,1,7,3,6,8,0,FW,20-24,Forward,Nigeria,Africa
134294,Danny Ings,ENG,Southampton,Premier League,2019,27.0,1992.0,31.2,42,25,16,16,10,13,67,19.4,54,62,4,58,9,51,30,1,FW,25-29,Forward,England,Europe
133964,Lorenzo Insigne,ITA,Napoli,Serie A,2019,28.0,1991.0,31.2,21,15,6,8,7,6,35,17.1,29,13,0,13,30,51,4,1,"FW,MF",25-29,Forward,Italy,Europe
98249,Takashi Inui,JPN,Eibar,La Liga,2019,31.0,1988.0,21.8,20,10,7,8,5,11,34,32.4,23,23,4,19,18,38,12,0,"MF,FW",30-34,Midfielder,Japan,Asia
349066,Alexander Isak,SWE,Real Sociedad,La Liga,2019,19.0,1999.0,16.7,7,2,0,3,4,1,8,12.5,7,8,0,8,3,10,6,0,FW,Under 20,Forward,Sweden,Europe
242631,Alex Iwobi,NGA,Everton,Premier League,2019,23.0,1996.0,17.7,25,17,8,15,2,12,33,36.4,21,18,2,16,14,39,10,1,"MF,FW",20-24,Midfielder,Nigeria,Africa
32113,Armando Izzo,ITA,Torino,Serie A,2019,27.0,1992.0,29.8,42,24,24,14,4,17,35,48.6,18,44,29,15,71,113,121,1,DF,25-29,Defender,Italy,Europe
28335,Christophe Jallet,FRA,Amiens,Ligue 1,2019,35.0,1983.0,9.5,24,16,14,8,2,14,37,37.8,23,8,2,6,18,42,29,0,DF,35-39,Defender,France,Europe
319301,Daniel James,WAL,Manchester Utd,Premier League,2019,21.0,1997.0,25.4,20,10,5,10,5,7,45,15.6,38,23,4,19,7,27,12,0,FW,20-24,Forward,Wales,Europe
177847,Adnan Januzaj,BEL,Real Sociedad,La Liga,2019,24.0,1995.0,13.0,8,7,3,2,3,3,16,18.8,13,9,1,8,7,15,2,0,"FW,MF",20-24,Forward,Belgium,Europe
111048,Benjamin Jeannot,FRA,Dijon,Ligue 1,2019,27.0,1992.0,1.9,2,1,0,1,1,0,4,0.0,4,2,0,2,2,4,4,0,"MF,FW",25-29,Midfielder,France,Europe
249157,Fredrik Jensen,FIN,Augsburg,Bundesliga,2019,21.0,1997.0,5.1,3,1,2,1,0,2,7,28.6,5,7,1,6,1,4,3,0,"MF,FW",20-24,Midfielder,Finland,Europe
363205,Gabriel Jesus,BRA,Manchester City,Premier League,2019,22.0,1997.0,22.6,17,10,4,5,8,7,25,28.0,18,26,1,25,11,28,6,0,FW,20-24,Forward,Brazil,South America
333241,Joelinton,BRA,Newcastle Utd,Premier League,2019,22.0,1996.0,29.8,34,20,7,22,5,9,32,28.1,23,32,6,26,11,45,30,0,FW,20-24,Forward,Brazil,South America
433188,Curtis Jones,ENG,Liverpool,Premier League,2019,18.0,2001.0,1.4,4,4,0,1,3,3,4,75.0,1,2,0,2,2,6,1,0,MF,Under 20,Midfielder,England,Europe
117996,Phil Jones,ENG,Manchester Utd,Premier League,2019,27.0,1992.0,1.5,2,2,1,1,0,1,1,100.0,0,2,0,2,2,4,9,1,DF,25-29,Defender,England,Europe
326330,Frenkie de Jong,NED,Barcelona,La Liga,2019,22.0,1997.0,23.5,26,19,7,12,7,7,22,31.8,15,17,7,10,21,47,9,0,MF,20-24,Midfielder,Netherlands,Europe
512356,Jorginho,ITA,Chelsea,Premier League,2019,27.0,1991.0,26.4,66,40,24,34,8,35,91,38.5,56,30,5,25,64,130,27,2,MF,25-29,Midfielder,Italy,Europe
122155,Willian Jos,BRA,Real Sociedad,La Liga,2019,27.0,1991.0,22.3,5,2,0,4,1,2,8,25.0,6,10,4,6,1,6,16,0,FW,25-29,Forward,Brazil,South America
340950,Diogo Jota,POR,Wolves,Premier League,2019,22.0,1996.0,25.4,28,15,16,10,2,12,48,25.0,36,17,0,17,9,37,10,2,FW,20-24,Forward,Portugal,Europe
361260,Ozan Kabak,TUR,Schalke 04,Bundesliga,2019,19.0,2000.0,19.7,37,23,28,9,0,14,21,66.7,7,33,19,14,37,74,97,0,DF,Under 20,Defender,Turkey,Asia
81512,Christian Kabasele,BEL,Watford,Premier League,2019,28.0,1991.0,25.0,37,24,26,11,0,17,32,53.1,15,31,23,8,36,73,127,0,DF,25-29,Defender,Belgium,Europe
560725,Abdoul Kader Bamba,FRA,Nantes,Ligue 1,2019,25.0,1994.0,16.3,19,15,5,9,5,9,30,30.0,21,8,2,6,16,35,8,0,"FW,MF",25-29,Forward,France,Europe
106270,Florian Kainz,AUT,Kln,Bundesliga,2019,26.0,1992.0,17.3,21,13,12,6,3,15,33,45.5,18,26,2,24,13,34,11,0,"FW,MF",25-29,Forward,Austria,Europe
74297,Gal Kakuta,COD,Amiens,Ligue 1,2019,28.0,1991.0,22.2,46,27,13,27,6,17,48,35.4,31,15,1,14,16,62,8,2,"MF,FW",25-29,Midfielder,DR Congo,Africa
7971,Salomon Kalou,CIV,Hertha BSC,Bundesliga,2019,33.0,1985.0,1.6,1,0,1,0,0,0,2,0.0,2,2,0,2,0,1,1,0,"FW,MF",30-34,Forward,Ivory Coast,Africa
424051,Samuel Kalu,NGA,Bordeaux,Ligue 1,2019,21.0,1997.0,15.1,33,17,19,12,2,16,36,44.4,20,13,1,12,24,57,10,0,"DF,FW",20-24,Defender,Nigeria,Africa
356141,Daichi Kamada,JPN,Eint Frankfurt,Bundesliga,2019,22.0,1996.0,21.9,29,20,7,17,5,8,42,19.0,34,16,1,15,10,39,6,0,"MF,FW",20-24,Midfielder,Japan,Asia
394327,Boubacar Kamara,FRA,Marseille,Ligue 1,2019,19.0,1999.0,23.8,67,34,37,27,3,27,57,47.4,30,27,14,13,34,101,53,1,"DF,MF",Under 20,Defender,France,Europe
290017,Hassane Kamara,CIV,Reims,Ligue 1,2019,25.0,1994.0,19.0,58,47,40,14,4,24,35,68.6,11,17,2,15,58,116,58,0,"DF,FW",25-29,Defender,Ivory Coast,Africa
132098,Harry Kane,ENG,Tottenham,Premier League,2019,26.0,1993.0,28.7,18,12,3,12,3,4,17,23.5,13,17,7,10,6,24,30,0,FW,25-29,Forward,England,Europe
225083,N'Golo Kant,FRA,Chelsea,Premier League,2019,28.0,1991.0,19.2,44,20,22,14,8,17,36,47.2,19,29,5,24,44,88,32,2,MF,25-29,Midfielder,France,Europe
324804,Yann Karamoh,FRA,Parma,Serie A,2019,21.0,1998.0,6.4,10,7,5,4,1,3,9,33.3,6,5,0,5,2,12,3,0,"FW,MF",20-24,Forward,France,Europe
469949,Noah Katterbach,GER,Kln,Bundesliga,2019,18.0,2001.0,14.6,29,23,21,8,0,11,28,39.3,17,12,1,11,29,58,26,0,DF,Under 20,Defender,Germany,Europe
228948,Thilo Kehrer,GER,Paris S-G,Ligue 1,2019,22.0,1996.0,5.3,10,7,4,5,1,5,10,50.0,5,2,0,2,1,11,2,1,DF,20-24,Defender,Germany,Europe
302215,Naby Keta,GUI,Liverpool,Premier League,2019,24.0,1995.0,9.1,30,14,8,16,6,11,26,42.3,15,18,0,18,10,40,4,0,MF,20-24,Midfielder,Guinea,Africa
342039,Yannik Keitel,GER,Freiburg,Bundesliga,2019,19.0,2000.0,1.9,2,1,1,1,0,0,6,0.0,6,3,1,2,4,6,4,0,MF,Under 20,Midfielder,Germany,Europe
281404,Kenedy,BRA,Getafe,La Liga,2019,23.0,1996.0,6.5,9,5,3,3,3,2,5,40.0,3,10,0,10,11,20,4,0,MF,20-24,Midfielder,Brazil,South America
258883,Jonjoe Kenny,ENG,Schalke 04,Bundesliga,2019,22.0,1997.0,30.2,49,29,24,19,6,26,51,51.0,25,45,10,35,26,75,79,0,DF,20-24,Defender,England,Europe
294808,Franck Kessi,CIV,Milan,Serie A,2019,22.0,1996.0,32.3,54,29,28,18,8,16,52,30.8,36,34,5,29,34,88,32,2,MF,20-24,Midfielder,Ivory Coast,Africa
270411,Saf-Eddine Khaoui,TUN,Marseille,Ligue 1,2019,24.0,1995.0,1.2,3,1,0,3,0,2,5,40.0,3,2,0,2,1,4,4,0,"MF,FW",20-24,Midfielder,Tunisia,Africa
103565,Wahbi Khazri,TUN,Saint-tienne,Ligue 1,2019,28.0,1991.0,12.8,17,9,5,7,5,9,27,33.3,18,11,0,11,4,21,0,0,"FW,MF",25-29,Forward,Tunisia,Africa
29401,Sami Khedira,GER,Juventus,Serie A,2019,32.0,1987.0,7.6,14,7,3,8,3,4,19,21.1,15,12,1,11,3,17,13,0,MF,30-34,Midfielder,Germany,Europe
161056,Joshua Kimmich,GER,Bayern Munich,Bundesliga,2019,24.0,1995.0,31.3,52,29,21,20,11,22,55,40.0,33,38,9,29,29,81,29,0,"MF,DF",20-24,Midfielder,Germany,Europe
282041,Presnel Kimpembe,FRA,Paris S-G,Ligue 1,2019,23.0,1995.0,13.6,33,25,25,8,0,14,20,70.0,6,7,3,4,21,54,33,1,DF,20-24,Defender,France,Europe
89591,Felix Klaus,GER,Wolfsburg,Bundesliga,2019,26.0,1992.0,7.4,24,16,4,13,7,7,19,36.8,12,10,2,8,3,27,5,0,"MF,FW",25-29,Midfielder,Germany,Europe
215599,Lukas Klostermann,GER,RB Leipzig,Bundesliga,2019,23.0,1996.0,29.4,45,26,24,16,5,18,31,58.1,13,34,16,18,26,71,101,2,DF,20-24,Defender,Germany,Europe
330659,Justin Kluivert,NED,Roma,Serie A,2019,20.0,1999.0,16.8,17,11,4,8,5,7,16,43.8,9,15,0,15,6,23,7,0,FW,20-24,Forward,Netherlands,Europe
118847,Dominik Kohr,GER,Eint Frankfurt,Bundesliga,2019,25.0,1994.0,16.1,44,35,15,25,4,18,53,34.0,35,31,11,20,30,74,16,0,MF,25-29,Midfielder,Germany,Europe
84085,Timothe Kolodziejczak,FRA,Saint-tienne,Ligue 1,2019,27.0,1991.0,14.5,17,10,13,4,0,9,21,42.9,12,8,3,5,30,47,44,2,DF,25-29,Defender,France,Europe
127189,Geoffrey Kondogbia,CTA,Valencia,La Liga,2019,26.0,1993.0,20.1,63,40,40,18,5,19,51,37.3,32,25,6,19,57,120,36,2,MF,25-29,Midfielder,Central African Republic,Africa
57420,Lamine Kon,CIV,Strasbourg,Ligue 1,2019,30.0,1989.0,16.4,31,21,20,10,1,12,17,70.6,5,8,5,3,25,56,47,1,DF,30-34,Defender,Ivory Coast,Africa
413403,Ezri Konsa,ENG,Aston Villa,Premier League,2019,21.0,1997.0,22.7,18,9,12,6,0,7,16,43.8,9,34,24,10,25,43,70,2,DF,20-24,Defender,England,Europe
337725,Christian Kouam,CIV,Fiorentina,Serie A,2019,21.0,1997.0,3.3,3,2,0,3,0,0,1,0.0,1,5,1,4,1,4,1,0,"FW,MF",20-24,Forward,Ivory Coast,Africa
93128,Kalidou Koulibaly,SEN,Napoli,Serie A,2019,28.0,1991.0,23.4,51,33,30,17,4,17,28,60.7,11,28,16,12,31,82,61,1,DF,25-29,Defender,Senegal,Africa
411975,Jules Kound,FRA,Sevilla,La Liga,2019,20.0,1998.0,25.7,23,12,14,5,4,10,18,55.6,8,16,12,4,23,46,91,2,DF,20-24,Defender,France,Europe
66934,Cheikhou Kouyat,SEN,Crystal Palace,Premier League,2019,29.0,1989.0,28.1,67,32,43,20,4,26,48,54.2,22,35,11,24,43,110,58,1,"MF,DF",25-29,Midfielder,Senegal,Africa
31909,Toni Kroos,GER,Real Madrid,La Liga,2019,29.0,1990.0,29.5,56,28,18,29,9,18,70,25.7,52,27,0,27,23,79,15,0,MF,25-29,Midfielder,Germany,Europe
93604,Lukas Kbler,GER,Freiburg,Bundesliga,2019,26.0,1992.0,2.3,1,1,0,1,0,1,5,20.0,4,2,0,2,1,2,6,0,DF,25-29,Defender,Germany,Europe
405398,Takefusa Kubo,JPN,Mallorca,La Liga,2019,18.0,2001.0,25.7,34,22,16,12,6,15,44,34.1,29,19,1,18,23,57,10,0,"MF,FW",Under 20,Midfielder,Japan,Asia
74943,Juraj Kucka,SVK,Parma,Serie A,2019,32.0,1987.0,21.5,43,22,21,16,6,14,61,23.0,47,21,4,17,29,72,36,0,"MF,FW",30-34,Midfielder,Slovakia,Europe
431755,Dejan Kulusevski,SWE,Parma,Serie A,2019,19.0,2000.0,32.6,41,21,10,24,7,19,64,29.7,45,25,1,24,23,64,17,0,"FW,MF",Under 20,Forward,Sweden,Europe
134983,Andrea La Mantia,ITA,Lecce,Serie A,2019,28.0,1991.0,6.1,1,0,1,0,0,1,5,20.0,4,3,0,3,7,8,11,0,FW,25-29,Forward,Italy,Europe
181378,Gatan Laborde,FRA,Montpellier,Ligue 1,2019,25.0,1994.0,24.9,21,12,4,10,7,9,38,23.7,29,21,0,21,7,28,32,1,FW,25-29,Forward,France,Europe
93720,Alexandre Lacazette,FRA,Arsenal,Premier League,2019,28.0,1991.0,20.8,31,16,8,21,2,9,24,37.5,15,14,0,14,7,38,15,0,FW,25-29,Forward,France,Europe
223967,Konrad Laimer,AUT,RB Leipzig,Bundesliga,2019,22.0,1997.0,23.5,91,45,30,46,15,43,102,42.2,59,51,8,43,34,125,14,0,MF,20-24,Midfielder,Austria,Europe
85791,Stefan Lainer,AUT,Gladbach,Bundesliga,2019,26.0,1992.0,30.1,51,30,25,19,7,24,54,44.4,30,38,7,31,29,80,71,0,DF,25-29,Defender,Austria,Europe
174196,Kenny Lala,MAD,Strasbourg,Ligue 1,2019,27.0,1991.0,22.7,29,16,17,11,1,11,27,40.7,16,14,5,9,20,49,40,1,"DF,MF",25-29,Defender,Madagascar,Africa
43530,Adam Lallana,ENG,Liverpool,Premier League,2019,31.0,1988.0,4.2,19,9,7,9,3,6,21,28.6,15,7,0,7,5,24,3,0,"MF,FW",30-34,Midfielder,England,Europe
130394,Gianluca Lapadula,PER,Lecce,Serie A,2019,29.0,1990.0,19.8,15,8,6,8,1,5,16,31.3,11,2,0,2,1,16,14,0,FW,25-29,Forward,Peru,South America
183318,Jamaal Lascelles,ENG,Newcastle Utd,Premier League,2019,25.0,1993.0,23.1,14,3,10,4,0,4,9,44.4,5,23,20,3,28,42,116,1,DF,25-29,Defender,England,Europe
93726,Paul Lasne,FRA,Brest,Ligue 1,2019,30.0,1989.0,13.6,25,13,13,11,1,6,20,30.0,14,7,2,5,7,32,5,0,"MF,FW",30-34,Midfielder,France,Europe
39025,Danny Latza,GER,Mainz 05,Bundesliga,2019,29.0,1989.0,15.3,33,19,15,17,1,16,49,32.7,33,22,5,17,17,50,24,0,MF,25-29,Midfielder,Germany,Europe
357164,Rafael Leo,POR,Milan,Serie A,2019,20.0,1999.0,15.6,7,4,2,5,0,3,9,33.3,6,4,0,4,0,7,5,0,FW,20-24,Forward,Portugal,Europe
377393,Pierre Lees-Melou,FRA,Nice,Ligue 1,2019,26.0,1993.0,25.0,63,27,34,21,8,31,88,35.2,57,38,12,26,32,95,43,0,MF,25-29,Midfielder,France,Europe
192492,Jordan Lefort,FRA,Amiens,Ligue 1,2019,25.0,1993.0,9.4,3,2,2,1,0,3,5,60.0,2,4,1,3,9,12,29,0,DF,25-29,Defender,France,Europe
41414,Lucas Leiva,BRA,Lazio,Serie A,2019,32.0,1987.0,20.1,60,35,25,31,4,28,72,38.9,44,29,6,23,47,107,34,1,MF,30-34,Midfielder,Brazil,South America
127108,Florian Lejeune,FRA,Newcastle Utd,Premier League,2019,28.0,1991.0,4.9,8,2,6,2,0,4,7,57.1,3,6,2,4,10,18,15,2,DF,25-29,Defender,France,Europe
205562,Thomas Lemar,FRA,Atltico Madrid,La Liga,2019,23.0,1995.0,10.3,12,8,4,5,3,2,11,18.2,9,14,1,13,6,18,6,0,MF,20-24,Midfielder,France,Europe
182904,Clment Lenglet,FRA,Barcelona,La Liga,2019,24.0,1995.0,26.9,44,31,29,15,0,16,32,50.0,16,29,15,14,35,79,79,1,DF,20-24,Defender,France,Europe
159844,Christopher Lenz,GER,Union Berlin,Bundesliga,2019,24.0,1994.0,25.2,63,37,37,20,6,26,49,53.1,23,46,11,35,43,106,65,0,"DF,MF",20-24,Defender,Germany,Europe
262980,Jefferson Lerma,COL,Bournemouth,Premier League,2019,24.0,1994.0,30.0,54,32,17,31,6,22,48,45.8,26,28,12,16,57,111,54,1,MF,20-24,Midfielder,Colombia,South America
314940,Dimitri Linard,FRA,Strasbourg,Ligue 1,2019,31.0,1988.0,16.5,37,24,10,22,5,18,39,46.2,21,18,4,14,17,54,25,0,MF,30-34,Midfielder,France,Europe
225657,Philipp Lienhart,AUT,Freiburg,Bundesliga,2019,23.0,1996.0,20.2,11,4,10,1,0,6,13,46.2,7,24,17,7,28,39,86,0,DF,20-24,Defender,Austria,Europe
184573,Victor Lindelf,SWE,Manchester Utd,Premier League,2019,25.0,1994.0,34.4,29,15,16,12,1,17,20,85.0,3,25,16,9,26,55,129,0,DF,25-29,Defender,Sweden,Europe
141660,Jesse Lingard,ENG,Manchester Utd,Premier League,2019,26.0,1992.0,10.4,15,8,6,4,5,5,18,27.8,13,5,0,5,3,18,0,0,"MF,FW",25-29,Midfielder,England,Europe
348795,Giovani Lo Celso,ARG,Tottenham,Premier League,2019,23.0,1996.0,16.6,51,29,12,33,6,12,59,20.3,47,20,4,16,9,60,19,0,"MF,FW",20-24,Midfielder,Argentina,South America
581781,Enzo Loiodice,FRA,Dijon,Ligue 1,2019,18.0,2000.0,2.1,6,4,1,4,1,1,3,33.3,2,2,0,2,2,8,1,0,MF,Under 20,Midfielder,France,Europe
37304,Shane Long,IRL,Southampton,Premier League,2019,32.0,1987.0,15.5,19,10,5,8,6,7,19,36.8,12,12,0,12,4,23,16,0,FW,30-34,Forward,Republic of Ireland,Europe
346707,Sean Longstaff,ENG,Newcastle Utd,Premier League,2019,21.0,1997.0,15.3,35,19,17,16,2,20,50,40.0,30,23,5,18,19,54,20,2,MF,20-24,Midfielder,England,Europe
406040,Ademola Lookman,NGA,RB Leipzig,Bundesliga,2019,21.0,1997.0,3.4,6,4,3,1,2,1,1,100.0,0,3,0,3,1,7,0,1,"FW,MF",20-24,Forward,Nigeria,Africa
316889,Hirving Lozano,MEX,Napoli,Serie A,2019,24.0,1995.0,11.4,6,4,1,5,0,2,15,13.3,13,13,0,13,5,11,5,0,"FW,MF",20-24,Forward,Mexico,North America
578872,Jean Lucas,BRA,Lyon,Ligue 1,2019,21.0,1998.0,2.2,16,7,8,5,3,2,9,22.2,7,2,2,0,2,18,0,0,MF,20-24,Midfielder,Brazil,South America
160561,Fabio Lucioni,ITA,Lecce,Serie A,2019,31.0,1987.0,34.8,29,13,20,9,0,14,32,43.8,18,48,38,10,36,65,169,5,DF,30-34,Defender,Italy,Europe
125020,Jos Luis Palomino,ARG,Atalanta,Serie A,2019,29.0,1990.0,27.6,81,44,46,33,2,28,54,51.9,26,39,14,25,61,142,74,2,DF,25-29,Defender,Argentina,South America
46741,David Luiz,BRA,Arsenal,Premier League,2019,32.0,1987.0,31.2,28,16,14,14,0,13,24,54.2,11,42,37,5,32,60,133,2,DF,30-34,Defender,Brazil,South America
447661,Douglas Luiz,BRA,Aston Villa,Premier League,2019,21.0,1998.0,29.0,46,24,25,17,4,19,65,29.2,46,42,15,27,36,82,54,1,MF,20-24,Midfielder,Brazil,South America
96341,Romelu Lukaku,BEL,Inter,Serie A,2019,26.0,1993.0,33.1,13,7,4,7,2,3,10,30.0,7,14,6,8,1,14,28,0,FW,25-29,Forward,Belgium,Europe
534033,Alexis Mac Allister,ARG,Brighton,Premier League,2019,20.0,1998.0,3.9,9,5,4,3,2,5,9,55.6,4,12,0,12,1,10,2,0,"MF,FW",20-24,Midfielder,Argentina,South America
211251,Darwin Machs,VEN,Granada,La Liga,2019,26.0,1993.0,23.7,23,13,11,8,4,8,23,34.8,15,22,4,18,31,54,9,0,"FW,MF",25-29,Forward,Venezuela,South America
294057,James Maddison,ENG,Leicester City,Premier League,2019,22.0,1996.0,29.2,59,30,13,31,15,23,68,33.8,45,16,0,16,9,68,7,1,MF,20-24,Midfielder,England,Europe
435338,Gabriel Magalhes,BRA,Lille,Ligue 1,2019,21.0,1997.0,23.2,41,29,27,11,3,15,22,68.2,7,27,18,9,22,63,86,2,DF,20-24,Defender,Brazil,South America
66736,Lisandro Magalln,ARG,Alavs,La Liga,2019,25.0,1993.0,13.3,22,15,10,12,0,8,14,57.1,6,17,6,11,16,38,43,1,DF,25-29,Defender,Argentina,South America
474662,Hugo Magnetti,FRA,Brest,Ligue 1,2019,21.0,1998.0,2.6,16,10,7,7,2,5,9,55.6,4,4,0,4,7,23,4,0,MF,20-24,Midfielder,France,Europe
177907,Harry Maguire,ENG,Manchester Utd,Premier League,2019,26.0,1993.0,38.0,37,23,23,14,0,18,34,52.9,16,31,22,9,72,109,159,0,DF,25-29,Defender,England,Europe
296397,Arne Maier,GER,Hertha BSC,Bundesliga,2019,20.0,1999.0,5.9,9,7,6,1,2,1,10,10.0,9,5,0,5,7,16,2,1,MF,20-24,Midfielder,Germany,Europe
293944,Habib Maga,CIV,Metz,Ligue 1,2019,23.0,1996.0,25.2,84,50,36,38,10,24,64,37.5,40,39,4,35,34,118,39,2,MF,20-24,Midfielder,Ivory Coast,Africa
285845,Ainsley Maitland-Niles,ENG,Arsenal,Premier League,2019,21.0,1997.0,15.4,41,23,34,5,2,22,43,51.2,21,12,3,9,28,69,38,0,DF,20-24,Defender,England,Europe
453824,Josh Maja,NGA,Bordeaux,Ligue 1,2019,20.0,1998.0,8.2,5,2,0,2,3,1,10,10.0,9,8,4,4,1,6,3,0,FW,20-24,Forward,Nigeria,Africa
322305,Jean-Victor Makengo,FRA,Toulouse,Ligue 1,2019,21.0,1998.0,11.0,14,11,3,10,1,4,13,30.8,9,7,1,6,3,17,5,1,MF,20-24,Midfielder,France,Europe
207877,Ruslan Malinovskyi,UKR,Atalanta,Serie A,2019,26.0,1993.0,17.1,22,14,2,17,3,9,31,29.0,22,13,2,11,5,27,5,0,"MF,FW",25-29,Midfielder,Ukraine,Europe
161060,Streli Mamba,GER,Paderborn 07,Bundesliga,2019,25.0,1994.0,16.9,15,9,0,9,6,1,13,7.7,12,12,2,10,6,21,2,0,FW,25-29,Forward,Germany,Europe
83132,Vincent Manceau,FRA,Angers,Ligue 1,2019,30.0,1989.0,22.0,34,22,18,13,3,16,36,44.4,20,16,3,13,22,56,51,0,DF,30-34,Defender,France,Europe
256448,Gianluca Mancini,ITA,Roma,Serie A,2019,23.0,1996.0,30.4,49,26,26,18,5,22,44,50.0,22,32,15,17,60,109,98,1,"DF,MF",20-24,Defender,Italy,Europe
80293,Assa Mandi,ALG,Betis,La Liga,2019,27.0,1991.0,28.6,33,15,22,8,3,18,28,64.3,10,29,15,14,38,71,93,0,DF,25-29,Defender,Algeria,Africa
308279,Rolando Mandragora,ITA,Udinese,Serie A,2019,22.0,1997.0,22.8,47,24,15,25,7,15,55,27.3,40,30,5,25,26,73,25,0,MF,20-24,Midfielder,Italy,Europe
200512,Sadio Man,SEN,Liverpool,Premier League,2019,27.0,1992.0,30.5,44,32,9,20,15,13,40,32.5,27,19,0,19,13,57,11,2,FW,25-29,Forward,Senegal,Africa
18934,Thomas Mangani,FRA,Angers,Ligue 1,2019,32.0,1987.0,20.8,33,23,15,16,2,14,47,29.8,33,17,2,15,12,45,20,1,MF,30-34,Midfielder,France,Europe
357072,Faitout Maouassa,FRA,Rennes,Ligue 1,2019,21.0,1998.0,20.0,51,33,27,20,4,14,26,53.8,12,13,5,8,23,74,59,0,DF,20-24,Defender,France,Europe
209212,Solly March,ENG,Brighton,Premier League,2019,25.0,1994.0,12.7,25,12,16,6,3,9,19,47.4,10,16,4,12,20,45,14,2,"FW,MF",25-29,Forward,England,Europe
277167,Gian Marco Ferrari,ITA,Sassuolo,Serie A,2019,27.0,1992.0,21.1,9,5,6,3,0,4,8,50.0,4,25,22,3,26,35,41,1,DF,25-29,Defender,Italy,Europe
250845,Jos Mara Gimnez,URU,Atltico Madrid,La Liga,2019,24.0,1995.0,19.5,20,16,18,1,1,7,11,63.6,4,14,7,7,23,43,75,1,DF,20-24,Defender,Uruguay,South America
441385,Gonzalo Maroni,ARG,Sampdoria,Serie A,2019,20.0,1999.0,2.0,3,1,1,1,1,3,7,42.9,4,1,0,1,3,6,0,0,"MF,FW",20-24,Midfielder,Argentina,South America
164108,Bruno Martella,ITA,Brescia,Serie A,2019,26.0,1992.0,14.1,18,9,14,3,1,9,16,56.3,7,13,7,6,17,35,48,1,DF,25-29,Defender,Italy,Europe
655488,Gabriel Martinelli,BRA,Arsenal,Premier League,2019,18.0,2001.0,7.4,20,15,10,6,4,7,20,35.0,13,15,1,14,3,23,8,0,FW,Under 20,Forward,Brazil,South America
406625,Lautaro Martnez,ARG,Inter,Serie A,2019,21.0,1997.0,27.2,22,7,2,8,12,4,34,11.8,30,30,2,28,15,37,11,0,FW,20-24,Forward,Argentina,South America
142031,Omar Mascarell,EQG,Schalke 04,Bundesliga,2019,26.0,1993.0,22.5,42,23,17,22,3,21,57,36.8,36,46,14,32,62,104,40,0,MF,25-29,Midfielder,Equatorial Guinea,Africa
286949,Adam Masina,MAR,Watford,Premier League,2019,25.0,1994.0,20.2,38,22,24,11,3,14,37,37.8,23,26,12,14,28,66,66,0,DF,25-29,Defender,Morocco,Africa
420002,Jean-Philippe Mateta,FRA,Mainz 05,Bundesliga,2019,22.0,1997.0,11.7,2,2,0,2,0,0,6,0.0,6,3,2,1,1,3,11,0,FW,20-24,Forward,France,Europe
33923,Blaise Matuidi,FRA,Juventus,Serie A,2019,32.0,1987.0,24.9,48,27,13,27,8,13,34,38.2,21,35,6,29,22,70,16,0,MF,30-34,Midfielder,France,Europe
217115,Neal Maupay,FRA,Brighton,Premier League,2019,22.0,1996.0,30.7,20,12,1,13,6,9,29,31.0,20,24,0,24,4,24,10,0,FW,20-24,Forward,France,Europe
340328,Stephy Mavididi,ENG,Dijon,Ligue 1,2019,21.0,1998.0,15.5,18,11,7,8,3,10,26,38.5,16,11,0,11,7,25,5,0,"FW,MF",20-24,Forward,England,Europe
342229,Kylian Mbapp,FRA,Paris S-G,Ligue 1,2019,20.0,1998.0,16.8,7,2,1,5,1,3,10,30.0,7,4,0,4,3,10,0,0,FW,20-24,Forward,France,Europe
207715,Ibrahima Mbaye,SEN,Bologna,Serie A,2019,24.0,1994.0,16.7,19,10,13,4,2,7,17,41.2,10,22,11,11,15,34,42,0,DF,20-24,Defender,Senegal,Africa
41416,James McArthur,SCO,Crystal Palace,Premier League,2019,31.0,1987.0,34.3,88,51,43,34,11,37,106,34.9,69,69,19,50,60,148,56,0,MF,30-34,Midfielder,Scotland,Europe
193116,John McGinn,SCO,Aston Villa,Premier League,2019,24.0,1994.0,25.7,53,35,19,23,11,18,62,29.0,44,25,1,24,25,78,18,0,MF,20-24,Midfielder,Scotland,Europe
35416,David McGoldrick,IRL,Sheffield Utd,Premier League,2019,31.0,1987.0,20.2,41,26,9,24,8,5,20,25.0,15,14,2,12,3,44,23,0,FW,30-34,Forward,Republic of Ireland,Europe
332697,Weston McKennie,USA,Schalke 04,Bundesliga,2019,20.0,1998.0,23.0,38,20,17,16,5,13,40,32.5,27,38,12,26,46,84,39,0,"MF,DF",20-24,Midfielder,United States,North America
126600,Kenny McLean,SCO,Norwich City,Premier League,2019,27.0,1992.0,33.0,44,29,20,18,6,14,42,33.3,28,32,7,25,38,82,67,2,MF,25-29,Midfielder,Scotland,Europe
584769,Dwight McNeil,ENG,Burnley,Premier League,2019,19.0,1999.0,37.1,47,33,18,22,7,23,71,32.4,48,60,8,52,30,77,34,0,MF,Under 20,Midfielder,England,Europe
315969,Scott McTominay,SCO,Manchester Utd,Premier League,2019,22.0,1996.0,19.7,43,22,14,25,4,17,32,53.1,15,25,5,20,31,74,34,2,MF,20-24,Midfielder,Scotland,Europe
124002,Biagio Meccariello,ITA,Lecce,Serie A,2019,28.0,1991.0,8.5,23,13,15,6,2,12,29,41.4,17,14,2,12,10,33,25,0,DF,25-29,Defender,Italy,Europe
60889,Gary Medel,CHI,Bologna,Serie A,2019,31.0,1987.0,19.8,43,22,15,24,4,16,43,37.2,27,24,8,16,34,77,31,2,MF,30-34,Midfielder,Chile,South America
74810,Ben Mee,ENG,Burnley,Premier League,2019,29.0,1989.0,32.0,41,22,25,16,0,17,29,58.6,12,42,31,11,42,83,165,2,DF,25-29,Defender,England,Europe
196815,Joshua Mees,GER,Union Berlin,Bundesliga,2019,23.0,1996.0,3.6,8,5,3,4,1,4,12,33.3,8,3,0,3,2,10,4,0,"MF,FW",20-24,Midfielder,Germany,Europe
425400,Farid El Melali,ALG,Angers,Ligue 1,2019,22.0,1997.0,3.4,7,5,2,2,3,4,14,28.6,10,5,0,5,2,9,4,0,"MF,FW",20-24,Midfielder,Algeria,Africa
362842,Arthur Melo,BRA,Barcelona,La Liga,2019,22.0,1996.0,13.1,15,10,4,7,4,4,12,33.3,8,9,0,9,4,19,5,2,MF,20-24,Midfielder,Brazil,South America
135617,Thiago Mendes,BRA,Lyon,Ligue 1,2019,27.0,1992.0,20.1,43,29,20,19,4,21,45,46.7,24,21,7,14,46,89,36,0,MF,25-29,Midfielder,Brazil,South America
290561,Alexandre Mendy,GNB,Brest,Ligue 1,2019,25.0,1994.0,10.0,5,1,1,0,4,1,4,25.0,3,4,1,3,0,5,10,0,FW,25-29,Forward,Guinea-Bissau,Africa
157495,Benjamin Mendy,FRA,Manchester City,Premier League,2019,25.0,1994.0,16.6,18,15,7,7,4,9,27,33.3,18,10,2,8,16,34,21,3,DF,25-29,Defender,France,Europe
291417,Ferland Mendy,FRA,Real Madrid,La Liga,2019,24.0,1995.0,20.1,32,26,20,9,3,14,18,77.8,4,19,5,14,22,54,30,1,DF,20-24,Defender,France,Europe
111051,Nampalys Mendy,SEN,Leicester City,Premier League,2019,27.0,1992.0,3.2,7,5,4,1,2,4,5,80.0,1,4,1,3,6,13,6,0,MF,25-29,Midfielder,Senegal,Africa
480987,Chris Mepham,WAL,Bournemouth,Premier League,2019,21.0,1997.0,10.1,20,9,13,7,0,11,14,78.6,3,17,11,6,17,37,62,1,DF,20-24,Defender,Wales,Europe
28003,Lionel Messi,ARG,Barcelona,La Liga,2019,32.0,1987.0,32.0,21,10,4,7,10,3,21,14.3,18,9,0,9,7,28,1,0,FW,30-34,Forward,Argentina,South America
100986,Thomas Meunier,BEL,Paris S-G,Ligue 1,2019,27.0,1991.0,13.8,27,21,9,12,6,16,26,61.5,10,17,5,12,18,45,19,1,DF,25-29,Defender,Belgium,Europe
186988,Sven Michel,GER,Paderborn 07,Bundesliga,2019,29.0,1990.0,15.3,14,12,3,5,6,3,20,15.0,17,13,2,11,7,21,7,0,FW,25-29,Forward,Germany,Europe
401530,der Milito,BRA,Real Madrid,La Liga,2019,21.0,1998.0,11.4,25,15,15,9,1,10,17,58.8,7,12,6,6,20,45,42,0,DF,20-24,Defender,Brazil,South America
3333,James Milner,ENG,Liverpool,Premier League,2019,33.0,1986.0,10.4,16,10,3,10,3,6,26,23.1,20,12,3,9,7,23,17,1,"MF,DF",30-34,Midfielder,England,Europe
289446,Yerry Mina,COL,Everton,Premier League,2019,24.0,1994.0,25.4,39,22,25,12,2,18,24,75.0,6,20,14,6,28,67,102,1,DF,20-24,Defender,Colombia,South America
165793,Takumi Minamino,JPN,Liverpool,Premier League,2019,24.0,1995.0,2.8,3,3,0,2,1,2,10,20.0,8,3,0,3,0,3,3,0,"FW,MF",20-24,Forward,Japan,Asia
253677,Tyrone Mings,ENG,Aston Villa,Premier League,2019,26.0,1993.0,32.2,15,11,11,3,1,10,13,76.9,3,56,48,8,30,45,190,4,DF,25-29,Defender,England,Europe
35747,Simone Missiroli,ITA,SPAL,Serie A,2019,33.0,1986.0,31.1,42,27,18,20,4,13,43,30.2,30,42,27,15,54,96,62,1,MF,30-34,Midfielder,Italy,Europe
50512,Anthony Modeste,FRA,Kln,Bundesliga,2019,31.0,1988.0,12.6,10,5,1,5,4,1,10,10.0,9,5,3,2,0,10,19,0,FW,30-34,Forward,France,Europe
5017,Niklas Moisander,FIN,Werder Bremen,Bundesliga,2019,33.0,1985.0,22.0,27,15,19,6,2,11,26,42.3,15,37,19,18,49,76,85,0,DF,30-34,Defender,Finland,Europe
222859,Florent Mollet,FRA,Montpellier,Ligue 1,2019,27.0,1991.0,18.7,13,11,3,8,2,7,28,25.0,21,9,1,8,9,22,2,0,"MF,FW",25-29,Midfielder,France,Europe
127182,Thomas Monconduit,FRA,Amiens,Ligue 1,2019,28.0,1991.0,15.2,26,12,6,18,2,9,26,34.6,17,11,4,7,10,36,25,3,MF,25-29,Midfielder,France,Europe
381362,Wesley Moraes,BRA,Aston Villa,Premier League,2019,22.0,1996.0,19.8,15,8,3,8,4,0,5,0.0,5,10,2,8,4,19,23,0,FW,20-24,Forward,Brazil,South America
58500,Alfredo Morales,USA,Dsseldorf,Bundesliga,2019,29.0,1990.0,19.2,31,15,11,16,4,11,35,31.4,24,17,6,11,18,49,37,0,MF,25-29,Midfielder,United States,North America
23960,Jrmy Morel,MAD,Rennes,Ligue 1,2019,35.0,1984.0,20.1,15,9,13,1,1,9,20,45.0,11,21,17,4,17,32,59,1,DF,35-39,Defender,Madagascar,Africa
10003,Wes Morgan,JAM,Leicester City,Premier League,2019,35.0,1984.0,4.8,4,1,3,1,0,0,3,0.0,3,5,3,2,7,11,19,0,DF,35-39,Defender,Jamaica,North America
427161,Lebo Mothiba,RSA,Strasbourg,Ligue 1,2019,23.0,1996.0,11.6,4,3,1,1,2,1,6,16.7,5,5,0,5,3,7,1,0,FW,20-24,Forward,South Africa,Africa
77100,Lucas Moura,BRA,Tottenham,Premier League,2019,26.0,1992.0,24.9,57,33,25,22,10,16,58,27.6,42,29,2,27,15,72,27,0,"FW,MF",25-29,Forward,Brazil,South America
461906,Joo Moutinho,POR,Wolves,Premier League,2019,32.0,1986.0,34.5,93,50,43,41,9,46,139,33.1,93,43,13,30,50,143,18,1,MF,30-34,Midfielder,Portugal,Europe
348026,Nordi Mukiele,FRA,RB Leipzig,Bundesliga,2019,21.0,1997.0,19.8,61,39,39,12,10,25,38,65.8,13,26,4,22,47,108,57,0,"DF,FW",20-24,Defender,France,Europe
58358,Thomas Mller,GER,Bayern Munich,Bundesliga,2019,29.0,1989.0,25.1,45,27,7,26,12,22,69,31.9,47,27,3,24,12,57,8,0,"MF,FW",25-29,Midfielder,Germany,Europe
289061,Alessandro Murgia,ITA,SPAL,Serie A,2019,22.0,1996.0,19.4,27,17,16,8,3,14,34,41.2,20,10,3,7,18,45,15,0,MF,20-24,Midfielder,Italy,Europe
119228,Luis Muriel,COL,Atalanta,Serie A,2019,28.0,1991.0,14.0,15,9,3,8,4,3,14,21.4,11,12,0,12,4,19,0,0,FW,25-29,Forward,Colombia,South America
45693,Glenn Murray,ENG,Brighton,Premier League,2019,35.0,1983.0,8.9,5,2,0,3,2,2,9,22.2,7,6,2,4,1,6,12,0,FW,35-39,Forward,England,Europe
171399,Nicola Murru,ITA,Sampdoria,Serie A,2019,24.0,1994.0,25.1,40,22,24,8,8,21,41,51.2,20,22,4,18,27,67,58,0,DF,20-24,Defender,Italy,Europe
88590,Shkodran Mustafi,GER,Arsenal,Premier League,2019,27.0,1992.0,13.4,17,10,11,5,1,6,12,50.0,6,10,6,4,18,35,72,0,DF,25-29,Defender,Germany,Europe
342209,Kvin N'Doram,FRA,Metz,Ligue 1,2019,23.0,1996.0,18.3,43,28,19,21,3,17,40,42.5,23,20,8,12,26,69,23,0,MF,20-24,Midfielder,France,Europe
315063,Nahitan Nndez,URU,Cagliari,Serie A,2019,23.0,1995.0,32.2,58,38,37,17,4,25,69,36.2,44,30,1,29,25,83,26,0,"MF,DF",20-24,Midfielder,Uruguay,South America
274839,Wilfred Ndidi,NGA,Leicester City,Premier League,2019,22.0,1996.0,29.7,128,67,56,61,11,45,91,49.5,46,52,6,46,80,208,69,3,MF,20-24,Midfielder,Nigeria,Africa
287717,Emanuele Ndoj,ALB,Brescia,Serie A,2019,22.0,1996.0,6.2,9,6,2,6,1,3,13,23.1,10,7,0,7,5,14,5,0,MF,20-24,Midfielder,Albania,Europe
54581,Ilija Nestorovski,MKD,Udinese,Serie A,2019,29.0,1990.0,13.9,10,7,5,5,0,6,21,28.6,15,13,2,11,4,14,12,0,FW,25-29,Forward,North Macedonia,Europe
278332,Florian Neuhaus,GER,Gladbach,Bundesliga,2019,22.0,1997.0,26.2,42,23,13,22,7,12,54,22.2,42,24,4,20,27,69,8,0,MF,20-24,Midfielder,Germany,Europe
225161,Rben Neves,POR,Wolves,Premier League,2019,22.0,1997.0,34.0,62,33,27,32,3,34,86,39.5,52,38,9,29,56,118,34,1,MF,20-24,Midfielder,Portugal,Europe
68290,Neymar,BRA,Paris S-G,Ligue 1,2019,27.0,1992.0,14.6,12,7,1,9,2,3,21,14.3,18,10,0,10,4,16,1,0,"MF,FW",25-29,Midfielder,Brazil,South America
205587,Opa Nguette,SEN,Metz,Ligue 1,2019,25.0,1994.0,20.3,44,28,23,15,6,11,39,28.2,28,17,3,14,12,56,12,0,FW,25-29,Forward,Senegal,Africa
490417,Ibrahima Niane,SEN,Metz,Ligue 1,2019,20.0,1999.0,10.6,8,7,2,5,1,5,16,31.3,11,5,1,4,10,18,11,1,FW,20-24,Forward,Senegal,Africa
538996,Tanguy Nianzou,FRA,Paris S-G,Ligue 1,2019,17.0,2002.0,5.0,2,1,0,1,1,1,3,33.3,2,4,2,2,3,5,6,0,"DF,MF",Under 20,Defender,France,Europe
152963,Florian Niederlechner,GER,Augsburg,Bundesliga,2019,28.0,1990.0,30.2,21,13,7,9,5,4,21,19.0,17,21,5,16,8,29,38,0,"FW,MF",25-29,Forward,Germany,Europe
392810,Casimir Ninga,CHA,Angers,Ligue 1,2019,26.0,1993.0,7.6,5,5,4,0,1,1,5,20.0,4,5,0,5,3,8,2,0,"MF,FW",25-29,Midfielder,Chad,Africa
340324,Eddie Nketiah,ENG,Arsenal,Premier League,2019,20.0,1999.0,7.0,7,5,3,4,0,2,6,33.3,4,9,0,9,2,9,5,0,FW,20-24,Forward,England,Europe
344381,Christopher Nkunku,FRA,RB Leipzig,Bundesliga,2019,21.0,1997.0,21.4,21,13,4,11,6,9,33,27.3,24,25,2,23,20,41,8,0,"MF,FW",20-24,Midfielder,France,Europe
324811,Arnaud Nordin,FRA,Saint-tienne,Ligue 1,2019,21.0,1998.0,10.1,7,3,3,3,1,4,13,30.8,9,11,1,10,4,11,6,0,"FW,MF",20-24,Forward,France,Europe
111508,Allan Nyom,CMR,Getafe,La Liga,2019,31.0,1988.0,26.9,45,25,26,15,4,20,37,54.1,17,24,5,19,14,59,50,1,"DF,MF",30-34,Defender,Cameroon,Africa
212829,Jack O'Connell,ENG,Sheffield Utd,Premier League,2019,25.0,1994.0,32.4,23,14,15,6,2,10,20,50.0,10,38,17,21,42,65,154,1,DF,25-29,Defender,England,Europe
101213,Pedro Obiang,EQG,Sassuolo,Serie A,2019,27.0,1992.0,18.6,46,31,21,19,6,19,40,47.5,21,24,10,14,21,67,31,1,MF,25-29,Midfielder,Equatorial Guinea,Africa
189441,Lucas Ocampos,ARG,Sevilla,La Liga,2019,25.0,1994.0,30.5,54,31,30,19,5,30,72,41.7,42,33,2,31,22,76,27,0,"FW,MF",25-29,Forward,Argentina,South America
53437,Bastian Oczipka,GER,Schalke 04,Bundesliga,2019,30.0,1989.0,33.5,72,50,42,21,9,36,62,58.1,26,35,6,29,37,109,68,0,DF,30-34,Defender,Germany,Europe
48002,Angelo Ogbonna,ITA,West Ham,Premier League,2019,31.0,1988.0,31.0,38,24,20,14,4,18,32,56.3,14,50,32,18,27,65,134,1,DF,30-34,Defender,Italy,Europe
563812,Christian Oliva,URU,Cagliari,Serie A,2019,23.0,1996.0,5.2,13,7,9,4,0,5,15,33.3,10,5,0,5,7,20,14,0,MF,20-24,Midfielder,Uruguay,South America
119234,Karim Onisiwo,AUT,Mainz 05,Bundesliga,2019,27.0,1992.0,19.2,27,19,6,10,11,5,13,38.5,8,20,3,17,7,34,11,0,FW,25-29,Forward,Austria,Europe
60890,Fabin Orellana,CHI,Eibar,La Liga,2019,33.0,1986.0,26.6,29,18,10,6,13,14,52,26.9,38,9,0,9,20,49,2,0,"MF,FW",30-34,Midfielder,Chile,South America
148368,Divock Origi,BEL,Liverpool,Premier League,2019,24.0,1995.0,8.0,12,9,2,5,5,4,9,44.4,5,2,0,2,4,16,5,0,FW,20-24,Forward,Belgium,Europe
108650,Yuya Osako,JPN,Werder Bremen,Bundesliga,2019,29.0,1990.0,20.5,29,16,5,19,5,3,29,10.3,26,10,1,9,6,35,13,1,"FW,MF",25-29,Forward,Japan,Asia
218087,Ben Osborn,ENG,Sheffield Utd,Premier League,2019,24.0,1994.0,6.6,15,10,11,3,1,3,16,18.8,13,6,1,5,6,21,7,0,"MF,DF",20-24,Midfielder,England,Europe
818495,Otvio,BRA,Bordeaux,Ligue 1,2019,25.0,1994.0,24.6,80,45,23,52,5,35,82,42.7,47,26,9,17,41,121,40,6,MF,25-29,Midfielder,Brazil,South America
221611,Paulo Otvio,BRA,Wolfsburg,Bundesliga,2019,24.0,1994.0,4.2,21,16,11,9,1,10,13,76.9,3,12,2,10,9,30,11,0,DF,20-24,Defender,Brazil,South America
400485,Adam Ounas,ALG,Nice,Ligue 1,2019,22.0,1996.0,12.5,10,5,2,6,2,5,13,38.5,8,9,1,8,11,21,8,1,"FW,MF",20-24,Forward,Algeria,Africa
181547,Gonalo Pacincia,POR,Eint Frankfurt,Bundesliga,2019,24.0,1994.0,14.3,9,5,1,4,4,3,13,23.1,10,9,1,8,1,10,11,0,FW,20-24,Forward,Portugal,Europe
139279,Nicolas Pallois,FRA,Nantes,Ligue 1,2019,31.0,1987.0,21.0,47,36,28,17,2,31,55,56.4,24,18,13,5,40,87,77,1,DF,30-34,Defender,France,Europe
12563,Goran Pandev,MKD,Genoa,Serie A,2019,36.0,1983.0,18.7,12,8,2,7,3,3,25,12.0,22,4,1,3,0,12,5,1,"FW,MF",35-39,Forward,North Macedonia,Europe
34322,Sokratis Papastathopoulos,GRE,Arsenal,Premier League,2019,31.0,1988.0,18.8,25,16,17,7,1,10,21,47.6,11,30,24,6,17,42,68,1,DF,30-34,Defender,Greece,Europe
444523,Lucas Paquet,BRA,Milan,Serie A,2019,21.0,1997.0,12.3,33,19,12,17,4,14,37,37.8,23,17,2,15,8,41,9,0,"MF,FW",20-24,Midfielder,Brazil,South America
166237,Leandro Paredes,ARG,Paris S-G,Ligue 1,2019,25.0,1994.0,9.0,22,14,7,14,1,13,29,44.8,16,7,1,6,15,37,7,0,MF,25-29,Midfielder,Argentina,South America
230784,Thomas Partey,GHA,Atltico Madrid,La Liga,2019,26.0,1993.0,28.3,70,41,34,30,6,26,58,44.8,32,32,8,24,48,118,41,7,MF,25-29,Midfielder,Ghana,Africa
55215,Javier Pastore,ARG,Roma,Serie A,2019,30.0,1989.0,5.7,14,10,3,5,6,5,12,41.7,7,4,0,4,5,19,5,0,MF,30-34,Midfielder,Argentina,South America
842718,Paulinho,BRA,Leverkusen,Bundesliga,2019,19.0,2000.0,3.4,4,3,3,1,0,1,2,50.0,1,5,1,4,1,5,0,0,"MF,FW",Under 20,Midfielder,Brazil,South America
353366,Benjamin Pavard,FRA,Bayern Munich,Bundesliga,2019,23.0,1996.0,31.0,34,22,15,10,9,16,28,57.1,12,28,10,18,52,86,60,0,DF,20-24,Defender,France,Europe
37647,Dimitri Payet,FRA,Marseille,Ligue 1,2019,32.0,1987.0,21.4,22,12,8,8,6,10,26,38.5,16,8,1,7,8,30,12,0,"FW,MF",30-34,Forward,France,Europe
19447,Giampaolo Pazzini,ITA,Hellas Verona,Serie A,2019,34.0,1984.0,3.4,1,0,0,1,0,0,4,0.0,4,2,0,2,1,2,4,0,"FW,MF",30-34,Forward,Italy,Europe
286297,Lorenzo Pellegrini,ITA,Roma,Serie A,2019,23.0,1996.0,23.3,30,13,9,13,8,12,33,36.4,21,28,0,28,15,45,18,0,MF,20-24,Midfielder,Italy,Europe
346567,Luca Pellegrini,ITA,Cagliari,Serie A,2019,20.0,1999.0,21.2,31,15,20,7,4,15,38,39.5,23,19,2,17,21,52,45,2,DF,20-24,Defender,Italy,Europe
343052,Nicolas Pp,CIV,Arsenal,Premier League,2019,24.0,1995.0,22.3,32,17,15,13,4,8,16,50.0,8,15,2,13,8,40,5,0,FW,20-24,Forward,Ivory Coast,Africa
203394,Andreas Pereira,BRA,Manchester Utd,Premier League,2019,23.0,1996.0,16.5,24,13,8,9,7,10,39,25.6,29,13,0,13,7,31,7,0,"MF,FW",20-24,Midfielder,Brazil,South America
264116,Gastn Pereiro,URU,Cagliari,Serie A,2019,24.0,1995.0,3.9,2,2,2,0,0,1,4,25.0,3,1,0,1,0,2,1,1,"MF,FW",20-24,Midfielder,Uruguay,South America
54984,Diego Perotti,ARG,Roma,Serie A,2019,31.0,1988.0,9.7,16,13,5,8,3,5,20,25.0,15,14,0,14,3,19,6,0,"FW,MF",30-34,Forward,Argentina,South America
318523,Romain Perraud,FRA,Brest,Ligue 1,2019,21.0,1997.0,18.6,29,14,18,9,2,14,28,50.0,14,24,9,15,27,56,50,0,DF,20-24,Defender,France,Europe
199258,Andrea Petagna,ITA,SPAL,Serie A,2019,24.0,1995.0,33.7,9,4,2,7,0,3,17,17.6,14,11,5,6,1,10,27,0,FW,20-24,Forward,Italy,Europe
42936,Nils Petersen,GER,Freiburg,Bundesliga,2019,30.0,1988.0,27.1,19,14,7,9,3,10,28,35.7,18,32,6,26,10,29,67,0,"FW,MF",30-34,Forward,Germany,Europe
218067,Jacopo Petriccione,ITA,Lecce,Serie A,2019,24.0,1995.0,23.8,38,20,29,9,0,15,57,26.3,42,20,7,13,28,66,25,2,MF,20-24,Midfielder,Italy,Europe
113133,Germn Pezzella,ARG,Fiorentina,Serie A,2019,28.0,1991.0,31.4,36,18,26,9,1,14,32,43.8,18,31,20,11,55,91,134,1,DF,25-29,Defender,Argentina,South America
255220,Romain Philippoteaux,FRA,Nmes,Ligue 1,2019,31.0,1988.0,22.2,23,12,11,11,1,9,43,20.9,34,22,1,21,13,36,10,0,"FW,MF",30-34,Forward,France,Europe
60583,Jrmy Pied,FRA,Lille,Ligue 1,2019,30.0,1989.0,5.0,18,10,6,11,1,11,16,68.8,5,8,0,8,7,25,10,0,DF,30-34,Defender,France,Europe
43763,Erik Pieters,NED,Burnley,Premier League,2019,30.0,1988.0,20.9,54,32,18,29,7,28,69,40.6,41,30,4,26,28,82,60,1,"DF,MF",30-34,Defender,Netherlands,Europe
315865,Andrea Pinamonti,ITA,Genoa,Serie A,2019,20.0,1999.0,24.8,19,12,1,7,11,5,25,20.0,20,19,2,17,9,28,25,0,FW,20-24,Forward,Italy,Europe
101922,Fabio Pisacane,ITA,Cagliari,Serie A,2019,33.0,1986.0,27.1,32,21,22,10,0,21,37,56.8,16,36,28,8,27,59,110,2,DF,30-34,Defender,Italy,Europe
167329,Alassane Pla,FRA,Gladbach,Bundesliga,2019,26.0,1993.0,23.8,16,7,5,6,5,8,28,28.6,20,21,2,19,9,25,7,0,FW,25-29,Forward,France,Europe
122153,Paul Pogba,FRA,Manchester Utd,Premier League,2019,26.0,1993.0,13.4,20,9,8,8,4,8,16,50.0,8,12,4,8,7,27,10,2,MF,25-29,Midfielder,France,Europe
60957,Sebastian Polter,GER,Union Berlin,Bundesliga,2019,28.0,1991.0,3.7,2,2,0,1,1,1,3,33.3,2,2,0,2,1,3,1,0,FW,25-29,Forward,Germany,Europe
223974,Stefan Posch,AUT,Hoffenheim,Bundesliga,2019,22.0,1997.0,25.6,63,34,35,27,1,35,63,55.6,28,57,25,32,40,103,101,1,DF,20-24,Defender,Austria,Europe
157635,Yussuf Poulsen,DEN,RB Leipzig,Bundesliga,2019,25.0,1994.0,13.6,14,10,2,10,2,4,21,19.0,17,12,0,12,4,18,15,0,FW,25-29,Forward,Denmark,Europe
122116,Nicolas de Prville,FRA,Bordeaux,Ligue 1,2019,28.0,1991.0,22.2,35,21,9,22,4,18,56,32.1,38,15,3,12,6,41,19,0,"MF,FW",25-29,Midfielder,France,Europe
223572,Kai Prger,GER,Paderborn 07,Bundesliga,2019,27.0,1992.0,23.1,43,22,21,17,5,17,58,29.3,41,34,6,28,14,57,20,1,"MF,FW",25-29,Midfielder,Germany,Europe
234029,Grischa Prmel,GER,Union Berlin,Bundesliga,2019,24.0,1995.0,10.3,14,11,6,6,2,7,19,36.8,12,10,2,8,14,28,9,0,MF,20-24,Midfielder,Germany,Europe
46972,Teemu Pukki,FIN,Norwich City,Premier League,2019,29.0,1990.0,32.1,12,6,3,5,4,1,23,4.3,22,13,0,13,6,18,7,0,FW,25-29,Forward,Finland,Europe
215616,Erick Pulgar,CHI,Fiorentina,Serie A,2019,25.0,1994.0,32.8,73,46,25,41,7,22,96,22.9,74,45,15,30,49,122,53,1,MF,25-29,Midfielder,Chile,South America
315779,Christian Pulisic,USA,Chelsea,Premier League,2019,20.0,1998.0,19.1,23,11,13,4,6,7,24,29.2,17,15,0,15,6,29,11,0,FW,20-24,Forward,United States,North America
22328,Fabio Quagliarella,ITA,Sampdoria,Serie A,2019,36.0,1983.0,25.3,9,5,0,6,3,2,30,6.7,28,13,0,13,8,17,15,0,FW,35-39,Forward,Italy,Europe
182913,Adrien Rabiot,FRA,Juventus,Serie A,2019,24.0,1995.0,21.2,47,31,16,19,12,15,41,36.6,26,36,6,30,32,79,19,0,MF,20-24,Midfielder,France,Europe
19819,Raffael,BRA,Gladbach,Bundesliga,2019,34.0,1985.0,0.7,0,0,0,0,0,0,2,0.0,2,2,0,2,0,0,0,0,"MF,FW",30-34,Midfielder,Brazil,South America
69751,Jordi Alba,ESP,Barcelona,La Liga,2019,30.0,1989.0,24.3,20,13,9,7,4,6,27,22.2,21,12,3,9,37,57,40,0,DF,30-34,Defender,Spain,Europe
128220,Luis Alberto,ESP,Lazio,Serie A,2019,26.0,1992.0,34.6,50,30,21,19,10,27,82,32.9,55,32,1,31,21,71,9,1,MF,25-29,Midfielder,Spain,Europe
126716,Paco Alccer,ESP,Villarreal,La Liga,2019,25.0,1993.0,10.3,3,3,2,1,0,1,7,14.3,6,4,1,3,2,5,10,0,FW,25-29,Forward,Spain,Europe
60444,Thiago Alcntara,ESP,Bayern Munich,Bundesliga,2019,28.0,1991.0,19.7,45,26,17,23,5,12,33,36.4,21,12,3,9,45,90,13,1,MF,25-29,Midfielder,Spain,Europe
247250,Rubn Alcaraz,ESP,Valladolid,La Liga,2019,28.0,1991.0,21.4,61,30,37,20,4,30,63,47.6,33,46,15,31,15,76,41,0,MF,25-29,Midfielder,Spain,Europe
284854,Carles Ale,ESP,Barcelona,La Liga,2019,21.0,1998.0,1.9,2,1,1,1,0,1,4,25.0,3,1,0,1,0,2,0,0,MF,20-24,Midfielder,Spain,Europe
255488,Yeray lvarez,ESP,Athletic Club,La Liga,2019,24.0,1995.0,31.2,36,19,28,7,1,17,30,56.7,13,33,22,11,62,98,138,2,DF,20-24,Defender,Spain,Europe
71548,Anaitz Arbilla,ESP,Eibar,La Liga,2019,32.0,1987.0,22.3,33,20,23,8,2,16,34,47.1,18,20,4,16,29,62,82,0,DF,30-34,Defender,Spain,Europe
72047,Iago Aspas,ESP,Celta Vigo,La Liga,2019,31.0,1987.0,36.2,29,19,7,9,13,12,45,26.7,33,16,1,15,22,51,7,0,FW,30-34,Forward,Spain,Europe
57500,Csar Azpilicueta,ESP,Chelsea,Premier League,2019,29.0,1989.0,35.9,86,56,40,32,14,35,69,50.7,34,56,21,35,67,153,94,0,DF,25-29,Defender,Spain,Europe
298575,Kike Barja,ESP,Osasuna,La Liga,2019,22.0,1997.0,3.5,1,1,1,0,0,1,1,100.0,0,3,1,2,0,1,2,0,"MF,FW",20-24,Midfielder,Spain,Europe
616369,Ander Barrenetxea,ESP,Real Sociedad,La Liga,2019,17.0,2001.0,4.9,12,9,5,5,2,4,10,40.0,6,3,0,3,3,15,4,0,"FW,MF",Under 20,Forward,Spain,Europe
237164,Ihlas Bebou,TOG,Hoffenheim,Bundesliga,2019,25.0,1994.0,23.4,27,15,9,13,5,8,23,34.8,15,25,4,21,11,38,25,0,"FW,MF",25-29,Forward,Togo,Africa
243028,Jan Bednarek,POL,Southampton,Premier League,2019,23.0,1996.0,34.0,65,38,41,18,6,31,61,50.8,30,44,23,21,77,142,198,4,DF,20-24,Defender,Poland,Europe
191217,Hctor Bellern,ESP,Arsenal,Premier League,2019,24.0,1995.0,12.9,20,13,7,11,2,11,29,37.9,18,20,4,16,19,39,27,1,"DF,MF",20-24,Defender,Spain,Europe
423444,Fran Beltrn,ESP,Celta Vigo,La Liga,2019,20.0,1999.0,20.3,31,19,15,12,4,11,35,31.4,24,14,1,13,14,45,17,0,MF,20-24,Midfielder,Spain,Europe
61812,Yuri Berchiche,ESP,Athletic Club,La Liga,2019,29.0,1990.0,31.7,48,35,32,15,1,21,40,52.5,19,26,4,22,30,78,73,1,DF,25-29,Defender,Spain,Europe
338425,lex Berenguer,ESP,Torino,Serie A,2019,24.0,1995.0,20.3,20,6,6,13,1,8,33,24.2,25,17,1,16,18,38,17,0,"MF,DF",20-24,Midfielder,Spain,Europe
144143,Bartosz Bereszyski,POL,Sampdoria,Serie A,2019,27.0,1992.0,26.7,53,35,25,23,5,26,52,50.0,26,38,16,22,35,88,88,1,DF,25-29,Defender,Poland,Europe
333014,Sander Berge,NOR,Sheffield Utd,Premier League,2019,21.0,1998.0,10.5,22,15,3,14,5,5,10,50.0,5,15,1,14,10,32,16,0,MF,20-24,Midfielder,Norway,Europe
126719,Juan Bernat,ESP,Paris S-G,Ligue 1,2019,26.0,1993.0,15.4,42,27,19,16,7,20,51,39.2,31,13,1,12,10,52,26,0,"DF,MF",25-29,Defender,Spain,Europe
203043,Pedro Bigas,ESP,Eibar,La Liga,2019,28.0,1990.0,19.7,18,9,11,7,0,9,19,47.4,10,16,10,6,36,54,82,0,DF,25-29,Defender,Spain,Europe
65230,Sergio Busquets,ESP,Barcelona,La Liga,2019,31.0,1988.0,27.6,80,44,23,43,14,41,71,57.7,30,36,5,31,44,124,24,2,MF,30-34,Midfielder,Spain,Europe
156808,Unai Bustinza,ESP,Legans,La Liga,2019,27.0,1992.0,29.8,66,40,40,19,7,32,53,60.4,21,30,9,21,65,131,77,0,DF,25-29,Defender,Spain,Europe
61253,Jos Callejn,ESP,Napoli,Serie A,2019,32.0,1987.0,24.1,13,9,3,7,3,9,25,36.0,16,15,3,12,10,23,14,1,"FW,MF",30-34,Forward,Spain,Europe
120095,Jos Campaa,ESP,Levante,La Liga,2019,26.0,1993.0,35.1,38,25,15,13,10,13,53,24.5,40,30,5,25,44,82,42,2,MF,25-29,Midfielder,Spain,Europe
394285,Vctor Campuzano,ESP,Espanyol,La Liga,2019,22.0,1997.0,9.7,12,9,1,6,5,3,19,15.8,16,8,0,8,2,14,4,0,FW,20-24,Forward,Spain,Europe
66106,Sergio Canales,ESP,Betis,La Liga,2019,28.0,1991.0,35.1,25,16,14,6,5,7,28,25.0,21,30,1,29,13,38,16,0,"MF,FW",25-29,Midfielder,Spain,Europe
197545,Ander Capa,ESP,Athletic Club,La Liga,2019,27.0,1992.0,31.9,64,36,37,21,6,24,59,40.7,35,26,7,19,28,92,63,0,DF,25-29,Defender,Spain,Europe
195171,Samu Castillejo,ESP,Milan,Serie A,2019,24.0,1995.0,13.4,24,15,10,11,3,9,42,21.4,33,17,2,15,24,48,5,0,"FW,MF",20-24,Forward,Spain,Europe
59606,Craig Cathcart,NIR,Watford,Premier League,2019,30.0,1989.0,27.6,41,26,25,15,1,10,24,41.7,14,19,16,3,25,66,136,1,DF,30-34,Defender,Northern Ireland,Europe
15799,Santi Cazorla,ESP,Villarreal,La Liga,2019,34.0,1984.0,27.2,48,25,14,21,13,20,57,35.1,37,23,1,22,19,67,16,2,MF,30-34,Midfielder,Spain,Europe
319745,Dani Ceballos,ESP,Arsenal,Premier League,2019,22.0,1996.0,18.8,45,23,26,14,5,18,61,29.5,43,14,3,11,32,77,16,1,MF,20-24,Midfielder,Spain,Europe
79510,Thiago Cionek,POL,SPAL,Serie A,2019,33.0,1986.0,24.1,53,32,36,12,5,22,53,41.5,31,30,11,19,46,99,91,2,DF,30-34,Defender,Poland,Europe
193784,Carlos Clerc,ESP,Levante,La Liga,2019,27.0,1992.0,20.5,28,16,14,13,1,12,20,60.0,8,22,9,13,22,50,61,0,DF,25-29,Defender,Spain,Europe
71905,Coke,ESP,Levante,La Liga,2019,32.0,1987.0,11.0,25,18,14,8,3,14,30,46.7,16,9,2,7,13,38,19,0,DF,30-34,Defender,Spain,Europe
546212,Diego Costa,ESP,Atltico Madrid,La Liga,2019,30.0,1988.0,15.0,9,5,1,4,4,1,10,10.0,9,4,2,2,3,12,10,0,FW,30-34,Forward,Spain,Europe
65318,Jaume Costa,ESP,Valencia,La Liga,2019,31.0,1988.0,15.4,27,23,17,8,2,14,28,50.0,14,11,6,5,24,51,52,1,DF,30-34,Defender,Spain,Europe
142021,Sergi Darder,ESP,Espanyol,La Liga,2019,25.0,1993.0,29.5,47,23,11,26,10,17,58,29.3,41,30,1,29,24,71,23,1,MF,25-29,Midfielder,Spain,Europe
248732,Pawe Dawidowicz,POL,Hellas Verona,Serie A,2019,24.0,1995.0,7.7,15,12,11,4,0,5,11,45.5,6,6,5,1,12,27,26,0,DF,20-24,Defender,Poland,Europe
129476,Gerard Deulofeu,ESP,Watford,Premier League,2019,25.0,1994.0,23.3,33,16,18,9,6,12,59,20.3,47,10,0,10,25,58,6,0,FW,25-29,Forward,Spain,Europe
58330,Vctor Daz,ESP,Granada,La Liga,2019,31.0,1988.0,32.0,74,43,38,31,5,31,60,51.7,29,53,23,30,48,122,94,1,DF,30-34,Defender,Spain,Europe
221150,Djen,TOG,Getafe,La Liga,2019,27.0,1991.0,34.0,42,32,27,15,0,17,30,56.7,13,20,7,13,34,76,105,1,DF,25-29,Defender,Togo,Africa
177046,Rubn Duarte,ESP,Alavs,La Liga,2019,23.0,1995.0,29.6,61,32,30,28,3,34,60,56.7,26,30,8,22,47,108,71,0,DF,20-24,Defender,Spain,Europe
229804,Aritz Elustondo,ESP,Real Sociedad,La Liga,2019,25.0,1994.0,16.8,28,17,19,8,1,13,23,56.5,10,21,8,13,15,43,67,0,DF,25-29,Defender,Spain,Europe
81988,Sergi Enrich,ESP,Eibar,La Liga,2019,29.0,1990.0,20.7,17,6,4,8,5,4,21,19.0,17,16,2,14,9,26,12,0,FW,25-29,Forward,Spain,Europe
93935,Sergio Escudero,ESP,Sevilla,La Liga,2019,29.0,1989.0,8.6,29,16,17,10,2,19,28,67.9,9,11,1,10,13,42,35,0,DF,25-29,Defender,Spain,Europe
40888,Beat Etxebarria,ESP,Athletic Club,La Liga,2019,32.0,1987.0,4.4,6,1,2,3,1,2,13,15.4,11,6,1,5,4,10,6,0,MF,30-34,Midfielder,Spain,Europe
42412,Jonny Evans,NIR,Leicester City,Premier League,2019,31.0,1988.0,37.6,48,34,33,14,1,28,39,71.8,11,33,18,15,57,105,174,4,DF,30-34,Defender,Northern Ireland,Europe
506248,Edu Expsito,ESP,Eibar,La Liga,2019,22.0,1996.0,25.7,52,28,12,31,9,18,49,36.7,31,20,6,14,31,83,18,1,MF,20-24,Midfielder,Spain,Europe
8806,Cesc Fbregas,ESP,Monaco,Ligue 1,2019,32.0,1987.0,10.3,11,4,6,3,2,6,29,20.7,23,8,1,7,7,18,3,0,MF,30-34,Midfielder,Spain,Europe
59340,Iago Falque,ESP,Torino,Serie A,2019,29.0,1990.0,1.1,0,0,0,0,0,0,1,0.0,1,1,0,1,0,0,0,0,"FW,MF",25-29,Forward,Spain,Europe
466810,Ansu Fati,ESP,Barcelona,La Liga,2019,16.0,2002.0,11.4,16,8,4,7,5,5,15,33.3,10,14,1,13,8,24,3,0,FW,Under 20,Forward,Spain,Europe
217144,Aleix Febas,ESP,Mallorca,La Liga,2019,23.0,1996.0,18.8,36,24,13,19,4,12,36,33.3,24,15,0,15,17,53,6,0,"MF,FW",20-24,Midfielder,Spain,Europe
76467,Kiko Femena,ESP,Watford,Premier League,2019,28.0,1991.0,24.9,68,38,49,17,2,43,80,53.8,37,16,2,14,36,104,49,0,DF,25-29,Defender,Spain,Europe
216464,Carlos Fernndez,ESP,Granada,La Liga,2019,23.0,1996.0,24.5,24,15,7,11,6,3,32,9.4,29,25,2,23,11,35,30,0,"FW,MF",20-24,Forward,Spain,Europe
357885,Pablo Fornals,ESP,West Ham,Premier League,2019,23.0,1996.0,24.1,46,28,21,18,7,19,64,29.7,45,35,1,34,25,71,15,0,"MF,FW",20-24,Midfielder,Spain,Europe
114060,Enric Gallego,ESP,Osasuna,La Liga,2019,32.0,1986.0,9.8,9,5,1,5,3,0,4,0.0,4,10,2,8,4,13,8,0,FW,30-34,Forward,Spain,Europe
442816,Fran Gmez,ESP,Mallorca,La Liga,2019,28.0,1991.0,19.6,64,42,32,27,5,33,74,44.6,41,31,11,20,29,93,41,0,DF,25-29,Defender,Spain,Europe
298589,David Garca,ESP,Osasuna,La Liga,2019,25.0,1994.0,31.0,28,16,15,12,1,14,31,45.2,17,20,16,4,48,76,123,2,DF,25-29,Defender,Spain,Europe
466794,Eric Garca,ESP,Manchester City,Premier League,2019,18.0,2001.0,8.8,6,1,4,2,0,5,9,55.6,4,2,0,2,18,24,33,0,DF,Under 20,Defender,Spain,Europe
361238,Rubn Garca,ESP,Osasuna,La Liga,2019,26.0,1993.0,24.3,55,30,22,26,7,18,46,39.1,28,34,5,29,11,66,23,1,"MF,FW",25-29,Midfielder,Spain,Europe
197122,Unai Garca,ESP,Osasuna,La Liga,2019,27.0,1992.0,6.0,9,6,4,4,1,5,9,55.6,4,13,9,4,8,17,31,0,DF,25-29,Defender,Spain,Europe
590690,Vctor Garca,ESP,Valladolid,La Liga,2019,21.0,1997.0,1.0,0,0,0,0,0,0,1,0.0,1,1,0,1,0,0,1,0,"FW,MF",20-24,Forward,Spain,Europe
60632,Theodor Gebre Selassie,CZE,Werder Bremen,Bundesliga,2019,32.0,1986.0,27.0,36,27,23,10,3,17,35,48.6,18,26,9,17,63,99,81,0,"DF,MF",30-34,Defender,Czech Republic,Europe
127837,Ibai Gmez,ESP,Athletic Club,La Liga,2019,29.0,1989.0,7.7,5,3,2,2,1,3,8,37.5,5,4,0,4,3,8,6,0,FW,25-29,Forward,Spain,Europe
175449,Moi Gmez,ESP,Villarreal,La Liga,2019,25.0,1994.0,25.8,30,22,9,14,7,11,33,33.3,22,22,2,20,25,55,23,0,"FW,MF",25-29,Forward,Spain,Europe
183647,lvaro Gonzlez,ESP,Marseille,Ligue 1,2019,29.0,1990.0,18.1,19,13,14,4,1,9,13,69.2,4,7,4,3,18,37,65,0,DF,25-29,Defender,Spain,Europe
289255,Andoni Gorosabel,ESP,Real Sociedad,La Liga,2019,22.0,1996.0,7.9,14,8,9,3,2,10,20,50.0,10,13,1,12,13,27,21,0,DF,20-24,Defender,Spain,Europe
44065,Esteban Granero,ESP,Espanyol,La Liga,2019,32.0,1987.0,5.3,10,4,5,3,2,5,11,45.5,6,3,2,1,2,12,5,0,MF,30-34,Midfielder,Spain,Europe
256429,Sergi Guardiola,ESP,Valladolid,La Liga,2019,28.0,1991.0,29.5,14,6,3,7,4,4,24,16.7,20,23,0,23,6,20,18,1,FW,25-29,Forward,Spain,Europe
74294,Nemanja Gudelj,SRB,Sevilla,La Liga,2019,27.0,1991.0,13.5,20,14,11,8,1,6,19,31.6,13,17,8,9,12,32,35,1,"MF,DF",25-29,Midfielder,Serbia,Europe
418560,Erling Haaland,NOR,Dortmund,Bundesliga,2019,19.0,2000.0,11.8,4,2,1,0,3,0,4,0.0,4,7,4,3,4,8,4,0,FW,Under 20,Forward,Norway,Europe
82503,Aridane Hernndez,ESP,Osasuna,La Liga,2019,30.0,1989.0,29.0,35,23,22,13,0,15,19,78.9,4,24,15,9,34,69,137,2,DF,30-34,Defender,Spain,Europe
109751,Onel Hernndez,CUB,Norwich City,Premier League,2019,26.0,1993.0,15.4,27,19,13,11,3,9,31,29.0,22,12,1,11,19,46,10,0,"FW,MF",25-29,Forward,Cuba,North America
99343,Ander Herrera,ESP,Paris S-G,Ligue 1,2019,29.0,1989.0,6.1,19,11,9,9,1,5,14,35.7,9,10,2,8,6,25,4,0,"MF,DF",25-29,Midfielder,Spain,Europe
142027,Pablo Hervas,ESP,Valladolid,La Liga,2019,26.0,1993.0,11.3,24,20,8,14,2,12,22,54.5,10,8,0,8,5,29,0,0,"MF,FW",25-29,Midfielder,Spain,Europe
278359,Borja Iglesias,ESP,Betis,La Liga,2019,26.0,1993.0,21.4,7,5,1,4,2,0,9,0.0,9,7,4,3,5,12,18,0,FW,25-29,Forward,Spain,Europe
85288,Isco,ESP,Real Madrid,La Liga,2019,27.0,1992.0,13.1,13,9,2,10,1,5,14,35.7,9,9,0,9,7,20,4,1,"FW,MF",25-29,Forward,Spain,Europe
319160,Jakub Jankto,CZE,Sampdoria,Serie A,2019,23.0,1996.0,23.3,27,13,14,10,3,10,42,23.8,32,30,3,27,22,49,22,0,"MF,FW",20-24,Midfielder,Czech Republic,Europe
358870,Dennis Jastrzembski,POL,Paderborn 07,Bundesliga,2019,19.0,2000.0,2.0,2,0,1,1,0,0,1,0.0,1,3,0,3,3,5,0,0,"MF,FW",Under 20,Midfielder,Poland,Europe
7663,Joaqun,ESP,Betis,La Liga,2019,38.0,1981.0,22.9,14,7,4,8,2,4,11,36.4,7,10,2,8,15,29,22,1,"MF,FW",35-39,Midfielder,Spain,Europe
228761,Jony,ESP,Lazio,Serie A,2019,28.0,1991.0,13.1,13,9,7,4,2,5,23,21.7,18,11,2,9,14,27,17,0,"DF,FW",25-29,Defender,Spain,Europe
263727,Joan Jordn,ESP,Sevilla,La Liga,2019,25.0,1994.0,25.0,64,34,27,31,6,21,76,27.6,55,25,5,20,26,90,20,4,MF,25-29,Midfielder,Spain,Europe
81999,Joselu,ESP,Alavs,La Liga,2019,29.0,1990.0,30.9,26,17,4,12,10,4,32,12.5,28,36,5,31,13,39,46,0,FW,25-29,Forward,Spain,Europe
257462,Luka Jovi,SRB,Real Madrid,La Liga,2019,21.0,1997.0,4.8,2,1,0,0,2,1,2,50.0,1,1,0,1,2,4,0,0,FW,20-24,Forward,Serbia,Europe
126737,Juanmi,ESP,Betis,La Liga,2019,26.0,1993.0,2.9,4,1,1,2,1,1,4,25.0,3,1,0,1,0,4,0,0,"FW,MF",25-29,Forward,Spain,Europe
53418,Kevin Kampl,SVN,RB Leipzig,Bundesliga,2019,28.0,1990.0,7.5,17,11,7,10,0,7,23,30.4,16,7,2,5,16,33,6,0,MF,25-29,Midfielder,Slovenia,Europe
91059,Joshua King,NOR,Bournemouth,Premier League,2019,27.0,1992.0,22.3,16,6,4,8,4,4,16,25.0,12,20,3,17,8,24,9,0,"FW,MF",25-29,Forward,Norway,Europe
74229,Koke,ESP,Atltico Madrid,La Liga,2019,27.0,1992.0,30.0,70,42,27,30,13,29,89,32.6,60,33,8,25,29,99,28,2,MF,25-29,Midfielder,Spain,Europe
46156,Aleksandar Kolarov,SRB,Roma,Serie A,2019,33.0,1985.0,30.4,37,28,16,16,5,20,37,54.1,17,20,9,11,31,68,57,0,DF,30-34,Defender,Serbia,Europe
208167,Dawid Kownacki,POL,Dsseldorf,Bundesliga,2019,22.0,1997.0,12.1,13,8,5,7,1,9,20,45.0,11,13,2,11,6,19,8,0,"FW,MF",20-24,Forward,Poland,Europe
67080,Vctor Laguardia,ESP,Alavs,La Liga,2019,29.0,1989.0,29.5,21,15,15,6,0,16,30,53.3,14,24,18,6,37,58,131,1,DF,25-29,Defender,Spain,Europe
176553,Aymeric Laporte,ESP,Manchester City,Premier League,2019,25.0,1994.0,12.2,13,6,6,7,0,4,9,44.4,5,6,5,1,20,33,26,1,DF,25-29,Defender,Spain,Europe
320271,Toni Lato,ESP,Osasuna,La Liga,2019,21.0,1997.0,5.2,22,15,11,8,3,9,10,90.0,1,9,1,8,8,30,13,1,"DF,MF",20-24,Defender,Spain,Europe
70411,Darko Lazovi,SRB,Hellas Verona,Serie A,2019,28.0,1990.0,36.0,26,16,14,8,4,14,27,51.9,13,15,4,11,23,49,53,0,DF,25-29,Defender,Serbia,Europe
145769,Sergio Len,ESP,Levante,La Liga,2019,30.0,1989.0,7.5,3,3,0,3,0,2,4,50.0,2,3,0,3,1,4,2,0,FW,30-34,Forward,Spain,Europe
346018,Jamal Lewis,NIR,Norwich City,Premier League,2019,21.0,1998.0,25.6,51,35,42,6,3,22,36,61.1,14,27,12,15,25,76,68,0,DF,20-24,Defender,Northern Ireland,Europe
225873,Karol Linetty,POL,Sampdoria,Serie A,2019,24.0,1995.0,22.4,61,32,24,25,12,21,65,32.3,44,26,3,23,26,87,17,0,MF,20-24,Midfielder,Poland,Europe
298975,Pol Lirola,ESP,Fiorentina,Serie A,2019,21.0,1997.0,29.4,34,20,18,10,6,21,38,55.3,17,16,4,12,26,60,52,0,DF,20-24,Defender,Spain,Europe
710131,Diego Llorente,ESP,Real Sociedad,La Liga,2019,25.0,1993.0,25.9,30,14,20,9,1,16,28,57.1,12,14,7,7,28,58,101,5,DF,25-29,Defender,Spain,Europe
35564,Fernando Llorente,ESP,Napoli,Serie A,2019,34.0,1985.0,5.6,0,0,0,0,0,0,1,0.0,1,4,0,4,1,1,3,0,FW,30-34,Forward,Spain,Europe
45383,Adrin Lpez,ESP,Osasuna,La Liga,2019,31.0,1988.0,16.0,7,5,1,5,1,2,19,10.5,17,6,2,4,4,11,8,0,FW,30-34,Forward,Spain,Europe
947431,David Lpez,ESP,Espanyol,La Liga,2019,29.0,1989.0,27.3,38,20,15,20,3,13,41,31.7,28,28,13,15,35,73,63,3,"DF,MF",25-29,Defender,Spain,Europe
192009,Unai Lpez,ESP,Athletic Club,La Liga,2019,23.0,1995.0,19.9,30,22,8,18,4,10,41,24.4,31,13,2,11,18,48,12,1,MF,20-24,Midfielder,Spain,Europe
252677,Jos Luis Morales,ESP,Levante,La Liga,2019,32.0,1987.0,28.0,17,8,5,9,3,6,34,17.6,28,14,1,13,6,23,5,1,"FW,MF",30-34,Forward,Spain,Europe
245056,Saa Luki,SRB,Torino,Serie A,2019,22.0,1996.0,20.7,29,17,8,19,2,10,35,28.6,25,21,7,14,29,58,15,0,MF,20-24,Midfielder,Serbia,Europe
124715,Nikola Maksimovi,SRB,Napoli,Serie A,2019,27.0,1991.0,20.0,35,24,21,14,0,10,21,47.6,11,19,11,8,30,65,64,1,DF,25-29,Defender,Serbia,Europe
212391,Roger Mart,ESP,Levante,La Liga,2019,28.0,1991.0,25.2,18,11,8,7,3,7,29,24.1,22,14,0,14,6,24,17,0,FW,25-29,Forward,Spain,Europe
251878,Aarn Martn,ESP,Mainz 05,Bundesliga,2019,22.0,1997.0,19.9,29,15,17,8,4,9,22,40.9,13,11,5,6,30,59,36,0,DF,20-24,Defender,Spain,Europe
158863,Iigo Martnez,ESP,Athletic Club,La Liga,2019,28.0,1991.0,33.0,48,30,33,13,2,27,47,57.4,20,28,13,15,39,87,140,0,DF,25-29,Defender,Spain,Europe
227961,Jaime Mata,ESP,Getafe,La Liga,2019,30.0,1988.0,30.5,21,13,3,11,7,3,20,15.0,17,16,1,15,7,28,15,0,FW,30-34,Forward,Spain,Europe
298976,Borja Mayoral,ESP,Levante,La Liga,2019,22.0,1997.0,23.8,12,3,4,6,2,2,13,15.4,11,11,0,11,4,16,6,0,FW,20-24,Forward,Spain,Europe
162056,Gonzalo Melero,ESP,Levante,La Liga,2019,25.0,1994.0,13.7,20,13,9,9,2,7,27,25.9,20,12,3,9,9,29,15,1,MF,25-29,Midfielder,Spain,Europe
309110,Brais Mndez,ESP,Celta Vigo,La Liga,2019,22.0,1997.0,16.4,26,11,14,9,3,12,39,30.8,27,20,0,20,12,38,23,1,"MF,FW",20-24,Midfielder,Spain,Europe
286779,Jorge Mer,ESP,Kln,Bundesliga,2019,22.0,1997.0,6.9,6,5,2,4,0,1,2,50.0,1,13,11,2,14,20,30,0,DF,20-24,Defender,Spain,Europe
42920,Fran Mrida,ESP,Osasuna,La Liga,2019,29.0,1990.0,12.9,27,15,11,10,6,9,27,33.3,18,15,4,11,25,52,10,0,MF,25-29,Midfielder,Spain,Europe
202984,Roque Mesa,ESP,Legans,La Liga,2019,30.0,1989.0,22.4,40,21,17,18,5,13,44,29.5,31,13,4,9,11,51,8,0,MF,30-34,Midfielder,Spain,Europe
413507,Nikola Milenkovi,SRB,Fiorentina,Serie A,2019,21.0,1997.0,36.2,46,25,30,16,0,11,31,35.5,20,39,21,18,29,75,129,1,DF,20-24,Defender,Serbia,Europe
191891,Arkadiusz Milik,POL,Napoli,Serie A,2019,25.0,1994.0,19.4,12,5,4,1,7,3,11,27.3,8,11,1,10,2,14,12,0,FW,25-29,Forward,Poland,Europe
266302,Sergej Milinkovi-Savi,SRB,Lazio,Serie A,2019,24.0,1995.0,33.7,60,35,25,24,11,15,79,19.0,64,67,16,51,37,97,60,1,MF,20-24,Midfielder,Serbia,Europe
255653,Santi Mina,ESP,Celta Vigo,La Liga,2019,23.0,1995.0,21.6,13,8,8,5,0,5,38,13.2,33,19,2,17,10,23,27,0,"FW,MF",20-24,Forward,Spain,Europe
228917,Jorge Miramn,ESP,Levante,La Liga,2019,30.0,1989.0,27.0,52,27,35,13,4,26,45,57.8,19,30,8,22,46,98,61,1,DF,30-34,Defender,Spain,Europe
341227,Juan Miranda,ESP,Schalke 04,Bundesliga,2019,19.0,2000.0,8.7,14,10,8,6,0,6,18,33.3,12,12,4,8,10,24,27,1,DF,Under 20,Defender,Spain,Europe
57825,Jorge Molina,ESP,Getafe,La Liga,2019,37.0,1982.0,21.0,8,2,0,4,4,0,12,0.0,12,13,2,11,4,12,18,0,FW,35-39,Forward,Spain,Europe
552425,Jon Moncayola,ESP,Osasuna,La Liga,2019,21.0,1998.0,16.6,52,30,26,22,4,27,54,50.0,27,29,5,24,16,68,23,1,"MF,DF",20-24,Midfielder,Spain,Europe
59551,ngel Montoro,ESP,Granada,La Liga,2019,31.0,1988.0,10.8,19,8,8,9,2,3,13,23.1,10,10,1,9,13,32,15,0,MF,30-34,Midfielder,Spain,Europe
568149,Alberto Moreno,ESP,Villarreal,La Liga,2019,27.0,1992.0,16.3,27,16,15,11,1,9,25,36.0,16,15,3,12,25,52,36,0,DF,25-29,Defender,Spain,Europe
193098,lex Moreno,ESP,Betis,La Liga,2019,26.0,1993.0,25.2,37,20,27,8,2,12,32,37.5,20,21,8,13,23,60,47,1,DF,25-29,Defender,Spain,Europe
177467,Gerard Moreno,ESP,Villarreal,La Liga,2019,27.0,1992.0,30.5,19,8,4,10,5,5,46,10.9,41,19,3,16,10,29,51,0,"FW,MF",25-29,Forward,Spain,Europe
54235,Iker Muniain,ESP,Athletic Club,La Liga,2019,26.0,1992.0,26.5,26,19,11,10,5,4,24,16.7,20,9,0,9,12,38,7,0,"FW,MF",25-29,Forward,Spain,Europe
15956,Jess Navas,ESP,Sevilla,La Liga,2019,33.0,1985.0,37.4,27,15,16,7,4,15,32,46.9,17,20,7,13,31,58,70,0,DF,30-34,Defender,Spain,Europe
448844,Carlos Neva,ESP,Granada,La Liga,2019,23.0,1996.0,24.5,16,11,12,3,1,9,21,42.9,12,15,2,13,28,44,60,0,DF,20-24,Defender,Spain,Europe
148928,Sal guez,ESP,Atltico Madrid,La Liga,2019,24.0,1994.0,34.1,95,59,44,42,9,39,88,44.3,49,58,13,45,55,150,68,1,"MF,DF",20-24,Midfielder,Spain,Europe
70934,Nolito,ESP,Sevilla,La Liga,2019,32.0,1986.0,10.0,21,12,5,11,5,7,20,35.0,13,7,0,7,1,22,1,0,FW,30-34,Forward,Spain,Europe
73547,Oliver Norwood,NIR,Sheffield Utd,Premier League,2019,28.0,1991.0,34.3,66,37,35,24,7,28,97,28.9,69,34,12,22,47,113,40,1,MF,25-29,Midfielder,Northern Ireland,Europe
338285,Unai Nez,ESP,Athletic Club,La Liga,2019,22.0,1997.0,17.5,13,10,10,2,1,6,16,37.5,10,25,17,8,23,36,71,0,DF,20-24,Defender,Spain,Europe
51667,Kiko Olivas,ESP,Valladolid,La Liga,2019,30.0,1988.0,32.7,33,16,25,7,1,13,35,37.1,22,30,16,14,61,94,112,2,DF,30-34,Defender,Spain,Europe
293385,Dani Olmo,ESP,RB Leipzig,Bundesliga,2019,21.0,1998.0,8.3,20,14,5,10,5,1,13,7.7,12,7,1,6,4,24,6,0,"MF,FW",20-24,Midfielder,Spain,Europe
356197,Alfonso Pedraza,ESP,Betis,La Liga,2019,23.0,1996.0,15.0,30,19,16,11,3,19,33,57.6,14,18,6,12,16,46,26,1,DF,20-24,Defender,Spain,Europe
501418,Adri Pedrosa,ESP,Espanyol,La Liga,2019,21.0,1998.0,12.1,19,13,8,9,2,7,25,28.0,18,12,1,11,11,30,32,0,"DF,MF",20-24,Defender,Spain,Europe
238868,Rubn Pea,ESP,Villarreal,La Liga,2019,28.0,1991.0,21.2,42,24,23,19,0,17,50,34.0,33,25,8,17,35,77,58,2,DF,25-29,Defender,Spain,Europe
246968,Ayoze Prez,ESP,Leicester City,Premier League,2019,26.0,1993.0,22.3,45,28,14,26,5,8,54,14.8,46,33,1,32,14,59,9,1,"MF,FW",25-29,Midfielder,Spain,Europe
282810,Carles Prez,ESP,Roma,Serie A,2019,21.0,1998.0,6.3,12,8,4,6,2,3,10,30.0,7,6,1,5,3,15,1,0,"FW,MF",20-24,Forward,Spain,Europe
71579,Iigo Prez,ESP,Osasuna,La Liga,2019,31.0,1988.0,12.0,15,11,3,7,5,8,22,36.4,14,7,1,6,12,27,6,0,MF,30-34,Midfielder,Spain,Europe
18944,Gerard Piqu,ESP,Barcelona,La Liga,2019,32.0,1987.0,34.4,32,23,20,11,1,16,26,61.5,10,39,24,15,36,68,157,0,DF,30-34,Defender,Spain,Europe
221309,scar Plano,ESP,Valladolid,La Liga,2019,28.0,1991.0,27.8,48,30,25,19,4,20,61,32.8,41,36,3,33,35,83,29,0,MF,25-29,Midfielder,Spain,Europe
242497,Pere Pons,ESP,Alavs,La Liga,2019,26.0,1993.0,12.1,28,16,14,12,2,12,26,46.2,14,16,3,13,12,40,8,1,MF,25-29,Midfielder,Spain,Europe
138803,Francisco Portillo,ESP,Getafe,La Liga,2019,29.0,1990.0,4.2,11,6,3,6,2,4,12,33.3,8,2,0,2,2,13,3,0,MF,25-29,Midfielder,Spain,Europe
99353,Portu,ESP,Real Sociedad,La Liga,2019,27.0,1992.0,26.6,32,21,10,15,7,13,33,39.4,20,28,3,25,13,45,5,0,"FW,MF",25-29,Forward,Spain,Europe
158791,Sergio Postigo,ESP,Levante,La Liga,2019,30.0,1988.0,26.4,32,15,23,7,2,11,18,61.1,7,24,15,9,34,66,132,1,DF,30-34,Defender,Spain,Europe
177452,Abdn Prats,ESP,Mallorca,La Liga,2019,26.0,1992.0,3.1,1,1,0,0,1,0,1,0.0,1,1,0,1,0,1,1,0,FW,25-29,Forward,Spain,Europe
262365,Antonio Puertas,ESP,Granada,La Liga,2019,27.0,1992.0,28.5,37,24,8,18,11,16,53,30.2,37,21,3,18,12,49,21,0,"FW,MF",25-29,Forward,Spain,Europe
168959,Nemanja Radoja,SRB,Levante,La Liga,2019,26.0,1993.0,22.1,43,19,27,16,0,15,46,32.6,31,21,4,17,23,66,24,0,MF,25-29,Midfielder,Serbia,Europe
245078,Nemanja Radonji,SRB,Marseille,Ligue 1,2019,23.0,1996.0,9.8,10,3,4,3,3,6,17,35.3,11,7,0,7,2,12,7,0,"FW,MF",20-24,Forward,Serbia,Europe
205022,Rafinha,BRA,Barcelona,La Liga,2019,26.0,1993.0,2.1,3,2,1,1,1,1,2,50.0,1,0,0,0,1,4,0,0,"FW,MF",25-29,Forward,Brazil,South America
66360,Daniele Ragatzu,ITA,Cagliari,Serie A,2019,27.0,1991.0,3.5,3,2,0,2,1,1,3,33.3,2,1,0,1,1,4,5,0,"MF,FW",25-29,Midfielder,Italy,Europe
123742,Gastn Ramrez,URU,Sampdoria,Serie A,2019,28.0,1990.0,15.5,32,21,7,16,9,8,30,26.7,22,28,2,26,11,43,10,0,"MF,FW",25-29,Midfielder,Uruguay,South America
73782,Adrin Ramos,COL,Granada,La Liga,2019,33.0,1986.0,2.5,6,2,0,2,4,2,3,66.7,1,2,0,2,1,7,1,0,"FW,MF",30-34,Forward,Colombia,South America
646658,Aaron Ramsey,WAL,Juventus,Serie A,2019,28.0,1990.0,11.7,20,15,6,8,6,6,24,25.0,18,18,3,15,11,31,12,0,MF,25-29,Midfielder,Wales,Europe
405885,Giacomo Raspadori,ITA,Sassuolo,Serie A,2019,19.0,2000.0,2.9,8,6,5,2,1,3,4,75.0,1,5,0,5,1,9,0,0,"MF,FW",Under 20,Midfielder,Italy,Europe
129078,Nathan Redmond,ENG,Southampton,Premier League,2019,25.0,1994.0,30.7,49,29,17,23,9,21,57,36.8,36,39,2,37,16,65,16,0,"MF,FW",25-29,Midfielder,England,Europe
16831,Ken Reichel,GER,Union Berlin,Bundesliga,2019,32.0,1986.0,5.9,6,3,2,3,1,3,13,23.1,10,8,1,7,9,15,12,0,DF,30-34,Defender,Germany,Europe
326300,Jeff Reine-Adlade,FRA,Angers,Ligue 1,2019,21.0,1998.0,0.9,3,1,1,2,0,1,1,100.0,0,1,0,1,0,3,1,0,MF,20-24,Midfielder,France,Europe
182579,Karim Rekik,NED,Hertha BSC,Bundesliga,2019,24.0,1994.0,14.0,16,10,10,6,0,3,6,50.0,3,23,15,8,18,34,44,0,DF,20-24,Defender,Netherlands,Europe
45121,Loc Rmy,FRA,Lille,Ligue 1,2019,32.0,1987.0,10.7,4,1,0,3,1,0,4,0.0,4,1,1,0,0,4,7,0,FW,30-34,Forward,France,Europe
605893,Lucas Ribeiro,BRA,Hoffenheim,Bundesliga,2019,20.0,1999.0,0.7,1,0,1,0,0,0,3,0.0,3,1,0,1,1,2,1,0,MF,20-24,Midfielder,Brazil,South America
22068,Franck Ribry,FRA,Fiorentina,Serie A,2019,36.0,1983.0,15.7,20,14,7,10,3,4,20,20.0,16,9,0,9,3,23,3,0,FW,35-39,Forward,France,Europe
357662,Declan Rice,ENG,West Ham,Premier League,2019,20.0,1999.0,38.0,116,60,64,48,4,47,98,48.0,51,41,9,32,77,193,55,0,MF,20-24,Midfielder,England,Europe
75942,Toms Rincn,VEN,Torino,Serie A,2019,31.0,1988.0,30.0,56,25,23,25,8,23,65,35.4,42,20,3,17,36,92,62,0,MF,30-34,Midfielder,Venezuela,South America
74448,Andrea Rispoli,ITA,Lecce,Serie A,2019,30.0,1988.0,21.2,24,18,14,9,1,15,30,50.0,15,28,7,21,32,56,62,1,DF,30-34,Defender,Italy,Europe
234803,Andrew Robertson,SCO,Liverpool,Premier League,2019,25.0,1994.0,34.6,54,31,17,25,12,27,61,44.3,34,29,7,22,38,92,72,1,DF,25-29,Defender,Scotland,Europe
183299,Callum Robinson,IRL,Sheffield Utd,Premier League,2019,24.0,1995.0,7.5,6,3,2,2,2,2,7,28.6,5,3,0,3,7,13,3,0,"FW,MF",20-24,Forward,Republic of Ireland,Europe
44466,Sebastian Rode,GER,Eint Frankfurt,Bundesliga,2019,28.0,1990.0,21.5,58,33,27,27,4,17,59,28.8,42,32,5,27,34,92,13,0,MF,25-29,Midfielder,Germany,Europe
342385,Guido Rodrguez,ARG,Betis,La Liga,2019,25.0,1994.0,10.4,24,16,11,11,2,15,25,60.0,10,13,4,9,10,34,21,0,MF,25-29,Midfielder,Argentina,South America
412363,Rodrygo,BRA,Real Madrid,La Liga,2019,18.0,2001.0,11.3,6,1,2,3,1,2,21,9.5,19,13,0,13,10,16,5,0,FW,Under 20,Forward,Brazil,South America
889683,Rogrio,BRA,Sassuolo,Serie A,2019,21.0,1998.0,11.3,22,14,12,8,2,16,23,69.6,7,13,3,10,9,31,34,0,DF,20-24,Defender,Brazil,South America
256678,Filippo Romagna,ITA,Sassuolo,Serie A,2019,22.0,1997.0,16.4,7,6,2,5,0,5,6,83.3,1,24,17,7,10,17,69,0,DF,20-24,Defender,Italy,Europe
197747,Alessio Romagnoli,ITA,Milan,Serie A,2019,24.0,1995.0,34.3,46,25,28,15,3,16,27,59.3,11,32,18,14,56,102,157,1,DF,20-24,Defender,Italy,Europe
355915,Cristian Romero,ARG,Genoa,Serie A,2019,21.0,1998.0,28.6,52,35,36,12,4,12,41,29.3,29,59,33,26,75,127,116,2,DF,20-24,Defender,Argentina,South America
8198,Cristiano Ronaldo,POR,Juventus,Serie A,2019,34.0,1985.0,32.4,14,10,3,3,8,4,20,20.0,16,10,3,7,6,20,21,1,FW,30-34,Forward,Portugal,Europe
61546,Facundo Roncaglia,ARG,Osasuna,La Liga,2019,32.0,1987.0,14.2,24,20,12,10,2,11,20,55.0,9,18,3,15,22,46,46,0,DF,30-34,Defender,Argentina,South America
332889,Valentin Rongier,FRA,Marseille,Ligue 1,2019,24.0,1994.0,19.9,76,51,25,41,10,22,63,34.9,41,30,4,26,36,112,16,2,MF,20-24,Midfielder,France,Europe
127076,Jrme Roussillon,FRA,Wolfsburg,Bundesliga,2019,26.0,1993.0,26.3,48,29,26,18,4,15,29,51.7,14,33,5,28,30,78,58,0,DF,25-29,Defender,France,Europe
81460,Nolan Roux,FRA,Nmes,Ligue 1,2019,31.0,1988.0,6.5,5,2,1,3,1,1,3,33.3,2,2,0,2,4,9,5,0,FW,30-34,Forward,France,Europe
86202,Antonio Rdiger,GER,Chelsea,Premier League,2019,26.0,1993.0,19.0,28,18,19,7,2,16,25,64.0,9,15,9,6,16,44,59,1,DF,25-29,Defender,Germany,Europe
57051,Sebastian Rudy,GER,Hoffenheim,Bundesliga,2019,29.0,1990.0,30.4,73,49,31,29,13,28,75,37.3,47,26,5,21,27,100,38,0,"MF,DF",25-29,Midfielder,Germany,Europe
87884,Mrio Rui,POR,Napoli,Serie A,2019,28.0,1991.0,21.8,31,17,12,12,7,11,29,37.9,18,24,5,19,21,52,43,0,DF,25-29,Defender,Portugal,Europe
135492,Youssouf Sabaly,SEN,Bordeaux,Ligue 1,2019,26.0,1993.0,10.1,18,11,9,4,5,6,22,27.3,16,8,1,7,18,36,23,0,DF,25-29,Defender,Senegal,Africa
167491,Stefano Sabelli,ITA,Brescia,Serie A,2019,26.0,1993.0,35.2,83,44,51,28,4,50,106,47.2,56,40,13,27,58,141,107,0,DF,25-29,Defender,Italy,Europe
340394,Abdelhamid Sabiri,MAR,Paderborn 07,Bundesliga,2019,22.0,1996.0,11.6,20,16,6,11,3,9,27,33.3,18,9,2,7,8,28,18,1,MF,20-24,Midfielder,Morocco,Africa
381950,Alexis Saelemaekers,BEL,Milan,Serie A,2019,20.0,1999.0,7.6,14,8,5,7,2,6,20,30.0,14,13,1,12,8,22,1,0,"FW,DF",20-24,Forward,Belgium,Europe
182916,Wesley Sad,FRA,Toulouse,Ligue 1,2019,24.0,1995.0,12.9,20,9,8,10,2,2,13,15.4,11,6,0,6,9,29,8,0,"MF,FW",20-24,Midfielder,France,Europe
433177,Bukayo Saka,ENG,Arsenal,Premier League,2019,17.0,2001.0,19.5,36,21,21,8,7,19,37,51.4,18,12,3,9,12,48,19,0,"DF,FW",Under 20,Defender,England,Europe
96806,Jacopo Sala,ITA,SPAL,Serie A,2019,27.0,1991.0,9.5,29,24,17,11,1,17,31,54.8,14,4,0,4,13,42,15,1,DF,25-29,Defender,Italy,Europe
148455,Mohamed Salah,EGY,Liverpool,Premier League,2019,27.0,1992.0,32.0,16,6,1,4,11,5,22,22.7,17,3,1,2,8,24,2,1,FW,25-29,Forward,Egypt,Africa
563963,Mohammed Salisu,GHA,Valladolid,La Liga,2019,20.0,1999.0,30.3,41,24,28,13,0,21,34,61.8,13,32,26,6,35,76,158,3,DF,20-24,Defender,Ghana,Africa
335147,Junior Sambia,FRA,Montpellier,Ligue 1,2019,22.0,1996.0,6.5,8,6,4,2,2,3,13,23.1,10,4,0,4,8,16,6,0,"DF,MF",20-24,Defender,France,Europe
80173,Frdric Sammaritano,FRA,Dijon,Ligue 1,2019,33.0,1986.0,5.8,9,7,4,4,1,4,11,36.4,7,6,1,5,2,11,3,1,"MF,FW",30-34,Midfielder,France,Europe
234523,Antonio Sanabria,PAR,Genoa,Serie A,2019,23.0,1996.0,15.4,14,11,2,7,5,3,14,21.4,11,13,1,12,5,19,12,1,FW,20-24,Forward,Paraguay,South America
40433,Alexis Snchez,CHI,Inter,Serie A,2019,30.0,1988.0,10.3,9,7,1,4,4,5,13,38.5,8,7,0,7,3,12,1,0,FW,30-34,Forward,Chile,South America
401173,Jadon Sancho,ENG,Dortmund,Bundesliga,2019,19.0,2000.0,25.4,14,11,6,6,2,8,24,33.3,16,8,0,8,14,28,6,0,"FW,MF",Under 20,Forward,England,Europe
79960,Alex Sandro,BRA,Juventus,Serie A,2019,28.0,1991.0,26.5,44,26,23,14,7,12,33,36.4,21,26,6,20,47,91,46,3,DF,25-29,Defender,Brazil,South America
126534,Salif San,SEN,Schalke 04,Bundesliga,2019,28.0,1990.0,12.5,16,9,12,4,0,11,19,57.9,8,19,7,12,21,37,50,0,DF,25-29,Defender,Senegal,Africa
375885,Ibrahim Sangar,CIV,Toulouse,Ligue 1,2019,21.0,1997.0,24.2,84,54,37,42,5,33,74,44.6,41,28,10,18,39,123,49,4,MF,20-24,Midfielder,Ivory Coast,Africa
127194,Yaya Sanogo,FRA,Toulouse,Ligue 1,2019,26.0,1993.0,10.1,6,3,2,3,1,1,2,50.0,1,4,1,3,7,13,14,0,FW,25-29,Forward,France,Europe
174094,Morgan Sanson,FRA,Marseille,Ligue 1,2019,24.0,1994.0,24.1,60,28,20,29,11,13,52,25.0,39,39,5,34,23,83,9,0,MF,20-24,Midfielder,France,Europe
82048,Nicola Sansone,ITA,Bologna,Serie A,2019,27.0,1991.0,25.2,34,20,12,18,4,15,59,25.4,44,21,0,21,11,45,9,0,"FW,MF",25-29,Forward,Italy,Europe
285323,Baptiste Santamaria,FRA,Angers,Ligue 1,2019,24.0,1995.0,27.8,91,53,39,43,9,35,79,44.3,44,27,5,22,43,134,36,0,MF,20-24,Midfielder,France,Europe
99180,Federico Santander,PAR,Bologna,Serie A,2019,28.0,1991.0,8.6,13,8,3,0,10,1,4,25.0,3,3,0,3,7,20,12,0,FW,25-29,Forward,Paraguay,South America
84344,Davide Santon,ITA,Roma,Serie A,2019,28.0,1991.0,6.9,11,6,6,5,0,6,17,35.3,11,2,1,1,11,22,13,0,DF,25-29,Defender,Italy,Europe
393325,Josh Sargent,USA,Werder Bremen,Bundesliga,2019,19.0,2000.0,15.7,11,6,5,4,2,2,12,16.7,10,17,1,16,14,25,21,0,FW,Under 20,Forward,United States,North America
190685,Bouna Sarr,SEN,Marseille,Ligue 1,2019,27.0,1992.0,24.0,60,37,30,19,11,30,53,56.6,23,17,1,16,32,92,38,0,"DF,FW",25-29,Defender,Senegal,Africa
127156,Tji Savanier,FRA,Montpellier,Ligue 1,2019,27.0,1991.0,16.9,52,39,16,30,6,25,77,32.5,52,10,0,10,35,87,21,1,MF,25-29,Midfielder,France,Europe
135343,Fabian Schr,SUI,Newcastle Utd,Premier League,2019,27.0,1991.0,18.6,39,21,25,14,0,19,40,47.5,21,35,18,17,47,86,74,2,"DF,MF",25-29,Defender,Switzerland,Europe
147485,Louis Schaub,AUT,Kln,Bundesliga,2019,24.0,1994.0,6.9,15,12,2,9,4,5,14,35.7,9,10,1,9,3,18,2,0,MF,20-24,Midfielder,Austria,Europe
119164,Ezequiel Schelotto,ITA,Brighton,Premier League,2019,30.0,1989.0,4.0,4,3,1,2,1,2,8,25.0,6,3,0,3,7,11,14,0,DF,30-34,Defender,Italy,Europe
223979,Xaver Schlager,AUT,Wolfsburg,Bundesliga,2019,21.0,1997.0,19.1,47,29,13,30,4,14,44,31.8,30,16,2,14,17,64,12,0,MF,20-24,Midfielder,Austria,Europe
413843,Keven Schlotterbeck,GER,Union Berlin,Bundesliga,2019,22.0,1997.0,21.5,52,27,36,15,1,17,29,58.6,12,40,21,19,40,92,113,1,DF,20-24,Defender,Germany,Europe
388198,Nico Schlotterbeck,GER,Freiburg,Bundesliga,2019,19.0,1999.0,4.1,6,3,4,2,0,2,5,40.0,3,7,5,2,3,9,20,1,DF,Under 20,Defender,Germany,Europe
70285,Jonathan Schmid,FRA,Freiburg,Bundesliga,2019,29.0,1990.0,31.5,42,27,19,19,4,19,37,51.4,18,23,8,15,35,77,84,0,DF,25-29,Defender,France,Europe
213751,Sebastian Schonlau,GER,Paderborn 07,Bundesliga,2019,24.0,1994.0,23.0,64,43,50,14,0,41,66,62.1,25,36,15,21,40,104,138,1,DF,20-24,Defender,Germany,Europe
118397,Alessandro Schpf,AUT,Schalke 04,Bundesliga,2019,25.0,1994.0,15.9,29,16,11,10,8,12,33,36.4,21,17,1,16,26,55,8,0,MF,25-29,Midfielder,Austria,Europe
85867,Nico Schulz,GER,Dortmund,Bundesliga,2019,26.0,1993.0,6.6,11,7,3,6,2,8,13,61.5,5,14,4,10,9,20,9,0,"DF,MF",25-29,Defender,Germany,Europe
178459,Davie Selke,GER,Hertha BSC,Bundesliga,2019,24.0,1995.0,10.7,6,3,2,2,2,4,7,57.1,3,7,1,6,1,7,11,0,FW,20-24,Forward,Germany,Europe
252345,Ken Sema,SWE,Udinese,Serie A,2019,25.0,1993.0,27.3,59,41,43,15,1,36,68,52.9,32,26,6,20,17,76,41,1,"DF,MF",25-29,Defender,Sweden,Europe
231572,Nlson Semedo,POR,Barcelona,La Liga,2019,25.0,1993.0,23.3,51,30,27,18,6,21,36,58.3,15,18,3,15,22,73,30,0,DF,25-29,Defender,Portugal,Europe
315843,Alessandro Semprini,ITA,Brescia,Serie A,2019,21.0,1998.0,7.0,10,4,7,3,0,7,9,77.8,2,10,3,7,9,19,16,0,DF,20-24,Defender,Italy,Europe
216179,Stefano Sensi,ITA,Inter,Serie A,2019,23.0,1995.0,8.0,18,10,10,7,1,6,22,27.3,16,15,1,14,9,27,4,0,MF,20-24,Midfielder,Italy,Europe
261905,Suat Serdar,GER,Schalke 04,Bundesliga,2019,22.0,1997.0,17.8,56,37,16,33,7,18,61,29.5,43,39,7,32,24,80,7,0,MF,20-24,Midfielder,Germany,Europe
86792,Xherdan Shaqiri,SUI,Liverpool,Premier League,2019,27.0,1991.0,2.1,1,0,0,1,0,0,1,0.0,1,0,0,0,0,1,0,0,"FW,MF",25-29,Forward,Switzerland,Europe
49542,Billy Sharp,ENG,Sheffield Utd,Premier League,2019,33.0,1986.0,11.7,6,5,2,1,3,1,6,16.7,5,2,0,2,1,7,2,0,FW,30-34,Forward,England,Europe
183288,Luke Shaw,ENG,Manchester Utd,Premier League,2019,24.0,1995.0,19.3,34,18,19,11,4,19,33,57.6,14,26,6,20,24,58,56,1,DF,20-24,Defender,England,Europe
161869,Djibril Sidib,FRA,Everton,Premier League,2019,27.0,1992.0,20.3,83,44,48,25,10,43,72,59.7,29,19,3,16,40,123,41,0,"DF,MF",25-29,Defender,France,Europe
27374,Sidnei,BRA,Betis,La Liga,2019,29.0,1989.0,13.1,23,19,17,6,0,9,14,64.3,5,15,12,3,21,44,57,0,DF,25-29,Defender,Brazil,South America
86079,Luca Siligardi,ITA,Parma,Serie A,2019,31.0,1988.0,3.7,6,2,3,2,1,4,8,50.0,4,3,0,3,3,9,5,0,"MF,FW",30-34,Midfielder,Italy,Europe
241641,Bernardo Silva,POR,Manchester City,Premier League,2019,24.0,1994.0,22.6,36,18,8,21,7,13,44,29.5,31,25,1,24,24,60,13,0,"FW,MF",20-24,Forward,Portugal,Europe
1074917,Jonathan Silva,ARG,Legans,La Liga,2019,25.0,1994.0,30.9,60,34,32,22,6,27,52,51.9,25,12,4,8,34,94,46,0,DF,25-29,Defender,Argentina,South America
294817,Thiago Silva,BRA,Paris S-G,Ligue 1,2019,34.0,1984.0,17.5,28,16,15,13,0,13,16,81.3,3,18,15,3,26,54,54,0,DF,30-34,Defender,Brazil,South America
666234,Mohamed Simakan,FRA,Strasbourg,Ligue 1,2019,19.0,2000.0,16.7,54,32,35,16,3,22,34,64.7,12,14,3,11,31,85,25,0,DF,Under 20,Defender,France,Europe
282388,Giovanni Simeone,ARG,Cagliari,Serie A,2019,24.0,1995.0,32.5,24,13,9,10,5,5,32,15.6,27,24,7,17,11,35,16,1,FW,20-24,Forward,Argentina,South America
274862,Moses Simon,NGA,Nantes,Ligue 1,2019,24.0,1995.0,24.2,15,7,5,4,6,6,21,28.6,15,6,0,6,8,23,6,0,"FW,MF",20-24,Forward,Nigeria,Africa
372712,Ibrahima Sissoko,MLI,Strasbourg,Ligue 1,2019,21.0,1997.0,17.8,46,27,21,21,4,16,48,33.3,32,14,5,9,20,66,25,0,MF,20-24,Midfielder,Mali,Africa
46001,Moussa Sissoko,FRA,Tottenham,Premier League,2019,29.0,1989.0,27.2,39,25,25,12,2,20,48,41.7,28,19,4,15,27,66,43,2,MF,25-29,Midfielder,France,Europe
290587,Ellyes Skhiri,TUN,Kln,Bundesliga,2019,24.0,1995.0,29.7,74,52,30,37,7,29,77,37.7,48,47,9,38,67,141,33,0,MF,20-24,Midfielder,Tunisia,Africa
432982,Andreas Skov Olsen,DEN,Bologna,Serie A,2019,19.0,1999.0,8.4,11,8,5,5,1,4,12,33.3,8,10,1,9,8,19,5,0,"FW,MF",Under 20,Forward,Denmark,Europe
93827,Steven Skrzybski,GER,Dsseldorf,Bundesliga,2019,26.0,1992.0,5.9,4,4,2,1,1,0,16,0.0,16,10,0,10,10,14,4,0,"FW,MF",25-29,Forward,Germany,Europe
103427,Chris Smalling,ENG,Roma,Serie A,2019,29.0,1989.0,28.5,25,16,15,9,1,10,13,76.9,3,44,35,9,56,81,126,2,DF,25-29,Defender,England,Europe
163532,Adam Smith,ENG,Bournemouth,Premier League,2019,28.0,1991.0,22.8,47,32,29,16,2,23,50,46.0,27,27,6,21,25,72,64,1,DF,25-29,Defender,England,Europe
112988,Cdric Soares,POR,Arsenal,Premier League,2019,27.0,1991.0,2.8,8,6,2,6,0,1,3,33.3,2,3,0,3,3,11,4,0,"MF,DF",25-29,Midfielder,Portugal,Europe
258889,Dominic Solanke,ENG,Bournemouth,Premier League,2019,21.0,1997.0,18.3,8,4,2,5,1,5,33,15.2,28,9,1,8,8,16,18,1,FW,20-24,Forward,England,Europe
644563,Bryan Soumar,FRA,Dijon,Ligue 1,2019,20.0,1999.0,4.3,12,1,6,5,1,6,9,66.7,3,1,0,1,2,14,1,0,"MF,FW",20-24,Midfielder,France,Europe
111058,Arnaud Souquet,FRA,Montpellier,Ligue 1,2019,27.0,1992.0,22.4,62,40,45,13,4,30,67,44.8,37,20,6,14,17,79,44,0,"DF,FW",25-29,Defender,France,Europe
212723,Djibril Sow,SUI,Eint Frankfurt,Bundesliga,2019,22.0,1997.0,19.4,56,33,26,17,13,16,47,34.0,31,15,3,12,30,86,9,0,MF,20-24,Midfielder,Switzerland,Europe
118689,Leonardo Spinazzola,ITA,Roma,Serie A,2019,26.0,1993.0,17.2,24,12,11,8,5,12,21,57.1,9,13,5,8,20,44,41,0,DF,25-29,Defender,Italy,Europe
249356,Jack Stacey,ENG,Bournemouth,Premier League,2019,23.0,1996.0,17.2,21,11,9,11,1,8,22,36.4,14,27,11,16,18,39,64,1,DF,20-24,Defender,England,Europe
87672,Junior Stanislas,ENG,Bournemouth,Premier League,2019,29.0,1989.0,7.9,10,7,2,3,5,3,8,37.5,5,6,0,6,4,14,6,0,"MF,FW",25-29,Midfielder,England,Europe
162434,Niklas Stark,GER,Hertha BSC,Bundesliga,2019,24.0,1995.0,19.2,36,20,24,10,2,9,21,42.9,12,27,12,15,21,57,97,2,DF,20-24,Defender,Germany,Europe
49755,Dale Stephens,ENG,Brighton,Premier League,2019,30.0,1989.0,28.1,73,44,30,37,6,25,75,33.3,50,31,11,20,58,131,42,2,MF,30-34,Midfielder,England,Europe
163744,Jack Stephens,ENG,Southampton,Premier League,2019,25.0,1994.0,27.2,44,27,30,13,1,24,46,52.2,22,38,22,16,31,75,120,2,DF,25-29,Defender,England,Europe
134425,Raheem Sterling,ENG,Manchester City,Premier League,2019,24.0,1994.0,29.5,27,15,8,10,9,6,28,21.4,22,16,2,14,15,42,4,0,FW,20-24,Forward,England,Europe
85706,Enda Stevens,IRL,Sheffield Utd,Premier League,2019,29.0,1990.0,37.2,81,46,48,26,7,42,96,43.8,54,27,8,19,35,116,71,3,DF,25-29,Defender,Republic of Ireland,Europe
48298,Lars Stindl,GER,Gladbach,Bundesliga,2019,30.0,1988.0,15.9,27,16,4,15,8,10,28,35.7,18,18,2,16,10,37,7,0,"MF,FW",30-34,Midfielder,Germany,Europe
106872,Kevin Stger,AUT,Dsseldorf,Bundesliga,2019,25.0,1993.0,14.1,21,15,10,7,4,6,24,25.0,18,24,2,22,26,47,7,1,MF,25-29,Midfielder,Austria,Europe
345041,Vlatko Stojanovski,MKD,Nmes,Ligue 1,2019,22.0,1997.0,1.4,3,3,0,3,0,1,1,100.0,0,0,0,0,0,3,1,0,FW,20-24,Forward,North Macedonia,Europe
186590,John Stones,ENG,Manchester City,Premier League,2019,25.0,1994.0,12.5,16,10,8,7,1,3,5,60.0,2,5,3,2,9,25,32,2,DF,25-29,Defender,England,Europe
457673,Gabriel Strefezza,BRA,SPAL,Serie A,2019,22.0,1997.0,23.4,64,40,28,26,10,22,54,40.7,32,29,3,26,21,85,17,0,"DF,MF",20-24,Defender,Brazil,South America
48081,Christian Strohdiek,GER,Paderborn 07,Bundesliga,2019,31.0,1988.0,15.1,26,22,21,5,0,20,42,47.6,22,16,10,6,25,51,92,0,DF,30-34,Defender,Germany,Europe
68864,Kevin Strootman,NED,Marseille,Ligue 1,2019,29.0,1990.0,15.7,39,27,13,23,3,20,49,40.8,29,16,1,15,17,56,24,0,MF,25-29,Midfielder,Netherlands,Europe
76746,Damin Surez,URU,Getafe,La Liga,2019,31.0,1988.0,28.8,62,32,32,21,9,38,72,52.8,34,25,2,23,27,89,41,0,DF,30-34,Defender,Uruguay,South America
424784,Luis Surez,URU,Barcelona,La Liga,2019,32.0,1987.0,22.2,4,0,0,1,3,2,12,16.7,10,6,1,5,1,5,11,0,FW,30-34,Forward,Uruguay,South America
166601,Niklas Sle,GER,Bayern Munich,Bundesliga,2019,23.0,1995.0,7.1,10,6,8,2,0,4,5,80.0,1,8,6,2,8,18,22,1,DF,20-24,Defender,Germany,Europe
220878,Issiaga Sylla,GUI,Toulouse,Ligue 1,2019,25.0,1994.0,28.0,73,49,44,21,8,40,69,58.0,29,31,7,24,67,140,90,2,DF,25-29,Defender,Guinea,Africa
39106,dm Szalai,HUN,Mainz 05,Bundesliga,2019,31.0,1987.0,12.7,8,4,0,6,2,1,11,9.1,10,9,0,9,2,10,14,0,FW,30-34,Forward,Hungary,Europe
134369,Andrea Tabanelli,ITA,Lecce,Serie A,2019,29.0,1990.0,10.7,22,13,10,9,3,8,28,28.6,20,13,2,11,11,33,19,0,MF,25-29,Midfielder,Italy,Europe
62415,Panagiotis Tachtsidis,GRE,Lecce,Serie A,2019,28.0,1991.0,22.3,52,27,26,20,6,20,56,35.7,36,27,11,16,35,87,32,2,MF,25-29,Midfielder,Greece,Europe
196357,Jonathan Tah,GER,Leverkusen,Bundesliga,2019,23.0,1996.0,23.2,36,26,23,11,2,18,29,62.1,11,25,13,12,27,63,98,2,DF,20-24,Defender,Germany,Europe
346478,Japhet Tanganga,ENG,Tottenham,Premier League,2019,20.0,1999.0,5.8,17,9,10,6,1,10,17,58.8,7,7,6,1,11,28,31,2,DF,20-24,Defender,England,Europe
173504,James Tarkowski,ENG,Burnley,Premier League,2019,26.0,1992.0,38.0,66,43,47,19,0,31,54,57.4,23,63,47,16,63,129,204,4,DF,25-29,Defender,England,Europe
413112,Aurlien Tchouamni,FRA,Bordeaux,Ligue 1,2019,19.0,2000.0,12.3,30,14,15,13,2,11,27,40.7,16,11,3,8,13,43,19,1,MF,Under 20,Midfielder,France,Europe
422380,Bernard Tekpetey,GHA,Dsseldorf,Bundesliga,2019,21.0,1997.0,5.0,4,4,1,2,1,0,2,0.0,2,5,0,5,2,6,0,0,"FW,MF",20-24,Forward,Ghana,Africa
36284,Simon Terodde,GER,Kln,Bundesliga,2019,31.0,1988.0,9.0,8,5,4,3,1,3,13,23.1,10,14,3,11,2,10,14,0,FW,30-34,Forward,Germany,Europe
206746,Kenny Tete,NED,Lyon,Ligue 1,2019,23.0,1995.0,11.9,33,21,12,16,5,15,23,65.2,8,12,3,9,19,52,34,0,DF,20-24,Defender,Netherlands,Europe
472249,Jan Thielmann,GER,Kln,Bundesliga,2019,17.0,2002.0,6.2,9,6,2,6,1,5,12,41.7,7,8,0,8,8,17,6,0,"FW,MF",Under 20,Forward,Germany,Europe
290593,Sada Thioub,SEN,Angers,Ligue 1,2019,24.0,1995.0,16.8,20,12,8,9,3,5,18,27.8,13,9,1,8,4,24,5,0,"MF,FW",20-24,Midfielder,Senegal,Africa
57467,Romain Thomas,FRA,Angers,Ligue 1,2019,31.0,1988.0,26.0,24,17,16,7,1,8,18,44.4,10,35,18,17,39,63,118,1,DF,30-34,Defender,France,Europe
215977,Adrien Thomasson,FRA,Strasbourg,Ligue 1,2019,25.0,1993.0,23.0,36,21,11,16,9,15,47,31.9,32,21,1,20,9,45,9,0,"MF,FW",25-29,Midfielder,France,Europe
156779,Erik Thommy,GER,Dsseldorf,Bundesliga,2019,24.0,1994.0,25.1,40,23,16,16,8,15,39,38.5,24,23,2,21,16,56,20,1,"MF,FW",20-24,Midfielder,Germany,Europe
249565,Youri Tielemans,BEL,Leicester City,Premier League,2019,22.0,1997.0,31.4,52,29,17,30,5,24,74,32.4,50,43,4,39,22,74,18,0,MF,20-24,Midfielder,Belgium,Europe
300716,Kieran Tierney,SCO,Arsenal,Premier League,2019,22.0,1997.0,11.0,20,16,13,6,1,11,15,73.3,4,10,4,6,9,29,37,1,"DF,MF",20-24,Defender,Scotland,Europe
424709,Cheick Timite,CIV,Amiens,Ligue 1,2019,21.0,1997.0,1.3,1,0,0,1,0,0,1,0.0,1,0,0,0,2,3,1,0,"MF,FW",20-24,Midfielder,Ivory Coast,Africa
315110,Karl Toko Ekambi,CMR,Villarreal,La Liga,2019,26.0,1992.0,11.0,5,3,0,3,2,1,4,25.0,3,2,0,2,3,8,2,0,FW,25-29,Forward,Cameroon,Africa
190393,Corentin Tolisso,FRA,Bayern Munich,Bundesliga,2019,24.0,1994.0,7.1,9,4,4,3,2,1,9,11.1,8,9,3,6,4,13,2,1,MF,20-24,Midfielder,France,Europe
129674,Jeremy Toljan,GER,Sassuolo,Serie A,2019,24.0,1994.0,24.3,37,21,24,10,3,18,35,51.4,17,23,12,11,18,55,58,1,DF,20-24,Defender,Germany,Europe
72441,Rafael Toli,ITA,Atalanta,Serie A,2019,28.0,1990.0,29.0,56,29,28,23,5,33,76,43.4,43,31,17,14,45,101,80,0,DF,25-29,Defender,Italy,Europe
331560,Takehiro Tomiyasu,JPN,Bologna,Serie A,2019,20.0,1998.0,28.1,42,24,25,13,4,22,41,53.7,19,34,9,25,49,91,78,1,DF,20-24,Defender,Japan,Asia
61592,James Tomkins,ENG,Crystal Palace,Premier League,2019,30.0,1989.0,17.6,29,17,21,8,0,18,25,72.0,7,17,15,2,21,50,103,0,DF,30-34,Defender,England,Europe
303254,Fikayo Tomori,ENG,Chelsea,Premier League,2019,21.0,1997.0,14.3,29,16,21,8,0,10,15,66.7,5,13,7,6,22,51,48,2,DF,20-24,Defender,England,Europe
397033,Sandro Tonali,ITA,Brescia,Serie A,2019,19.0,2000.0,33.5,39,25,16,20,3,16,55,29.1,39,36,14,22,41,80,42,0,MF,Under 20,Midfielder,Italy,Europe
111347,Lorenzo Tonelli,ITA,Sampdoria,Serie A,2019,29.0,1990.0,7.8,13,9,13,0,0,4,10,40.0,6,10,7,3,4,17,23,0,DF,25-29,Defender,Italy,Europe
159883,Ernesto Torregrossa,VEN,Brescia,Serie A,2019,27.0,1992.0,20.5,17,7,5,10,2,6,22,27.3,16,10,2,8,5,22,22,0,FW,25-29,Forward,Venezuela,South America
530902,Abdoulaye Tour,GUI,Nantes,Ligue 1,2019,25.0,1994.0,24.7,32,21,10,21,1,10,30,33.3,20,31,11,20,29,61,18,1,MF,25-29,Midfielder,Guinea,Africa
216181,Almamy Tour,MLI,Eint Frankfurt,Bundesliga,2019,23.0,1996.0,16.6,32,19,18,11,3,11,22,50.0,11,18,7,11,23,55,54,1,DF,20-24,Defender,Mali,Africa
353948,Lucas Tousart,FRA,Lyon,Ligue 1,2019,22.0,1997.0,19.6,58,32,19,34,5,17,56,30.4,39,19,7,12,31,89,27,1,MF,20-24,Midfielder,France,Europe
297070,Hamari Traor,MLI,Rennes,Ligue 1,2019,27.0,1992.0,26.8,55,26,34,18,3,32,64,50.0,32,22,5,17,48,103,59,1,DF,25-29,Defender,Mali,Africa
75921,Christopher Trimmel,AUT,Union Berlin,Bundesliga,2019,32.0,1987.0,31.8,71,41,35,32,4,32,54,59.3,22,31,10,21,51,122,88,1,"DF,MF",30-34,Defender,Austria,Europe
144028,Leandro Trossard,BEL,Brighton,Premier League,2019,24.0,1994.0,22.3,22,17,7,12,3,6,38,15.8,32,16,1,15,9,31,8,0,"FW,MF",20-24,Forward,Belgium,Europe
142281,Anthony Ujah,NGA,Union Berlin,Bundesliga,2019,28.0,1990.0,10.5,8,6,4,2,2,1,6,16.7,5,0,0,0,3,11,10,0,"FW,MF",25-29,Forward,Nigeria,Africa
251106,Enes nal,TUR,Valladolid,La Liga,2019,22.0,1997.0,26.0,20,12,6,11,3,6,28,21.4,22,17,5,12,6,26,13,0,FW,20-24,Forward,Turkey,Asia
344695,Dayot Upamecano,FRA,RB Leipzig,Bundesliga,2019,20.0,1998.0,26.2,52,31,37,15,0,23,43,53.5,20,31,17,14,43,95,88,1,DF,20-24,Defender,France,Europe
47893,William Vainqueur,FRA,Toulouse,Ligue 1,2019,30.0,1988.0,19.1,68,36,30,32,6,22,60,36.7,38,21,5,16,29,97,23,0,MF,30-34,Midfielder,France,Europe
406008,Yan Valery,TUN,Southampton,Premier League,2019,20.0,1999.0,8.7,20,7,9,7,4,11,19,57.9,8,9,1,8,13,33,32,2,DF,20-24,Defender,Tunisia,Africa
369081,Federico Valverde,URU,Real Madrid,La Liga,2019,21.0,1998.0,21.2,38,19,9,19,10,12,36,33.3,24,38,4,34,21,59,12,2,MF,20-24,Midfielder,Uruguay,South America
139208,Virgil van Dijk,NED,Liverpool,Premier League,2019,28.0,1991.0,38.0,23,12,18,5,0,6,13,46.2,7,20,15,5,40,63,166,2,DF,25-29,Defender,Netherlands,Europe
197838,Jamie Vardy,ENG,Leicester City,Premier League,2019,32.0,1987.0,33.7,15,12,0,9,6,2,4,50.0,2,22,4,18,2,17,22,0,FW,30-34,Forward,England,Europe
333516,Sebastian Vasiliadis,GRE,Paderborn 07,Bundesliga,2019,21.0,1997.0,31.2,73,45,34,31,8,28,81,34.6,53,47,6,41,34,107,50,0,MF,20-24,Midfielder,Greece,Europe
76163,Franco Vzquez,ARG,Sevilla,La Liga,2019,30.0,1989.0,12.2,25,17,9,14,2,6,36,16.7,30,13,0,13,10,35,10,0,"MF,FW",30-34,Midfielder,Argentina,South America
240219,Lorenzo Venuti,ITA,Fiorentina,Serie A,2019,24.0,1995.0,9.5,20,10,12,6,2,13,19,68.4,6,5,1,4,11,31,15,0,"DF,MF",20-24,Defender,Italy,Europe
130360,Simone Verdi,ITA,Torino,Serie A,2019,27.0,1992.0,23.0,19,10,4,12,3,9,38,23.7,29,14,0,14,7,26,1,0,"MF,FW",25-29,Midfielder,Italy,Europe
164771,Jordan Veretout,FRA,Roma,Serie A,2019,26.0,1993.0,29.2,36,18,13,16,7,14,43,32.6,29,35,5,30,18,54,31,1,MF,25-29,Midfielder,France,Europe
162961,Valerio Verre,ITA,Hellas Verona,Serie A,2019,25.0,1994.0,19.7,25,15,4,11,10,9,23,39.1,14,5,0,5,13,38,9,0,"MF,FW",25-29,Midfielder,Italy,Europe
99331,Jannik Vestergaard,DEN,Southampton,Premier League,2019,26.0,1992.0,16.6,19,12,14,5,0,11,28,39.3,17,15,9,6,26,45,99,2,DF,25-29,Defender,Denmark,Europe
240158,Francesco Vicari,ITA,SPAL,Serie A,2019,24.0,1994.0,32.2,27,13,20,6,1,12,25,48.0,13,48,37,11,38,65,145,1,DF,20-24,Defender,Italy,Europe
37666,Arturo Vidal,CHI,Barcelona,La Liga,2019,32.0,1987.0,18.6,63,38,22,30,11,24,58,41.4,34,31,7,24,17,80,16,1,MF,30-34,Midfielder,Chile,South America
434676,Ronaldo Vieira,ENG,Sampdoria,Serie A,2019,21.0,1998.0,20.2,33,19,13,17,3,6,28,21.4,22,14,2,12,21,54,31,0,MF,20-24,Midfielder,England,Europe
82009,Kevin Volland,GER,Leverkusen,Bundesliga,2019,27.0,1992.0,22.7,16,6,5,6,5,5,16,31.3,11,14,2,12,5,21,7,0,FW,25-29,Forward,Germany,Europe
111196,Stefan de Vrij,NED,Inter,Serie A,2019,27.0,1992.0,31.4,33,18,20,12,1,14,27,51.9,13,34,24,10,52,85,121,1,DF,25-29,Defender,Netherlands,Europe
323954,Walace,BRA,Udinese,Serie A,2019,24.0,1995.0,12.7,28,9,19,6,3,13,42,31.0,29,14,6,8,33,61,19,0,MF,20-24,Midfielder,Brazil,South America
33713,Theo Walcott,ENG,Everton,Premier League,2019,30.0,1989.0,14.3,13,8,6,5,2,3,15,20.0,12,13,0,13,8,21,1,0,"MF,FW",30-34,Midfielder,England,Europe
196095,Luca Waldschmidt,GER,Freiburg,Bundesliga,2019,23.0,1996.0,14.1,10,7,3,5,2,2,18,11.1,16,11,2,9,4,14,4,0,"FW,MF",20-24,Forward,Germany,Europe
95424,Kyle Walker,ENG,Manchester City,Premier League,2019,29.0,1990.0,26.6,28,18,12,15,1,12,29,41.4,17,15,6,9,28,56,42,1,DF,25-29,Defender,England,Europe
477758,Aaron Wan-Bissaka,ENG,Manchester Utd,Premier League,2019,21.0,1997.0,34.1,129,80,71,50,8,64,86,74.4,22,46,13,33,66,195,83,0,DF,20-24,Defender,England,Europe
92572,Joel Ward,ENG,Crystal Palace,Premier League,2019,29.0,1989.0,26.5,69,42,48,16,5,39,56,69.6,17,13,6,7,48,117,93,1,DF,25-29,Defender,England,Europe
181579,James Ward-Prowse,ENG,Southampton,Premier League,2019,24.0,1994.0,38.0,92,48,39,39,14,39,94,41.5,55,48,14,34,60,152,75,1,"MF,DF",20-24,Midfielder,England,Europe
212847,Adam Webster,ENG,Brighton,Premier League,2019,24.0,1995.0,29.6,30,17,21,8,1,14,32,43.8,18,43,26,17,45,75,110,2,DF,20-24,Defender,England,Europe
196792,Julian Weigl,GER,Dortmund,Bundesliga,2019,23.0,1995.0,11.3,16,9,12,3,1,9,16,56.3,7,10,0,10,8,24,21,0,"MF,DF",20-24,Midfielder,Germany,Europe
67063,Danny Welbeck,ENG,Watford,Premier League,2019,28.0,1990.0,9.1,14,6,6,5,3,3,11,27.3,8,12,1,11,5,19,7,0,"FW,MF",25-29,Forward,England,Europe
19305,Oscar Wendt,SWE,Gladbach,Bundesliga,2019,33.0,1985.0,18.7,26,14,16,8,2,12,31,38.7,19,27,6,21,20,46,45,0,DF,30-34,Defender,Sweden,Europe
170527,Timo Werner,GER,RB Leipzig,Bundesliga,2019,23.0,1996.0,31.1,20,9,6,7,7,3,16,18.8,13,16,0,16,5,25,2,0,FW,20-24,Forward,Germany,Europe
91317,Ashley Westwood,ENG,Burnley,Premier League,2019,29.0,1990.0,35.0,54,33,15,32,7,17,48,35.4,31,23,11,12,32,86,32,3,MF,25-29,Midfielder,England,Europe
49499,Georginio Wijnaldum,NED,Liverpool,Premier League,2019,28.0,1990.0,32.6,38,20,12,21,5,10,40,25.0,30,18,4,14,17,55,34,3,MF,25-29,Midfielder,Netherlands,Europe
341710,William,BRA,Wolfsburg,Bundesliga,2019,24.0,1995.0,15.2,55,26,34,14,7,27,59,45.8,32,10,3,7,24,79,38,1,DF,20-24,Defender,Brazil,South America
507700,Brandon Williams,ENG,Manchester Utd,Premier League,2019,18.0,2000.0,11.2,21,15,11,6,4,9,29,31.0,20,9,4,5,16,37,27,0,DF,Under 20,Defender,England,Europe
255508,Iaki Williams,GHA,Athletic Club,La Liga,2019,25.0,1994.0,32.7,15,5,0,7,8,5,18,27.8,13,18,2,16,5,20,29,0,FW,25-29,Forward,Ghana,Africa
55338,Willian,BRA,Chelsea,Premier League,2019,30.0,1988.0,28.9,45,27,14,24,7,14,43,32.6,29,15,0,15,20,65,7,0,"FW,MF",30-34,Forward,Brazil,South America
340329,Joe Willock,ENG,Arsenal,Premier League,2019,19.0,1999.0,9.5,25,16,9,12,4,8,21,38.1,13,16,2,14,4,29,11,2,"MF,FW",Under 20,Midfielder,England,Europe
450826,Callum Wilson,ENG,Bournemouth,Premier League,2019,27.0,1992.0,32.3,12,9,3,6,3,2,17,11.8,15,16,2,14,4,16,16,0,FW,25-29,Forward,England,Europe
279455,Harry Wilson,WAL,Bournemouth,Premier League,2019,22.0,1997.0,18.3,23,13,8,10,5,11,34,32.4,23,26,2,24,11,34,15,1,"MF,FW",20-24,Midfielder,Wales,Europe
249126,Harry Winks,ENG,Tottenham,Premier League,2019,23.0,1996.0,24.7,40,24,18,20,2,17,54,31.5,37,27,8,19,36,76,32,1,MF,20-24,Midfielder,England,Europe
35047,Axel Witsel,BEL,Dortmund,Bundesliga,2019,30.0,1989.0,24.9,28,20,10,17,1,14,33,42.4,19,26,7,19,31,59,19,1,MF,30-34,Midfielder,Belgium,Europe
108725,Chris Wood,NZL,Burnley,Premier League,2019,27.0,1991.0,27.1,7,4,2,4,1,5,15,33.3,10,15,2,13,4,11,18,0,FW,25-29,Forward,New Zealand,Oceania
111455,Granit Xhaka,SUI,Arsenal,Premier League,2019,26.0,1992.0,28.7,45,25,20,19,6,25,55,45.5,30,32,16,16,21,66,59,3,MF,25-29,Midfielder,Switzerland,Europe
344598,Dan-Axel Zagadou,FRA,Dortmund,Bundesliga,2019,20.0,1999.0,10.9,16,10,12,4,0,6,8,75.0,2,12,8,4,15,31,38,0,DF,20-24,Defender,France,Europe
334526,Denis Zakaria,SUI,Gladbach,Bundesliga,2019,22.0,1996.0,21.6,49,30,23,23,3,20,39,51.3,19,39,12,27,37,86,31,1,"MF,DF",20-24,Midfielder,Switzerland,Europe
407265,Luca Zanimacchia,ITA,Juventus,Serie A,2019,21.0,1998.0,1.3,5,1,1,2,2,1,2,50.0,1,1,0,1,0,5,0,0,"FW,MF",20-24,Forward,Italy,Europe
392085,Nicol Zaniolo,ITA,Roma,Serie A,2019,20.0,1999.0,16.7,15,11,4,7,4,3,24,12.5,21,14,0,14,5,20,5,0,"FW,MF",20-24,Forward,Italy,Europe
34344,Cristin Zapata,COL,Genoa,Serie A,2019,32.0,1986.0,19.1,23,17,16,7,0,8,16,50.0,8,29,17,12,24,47,75,0,DF,30-34,Defender,Colombia,South America
73794,Duvn Zapata,COL,Atalanta,Serie A,2019,28.0,1991.0,22.5,7,3,1,2,4,1,6,16.7,5,18,7,11,2,9,11,0,FW,25-29,Forward,Colombia,South America
96828,Simone Zaza,ITA,Torino,Serie A,2019,28.0,1991.0,18.2,15,10,6,4,5,3,10,30.0,7,11,0,11,9,24,13,1,FW,25-29,Forward,Italy,Europe
118196,Jean Zimmer,GER,Dsseldorf,Bundesliga,2019,25.0,1993.0,8.0,11,6,5,5,1,5,10,50.0,5,3,1,2,3,14,0,0,"DF,FW",25-29,Defender,Germany,Europe
77812,Christoph Zimmermann,GER,Norwich City,Premier League,2019,26.0,1993.0,15.9,32,21,26,6,0,21,30,70.0,9,22,18,4,19,51,87,2,DF,25-29,Defender,Germany,Europe
203853,Oleksandr Zinchenko,UKR,Manchester City,Premier League,2019,22.0,1996.0,14.2,31,19,16,11,4,17,32,53.1,15,9,0,9,17,48,21,1,DF,20-24,Defender,Ukraine,Europe
93841,Ben Zolinski,GER,Paderborn 07,Bundesliga,2019,27.0,1992.0,13.4,17,9,7,9,1,7,27,25.9,20,12,0,12,8,25,4,0,"FW,MF",25-29,Forward,Germany,Europe
157509,Kurt Zouma,FRA,Chelsea,Premier League,2019,24.0,1994.0,26.0,23,14,17,6,0,9,16,56.3,7,22,14,8,58,81,116,2,DF,20-24,Defender,France,Europe
199369,Sandro Ramrez,ESP,Valladolid,La Liga,2019,24.0,1995.0,14.5,12,10,2,6,4,2,20,10.0,18,11,1,10,7,19,2,0,"FW,MF",20-24,Forward,Spain,Europe
26066,Ivn Ramis,ESP,Eibar,La Liga,2019,34.0,1984.0,5.1,3,2,2,1,0,1,4,25.0,3,2,0,2,4,7,23,2,DF,30-34,Defender,Spain,Europe
25557,Sergio Ramos,ESP,Real Madrid,La Liga,2019,33.0,1986.0,33.5,46,31,26,17,3,20,42,47.6,22,22,9,13,49,95,102,4,DF,30-34,Defender,Spain,Europe
268178,Arkadiusz Reca,POL,SPAL,Serie A,2019,24.0,1995.0,21.4,38,23,22,10,6,13,39,33.3,26,15,2,13,32,70,48,1,DF,20-24,Defender,Poland,Europe
282429,Sergio Reguiln,ESP,Sevilla,La Liga,2019,22.0,1996.0,27.9,57,30,28,25,4,27,64,42.2,37,25,5,20,33,90,53,0,DF,20-24,Defender,Spain,Europe
249513,Diego Rico,ESP,Bournemouth,Premier League,2019,26.0,1993.0,25.9,61,39,32,24,5,29,59,49.2,30,31,7,24,84,145,91,0,DF,25-29,Defender,Spain,Europe
278837,Luis Rioja,ESP,Alavs,La Liga,2019,25.0,1993.0,18.2,18,12,11,6,1,8,25,32.0,17,21,0,21,16,34,6,0,MF,25-29,Midfielder,Spain,Europe
85370,Sergi Roberto,ESP,Barcelona,La Liga,2019,27.0,1992.0,26.0,35,22,16,11,8,15,25,60.0,10,12,3,9,33,68,36,0,"DF,MF",25-29,Defender,Spain,Europe
67548,Rubn Rochina,ESP,Levante,La Liga,2019,28.0,1991.0,20.8,41,26,22,9,10,19,52,36.5,33,16,0,16,12,53,19,1,MF,25-29,Midfielder,Spain,Europe
51510,ngel Rodrguez,ESP,Getafe,La Liga,2019,32.0,1987.0,15.6,14,8,2,8,4,2,18,11.1,16,10,1,9,3,17,10,0,FW,30-34,Forward,Spain,Europe
834470,Dani Rodrguez,ESP,Mallorca,La Liga,2019,31.0,1988.0,33.8,59,32,24,28,7,18,61,29.5,43,35,3,32,38,97,27,1,"MF,FW",30-34,Midfielder,Spain,Europe
378139,Aitor Ruibal,ESP,Legans,La Liga,2019,23.0,1996.0,13.6,27,17,14,11,2,16,39,41.0,23,18,1,17,8,35,11,0,"DF,MF",20-24,Defender,Spain,Europe
307519,Fede San Emeterio,ESP,Valladolid,La Liga,2019,22.0,1997.0,19.5,26,13,18,6,2,7,29,24.1,22,20,8,12,28,54,13,1,MF,20-24,Midfielder,Spain,Europe
571020,Oihan Sancet,ESP,Athletic Club,La Liga,2019,19.0,2000.0,8.2,11,7,5,4,2,4,11,36.4,7,6,0,6,2,13,2,0,"MF,FW",Under 20,Midfielder,Spain,Europe
95963,Germn Snchez,ESP,Granada,La Liga,2019,32.0,1986.0,25.5,16,10,12,4,0,6,16,37.5,10,29,23,6,33,49,115,2,DF,30-34,Defender,Spain,Europe
63290,Vctor Snchez,ESP,Espanyol,La Liga,2019,31.0,1987.0,18.8,66,36,36,23,7,30,71,42.3,41,31,8,23,27,93,23,1,MF,30-34,Midfielder,Spain,Europe
289286,Luca Sangalli,ESP,Real Sociedad,La Liga,2019,24.0,1995.0,4.1,1,0,0,1,0,1,8,12.5,7,3,0,3,1,2,0,0,MF,20-24,Midfielder,Spain,Europe
63040,Oier Sanjurjo,ESP,Osasuna,La Liga,2019,33.0,1986.0,25.8,65,34,21,34,10,28,64,43.8,36,33,8,25,35,100,39,1,MF,30-34,Midfielder,Spain,Europe
74230,Pablo Sarabia,ESP,Paris S-G,Ligue 1,2019,27.0,1992.0,12.9,12,7,3,6,3,4,25,16.0,21,19,1,18,10,22,5,0,"FW,MF",25-29,Forward,Spain,Europe
242086,Patrik Schick,CZE,RB Leipzig,Bundesliga,2019,23.0,1996.0,14.4,7,3,1,3,3,2,9,22.2,7,8,2,6,2,9,17,0,FW,20-24,Forward,Czech Republic,Europe
237499,Aleksandar Sedlar,SRB,Mallorca,La Liga,2019,27.0,1991.0,9.0,13,6,10,2,1,7,11,63.6,4,17,11,6,16,29,31,0,DF,25-29,Defender,Serbia,Europe
161267,Josep Se,ESP,Mallorca,La Liga,2019,27.0,1991.0,1.7,2,1,2,0,0,2,5,40.0,3,2,1,1,0,2,2,0,MF,25-29,Midfielder,Spain,Europe
58799,Salva Sevilla,ESP,Mallorca,La Liga,2019,35.0,1984.0,28.5,27,21,11,16,0,9,30,30.0,21,17,5,12,29,56,17,1,MF,35-39,Midfielder,Spain,Europe
86759,David Silva,ESP,Manchester City,Premier League,2019,33.0,1986.0,20.3,26,14,3,15,8,10,28,35.7,18,18,3,15,13,39,5,0,MF,30-34,Midfielder,Spain,Europe
85383,Rubn Sobrino,ESP,Valencia,La Liga,2019,27.0,1992.0,1.9,7,5,3,2,2,2,3,66.7,1,1,0,1,0,7,1,0,"FW,MF",25-29,Forward,Spain,Europe
372246,Carlos Soler,ESP,Valencia,La Liga,2019,22.0,1997.0,23.0,21,10,10,10,1,9,39,23.1,30,16,6,10,9,30,14,0,MF,20-24,Midfielder,Spain,Europe
44412,Bruno Soriano,ESP,Villarreal,La Liga,2019,35.0,1984.0,2.9,4,0,1,2,1,1,1,100.0,0,4,0,4,1,5,7,0,"MF,FW",35-39,Midfielder,Spain,Europe
165007,Denis Surez,ESP,Celta Vigo,La Liga,2019,25.0,1994.0,18.1,22,15,14,7,1,10,37,27.0,27,9,1,8,14,36,12,1,"MF,FW",25-29,Midfielder,Spain,Europe
111961,Suso,ESP,Milan,Serie A,2019,25.0,1993.0,15.1,7,3,2,3,2,2,10,20.0,8,5,0,5,8,15,3,0,"FW,MF",25-29,Forward,Spain,Europe
290273,lvaro Tejero,ESP,Eibar,La Liga,2019,23.0,1996.0,16.1,30,18,17,10,3,14,23,60.9,9,17,4,13,28,58,38,0,DF,20-24,Defender,Spain,Europe
141834,Cristian Tello,ESP,Betis,La Liga,2019,27.0,1991.0,8.7,8,5,2,2,4,4,8,50.0,4,5,0,5,4,12,0,0,"MF,FW",25-29,Midfielder,Spain,Europe
12384,Alexander Tettey,NOR,Norwich City,Premier League,2019,33.0,1986.0,26.0,23,18,7,16,0,11,39,28.2,28,20,9,11,43,66,72,1,"MF,DF",30-34,Midfielder,Norway,Europe
226524,Morten Thorsby,NOR,Sampdoria,Serie A,2019,23.0,1996.0,20.7,53,34,17,23,13,27,52,51.9,25,24,6,18,17,70,34,0,"MF,DF",20-24,Midfielder,Norway,Europe
158795,David Timor,ESP,Getafe,La Liga,2019,29.0,1989.0,10.5,9,6,4,5,0,5,16,31.3,11,8,3,5,18,27,23,0,"MF,DF",25-29,Midfielder,Spain,Europe
47085,Nenad Tomovi,SRB,SPAL,Serie A,2019,31.0,1987.0,19.5,26,19,18,6,2,10,21,47.6,11,32,23,9,30,56,65,1,DF,30-34,Defender,Serbia,Europe
214775,liver Torres,ESP,Sevilla,La Liga,2019,24.0,1994.0,17.7,45,27,12,26,7,23,60,38.3,37,23,1,22,13,58,9,1,"MF,FW",20-24,Midfielder,Spain,Europe
399776,Pau Torres,ESP,Villarreal,La Liga,2019,22.0,1997.0,33.0,34,21,24,10,0,16,24,66.7,8,39,23,16,27,61,153,1,DF,20-24,Defender,Spain,Europe
162074,lvaro Vadillo,ESP,Granada,La Liga,2019,24.0,1994.0,13.5,16,11,6,8,2,9,16,56.3,7,12,0,12,7,23,2,0,"FW,MF",20-24,Forward,Spain,Europe
40372,Borja Valero,ESP,Inter,Serie A,2019,34.0,1985.0,10.3,18,7,9,3,6,6,24,25.0,18,12,3,9,8,26,9,0,MF,30-34,Midfielder,Spain,Europe
221316,Lucas Vzquez,ESP,Real Madrid,La Liga,2019,28.0,1991.0,9.4,23,17,10,13,0,11,26,42.3,15,10,0,10,10,33,8,1,"MF,FW",25-29,Midfielder,Spain,Europe
88490,Aleix Vidal,ESP,Alavs,La Liga,2019,29.0,1989.0,24.1,21,14,8,11,2,8,37,21.6,29,14,1,13,23,44,18,0,MF,25-29,Midfielder,Spain,Europe
216870,Nacho Vidal,ESP,Osasuna,La Liga,2019,24.0,1995.0,25.9,45,29,26,13,6,21,38,55.3,17,24,6,18,44,89,70,1,DF,20-24,Defender,Spain,Europe
67090,Ddac Vil,ESP,Espanyol,La Liga,2019,30.0,1989.0,27.7,73,42,44,23,6,25,61,41.0,36,31,5,26,40,113,63,0,DF,30-34,Defender,Spain,Europe
337066,Toni Villa,ESP,Valladolid,La Liga,2019,24.0,1995.0,15.0,31,16,13,14,4,13,50,26.0,37,16,1,15,8,39,11,0,MF,20-24,Midfielder,Spain,Europe
251897,Asier Villalibre,ESP,Athletic Club,La Liga,2019,21.0,1997.0,5.9,0,0,0,0,0,0,3,0.0,3,3,0,3,1,1,4,0,FW,20-24,Forward,Spain,Europe
398163,Gonzalo Villar,ESP,Roma,Serie A,2019,21.0,1998.0,3.3,5,3,4,0,1,2,4,50.0,2,2,0,2,2,7,3,0,MF,20-24,Midfielder,Spain,Europe
85500,Juan Villar,ESP,Osasuna,La Liga,2019,31.0,1988.0,2.7,1,0,0,1,0,0,2,0.0,2,4,1,3,1,2,0,0,FW,30-34,Forward,Spain,Europe
67082,Vitolo,ESP,Atltico Madrid,La Liga,2019,29.0,1989.0,13.6,15,12,7,7,1,5,17,29.4,12,9,0,9,10,25,9,0,"FW,MF",25-29,Forward,Spain,Europe
357498,Duan Vlahovi,SRB,Fiorentina,Serie A,2019,19.0,2000.0,16.7,6,2,1,4,1,4,13,30.8,9,5,2,3,7,13,6,0,FW,Under 20,Forward,Serbia,Europe
181136,Piotr Zieliski,POL,Napoli,Serie A,2019,25.0,1994.0,32.5,26,16,10,11,5,12,30,40.0,18,28,5,23,21,47,15,0,MF,25-29,Midfielder,Poland,Europe
355628,Igor Zubeldia,ESP,Real Sociedad,La Liga,2019,22.0,1997.0,29.3,42,21,18,19,5,17,35,48.6,18,38,21,17,26,68,82,2,"MF,DF",20-24,Midfielder,Spain,Europe
393323,Brenden Aaronson,USA,Leeds United,Premier League,2022,21.0,2000.0,26.4,45,18,16,22,7,15,46,32.6,31,43,3,40,5,50,6,1,"MF,FW",20-24,Midfielder,United States,North America
199704,Yunis Abdelhamid,MAR,Reims,Ligue 1,2022,34.0,1987.0,37.0,82,50,47,33,2,39,52,75.0,13,65,27,38,64,146,116,1,DF,30-34,Defender,Morocco,Africa
592979,Himad Abdelli,ALG,Angers,Ligue 1,2022,22.0,1999.0,23.7,64,38,22,32,10,31,67,46.3,36,30,1,29,28,92,15,0,"MF,FW",20-24,Midfielder,Algeria,Africa
688707,Salis Abdul Samed,GHA,Lens,Ligue 1,2022,22.0,2000.0,32.2,46,26,18,23,5,29,52,55.8,23,38,9,29,36,82,26,0,MF,20-24,Midfielder,Ghana,Africa
238626,Laurent Abergel,FRA,Lorient,Ligue 1,2022,29.0,1993.0,26.0,92,52,59,30,3,39,92,42.4,53,47,8,39,34,126,39,0,MF,25-29,Midfielder,France,Europe
325993,Oliver Abildgaard,DEN,Hellas Verona,Serie A,2022,26.0,1996.0,6.6,10,6,6,3,1,7,16,43.8,9,7,1,6,5,15,17,0,MF,25-29,Midfielder,Denmark,Europe
646402,Abner,BRA,Betis,La Liga,2022,22.0,2000.0,6.7,12,9,9,2,1,7,16,43.8,9,8,2,6,8,20,24,0,DF,20-24,Defender,Brazil,South America
393238,Zakaria Aboukhlal,MAR,Toulouse,Ligue 1,2022,22.0,2000.0,27.5,33,23,13,9,11,14,45,31.1,31,18,1,17,22,55,23,0,"FW,MF",20-24,Forward,Morocco,Africa
331726,Tammy Abraham,ENG,Roma,Serie A,2022,24.0,1997.0,24.3,17,10,4,8,5,3,16,18.8,13,10,4,6,3,20,14,0,FW,20-24,Forward,England,Europe
131075,Francesco Acerbi,ITA,Inter,Serie A,2022,34.0,1988.0,26.9,33,19,22,7,4,20,27,74.1,7,25,18,7,41,74,85,2,DF,30-34,Defender,Italy,Europe
125614,Sargis Adamyan,ARM,Kln,Bundesliga,2022,29.0,1993.0,7.2,14,7,5,3,6,7,17,41.2,10,12,0,12,4,18,5,0,"FW,MF",25-29,Forward,Armenia,Asia
258878,Tosin Adarabioyo,ENG,Fulham,Premier League,2022,24.0,1997.0,23.2,30,13,22,6,2,16,23,69.6,7,20,15,5,26,56,140,1,DF,20-24,Defender,England,Europe
496094,Karim Adeyemi,GER,Dortmund,Bundesliga,2022,20.0,2002.0,15.4,16,11,6,6,4,8,30,26.7,22,18,1,17,7,23,3,0,"FW,MF",20-24,Forward,Germany,Europe
532776,Amine Adli,MAR,Leverkusen,Bundesliga,2022,22.0,2000.0,15.9,18,10,4,6,8,5,17,29.4,12,28,2,26,6,24,7,0,"FW,MF",20-24,Forward,Morocco,Africa
395236,Yacine Adli,FRA,Milan,Serie A,2022,22.0,2000.0,1.6,6,3,2,4,0,2,2,100.0,0,2,0,2,1,7,1,0,"MF,FW",20-24,Midfielder,France,Europe
872380,Felix Afena-Gyan,GHA,Cremonese,Serie A,2022,19.0,2003.0,9.1,7,3,4,1,2,2,10,20.0,8,5,1,4,1,8,6,0,"FW,MF",Under 20,Forward,Ghana,Africa
683895,Emmanuel Agbadou,CIV,Reims,Ligue 1,2022,25.0,1997.0,26.5,71,49,53,16,2,42,65,64.6,23,30,14,16,32,103,107,3,DF,25-29,Defender,Ivory Coast,Africa
587458,Kevin Agudelo,COL,Spezia,Serie A,2022,23.0,1998.0,23.7,71,38,22,30,19,25,59,42.4,34,39,5,34,10,81,6,0,"MF,FW",20-24,Midfielder,Colombia,South America
361914,Nayef Aguerd,MAR,West Ham,Premier League,2022,26.0,1996.0,17.7,27,18,18,8,1,13,20,65.0,7,26,24,2,18,45,79,2,DF,25-29,Defender,Morocco,Africa
203746,Ruben Aguilar,FRA,Monaco,Ligue 1,2022,29.0,1993.0,13.0,19,9,7,7,5,8,22,36.4,14,13,1,12,18,37,28,1,DF,25-29,Defender,France,Europe
178313,Jean-Eudes Aholou,CIV,Strasbourg,Ligue 1,2022,28.0,1994.0,14.4,34,20,10,20,4,12,31,38.7,19,25,0,25,24,58,15,0,MF,25-29,Midfielder,Ivory Coast,Africa
358250,Joseph Aidoo,GHA,Celta Vigo,La Liga,2022,26.0,1995.0,34.7,51,36,33,17,1,16,28,57.1,12,26,14,12,31,82,150,0,DF,25-29,Defender,Ghana,Africa
236490,Ola Aina,NGA,Torino,Serie A,2022,25.0,1996.0,9.7,17,13,5,8,4,9,15,60.0,6,12,2,10,11,28,26,0,DF,25-29,Defender,Nigeria,Africa
283994,Ludovic Ajorque,FRA,Strasbourg,Ligue 1,2022,28.0,1994.0,8.6,5,4,1,4,0,3,9,33.3,6,3,1,2,2,7,7,0,FW,25-29,Forward,France,Europe
177476,Nathan Ak,NED,Manchester City,Premier League,2022,27.0,1995.0,20.8,26,12,15,9,2,11,15,73.3,4,20,10,10,20,46,48,0,DF,25-29,Defender,Netherlands,Europe
429901,Paul Akouokou,CIV,Betis,La Liga,2022,24.0,1997.0,5.0,16,9,13,3,0,13,20,65.0,7,2,2,0,12,28,17,1,"MF,DF",20-24,Midfielder,Ivory Coast,Africa
160241,Kevin Akpoguma,NGA,Hoffenheim,Bundesliga,2022,27.0,1995.0,21.7,75,44,45,27,3,32,45,71.1,13,45,16,29,24,99,70,1,DF,25-29,Defender,Nigeria,Africa
59016,David Alaba,AUT,Real Madrid,La Liga,2022,30.0,1992.0,20.4,15,11,8,4,3,9,15,60.0,6,18,9,9,14,29,37,1,DF,30-34,Defender,Austria,Europe
193782,Lucas Alario,ARG,Eint Frankfurt,Bundesliga,2022,29.0,1992.0,3.7,3,2,1,0,2,0,1,0.0,1,0,0,0,2,5,13,0,"FW,MF",25-29,Forward,Argentina,South America
748319,Carlos Alcaraz,ARG,Southampton,Premier League,2022,19.0,2002.0,11.4,10,5,2,7,1,6,22,27.3,16,14,5,9,1,11,11,0,"MF,FW",Under 20,Midfielder,Argentina,South America
353032,Omar Alderete,PAR,Getafe,La Liga,2022,25.0,1996.0,22.7,35,20,21,14,0,28,40,70.0,12,23,16,7,26,61,85,0,DF,25-29,Defender,Paraguay,South America
314353,Trent Alexander-Arnold,ENG,Liverpool,Premier League,2022,23.0,1998.0,32.5,57,40,32,16,9,42,80,52.5,38,25,7,18,43,100,41,2,DF,20-24,Defender,England,Europe
646733,Jim Allevinah,GAB,Clermont Foot,Ligue 1,2022,27.0,1995.0,24.9,39,24,24,11,4,19,62,30.6,43,24,2,22,24,63,26,1,"DF,FW",25-29,Defender,Gabon,Africa
577486,Gastn lvarez,URU,Getafe,La Liga,2022,22.0,2000.0,16.7,38,30,24,9,5,23,42,54.8,19,15,5,10,15,53,35,0,DF,20-24,Defender,Uruguay,South America
377219,Selim Amallah,MAR,Valladolid,La Liga,2022,25.0,1996.0,3.0,15,9,7,8,0,5,8,62.5,3,2,0,2,5,20,2,0,"MF,FW",25-29,Midfielder,Morocco,Africa
344072,Kelvin Amian,FRA,Spezia,Serie A,2022,24.0,1998.0,26.4,54,32,33,12,9,24,31,77.4,7,34,12,22,22,76,87,1,DF,20-24,Defender,France,Europe
232454,Nadiem Amiri,GER,Leverkusen,Bundesliga,2022,25.0,1996.0,10.9,15,6,5,8,2,9,20,45.0,11,12,1,11,6,21,10,2,"MF,FW",25-29,Midfielder,Germany,Europe
392771,Ethan Ampadu,WAL,Spezia,Serie A,2022,21.0,2000.0,29.3,66,37,33,28,5,17,41,41.5,24,48,23,25,36,102,98,0,"DF,MF",20-24,Defender,Wales,Europe
260827,Joachim Andersen,DEN,Crystal Palace,Premier League,2022,26.0,1996.0,30.9,42,22,30,12,0,16,32,50.0,16,28,13,15,24,66,188,1,DF,25-29,Defender,Denmark,Europe
567576,Elliot Anderson,ENG,Newcastle Utd,Premier League,2022,19.0,2002.0,4.6,11,5,5,3,3,6,12,50.0,6,11,2,9,6,17,2,0,"MF,FW",Under 20,Midfielder,England,Europe
159372,Felipe Anderson,BRA,Lazio,Serie A,2022,29.0,1993.0,32.9,80,50,31,41,8,31,88,35.2,57,58,6,52,31,111,27,0,FW,25-29,Forward,Brazil,South America
84301,Benjamin Andr,FRA,Lille,Ligue 1,2022,31.0,1990.0,32.4,128,74,51,60,17,65,121,53.7,56,50,8,42,47,175,60,0,MF,30-34,Midfielder,France,Europe
684210,Jaidon Anthony,ENG,Bournemouth,Premier League,2022,22.0,1999.0,14.0,30,17,15,9,6,8,24,33.3,16,30,3,27,10,40,19,0,"MF,FW",20-24,Midfielder,England,Europe
538974,Janis Antiste,FRA,Sassuolo,Serie A,2022,19.0,2002.0,0.6,1,0,1,0,0,1,1,100.0,0,0,0,0,0,1,0,0,FW,Under 20,Forward,France,Europe
193004,Waldemar Anton,GER,Stuttgart,Bundesliga,2022,26.0,1996.0,32.6,49,27,27,19,3,27,51,52.9,24,44,16,28,38,87,123,2,DF,25-29,Defender,Germany,Europe
798687,Antony,BRA,Manchester Utd,Premier League,2022,22.0,2000.0,20.0,22,9,9,9,4,8,28,28.6,20,18,0,18,11,33,6,0,FW,20-24,Forward,Brazil,South America
289182,Christopher Antwi-Adjei,GHA,Bochum,Bundesliga,2022,28.0,1994.0,22.0,23,15,7,8,8,10,29,34.5,19,17,0,17,5,28,16,0,"FW,MF",25-29,Forward,Ghana,Africa
395693,Houssem Aouar,ALG,Lyon,Ligue 1,2022,24.0,1998.0,5.8,12,5,5,5,2,3,9,33.3,6,12,2,10,8,20,3,0,MF,20-24,Midfielder,Algeria,Africa
569385,Adil Aouchiche,FRA,Lorient,Ligue 1,2022,20.0,2002.0,2.8,5,2,3,1,1,1,9,11.1,8,1,0,1,4,9,1,0,MF,20-24,Midfielder,France,Europe
111038,Dennis Appiah,FRA,Nantes,Ligue 1,2022,30.0,1992.0,8.8,21,11,14,7,0,10,27,37.0,17,13,5,8,10,31,16,0,"DF,MF",30-34,Defender,France,Europe
89701,Charles Arnguiz,CHI,Leverkusen,Bundesliga,2022,33.0,1989.0,5.5,17,7,7,10,0,12,20,60.0,8,4,0,4,7,24,4,0,MF,30-34,Midfielder,Chile,South America
855056,Taryk Arconte,FRA,Brest,Ligue 1,2022,18.0,2003.0,1.4,1,1,0,0,1,0,3,0.0,3,1,0,1,0,1,2,0,FW,Under 20,Forward,France,Europe
468198,Joe Aribo,NGA,Southampton,Premier League,2022,26.0,1996.0,13.6,31,20,15,12,4,11,20,55.0,9,14,1,13,10,41,11,0,"MF,FW",25-29,Midfielder,Nigeria,Africa
250426,Adam Armstrong,ENG,Southampton,Premier League,2022,25.0,1997.0,14.8,14,9,6,5,3,3,10,30.0,7,15,3,12,5,19,6,0,"FW,MF",25-29,Forward,England,Europe
130765,Stuart Armstrong,SCO,Southampton,Premier League,2022,30.0,1992.0,15.6,32,21,15,13,4,14,39,35.9,25,18,0,18,10,42,9,2,"MF,FW",30-34,Midfielder,Scotland,Europe
53536,Tolgay Arslan,GER,Udinese,Serie A,2022,31.0,1990.0,13.5,29,18,13,15,1,14,39,35.9,25,19,0,19,12,41,9,1,MF,30-34,Midfielder,Germany,Europe
520947,Santiago Arzamendia,PAR,Cdiz,La Liga,2022,24.0,1998.0,5.4,9,8,7,1,1,6,21,28.6,15,11,1,10,2,11,15,1,"DF,MF",20-24,Defender,Paraguay,South America
245744,Takuma Asano,JPN,Bochum,Bundesliga,2022,27.0,1994.0,19.0,14,9,4,4,6,7,16,43.8,9,17,1,16,8,22,8,0,"FW,MF",25-29,Forward,Japan,Asia
423436,Santiago Ascacbar,ARG,Cremonese,Serie A,2022,25.0,1997.0,8.1,29,14,17,10,2,14,35,40.0,21,14,2,12,13,42,11,0,MF,25-29,Midfielder,Argentina,South America
284595,Tommaso Augello,ITA,Sampdoria,Serie A,2022,27.0,1994.0,34.0,17,14,13,2,2,9,20,45.0,11,23,7,16,17,34,61,1,DF,25-29,Defender,Italy,Europe
585982,Carlos Augusto,BRA,Monza,Serie A,2022,23.0,1999.0,34.3,73,38,42,23,8,33,54,61.1,21,24,6,18,24,97,85,1,DF,20-24,Defender,Brazil,South America
127032,Serge Aurier,CIV,Nott'ham Forest,Premier League,2022,29.0,1992.0,21.6,64,41,41,18,5,23,33,69.7,10,34,11,23,29,93,75,0,DF,25-29,Defender,Ivory Coast,Africa
295313,Taiwo Awoniyi,NGA,Nott'ham Forest,Premier League,2022,24.0,1997.0,15.6,17,10,2,10,5,6,12,50.0,6,18,4,14,4,21,20,0,FW,20-24,Forward,Nigeria,Africa
45403,Andr Ayew,GHA,Nott'ham Forest,Premier League,2022,32.0,1989.0,3.5,5,3,0,4,1,2,4,50.0,2,6,1,5,0,5,7,0,"FW,MF",30-34,Forward,Ghana,Africa
108354,Jordan Ayew,GHA,Crystal Palace,Premier League,2022,30.0,1991.0,30.2,66,41,23,20,23,21,53,39.6,32,35,4,31,15,81,31,0,"FW,MF",30-34,Forward,Ghana,Africa
67420,Luke Ayling,ENG,Leeds United,Premier League,2022,30.0,1991.0,22.8,66,37,42,15,9,42,85,49.4,43,34,11,23,26,92,52,2,DF,30-34,Defender,England,Europe
180337,Sardar Azmoun,IRN,Leverkusen,Bundesliga,2022,27.0,1995.0,10.3,6,3,1,4,1,1,7,14.3,6,4,0,4,2,8,14,0,"FW,MF",25-29,Forward,Iran,Asia
442805,Iddrisu Baba,GHA,Mallorca,La Liga,2022,26.0,1996.0,18.9,31,17,15,16,0,15,32,46.9,17,18,8,10,11,42,39,0,"MF,DF",25-29,Midfielder,Ghana,Africa
463603,Benot Badiashile,FRA,Chelsea,Premier League,2022,21.0,2001.0,10.1,14,8,10,4,0,9,14,64.3,5,5,2,3,16,30,34,1,DF,20-24,Defender,France,Europe
387626,Leon Bailey,JAM,Aston Villa,Premier League,2022,24.0,1997.0,21.9,14,6,6,7,1,5,20,25.0,15,13,0,13,6,20,12,0,"FW,MF",20-24,Forward,Jamaica,North America
641537,Tommaso Baldanzi,ITA,Empoli,Serie A,2022,19.0,2003.0,19.7,25,12,9,13,3,7,32,21.9,25,21,1,20,2,27,5,0,MF,Under 20,Midfielder,Italy,Europe
973085,Carlos Baleba,CMR,Lille,Ligue 1,2022,18.0,2004.0,5.3,13,11,2,9,2,9,14,64.3,5,13,3,10,1,14,3,2,MF,Under 20,Midfielder,Cameroon,Africa
85295,Ivn Balliu,ALB,Rayo Vallecano,La Liga,2022,30.0,1992.0,35.9,52,29,26,20,6,18,30,60.0,12,26,3,23,25,77,72,1,DF,30-34,Defender,Albania,Europe
296422,Fod Ballo-Tour,SEN,Milan,Serie A,2022,25.0,1997.0,5.8,14,9,7,6,1,7,10,70.0,3,11,3,8,2,16,3,0,DF,25-29,Defender,Senegal,Africa
503770,Folarin Balogun,USA,Reims,Ligue 1,2022,21.0,2001.0,33.3,9,5,1,5,3,2,20,10.0,18,20,1,19,3,12,15,0,FW,20-24,Forward,United States,North America
292818,Jonathan Bamba,CIV,Lille,Ligue 1,2022,26.0,1996.0,30.9,37,17,12,14,11,14,45,31.1,31,36,1,35,22,59,14,0,FW,25-29,Forward,Ivory Coast,Africa
183334,Patrick Bamford,ENG,Leeds United,Premier League,2022,28.0,1993.0,16.8,9,6,0,6,3,4,20,20.0,16,12,5,7,5,14,13,0,FW,25-29,Forward,England,Europe
545538,Lameck Banda,ZAM,Lecce,Serie A,2022,21.0,2001.0,18.2,30,20,13,14,3,15,41,36.6,26,24,2,22,8,38,5,0,"FW,MF",20-24,Forward,Zambia,Africa
240934,Filippo Bandinelli,ITA,Empoli,Serie A,2022,27.0,1995.0,25.1,55,34,19,26,10,17,45,37.8,28,20,7,13,18,73,40,0,MF,25-29,Midfielder,Italy,Europe
533916,Shandon Baptiste,GRN,Brentford,Premier League,2022,24.0,1998.0,6.9,15,9,6,6,3,7,17,41.2,10,10,2,8,7,22,10,0,MF,20-24,Midfielder,Grenada,North America
708265,Bradley Barcola,FRA,Lyon,Ligue 1,2022,19.0,2002.0,16.0,25,16,8,10,7,8,39,20.5,31,29,0,29,19,44,10,0,"FW,MF",Under 20,Forward,France,Europe
295622,Keidi Bare,ALB,Espanyol,La Liga,2022,24.0,1997.0,5.6,15,8,7,5,3,7,13,53.8,6,8,2,6,11,26,8,0,MF,20-24,Midfielder,Albania,Europe
255942,Nicol Barella,ITA,Inter,Serie A,2022,25.0,1997.0,29.0,49,25,17,26,6,28,53,52.8,25,29,5,24,12,61,12,0,MF,25-29,Midfielder,Italy,Europe
131978,Ross Barkley,ENG,Nice,Ligue 1,2022,28.0,1993.0,10.7,16,9,7,4,5,7,13,53.8,6,7,2,5,8,24,6,0,"MF,FW",25-29,Midfielder,England,Europe
315332,Aymen Barkok,MAR,Mainz 05,Bundesliga,2022,24.0,1998.0,6.5,18,8,10,5,3,5,10,50.0,5,7,0,7,3,21,9,0,MF,20-24,Midfielder,Morocco,Africa
398065,Harvey Barnes,ENG,Leicester City,Premier League,2022,24.0,1997.0,30.1,26,14,8,14,4,14,42,33.3,28,32,1,31,8,34,12,0,"FW,MF",20-24,Forward,England,Europe
486624,Musa Barrow,GAM,Bologna,Serie A,2022,23.0,1998.0,21.8,21,4,10,6,5,8,14,57.1,6,25,1,24,1,22,7,0,"FW,MF",20-24,Forward,Gambia,Africa
351955,Federico Baschirotto,ITA,Lecce,Serie A,2022,25.0,1996.0,37.0,40,30,35,5,0,22,36,61.1,14,45,29,16,36,76,192,0,DF,25-29,Defender,Italy,Europe
334835,Toma Bai,CRO,Lazio,Serie A,2022,25.0,1996.0,5.7,6,4,4,1,1,3,8,37.5,5,9,0,9,7,13,8,0,MF,25-29,Midfielder,Croatia,Europe
315853,Alessandro Bastoni,ITA,Inter,Serie A,2022,23.0,1999.0,24.0,41,20,20,14,7,11,27,40.7,16,27,13,14,24,65,45,0,DF,20-24,Defender,Italy,Europe
257751,Simone Bastoni,ITA,Spezia,Serie A,2022,25.0,1996.0,13.2,47,24,23,19,5,15,33,45.5,18,20,5,15,8,55,14,0,"MF,DF",25-29,Midfielder,Italy,Europe
324278,Christoph Baumgartner,AUT,Hoffenheim,Bundesliga,2022,22.0,1999.0,28.5,36,19,12,17,7,9,52,17.3,43,57,5,52,15,51,19,1,"MF,FW",20-24,Midfielder,Austria,Europe
267147,Cyrille Bayala,BFA,Ajaccio,Ligue 1,2022,26.0,1996.0,22.3,53,37,16,20,17,23,48,47.9,25,20,3,17,25,78,21,0,MF,25-29,Midfielder,Burkina Faso,Africa
188888,Sheraldo Becker,SUR,Union Berlin,Bundesliga,2022,27.0,1995.0,28.4,15,5,1,7,7,2,11,18.2,9,13,1,12,3,18,7,1,FW,25-29,Forward,Suriname,South America
117432,Kevin Behrens,GER,Union Berlin,Bundesliga,2022,31.0,1991.0,17.1,11,7,4,4,3,4,18,22.2,14,18,3,15,5,16,25,0,FW,30-34,Forward,Germany,Europe
539065,Alexis Beka Beka,FRA,Nice,Ligue 1,2022,21.0,2001.0,6.1,16,5,6,9,1,4,15,26.7,11,9,1,8,12,28,6,0,"MF,DF",20-24,Midfielder,France,Europe
170966,Jrmie Bela,ANG,Clermont Foot,Ligue 1,2022,29.0,1993.0,8.3,6,4,2,1,3,3,4,75.0,1,10,1,9,9,15,8,0,"DF,MF",25-29,Defender,Angola,Africa
175014,Youcef Belali,ALG,Ajaccio,Ligue 1,2022,30.0,1992.0,12.8,18,10,3,9,6,8,20,40.0,12,10,1,9,5,23,4,0,"MF,FW",30-34,Midfielder,Algeria,Africa
138055,Haris Belkebla,ALG,Brest,Ligue 1,2022,28.0,1994.0,29.5,80,48,35,40,5,44,85,51.8,41,32,6,26,52,132,21,3,MF,25-29,Midfielder,Algeria,Africa
82350,Stefan Bell,GER,Mainz 05,Bundesliga,2022,30.0,1991.0,26.6,43,28,32,10,1,22,44,50.0,22,42,15,27,44,87,133,0,DF,30-34,Defender,Germany,Europe
450050,Jean-Ricner Bellegarde,FRA,Strasbourg,Ligue 1,2022,24.0,1998.0,26.9,47,25,15,21,11,11,25,44.0,14,26,3,23,26,73,22,0,"MF,FW",20-24,Midfielder,France,Europe
581678,Jude Bellingham,ENG,Dortmund,Bundesliga,2022,19.0,2003.0,29.9,76,42,28,34,14,34,51,66.7,17,51,4,47,35,111,30,0,MF,Under 20,Midfielder,England,Europe
810895,Eliesse Ben Seghir,MAR,Monaco,Ligue 1,2022,17.0,2005.0,11.7,18,10,4,12,2,4,12,33.3,8,18,1,17,4,22,1,0,"FW,MF",Under 20,Forward,Morocco,Africa
146854,Wissam Ben Yedder,FRA,Monaco,Ligue 1,2022,31.0,1990.0,23.5,16,9,2,5,9,4,13,30.8,9,15,0,15,4,20,0,0,FW,30-34,Forward,France,Europe
351816,Ismal Bennacer,ALG,Milan,Serie A,2022,24.0,1997.0,22.3,59,33,26,31,2,30,51,58.8,21,25,7,18,26,85,16,1,MF,20-24,Midfielder,Algeria,Africa
290532,Sad Benrahma,ALG,West Ham,Premier League,2022,26.0,1995.0,23.0,25,15,11,7,7,11,27,40.7,16,23,1,22,9,34,13,0,"FW,MF",25-29,Forward,Algeria,Africa
284732,Ramy Bensebaini,ALG,Gladbach,Bundesliga,2022,27.0,1995.0,27.6,34,21,21,10,3,26,39,66.7,13,44,14,30,36,70,98,1,DF,25-29,Defender,Algeria,Africa
245537,Nabil Bentaleb,ALG,Angers,Ligue 1,2022,27.0,1994.0,27.7,74,40,31,35,8,36,61,59.0,25,33,11,22,44,118,29,3,MF,25-29,Midfielder,Algeria,Africa
18922,Karim Benzema,FRA,Real Madrid,La Liga,2022,34.0,1987.0,22.6,9,5,2,4,3,2,11,18.2,9,11,0,11,2,11,5,0,FW,30-34,Forward,France,Europe
177843,Domenico Berardi,ITA,Sassuolo,Serie A,2022,27.0,1994.0,20.7,23,14,8,10,5,9,40,22.5,31,13,0,13,19,42,18,0,FW,25-29,Forward,Italy,Europe
595809,Beto,GNB,Udinese,Serie A,2022,24.0,1998.0,23.7,16,9,0,9,7,4,17,23.5,13,18,3,15,6,22,30,0,FW,20-24,Forward,Guinea-Bissau,Africa
602124,Alessandro Bianco,ITA,Fiorentina,Serie A,2022,19.0,2002.0,1.7,5,2,2,3,0,2,3,66.7,1,1,0,1,0,5,0,0,MF,Under 20,Midfielder,Italy,Europe
320411,Philip Billing,DEN,Bournemouth,Premier League,2022,26.0,1996.0,30.7,63,36,21,33,9,11,42,26.2,31,48,8,40,31,94,58,1,"MF,FW",25-29,Midfielder,Denmark,Europe
124555,Cristiano Biraghi,ITA,Fiorentina,Serie A,2022,29.0,1992.0,28.3,65,38,29,29,7,32,65,49.2,33,32,7,25,14,79,42,1,DF,25-29,Defender,Italy,Europe
461019,Samuele Birindelli,ITA,Monza,Serie A,2022,23.0,1999.0,15.6,35,19,21,10,4,18,29,62.1,11,28,8,20,16,51,30,0,DF,20-24,Defender,Italy,Europe
822959,Tom Bischof,GER,Hoffenheim,Bundesliga,2022,17.0,2005.0,3.5,15,10,8,3,4,7,10,70.0,3,5,1,4,1,16,1,0,"MF,FW",Under 20,Midfielder,Germany,Europe
93844,Leonardo Bittencourt,GER,Werder Bremen,Bundesliga,2022,28.0,1993.0,18.1,53,28,20,25,8,25,62,40.3,37,13,0,13,10,63,15,0,"MF,DF",25-29,Midfielder,Germany,Europe
831161,Lautaro Blanco,ARG,Elche,La Liga,2022,23.0,1999.0,9.7,16,9,10,4,2,9,26,34.6,17,8,1,7,2,18,10,1,"DF,MF",20-24,Defender,Argentina,South America
288225,Ludovic Blas,FRA,Nantes,Ligue 1,2022,24.0,1997.0,31.3,47,30,17,19,11,17,49,34.7,32,26,1,25,19,66,8,0,"MF,FW",20-24,Midfielder,France,Europe
236041,Alexis Blin,FRA,Lecce,Serie A,2022,25.0,1996.0,26.4,69,39,27,33,9,38,73,52.1,35,55,15,40,34,103,74,0,MF,25-29,Midfielder,France,Europe
412932,Myron Boadu,NED,Monaco,Ligue 1,2022,21.0,2001.0,3.3,3,3,0,2,1,1,7,14.3,6,1,0,1,0,3,1,0,FW,20-24,Forward,Netherlands,Europe
182574,Jean-Paul Botius,NED,Hertha BSC,Bundesliga,2022,28.0,1994.0,11.7,30,16,19,9,2,8,25,32.0,17,25,5,20,14,44,10,0,MF,25-29,Midfielder,Netherlands,Europe
412671,Quentin Boisgard,FRA,Lorient,Ligue 1,2022,25.0,1997.0,2.0,6,2,1,4,1,3,4,75.0,1,3,1,2,4,10,2,0,MF,25-29,Midfielder,France,Europe
142310,Willy Boly,CIV,Nott'ham Forest,Premier League,2022,31.0,1991.0,7.6,13,6,8,3,2,8,13,61.5,5,13,4,9,12,25,45,0,DF,30-34,Defender,Ivory Coast,Africa
57280,Giacomo Bonaventura,ITA,Fiorentina,Serie A,2022,32.0,1989.0,21.2,35,23,14,15,6,24,37,64.9,13,14,0,14,16,51,5,1,MF,30-34,Midfielder,Italy,Europe
241527,Federico Bonazzoli,ITA,Salernitana,Serie A,2022,25.0,1997.0,12.4,5,3,0,3,2,0,9,0.0,9,9,1,8,3,8,0,0,"FW,MF",25-29,Forward,Italy,Europe
557939,Neto Borges,BRA,Clermont Foot,Ligue 1,2022,25.0,1996.0,31.5,75,45,45,20,10,46,75,61.3,29,45,11,34,41,116,62,1,DF,25-29,Defender,Brazil,South America
338629,Sebastiaan Bornauw,BEL,Wolfsburg,Bundesliga,2022,23.0,1999.0,21.4,29,17,17,10,2,16,22,72.7,6,27,12,15,31,60,83,1,DF,20-24,Defender,Belgium,Europe
323831,Rafael Borr,COL,Eint Frankfurt,Bundesliga,2022,26.0,1995.0,12.0,25,15,4,13,8,4,17,23.5,13,10,2,8,2,27,9,0,"MF,FW",25-29,Midfielder,Colombia,South America
361093,Sven Botman,NED,Newcastle Utd,Premier League,2022,22.0,2000.0,34.7,38,24,31,7,0,22,28,78.6,6,44,24,20,34,72,126,2,DF,20-24,Defender,Netherlands,Europe
707242,Badredine Bouanani,ALG,Nice,Ligue 1,2022,17.0,2004.0,9.6,13,9,2,7,4,7,14,50.0,7,4,0,4,1,14,2,0,"FW,MF",Under 20,Forward,Algeria,Africa
560593,Hicham Boudaoui,ALG,Nice,Ligue 1,2022,22.0,1999.0,20.8,67,32,31,30,6,35,53,66.0,18,34,5,29,36,103,16,0,MF,20-24,Midfielder,Algeria,Africa
266359,Benjamin Bourigeaud,FRA,Rennes,Ligue 1,2022,28.0,1994.0,34.1,45,29,16,23,6,21,65,32.3,44,38,3,35,31,76,32,0,"MF,FW",25-29,Midfielder,France,Europe
562049,Edoardo Bove,ITA,Roma,Serie A,2022,20.0,2002.0,11.0,35,18,12,15,8,16,39,41.0,23,15,1,14,10,45,11,0,MF,20-24,Midfielder,Italy,Europe
314875,Jarrod Bowen,ENG,West Ham,Premier League,2022,25.0,1996.0,35.9,39,16,14,11,14,16,58,27.6,42,47,9,38,36,75,25,0,"FW,MF",25-29,Forward,England,Europe
334222,Lucas Boy,ARG,Elche,La Liga,2022,26.0,1996.0,27.4,36,16,12,16,8,17,35,48.6,18,33,5,28,15,51,46,0,FW,25-29,Forward,Argentina,South America
187492,Julian Brandt,GER,Dortmund,Bundesliga,2022,26.0,1996.0,26.6,29,20,6,14,9,12,43,27.9,31,23,0,23,15,44,9,1,"MF,FW",25-29,Midfielder,Germany,Europe
485960,Lilian Brassier,FRA,Brest,Ligue 1,2022,22.0,1999.0,34.4,42,30,31,8,3,23,32,71.9,9,42,19,23,53,95,132,1,DF,20-24,Defender,France,Europe
324223,James Bree,ENG,Southampton,Premier League,2022,24.0,1997.0,4.1,5,3,4,1,0,3,4,75.0,1,3,1,2,6,11,11,0,DF,20-24,Defender,England,Europe
571743,Armando Broja,ALB,Chelsea,Premier League,2022,20.0,2001.0,3.3,4,1,0,3,1,1,1,100.0,0,10,1,9,1,5,1,0,FW,20-24,Forward,Albania,Europe
450417,Dylan Bronn,TUN,Salernitana,Serie A,2022,27.0,1995.0,18.7,34,18,17,16,1,20,30,66.7,10,32,20,12,20,54,58,1,DF,25-29,Defender,Tunisia,Africa
277033,David Brooks,WAL,Bournemouth,Premier League,2022,25.0,1997.0,1.9,1,0,1,0,0,0,1,0.0,1,2,0,2,2,3,5,0,"FW,MF",25-29,Forward,Wales,Europe
406973,Moritz Broschinski,GER,Bochum,Bundesliga,2022,21.0,2000.0,2.4,0,0,0,0,0,0,5,0.0,5,1,0,1,0,0,6,0,"FW,MF",20-24,Forward,Germany,Europe
293281,Jacob Bruun Larsen,DEN,Hoffenheim,Bundesliga,2022,23.0,1998.0,3.6,4,3,0,1,3,3,4,75.0,1,3,1,2,1,5,0,0,FW,20-24,Forward,Denmark,Europe
532539,Lee Buchanan,ENG,Werder Bremen,Bundesliga,2022,21.0,2001.0,5.2,14,10,2,11,1,6,12,50.0,6,5,0,5,12,26,21,0,"DF,FW",20-24,Defender,England,Europe
46413,Ante Budimir,CRO,Osasuna,La Liga,2022,31.0,1991.0,20.0,19,9,0,12,7,2,10,20.0,8,10,0,10,5,24,19,0,FW,30-34,Forward,Croatia,Europe
438001,Santiago Bueno,URU,Girona,La Liga,2022,23.0,1998.0,33.4,63,38,43,19,1,24,36,66.7,12,34,22,12,31,94,105,2,DF,20-24,Defender,Uruguay,South America
187384,Cristian Buonaiuto,ITA,Cremonese,Serie A,2022,29.0,1992.0,10.9,25,16,8,11,6,12,26,46.2,14,11,0,11,14,39,7,0,"MF,FW",25-29,Midfielder,Italy,Europe
983989,Facundo Buonanotte,ARG,Brighton,Premier League,2022,17.0,2004.0,6.3,2,1,1,1,0,1,22,4.5,21,5,2,3,4,6,3,0,"FW,MF",Under 20,Forward,Argentina,South America
386446,Alessandro Buongiorno,ITA,Torino,Serie A,2022,23.0,1999.0,30.2,38,25,22,16,0,16,31,51.6,15,38,19,19,60,98,105,2,DF,20-24,Defender,Italy,Europe
436585,Delano Burgzorg,SUR,Mainz 05,Bundesliga,2022,23.0,1998.0,2.7,3,3,1,1,1,2,3,66.7,1,2,0,2,0,3,2,0,"FW,MF",20-24,Forward,Suriname,South America
333647,Jonathan Burkardt,GER,Mainz 05,Bundesliga,2022,22.0,2000.0,5.9,3,1,0,1,2,1,4,25.0,3,6,1,5,1,4,1,0,"MF,FW",20-24,Midfielder,Germany,Europe
134270,Dan Burn,ENG,Newcastle Utd,Premier League,2022,30.0,1992.0,34.6,60,38,29,23,8,34,67,50.7,33,42,16,26,32,92,120,2,DF,30-34,Defender,England,Europe
258039,Aurlio Buta,POR,Eint Frankfurt,Bundesliga,2022,25.0,1997.0,14.6,33,19,15,13,5,15,27,55.6,12,18,1,17,9,42,34,0,DF,25-29,Defender,Portugal,Europe
113707,Rmy Cabella,FRA,Lille,Ligue 1,2022,32.0,1990.0,28.1,64,37,21,28,15,29,64,45.3,35,41,5,36,17,81,7,1,"MF,FW",30-34,Midfielder,France,Europe
206912,Jimmy Cabot,FRA,Lens,Ligue 1,2022,28.0,1994.0,5.7,20,12,10,8,2,12,26,46.2,14,5,0,5,4,24,12,0,"DF,MF",25-29,Defender,France,Europe
102423,Leandro Cabrera,URU,Espanyol,La Liga,2022,31.0,1991.0,29.7,46,24,34,12,0,28,43,65.1,15,37,23,14,43,89,114,2,DF,30-34,Defender,Uruguay,South America
469211,Liberato Cacace,NZL,Empoli,Serie A,2022,21.0,2000.0,6.5,25,10,12,8,5,9,15,60.0,6,15,7,8,4,29,16,0,DF,20-24,Defender,New Zealand,Oceania
453016,Anthony Caci,FRA,Mainz 05,Bundesliga,2022,25.0,1997.0,22.6,58,33,32,20,6,28,42,66.7,14,28,4,24,54,112,40,0,DF,25-29,Defender,France,Europe
687626,Moiss Caicedo,ECU,Brighton,Premier League,2022,20.0,2001.0,34.9,100,50,41,47,12,40,68,58.8,28,43,7,36,56,156,31,3,MF,20-24,Midfielder,Ecuador,South America
123275,Tom Cairney,SCO,Fulham,Premier League,2022,31.0,1991.0,11.0,17,6,4,8,5,7,10,70.0,3,18,3,15,5,22,3,0,MF,30-34,Midfielder,Scotland,Europe
468066,Jens Cajuste,SWE,Reims,Ligue 1,2022,22.0,1999.0,17.0,46,25,25,14,7,25,48,52.1,23,30,6,24,18,64,22,0,MF,20-24,Midfielder,Sweden,Europe
262523,Davide Calabria,ITA,Milan,Serie A,2022,25.0,1996.0,18.8,71,44,31,32,8,38,61,62.3,23,22,7,15,25,96,34,0,DF,25-29,Defender,Italy,Europe
88680,Luca Caldirola,ITA,Monza,Serie A,2022,31.0,1991.0,26.1,26,14,19,4,3,13,26,50.0,13,32,18,14,25,51,66,1,DF,30-34,Defender,Italy,Europe
126414,Hakan alhanolu,TUR,Inter,Serie A,2022,28.0,1994.0,26.3,48,27,17,26,5,16,43,37.2,27,30,5,25,25,73,13,1,MF,25-29,Midfielder,Turkey,Asia
38410,Daniel Caligiuri,ITA,Augsburg,Bundesliga,2022,34.0,1988.0,3.2,8,5,5,3,0,4,5,80.0,1,3,2,1,3,11,2,0,"DF,MF",30-34,Defender,Italy,Europe
306024,Dominic Calvert-Lewin,ENG,Everton,Premier League,2022,25.0,1997.0,12.9,4,2,1,0,3,1,5,20.0,4,5,1,4,3,7,18,0,FW,25-29,Forward,England,Europe
543382,Mohamed Camara,GUI,Roma,Serie A,2022,25.0,1997.0,7.7,13,10,3,7,3,5,15,33.3,10,5,1,4,10,23,8,0,MF,25-29,Midfielder,Guinea,Africa
640428,Eduardo Camavinga,FRA,Real Madrid,La Liga,2022,19.0,2002.0,22.3,68,48,32,21,15,24,64,37.5,40,24,5,19,17,85,25,0,"MF,DF",Under 20,Midfielder,France,Europe
459151,Nicol Cambiaghi,ITA,Empoli,Serie A,2022,21.0,2000.0,14.3,30,22,11,12,7,8,27,29.6,19,19,1,18,9,39,8,0,"FW,MF",20-24,Forward,Italy,Europe
459658,Andrea Cambiaso,ITA,Bologna,Serie A,2022,22.0,2000.0,24.1,57,34,34,20,3,28,65,43.1,37,26,2,24,26,83,33,1,DF,20-24,Defender,Italy,Europe
924800,Axel Camblan,FRA,Brest,Ligue 1,2022,18.0,2003.0,0.8,2,2,1,1,0,0,1,0.0,1,0,0,0,0,2,0,0,"FW,MF",Under 20,Forward,France,Europe
119296,Emre Can,GER,Dortmund,Bundesliga,2022,28.0,1994.0,21.1,57,28,25,27,5,22,43,51.2,21,16,6,10,25,82,39,1,MF,25-29,Midfielder,Germany,Europe
182712,Joo Cancelo,POR,Manchester City,Premier League,2022,28.0,1994.0,14.2,29,21,16,9,4,17,24,70.8,7,7,1,6,19,48,9,1,DF,25-29,Defender,Portugal,Europe
25488,Antonio Candreva,ITA,Salernitana,Serie A,2022,35.0,1987.0,30.3,17,7,13,2,2,11,38,28.9,27,7,3,4,17,34,32,0,"MF,DF",35-39,Midfielder,Italy,Europe
214532,Pierrick Capelle,FRA,Angers,Ligue 1,2022,35.0,1987.0,15.9,36,21,17,15,4,22,55,40.0,33,24,3,21,15,51,24,0,"MF,DF",35-39,Midfielder,France,Europe
63494,tienne Capoue,FRA,Villarreal,La Liga,2022,34.0,1988.0,21.7,21,12,6,13,2,10,18,55.6,8,12,5,7,19,40,20,1,MF,30-34,Midfielder,France,Europe
146752,Gianluca Caprari,ITA,Monza,Serie A,2022,29.0,1993.0,27.1,16,6,3,11,2,8,26,30.8,18,22,1,21,8,24,3,0,"MF,FW",25-29,Midfielder,Italy,Europe
84765,Francesco Caputo,ITA,Sampdoria,Serie A,2022,34.0,1987.0,12.2,3,1,0,0,3,0,3,0.0,3,0,0,0,1,4,3,0,FW,30-34,Forward,Italy,Europe
481834,Andrea Carboni,ITA,Monza,Serie A,2022,21.0,2001.0,1.9,3,2,2,0,1,2,5,40.0,3,3,2,1,3,6,2,1,DF,20-24,Defender,Italy,Europe
342226,Irvin Cardona,FRA,Brest,Ligue 1,2022,24.0,1997.0,2.6,2,0,1,1,0,0,3,0.0,3,3,0,3,2,4,2,0,"FW,MF",20-24,Forward,France,Europe
140776,Yannick Carrasco,BEL,Atltico Madrid,La Liga,2022,28.0,1993.0,25.7,35,14,21,10,4,23,54,42.6,31,23,1,22,12,47,19,0,"DF,MF",25-29,Defender,Belgium,Europe
100131,William Carvalho,POR,Betis,La Liga,2022,30.0,1992.0,27.1,43,27,18,23,2,17,44,38.6,27,27,6,21,16,59,22,0,MF,30-34,Midfielder,Portugal,Europe
389837,Nicol Casale,ITA,Lazio,Serie A,2022,24.0,1998.0,27.1,42,20,28,14,0,22,34,64.7,12,25,17,8,17,59,73,1,DF,20-24,Defender,Italy,Europe
262226,Timothy Castagne,BEL,Leicester City,Premier League,2022,26.0,1995.0,36.2,87,44,53,27,7,41,84,48.8,43,50,13,37,43,130,110,0,DF,25-29,Defender,Belgium,Europe
182875,Jean-Charles Castelletto,CMR,Nantes,Ligue 1,2022,27.0,1995.0,28.5,43,26,29,12,2,22,36,61.1,14,35,22,13,58,101,90,0,DF,25-29,Defender,Cameroon,Africa
303116,Gaetano Castrovilli,ITA,Fiorentina,Serie A,2022,25.0,1997.0,8.0,10,8,1,7,2,2,9,22.2,7,5,1,4,8,18,5,0,MF,25-29,Midfielder,Italy,Europe
199733,Danilo Cataldi,ITA,Lazio,Serie A,2022,27.0,1994.0,21.3,25,16,7,15,3,14,40,35.0,26,23,9,14,24,49,33,0,MF,25-29,Midfielder,Italy,Europe
48280,Edinson Cavani,URU,Valencia,La Liga,2022,35.0,1987.0,16.1,7,4,3,3,1,3,15,20.0,12,10,3,7,2,9,11,0,FW,35-39,Forward,Uruguay,South America
388382,Assan Ceesay,GAM,Lecce,Serie A,2022,28.0,1994.0,20.1,23,18,7,8,8,9,17,52.9,8,15,2,13,3,26,24,0,FW,25-29,Forward,Gambia,Africa
251075,Zeki elik,TUR,Roma,Serie A,2022,25.0,1997.0,16.7,42,21,19,21,2,24,41,58.5,17,33,6,27,14,56,36,2,DF,25-29,Defender,Turkey,Asia
341110,Franco Cervi,ARG,Celta Vigo,La Liga,2022,28.0,1994.0,21.0,76,46,29,36,11,33,66,50.0,33,33,1,32,36,112,16,0,"MF,DF",25-29,Midfielder,Argentina,South America
418662,Florian Chabrolle,FRA,Ajaccio,Ligue 1,2022,24.0,1998.0,3.7,6,4,1,5,0,2,4,50.0,2,3,0,3,7,13,2,0,MF,20-24,Midfielder,France,Europe
346314,Trevoh Chalobah,ENG,Chelsea,Premier League,2022,23.0,1999.0,17.9,31,20,22,6,3,24,35,68.6,11,17,7,10,24,55,56,1,DF,20-24,Defender,England,Europe
93678,Gatan Charbonnier,FRA,Auxerre,Ligue 1,2022,33.0,1988.0,2.8,2,1,0,2,0,0,4,0.0,4,2,0,2,0,2,5,0,"FW,MF",30-34,Forward,France,Europe
250779,Brendan Chardonnet,FRA,Brest,Ligue 1,2022,27.0,1994.0,27.7,45,27,27,18,0,20,38,52.6,18,40,19,21,63,108,86,1,DF,25-29,Defender,France,Europe
118278,Xavier Chavalerin,FRA,Troyes,Ligue 1,2022,31.0,1991.0,27.0,82,50,39,30,13,27,71,38.0,44,31,8,23,41,123,24,0,MF,30-34,Midfielder,France,Europe
341092,Federico Chiesa,ITA,Juventus,Serie A,2022,24.0,1997.0,9.5,22,11,6,6,10,5,14,35.7,9,13,1,12,0,22,1,0,"DF,MF",20-24,Defender,Italy,Europe
316125,Ben Chilwell,ENG,Chelsea,Premier League,2022,25.0,1996.0,15.6,21,17,12,8,1,13,25,52.0,12,21,2,19,18,39,26,0,"DF,MF",25-29,Defender,England,Europe
624037,Joris Chotard,FRA,Montpellier,Ligue 1,2022,20.0,2001.0,27.3,64,34,37,23,4,40,78,51.3,38,40,11,29,40,104,42,1,MF,20-24,Midfielder,France,Europe
196948,Andreas Christensen,DEN,Barcelona,La Liga,2022,26.0,1996.0,19.6,20,15,9,11,0,10,16,62.5,6,14,12,2,21,41,47,0,DF,25-29,Defender,Denmark,Europe
188077,Ryan Christie,SCO,Bournemouth,Premier League,2022,27.0,1995.0,20.4,34,22,10,23,1,14,50,28.0,36,16,4,12,26,60,20,0,"MF,FW",25-29,Midfielder,Scotland,Europe
659459,Carney Chukwuemeka,ENG,Chelsea,Premier League,2022,18.0,2003.0,3.9,13,7,7,6,0,3,5,60.0,2,7,0,7,6,19,1,0,"MF,FW",Under 20,Midfielder,England,Europe
401922,Samuel Chukwueze,NGA,Villarreal,La Liga,2022,23.0,1999.0,26.0,14,7,7,2,5,7,23,30.4,16,13,0,13,12,26,16,0,"FW,MF",20-24,Forward,Nigeria,Africa
801754,Yanis Cimignani,FRA,Ajaccio,Ligue 1,2022,20.0,2002.0,3.1,11,5,3,7,1,4,5,80.0,1,5,1,4,2,13,2,0,"MF,DF",20-24,Midfielder,France,Europe
29605,Daniel Ciofani,ITA,Cremonese,Serie A,2022,37.0,1985.0,11.8,6,3,1,2,3,4,7,57.1,3,7,1,6,2,8,10,0,FW,35-39,Forward,Italy,Europe
525578,Path Ciss,SEN,Rayo Vallecano,La Liga,2022,28.0,1994.0,14.2,39,29,11,23,5,15,34,44.1,19,23,10,13,22,61,34,0,"MF,DF",25-29,Midfielder,Senegal,Africa
255838,Patrick Ciurria,ITA,Monza,Serie A,2022,27.0,1995.0,30.6,31,18,20,10,1,17,33,51.5,16,24,2,22,7,38,32,0,"DF,MF",25-29,Defender,Italy,Europe
175639,Jonathan Clauss,FRA,Marseille,Ligue 1,2022,29.0,1992.0,28.8,46,28,21,16,9,23,52,44.2,29,29,4,25,31,77,40,2,DF,25-29,Defender,France,Europe
128901,Conor Coady,ENG,Everton,Premier League,2022,29.0,1993.0,23.3,14,9,8,6,0,7,15,46.7,8,21,17,4,14,28,88,3,DF,25-29,Defender,England,Europe
68390,Samus Coleman,IRL,Everton,Premier League,2022,33.0,1988.0,18.4,35,26,21,10,4,19,29,65.5,10,14,7,7,22,57,58,2,DF,30-34,Defender,Republic of Ireland,Europe
487843,Lorenzo Colombo,ITA,Lecce,Serie A,2022,20.0,2002.0,16.8,17,9,1,9,7,6,14,42.9,8,22,0,22,2,19,7,0,FW,20-24,Forward,Italy,Europe
392959,Andrea Colpani,ITA,Monza,Serie A,2022,23.0,1999.0,10.5,14,9,6,5,3,8,12,66.7,4,14,2,12,3,17,6,0,MF,20-24,Midfielder,Italy,Europe
243714,Kingsley Coman,FRA,Bayern Munich,Bundesliga,2022,26.0,1996.0,15.7,11,8,3,5,3,7,17,41.2,10,19,1,18,2,13,7,0,"FW,MF",25-29,Forward,France,Europe
298583,Eray Cmert,SUI,Valencia,La Liga,2022,24.0,1998.0,18.6,35,23,24,10,1,17,33,51.5,16,23,8,15,29,64,76,1,DF,20-24,Defender,Switzerland,Europe
337798,Abdu Cont,POR,Troyes,Ligue 1,2022,24.0,1998.0,14.6,25,17,14,8,3,12,22,54.5,10,13,6,7,6,31,25,0,DF,20-24,Defender,Portugal,Europe
75067,Liam Cooper,SCO,Leeds United,Premier League,2022,30.0,1991.0,15.8,38,23,27,9,2,23,36,63.9,13,16,8,8,34,72,57,3,DF,30-34,Defender,Scotland,Europe
74869,Francis Coquelin,FRA,Villarreal,La Liga,2022,31.0,1991.0,8.3,18,13,7,9,2,7,7,100.0,0,8,2,6,9,27,7,0,MF,30-34,Midfielder,France,Europe
102744,Sbastien Corchia,FRA,Nantes,Ligue 1,2022,31.0,1990.0,8.7,16,6,10,2,4,11,22,50.0,11,9,3,6,14,30,21,0,DF,30-34,Defender,France,Europe
125165,Jess Corona,MEX,Sevilla,La Liga,2022,29.0,1993.0,1.2,1,0,1,0,0,0,1,0.0,1,0,0,0,1,2,1,0,FW,25-29,Forward,Mexico,North America
266807,ngel Correa,ARG,Atltico Madrid,La Liga,2022,27.0,1995.0,16.2,12,6,6,3,3,5,16,31.3,11,17,0,17,10,22,6,1,"FW,MF",25-29,Forward,Argentina,South America
227081,Joaqun Correa,ARG,Inter,Serie A,2022,27.0,1994.0,10.6,12,7,3,6,3,4,15,26.7,11,4,1,3,3,15,0,0,FW,25-29,Forward,Argentina,South America
85906,Danny da Costa,GER,Mainz 05,Bundesliga,2022,29.0,1993.0,13.7,20,16,7,8,5,12,20,60.0,8,22,3,19,9,29,26,0,DF,25-29,Defender,Germany,Europe
484988,Logan Costa,CPV,Toulouse,Ligue 1,2022,21.0,2001.0,4.6,9,4,7,1,1,6,9,66.7,3,6,3,3,4,13,12,0,DF,20-24,Defender,Cape Verde,Africa
386552,Lassana Coulibaly,MLI,Salernitana,Serie A,2022,26.0,1996.0,32.1,84,50,42,35,7,30,73,41.1,43,35,7,28,25,109,33,2,MF,25-29,Midfielder,Mali,Africa
618425,Tanguy Coulibaly,FRA,Stuttgart,Bundesliga,2022,21.0,2001.0,3.6,12,9,9,1,2,5,12,41.7,7,10,0,10,3,15,0,0,"FW,DF",20-24,Forward,France,Europe
80444,Philippe Coutinho,BRA,Aston Villa,Premier League,2022,30.0,1992.0,8.8,19,14,8,8,3,9,15,60.0,6,11,1,10,4,23,2,0,"MF,FW",30-34,Midfielder,Brazil,South America
627228,Yan Couto,BRA,Girona,La Liga,2022,20.0,2002.0,12.9,25,18,11,11,3,12,20,60.0,8,7,2,5,5,30,10,0,"DF,MF",20-24,Defender,Brazil,South America
199248,Bryan Cristante,ITA,Roma,Serie A,2022,27.0,1995.0,32.6,113,62,55,49,9,55,90,61.1,35,39,10,29,18,131,53,0,"MF,DF",25-29,Midfielder,Italy,Europe
91970,Juan Cuadrado,COL,Juventus,Serie A,2022,34.0,1988.0,23.1,50,34,34,13,3,27,65,41.5,38,15,2,13,24,74,32,0,"DF,FW",30-34,Defender,Colombia,South America
55769,Danilo D'Ambrosio,ITA,Inter,Serie A,2022,33.0,1988.0,8.1,25,17,17,7,1,15,27,55.6,12,12,4,8,10,35,17,0,DF,30-34,Defender,Italy,Europe
725242,Luca D'Andrea,ITA,Sassuolo,Serie A,2022,17.0,2004.0,3.5,4,0,2,1,1,1,4,25.0,3,2,0,2,1,5,1,0,FW,Under 20,Forward,Italy,Europe
365172,Patson Daka,ZAM,Leicester City,Premier League,2022,23.0,1998.0,13.2,14,8,6,8,0,3,13,23.1,10,14,2,12,7,21,7,0,FW,20-24,Forward,Zambia,Africa
538964,Thijs Dallinga,NED,Toulouse,Ligue 1,2022,21.0,2000.0,26.1,8,6,2,2,4,1,13,7.7,12,17,3,14,3,11,20,0,FW,20-24,Forward,Netherlands,Europe
357147,Diogo Dalot,POR,Manchester Utd,Premier League,2022,23.0,1999.0,23.9,54,41,40,13,1,33,45,73.3,12,25,7,18,37,91,55,2,DF,20-24,Defender,Portugal,Europe
808509,Danilo,BRA,Nott'ham Forest,Premier League,2022,21.0,2001.0,10.8,18,7,7,9,2,6,25,24.0,19,26,6,20,9,27,19,0,MF,20-24,Midfielder,Brazil,South America
263236,Kevin Danso,AUT,Lens,Ligue 1,2022,23.0,1998.0,35.9,37,19,25,11,1,19,30,63.3,11,48,34,14,33,70,124,0,DF,20-24,Defender,Austria,Europe
16136,Dante,BRA,Nice,Ligue 1,2022,38.0,1983.0,36.7,70,40,45,21,4,36,59,61.0,23,52,31,21,47,117,125,2,DF,35-39,Defender,Brazil,South America
432281,Mrton Drdai,HUN,Hertha BSC,Bundesliga,2022,20.0,2002.0,10.5,17,8,9,8,0,9,18,50.0,9,14,9,5,11,28,45,1,"DF,MF",20-24,Defender,Hungary,Europe
566823,Achraf Dari,MAR,Brest,Ligue 1,2022,23.0,1999.0,14.6,21,14,15,5,1,14,20,70.0,6,16,10,6,19,40,65,2,DF,20-24,Defender,Morocco,Africa
340321,Josh Dasilva,ENG,Brentford,Premier League,2022,23.0,1998.0,15.4,18,9,6,6,6,6,15,40.0,9,22,6,16,5,23,7,1,MF,20-24,Midfielder,England,Europe
533738,Jonathan David,CAN,Lille,Ligue 1,2022,22.0,2000.0,35.2,24,17,6,11,7,10,27,37.0,17,20,2,18,8,32,13,0,FW,20-24,Forward,Canada,North America
424204,Alphonso Davies,CAN,Bayern Munich,Bundesliga,2022,21.0,2000.0,22.7,45,28,25,13,7,18,39,46.2,21,28,4,24,24,69,24,4,DF,20-24,Defender,Canada,North America
257097,Ben Davies,WAL,Tottenham,Premier League,2022,29.0,1993.0,25.4,28,11,13,13,2,14,26,53.8,12,17,8,9,18,46,72,0,DF,25-29,Defender,Wales,Europe
854853,Tom Davies,ENG,Everton,Premier League,2022,24.0,1998.0,6.0,15,9,5,9,1,7,14,50.0,7,10,1,9,4,19,7,1,MF,20-24,Midfielder,England,Europe
121477,Craig Dawson,ENG,West Ham,Premier League,2022,32.0,1990.0,8.0,11,7,9,2,0,5,7,71.4,2,9,6,3,6,17,26,0,DF,30-34,Defender,England,Europe
88755,Kevin De Bruyne,BEL,Manchester City,Premier League,2022,31.0,1991.0,26.9,28,12,3,12,13,14,39,35.9,25,27,2,25,9,37,10,0,MF,30-34,Midfielder,Belgium,Europe
435772,Charles De Ketelaere,BEL,Milan,Serie A,2022,21.0,2001.0,12.4,26,12,7,14,5,13,30,43.3,17,14,2,12,4,30,9,0,"MF,FW",20-24,Midfielder,Belgium,Europe
33571,Lorenzo De Silvestri,ITA,Bologna,Serie A,2022,34.0,1988.0,7.5,3,2,2,0,1,3,7,42.9,4,6,5,1,3,6,20,0,DF,30-34,Defender,Italy,Europe
353399,Romain Del Castillo,FRA,Brest,Ligue 1,2022,26.0,1996.0,15.8,39,24,13,17,9,16,36,44.4,20,14,1,13,11,50,5,0,"MF,FW",25-29,Midfielder,France,Europe
170961,Thomas Delaine,FRA,Strasbourg,Ligue 1,2022,30.0,1992.0,11.9,28,14,16,6,6,13,26,50.0,13,8,3,5,16,44,9,0,"DF,MF",30-34,Defender,France,Europe
122797,Andy Delort,ALG,Nice,Ligue 1,2022,30.0,1991.0,8.7,2,0,1,1,0,1,2,50.0,1,0,0,0,1,3,7,0,FW,30-34,Forward,Algeria,Africa
466602,Karamoko Dembl,ENG,Brest,Ligue 1,2022,19.0,2003.0,2.0,2,0,1,1,0,2,2,100.0,0,1,0,1,1,3,0,0,"FW,MF",Under 20,Forward,England,Europe
229004,Moussa Dembl,FRA,Lyon,Ligue 1,2022,26.0,1996.0,9.7,8,4,3,3,2,4,7,57.1,3,5,0,5,2,10,6,0,"FW,MF",25-29,Forward,France,Europe
288230,Ousmane Dembl,FRA,Barcelona,La Liga,2022,25.0,1997.0,15.7,19,12,4,8,7,4,15,26.7,11,10,1,9,0,19,2,0,FW,25-29,Forward,France,Europe
488656,Siriki Dembl,CIV,Bournemouth,Premier League,2022,25.0,1996.0,1.2,3,1,2,1,0,0,1,0.0,1,1,0,1,1,4,1,0,"FW,MF",25-29,Forward,Ivory Coast,Africa
541231,Sepp van den Berg,NED,Schalke 04,Bundesliga,2022,20.0,2001.0,7.7,5,4,2,2,1,1,4,25.0,3,8,5,3,13,18,33,2,DF,20-24,Defender,Netherlands,Europe
448854,Emmanuel Dennis,NGA,Nott'ham Forest,Premier League,2022,24.0,1997.0,8.0,17,11,5,5,7,8,18,44.4,10,13,1,12,2,19,6,0,"FW,MF",20-24,Forward,Nigeria,Africa
475188,Kiernan Dewsbury-Hall,ENG,Leicester City,Premier League,2022,23.0,1998.0,25.6,53,29,14,34,5,19,47,40.4,28,55,13,42,28,81,21,0,MF,20-24,Midfielder,England,Europe
38607,Federico Di Francesco,ITA,Lecce,Serie A,2022,28.0,1994.0,22.6,28,16,7,11,10,9,19,47.4,10,16,0,16,8,36,14,0,"FW,MF",25-29,Forward,Italy,Europe
169880,Giovanni Di Lorenzo,ITA,Napoli,Serie A,2022,28.0,1993.0,36.2,60,29,33,19,8,25,49,51.0,24,30,9,21,30,90,60,0,DF,25-29,Defender,Italy,Europe
626913,Boulaye Dia,SEN,Salernitana,Serie A,2022,25.0,1996.0,28.0,12,5,3,6,3,2,7,28.6,5,10,0,10,7,19,27,1,"FW,MF",25-29,Forward,Senegal,Africa
395516,Moussa Diaby,FRA,Leverkusen,Bundesliga,2022,23.0,1999.0,30.0,14,8,4,8,2,7,14,50.0,7,8,0,8,5,19,3,0,"FW,MF",20-24,Forward,France,Europe
346289,Mouctar Diakhaby,GUI,Valencia,La Liga,2022,25.0,1996.0,27.2,30,16,19,11,0,13,20,65.0,7,30,17,13,20,50,111,2,DF,25-29,Defender,Guinea,Africa
463605,Bafod Diakit,FRA,Lille,Ligue 1,2022,21.0,2001.0,29.5,54,35,23,24,7,32,57,56.1,25,37,8,29,17,71,58,0,DF,20-24,Defender,France,Europe
229005,Abdou Diallo,SEN,RB Leipzig,Bundesliga,2022,26.0,1996.0,5.3,6,5,5,1,0,1,3,33.3,2,8,5,3,8,14,22,0,"DF,MF",25-29,Defender,Senegal,Africa
344888,Habib Diallo,SEN,Strasbourg,Ligue 1,2022,27.0,1995.0,32.0,18,10,8,7,3,6,16,37.5,10,19,4,15,12,30,26,0,FW,25-29,Forward,Senegal,Africa
876631,Habib Diarra,SEN,Strasbourg,Ligue 1,2022,18.0,2004.0,18.1,24,16,10,11,3,15,29,51.7,14,17,1,16,11,35,13,0,"MF,FW",Under 20,Midfielder,Senegal,Africa
428954,Stphane Diarra,FRA,Lorient,Ligue 1,2022,23.0,1998.0,11.8,25,17,14,9,2,11,29,37.9,18,13,1,12,22,47,9,0,"FW,MF",20-24,Forward,France,Europe
258004,Rben Dias,POR,Manchester City,Premier League,2022,25.0,1997.0,22.2,21,13,10,10,1,11,18,61.1,7,21,13,8,18,39,56,1,DF,25-29,Defender,Portugal,Europe
490426,Krpin Diatta,SEN,Monaco,Ligue 1,2022,23.0,1999.0,23.0,30,21,4,17,9,13,32,40.6,19,29,1,28,17,47,12,0,"MF,FW",20-24,Midfielder,Senegal,Africa
314678,Brahim Daz,MAR,Milan,Serie A,2022,22.0,1999.0,21.4,32,15,5,22,5,5,15,33.3,10,11,0,11,7,39,6,0,"MF,FW",20-24,Midfielder,Morocco,Africa
480692,Luis Daz,COL,Liverpool,Premier League,2022,25.0,1997.0,11.1,17,11,4,8,5,8,15,53.3,7,8,0,8,6,23,2,0,FW,25-29,Forward,Colombia,South America
822458,Bamba Dieng,SEN,Marseille,Ligue 1,2022,22.0,2000.0,2.2,4,4,2,1,1,3,4,75.0,1,5,1,4,0,4,0,0,"FW,MF",20-24,Forward,Senegal,Africa
175722,Eric Dier,ENG,Tottenham,Premier League,2022,28.0,1994.0,31.3,30,19,16,12,2,9,19,47.4,10,41,24,17,35,65,112,2,DF,25-29,Defender,England,Europe
283871,Florian Dietz,GER,Kln,Bundesliga,2022,23.0,1998.0,4.4,2,1,0,2,0,1,4,25.0,3,4,1,3,0,2,2,0,FW,20-24,Forward,Germany,Europe
126664,Lucas Digne,FRA,Aston Villa,Premier League,2022,29.0,1993.0,16.7,30,12,20,9,1,20,33,60.6,13,18,5,13,18,48,45,0,DF,25-29,Defender,France,Europe
198116,Federico Dimarco,ITA,Inter,Serie A,2022,24.0,1997.0,23.0,31,25,6,18,7,9,19,47.4,10,15,4,11,18,49,20,0,DF,20-24,Defender,Italy,Europe
536482,Junior Dina Ebimbe,FRA,Eint Frankfurt,Bundesliga,2022,21.0,2000.0,11.8,30,19,16,14,0,16,33,48.5,17,18,5,13,11,41,20,0,"DF,MF",20-24,Defender,France,Europe
126683,Tristan Dingom,CMR,Troyes,Ligue 1,2022,31.0,1991.0,1.1,1,1,0,1,0,0,2,0.0,2,0,0,0,0,1,0,0,MF,30-34,Midfielder,Cameroon,Africa
272622,Issa Diop,FRA,Fulham,Premier League,2022,25.0,1997.0,22.4,28,19,18,9,1,17,32,53.1,15,24,17,7,35,63,86,0,DF,25-29,Defender,France,Europe
386047,Axel Disasi,FRA,Monaco,Ligue 1,2022,24.0,1998.0,37.0,30,20,13,13,4,13,27,48.1,14,51,31,20,56,86,112,2,DF,20-24,Defender,France,Europe
183031,Koffi Djidji,CIV,Torino,Serie A,2022,29.0,1992.0,26.9,50,25,32,17,1,18,32,56.3,14,29,14,15,34,84,72,0,DF,25-29,Defender,Ivory Coast,Africa
401529,Dod,BRA,Fiorentina,Serie A,2022,23.0,1998.0,25.9,40,22,20,14,6,22,46,47.8,24,26,2,24,25,65,37,0,DF,20-24,Defender,Brazil,South America
387047,Danilho Doekhi,NED,Union Berlin,Bundesliga,2022,24.0,1998.0,24.6,38,23,21,17,0,14,26,53.8,12,27,12,15,29,67,93,0,DF,20-24,Defender,Netherlands,Europe
567129,Josh Doig,SCO,Hellas Verona,Serie A,2022,20.0,2002.0,15.0,19,8,6,7,6,6,16,37.5,10,25,6,19,11,30,13,1,DF,20-24,Defender,Scotland,Europe
497291,Nicols Domnguez,ARG,Bologna,Serie A,2022,24.0,1998.0,25.6,79,49,34,33,12,39,76,51.3,37,29,3,26,21,100,29,1,MF,20-24,Midfielder,Argentina,South America
88684,Giulio Donati,ITA,Monza,Serie A,2022,32.0,1990.0,4.7,4,1,1,1,2,3,6,50.0,3,3,1,2,4,8,11,0,DF,30-34,Defender,Italy,Europe
221151,Jodel Dossou,BEN,Clermont Foot,Ligue 1,2022,30.0,1992.0,2.9,7,4,3,2,2,4,4,100.0,0,2,1,1,1,8,0,0,"MF,DF",30-34,Midfielder,Benin,Africa
830265,Lohann Doucet,FRA,Nantes,Ligue 1,2022,19.0,2002.0,1.0,3,0,2,0,1,3,4,75.0,1,2,0,2,2,5,4,0,"MF,FW",Under 20,Midfielder,France,Europe
127187,Abdoulaye Doucour,MLI,Everton,Premier League,2022,29.0,1993.0,17.0,31,20,9,15,7,12,37,32.4,25,26,3,23,13,44,11,0,MF,25-29,Midfielder,Mali,Africa
543387,Cheick Doucour,MLI,Crystal Palace,Premier League,2022,22.0,2000.0,30.8,77,46,40,33,4,29,52,55.8,23,47,13,34,56,133,48,0,MF,20-24,Midfielder,Mali,Africa
914562,Dsir Dou,FRA,Rennes,Ligue 1,2022,17.0,2005.0,12.4,37,18,10,23,4,13,32,40.6,19,17,1,16,13,50,3,0,"MF,FW",Under 20,Midfielder,France,Europe
786436,Ismal Doukour,FRA,Strasbourg,Ligue 1,2022,19.0,2003.0,25.5,48,24,23,21,4,20,34,58.8,14,26,8,18,27,75,54,0,"DF,MF",Under 20,Defender,France,Europe
671594,Kamory Doumbia,MLI,Reims,Ligue 1,2022,19.0,2003.0,12.8,31,16,9,14,8,12,37,32.4,25,17,1,16,13,44,3,0,MF,Under 20,Midfielder,Mali,Africa
506189,Flynn Downes,ENG,West Ham,Premier League,2022,23.0,1999.0,8.5,16,9,4,10,2,6,12,50.0,6,15,2,13,7,23,6,0,MF,20-24,Midfielder,England,Europe
53400,Dominick Drexler,GER,Schalke 04,Bundesliga,2022,32.0,1990.0,15.2,25,17,12,10,3,9,22,40.9,13,18,2,16,8,33,12,0,"MF,FW",30-34,Midfielder,Germany,Europe
257376,Domingos Duarte,POR,Getafe,La Liga,2022,27.0,1995.0,29.5,26,18,21,5,0,19,26,73.1,7,29,23,6,39,65,145,0,DF,25-29,Defender,Portugal,Europe
232418,Ondrej Duda,SVK,Hellas Verona,Serie A,2022,27.0,1994.0,11.8,22,14,7,12,3,9,16,56.3,7,11,0,11,13,35,8,0,MF,25-29,Midfielder,Slovakia,Europe
174304,Rmy Dugimont,FRA,Auxerre,Ligue 1,2022,36.0,1986.0,1.3,2,1,0,1,1,1,2,50.0,1,3,0,3,0,2,5,0,"FW,MF",35-39,Forward,France,Europe
321528,Denzel Dumfries,NED,Inter,Serie A,2022,26.0,1996.0,24.6,35,18,17,13,5,22,34,64.7,12,33,9,24,12,47,26,0,DF,25-29,Defender,Netherlands,Europe
184894,Alfred Duncan,GHA,Fiorentina,Serie A,2022,29.0,1993.0,12.3,18,10,0,17,1,10,21,47.6,11,9,0,9,8,26,6,0,MF,25-29,Midfielder,Ghana,Africa
148153,Lewis Dunk,ENG,Brighton,Premier League,2022,30.0,1991.0,36.0,30,19,19,9,2,18,41,43.9,23,37,27,10,34,64,81,1,DF,30-34,Defender,England,Europe
649317,Jhon Durn,COL,Aston Villa,Premier League,2022,18.0,2003.0,1.5,2,2,0,1,1,1,4,25.0,3,0,0,0,2,4,2,0,"FW,MF",Under 20,Forward,Colombia,South America
206050,Paulo Dybala,ARG,Roma,Serie A,2022,28.0,1993.0,19.3,14,4,1,8,5,8,26,30.8,18,12,1,11,8,22,4,0,"MF,FW",25-29,Midfielder,Argentina,South America
309944,Tyronne Ebuehi,NGA,Empoli,Serie A,2022,26.0,1995.0,21.4,22,14,11,7,4,9,13,69.2,4,23,12,11,12,34,79,1,DF,25-29,Defender,Nigeria,Africa
607854,derson,BRA,Atalanta,Serie A,2022,23.0,1999.0,24.6,67,34,18,42,7,29,66,43.9,37,56,7,49,36,103,31,0,MF,20-24,Midfielder,Brazil,South America
500067,Chidera Ejuke,NGA,Hertha BSC,Bundesliga,2022,24.0,1998.0,9.9,5,4,1,4,0,1,5,20.0,4,4,0,4,4,9,1,0,"FW,MF",20-24,Forward,Nigeria,Africa
49275,Albin Ekdal,SWE,Spezia,Serie A,2022,33.0,1989.0,19.3,37,20,14,20,3,19,45,42.2,26,24,2,22,26,63,36,0,MF,30-34,Midfielder,Sweden,Europe
583189,Anthony Elanga,SWE,Manchester Utd,Premier League,2022,20.0,2002.0,4.7,3,0,0,2,1,1,2,50.0,1,4,0,4,2,5,4,0,FW,20-24,Forward,Sweden,Europe
565822,Harvey Elliott,ENG,Liverpool,Premier League,2022,19.0,2003.0,17.9,27,18,6,12,9,9,37,24.3,28,26,1,25,15,42,8,0,"MF,FW",Under 20,Midfielder,England,Europe
192635,Nico Elvedi,SUI,Gladbach,Bundesliga,2022,25.0,1996.0,31.4,46,24,32,12,2,27,41,65.9,14,31,16,15,35,81,149,3,DF,25-29,Defender,Switzerland,Europe
176140,Rodrigo Ely,BRA,Almera,La Liga,2022,28.0,1993.0,35.1,30,21,26,4,0,18,25,72.0,7,46,33,13,31,61,203,1,DF,25-29,Defender,Brazil,South America
237662,Breel Embolo,SUI,Monaco,Ligue 1,2022,25.0,1997.0,20.7,15,9,2,7,6,5,10,50.0,5,14,3,11,5,20,12,0,FW,25-29,Forward,Switzerland,Europe
181778,Emerson,BRA,Tottenham,Premier League,2022,23.0,1999.0,19.3,54,33,38,12,4,27,40,67.5,13,17,3,14,18,72,75,0,DF,20-24,Defender,Brazil,South America
660867,Julio Enciso,PAR,Brighton,Premier League,2022,18.0,2004.0,9.0,13,4,3,6,4,8,13,61.5,5,9,0,9,4,17,2,0,"FW,MF",Under 20,Forward,Paraguay,South America
146310,Wataru Endo,JPN,Stuttgart,Bundesliga,2022,29.0,1993.0,32.5,70,37,30,31,9,38,85,44.7,47,44,6,38,26,96,63,0,MF,25-29,Midfielder,Japan,Asia
69633,Christian Eriksen,DEN,Manchester Utd,Premier League,2022,30.0,1992.0,22.8,22,18,10,7,5,10,33,30.3,23,23,9,14,11,33,20,1,MF,30-34,Midfielder,Denmark,Europe
266795,Gonzalo Escalante,ARG,Cremonese,Serie A,2022,29.0,1993.0,6.2,16,8,8,8,0,10,13,76.9,3,7,1,6,10,26,4,0,MF,25-29,Midfielder,Argentina,South America
311044,Alfonso Espino,URU,Cdiz,La Liga,2022,30.0,1992.0,34.7,87,56,55,20,12,48,96,50.0,48,52,11,41,48,135,99,3,DF,30-34,Defender,Uruguay,South America
64598,Bernardo Espinosa,COL,Girona,La Liga,2022,33.0,1989.0,13.6,6,2,2,4,0,3,9,33.3,6,17,10,7,12,18,70,2,DF,30-34,Defender,Colombia,South America
390160,Salvatore Esposito,ITA,Spezia,Serie A,2022,21.0,2000.0,10.8,15,12,8,5,2,5,21,23.8,16,9,1,8,11,26,18,0,MF,20-24,Midfielder,Italy,Europe
349599,Pervis Estupin,ECU,Brighton,Premier League,2022,24.0,1998.0,29.7,61,31,36,19,6,35,60,58.3,25,30,8,22,37,98,37,1,DF,20-24,Defender,Ecuador,South America
479999,Eberechi Eze,ENG,Crystal Palace,Premier League,2022,24.0,1998.0,29.3,42,24,17,18,7,18,38,47.4,20,22,0,22,13,55,10,0,"MF,FW",20-24,Midfielder,England,Europe
724520,Abde Ezzalzouli,MAR,Osasuna,La Liga,2022,20.0,2001.0,16.7,29,19,13,12,4,13,23,56.5,10,20,0,20,4,33,6,0,"FW,MF",20-24,Forward,Morocco,Africa
697714,Fabinho,BRA,Liverpool,Premier League,2022,28.0,1993.0,29.7,65,38,18,40,7,24,62,38.7,38,38,11,27,37,102,40,0,MF,25-29,Midfielder,Brazil,South America
61891,Fbio,BRA,Nantes,Ligue 1,2022,32.0,1990.0,2.5,4,2,1,2,1,4,6,66.7,2,2,0,2,3,7,11,0,"DF,MF",30-34,Defender,Brazil,South America
432090,Nicol Fagioli,ITA,Juventus,Serie A,2022,21.0,2001.0,16.9,29,19,12,15,2,8,27,29.6,19,16,2,14,8,37,7,1,MF,20-24,Midfielder,Italy,Europe
555076,Romain Faivre,FRA,Lorient,Ligue 1,2022,24.0,1998.0,13.8,13,8,5,4,4,5,25,20.0,20,11,0,11,1,14,4,0,"MF,FW",20-24,Midfielder,France,Europe
39152,Radamel Falcao,COL,Rayo Vallecano,La Liga,2022,36.0,1986.0,6.8,4,4,1,3,0,1,8,12.5,7,5,1,4,2,6,10,0,"FW,MF",35-39,Forward,Colombia,South America
73926,Davide Faraoni,ITA,Hellas Verona,Serie A,2022,30.0,1991.0,16.5,34,24,19,13,2,16,41,39.0,25,30,11,19,15,49,37,0,DF,30-34,Defender,Italy,Europe
782630,Khalil Fayad,FRA,Montpellier,Ligue 1,2022,18.0,2004.0,8.0,30,14,12,16,2,12,21,57.1,9,8,1,7,9,39,4,0,MF,Under 20,Midfielder,France,Europe
45314,Federico Fazio,ARG,Salernitana,Serie A,2022,35.0,1987.0,11.9,15,12,8,7,0,4,11,36.4,7,9,4,5,28,43,61,0,DF,35-39,Defender,Argentina,South America
691482,Jacopo Fazzini,ITA,Empoli,Serie A,2022,19.0,2003.0,9.2,31,17,20,8,3,18,34,52.9,16,15,3,12,7,38,19,0,MF,Under 20,Midfielder,Italy,Europe
203496,Nabil Fekir,FRA,Betis,La Liga,2022,29.0,1993.0,10.7,11,5,3,3,5,2,9,22.2,7,6,2,4,1,12,0,0,MF,25-29,Midfielder,France,Europe
573907,Luiz Felipe,ITA,Betis,La Liga,2022,25.0,1997.0,19.6,34,23,23,11,0,18,34,52.9,16,43,24,19,28,62,106,0,DF,25-29,Defender,Italy,Europe
462250,Joo Flix,POR,Chelsea,Premier League,2022,22.0,1999.0,10.5,14,7,5,6,3,4,12,33.3,8,3,0,3,1,15,1,1,"FW,MF",20-24,Forward,Portugal,Europe
648046,Evan Ferguson,IRL,Brighton,Premier League,2022,17.0,2004.0,10.6,6,3,1,3,2,1,7,14.3,6,11,1,10,2,8,6,0,FW,Under 20,Forward,Republic of Ireland,Europe
428563,Lewis Ferguson,SCO,Bologna,Serie A,2022,22.0,1999.0,25.7,44,25,16,20,8,20,40,50.0,20,22,7,15,19,63,25,0,"MF,FW",20-24,Midfielder,Scotland,Europe
240306,Bruno Fernandes,POR,Manchester Utd,Premier League,2022,27.0,1994.0,36.8,68,42,24,25,19,30,71,42.3,41,37,5,32,25,93,40,1,"MF,FW",25-29,Midfielder,Portugal,Europe
247555,Edimilson Fernandes,SUI,Mainz 05,Bundesliga,2022,26.0,1996.0,27.1,35,25,26,5,4,18,34,52.9,16,37,16,21,54,89,87,2,DF,25-29,Defender,Switzerland,Europe
648195,Enzo Fernndez,ARG,Chelsea,Premier League,2022,21.0,2001.0,17.2,45,27,25,17,3,21,56,37.5,35,32,2,30,16,61,12,1,MF,20-24,Midfielder,Argentina,South America
118284,Jordan Ferri,FRA,Montpellier,Ligue 1,2022,30.0,1992.0,30.4,55,35,32,19,4,30,89,33.7,59,22,6,16,26,81,21,0,MF,30-34,Midfielder,France,Europe
374139,Junior Firpo,DOM,Leeds United,Premier League,2022,25.0,1996.0,15.2,47,25,27,15,5,24,46,52.2,22,23,7,16,24,71,40,0,DF,25-29,Defender,Dominican Republic,North America
435796,Kilian Fischer,GER,Wolfsburg,Bundesliga,2022,21.0,2000.0,5.6,9,6,3,4,2,6,11,54.5,5,6,0,6,5,14,18,0,"DF,FW",20-24,Defender,Germany,Europe
596881,Florian Flick,GER,Schalke 04,Bundesliga,2022,22.0,2000.0,5.7,12,3,7,5,0,4,14,28.6,10,9,3,6,4,16,18,0,MF,20-24,Midfielder,Germany,Europe
130365,Alessandro Florenzi,ITA,Milan,Serie A,2022,31.0,1991.0,2.3,6,4,3,2,1,4,7,57.1,3,1,0,1,4,10,2,0,DF,30-34,Defender,Italy,Europe
406635,Phil Foden,ENG,Manchester City,Premier League,2022,22.0,2000.0,20.5,16,10,9,5,2,8,19,42.1,11,25,2,23,5,21,12,0,FW,20-24,Forward,England,Europe
182893,Seko Fofana,CIV,Lens,Ligue 1,2022,27.0,1995.0,34.1,28,13,8,18,2,15,39,38.5,24,17,4,13,19,47,14,0,MF,25-29,Midfielder,Ivory Coast,Africa
475411,Wesley Fofana,FRA,Leicester City,Premier League,2022,21.0,2000.0,2.0,4,2,1,2,1,1,3,33.3,2,1,1,0,9,13,5,0,DF,20-24,Defender,France,Europe
569598,Youssouf Fofana,FRA,Monaco,Ligue 1,2022,23.0,1999.0,34.3,81,41,31,42,8,38,74,51.4,36,50,6,44,56,137,32,1,MF,20-24,Midfielder,France,Europe
111078,Emil Forsberg,SWE,RB Leipzig,Bundesliga,2022,30.0,1991.0,16.5,16,11,1,8,7,6,20,30.0,14,25,2,23,3,19,7,0,"MF,FW",30-34,Midfielder,Sweden,Europe
179635,Philipp Frster,GER,Bochum,Bundesliga,2022,27.0,1995.0,14.5,31,19,11,15,5,12,40,30.0,28,22,0,22,6,37,6,0,MF,25-29,Midfielder,Germany,Europe
315131,Timothy Fosu-Mensah,NED,Leverkusen,Bundesliga,2022,24.0,1998.0,2.1,7,5,3,3,1,4,4,100.0,0,2,0,2,0,7,1,0,DF,20-24,Defender,Netherlands,Europe
480763,Juan Foyth,ARG,Villarreal,La Liga,2022,24.0,1998.0,21.8,73,48,49,22,2,41,57,71.9,16,32,11,21,20,93,68,0,DF,20-24,Defender,Argentina,South America
146795,Ryan Fraser,SCO,Newcastle Utd,Premier League,2022,28.0,1994.0,3.5,2,2,0,0,2,2,5,40.0,3,3,1,2,0,2,3,0,FW,25-29,Forward,Scotland,Europe
394300,Davide Frattesi,ITA,Sassuolo,Serie A,2022,22.0,1999.0,31.9,63,36,24,29,10,25,44,56.8,19,27,6,21,16,79,42,0,MF,20-24,Midfielder,Italy,Europe
484547,Jeremie Frimpong,NED,Leverkusen,Bundesliga,2022,21.0,2000.0,30.1,53,27,22,26,5,23,44,52.3,21,24,3,21,16,69,40,0,"DF,MF",20-24,Defender,Netherlands,Europe
272278,Chris Fhrich,GER,Stuttgart,Bundesliga,2022,24.0,1998.0,20.9,36,14,15,14,7,24,44,54.5,20,29,2,27,7,43,13,0,"FW,MF",20-24,Forward,Germany,Europe
250013,Angelo Fulgini,FRA,Lens,Ligue 1,2022,25.0,1996.0,9.5,14,7,2,4,8,5,14,35.7,9,11,0,11,8,22,2,0,"MF,FW",25-29,Midfielder,France,Europe
75489,Niclas Fllkrug,GER,Werder Bremen,Bundesliga,2022,29.0,1993.0,27.5,9,4,0,6,3,3,13,23.1,10,13,4,9,1,10,24,0,FW,25-29,Forward,Germany,Europe
434675,Cody Gakpo,NED,Liverpool,Premier League,2022,23.0,1999.0,16.2,26,15,4,13,9,13,38,34.2,25,13,1,12,4,30,2,0,"FW,MF",20-24,Forward,Netherlands,Europe
488362,Conor Gallagher,ENG,Chelsea,Premier League,2022,22.0,2000.0,18.0,46,33,17,19,10,10,37,27.0,27,41,10,31,23,69,18,1,MF,20-24,Midfielder,England,Europe
392516,Antonino Gallo,ITA,Lecce,Serie A,2022,22.0,2000.0,27.6,56,36,35,12,9,38,57,66.7,19,37,6,31,13,69,71,0,DF,20-24,Defender,Italy,Europe
121686,Cristian Gamboa,CRC,Bochum,Bundesliga,2022,32.0,1989.0,16.4,42,24,27,14,1,21,31,67.7,10,20,7,13,16,58,34,1,DF,30-34,Defender,Costa Rica,North America
27389,Kvin Gameiro,FRA,Strasbourg,Ligue 1,2022,35.0,1987.0,23.3,20,10,6,10,4,8,28,28.6,20,10,1,9,9,29,0,0,FW,35-39,Forward,France,Europe
811779,Alejandro Garnacho,ARG,Manchester Utd,Premier League,2022,18.0,2004.0,6.3,5,2,2,0,3,1,11,9.1,10,5,0,5,5,10,3,0,"FW,MF",Under 20,Forward,Argentina,South America
505219,James Garner,ENG,Everton,Premier League,2022,21.0,2001.0,8.9,16,13,4,8,4,9,19,47.4,10,9,1,8,12,28,13,0,"MF,DF",20-24,Midfielder,England,Europe
72121,Johan Gastien,FRA,Clermont Foot,Ligue 1,2022,34.0,1988.0,28.9,62,34,30,23,9,38,111,34.2,73,37,7,30,36,98,25,1,MF,30-34,Midfielder,France,Europe
509022,Federico Gatti,ITA,Juventus,Serie A,2022,24.0,1998.0,16.1,15,11,9,4,2,9,15,60.0,6,20,14,6,21,36,54,2,DF,20-24,Defender,Italy,Europe
251309,Dennis Geiger,GER,Hoffenheim,Bundesliga,2022,24.0,1998.0,21.7,45,25,15,28,2,22,35,62.9,13,27,3,24,24,69,18,2,MF,20-24,Midfielder,Germany,Europe
503980,Joe Gelhardt,ENG,Leeds United,Premier League,2022,20.0,2002.0,2.4,6,2,1,3,2,3,5,60.0,2,5,0,5,0,6,4,0,FW,20-24,Forward,England,Europe
470618,Denis Genreau,AUS,Toulouse,Ligue 1,2022,23.0,1999.0,7.3,35,13,16,12,7,13,31,41.9,18,16,1,15,8,43,9,0,MF,20-24,Midfielder,Australia,Oceania
119277,Yannick Gerhardt,GER,Wolfsburg,Bundesliga,2022,28.0,1994.0,20.7,29,15,10,11,8,12,30,40.0,18,26,5,21,7,36,24,0,MF,25-29,Midfielder,Germany,Europe
60540,Valre Germain,FRA,Montpellier,Ligue 1,2022,32.0,1990.0,7.6,13,11,3,5,5,4,12,33.3,8,8,0,8,6,19,12,0,"FW,MF",30-34,Forward,France,Europe
341705,Gerson,BRA,Marseille,Ligue 1,2022,25.0,1997.0,4.6,6,4,1,4,1,3,5,60.0,2,5,0,5,2,8,4,0,MF,25-29,Midfielder,Brazil,South America
313477,Paolo Ghiglione,ITA,Cremonese,Serie A,2022,25.0,1997.0,7.9,16,11,10,3,3,10,23,43.5,13,9,4,5,4,20,12,0,DF,25-29,Defender,Italy,Europe
204294,Saman Ghoddos,IRN,Brentford,Premier League,2022,28.0,1993.0,1.5,2,1,0,1,1,1,3,33.3,2,5,1,4,4,6,2,0,"MF,FW",25-29,Midfielder,Iran,Asia
429014,Morgan Gibbs-White,ENG,Wolves,Premier League,2022,22.0,2000.0,2.0,3,1,3,0,0,2,4,50.0,2,2,0,2,1,4,3,0,"FW,MF",20-24,Forward,England,Europe
72792,Niko Gieelmann,GER,Union Berlin,Bundesliga,2022,30.0,1991.0,14.5,21,11,9,9,3,13,31,41.9,18,17,5,12,9,30,28,0,DF,30-34,Defender,Germany,Europe
276896,Samuel Gigot,FRA,Marseille,Ligue 1,2022,28.0,1993.0,20.9,46,24,22,21,3,12,15,80.0,3,24,7,17,45,91,85,1,DF,25-29,Defender,France,Europe
423744,Billy Gilmour,SCO,Brighton,Premier League,2022,21.0,2001.0,5.6,5,2,2,2,1,2,8,25.0,6,5,2,3,6,11,5,0,MF,20-24,Midfielder,Scotland,Europe
270051,Andrei Girotto,BRA,Nantes,Ligue 1,2022,30.0,1992.0,35.0,122,73,71,45,6,74,132,56.1,58,55,24,31,73,195,176,1,"DF,MF",30-34,Defender,Brazil,South America
82442,Olivier Giroud,FRA,Milan,Serie A,2022,35.0,1986.0,23.8,8,5,2,4,2,2,10,20.0,8,11,3,8,3,11,23,0,FW,35-39,Forward,France,Europe
670882,Jamie Gittens,ENG,Dortmund,Bundesliga,2022,17.0,2004.0,5.9,8,4,2,5,1,2,7,28.6,5,1,0,1,1,9,2,0,"FW,MF",Under 20,Forward,England,Europe
159471,Serge Gnabry,GER,Bayern Munich,Bundesliga,2022,27.0,1995.0,21.6,35,23,11,14,10,17,43,39.5,26,24,1,23,11,46,5,1,"FW,MF",25-29,Forward,Germany,Europe
627626,Wilfried Gnonto,ITA,Leeds United,Premier League,2022,18.0,2003.0,15.0,27,17,7,15,5,10,30,33.3,20,24,1,23,5,32,7,0,"FW,MF",Under 20,Forward,Italy,Europe
263918,Aleksandr Golovin,RUS,Monaco,Ligue 1,2022,26.0,1996.0,27.4,62,36,19,32,11,28,72,38.9,44,28,1,27,37,99,10,0,"MF,FW",25-29,Midfielder,Russia,Europe
670710,Andr Gomes,POR,Lille,Ligue 1,2022,29.0,1993.0,18.1,37,19,12,17,8,19,52,36.5,33,20,5,15,9,46,16,1,MF,25-29,Midfielder,Portugal,Europe
392770,Angel Gomes,ENG,Lille,Ligue 1,2022,21.0,2000.0,31.3,41,19,12,21,8,18,49,36.7,31,22,2,20,13,54,11,1,MF,20-24,Midfielder,England,Europe
735570,Joo Gomes,BRA,Wolves,Premier League,2022,21.0,2001.0,7.3,29,13,14,14,1,13,23,56.5,10,12,3,9,4,33,11,0,MF,20-24,Midfielder,Brazil,South America
256178,Joe Gomez,ENG,Liverpool,Premier League,2022,25.0,1997.0,16.3,28,21,15,11,2,11,19,57.9,8,17,11,6,24,52,51,2,DF,25-29,Defender,England,Europe
20005,Papu Gmez,ARG,Sevilla,La Liga,2022,34.0,1988.0,11.8,6,4,3,3,0,2,10,20.0,8,8,1,7,4,10,5,0,"FW,MF",30-34,Forward,Argentina,South America
388795,Oumar Gonzalez,CMR,Ajaccio,Ligue 1,2022,24.0,1998.0,28.6,51,28,34,13,4,23,37,62.2,14,32,11,21,52,103,82,0,DF,20-24,Defender,Cameroon,Africa
503733,Anthony Gordon,ENG,Newcastle Utd,Premier League,2022,21.0,2001.0,5.4,14,12,5,7,2,9,20,45.0,11,9,1,8,2,16,1,1,"FW,MF",20-24,Forward,England,Europe
153084,Leon Goretzka,GER,Bayern Munich,Bundesliga,2022,27.0,1995.0,19.2,43,24,21,16,6,27,48,56.3,21,40,3,37,30,73,32,0,MF,25-29,Midfielder,Germany,Europe
418659,Amine Gouiri,ALG,Nice,Ligue 1,2022,22.0,2000.0,2.5,1,1,1,0,0,0,1,0.0,1,1,0,1,0,1,3,0,"FW,MF",20-24,Forward,Algeria,Africa
106405,Jeffrey Gouweleeuw,NED,Augsburg,Bundesliga,2022,31.0,1991.0,31.1,42,27,19,17,6,24,49,49.0,25,41,23,18,50,92,141,2,DF,30-34,Defender,Netherlands,Europe
126557,Jonathan Gradit,FRA,Lens,Ligue 1,2022,29.0,1992.0,31.4,62,40,30,25,7,31,53,58.5,22,40,26,14,38,100,83,0,DF,25-29,Defender,France,Europe
197473,Alberto Grassi,ITA,Empoli,Serie A,2022,27.0,1995.0,13.3,26,21,13,13,0,15,24,62.5,9,23,12,11,27,53,45,0,MF,25-29,Midfielder,Italy,Europe
478573,Ryan Gravenberch,NED,Bayern Munich,Bundesliga,2022,20.0,2002.0,6.4,17,8,4,10,3,7,13,53.8,6,9,1,8,9,26,10,0,MF,20-24,Midfielder,Netherlands,Europe
292417,Demarai Gray,JAM,Everton,Premier League,2022,26.0,1996.0,27.9,33,24,9,14,10,17,31,54.8,14,23,3,20,13,46,18,0,"FW,MF",25-29,Forward,Jamaica,North America
203460,Jack Grealish,ENG,Manchester City,Premier League,2022,26.0,1995.0,22.8,25,16,10,12,3,13,23,56.5,10,17,3,14,7,32,9,0,FW,25-29,Forward,England,Europe
532178,Sam Greenwood,ENG,Leeds United,Premier League,2022,20.0,2002.0,4.7,15,7,7,8,0,8,21,38.1,13,10,2,8,1,16,1,0,"MF,FW",20-24,Midfielder,England,Europe
72479,Clment Grenier,FRA,Mallorca,La Liga,2022,31.0,1991.0,8.0,20,8,6,12,2,10,20,50.0,10,9,1,8,6,26,7,0,MF,30-34,Midfielder,France,Europe
125781,Antoine Griezmann,FRA,Atltico Madrid,La Liga,2022,31.0,1991.0,31.8,49,34,15,23,11,20,66,30.3,46,34,3,31,24,73,31,0,"FW,MF",30-34,Forward,France,Europe
185077,Vincenzo Grifo,ITA,Freiburg,Bundesliga,2022,29.0,1993.0,26.8,29,16,6,15,8,13,31,41.9,18,18,1,17,19,48,19,0,"MF,FW",25-29,Midfielder,Italy,Europe
58396,Christian Gro,GER,Werder Bremen,Bundesliga,2022,33.0,1989.0,21.0,56,25,20,34,2,29,60,48.3,31,20,5,15,23,79,38,1,MF,30-34,Midfielder,Germany,Europe
82873,Pascal Gro,GER,Brighton,Premier League,2022,31.0,1991.0,36.0,59,38,23,27,9,25,55,45.5,30,32,10,22,13,72,21,1,"MF,DF",30-34,Midfielder,Germany,Europe
381753,Ilia Gruev,BUL,Werder Bremen,Bundesliga,2022,22.0,2000.0,17.6,44,27,16,25,3,18,31,58.1,13,23,6,17,22,66,21,1,MF,20-24,Midfielder,Bulgaria,Europe
20506,Andrs Guardado,MEX,Betis,La Liga,2022,35.0,1986.0,15.3,41,25,17,20,4,18,43,41.9,25,14,5,9,23,64,29,0,MF,35-39,Midfielder,Mexico,North America
362108,Gabriel Gudmundsson,SWE,Lille,Ligue 1,2022,23.0,1999.0,9.3,19,11,7,10,2,12,22,54.5,10,11,2,9,10,29,20,0,"DF,FW",20-24,Defender,Sweden,Europe
225122,Gonalo Guedes,POR,Wolves,Premier League,2022,25.0,1996.0,7.9,8,6,4,3,1,5,8,62.5,3,4,0,4,1,9,2,0,"FW,MF",25-29,Forward,Portugal,Europe
500689,Evann Guessand,CIV,Nantes,Ligue 1,2022,21.0,2001.0,14.0,24,16,8,13,3,6,12,50.0,6,17,1,16,9,33,6,0,"FW,MF",20-24,Forward,Ivory Coast,Africa
485963,Pape Gueye,SEN,Sevilla,La Liga,2022,23.0,1999.0,13.0,37,22,13,21,3,16,33,48.5,17,21,5,16,22,59,10,0,MF,20-24,Midfielder,Senegal,Africa
93704,Josuha Guilavogui,FRA,Wolfsburg,Bundesliga,2022,31.0,1990.0,13.1,18,11,7,10,1,6,17,35.3,11,19,13,6,23,41,52,0,"DF,MF",30-34,Defender,France,Europe
520624,Bruno Guimares,BRA,Newcastle Utd,Premier League,2022,24.0,1997.0,30.3,78,40,27,46,5,38,65,58.5,27,28,4,24,36,114,22,1,MF,20-24,Midfielder,Brazil,South America
93707,Christian Gnter,GER,Freiburg,Bundesliga,2022,29.0,1993.0,30.5,29,21,18,9,2,13,43,30.2,30,22,4,18,16,45,41,0,"DF,MF",25-29,Defender,Germany,Europe
241076,Emmanuel Gyasi,GHA,Spezia,Serie A,2022,28.0,1994.0,31.2,24,15,11,10,3,9,36,25.0,27,24,6,18,8,32,26,0,"FW,DF",25-29,Forward,Ghana,Africa
192638,Nicolas Haas,SUI,Empoli,Serie A,2022,26.0,1996.0,12.8,27,13,16,6,5,12,24,50.0,12,16,4,12,8,35,27,0,MF,25-29,Midfielder,Switzerland,Europe
177779,Janik Haberer,GER,Union Berlin,Bundesliga,2022,28.0,1994.0,24.3,29,17,8,18,3,17,48,35.4,31,35,2,33,14,43,25,0,MF,25-29,Midfielder,Germany,Europe
223725,Munir El Haddadi,MAR,Getafe,La Liga,2022,26.0,1995.0,12.8,12,7,3,7,2,2,10,20.0,8,23,2,21,9,21,7,0,"MF,FW",25-29,Midfielder,Morocco,Africa
750903,Jaouen Hadjam,ALG,Nantes,Ligue 1,2022,19.0,2003.0,8.9,27,21,13,9,5,16,25,64.0,9,10,3,7,12,39,12,0,DF,Under 20,Defender,Algeria,Africa
42783,Andr Hahn,GER,Augsburg,Bundesliga,2022,31.0,1990.0,4.3,9,5,4,4,1,8,12,66.7,4,9,2,7,4,13,14,0,"FW,MF",30-34,Forward,Germany,Europe
402008,Amadou Haidara,MLI,RB Leipzig,Bundesliga,2022,24.0,1998.0,15.9,25,11,15,10,0,13,34,38.2,21,26,6,20,26,51,20,0,MF,20-24,Midfielder,Mali,Africa
398073,Achraf Hakimi,MAR,Paris S-G,Ligue 1,2022,23.0,1998.0,22.8,54,34,19,20,15,31,59,52.5,28,34,2,32,16,70,19,0,"DF,MF",20-24,Defender,Morocco,Africa
98349,Romain Hamouma,FRA,Ajaccio,Ligue 1,2022,35.0,1987.0,12.0,8,3,3,3,2,3,6,50.0,3,8,0,8,2,10,2,0,"FW,MF",35-39,Forward,France,Europe
79377,Genki Haraguchi,JPN,Stuttgart,Bundesliga,2022,31.0,1991.0,8.3,16,7,7,7,2,4,16,25.0,12,13,2,11,8,24,6,0,MF,30-34,Midfielder,Japan,Asia
372711,Amine Harit,MAR,Marseille,Ligue 1,2022,25.0,1997.0,5.7,6,4,0,3,3,3,8,37.5,5,4,1,3,4,10,6,0,"MF,FW",25-29,Midfielder,Morocco,Africa
417346,Jack Harrison,ENG,Leeds United,Premier League,2022,25.0,1996.0,30.1,41,17,5,15,21,12,52,23.1,40,47,2,45,22,63,25,0,"FW,MF",25-29,Forward,England,Europe
416386,Abdou Harroui,NED,Sassuolo,Serie A,2022,24.0,1998.0,7.2,17,6,6,7,4,2,7,28.6,5,6,1,5,2,19,10,0,MF,20-24,Midfielder,Netherlands,Europe
275303,Hans Hateboer,NED,Atalanta,Serie A,2022,28.0,1994.0,15.5,21,13,11,8,2,11,27,40.7,16,23,4,19,12,33,25,0,DF,25-29,Defender,Netherlands,Europe
309400,Kai Havertz,GER,Chelsea,Premier League,2022,23.0,1999.0,28.5,34,16,4,20,10,10,30,33.3,20,28,0,28,7,41,41,0,"FW,MF",20-24,Forward,Germany,Europe
108537,Jonas Hector,GER,Kln,Bundesliga,2022,32.0,1990.0,31.4,112,66,59,43,10,66,113,58.4,47,61,9,52,39,151,74,1,DF,30-34,Defender,Germany,Europe
344892,Gauthier Hein,FRA,Auxerre,Ligue 1,2022,25.0,1996.0,20.8,27,20,13,11,3,18,48,37.5,30,10,0,10,6,33,10,0,"MF,FW",25-29,Midfielder,France,Europe
110036,Dominique Heintz,GER,Bochum,Bundesliga,2022,28.0,1993.0,8.8,13,9,5,7,1,6,17,35.3,11,11,7,4,12,25,34,0,DF,25-29,Defender,Germany,Europe
193867,Liam Henderson,SCO,Empoli,Serie A,2022,26.0,1996.0,11.2,13,10,6,5,2,4,21,19.0,17,10,2,8,10,23,10,0,MF,25-29,Midfielder,Scotland,Europe
202591,Benjamin Henrichs,GER,RB Leipzig,Bundesliga,2022,25.0,1997.0,24.3,73,46,41,29,3,43,66,65.2,23,48,4,44,35,108,46,0,"DF,MF",25-29,Defender,Germany,Europe
412513,Thomas Henry,FRA,Hellas Verona,Serie A,2022,27.0,1994.0,11.4,5,3,1,1,3,1,5,20.0,4,6,2,4,0,5,14,0,FW,25-29,Forward,France,Europe
339808,Theo Hernndez,FRA,Milan,Serie A,2022,24.0,1997.0,30.8,43,24,27,15,1,22,38,57.9,16,34,7,27,21,64,35,1,DF,20-24,Defender,France,Europe
378293,Yangel Herrera,VEN,Girona,La Liga,2022,24.0,1998.0,10.7,26,9,9,14,3,6,15,40.0,9,14,1,13,4,30,12,0,"MF,FW",20-24,Midfielder,Venezuela,South America
32711,Patrick Herrmann,GER,Gladbach,Bundesliga,2022,31.0,1991.0,1.8,6,2,4,1,1,2,4,50.0,2,2,0,2,2,8,1,0,"FW,MF",30-34,Forward,Germany,Europe
591949,Aaron Hickey,SCO,Brentford,Premier League,2022,20.0,2002.0,21.3,38,26,27,11,0,18,32,56.3,14,18,7,11,17,55,32,1,DF,20-24,Defender,Scotland,Europe
659813,Piero Hincapi,ECU,Leverkusen,Bundesliga,2022,20.0,2002.0,27.3,51,34,28,20,3,25,38,65.8,13,41,20,21,31,82,83,1,"DF,MF",20-24,Defender,Ecuador,South America
55099,Nicolas Hfler,GER,Freiburg,Bundesliga,2022,32.0,1990.0,31.3,66,35,28,35,3,27,61,44.3,34,40,13,27,58,124,49,0,MF,30-34,Midfielder,Germany,Europe
227085,Jonas Hofmann,GER,Gladbach,Bundesliga,2022,30.0,1992.0,29.8,31,16,17,8,6,15,52,28.8,37,36,2,34,16,47,21,0,"FW,MF",30-34,Forward,Germany,Europe
119037,Philipp Hofmann,GER,Bochum,Bundesliga,2022,29.0,1993.0,29.2,18,11,0,13,5,5,12,41.7,7,20,8,12,6,24,48,0,FW,25-29,Forward,Germany,Europe
248999,Lucas Hler,GER,Freiburg,Bundesliga,2022,28.0,1994.0,16.7,19,14,5,7,7,6,22,27.3,16,22,5,17,10,29,17,0,"FW,MF",25-29,Forward,Germany,Europe
496745,Emil Holm,SWE,Spezia,Serie A,2022,22.0,2000.0,15.5,26,15,13,8,5,16,31,51.6,15,21,6,15,9,35,41,0,DF,20-24,Defender,Sweden,Europe
190289,Gerrit Holtmann,PHI,Bochum,Bundesliga,2022,27.0,1995.0,10.5,14,7,6,7,1,12,21,57.1,9,15,1,14,2,16,4,0,"FW,MF",25-29,Forward,Philippines,Asia
229006,Franck Honorat,FRA,Brest,Ligue 1,2022,25.0,1996.0,28.2,41,29,20,8,13,19,34,55.9,15,22,2,20,21,62,18,0,"FW,MF",25-29,Forward,France,Europe
198709,Cdric Hountondji,BEN,Angers,Ligue 1,2022,28.0,1994.0,34.4,50,36,31,17,2,19,29,65.5,10,44,22,22,59,109,132,1,DF,25-29,Defender,Benin,Africa
236981,Timo Hbers,GER,Kln,Bundesliga,2022,26.0,1996.0,28.4,43,28,35,8,0,24,52,46.2,28,27,13,14,58,101,153,0,DF,25-29,Defender,Germany,Europe
392768,Callum Hudson-Odoi,ENG,Leverkusen,Bundesliga,2022,21.0,2000.0,6.7,5,3,4,0,1,1,1,100.0,0,0,0,0,2,7,4,0,"FW,MF",20-24,Forward,England,Europe
207014,Will Hughes,ENG,Crystal Palace,Premier League,2022,27.0,1995.0,9.4,29,16,11,16,2,11,20,55.0,9,16,7,9,16,45,9,0,MF,25-29,Midfielder,England,Europe
203507,Adrien Hunou,FRA,Angers,Ligue 1,2022,28.0,1994.0,24.8,39,20,17,16,6,16,45,35.6,29,35,0,35,7,46,7,0,"MF,FW",25-29,Midfielder,France,Europe
678479,Denis Huseinbasic,BIH,Kln,Bundesliga,2022,21.0,2001.0,8.8,23,9,8,11,4,10,25,40.0,15,16,2,14,4,27,5,0,"MF,FW",20-24,Midfielder,Bosnia and Herzegovina,Europe
200056,Elseid Hysaj,ALB,Lazio,Serie A,2022,28.0,1994.0,22.2,39,23,24,11,4,23,41,56.1,18,31,7,24,20,59,42,0,DF,25-29,Defender,Albania,Europe
295330,Kelechi Iheanacho,NGA,Leicester City,Premier League,2022,25.0,1996.0,12.5,7,2,0,3,4,3,10,30.0,7,9,1,8,0,7,8,0,"FW,MF",25-29,Forward,Nigeria,Africa
581672,Samuel Iling-Junior,ENG,Juventus,Serie A,2022,18.0,2003.0,3.5,7,2,3,1,3,4,9,44.4,5,5,1,4,2,9,6,0,"DF,FW",Under 20,Defender,England,Europe
134294,Danny Ings,ENG,West Ham,Premier League,2022,30.0,1992.0,8.6,9,8,0,4,5,5,14,35.7,9,8,2,6,3,12,5,0,FW,30-34,Forward,England,Europe
124028,Ismaily,BRA,Lille,Ligue 1,2022,32.0,1990.0,19.8,41,18,16,16,9,17,32,53.1,15,25,5,20,21,62,39,0,DF,30-34,Defender,Brazil,South America
435228,Ardian Ismajli,ALB,Empoli,Serie A,2022,25.0,1996.0,23.3,40,32,25,15,0,18,24,75.0,6,47,31,16,27,67,120,0,DF,25-29,Defender,Albania,Europe
355816,Ko Itakura,JPN,Gladbach,Bundesliga,2022,25.0,1997.0,22.0,29,17,18,7,4,16,30,53.3,14,41,25,16,27,56,95,0,DF,25-29,Defender,Japan,Asia
353892,Hiroki Ito,JPN,Stuttgart,Bundesliga,2022,23.0,1999.0,28.5,40,29,24,14,2,18,35,51.4,17,38,17,21,40,80,94,0,DF,20-24,Defender,Japan,Asia
348791,Junya Ito,JPN,Reims,Ligue 1,2022,29.0,1993.0,32.4,40,20,14,15,11,13,53,24.5,40,29,1,28,8,48,4,1,FW,25-29,Forward,Japan,Asia
242631,Alex Iwobi,NGA,Everton,Premier League,2022,26.0,1996.0,37.5,69,37,37,28,4,33,65,50.8,32,41,2,39,25,94,29,0,"MF,FW",25-29,Midfielder,Nigeria,Africa
32113,Armando Izzo,ITA,Monza,Serie A,2022,30.0,1992.0,27.4,73,50,44,27,2,29,45,64.4,16,29,17,12,50,123,87,1,DF,30-34,Defender,Italy,Europe
776890,Nicolas Jackson,SEN,Villarreal,La Liga,2022,21.0,2001.0,17.8,14,11,2,10,2,2,8,25.0,6,18,2,16,2,16,4,0,FW,20-24,Forward,Senegal,Africa
284248,Paul Jaeckel,GER,Union Berlin,Bundesliga,2022,24.0,1998.0,13.3,24,18,11,11,2,17,35,48.6,18,11,5,6,19,43,44,1,DF,20-24,Defender,Germany,Europe
319301,Daniel James,WAL,Leeds United,Premier League,2022,24.0,1997.0,2.2,6,2,1,3,2,3,6,50.0,3,4,0,4,2,8,2,0,FW,20-24,Forward,Wales,Europe
270171,Vitaly Janelt,GER,Brentford,Premier League,2022,24.0,1998.0,24.5,54,27,20,24,10,21,49,42.9,28,29,9,20,29,83,26,0,"MF,DF",20-24,Midfielder,Germany,Europe
125314,Pontus Jansson,SWE,Brentford,Premier League,2022,31.0,1991.0,8.0,5,3,4,1,0,3,5,60.0,2,13,9,4,9,14,38,0,DF,30-34,Defender,Sweden,Europe
884072,Jeffinho,BRA,Lyon,Ligue 1,2022,22.0,1999.0,5.0,17,4,4,9,4,6,15,40.0,9,6,0,6,1,18,0,0,FW,20-24,Forward,Brazil,South America
249157,Fredrik Jensen,FIN,Augsburg,Bundesliga,2022,24.0,1997.0,10.3,15,10,8,3,4,5,10,50.0,5,12,5,7,4,19,12,0,"FW,MF",20-24,Forward,Finland,Europe
460245,Moritz Jenz,GER,Schalke 04,Bundesliga,2022,23.0,1999.0,10.5,14,11,8,5,1,5,8,62.5,3,16,10,6,8,22,53,1,DF,20-24,Defender,Germany,Europe
363205,Gabriel Jesus,BRA,Arsenal,Premier League,2022,25.0,1997.0,22.9,33,25,16,8,9,15,31,48.4,16,27,3,24,11,44,15,1,FW,25-29,Forward,Brazil,South America
333241,Joelinton,BRA,Newcastle Utd,Premier League,2022,25.0,1996.0,29.6,70,49,36,26,8,26,62,41.9,36,52,7,45,48,118,39,0,"MF,FW",25-29,Midfielder,Brazil,South America
468002,Ben Johnson,ENG,West Ham,Premier League,2022,22.0,2000.0,9.6,20,14,12,4,4,12,18,66.7,6,12,4,8,9,29,28,1,DF,20-24,Defender,England,Europe
470607,Brennan Johnson,WAL,Nott'ham Forest,Premier League,2022,21.0,2001.0,32.6,34,20,18,8,8,8,29,27.6,21,30,1,29,5,39,7,1,"FW,MF",20-24,Forward,Wales,Europe
433188,Curtis Jones,ENG,Liverpool,Premier League,2022,21.0,2001.0,11.5,34,17,8,12,14,18,31,58.1,13,12,2,10,3,37,9,0,MF,20-24,Midfielder,England,Europe
326330,Frenkie de Jong,NED,Barcelona,La Liga,2022,25.0,1997.0,28.2,46,26,16,21,9,17,41,41.5,24,11,1,10,35,81,22,1,MF,25-29,Midfielder,Netherlands,Europe
122155,Willian Jos,BRA,Betis,La Liga,2022,30.0,1991.0,8.1,9,6,6,3,0,4,9,44.4,5,4,0,4,1,10,15,0,FW,30-34,Forward,Brazil,South America
340950,Diogo Jota,POR,Liverpool,Premier League,2022,25.0,1996.0,12.6,23,15,8,8,7,12,37,32.4,25,5,0,5,3,26,11,0,FW,25-29,Forward,Portugal,Europe
149928,Jubal,BRA,Auxerre,Ligue 1,2022,28.0,1993.0,35.7,41,26,29,11,1,19,38,50.0,19,57,34,23,53,94,193,0,DF,25-29,Defender,Brazil,South America
201737,Christopher Jullien,FRA,Montpellier,Ligue 1,2022,29.0,1993.0,29.9,46,28,29,14,3,28,51,54.9,23,35,18,17,43,89,114,1,DF,25-29,Defender,France,Europe
58995,Anthony Jung,GER,Werder Bremen,Bundesliga,2022,30.0,1991.0,29.1,46,27,19,20,7,31,58,53.4,27,30,6,24,22,68,63,0,"DF,FW",30-34,Defender,Germany,Europe
361260,Ozan Kabak,TUR,Hoffenheim,Bundesliga,2022,22.0,2000.0,26.5,51,34,27,21,3,17,30,56.7,13,35,23,12,45,96,83,0,DF,20-24,Defender,Turkey,Asia
649452,Issa Kabor,BFA,Marseille,Ligue 1,2022,21.0,2001.0,11.4,33,19,10,18,5,21,32,65.6,11,11,1,10,12,45,21,1,DF,20-24,Defender,Burkina Faso,Africa
560725,Abdoul Kader Bamba,FRA,Nantes,Ligue 1,2022,28.0,1994.0,0.9,0,0,0,0,0,0,2,0.0,2,3,1,2,0,0,1,0,"FW,MF",25-29,Forward,France,Europe
384060,Tino Kadewere,ZIM,Mallorca,La Liga,2022,26.0,1996.0,6.0,6,3,3,3,0,4,9,44.4,5,6,2,4,2,8,1,0,"FW,MF",25-29,Forward,Zimbabwe,Africa
106270,Florian Kainz,AUT,Kln,Bundesliga,2022,29.0,1992.0,26.0,21,10,7,12,2,8,26,30.8,18,27,6,21,32,53,30,1,"MF,FW",25-29,Midfielder,Austria,Europe
585959,Arnaud Kalimuendo,FRA,Rennes,Ligue 1,2022,20.0,2002.0,20.5,15,8,3,6,6,5,20,25.0,15,15,2,13,2,17,9,0,FW,20-24,Forward,France,Europe
623040,Yayah Kallon,SLE,Hellas Verona,Serie A,2022,21.0,2001.0,9.6,14,10,5,4,5,7,12,58.3,5,10,0,10,8,22,5,0,"MF,FW",20-24,Midfielder,Sierra Leone,Africa
585949,Pierre Kalulu,FRA,Milan,Serie A,2022,22.0,2000.0,28.3,57,39,33,21,3,28,42,66.7,14,41,17,24,41,98,56,1,DF,20-24,Defender,France,Europe
356141,Daichi Kamada,JPN,Eint Frankfurt,Bundesliga,2022,25.0,1996.0,25.2,51,31,10,37,4,31,57,54.4,26,31,2,29,16,67,17,1,MF,25-29,Midfielder,Japan,Asia
394327,Boubacar Kamara,FRA,Aston Villa,Premier League,2022,22.0,1999.0,19.7,58,25,25,23,10,27,56,48.2,29,38,12,26,19,77,24,3,MF,20-24,Midfielder,France,Europe
132098,Harry Kane,ENG,Tottenham,Premier League,2022,29.0,1993.0,37.8,15,12,1,6,8,7,21,33.3,14,27,7,20,2,17,18,0,FW,25-29,Forward,England,Europe
225083,N'Golo Kant,FRA,Chelsea,Premier League,2022,31.0,1991.0,5.8,16,10,4,10,2,4,8,50.0,4,11,0,11,6,22,2,0,MF,30-34,Midfielder,France,Europe
324804,Yann Karamoh,FRA,Torino,Serie A,2022,24.0,1998.0,8.0,5,2,3,2,0,1,5,20.0,4,5,0,5,0,5,2,1,"MF,FW",20-24,Midfielder,France,Europe
298635,Grigoris Kastanos,CYP,Salernitana,Serie A,2022,24.0,1998.0,14.3,39,23,18,19,2,16,40,40.0,24,20,6,14,8,47,8,0,"MF,DF",20-24,Midfielder,Cyprus,Asia
364135,Moise Kean,ITA,Juventus,Serie A,2022,22.0,2000.0,11.1,8,6,2,5,1,3,7,42.9,4,4,0,4,5,13,2,0,FW,20-24,Forward,Italy,Europe
111422,Neeskens Kebano,COD,Fulham,Premier League,2022,30.0,1992.0,8.5,17,9,8,6,3,9,18,50.0,9,14,0,14,1,18,8,0,FW,30-34,Forward,DR Congo,Africa
228948,Thilo Kehrer,GER,West Ham,Premier League,2022,25.0,1996.0,24.8,43,24,25,14,4,21,45,46.7,24,16,6,10,34,77,76,1,DF,25-29,Defender,Germany,Europe
342039,Yannik Keitel,GER,Freiburg,Bundesliga,2022,22.0,2000.0,7.6,11,7,4,6,1,3,5,60.0,2,6,3,3,13,24,8,0,MF,20-24,Midfielder,Germany,Europe
281404,Kenedy,BRA,Valladolid,La Liga,2022,26.0,1996.0,3.1,6,2,3,3,0,2,4,50.0,2,2,0,2,1,7,0,0,"FW,DF",25-29,Forward,Brazil,South America
258883,Jonjoe Kenny,ENG,Hertha BSC,Bundesliga,2022,25.0,1997.0,24.9,46,34,27,16,3,24,42,57.1,18,38,9,29,46,92,74,0,DF,25-29,Defender,England,Europe
294808,Franck Kessi,CIV,Barcelona,La Liga,2022,25.0,1996.0,11.0,15,9,6,6,3,8,18,44.4,10,10,2,8,12,27,11,2,MF,25-29,Midfielder,Ivory Coast,Africa
270411,Saf-Eddine Khaoui,TUN,Clermont Foot,Ligue 1,2022,27.0,1995.0,22.5,47,28,14,25,8,15,47,31.9,32,17,2,15,33,80,8,0,MF,25-29,Midfielder,Tunisia,Africa
103565,Wahbi Khazri,TUN,Montpellier,Ligue 1,2022,31.0,1991.0,18.2,26,13,13,7,6,6,25,24.0,19,17,1,16,9,35,20,0,"FW,MF",30-34,Forward,Tunisia,Africa
384553,Luca Kilian,GER,Kln,Bundesliga,2022,22.0,1999.0,12.5,22,16,14,7,1,12,21,57.1,9,16,8,8,11,33,48,0,DF,20-24,Defender,Germany,Europe
161056,Joshua Kimmich,GER,Bayern Munich,Bundesliga,2022,27.0,1995.0,31.2,78,49,24,46,8,38,72,52.8,34,36,7,29,41,119,39,2,MF,25-29,Midfielder,Germany,Europe
215599,Lukas Klostermann,GER,RB Leipzig,Bundesliga,2022,26.0,1996.0,10.1,16,8,7,9,0,8,15,53.3,7,6,3,3,13,29,31,0,DF,25-29,Defender,Germany,Europe
330659,Justin Kluivert,NED,Valencia,La Liga,2022,23.0,1999.0,16.1,17,14,7,4,6,6,12,50.0,6,4,0,4,7,24,4,0,"FW,MF",20-24,Forward,Netherlands,Europe
429874,Ansgar Knauff,GER,Eint Frankfurt,Bundesliga,2022,20.0,2002.0,14.3,36,25,22,11,3,15,34,44.1,19,19,1,18,15,51,26,0,DF,20-24,Defender,Germany,Europe
118847,Dominik Kohr,GER,Mainz 05,Bundesliga,2022,28.0,1994.0,25.5,59,33,23,31,5,29,61,47.5,32,46,9,37,34,93,26,1,MF,25-29,Midfielder,Germany,Europe
487969,Randal Kolo Muani,FRA,Eint Frankfurt,Bundesliga,2022,23.0,1998.0,29.2,14,10,3,3,8,1,9,11.1,8,19,2,17,3,17,13,0,FW,20-24,Forward,France,Europe
357119,Ibrahima Konat,FRA,Liverpool,Premier League,2022,23.0,1999.0,17.2,38,26,25,13,0,16,27,59.3,11,12,5,7,26,64,61,4,DF,20-24,Defender,France,Europe
490223,Ibrahima Kon,MLI,Lorient,Ligue 1,2022,23.0,1999.0,17.5,24,13,3,13,8,5,11,45.5,6,13,0,13,4,28,18,0,FW,20-24,Forward,Mali,Africa
360518,Teun Koopmeiners,NED,Atalanta,Serie A,2022,24.0,1998.0,31.8,46,26,15,24,7,28,55,50.9,27,41,5,36,19,65,36,2,MF,20-24,Midfielder,Netherlands,Europe
337725,Christian Kouam,CIV,Fiorentina,Serie A,2022,24.0,1997.0,20.7,27,18,8,10,9,7,14,50.0,7,15,3,12,12,39,8,0,FW,20-24,Forward,Ivory Coast,Africa
277635,Rominigue Kouam,MLI,Troyes,Ligue 1,2022,25.0,1996.0,29.6,44,27,28,14,2,17,41,41.5,24,32,11,21,49,93,46,1,MF,25-29,Midfielder,Mali,Africa
93128,Kalidou Koulibaly,SEN,Chelsea,Premier League,2022,31.0,1991.0,20.0,45,31,34,8,3,26,40,65.0,14,30,13,17,29,74,77,0,DF,30-34,Defender,Senegal,Africa
411975,Jules Kound,FRA,Barcelona,La Liga,2022,23.0,1998.0,27.0,37,23,18,13,6,21,31,67.7,10,24,9,15,19,56,61,3,DF,20-24,Defender,France,Europe
66934,Cheikhou Kouyat,SEN,Nott'ham Forest,Premier League,2022,32.0,1989.0,9.8,29,21,18,8,3,9,13,69.2,4,14,2,12,10,39,24,0,MF,30-34,Midfielder,Senegal,Africa
203842,Viktor Kovalenko,UKR,Spezia,Serie A,2022,26.0,1996.0,6.1,9,5,1,6,2,5,8,62.5,3,11,2,9,4,13,7,0,MF,25-29,Midfielder,Ukraine,Europe
405393,Soichiro Kozuki,JPN,Schalke 04,Bundesliga,2022,21.0,2000.0,4.2,6,4,3,3,0,4,6,66.7,2,5,0,5,3,9,3,0,"FW,MF",20-24,Forward,Japan,Asia
82097,Christoph Kramer,GER,Gladbach,Bundesliga,2022,31.0,1991.0,24.7,44,33,24,15,5,22,55,40.0,33,34,2,32,17,61,40,0,MF,30-34,Midfielder,Germany,Europe
405687,Tom Krau,GER,Schalke 04,Bundesliga,2022,21.0,2001.0,27.9,112,68,39,62,11,51,100,51.0,49,39,6,33,36,148,35,0,MF,20-24,Midfielder,Germany,Europe
31909,Toni Kroos,GER,Real Madrid,La Liga,2022,32.0,1990.0,23.9,51,32,16,33,2,23,69,33.3,46,23,4,19,24,75,11,0,MF,30-34,Midfielder,Germany,Europe
93604,Lukas Kbler,GER,Freiburg,Bundesliga,2022,29.0,1992.0,18.2,37,25,24,9,4,18,30,60.0,12,25,11,14,29,66,50,0,DF,25-29,Defender,Germany,Europe
405398,Takefusa Kubo,JPN,Real Sociedad,La Liga,2022,21.0,2001.0,27.1,44,26,18,16,10,16,38,42.1,22,29,1,28,9,53,4,0,"FW,MF",20-24,Forward,Japan,Asia
431755,Dejan Kulusevski,SWE,Tottenham,Premier League,2022,22.0,2000.0,23.0,38,15,23,7,8,16,44,36.4,28,19,0,19,13,51,7,0,"MF,FW",20-24,Midfielder,Sweden,Europe
502670,Khvicha Kvaratskhelia,GEO,Napoli,Serie A,2022,21.0,2001.0,28.0,43,23,12,8,23,17,43,39.5,26,20,0,20,5,48,6,1,FW,20-24,Forward,Georgia,Asia
315762,Luca de la Torre,USA,Celta Vigo,La Liga,2022,24.0,1998.0,16.5,28,19,11,14,3,12,32,37.5,20,22,1,21,9,37,6,0,MF,20-24,Midfielder,United States,North America
181378,Gatan Laborde,FRA,Nice,Ligue 1,2022,28.0,1994.0,27.8,45,25,13,17,15,18,40,45.0,22,27,2,25,9,54,13,0,FW,25-29,Forward,France,Europe
93720,Alexandre Lacazette,FRA,Lyon,Ligue 1,2022,31.0,1991.0,32.5,43,23,7,17,19,10,29,34.5,19,23,3,20,15,58,4,0,FW,30-34,Forward,France,Europe
233782,Assa Ladouni,TUN,Union Berlin,Bundesliga,2022,25.0,1996.0,9.7,14,7,6,8,0,5,17,29.4,12,22,4,18,9,23,3,0,MF,25-29,Midfielder,Tunisia,Africa
223967,Konrad Laimer,AUT,RB Leipzig,Bundesliga,2022,25.0,1997.0,16.3,60,31,23,30,7,30,54,55.6,24,31,4,27,18,78,8,0,MF,25-29,Midfielder,Austria,Europe
85791,Stefan Lainer,AUT,Gladbach,Bundesliga,2022,29.0,1992.0,9.1,16,8,10,5,1,10,23,43.5,13,8,1,7,14,30,34,1,DF,25-29,Defender,Austria,Europe
174196,Kenny Lala,MAD,Brest,Ligue 1,2022,30.0,1991.0,15.7,36,19,19,15,2,22,38,57.9,16,15,5,10,21,57,28,0,DF,30-34,Defender,Madagascar,Africa
43530,Adam Lallana,ENG,Brighton,Premier League,2022,34.0,1988.0,8.0,9,4,6,2,1,0,7,0.0,7,6,0,6,2,11,1,0,"MF,FW",30-34,Midfielder,England,Europe
386057,Julien Laporte,FRA,Lorient,Ligue 1,2022,28.0,1993.0,18.4,22,16,18,3,1,16,22,72.7,6,33,27,6,18,40,108,2,DF,25-29,Defender,France,Europe
343463,Cyle Larin,CAN,Valladolid,La Liga,2022,27.0,1995.0,16.3,9,3,2,4,3,3,7,42.9,4,6,3,3,0,9,15,0,FW,25-29,Forward,Canada,North America
554251,Yasser Larouci,ALG,Troyes,Ligue 1,2022,21.0,2001.0,20.0,23,13,13,8,2,15,24,62.5,9,15,1,14,26,49,46,0,"DF,MF",20-24,Defender,Algeria,Africa
39025,Danny Latza,GER,Schalke 04,Bundesliga,2022,32.0,1989.0,9.5,17,13,8,8,1,5,17,29.4,12,16,1,15,5,22,15,0,MF,30-34,Midfielder,Germany,Europe
628451,Romo Lavia,BEL,Southampton,Premier League,2022,18.0,2004.0,24.7,60,35,27,29,4,21,53,39.6,32,47,11,36,33,93,23,1,MF,Under 20,Midfielder,Belgium,Europe
186368,Valentino Lazaro,AUT,Torino,Serie A,2022,26.0,1996.0,15.3,10,5,6,0,4,6,14,42.9,8,16,3,13,3,13,29,0,DF,25-29,Defender,Austria,Europe
766412,Tho Le Bris,FRA,Lorient,Ligue 1,2022,19.0,2002.0,16.1,31,19,17,11,3,15,33,45.5,18,21,2,19,18,49,31,0,"MF,DF",Under 20,Midfielder,France,Europe
794349,Julien Le Cardinal,FRA,Lens,Ligue 1,2022,24.0,1997.0,1.8,6,4,5,0,1,4,6,66.7,2,3,0,3,2,8,5,0,DF,20-24,Defender,France,Europe
737781,Jrmy Le Douaron,FRA,Brest,Ligue 1,2022,24.0,1998.0,23.0,15,9,5,9,1,3,27,11.1,24,29,2,27,11,26,30,0,"MF,FW",20-24,Midfielder,France,Europe
633992,Enzo Le Fe,FRA,Lorient,Ligue 1,2022,22.0,2000.0,33.6,108,64,52,40,16,43,113,38.1,70,50,5,45,34,142,38,1,MF,20-24,Midfielder,France,Europe
120651,Vincent Le Goff,FRA,Lorient,Ligue 1,2022,32.0,1989.0,37.0,75,32,56,16,3,45,62,72.6,17,29,9,20,41,116,105,1,DF,30-34,Defender,France,Europe
357164,Rafael Leo,POR,Milan,Serie A,2022,23.0,1999.0,26.9,8,7,2,3,3,6,14,42.9,8,9,2,7,15,23,8,0,"FW,MF",20-24,Forward,Portugal,Europe
377393,Pierre Lees-Melou,FRA,Brest,Ligue 1,2022,29.0,1993.0,30.7,97,55,55,37,5,57,123,46.3,66,48,13,35,52,149,46,1,MF,25-29,Midfielder,France,Europe
127108,Florian Lejeune,FRA,Rayo Vallecano,La Liga,2022,31.0,1991.0,28.5,28,17,19,8,1,17,25,68.0,8,24,16,8,15,43,123,0,DF,30-34,Defender,France,Europe
205562,Thomas Lemar,FRA,Atltico Madrid,La Liga,2022,26.0,1995.0,13.9,30,18,10,13,7,10,28,35.7,18,12,3,9,7,37,12,0,MF,25-29,Midfielder,France,Europe
182904,Clment Lenglet,FRA,Tottenham,Premier League,2022,27.0,1995.0,22.4,38,23,18,15,5,16,34,47.1,18,26,11,15,18,56,68,2,DF,25-29,Defender,France,Europe
159844,Christopher Lenz,GER,Eint Frankfurt,Bundesliga,2022,27.0,1994.0,14.3,29,21,17,7,5,16,37,43.2,21,16,3,13,21,50,34,0,DF,25-29,Defender,Germany,Europe
585973,Johann Lepenant,FRA,Lyon,Ligue 1,2022,19.0,2002.0,21.5,58,34,24,27,7,32,86,37.2,54,29,5,24,28,86,17,3,MF,Under 20,Midfielder,France,Europe
262980,Jefferson Lerma,COL,Bournemouth,Premier League,2022,27.0,1994.0,36.1,50,30,23,23,4,20,45,44.4,25,32,15,17,47,97,91,2,MF,25-29,Midfielder,Colombia,South America
518505,Jamie Leweling,GER,Union Berlin,Bundesliga,2022,21.0,2001.0,2.9,5,3,2,2,1,3,5,60.0,2,3,0,3,1,6,0,0,"FW,MF",20-24,Forward,Germany,Europe
314940,Dimitri Linard,FRA,Strasbourg,Ligue 1,2022,34.0,1988.0,17.1,46,29,20,18,8,34,57,59.6,23,28,4,24,16,62,24,0,"DF,MF",30-34,Defender,France,Europe
225657,Philipp Lienhart,AUT,Freiburg,Bundesliga,2022,26.0,1996.0,27.8,29,18,19,10,0,13,27,48.1,14,29,15,14,35,64,97,0,DF,25-29,Defender,Austria,Europe
513245,Jesper Lindstrm,DEN,Eint Frankfurt,Bundesliga,2022,22.0,2000.0,18.7,26,11,15,7,4,7,22,31.8,15,25,3,22,9,35,9,0,"MF,FW",20-24,Midfielder,Denmark,Europe
141660,Jesse Lingard,ENG,Nott'ham Forest,Premier League,2022,29.0,1992.0,10.3,4,4,2,2,0,1,7,14.3,6,11,0,11,5,9,4,0,"FW,MF",25-29,Forward,England,Europe
694928,Samuel Lino,BRA,Valencia,La Liga,2022,22.0,1999.0,32.1,66,43,17,37,12,26,72,36.1,46,34,0,34,18,84,16,0,"FW,MF",20-24,Forward,Brazil,South America
287188,Dejan Ljubicic,AUT,Kln,Bundesliga,2022,24.0,1997.0,19.0,25,14,7,14,4,13,40,32.5,27,20,1,19,8,33,8,1,"MF,FW",20-24,Midfielder,Austria,Europe
348795,Giovani Lo Celso,ARG,Villarreal,La Liga,2022,26.0,1996.0,12.5,32,28,7,15,10,12,21,57.1,9,14,2,12,6,38,5,0,"MF,FW",25-29,Midfielder,Argentina,South America
192735,Stanislav Lobotka,SVK,Napoli,Serie A,2022,27.0,1994.0,34.5,83,44,35,35,13,43,73,58.9,30,29,7,22,23,106,16,0,MF,25-29,Midfielder,Slovakia,Europe
345189,Luka Lochoshvili,GEO,Cremonese,Serie A,2022,24.0,1998.0,20.4,45,19,30,11,4,22,31,71.0,9,31,10,21,22,67,89,0,DF,20-24,Defender,Georgia,Asia
202886,Ruben Loftus-Cheek,ENG,Chelsea,Premier League,2022,26.0,1996.0,17.1,25,14,8,14,3,12,22,54.5,10,15,2,13,12,37,23,0,"MF,DF",25-29,Midfielder,England,Europe
346707,Sean Longstaff,ENG,Newcastle Utd,Premier League,2022,24.0,1997.0,28.0,42,21,16,20,6,20,52,38.5,32,35,8,27,16,58,23,0,MF,20-24,Midfielder,England,Europe
406040,Ademola Lookman,NGA,Atalanta,Serie A,2022,24.0,1997.0,19.2,13,5,2,6,5,3,15,20.0,12,18,0,18,4,17,1,0,"FW,MF",20-24,Forward,Nigeria,Africa
649033,Dion Lopy,SEN,Reims,Ligue 1,2022,20.0,2002.0,15.3,45,24,22,16,7,23,62,37.1,39,27,3,24,22,67,18,0,MF,20-24,Midfielder,Senegal,Africa
111266,Anthony Losilla,FRA,Bochum,Bundesliga,2022,36.0,1986.0,30.2,76,49,32,34,10,38,77,49.4,39,39,12,27,37,113,67,0,MF,35-39,Midfielder,France,Europe
316889,Hirving Lozano,MEX,Napoli,Serie A,2022,27.0,1995.0,17.8,24,13,10,6,8,9,21,42.9,12,31,0,31,15,39,6,0,FW,25-29,Forward,Mexico,North America
578872,Jean Lucas,BRA,Monaco,Ligue 1,2022,24.0,1998.0,3.2,9,5,3,5,1,6,12,50.0,6,2,1,1,4,13,2,0,MF,20-24,Midfielder,Brazil,South America
413565,Jhon Lucum,COL,Bologna,Serie A,2022,24.0,1998.0,32.2,53,37,39,13,1,24,43,55.8,19,43,26,17,35,88,100,1,DF,20-24,Defender,Colombia,South America
125020,Jos Luis Palomino,ARG,Atalanta,Serie A,2022,32.0,1990.0,8.4,23,14,16,7,0,11,19,57.9,8,11,4,7,28,51,20,0,DF,30-34,Defender,Argentina,South America
447661,Douglas Luiz,BRA,Aston Villa,Premier League,2022,24.0,1998.0,32.5,72,42,31,32,9,29,63,46.0,34,36,7,29,40,112,27,2,MF,20-24,Midfielder,Brazil,South America
96341,Romelu Lukaku,BEL,Inter,Serie A,2022,29.0,1993.0,18.4,3,1,1,0,2,2,5,40.0,3,3,1,2,0,3,16,0,FW,25-29,Forward,Belgium,Europe
618472,Castello Lukeba,FRA,Lyon,Ligue 1,2022,19.0,2002.0,33.2,39,23,27,8,4,21,31,67.7,10,42,24,18,75,114,105,1,DF,Under 20,Defender,France,Europe
278531,Sebastiano Luperto,ITA,Empoli,Serie A,2022,25.0,1996.0,34.8,33,18,24,8,1,9,20,45.0,11,54,42,12,43,76,163,1,DF,25-29,Defender,Italy,Europe
379807,Lyanco,BRA,Southampton,Premier League,2022,25.0,1997.0,13.1,24,16,15,9,0,12,18,66.7,6,30,25,5,20,44,65,2,DF,25-29,Defender,Brazil,South America
255729,Awer Mabil,AUS,Cdiz,La Liga,2022,26.0,1995.0,1.8,2,0,0,1,1,1,3,33.3,2,1,1,0,0,2,1,0,"MF,FW",25-29,Midfielder,Australia,Oceania
534033,Alexis Mac Allister,ARG,Brighton,Premier League,2022,23.0,1998.0,32.1,70,39,22,40,8,34,71,47.9,37,26,2,24,22,92,10,1,MF,20-24,Midfielder,Argentina,South America
332560,Deiver Machado,COL,Lens,Ligue 1,2022,28.0,1993.0,24.3,45,26,18,20,7,21,34,61.8,13,21,4,17,21,66,27,0,"DF,MF",25-29,Defender,Colombia,South America
211251,Darwin Machs,VEN,Valladolid,La Liga,2022,29.0,1993.0,6.7,3,2,0,2,1,1,8,12.5,7,5,0,5,3,6,4,0,FW,25-29,Forward,Venezuela,South America
294057,James Maddison,ENG,Leicester City,Premier League,2022,25.0,1996.0,27.6,51,26,25,19,7,19,50,38.0,31,19,1,18,13,64,6,1,"MF,FW",25-29,Midfielder,England,Europe
503987,Noni Madueke,ENG,Chelsea,Premier League,2022,20.0,2002.0,7.1,12,8,5,4,3,6,13,46.2,7,13,2,11,4,16,7,0,FW,20-24,Forward,England,Europe
435338,Gabriel Magalhes,BRA,Arsenal,Premier League,2022,24.0,1997.0,37.9,48,30,29,15,4,18,27,66.7,9,49,26,23,32,80,125,3,DF,20-24,Defender,Brazil,South America
66736,Lisandro Magalln,ARG,Elche,La Liga,2022,28.0,1993.0,10.0,19,11,11,5,3,10,12,83.3,2,14,5,9,13,32,30,1,DF,25-29,Defender,Argentina,South America
310458,Giangiacomo Magnani,ITA,Hellas Verona,Serie A,2022,26.0,1995.0,17.0,33,22,20,11,2,19,25,76.0,6,20,15,5,21,54,76,0,DF,25-29,Defender,Italy,Europe
474662,Hugo Magnetti,FRA,Brest,Ligue 1,2022,24.0,1998.0,18.8,43,27,18,23,2,23,63,36.5,40,21,1,20,25,68,12,0,MF,20-24,Midfielder,France,Europe
594997,Yohann Magnin,FRA,Clermont Foot,Ligue 1,2022,25.0,1997.0,26.7,89,54,37,45,7,54,106,50.9,52,50,12,38,25,114,46,0,MF,25-29,Midfielder,France,Europe
296397,Arne Maier,GER,Augsburg,Bundesliga,2022,23.0,1999.0,21.8,31,22,17,11,3,10,18,55.6,8,21,0,21,15,46,22,0,MF,20-24,Midfielder,Germany,Europe
335103,Linton Maina,GER,Kln,Bundesliga,2022,23.0,1999.0,24.9,18,12,5,11,2,7,30,23.3,23,19,0,19,5,23,9,0,"FW,MF",20-24,Forward,Germany,Europe
285845,Ainsley Maitland-Niles,ENG,Southampton,Premier League,2022,24.0,1997.0,15.6,45,24,23,18,4,28,44,63.6,16,28,7,21,22,67,45,1,"DF,MF",20-24,Defender,England,Europe
387106,Lovro Majer,CRO,Rennes,Ligue 1,2022,24.0,1998.0,18.5,34,23,16,13,5,8,29,27.6,21,21,1,20,21,55,5,1,"MF,FW",20-24,Midfielder,Croatia,Europe
698110,Lorenzo Malagrida,ITA,Sampdoria,Serie A,2022,18.0,2003.0,1.2,1,0,0,0,1,1,3,33.3,2,1,0,1,0,1,1,0,"MF,DF",Under 20,Midfielder,Italy,Europe
539134,Daniel Maldini,ITA,Spezia,Serie A,2022,20.0,2001.0,7.0,12,5,3,4,5,4,11,36.4,7,9,0,9,1,13,8,0,"FW,MF",20-24,Forward,Italy,Europe
326029,Donyell Malen,NED,Dortmund,Bundesliga,2022,23.0,1999.0,19.0,13,5,3,4,6,5,12,41.7,7,14,1,13,4,17,11,0,FW,20-24,Forward,Netherlands,Europe
207877,Ruslan Malinovskyi,UKR,Atalanta,Serie A,2022,29.0,1993.0,6.1,14,8,5,6,3,6,17,35.3,11,8,1,7,5,19,2,0,"MF,FW",25-29,Midfielder,Ukraine,Europe
256448,Gianluca Mancini,ITA,Roma,Serie A,2022,26.0,1996.0,31.8,37,19,27,9,1,18,34,52.9,16,38,17,21,46,83,67,0,DF,25-29,Defender,Italy,Europe
80293,Assa Mandi,ALG,Villarreal,La Liga,2022,30.0,1991.0,16.2,18,10,14,3,1,6,12,50.0,6,19,14,5,21,39,58,0,DF,30-34,Defender,Algeria,Africa
308279,Rolando Mandragora,ITA,Fiorentina,Serie A,2022,25.0,1997.0,21.7,42,24,12,22,8,23,52,44.2,29,25,3,22,16,58,21,0,MF,25-29,Midfielder,Italy,Europe
200512,Sadio Man,SEN,Bayern Munich,Bundesliga,2022,30.0,1992.0,15.8,11,5,3,3,5,1,9,11.1,8,15,2,13,0,11,4,0,"FW,MF",30-34,Forward,Senegal,Africa
289592,Orel Mangala,BEL,Nott'ham Forest,Premier League,2022,24.0,1998.0,17.2,28,20,16,10,2,12,29,41.4,17,21,7,14,23,51,15,0,MF,20-24,Midfielder,Belgium,Europe
357072,Faitout Maouassa,FRA,Montpellier,Ligue 1,2022,24.0,1998.0,21.4,52,32,26,20,6,18,41,43.9,23,31,3,28,20,72,23,0,"FW,DF",20-24,Forward,France,Europe
209212,Solly March,ENG,Brighton,Premier League,2022,28.0,1994.0,30.2,53,31,16,17,20,8,28,28.6,20,34,3,31,24,77,32,0,"FW,DF",25-29,Forward,England,Europe
374040,Vincent Marchetti,FRA,Ajaccio,Ligue 1,2022,25.0,1997.0,27.2,55,26,29,19,7,25,68,36.8,43,23,3,20,19,74,31,0,MF,25-29,Midfielder,France,Europe
277167,Gian Marco Ferrari,ITA,Sassuolo,Serie A,2022,30.0,1992.0,24.7,23,16,11,10,2,10,17,58.8,7,29,20,9,23,46,81,4,DF,30-34,Defender,Italy,Europe
250845,Jos Mara Gimnez,URU,Atltico Madrid,La Liga,2022,27.0,1995.0,26.9,43,25,28,14,1,24,35,68.6,11,37,17,20,24,67,138,1,DF,25-29,Defender,Uruguay,South America
295183,Rzvan Marin,ROU,Empoli,Serie A,2022,26.0,1996.0,28.2,44,22,22,21,1,19,40,47.5,21,29,11,18,14,58,33,0,MF,25-29,Midfielder,Romania,Europe
249730,Guillermo Maripn,CHI,Monaco,Ligue 1,2022,28.0,1994.0,24.0,46,26,26,20,0,17,33,51.5,16,39,27,12,38,84,87,0,DF,25-29,Defender,Chile,South America
445939,Omar Marmoush,EGY,Wolfsburg,Bundesliga,2022,23.0,1999.0,16.4,16,10,8,2,6,4,16,25.0,12,21,1,20,7,23,4,0,FW,20-24,Forward,Egypt,Africa
597000,Eric Martel,GER,Kln,Bundesliga,2022,20.0,2002.0,22.4,66,41,29,30,7,30,60,50.0,30,29,9,20,33,99,49,0,MF,20-24,Midfielder,Germany,Europe
655488,Gabriel Martinelli,BRA,Arsenal,Premier League,2022,21.0,2001.0,31.0,31,18,13,12,6,9,22,40.9,13,24,1,23,9,40,14,0,FW,20-24,Forward,Brazil,South America
406625,Lautaro Martnez,ARG,Inter,Serie A,2022,24.0,1997.0,28.6,25,14,3,15,7,7,23,30.4,16,31,1,30,13,38,16,1,FW,20-24,Forward,Argentina,South America
480762,Lisandro Martnez,ARG,Manchester Utd,Premier League,2022,24.0,1998.0,23.5,54,28,33,18,3,30,43,69.8,13,51,27,24,33,87,103,0,DF,20-24,Defender,Argentina,South America
373373,Lucas Martnez Quarta,ARG,Fiorentina,Serie A,2022,26.0,1996.0,24.1,80,48,44,32,4,42,61,68.9,19,41,19,22,48,128,78,1,DF,25-29,Defender,Argentina,South America
142031,Omar Mascarell,EQG,Elche,La Liga,2022,29.0,1993.0,27.2,53,26,32,19,2,31,64,48.4,33,51,19,32,45,98,54,1,"MF,DF",25-29,Midfielder,Equatorial Guinea,Africa
286949,Adam Masina,MAR,Udinese,Serie A,2022,28.0,1994.0,8.8,10,7,7,3,0,6,15,40.0,9,11,4,7,10,20,28,1,DF,25-29,Defender,Morocco,Africa
536508,Han-Noah Massengo,FRA,Auxerre,Ligue 1,2022,21.0,2001.0,12.4,27,15,10,15,2,7,16,43.8,9,12,3,9,14,41,7,0,MF,20-24,Midfielder,France,Europe
535834,Eliot Matazo,BEL,Monaco,Ligue 1,2022,20.0,2002.0,13.1,26,12,11,13,2,11,26,42.3,15,18,4,14,15,41,11,1,MF,20-24,Midfielder,Belgium,Europe
420002,Jean-Philippe Mateta,FRA,Crystal Palace,Premier League,2022,25.0,1997.0,8.6,7,1,2,4,1,1,3,33.3,2,3,1,2,3,10,18,0,FW,25-29,Forward,France,Europe
315145,Azor Matusiwa,NED,Reims,Ligue 1,2022,24.0,1998.0,27.6,66,41,30,29,7,36,61,59.0,25,37,11,26,46,112,52,0,MF,20-24,Midfielder,Netherlands,Europe
217115,Neal Maupay,FRA,Everton,Premier League,2022,25.0,1996.0,12.4,11,5,3,4,4,2,4,50.0,2,8,0,8,5,16,0,0,FW,25-29,Forward,France,Europe
860056,Aman Maurer,MAR,Clermont Foot,Ligue 1,2022,17.0,2004.0,5.6,2,1,1,1,0,1,10,10.0,9,1,0,1,3,5,5,0,MF,Under 20,Midfielder,Morocco,Africa
340328,Stephy Mavididi,ENG,Montpellier,Ligue 1,2022,24.0,1998.0,14.3,24,19,12,8,4,13,27,48.1,14,21,1,20,4,28,10,0,FW,20-24,Forward,England,Europe
415912,Konstantinos Mavropanos,GRE,Stuttgart,Bundesliga,2022,24.0,1997.0,25.4,50,27,32,15,3,28,38,73.7,10,39,18,21,63,113,99,0,DF,20-24,Defender,Greece,Europe
340456,Noussair Mazraoui,MAR,Bayern Munich,Bundesliga,2022,24.0,1997.0,11.9,29,21,9,9,11,15,24,62.5,9,13,2,11,10,39,25,0,DF,20-24,Defender,Morocco,Africa
250153,Pasquale Mazzocchi,ITA,Salernitana,Serie A,2022,27.0,1995.0,21.8,32,18,21,5,6,17,37,45.9,20,10,2,8,10,42,37,2,DF,25-29,Defender,Italy,Europe
342229,Kylian Mbapp,FRA,Paris S-G,Ligue 1,2022,23.0,1998.0,31.3,10,4,0,5,5,5,16,31.3,11,5,0,5,5,15,6,0,FW,20-24,Forward,France,Europe
203348,Chancel Mbemba,COD,Marseille,Ligue 1,2022,27.0,1994.0,31.7,43,26,24,17,2,22,31,71.0,9,25,12,13,42,85,89,0,DF,25-29,Defender,DR Congo,Africa
413039,Bryan Mbeumo,CMR,Brentford,Premier League,2022,22.0,1999.0,32.3,26,18,5,13,8,8,42,19.0,34,24,1,23,13,39,21,0,FW,20-24,Forward,Cameroon,Africa
193116,John McGinn,SCO,Aston Villa,Premier League,2022,27.0,1994.0,29.9,66,36,27,29,10,34,71,47.9,37,43,4,39,24,90,19,0,"MF,FW",25-29,Midfielder,Scotland,Europe
332697,Weston McKennie,USA,Leeds United,Premier League,2022,23.0,1998.0,16.0,30,13,5,18,7,10,29,34.5,19,22,3,19,22,52,26,0,MF,20-24,Midfielder,United States,North America
584769,Dwight McNeil,ENG,Everton,Premier League,2022,22.0,1999.0,27.8,64,41,35,14,15,27,65,41.5,38,46,7,39,31,95,41,0,"FW,MF",20-24,Forward,England,Europe
315969,Scott McTominay,SCO,Manchester Utd,Premier League,2022,25.0,1996.0,12.9,32,19,16,10,6,13,22,59.1,9,15,6,9,14,46,45,1,MF,25-29,Midfielder,Scotland,Europe
474800,Facundo Medina,ARG,Lens,Ligue 1,2022,23.0,1999.0,30.9,31,20,16,15,0,13,35,37.1,22,25,9,16,26,57,62,1,DF,20-24,Defender,Argentina,South America
74810,Ben Mee,ENG,Brentford,Premier League,2022,32.0,1989.0,36.3,45,24,28,13,4,20,37,54.1,17,54,42,12,48,93,122,2,DF,30-34,Defender,England,Europe
807165,Bamo Met,CIV,Lorient,Ligue 1,2022,20.0,2001.0,16.7,18,8,13,4,1,7,16,43.8,9,33,23,10,16,34,70,0,DF,20-24,Defender,Ivory Coast,Africa
425400,Farid El Melali,ALG,Angers,Ligue 1,2022,25.0,1997.0,9.0,21,12,7,12,2,11,22,50.0,11,16,0,16,8,29,7,0,"DF,FW",25-29,Defender,Algeria,Africa
616341,Nuno Mendes,POR,Paris S-G,Ligue 1,2022,20.0,2002.0,17.2,45,30,29,12,4,30,41,73.2,11,19,3,16,17,62,18,0,DF,20-24,Defender,Portugal,Europe
135617,Thiago Mendes,BRA,Lyon,Ligue 1,2022,30.0,1992.0,22.9,48,27,24,21,3,30,40,75.0,10,28,8,20,47,95,51,4,"MF,DF",30-34,Midfielder,Brazil,South America
891998,Antoine Mendy,FRA,Nice,Ligue 1,2022,18.0,2004.0,5.8,22,13,16,5,1,9,15,60.0,6,6,1,5,2,24,16,0,DF,Under 20,Defender,France,Europe
111051,Nampalys Mendy,SEN,Leicester City,Premier League,2022,30.0,1992.0,8.4,13,9,7,6,0,8,15,53.3,7,20,4,16,13,26,2,0,MF,30-34,Midfielder,Senegal,Africa
397171,Gideon Mensah,GHA,Auxerre,Ligue 1,2022,24.0,1998.0,25.1,80,44,43,32,5,44,77,57.1,33,33,10,23,38,118,41,0,DF,20-24,Defender,Ghana,Africa
480987,Chris Mepham,WAL,Bournemouth,Premier League,2022,24.0,1997.0,24.4,45,22,37,8,0,19,30,63.3,11,40,27,13,30,75,152,0,DF,20-24,Defender,Wales,Europe
557613,Quentin Merlin,FRA,Nantes,Ligue 1,2022,20.0,2002.0,19.9,31,19,19,8,4,18,38,47.4,20,27,4,23,24,55,30,0,DF,20-24,Defender,France,Europe
28003,Lionel Messi,ARG,Paris S-G,Ligue 1,2022,35.0,1987.0,31.5,26,18,1,13,12,11,27,40.7,16,11,0,11,2,28,0,0,"FW,MF",35-39,Forward,Argentina,South America
449151,Junior Messias,BRA,Milan,Serie A,2022,31.0,1991.0,16.6,24,18,9,9,6,5,19,26.3,14,20,4,16,7,31,28,0,"FW,DF",30-34,Forward,Brazil,South America
186988,Sven Michel,GER,Union Berlin,Bundesliga,2022,32.0,1990.0,5.5,9,5,1,5,3,4,8,50.0,4,5,1,4,0,9,4,0,"FW,MF",30-34,Forward,Germany,Europe
401530,der Milito,BRA,Real Madrid,La Liga,2022,24.0,1998.0,30.0,46,32,25,18,3,26,33,78.8,7,67,39,28,42,88,104,2,DF,20-24,Defender,Brazil,South America
569366,Enzo Millot,FRA,Stuttgart,Bundesliga,2022,20.0,2002.0,9.9,23,16,9,10,4,12,19,63.2,7,20,3,17,12,35,7,0,MF,20-24,Midfielder,France,Europe
3333,James Milner,ENG,Liverpool,Premier League,2022,36.0,1986.0,10.1,26,16,11,11,4,15,34,44.1,19,14,2,12,12,38,15,0,"MF,DF",35-39,Midfielder,England,Europe
289446,Yerry Mina,COL,Everton,Premier League,2022,27.0,1994.0,6.6,15,8,9,6,0,9,11,81.8,2,7,4,3,6,21,28,0,DF,25-29,Defender,Colombia,South America
165793,Takumi Minamino,JPN,Monaco,Ligue 1,2022,27.0,1995.0,8.0,15,8,5,7,3,7,35,20.0,28,14,0,14,6,21,4,0,"MF,FW",25-29,Midfielder,Japan,Asia
253677,Tyrone Mings,ENG,Aston Villa,Premier League,2022,29.0,1993.0,35.0,15,7,10,5,0,9,20,45.0,11,40,21,19,54,69,163,2,DF,25-29,Defender,England,Europe
571607,Fabio Miretti,ITA,Juventus,Serie A,2022,18.0,2003.0,13.7,24,11,15,6,3,12,29,41.4,17,20,1,19,4,28,11,0,"MF,FW",Under 20,Midfielder,Italy,Europe
730893,Tyrick Mitchell,ENG,Crystal Palace,Premier League,2022,22.0,1999.0,32.1,71,49,43,23,5,30,53,56.6,23,48,11,37,42,113,78,0,DF,20-24,Defender,England,Europe
504849,Kaoru Mitoma,JPN,Brighton,Premier League,2022,25.0,1997.0,25.8,44,27,15,16,13,20,41,48.8,21,25,0,25,17,61,10,0,"FW,MF",25-29,Forward,Japan,Asia
55735,Henrikh Mkhitaryan,ARM,Inter,Serie A,2022,33.0,1989.0,22.1,41,26,13,22,6,14,41,34.1,27,27,4,23,21,62,18,0,MF,30-34,Midfielder,Armenia,Asia
50512,Anthony Modeste,FRA,Dortmund,Bundesliga,2022,34.0,1988.0,9.0,4,4,2,0,2,2,5,40.0,3,7,0,7,2,6,22,0,FW,30-34,Forward,France,Europe
538874,Terem Moffi,NGA,Nice,Ligue 1,2022,23.0,1999.0,14.8,12,6,0,6,6,2,12,16.7,10,3,0,3,2,14,5,0,FW,20-24,Forward,Nigeria,Africa
462348,Mostafa Mohamed,EGY,Nantes,Ligue 1,2022,24.0,1997.0,21.5,18,13,5,7,6,9,20,45.0,11,23,1,22,10,28,33,0,FW,20-24,Forward,Egypt,Africa
153661,Tobias Mohr,GER,Schalke 04,Bundesliga,2022,26.0,1995.0,9.3,8,5,3,5,0,2,7,28.6,5,14,5,9,8,16,19,0,"DF,MF",25-29,Defender,Germany,Europe
424042,Nahuel Molina,ARG,Atltico Madrid,La Liga,2022,24.0,1998.0,31.9,69,43,38,18,13,39,91,42.9,52,38,7,31,18,87,63,1,DF,20-24,Defender,Argentina,South America
222859,Florent Mollet,FRA,Nantes,Ligue 1,2022,30.0,1991.0,12.1,14,6,5,4,5,7,24,29.2,17,12,1,11,10,24,11,0,MF,30-34,Midfielder,France,Europe
678441,Daniele Montevago,ITA,Sampdoria,Serie A,2022,19.0,2003.0,2.6,1,0,0,0,1,0,1,0.0,1,2,1,1,0,1,1,0,FW,Under 20,Forward,Italy,Europe
402733,Gonzalo Montiel,ARG,Sevilla,La Liga,2022,25.0,1997.0,16.9,26,15,12,14,0,15,29,51.7,14,25,7,18,19,45,38,0,DF,25-29,Defender,Argentina,South America
275590,Kieffer Moore,WAL,Bournemouth,Premier League,2022,29.0,1992.0,14.2,14,11,2,9,3,5,16,31.3,11,12,5,7,1,15,26,0,FW,25-29,Forward,Wales,Europe
617074,Ilaix Moriba,GUI,Valencia,La Liga,2022,19.0,2003.0,11.2,35,16,14,17,4,14,24,58.3,10,11,1,10,4,39,12,0,MF,Under 20,Midfielder,Guinea,Africa
316934,Nikola Moro,CRO,Bologna,Serie A,2022,24.0,1998.0,13.6,32,21,11,15,6,14,36,38.9,22,15,2,13,8,40,18,0,MF,20-24,Midfielder,Croatia,Europe
347253,Dany Mota,POR,Monza,Serie A,2022,24.0,1998.0,21.2,8,7,1,3,4,2,10,20.0,8,5,1,4,6,14,25,0,"FW,MF",20-24,Forward,Portugal,Europe
427161,Lebo Mothiba,RSA,Strasbourg,Ligue 1,2022,26.0,1996.0,4.8,1,0,1,0,0,0,1,0.0,1,6,1,5,0,1,4,0,"FW,MF",25-29,Forward,South Africa,Africa
467720,Youssoufa Moukoko,GER,Dortmund,Bundesliga,2022,17.0,2004.0,12.7,13,7,3,6,4,3,6,50.0,3,9,0,9,2,15,1,0,FW,Under 20,Forward,Germany,Europe
238639,Steve Mouni,BEN,Brest,Ligue 1,2022,27.0,1994.0,18.4,13,5,1,7,5,5,14,35.7,9,18,7,11,3,16,20,0,FW,25-29,Forward,Benin,Africa
77100,Lucas Moura,BRA,Tottenham,Premier League,2022,29.0,1992.0,1.7,8,5,1,3,4,1,4,25.0,3,0,0,0,2,10,1,1,"MF,DF",25-29,Midfielder,Brazil,South America
364525,Bevic Moussiti-Oko,CGO,Ajaccio,Ligue 1,2022,27.0,1995.0,7.8,3,1,1,1,1,1,2,50.0,1,5,3,2,2,5,8,0,FW,25-29,Forward,Congo,Africa
348026,Nordi Mukiele,FRA,Paris S-G,Ligue 1,2022,24.0,1997.0,12.6,31,23,16,6,9,19,29,65.5,10,22,9,13,14,45,16,0,DF,20-24,Defender,France,Europe
58358,Thomas Mller,GER,Bayern Munich,Bundesliga,2022,32.0,1989.0,18.5,21,12,5,9,7,6,16,37.5,10,19,3,16,4,25,16,0,"FW,MF",30-34,Forward,Germany,Europe
451801,Abdul Mumin,GHA,Rayo Vallecano,La Liga,2022,24.0,1998.0,10.2,11,9,5,6,0,3,7,42.9,4,13,5,8,9,20,36,2,DF,20-24,Defender,Ghana,Africa
119228,Luis Muriel,COL,Atalanta,Serie A,2022,31.0,1991.0,11.9,9,6,2,3,4,5,16,31.3,11,9,0,9,2,11,2,0,"FW,MF",30-34,Forward,Colombia,South America
199527,Jacob Murphy,ENG,Newcastle Utd,Premier League,2022,27.0,1995.0,13.9,15,7,3,8,4,8,20,40.0,12,17,0,17,7,22,3,0,FW,25-29,Forward,England,Europe
503991,Yunus Musah,USA,Valencia,La Liga,2022,19.0,2002.0,23.4,48,35,17,23,8,20,30,66.7,10,20,1,19,11,59,16,2,MF,Under 20,Midfielder,United States,North America
580195,Jamal Musiala,GER,Bayern Munich,Bundesliga,2022,19.0,2003.0,24.4,34,23,9,16,9,13,35,37.1,22,30,3,27,19,53,3,0,"MF,FW",Under 20,Midfielder,Germany,Europe
490307,Enock Mwepu,ZAM,Brighton,Premier League,2022,24.0,1998.0,2.4,10,5,1,6,3,3,4,75.0,1,3,1,2,1,11,1,0,"FW,MF",20-24,Forward,Zambia,Africa
404842,Vitaliy Mykolenko,UKR,Everton,Premier League,2022,23.0,1999.0,29.5,58,34,36,19,3,28,51,54.9,23,50,16,34,46,104,99,0,DF,20-24,Defender,Ukraine,Europe
568702,Papa Ndiaga Yade,MTN,Troyes,Ligue 1,2022,22.0,2000.0,6.3,10,6,6,2,2,7,22,31.8,15,10,2,8,8,18,10,0,"DF,MF",20-24,Defender,Mauritania,Africa
274839,Wilfred Ndidi,NGA,Leicester City,Premier League,2022,25.0,1996.0,18.7,61,42,34,24,3,17,43,39.5,26,32,14,18,38,99,48,3,MF,25-29,Midfielder,Nigeria,Africa
54581,Ilija Nestorovski,MKD,Udinese,Serie A,2022,32.0,1990.0,7.1,7,3,2,1,4,5,11,45.5,6,6,1,5,2,9,10,0,"FW,MF",30-34,Forward,North Macedonia,Europe
487465,Pedro Neto,POR,Wolves,Premier League,2022,22.0,2000.0,10.7,11,6,4,2,5,7,17,41.2,10,5,1,4,4,15,4,0,"FW,MF",20-24,Forward,Portugal,Europe
524285,Luca Netz,GER,Gladbach,Bundesliga,2022,19.0,2003.0,7.8,25,13,19,3,3,19,32,59.4,13,5,1,4,6,31,27,0,DF,Under 20,Defender,Germany,Europe
278332,Florian Neuhaus,GER,Gladbach,Bundesliga,2022,25.0,1997.0,15.6,19,9,9,5,5,8,27,29.6,19,20,3,17,12,31,5,0,MF,25-29,Midfielder,Germany,Europe
225161,Rben Neves,POR,Wolves,Premier League,2022,25.0,1997.0,33.5,79,43,31,33,15,32,76,42.1,44,59,22,37,50,129,85,1,MF,25-29,Midfielder,Portugal,Europe
68290,Neymar,BRA,Paris S-G,Ligue 1,2022,30.0,1992.0,17.2,22,14,6,9,7,9,19,47.4,10,7,1,6,4,26,1,1,"MF,FW",30-34,Midfielder,Brazil,South America
448177,Jessic Ngankam,GER,Hertha BSC,Bundesliga,2022,22.0,2000.0,9.2,14,9,7,4,3,6,14,42.9,8,6,1,5,1,15,4,0,"FW,MF",20-24,Forward,Germany,Europe
358032,Cyril Ngonge,BEL,Hellas Verona,Serie A,2022,22.0,2000.0,8.3,7,3,2,2,3,3,11,27.3,8,7,0,7,6,13,4,0,"MF,FW",20-24,Midfielder,Belgium,Europe
490417,Ibrahima Niane,SEN,Angers,Ligue 1,2022,23.0,1999.0,12.6,6,2,1,4,1,1,6,16.7,5,8,2,6,1,7,9,0,FW,20-24,Forward,Senegal,Africa
538996,Tanguy Nianzou,FRA,Sevilla,La Liga,2022,20.0,2002.0,15.2,20,15,10,9,1,8,11,72.7,3,8,5,3,16,36,44,3,DF,20-24,Defender,France,Europe
430280,Hans Nicolussi Caviglia,ITA,Salernitana,Serie A,2022,22.0,2000.0,6.5,15,6,5,8,2,9,15,60.0,6,9,0,9,7,22,7,1,MF,20-24,Midfielder,Italy,Europe
152963,Florian Niederlechner,GER,Augsburg,Bundesliga,2022,31.0,1990.0,10.1,10,5,5,4,1,4,7,57.1,3,16,2,14,1,11,9,0,"FW,MF",30-34,Forward,Germany,Europe
340324,Eddie Nketiah,ENG,Arsenal,Premier League,2022,23.0,1999.0,12.1,13,9,6,2,5,2,10,20.0,8,7,1,6,1,14,7,0,FW,20-24,Forward,England,Europe
344381,Christopher Nkunku,FRA,RB Leipzig,Bundesliga,2022,24.0,1997.0,21.1,6,4,2,1,3,1,6,16.7,5,8,3,5,8,14,11,0,"FW,MF",20-24,Forward,France,Europe
406640,Felix Nmecha,GER,Wolfsburg,Bundesliga,2022,21.0,2000.0,20.4,41,24,11,23,7,16,34,47.1,18,26,10,16,25,66,31,0,MF,20-24,Midfielder,Germany,Europe
314288,Lukas Nmecha,GER,Wolfsburg,Bundesliga,2022,23.0,1998.0,10.0,5,3,0,2,3,3,3,100.0,0,5,1,4,3,8,4,0,FW,20-24,Forward,Germany,Europe
324811,Arnaud Nordin,FRA,Montpellier,Ligue 1,2022,24.0,1998.0,26.7,26,14,10,12,4,12,28,42.9,16,19,1,18,14,40,7,0,FW,20-24,Forward,France,Europe
546543,Darwin Nez,URU,Liverpool,Premier League,2022,23.0,1999.0,18.8,11,5,2,4,5,4,17,23.5,13,10,0,10,3,14,13,0,FW,20-24,Forward,Uruguay,South America
148367,Christian Nrgaard,DEN,Brentford,Premier League,2022,28.0,1994.0,19.6,52,30,21,29,2,18,48,37.5,30,32,9,23,34,86,41,2,MF,25-29,Midfielder,Denmark,Europe
560694,Lewis O'Brien,ENG,Nott'ham Forest,Premier League,2022,23.0,1998.0,6.5,16,9,4,11,1,6,12,50.0,6,13,2,11,5,21,9,0,MF,20-24,Midfielder,England,Europe
598765,Brian Ocampo,URU,Cdiz,La Liga,2022,23.0,1999.0,12.4,18,15,12,5,1,8,21,38.1,13,13,0,13,3,21,3,0,"MF,FW",20-24,Midfielder,Uruguay,South America
189441,Lucas Ocampos,ARG,Sevilla,La Liga,2022,28.0,1994.0,12.9,22,14,9,9,4,8,31,25.8,23,17,2,15,8,30,5,0,"FW,MF",25-29,Forward,Argentina,South America
743498,Wilson Odobert,FRA,Troyes,Ligue 1,2022,17.0,2004.0,19.6,20,14,10,7,3,9,25,36.0,16,11,0,11,15,35,5,0,"MF,FW",Under 20,Midfielder,France,Europe
461833,Caleb Okoli,ITA,Atalanta,Serie A,2022,21.0,2001.0,10.7,21,17,14,6,1,10,25,40.0,15,10,5,5,30,51,44,3,DF,20-24,Defender,Italy,Europe
308133,Ado Onaiwu,JPN,Toulouse,Ligue 1,2022,26.0,1995.0,12.0,11,6,4,4,3,5,13,38.5,8,5,1,4,2,13,5,0,FW,25-29,Forward,Japan,Asia
485706,Amadou Onana,BEL,Everton,Premier League,2022,20.0,2001.0,27.6,72,43,24,42,6,30,42,71.4,12,25,6,19,37,109,39,0,MF,20-24,Midfielder,Belgium,Europe
656441,Jean Onana,CMR,Lens,Ligue 1,2022,22.0,2000.0,9.0,28,17,8,17,3,10,22,45.5,12,15,5,10,18,46,20,0,"MF,DF",20-24,Midfielder,Cameroon,Africa
119234,Karim Onisiwo,AUT,Mainz 05,Bundesliga,2022,30.0,1992.0,28.2,19,12,3,10,6,4,21,19.0,17,19,0,19,2,21,7,0,"FW,MF",30-34,Forward,Austria,Europe
272855,Paul Onuachu,NGA,Southampton,Premier League,2022,28.0,1994.0,4.5,3,2,1,1,1,1,3,33.3,2,4,1,3,0,3,4,0,FW,25-29,Forward,Nigeria,Africa
421637,Frank Onyeka,NGA,Brentford,Premier League,2022,24.0,1998.0,9.4,19,14,11,7,1,10,24,41.7,14,16,3,13,10,29,16,0,MF,20-24,Midfielder,Nigeria,Africa
368887,Los Openda,BEL,Lens,Ligue 1,2022,22.0,2000.0,28.0,11,9,2,6,3,2,13,15.4,11,9,0,9,2,13,6,0,FW,20-24,Forward,Belgium,Europe
118850,Ivan Ordets,UKR,Bochum,Bundesliga,2022,30.0,1992.0,27.2,31,19,21,9,1,16,28,57.1,12,34,17,17,57,88,139,0,DF,30-34,Defender,Ukraine,Europe
148368,Divock Origi,BEL,Milan,Serie A,2022,27.0,1995.0,11.4,10,5,4,3,3,5,10,50.0,5,6,2,4,0,10,13,0,FW,25-29,Forward,Belgium,Europe
221611,Paulo Otvio,BRA,Wolfsburg,Bundesliga,2022,27.0,1994.0,22.7,72,46,46,17,9,44,66,66.7,22,42,6,36,30,102,70,1,DF,25-29,Defender,Brazil,South America
823231,Dango Ouattara,BFA,Bournemouth,Premier League,2022,20.0,2002.0,13.8,28,15,20,6,2,13,32,40.6,19,20,3,17,13,41,29,1,"MF,FW",20-24,Midfielder,Burkina Faso,Africa
650104,Zindine Ould Khaled,FRA,Angers,Ligue 1,2022,22.0,2000.0,0.6,1,1,0,1,0,0,1,0.0,1,0,0,0,2,3,0,0,"MF,FW",20-24,Midfielder,France,Europe
244940,Salih zcan,TUR,Dortmund,Bundesliga,2022,24.0,1998.0,17.5,31,18,10,16,5,16,39,41.0,23,24,2,22,28,59,19,1,MF,20-24,Midfielder,Turkey,Asia
615350,Cenk zkacar,TUR,Valencia,La Liga,2022,21.0,2000.0,15.2,27,20,17,10,0,14,19,73.7,5,14,2,12,12,39,47,4,DF,20-24,Defender,Turkey,Asia
181547,Gonalo Pacincia,POR,Celta Vigo,La Liga,2022,27.0,1994.0,7.4,8,5,0,5,3,2,7,28.6,5,9,1,8,0,8,4,0,"FW,MF",25-29,Forward,Portugal,Europe
401578,Exequiel Palacios,ARG,Leverkusen,Bundesliga,2022,23.0,1998.0,18.4,59,36,20,33,6,29,48,60.4,19,29,2,27,33,92,28,0,MF,20-24,Midfielder,Argentina,South America
211389,Helibelton Palacios,COL,Elche,La Liga,2022,29.0,1993.0,21.3,38,20,21,15,2,19,26,73.1,7,26,12,14,20,58,55,0,DF,25-29,Defender,Colombia,South America
257455,Joo Palhinha,POR,Fulham,Premier League,2022,27.0,1995.0,34.5,148,83,59,65,24,71,135,52.6,64,48,5,43,46,194,61,2,MF,25-29,Midfielder,Portugal,Europe
139279,Nicolas Pallois,FRA,Nantes,Ligue 1,2022,34.0,1987.0,24.6,69,44,51,16,2,42,70,60.0,28,35,18,17,30,99,131,2,DF,30-34,Defender,France,Europe
568177,Cole Palmer,ENG,Manchester City,Premier League,2022,20.0,2002.0,4.1,5,1,0,3,2,3,5,60.0,2,2,1,1,1,6,2,0,"MF,FW",20-24,Midfielder,England,Europe
444523,Lucas Paquet,BRA,West Ham,Premier League,2022,24.0,1997.0,23.9,71,53,23,36,12,27,68,39.7,41,41,4,37,16,87,31,0,MF,20-24,Midfielder,Brazil,South America
711517,Kevin Paredes,USA,Wolfsburg,Bundesliga,2022,19.0,2003.0,5.9,13,9,6,3,4,9,12,75.0,3,7,0,7,6,19,8,0,"FW,MF",Under 20,Forward,United States,North America
547985,Fabiano Parisi,ITA,Empoli,Serie A,2022,21.0,2000.0,31.4,65,35,37,21,7,30,72,41.7,42,51,16,35,41,106,91,0,DF,20-24,Defender,Italy,Europe
230784,Thomas Partey,GHA,Arsenal,Premier League,2022,29.0,1993.0,27.6,70,40,20,35,15,25,52,48.1,27,26,5,21,28,98,41,1,MF,25-29,Midfielder,Ghana,Africa
449496,lvaro Aguado,ESP,Valladolid,La Liga,2022,26.0,1996.0,21.0,27,15,13,11,3,15,25,60.0,10,16,4,12,13,40,15,0,MF,25-29,Midfielder,Spain,Europe
355627,Sergio Akieme,ESP,Almera,La Liga,2022,24.0,1997.0,25.5,27,16,19,6,2,12,22,54.5,10,22,6,16,14,41,41,0,DF,20-24,Defender,Spain,Europe
69751,Jordi Alba,ESP,Barcelona,La Liga,2022,33.0,1989.0,15.8,25,18,13,11,1,12,28,42.9,16,12,5,7,11,36,23,0,DF,30-34,Defender,Spain,Europe
128220,Luis Alberto,ESP,Lazio,Serie A,2022,29.0,1992.0,27.1,49,29,18,20,11,23,72,31.9,49,35,6,29,9,58,4,0,MF,25-29,Midfielder,Spain,Europe
60444,Thiago Alcntara,ESP,Liverpool,Premier League,2022,31.0,1991.0,13.9,43,24,20,21,2,14,23,60.9,9,15,3,12,21,64,13,2,MF,30-34,Midfielder,Spain,Europe
247250,Rubn Alcaraz,ESP,Cdiz,La Liga,2022,31.0,1991.0,22.7,43,31,24,18,1,19,54,35.2,35,23,8,15,19,62,37,0,MF,30-34,Midfielder,Spain,Europe
281755,Ivn Alejo,ESP,Cdiz,La Liga,2022,27.0,1995.0,14.6,32,21,19,9,4,17,37,45.9,20,18,3,15,5,37,12,1,"MF,FW",25-29,Midfielder,Spain,Europe
284854,Carles Ale,ESP,Getafe,La Liga,2022,24.0,1998.0,23.5,18,10,7,5,6,5,34,14.7,29,19,1,18,4,22,18,0,"MF,FW",20-24,Midfielder,Spain,Europe
638589,ngel Algobia,ESP,Getafe,La Liga,2022,23.0,1999.0,12.6,27,13,14,13,0,22,48,45.8,26,15,5,10,3,30,11,0,MF,20-24,Midfielder,Spain,Europe
255488,Yeray lvarez,ESP,Athletic Club,La Liga,2022,27.0,1995.0,25.9,34,23,26,7,1,24,31,77.4,7,23,13,10,48,82,101,0,DF,25-29,Defender,Spain,Europe
277179,Angelio,ESP,Hoffenheim,Bundesliga,2022,25.0,1997.0,29.1,40,24,19,18,3,23,37,62.2,14,32,6,26,25,65,67,0,DF,25-29,Defender,Spain,Europe
574495,Kristoffer Askildsen,NOR,Lecce,Serie A,2022,21.0,2001.0,8.1,7,3,2,3,2,4,10,40.0,6,15,4,11,11,18,6,0,MF,20-24,Midfielder,Norway,Europe
72047,Iago Aspas,ESP,Celta Vigo,La Liga,2022,34.0,1987.0,31.9,8,4,0,4,4,3,22,13.6,19,10,1,9,7,15,23,0,FW,30-34,Forward,Spain,Europe
711969,Lorenz Assignon,TOG,Rennes,Ligue 1,2022,22.0,2000.0,2.9,6,2,4,2,0,2,4,50.0,2,6,0,6,2,8,9,0,DF,20-24,Defender,Togo,Africa
57500,Csar Azpilicueta,ESP,Chelsea,Premier League,2022,32.0,1989.0,17.0,43,25,23,15,5,22,37,59.5,15,26,5,21,19,62,54,1,DF,30-34,Defender,Spain,Europe
864799,Stefan Bajcetic,ESP,Liverpool,Premier League,2022,17.0,2004.0,5.8,9,6,5,3,1,8,27,29.6,19,7,0,7,9,18,4,0,MF,Under 20,Midfielder,Spain,Europe
636688,Alejandro Balde,ESP,Barcelona,La Liga,2022,18.0,2003.0,27.5,42,30,22,16,4,24,41,58.5,17,25,3,22,12,54,17,1,DF,Under 20,Defender,Spain,Europe
298575,Kike Barja,ESP,Osasuna,La Liga,2022,25.0,1997.0,14.6,15,9,6,5,4,8,24,33.3,16,7,0,7,4,19,3,0,"FW,MF",25-29,Forward,Spain,Europe
616369,Ander Barrenetxea,ESP,Real Sociedad,La Liga,2022,20.0,2001.0,9.8,21,15,15,6,0,12,28,42.9,16,15,1,14,5,26,7,0,"FW,DF",20-24,Forward,Spain,Europe
775605,Pablo Barrios,ESP,Atltico Madrid,La Liga,2022,19.0,2003.0,8.0,19,10,3,10,6,8,15,53.3,7,12,2,10,9,28,6,1,MF,Under 20,Midfielder,Spain,Europe
237164,Ihlas Bebou,TOG,Hoffenheim,Bundesliga,2022,28.0,1994.0,15.7,19,16,8,7,4,11,17,64.7,6,9,2,7,7,26,15,0,"FW,DF",25-29,Forward,Togo,Africa
423444,Fran Beltrn,ESP,Celta Vigo,La Liga,2022,23.0,1999.0,31.7,34,22,15,14,5,14,55,25.5,41,29,5,24,53,87,35,2,MF,20-24,Midfielder,Spain,Europe
61812,Yuri Berchiche,ESP,Athletic Club,La Liga,2022,32.0,1990.0,26.7,56,32,28,20,8,35,59,59.3,24,37,12,25,40,96,59,1,DF,30-34,Defender,Spain,Europe
338425,lex Berenguer,ESP,Athletic Club,La Liga,2022,27.0,1995.0,25.5,58,37,17,25,16,23,60,38.3,37,37,4,33,10,68,6,0,FW,25-29,Forward,Spain,Europe
126719,Juan Bernat,ESP,Paris S-G,Ligue 1,2022,29.0,1993.0,18.3,32,16,18,9,5,21,39,53.8,18,11,2,9,9,41,22,1,"DF,MF",25-29,Defender,Spain,Europe
203043,Pedro Bigas,ESP,Elche,La Liga,2022,31.0,1990.0,22.4,37,20,30,7,0,18,29,62.1,11,25,14,11,33,70,95,0,DF,30-34,Defender,Spain,Europe
371851,Jaka Bijol,SVN,Udinese,Serie A,2022,23.0,1999.0,30.3,39,23,32,7,0,16,27,59.3,11,41,25,16,29,68,165,0,DF,20-24,Defender,Slovenia,Europe
418559,Erik Botheim,NOR,Salernitana,Serie A,2022,22.0,2000.0,9.6,11,7,3,4,4,6,13,46.2,7,3,0,3,0,11,4,0,"MF,FW",20-24,Midfielder,Norway,Europe
770895,Ismal Boura,COM,Lens,Ligue 1,2022,21.0,2000.0,1.0,6,4,4,2,0,5,6,83.3,1,2,1,1,2,8,3,0,"DF,FW",20-24,Defender,Comoros,Africa
65230,Sergio Busquets,ESP,Barcelona,La Liga,2022,34.0,1988.0,26.0,58,26,24,26,8,29,51,56.9,22,32,6,26,27,85,36,2,MF,30-34,Midfielder,Spain,Europe
357884,Fernando Calero,ESP,Espanyol,La Liga,2022,26.0,1995.0,17.9,46,29,27,15,4,21,34,61.8,13,31,13,18,13,59,52,0,"DF,MF",25-29,Defender,Spain,Europe
505674,Sergio Camello,ESP,Rayo Vallecano,La Liga,2022,21.0,2001.0,26.7,16,10,3,9,4,5,17,29.4,12,9,1,8,2,18,26,0,FW,20-24,Forward,Spain,Europe
66106,Sergio Canales,ESP,Betis,La Liga,2022,31.0,1991.0,26.7,25,14,10,8,7,14,33,42.4,19,18,0,18,14,39,8,0,"FW,MF",30-34,Forward,Spain,Europe
195171,Samu Castillejo,ESP,Valencia,La Liga,2022,27.0,1995.0,15.1,21,12,8,9,4,8,40,20.0,32,21,2,19,9,30,2,0,"FW,MF",25-29,Forward,Spain,Europe
319745,Dani Ceballos,ESP,Real Madrid,La Liga,2022,25.0,1996.0,17.4,43,29,13,15,15,25,64,39.1,39,23,2,21,25,68,6,1,MF,25-29,Midfielder,Spain,Europe
423443,lex Centelles,ESP,Almera,La Liga,2022,24.0,1997.0,12.5,22,14,16,3,3,16,22,72.7,6,13,2,11,11,33,40,0,DF,20-24,Defender,Spain,Europe
333361,Chumi,ESP,Almera,La Liga,2022,23.0,1999.0,16.5,29,16,18,9,2,14,23,60.9,9,20,7,13,15,44,53,0,DF,20-24,Defender,Spain,Europe
495625,Vctor Chust,ESP,Cdiz,La Liga,2022,22.0,2000.0,10.7,9,6,7,2,0,4,7,57.1,3,8,3,5,10,19,53,0,DF,20-24,Defender,Spain,Europe
795431,Tio Cipot,SVN,Spezia,Serie A,2022,19.0,2003.0,1.5,12,7,6,3,3,6,8,75.0,2,0,0,0,0,12,2,0,"FW,MF",Under 20,Forward,Slovenia,Europe
193784,Carlos Clerc,ESP,Elche,La Liga,2022,30.0,1992.0,29.3,75,51,55,16,4,31,50,62.0,19,29,7,22,28,103,94,1,"DF,MF",30-34,Defender,Spain,Europe
282722,lex Collado,ESP,Elche,La Liga,2022,23.0,1999.0,8.0,26,14,13,11,2,8,13,61.5,5,12,1,11,2,28,4,0,MF,20-24,Midfielder,Spain,Europe
380598,Santi Comesaa,ESP,Rayo Vallecano,La Liga,2022,25.0,1996.0,27.2,71,44,24,41,6,38,82,46.3,44,39,3,36,32,103,17,0,MF,25-29,Midfielder,Spain,Europe
546212,Diego Costa,ESP,Wolves,Premier League,2022,33.0,1988.0,13.8,3,1,3,0,0,2,9,22.2,7,6,1,5,2,5,17,0,FW,30-34,Forward,Spain,Europe
65318,Jaume Costa,ESP,Mallorca,La Liga,2022,34.0,1988.0,28.9,50,34,26,17,7,29,51,56.9,22,13,5,8,22,72,44,1,DF,30-34,Defender,Spain,Europe
585700,Juan Cruz,ESP,Betis,La Liga,2022,22.0,2000.0,2.0,1,0,0,1,0,1,3,33.3,2,1,0,1,0,1,0,0,FW,20-24,Forward,Spain,Europe
142021,Sergi Darder,ESP,Espanyol,La Liga,2022,28.0,1993.0,36.9,69,38,12,43,14,29,73,39.7,44,34,2,32,24,93,23,0,MF,25-29,Midfielder,Spain,Europe
248732,Pawe Dawidowicz,POL,Hellas Verona,Serie A,2022,27.0,1995.0,18.1,48,31,28,17,3,22,31,71.0,9,14,9,5,23,71,71,0,DF,25-29,Defender,Poland,Europe
129476,Gerard Deulofeu,ESP,Udinese,Serie A,2022,28.0,1994.0,13.5,8,5,5,1,2,5,15,33.3,10,8,1,7,2,10,1,0,FW,25-29,Forward,Spain,Europe
221150,Djen,TOG,Getafe,La Liga,2022,30.0,1991.0,31.6,41,28,23,17,1,22,38,57.9,16,25,10,15,42,83,81,1,DF,30-34,Defender,Togo,Africa
573775,Hugo Duro,ESP,Valencia,La Liga,2022,22.0,1999.0,15.4,15,12,2,6,7,7,17,41.2,10,11,1,10,2,17,7,1,FW,20-24,Forward,Spain,Europe
281319,Alberth Elis,HON,Brest,Ligue 1,2022,26.0,1996.0,2.9,4,3,1,2,1,1,7,14.3,6,1,0,1,1,5,2,0,"MF,FW",25-29,Midfielder,Honduras,North America
93935,Sergio Escudero,ESP,Valladolid,La Liga,2022,32.0,1989.0,16.0,33,19,21,8,4,15,35,42.9,20,26,6,20,26,59,46,0,DF,30-34,Defender,Spain,Europe
506248,Edu Expsito,ESP,Espanyol,La Liga,2022,25.0,1996.0,12.9,34,20,16,15,3,13,23,56.5,10,7,0,7,12,46,20,0,MF,25-29,Midfielder,Spain,Europe
466810,Ansu Fati,ESP,Barcelona,La Liga,2022,19.0,2002.0,15.5,16,9,8,4,4,5,18,27.8,13,19,0,19,5,21,6,0,FW,Under 20,Forward,Spain,Europe
89733,lex Fernndez,ESP,Cdiz,La Liga,2022,29.0,1992.0,17.5,13,7,6,4,3,4,14,28.6,10,14,1,13,8,21,19,0,"MF,FW",25-29,Midfielder,Spain,Europe
216464,Carlos Fernndez,ESP,Real Sociedad,La Liga,2022,26.0,1996.0,7.0,6,4,1,3,2,1,15,6.7,14,1,0,1,1,7,4,0,FW,25-29,Forward,Spain,Europe
149231,Fidel,ESP,Elche,La Liga,2022,32.0,1989.0,19.0,15,10,8,5,2,4,38,10.5,34,9,0,9,5,20,8,0,"MF,FW",30-34,Midfielder,Spain,Europe
357885,Pablo Fornals,ESP,West Ham,Premier League,2022,26.0,1996.0,16.7,30,15,9,12,9,13,34,38.2,21,16,2,14,14,44,9,0,"FW,MF",25-29,Forward,Spain,Europe
448628,Javi Galn,ESP,Celta Vigo,La Liga,2022,27.0,1994.0,35.1,104,72,60,40,4,48,98,49.0,50,54,5,49,41,145,63,1,DF,25-29,Defender,Spain,Europe
126751,Iigo Ruiz de Galarreta,ESP,Mallorca,La Liga,2022,28.0,1993.0,27.2,54,38,27,23,4,20,52,38.5,32,26,9,17,30,84,19,0,MF,25-29,Midfielder,Spain,Europe
261504,Aleix Garca,ESP,Girona,La Liga,2022,25.0,1997.0,26.0,37,20,9,18,10,15,33,45.5,18,24,8,16,31,68,35,1,MF,25-29,Midfielder,Spain,Europe
1064403,lvaro Garca,ESP,Rayo Vallecano,La Liga,2022,29.0,1992.0,31.9,49,28,21,13,15,11,33,33.3,22,41,4,37,34,83,24,1,"FW,MF",25-29,Forward,Spain,Europe
67808,Borja Garca,ESP,Girona,La Liga,2022,31.0,1990.0,7.5,10,4,7,2,1,2,9,22.2,7,3,1,2,5,15,6,1,"MF,FW",30-34,Midfielder,Spain,Europe
298589,David Garca,ESP,Osasuna,La Liga,2022,28.0,1994.0,29.8,34,20,22,12,0,19,22,86.4,3,28,13,15,45,79,151,0,DF,25-29,Defender,Spain,Europe
466794,Eric Garca,ESP,Barcelona,La Liga,2022,21.0,2001.0,15.7,24,16,16,5,3,9,20,45.0,11,23,10,13,19,43,36,1,"DF,MF",20-24,Defender,Spain,Europe
361238,Rubn Garca,ESP,Osasuna,La Liga,2022,29.0,1993.0,12.9,20,11,12,4,4,7,24,29.2,17,14,1,13,12,32,13,0,"FW,MF",25-29,Forward,Spain,Europe
197122,Unai Garca,ESP,Osasuna,La Liga,2022,30.0,1992.0,19.0,23,13,13,8,2,12,17,70.6,5,23,14,9,19,42,60,2,DF,30-34,Defender,Spain,Europe
646740,Gavi,ESP,Barcelona,La Liga,2022,17.0,2004.0,28.1,47,31,7,30,10,21,55,38.2,34,32,5,27,18,65,22,0,"MF,FW",Under 20,Midfielder,Spain,Europe
537382,Bryan Gil,ESP,Tottenham,Premier League,2022,21.0,2001.0,1.6,3,1,3,0,0,0,3,0.0,3,3,0,3,1,4,1,0,"MF,FW",20-24,Midfielder,Spain,Europe
544106,scar Gil,ESP,Espanyol,La Liga,2022,25.0,1997.0,28.4,63,37,38,16,9,32,61,52.5,29,51,18,33,31,94,55,1,DF,25-29,Defender,Spain,Europe
175449,Moi Gmez,ESP,Osasuna,La Liga,2022,28.0,1994.0,27.3,26,17,9,14,3,15,32,46.9,17,15,3,12,10,36,5,1,"MF,FW",25-29,Midfielder,Spain,Europe
289255,Andoni Gorosabel,ESP,Real Sociedad,La Liga,2022,25.0,1996.0,19.0,41,25,23,9,9,26,43,60.5,17,21,2,19,17,58,23,0,DF,25-29,Defender,Spain,Europe
256429,Sergi Guardiola,ESP,Valladolid,La Liga,2022,31.0,1991.0,5.6,12,7,6,5,1,2,4,50.0,2,6,0,6,2,14,7,0,FW,30-34,Forward,Spain,Europe
74294,Nemanja Gudelj,SRB,Sevilla,La Liga,2022,30.0,1991.0,30.9,43,33,22,18,3,20,33,60.6,13,39,29,10,34,77,102,1,"DF,MF",30-34,Defender,Serbia,Europe
495629,Hugo Guillamn,ESP,Valencia,La Liga,2022,22.0,2000.0,18.1,20,12,10,8,2,8,24,33.3,16,14,2,12,19,39,30,2,MF,20-24,Midfielder,Spain,Europe
268670,Gerard Gumbau,ESP,Elche,La Liga,2022,27.0,1994.0,30.4,44,25,17,23,4,18,51,35.3,33,32,8,24,28,72,40,0,MF,25-29,Midfielder,Spain,Europe
340205,Gorka Guruzeta,ESP,Athletic Club,La Liga,2022,25.0,1996.0,15.8,24,20,6,12,6,11,24,45.8,13,23,2,21,4,28,8,0,FW,25-29,Forward,Spain,Europe
418560,Erling Haaland,NOR,Manchester City,Premier League,2022,22.0,2000.0,30.8,3,2,0,2,1,1,5,20.0,4,12,4,8,3,6,14,0,FW,20-24,Forward,Norway,Europe
370683,Andreas Hanche-Olsen,NOR,Mainz 05,Bundesliga,2022,25.0,1997.0,16.6,35,23,24,7,4,22,39,56.4,17,16,8,8,33,68,77,2,DF,25-29,Defender,Norway,Europe
422466,Javi Hernndez,ESP,Girona,La Liga,2022,24.0,1998.0,12.4,21,12,12,7,2,13,21,61.9,8,10,5,5,7,28,38,0,DF,20-24,Defender,Spain,Europe
82503,Aridane Hernndez,ESP,Osasuna,La Liga,2022,33.0,1989.0,19.9,21,15,17,4,0,12,25,48.0,13,34,21,13,28,49,96,1,DF,30-34,Defender,Spain,Europe
62945,Luis Hernndez,ESP,Cdiz,La Liga,2022,33.0,1989.0,35.0,33,21,25,7,1,22,36,61.1,14,31,24,7,31,64,145,0,DF,30-34,Defender,Spain,Europe
99343,Ander Herrera,ESP,Athletic Club,La Liga,2022,32.0,1989.0,7.7,18,10,8,7,3,6,18,33.3,12,12,3,9,11,29,12,0,MF,30-34,Midfielder,Spain,Europe
785353,Pablo Ibez,ESP,Osasuna,La Liga,2022,23.0,1998.0,11.8,29,13,7,17,5,12,35,34.3,23,19,2,17,8,37,24,0,MF,20-24,Midfielder,Spain,Europe
278359,Borja Iglesias,ESP,Betis,La Liga,2022,29.0,1993.0,26.3,8,4,3,3,2,2,13,15.4,11,9,1,8,1,9,17,0,FW,25-29,Forward,Spain,Europe
470794,Ivan Ili,SRB,Hellas Verona,Serie A,2022,21.0,2001.0,9.5,16,10,9,7,0,6,11,54.5,5,10,1,9,8,24,14,0,MF,20-24,Midfielder,Serbia,Europe
59344,Asier Illarramendi,ESP,Real Sociedad,La Liga,2022,32.0,1990.0,12.0,36,18,10,22,4,16,44,36.4,28,27,8,19,18,54,20,0,MF,30-34,Midfielder,Spain,Europe
85288,Isco,ESP,Sevilla,La Liga,2022,30.0,1992.0,8.9,15,9,6,5,4,8,14,57.1,6,3,0,3,10,25,3,0,"MF,FW",30-34,Midfielder,Spain,Europe
134936,Jes,ESP,Sampdoria,Serie A,2022,29.0,1993.0,2.3,2,0,0,2,0,0,1,0.0,1,3,1,2,1,3,2,0,FW,25-29,Forward,Spain,Europe
7663,Joaqun,ESP,Betis,La Liga,2022,41.0,1981.0,5.5,3,3,2,1,0,1,3,33.3,2,7,2,5,4,7,5,0,"MF,FW",Over 40,Midfielder,Spain,Europe
263727,Joan Jordn,ESP,Sevilla,La Liga,2022,28.0,1994.0,17.7,32,17,13,17,2,16,38,42.1,22,14,7,7,16,48,14,2,MF,25-29,Midfielder,Spain,Europe
277533,Josan,ESP,Elche,La Liga,2022,32.0,1989.0,12.0,25,20,20,5,0,14,27,51.9,13,8,0,8,7,32,15,1,"DF,MF",30-34,Defender,Spain,Europe
81999,Joselu,ESP,Espanyol,La Liga,2022,32.0,1990.0,33.2,13,11,3,4,6,4,17,23.5,13,25,4,21,8,21,43,0,FW,30-34,Forward,Spain,Europe
257462,Luka Jovi,SRB,Fiorentina,Serie A,2022,24.0,1997.0,17.0,6,3,1,4,1,2,8,25.0,6,7,2,5,2,8,10,0,"FW,MF",20-24,Forward,Serbia,Europe
126737,Juanmi,ESP,Betis,La Liga,2022,29.0,1993.0,10.3,14,10,4,7,3,7,31,22.6,24,10,0,10,4,18,4,0,FW,25-29,Forward,Spain,Europe
115333,Juanpe,ESP,Girona,La Liga,2022,31.0,1991.0,15.8,19,11,10,9,0,11,17,64.7,6,12,9,3,10,29,60,1,DF,30-34,Defender,Spain,Europe
53418,Kevin Kampl,SVN,RB Leipzig,Bundesliga,2022,31.0,1990.0,15.2,21,11,6,14,1,6,27,22.2,21,26,9,17,22,43,11,0,MF,30-34,Midfielder,Slovenia,Europe
425918,Jakub Kiwior,POL,Arsenal,Premier League,2022,22.0,2000.0,4.7,7,5,6,1,0,5,8,62.5,3,5,3,2,6,13,10,0,DF,20-24,Defender,Poland,Europe
74229,Koke,ESP,Atltico Madrid,La Liga,2022,30.0,1992.0,28.3,55,38,23,25,7,28,72,38.9,44,35,13,22,20,75,19,0,MF,30-34,Midfielder,Spain,Europe
337333,Alex Krl,CZE,Schalke 04,Bundesliga,2022,24.0,1998.0,26.2,34,24,10,22,2,17,37,45.9,20,31,6,25,17,51,53,0,MF,20-24,Midfielder,Czech Republic,Europe
226261,Csar de la Hoz,ESP,Almera,La Liga,2022,30.0,1992.0,18.6,37,20,17,18,2,19,37,51.4,18,26,6,20,13,50,37,0,MF,30-34,Midfielder,Spain,Europe
176553,Aymeric Laporte,ESP,Manchester City,Premier League,2022,28.0,1994.0,11.0,11,8,6,4,1,7,11,63.6,4,10,4,6,3,14,30,1,DF,25-29,Defender,Spain,Europe
623521,Juanmi Latasa,ESP,Getafe,La Liga,2022,21.0,2001.0,5.0,5,4,2,0,3,1,1,100.0,0,3,1,2,1,6,8,0,FW,20-24,Forward,Spain,Europe
320271,Toni Lato,ESP,Valencia,La Liga,2022,24.0,1997.0,10.2,23,11,9,12,2,9,21,42.9,12,10,1,9,6,29,14,0,"DF,MF",20-24,Defender,Spain,Europe
70411,Darko Lazovi,SRB,Hellas Verona,Serie A,2022,31.0,1990.0,24.9,24,13,9,12,3,13,29,44.8,16,14,3,11,16,40,19,0,"MF,DF",30-34,Midfielder,Serbia,Europe
255501,Iigo Lekue,ESP,Athletic Club,La Liga,2022,29.0,1993.0,14.7,24,17,20,4,0,12,19,63.2,7,16,2,14,13,37,31,1,DF,25-29,Defender,Spain,Europe
145769,Sergio Len,ESP,Valladolid,La Liga,2022,33.0,1989.0,14.8,6,4,0,4,2,3,6,50.0,3,6,0,6,0,6,4,0,FW,30-34,Forward,Spain,Europe
225873,Karol Linetty,POL,Torino,Serie A,2022,27.0,1995.0,21.0,32,17,7,22,3,13,25,52.0,12,28,8,20,19,51,25,0,MF,25-29,Midfielder,Poland,Europe
298975,Pol Lirola,ESP,Elche,La Liga,2022,24.0,1997.0,7.0,13,6,9,3,1,8,13,61.5,5,3,2,1,7,20,16,0,DF,20-24,Defender,Spain,Europe
947431,David Lpez,ESP,Girona,La Liga,2022,32.0,1989.0,18.4,31,18,17,13,1,19,27,70.4,8,29,19,10,14,45,64,1,DF,30-34,Defender,Spain,Europe
192009,Unai Lpez,ESP,Rayo Vallecano,La Liga,2022,26.0,1995.0,13.9,32,20,10,17,5,13,37,35.1,24,12,1,11,15,47,6,1,MF,25-29,Midfielder,Spain,Europe
268429,Sandi Lovri,SVN,Udinese,Serie A,2022,24.0,1998.0,25.9,40,18,16,16,8,25,43,58.1,18,25,2,23,26,66,21,0,MF,20-24,Midfielder,Slovenia,Europe
252677,Jos Luis Morales,ESP,Villarreal,La Liga,2022,35.0,1987.0,13.5,7,6,1,2,4,5,17,29.4,12,12,1,11,2,9,2,0,"FW,MF",35-39,Forward,Spain,Europe
245056,Saa Luki,SRB,Fulham,Premier League,2022,25.0,1996.0,4.6,8,3,1,4,3,3,7,42.9,4,6,2,4,5,13,3,0,MF,25-29,Midfielder,Serbia,Europe
167472,Youssouf M'Changama,COM,Auxerre,Ligue 1,2022,31.0,1990.0,12.0,22,11,7,12,3,7,13,53.8,6,6,0,6,15,37,6,1,MF,30-34,Midfielder,Comoros,Africa
251876,Pablo Maffeo,ESP,Mallorca,La Liga,2022,25.0,1997.0,33.1,75,46,54,16,5,45,78,57.7,33,38,11,27,26,101,76,0,DF,25-29,Defender,Spain,Europe
225462,Jos Mari,ESP,Cdiz,La Liga,2022,34.0,1987.0,4.4,16,7,12,3,1,10,16,62.5,6,3,1,2,5,21,9,0,MF,30-34,Midfielder,Spain,Europe
210178,Pablo Mar,ESP,Monza,Serie A,2022,28.0,1993.0,27.6,37,19,29,7,1,17,26,65.4,9,22,14,8,31,68,111,3,DF,25-29,Defender,Spain,Europe
907813,Pablo Marn,ESP,Real Sociedad,La Liga,2022,19.0,2003.0,4.0,10,5,5,4,1,2,7,28.6,5,1,0,1,4,14,2,0,"MF,FW",Under 20,Midfielder,Spain,Europe
212391,Roger Mart,ESP,Elche,La Liga,2022,31.0,1991.0,7.3,5,2,3,2,0,1,5,20.0,4,4,0,4,1,6,7,0,FW,30-34,Forward,Spain,Europe
251878,Aarn Martn,ESP,Mainz 05,Bundesliga,2022,25.0,1997.0,20.5,42,27,25,11,6,21,40,52.5,19,22,1,21,15,57,31,0,DF,25-29,Defender,Spain,Europe
531277,Andrs Martn,ESP,Rayo Vallecano,La Liga,2022,23.0,1999.0,2.3,4,2,2,1,1,3,5,60.0,2,2,0,2,1,5,2,0,"FW,MF",20-24,Forward,Spain,Europe
341278,Ivn Martn,ESP,Girona,La Liga,2022,23.0,1999.0,17.6,9,7,4,4,1,8,23,34.8,15,12,0,12,9,18,12,0,MF,20-24,Midfielder,Spain,Europe
227961,Jaime Mata,ESP,Getafe,La Liga,2022,33.0,1988.0,4.9,13,10,4,5,4,7,22,31.8,15,7,2,5,3,16,6,0,"FW,MF",30-34,Forward,Spain,Europe
298976,Borja Mayoral,ESP,Getafe,La Liga,2022,25.0,1997.0,30.7,9,4,7,2,0,5,31,16.1,26,18,0,18,3,12,10,0,FW,25-29,Forward,Spain,Europe
162056,Gonzalo Melero,ESP,Almera,La Liga,2022,28.0,1994.0,20.6,32,16,9,18,5,11,39,28.2,28,23,2,21,7,39,19,1,MF,25-29,Midfielder,Spain,Europe
309110,Brais Mndez,ESP,Real Sociedad,La Liga,2022,25.0,1997.0,26.7,58,34,18,30,10,24,64,37.5,40,27,3,24,12,70,14,1,MF,25-29,Midfielder,Spain,Europe
202984,Roque Mesa,ESP,Valladolid,La Liga,2022,33.0,1989.0,18.0,27,15,16,10,1,12,38,31.6,26,16,4,12,13,40,18,0,MF,30-34,Midfielder,Spain,Europe
266302,Sergej Milinkovi-Savi,SRB,Lazio,Serie A,2022,27.0,1995.0,33.6,58,35,22,23,13,24,67,35.8,43,50,12,38,28,86,49,0,MF,25-29,Midfielder,Serbia,Europe
281989,Luis Milla,ESP,Getafe,La Liga,2022,27.0,1994.0,20.6,48,30,21,18,9,19,44,43.2,25,13,1,12,32,80,25,1,MF,25-29,Midfielder,Spain,Europe
225593,Pere Milla,ESP,Elche,La Liga,2022,29.0,1992.0,20.5,31,20,18,8,5,14,41,34.1,27,18,3,15,9,40,19,1,"FW,MF",25-29,Forward,Spain,Europe
361254,Rafa Mir,ESP,Sevilla,La Liga,2022,25.0,1997.0,14.4,8,2,2,4,2,2,5,40.0,3,5,1,4,4,12,11,0,FW,25-29,Forward,Spain,Europe
341227,Juan Miranda,ESP,Betis,La Liga,2022,22.0,2000.0,16.4,23,16,16,6,1,14,29,48.3,15,20,7,13,20,43,63,0,DF,20-24,Defender,Spain,Europe
51152,Aleksandar Mitrovi,SRB,Fulham,Premier League,2022,27.0,1994.0,22.3,14,7,8,4,2,5,12,41.7,7,22,5,17,3,17,20,1,FW,25-29,Forward,Serbia,Europe
552425,Jon Moncayola,ESP,Osasuna,La Liga,2022,24.0,1998.0,27.2,55,39,24,22,9,30,76,39.5,46,37,5,32,17,72,32,2,"MF,DF",20-24,Midfielder,Spain,Europe
568149,Alberto Moreno,ESP,Villarreal,La Liga,2022,30.0,1992.0,14.4,23,12,10,10,3,11,24,45.8,13,12,1,11,23,46,26,0,DF,30-34,Defender,Spain,Europe
193098,lex Moreno,ESP,Aston Villa,Premier League,2022,29.0,1993.0,14.8,23,14,15,5,3,13,36,36.1,23,18,3,15,7,30,37,2,DF,25-29,Defender,Spain,Europe
635346,Diego Moreno,ESP,Osasuna,La Liga,2022,21.0,2001.0,7.1,4,4,2,2,0,3,8,37.5,5,7,4,3,5,9,21,0,DF,20-24,Defender,Spain,Europe
177467,Gerard Moreno,ESP,Villarreal,La Liga,2022,30.0,1992.0,13.7,11,6,0,6,5,3,6,50.0,3,6,2,4,5,16,10,0,FW,30-34,Forward,Spain,Europe
339816,Tete Morente,ESP,Elche,La Liga,2022,25.0,1996.0,23.0,33,21,18,13,2,15,36,41.7,21,23,3,20,25,58,28,0,"MF,DF",25-29,Midfielder,Spain,Europe
54235,Iker Muniain,ESP,Athletic Club,La Liga,2022,29.0,1992.0,18.8,21,16,7,11,3,6,17,35.3,11,10,1,9,4,25,2,0,"MF,FW",25-29,Midfielder,Spain,Europe
517842,Aihen Muoz,ESP,Real Sociedad,La Liga,2022,24.0,1997.0,19.5,38,23,17,17,4,22,47,46.8,25,26,5,21,9,47,38,0,DF,20-24,Defender,Spain,Europe
710677,Iker Muoz,ESP,Osasuna,La Liga,2022,19.0,2002.0,2.8,1,0,0,1,0,0,3,0.0,3,2,1,1,3,4,8,0,MF,Under 20,Midfielder,Spain,Europe
15956,Jess Navas,ESP,Sevilla,La Liga,2022,36.0,1985.0,22.0,19,12,8,3,8,11,22,50.0,11,18,7,11,22,41,52,1,"DF,FW",35-39,Defender,Spain,Europe
18644,lvaro Negredo,ESP,Cdiz,La Liga,2022,36.0,1985.0,8.4,5,4,1,2,2,2,2,100.0,0,4,1,3,0,5,8,0,FW,35-39,Forward,Spain,Europe
148928,Sal guez,ESP,Atltico Madrid,La Liga,2022,27.0,1994.0,12.2,42,27,18,18,6,22,37,59.5,15,27,5,22,15,57,29,0,"MF,DF",25-29,Midfielder,Spain,Europe
668276,Hugo Novoa,ESP,RB Leipzig,Bundesliga,2022,19.0,2003.0,2.0,8,2,1,3,4,4,7,57.1,3,4,0,4,1,9,0,0,"DF,FW",Under 20,Defender,Spain,Europe
338285,Unai Nez,ESP,Celta Vigo,La Liga,2022,25.0,1997.0,35.0,47,35,29,15,3,18,34,52.9,16,27,17,10,72,119,135,1,DF,25-29,Defender,Spain,Europe
166677,Brian Olivn,ESP,Espanyol,La Liga,2022,28.0,1994.0,26.7,47,27,30,12,5,17,26,65.4,9,26,6,20,22,69,67,0,DF,25-29,Defender,Spain,Europe
293385,Dani Olmo,ESP,RB Leipzig,Bundesliga,2022,24.0,1998.0,14.2,15,9,1,10,4,6,14,42.9,8,15,0,15,6,21,6,0,"MF,FW",20-24,Midfielder,Spain,Europe
711996,Warmed Omari,COM,Rennes,Ligue 1,2022,22.0,2000.0,15.1,20,11,14,6,0,14,28,50.0,14,13,7,6,17,37,43,1,DF,20-24,Defender,Comoros,Africa
634131,Aimar Oroz,ESP,Osasuna,La Liga,2022,20.0,2001.0,22.4,26,14,8,10,8,8,30,26.7,22,24,1,23,24,50,6,0,"MF,FW",20-24,Midfielder,Spain,Europe
591916,Aitor Paredes,ESP,Athletic Club,La Liga,2022,22.0,2000.0,9.5,7,6,4,2,1,6,11,54.5,5,11,7,4,14,21,26,0,DF,20-24,Defender,Spain,Europe
674612,Youssouf Ndayishimiye,BDI,Nice,Ligue 1,2022,23.0,1998.0,6.3,13,9,8,5,0,6,11,54.5,5,8,5,3,12,25,22,1,"MF,DF",20-24,Midfielder,Burundi,Africa
424015,Nathan Patterson,SCO,Everton,Premier League,2022,20.0,2001.0,14.2,49,24,32,13,4,29,54,53.7,25,24,4,20,15,64,45,0,"DF,MF",20-24,Defender,Scotland,Europe
353366,Benjamin Pavard,FRA,Bayern Munich,Bundesliga,2022,26.0,1996.0,27.0,70,41,36,26,8,36,48,75.0,12,35,16,19,44,114,83,0,DF,25-29,Defender,France,Europe
37647,Dimitri Payet,FRA,Marseille,Ligue 1,2022,35.0,1987.0,9.3,6,4,2,2,2,3,11,27.3,8,4,0,4,0,6,4,0,"MF,FW",35-39,Midfielder,France,Europe
183302,Ben Pearson,ENG,Bournemouth,Premier League,2022,27.0,1995.0,3.2,7,3,3,3,1,1,3,33.3,2,4,0,4,2,9,6,0,MF,25-29,Midfielder,England,Europe
364133,Pietro Pellegri,ITA,Torino,Serie A,2022,21.0,2001.0,5.2,6,2,1,3,2,2,3,66.7,1,5,1,4,0,6,4,0,FW,20-24,Forward,Italy,Europe
286297,Lorenzo Pellegrini,ITA,Roma,Serie A,2022,26.0,1996.0,28.3,52,29,24,24,4,22,48,45.8,26,27,4,23,26,78,22,0,MF,25-29,Midfielder,Italy,Europe
343052,Nicolas Pp,CIV,Nice,Ligue 1,2022,27.0,1995.0,16.6,25,13,14,5,6,11,25,44.0,14,17,0,17,3,28,1,0,"FW,MF",25-29,Forward,Ivory Coast,Africa
203394,Andreas Pereira,BRA,Fulham,Premier League,2022,26.0,1996.0,29.9,18,9,3,6,9,8,34,23.5,26,21,3,18,6,24,8,0,MF,25-29,Midfielder,Brazil,South America
141050,Danilo Pereira,POR,Paris S-G,Ligue 1,2022,30.0,1991.0,26.8,32,17,15,14,3,19,26,73.1,7,26,19,7,36,68,59,1,"DF,MF",30-34,Defender,Portugal,Europe
318523,Romain Perraud,FRA,Southampton,Premier League,2022,24.0,1997.0,20.4,54,33,23,23,8,28,52,53.8,24,24,6,18,20,74,42,0,DF,20-24,Defender,France,Europe
353404,Gatan Perrin,FRA,Auxerre,Ligue 1,2022,26.0,1996.0,15.5,17,8,5,6,6,8,30,26.7,22,15,0,15,10,27,9,0,"MF,FW",25-29,Midfielder,France,Europe
199258,Andrea Petagna,ITA,Monza,Serie A,2022,27.0,1995.0,18.5,7,5,2,3,2,3,6,50.0,3,16,4,12,3,10,18,0,FW,25-29,Forward,Italy,Europe
42936,Nils Petersen,GER,Freiburg,Bundesliga,2022,33.0,1988.0,3.1,6,4,0,3,3,2,5,40.0,3,11,2,9,1,7,6,0,FW,30-34,Forward,Germany,Europe
232463,Luca Pfeiffer,GER,Stuttgart,Bundesliga,2022,25.0,1996.0,7.8,1,1,1,0,0,0,1,0.0,1,4,0,4,1,2,5,0,FW,25-29,Forward,Germany,Europe
243879,Charles Pickel,COD,Cremonese,Serie A,2022,25.0,1997.0,27.6,55,23,25,26,4,32,57,56.1,25,37,5,32,24,79,36,1,MF,25-29,Midfielder,DR Congo,Africa
334221,Amos Pieper,GER,Werder Bremen,Bundesliga,2022,24.0,1998.0,21.7,46,28,25,19,2,24,40,60.0,16,23,11,12,30,76,94,1,DF,20-24,Defender,Germany,Europe
410185,Ronal Pierre-Gabriel,FRA,Espanyol,La Liga,2022,24.0,1998.0,2.6,17,9,12,4,1,5,11,45.5,6,5,2,3,9,26,11,0,DF,20-24,Defender,France,Europe
315865,Andrea Pinamonti,ITA,Sassuolo,Serie A,2022,23.0,1999.0,24.0,10,7,0,5,5,3,7,42.9,4,19,2,17,2,12,11,0,FW,20-24,Forward,Italy,Europe
442248,Ethan Pinnock,JAM,Brentford,Premier League,2022,29.0,1993.0,30.0,52,28,33,12,7,18,24,75.0,6,41,31,10,35,87,215,2,DF,25-29,Defender,Jamaica,North America
592735,Gonzalo Plata,ECU,Valladolid,La Liga,2022,21.0,2000.0,25.6,66,35,31,24,11,23,70,32.9,47,40,0,40,12,78,10,1,FW,20-24,Forward,Ecuador,South America
167329,Alassane Pla,FRA,Gladbach,Bundesliga,2022,29.0,1993.0,19.7,16,8,5,7,4,8,26,30.8,18,23,3,20,12,28,14,0,FW,25-29,Forward,France,Europe
392538,Tommaso Pobega,ITA,Milan,Serie A,2022,23.0,1999.0,9.8,27,16,8,15,4,13,20,65.0,7,12,4,8,9,36,11,0,MF,20-24,Midfielder,Italy,Europe
122153,Paul Pogba,FRA,Juventus,Serie A,2022,29.0,1993.0,1.2,0,0,0,0,0,0,1,0.0,1,0,0,0,0,0,2,0,"MF,FW",25-29,Midfielder,France,Europe
60957,Sebastian Polter,GER,Schalke 04,Bundesliga,2022,31.0,1991.0,7.0,4,3,0,4,0,1,4,25.0,3,4,0,4,1,5,6,0,FW,30-34,Forward,Germany,Europe
569390,Julien Ponceau,FRA,Lorient,Ligue 1,2022,21.0,2000.0,18.4,28,19,10,14,4,10,32,31.3,22,27,3,24,14,42,12,0,MF,20-24,Midfielder,France,Europe
157635,Yussuf Poulsen,DEN,RB Leipzig,Bundesliga,2022,28.0,1994.0,4.6,6,4,1,4,1,2,5,40.0,3,3,1,2,0,6,5,0,FW,25-29,Forward,Denmark,Europe
234029,Grischa Prmel,GER,Hoffenheim,Bundesliga,2022,27.0,1995.0,16.2,27,19,14,11,2,9,25,36.0,16,22,4,18,8,35,23,0,MF,25-29,Midfielder,Germany,Europe
315779,Christian Pulisic,USA,Chelsea,Premier League,2022,23.0,1998.0,9.1,11,6,3,6,2,3,5,60.0,2,8,1,7,4,15,4,0,"FW,DF",20-24,Forward,United States,North America
283528,Ignacio Pussetto,ARG,Sampdoria,Serie A,2022,26.0,1995.0,1.7,6,3,2,3,1,3,4,75.0,1,4,0,4,0,6,3,0,"MF,DF",25-29,Midfielder,Argentina,South America
22328,Fabio Quagliarella,ITA,Sampdoria,Serie A,2022,39.0,1983.0,8.9,2,1,1,1,0,1,7,14.3,6,5,1,4,0,2,9,0,FW,35-39,Forward,Italy,Europe
458777,Giacomo Quagliata,ITA,Cremonese,Serie A,2022,22.0,2000.0,7.8,10,8,7,1,2,5,11,45.5,6,7,2,5,11,21,8,0,DF,20-24,Defender,Italy,Europe
182913,Adrien Rabiot,FRA,Juventus,Serie A,2022,27.0,1995.0,30.5,65,35,31,23,11,30,57,52.6,27,37,7,30,26,91,44,1,MF,25-29,Midfielder,France,Europe
518644,Largie Ramazani,BEL,Almera,La Liga,2022,21.0,2001.0,15.6,15,9,6,3,6,8,27,29.6,19,11,0,11,15,30,10,0,"FW,MF",20-24,Forward,Belgium,Europe
51118,Adil Rami,FRA,Troyes,Ligue 1,2022,36.0,1985.0,17.7,19,14,13,5,1,17,32,53.1,15,23,16,7,25,44,75,3,DF,35-39,Defender,France,Europe
646658,Aaron Ramsey,WAL,Nice,Ligue 1,2022,31.0,1990.0,17.6,47,25,18,19,10,16,39,41.0,23,25,4,21,17,64,18,1,MF,30-34,Midfielder,Wales,Europe
503749,Jacob Ramsey,ENG,Aston Villa,Premier League,2022,21.0,2001.0,29.3,69,39,23,35,11,32,69,46.4,37,48,8,40,23,92,34,0,"MF,FW",20-24,Midfielder,England,Europe
489611,Filippo Ranocchia,ITA,Monza,Serie A,2022,21.0,2001.0,5.9,11,6,5,4,2,4,12,33.3,8,5,1,4,4,15,7,0,MF,20-24,Midfielder,Italy,Europe
289802,Rafael Rato,BRA,Toulouse,Ligue 1,2022,26.0,1995.0,20.6,52,36,29,16,7,27,73,37.0,46,34,0,34,21,73,7,0,"FW,MF",25-29,Forward,Brazil,South America
318204,David Raum,GER,RB Leipzig,Bundesliga,2022,24.0,1998.0,18.7,39,25,23,12,4,17,29,58.6,12,24,6,18,16,55,26,1,"DF,MF",20-24,Defender,Germany,Europe
145466,Tim Ream,USA,Fulham,Premier League,2022,34.0,1987.0,32.2,30,16,15,12,3,13,26,50.0,13,45,24,21,41,71,116,3,DF,30-34,Defender,United States,North America
187587,Ante Rebi,CRO,Milan,Serie A,2022,28.0,1993.0,10.9,10,8,1,3,6,3,11,27.3,8,6,1,5,1,11,5,0,"FW,MF",25-29,Forward,Croatia,Europe
226973,Harrison Reed,ENG,Fulham,Premier League,2022,27.0,1995.0,31.8,44,27,17,21,6,16,51,31.4,35,54,12,42,19,63,36,0,MF,25-29,Midfielder,England,Europe
182579,Karim Rekik,NED,Sevilla,La Liga,2022,27.0,1994.0,13.1,11,5,8,3,0,4,5,80.0,1,12,5,7,10,21,24,0,DF,25-29,Defender,Netherlands,Europe
467992,Samuele Ricci,ITA,Torino,Serie A,2022,20.0,2001.0,23.0,32,21,17,10,5,18,23,78.3,5,20,5,15,17,49,29,1,MF,20-24,Midfielder,Italy,Europe
357662,Declan Rice,ENG,West Ham,Premier League,2022,23.0,1999.0,36.4,79,38,44,31,4,31,50,62.0,19,45,15,30,63,142,58,0,MF,20-24,Midfielder,England,Europe
75942,Toms Rincn,VEN,Sampdoria,Serie A,2022,34.0,1988.0,28.4,56,27,22,26,8,29,61,47.5,32,37,7,30,30,86,18,0,MF,30-34,Midfielder,Venezuela,South America
457221,Lucas Robertone,ARG,Almera,La Liga,2022,25.0,1997.0,31.6,50,28,20,21,9,28,64,43.8,36,45,7,38,46,96,46,1,MF,25-29,Midfielder,Argentina,South America
234803,Andrew Robertson,SCO,Liverpool,Premier League,2022,28.0,1994.0,28.7,38,21,12,16,10,21,41,51.2,20,32,5,27,18,56,50,3,DF,25-29,Defender,Scotland,Europe
186862,Enzo Roco,CHI,Elche,La Liga,2022,29.0,1992.0,18.4,33,13,23,10,0,15,24,62.5,9,22,15,7,17,50,63,1,DF,25-29,Defender,Chile,South America
44466,Sebastian Rode,GER,Eint Frankfurt,Bundesliga,2022,31.0,1990.0,15.7,38,24,7,28,3,14,45,31.1,31,18,2,16,16,54,12,0,MF,30-34,Midfielder,Germany,Europe
297212,Joe Rodon,WAL,Rennes,Ligue 1,2022,24.0,1997.0,15.7,11,7,9,2,0,4,10,40.0,6,16,12,4,9,20,54,1,DF,20-24,Defender,Wales,Europe
342385,Guido Rodrguez,ARG,Betis,La Liga,2022,28.0,1994.0,31.9,115,75,59,50,6,54,101,53.5,47,58,14,44,42,157,76,1,MF,25-29,Midfielder,Argentina,South America
412363,Rodrygo,BRA,Real Madrid,La Liga,2022,21.0,2001.0,26.4,17,10,3,7,7,4,23,17.4,19,23,0,23,8,25,5,0,"FW,MF",20-24,Forward,Brazil,South America
889683,Rogrio,BRA,Sassuolo,Serie A,2022,24.0,1998.0,33.3,37,21,22,8,7,17,35,48.6,18,32,9,23,37,74,70,0,DF,20-24,Defender,Brazil,South America
197747,Alessio Romagnoli,ITA,Lazio,Serie A,2022,27.0,1995.0,32.5,33,15,19,14,0,11,22,50.0,11,33,26,7,38,71,108,0,DF,25-29,Defender,Italy,Europe
355915,Cristian Romero,ARG,Tottenham,Premier League,2022,24.0,1998.0,26.3,68,36,42,24,2,29,46,63.0,17,40,18,22,44,112,102,3,DF,20-24,Defender,Argentina,South America
769063,Luka Romero,ARG,Lazio,Serie A,2022,17.0,2004.0,1.7,0,0,0,0,0,0,3,0.0,3,4,0,4,3,3,1,0,FW,Under 20,Forward,Argentina,South America
8198,Cristiano Ronaldo,POR,Manchester Utd,Premier League,2022,37.0,1985.0,5.8,2,2,1,0,1,1,2,50.0,1,0,0,0,1,3,9,0,FW,35-39,Forward,Portugal,Europe
332889,Valentin Rongier,FRA,Marseille,Ligue 1,2022,27.0,1994.0,33.7,93,59,33,47,13,41,77,53.2,36,50,11,39,54,147,38,1,MF,25-29,Midfielder,France,Europe
370791,Pablo Rosario,NED,Nice,Ligue 1,2022,25.0,1997.0,19.6,46,26,22,20,4,18,34,52.9,16,15,5,10,23,69,32,1,"MF,DF",25-29,Midfielder,Netherlands,Europe
183293,Joe Rothwell,ENG,Bournemouth,Premier League,2022,27.0,1995.0,11.3,20,13,7,12,1,7,21,33.3,14,14,3,11,9,29,7,0,MF,25-29,Midfielder,England,Europe
690799,Anthony Rouault,FRA,Toulouse,Ligue 1,2022,21.0,2001.0,36.8,66,37,54,10,2,30,58,51.7,28,52,26,26,56,122,126,4,DF,20-24,Defender,France,Europe
86202,Antonio Rdiger,GER,Real Madrid,La Liga,2022,29.0,1993.0,26.8,18,16,12,5,1,14,23,60.9,9,23,13,10,19,37,74,0,DF,25-29,Defender,Germany,Europe
57051,Sebastian Rudy,GER,Hoffenheim,Bundesliga,2022,32.0,1990.0,8.8,26,12,10,16,0,13,27,48.1,14,27,7,20,11,37,13,0,MF,30-34,Midfielder,Germany,Europe
87884,Mrio Rui,POR,Napoli,Serie A,2022,31.0,1991.0,19.4,34,22,17,13,4,20,41,48.8,21,17,4,13,15,49,24,1,DF,30-34,Defender,Portugal,Europe
135492,Youssouf Sabaly,SEN,Betis,La Liga,2022,29.0,1993.0,18.7,45,23,29,14,2,22,33,66.7,11,35,8,27,19,64,52,1,DF,25-29,Defender,Senegal,Africa
340394,Abdelhamid Sabiri,MAR,Sampdoria,Serie A,2022,25.0,1996.0,11.9,18,7,5,9,4,4,13,30.8,9,18,4,14,2,20,5,0,"MF,FW",25-29,Midfielder,Morocco,Africa
364857,Falaye Sacko,MLI,Montpellier,Ligue 1,2022,27.0,1995.0,28.7,46,25,25,15,6,32,51,62.7,19,43,14,29,33,79,75,1,DF,25-29,Defender,Mali,Africa
381950,Alexis Saelemaekers,BEL,Milan,Serie A,2022,23.0,1999.0,15.6,31,20,12,16,3,19,41,46.3,22,13,1,12,19,50,11,0,"FW,DF",20-24,Forward,Belgium,Europe
182916,Wesley Sad,FRA,Lens,Ligue 1,2022,27.0,1995.0,7.2,4,1,1,2,1,2,6,33.3,4,4,0,4,1,5,2,0,"FW,MF",25-29,Forward,France,Europe
537127,Tho Sainte-Luce,FRA,Montpellier,Ligue 1,2022,23.0,1998.0,5.9,13,11,8,5,0,7,14,50.0,7,7,2,5,10,23,11,0,DF,20-24,Defender,France,Europe
433177,Bukayo Saka,ENG,Arsenal,Premier League,2022,20.0,2001.0,35.3,63,34,22,15,26,20,44,45.5,24,38,0,38,14,77,19,0,FW,20-24,Forward,England,Europe
263951,Hamza Sakhi,FRA,Auxerre,Ligue 1,2022,26.0,1996.0,18.4,44,22,22,17,5,22,42,52.4,20,16,1,15,25,69,9,0,MF,25-29,Midfielder,France,Europe
928323,Ibrahim Salah,MAR,Rennes,Ligue 1,2022,20.0,2001.0,2.5,8,1,5,3,0,2,15,13.3,13,3,0,3,2,10,0,0,"FW,MF",20-24,Forward,Morocco,Africa
148455,Mohamed Salah,EGY,Liverpool,Premier League,2022,30.0,1992.0,36.6,21,12,4,5,12,10,26,38.5,16,21,0,21,6,27,4,0,FW,30-34,Forward,Egypt,Africa
980576,Amine Salama,FRA,Angers,Ligue 1,2022,22.0,2000.0,13.9,11,9,3,7,1,2,12,16.7,10,8,2,6,10,21,2,0,"FW,MF",20-24,Forward,France,Europe
495666,William Saliba,FRA,Arsenal,Premier League,2022,21.0,2001.0,26.8,34,20,23,9,2,15,18,83.3,3,13,10,3,19,53,85,4,DF,20-24,Defender,France,Europe
563963,Mohammed Salisu,GHA,Southampton,Premier League,2022,23.0,1999.0,21.9,52,29,34,16,2,24,34,70.6,10,56,25,31,30,82,122,1,DF,20-24,Defender,Ghana,Africa
335147,Junior Sambia,FRA,Salernitana,Serie A,2022,25.0,1996.0,7.7,12,5,7,4,1,6,10,60.0,4,9,3,6,8,20,16,1,DF,25-29,Defender,France,Europe
234523,Antonio Sanabria,PAR,Torino,Serie A,2022,26.0,1996.0,27.0,11,5,3,3,5,1,7,14.3,6,9,2,7,4,15,7,0,FW,25-29,Forward,Paraguay,South America
40433,Alexis Snchez,CHI,Marseille,Ligue 1,2022,33.0,1988.0,29.8,27,17,5,16,6,3,24,12.5,21,14,0,14,5,32,6,0,"FW,MF",30-34,Forward,Chile,South America
401173,Jadon Sancho,ENG,Manchester Utd,Premier League,2022,22.0,2000.0,18.7,16,10,7,5,4,8,28,28.6,20,25,2,23,7,23,6,0,"FW,MF",20-24,Forward,England,Europe
192565,Leroy San,GER,Bayern Munich,Bundesliga,2022,26.0,1996.0,22.3,38,30,11,19,8,18,36,50.0,18,11,1,10,3,41,1,2,"MF,FW",25-29,Midfielder,Germany,Europe
82048,Nicola Sansone,ITA,Bologna,Serie A,2022,30.0,1991.0,8.2,12,4,6,4,2,5,10,50.0,5,0,0,0,0,12,4,0,FW,30-34,Forward,Italy,Europe
285323,Baptiste Santamaria,FRA,Rennes,Ligue 1,2022,27.0,1995.0,20.1,41,22,13,23,5,21,41,51.2,20,21,5,16,21,62,23,0,MF,25-29,Midfielder,France,Europe
568005,Jeremy Sarmiento,ECU,Brighton,Premier League,2022,20.0,2002.0,2.0,6,3,4,1,1,2,5,40.0,3,2,0,2,1,7,0,0,MF,20-24,Midfielder,Ecuador,South America
748382,Amin Sarr,SWE,Lyon,Ligue 1,2022,21.0,2001.0,6.0,9,6,1,4,4,1,4,25.0,3,2,0,2,0,9,4,0,FW,20-24,Forward,Sweden,Europe
127156,Tji Savanier,FRA,Montpellier,Ligue 1,2022,30.0,1991.0,28.3,46,30,16,19,11,23,70,32.9,47,30,2,28,30,76,12,1,MF,30-34,Midfielder,France,Europe
504153,Joe Scally,USA,Gladbach,Bundesliga,2022,19.0,2002.0,24.5,31,20,25,5,1,24,31,77.4,7,17,6,11,8,39,61,0,DF,Under 20,Defender,United States,North America
571604,Giorgio Scalvini,ITA,Atalanta,Serie A,2022,18.0,2003.0,25.9,54,29,30,18,6,29,55,52.7,26,36,13,23,56,110,57,2,DF,Under 20,Defender,Italy,Europe
315867,Gianluca Scamacca,ITA,West Ham,Premier League,2022,23.0,1999.0,10.3,10,5,1,3,6,2,2,100.0,0,3,0,3,4,14,5,0,FW,20-24,Forward,Italy,Europe
473050,Kevin Schade,GER,Brentford,Premier League,2022,20.0,2001.0,8.1,12,8,7,2,3,5,10,50.0,5,7,0,7,4,16,6,0,FW,20-24,Forward,Germany,Europe
454863,Andrs Schfer,HUN,Union Berlin,Bundesliga,2022,23.0,1999.0,9.6,21,9,7,12,2,6,14,42.9,8,12,2,10,4,25,11,0,MF,20-24,Midfielder,Hungary,Europe
135343,Fabian Schr,SUI,Newcastle Utd,Premier League,2022,30.0,1991.0,35.6,47,22,31,13,3,24,39,61.5,15,34,19,15,52,99,139,0,DF,30-34,Defender,Switzerland,Europe
223979,Xaver Schlager,AUT,RB Leipzig,Bundesliga,2022,24.0,1997.0,16.7,41,24,13,26,2,20,43,46.5,23,19,2,17,17,58,23,0,MF,20-24,Midfielder,Austria,Europe
388198,Nico Schlotterbeck,GER,Dortmund,Bundesliga,2022,22.0,1999.0,25.0,59,34,34,24,1,37,53,69.8,16,38,21,17,32,91,71,1,DF,20-24,Defender,Germany,Europe
346853,Romano Schmid,AUT,Werder Bremen,Bundesliga,2022,22.0,2000.0,16.9,24,15,5,13,6,10,22,45.5,12,21,3,18,7,31,12,0,"MF,FW",20-24,Midfielder,Austria,Europe
275249,Niklas Schmidt,GER,Werder Bremen,Bundesliga,2022,24.0,1998.0,12.1,25,10,12,11,2,13,28,46.4,15,10,0,10,5,30,12,0,MF,20-24,Midfielder,Germany,Europe
160968,Benno Schmitz,GER,Kln,Bundesliga,2022,27.0,1994.0,26.9,64,42,31,28,5,42,82,51.2,40,34,4,30,26,90,57,0,DF,25-29,Defender,Germany,Europe
418543,Perr Schuurs,NED,Torino,Serie A,2022,22.0,1999.0,25.8,51,25,29,17,5,14,26,53.8,12,28,16,12,28,79,102,0,DF,20-24,Defender,Netherlands,Europe
551752,Demba Seck,SEN,Torino,Serie A,2022,21.0,2001.0,5.8,5,2,3,2,0,2,3,66.7,1,3,1,2,1,6,1,0,"MF,FW",20-24,Midfielder,Senegal,Africa
183780,Paul Seguin,GER,Union Berlin,Bundesliga,2022,27.0,1995.0,7.7,17,8,9,4,4,8,18,44.4,10,6,0,6,6,23,7,0,MF,25-29,Midfielder,Germany,Europe
798404,Alidu Seidu,GHA,Clermont Foot,Ligue 1,2022,22.0,2000.0,27.3,52,31,35,14,3,31,51,60.8,20,28,14,14,52,104,50,2,DF,20-24,Defender,Ghana,Africa
178459,Davie Selke,GER,Hertha BSC,Bundesliga,2022,27.0,1995.0,3.1,2,1,1,1,0,0,1,0.0,1,3,1,2,1,3,5,0,FW,25-29,Forward,Germany,Europe
583255,Antoine Semenyo,GHA,Bournemouth,Premier League,2022,22.0,2000.0,2.9,1,0,0,0,1,1,6,16.7,5,10,1,9,2,3,4,0,"FW,MF",20-24,Forward,Ghana,Africa
216179,Stefano Sensi,ITA,Monza,Serie A,2022,26.0,1995.0,18.0,41,26,25,13,3,18,48,37.5,30,13,3,10,20,61,4,0,MF,25-29,Midfielder,Italy,Europe
261905,Suat Serdar,GER,Hertha BSC,Bundesliga,2022,25.0,1997.0,22.5,51,23,14,30,7,20,41,48.8,21,48,12,36,29,80,24,0,MF,25-29,Midfielder,Germany,Europe
340707,Leonardo Sernicola,ITA,Cremonese,Serie A,2022,25.0,1997.0,25.7,45,33,25,13,7,29,43,67.4,14,23,6,17,38,83,55,0,DF,25-29,Defender,Italy,Europe
392775,Ryan Sessegnon,ENG,Tottenham,Premier League,2022,22.0,2000.0,9.0,16,11,9,7,0,6,12,50.0,6,8,1,7,6,22,17,1,DF,20-24,Defender,England,Europe
94529,Stephan El Shaarawy,ITA,Roma,Serie A,2022,29.0,1992.0,16.9,21,9,8,10,3,6,22,27.3,16,11,1,10,15,36,11,0,"DF,MF",25-29,Defender,Italy,Europe
183288,Luke Shaw,ENG,Manchester Utd,Premier League,2022,27.0,1995.0,28.4,55,36,31,22,2,32,46,69.6,14,51,17,34,36,91,55,2,DF,25-29,Defender,England,Europe
358166,Eldor Shomurodov,UZB,Spezia,Serie A,2022,27.0,1995.0,9.0,5,5,3,1,1,2,11,18.2,9,5,1,4,3,8,4,0,FW,25-29,Forward,Uzbekistan,Asia
280387,Vincent Sierro,SUI,Toulouse,Ligue 1,2022,26.0,1995.0,7.4,19,11,9,9,1,11,29,37.9,18,12,3,9,4,23,11,1,MF,25-29,Midfielder,Switzerland,Europe
700646,Andr Silva,POR,RB Leipzig,Bundesliga,2022,26.0,1995.0,19.3,12,6,2,5,5,3,8,37.5,5,11,1,10,3,15,3,0,FW,25-29,Forward,Portugal,Europe
241641,Bernardo Silva,POR,Manchester City,Premier League,2022,27.0,1994.0,24.5,44,23,11,25,8,18,45,40.0,27,23,6,17,16,60,6,0,"MF,FW",25-29,Midfielder,Portugal,Europe
294817,Thiago Silva,BRA,Chelsea,Premier League,2022,37.0,1984.0,26.1,41,27,24,17,0,21,31,67.7,10,38,29,9,34,75,111,3,DF,35-39,Defender,Brazil,South America
776798,Abdallah Sima,SEN,Angers,Ligue 1,2022,21.0,2001.0,20.4,22,13,4,15,3,7,19,36.8,12,8,0,8,4,26,19,0,FW,20-24,Forward,Senegal,Africa
666234,Mohamed Simakan,FRA,RB Leipzig,Bundesliga,2022,22.0,2000.0,16.2,21,14,12,5,4,14,21,66.7,7,21,4,17,16,37,55,0,DF,20-24,Defender,France,Europe
282388,Giovanni Simeone,ARG,Napoli,Serie A,2022,27.0,1995.0,4.5,12,3,3,5,4,3,8,37.5,5,2,1,1,1,13,4,0,FW,25-29,Forward,Argentina,South America
274862,Moses Simon,NGA,Nantes,Ligue 1,2022,27.0,1995.0,26.1,18,9,6,7,5,7,15,46.7,8,14,1,13,11,29,3,0,"FW,MF",25-29,Forward,Nigeria,Africa
569140,Lassine Sinayoko,MLI,Auxerre,Ligue 1,2022,22.0,1999.0,17.4,33,15,14,12,7,21,40,52.5,19,12,0,12,18,51,17,0,"MF,FW",20-24,Midfielder,Mali,Africa
648779,Wilfried Singo,CIV,Torino,Serie A,2022,21.0,2000.0,22.7,27,17,14,10,3,12,19,63.2,7,15,2,13,12,39,33,1,DF,20-24,Defender,Ivory Coast,Africa
512385,Luis Sinisterra,COL,Leeds United,Premier League,2022,23.0,1999.0,9.6,21,14,8,9,4,11,18,61.1,7,11,1,10,8,29,2,0,FW,20-24,Forward,Colombia,South America
372712,Ibrahima Sissoko,MLI,Strasbourg,Ligue 1,2022,24.0,1997.0,14.6,40,22,18,17,5,22,42,52.4,20,20,6,14,10,50,19,0,MF,20-24,Midfielder,Mali,Africa
46001,Moussa Sissoko,FRA,Nantes,Ligue 1,2022,32.0,1989.0,21.3,26,16,16,7,3,12,18,66.7,6,22,5,17,16,42,17,0,MF,30-34,Midfielder,France,Europe
290587,Ellyes Skhiri,TUN,Kln,Bundesliga,2022,27.0,1995.0,31.7,79,44,29,42,8,26,66,39.4,40,52,12,40,56,135,48,0,MF,25-29,Midfielder,Tunisia,Africa
406638,Oliver Skipp,ENG,Tottenham,Premier League,2022,21.0,2000.0,16.6,34,17,18,15,1,16,33,48.5,17,17,8,9,17,51,19,1,MF,20-24,Midfielder,England,Europe
103427,Chris Smalling,ENG,Roma,Serie A,2022,32.0,1989.0,31.2,26,15,16,10,0,13,21,61.9,8,51,36,15,43,69,123,0,DF,30-34,Defender,England,Europe
163532,Adam Smith,ENG,Bournemouth,Premier League,2022,31.0,1991.0,32.7,49,29,27,19,3,29,60,48.3,31,30,13,17,25,74,81,1,DF,30-34,Defender,England,Europe
392765,Emile Smith Rowe,ENG,Arsenal,Premier League,2022,22.0,2000.0,1.9,1,1,1,0,0,1,3,33.3,2,1,0,1,0,1,2,0,"MF,FW",20-24,Midfielder,England,Europe
258889,Dominic Solanke,ENG,Bournemouth,Premier League,2022,24.0,1997.0,31.8,15,9,8,3,4,5,22,22.7,17,26,7,19,6,21,46,0,"FW,MF",20-24,Forward,England,Europe
293194,Borna Sosa,CRO,Stuttgart,Bundesliga,2022,24.0,1998.0,21.7,27,21,18,8,1,21,32,65.6,11,20,5,15,19,46,37,0,DF,20-24,Defender,Croatia,Europe
354726,Florian Sotoca,FRA,Lens,Ligue 1,2022,31.0,1990.0,33.9,39,19,11,17,11,15,40,37.5,25,41,2,39,29,68,51,0,"MF,FW",30-34,Midfielder,France,Europe
126673,Adama Soumaoro,FRA,Bologna,Serie A,2022,30.0,1992.0,20.7,25,17,11,12,2,5,7,71.4,2,18,13,5,15,40,75,1,DF,30-34,Defender,France,Europe
298091,Harry Souttar,AUS,Leicester City,Premier League,2022,23.0,1998.0,11.0,15,9,10,5,0,7,18,38.9,11,16,12,4,12,27,45,0,DF,20-24,Defender,Australia,Oceania
212723,Djibril Sow,SUI,Eint Frankfurt,Bundesliga,2022,25.0,1997.0,29.4,41,25,13,25,3,22,44,50.0,22,22,4,18,28,69,23,0,MF,25-29,Midfielder,Switzerland,Europe
371554,Kevin Spadanuda,SUI,Ajaccio,Ligue 1,2022,25.0,1997.0,11.8,29,18,15,9,5,12,33,36.4,21,18,0,18,11,40,5,0,"MF,FW",25-29,Midfielder,Switzerland,Europe
118689,Leonardo Spinazzola,ITA,Roma,Serie A,2022,29.0,1993.0,18.4,15,8,7,6,2,8,23,34.8,15,13,3,10,9,24,25,0,DF,25-29,Defender,Italy,Europe
344069,Anton Stach,GER,Mainz 05,Bundesliga,2022,23.0,1998.0,23.0,27,21,10,15,2,16,38,42.1,22,28,2,26,41,68,25,0,MF,20-24,Midfielder,Germany,Europe
289835,Jens Stage,DEN,Werder Bremen,Bundesliga,2022,25.0,1996.0,20.6,34,17,15,18,1,10,37,27.0,27,34,11,23,16,50,37,0,MF,25-29,Midfielder,Denmark,Europe
162434,Niklas Stark,GER,Werder Bremen,Bundesliga,2022,27.0,1995.0,23.1,56,36,29,24,3,27,42,64.3,15,24,13,11,37,93,110,0,DF,25-29,Defender,Germany,Europe
134425,Raheem Sterling,ENG,Chelsea,Premier League,2022,27.0,1994.0,21.0,18,10,5,4,9,8,14,57.1,6,17,0,17,2,20,5,0,"FW,MF",25-29,Forward,England,Europe
443710,Angelo Stiller,GER,Hoffenheim,Bundesliga,2022,21.0,2001.0,7.8,26,12,9,13,4,8,12,66.7,4,12,2,10,10,36,14,0,MF,20-24,Midfielder,Germany,Europe
48298,Lars Stindl,GER,Gladbach,Bundesliga,2022,33.0,1988.0,19.3,24,14,4,17,3,10,28,35.7,18,24,5,19,11,35,19,0,"FW,MF",30-34,Forward,Germany,Europe
106872,Kevin Stger,AUT,Bochum,Bundesliga,2022,28.0,1993.0,28.9,84,45,38,32,14,31,94,33.0,63,27,4,23,26,110,21,1,MF,25-29,Midfielder,Austria,Europe
186590,John Stones,ENG,Manchester City,Premier League,2022,28.0,1994.0,20.5,23,13,11,8,4,7,10,70.0,3,17,10,7,9,32,40,0,"DF,MF",25-29,Defender,England,Europe
457673,Gabriel Strefezza,BRA,Lecce,Serie A,2022,25.0,1997.0,27.1,50,24,18,20,12,27,53,50.9,26,36,3,33,16,66,15,0,"FW,MF",25-29,Forward,Brazil,South America
410708,Pascal Struijk,NED,Leeds United,Premier League,2022,22.0,1999.0,24.4,84,57,43,31,10,49,75,65.3,26,32,12,20,32,116,70,1,DF,20-24,Defender,Netherlands,Europe
59323,Cristhian Stuani,URU,Girona,La Liga,2022,35.0,1986.0,12.1,13,6,2,7,4,5,14,35.7,9,10,0,10,2,15,5,0,FW,35-39,Forward,Uruguay,South America
76746,Damin Surez,URU,Getafe,La Liga,2022,34.0,1988.0,21.6,49,33,23,19,7,26,48,54.2,22,40,0,40,15,64,36,0,"DF,MF",30-34,Defender,Uruguay,South America
295331,Isaac Success,NGA,Udinese,Serie A,2022,26.0,1996.0,20.2,8,4,2,5,1,3,8,37.5,5,13,2,11,4,12,18,0,FW,25-29,Forward,Nigeria,Africa
166601,Niklas Sle,GER,Dortmund,Bundesliga,2022,26.0,1995.0,23.5,25,19,18,3,4,14,23,60.9,9,28,19,9,17,42,53,0,DF,25-29,Defender,Germany,Europe
982267,Ibrahim Sulemana,GHA,Hellas Verona,Serie A,2022,19.0,2003.0,7.2,19,13,10,7,2,6,12,50.0,6,8,2,6,14,33,15,0,MF,Under 20,Midfielder,Ghana,Africa
746695,Kamaldeen Sulemana,GHA,Southampton,Premier League,2022,20.0,2002.0,10.7,15,9,4,7,4,4,14,28.6,10,16,0,16,6,21,6,0,"FW,MF",20-24,Forward,Ghana,Africa
474701,Crysencio Summerville,NED,Leeds United,Premier League,2022,20.0,2001.0,15.8,30,20,14,14,2,11,23,47.8,12,20,2,18,13,43,11,0,FW,20-24,Forward,Netherlands,Europe
398402,Sam Surridge,ENG,Nott'ham Forest,Premier League,2022,24.0,1998.0,3.6,5,0,1,3,1,1,4,25.0,3,5,2,3,0,5,7,0,FW,20-24,Forward,England,Europe
220878,Issiaga Sylla,GUI,Montpellier,Ligue 1,2022,28.0,1994.0,14.5,28,16,19,8,1,15,31,48.4,16,19,3,16,32,60,35,0,DF,25-29,Defender,Guinea,Africa
451276,Dominik Szoboszlai,HUN,RB Leipzig,Bundesliga,2022,21.0,2000.0,27.2,45,28,12,20,13,17,42,40.5,25,43,2,41,17,62,27,0,"MF,FW",20-24,Midfielder,Hungary,Europe
131225,Nicols Tagliafico,ARG,Lyon,Ligue 1,2022,29.0,1992.0,33.2,91,53,36,41,14,50,78,64.1,28,45,11,34,57,148,47,0,DF,25-29,Defender,Argentina,South America
196357,Jonathan Tah,GER,Leverkusen,Bundesliga,2022,26.0,1996.0,27.6,25,12,21,4,0,12,18,66.7,6,30,18,12,40,65,118,0,DF,25-29,Defender,Germany,Europe
496706,Montassar Talbi,TUN,Lorient,Ligue 1,2022,24.0,1998.0,38.0,53,25,40,13,0,22,35,62.9,13,55,34,21,40,93,190,3,DF,20-24,Defender,Tunisia,Africa
564545,Edmond Tapsoba,BFA,Leverkusen,Bundesliga,2022,23.0,1999.0,31.9,51,30,35,12,4,30,42,71.4,12,40,17,23,36,87,109,1,DF,20-24,Defender,Burkina Faso,Africa
212804,Florian Tardieu,FRA,Troyes,Ligue 1,2022,30.0,1992.0,11.2,31,20,19,12,0,12,31,38.7,19,19,4,15,23,54,15,0,MF,30-34,Midfielder,France,Europe
173504,James Tarkowski,ENG,Everton,Premier League,2022,29.0,1992.0,38.0,51,26,36,13,2,20,39,51.3,19,99,78,21,51,102,201,3,DF,25-29,Defender,England,Europe
535955,Nuno Tavares,POR,Marseille,Ligue 1,2022,22.0,2000.0,26.1,56,30,19,24,13,28,56,50.0,28,32,4,28,15,71,25,0,"DF,MF",20-24,Defender,Portugal,Europe
842338,Enzo Tchato,CMR,Montpellier,Ligue 1,2022,19.0,2002.0,12.2,26,17,14,11,1,13,22,59.1,9,17,2,15,7,33,33,0,DF,Under 20,Defender,Cameroon,Africa
413112,Aurlien Tchouamni,FRA,Real Madrid,La Liga,2022,22.0,2000.0,23.5,64,40,23,36,5,23,38,60.5,15,20,6,14,49,113,50,0,MF,20-24,Midfielder,France,Europe
255755,Alex Telles,BRA,Sevilla,La Liga,2022,29.0,1992.0,15.9,21,13,15,6,0,13,25,52.0,12,17,5,12,20,41,38,0,DF,25-29,Defender,Brazil,South America
36284,Simon Terodde,GER,Schalke 04,Bundesliga,2022,34.0,1988.0,20.3,15,8,4,7,4,3,14,21.4,11,6,2,4,6,21,9,0,FW,30-34,Forward,Germany,Europe
631007,Filippo Terracciano,ITA,Hellas Verona,Serie A,2022,19.0,2003.0,9.1,20,13,11,7,2,15,20,75.0,5,7,4,3,10,30,14,0,"DF,MF",Under 20,Defender,Italy,Europe
206746,Kenny Tete,NED,Fulham,Premier League,2022,26.0,1995.0,28.5,83,46,41,29,13,38,51,74.5,13,48,17,31,52,135,81,1,DF,25-29,Defender,Netherlands,Europe
184892,Florian Thauvin,FRA,Udinese,Serie A,2022,29.0,1993.0,6.1,2,1,0,2,0,2,13,15.4,11,5,0,5,2,4,2,0,"FW,MF",25-29,Forward,France,Europe
368891,Arthur Theate,BEL,Rennes,Ligue 1,2022,22.0,2000.0,34.7,29,19,17,8,4,17,30,56.7,13,26,14,12,30,59,114,3,DF,20-24,Defender,Belgium,Europe
472249,Jan Thielmann,GER,Kln,Bundesliga,2022,20.0,2002.0,9.7,9,8,3,4,2,2,11,18.2,9,16,3,13,9,18,7,0,FW,20-24,Forward,Germany,Europe
290593,Sada Thioub,SEN,Angers,Ligue 1,2022,27.0,1995.0,11.8,19,10,9,8,2,8,17,47.1,9,13,0,13,7,26,5,1,"DF,FW",25-29,Defender,Senegal,Africa
215977,Adrien Thomasson,FRA,Strasbourg,Ligue 1,2022,28.0,1993.0,10.4,19,9,8,6,5,9,30,30.0,21,18,0,18,3,22,2,0,MF,25-29,Midfielder,France,Europe
463618,Khphren Thuram,FRA,Nice,Ligue 1,2022,21.0,2001.0,28.3,51,25,22,23,6,19,43,44.2,24,33,13,20,38,89,34,0,MF,20-24,Midfielder,France,Europe
249565,Youri Tielemans,BEL,Leicester City,Premier League,2022,25.0,1997.0,26.0,66,39,27,30,9,23,62,37.1,39,35,8,27,28,94,24,1,MF,25-29,Midfielder,Belgium,Europe
300716,Kieran Tierney,SCO,Arsenal,Premier League,2022,25.0,1997.0,8.8,20,11,9,9,2,12,16,75.0,4,8,2,6,11,31,25,0,DF,25-29,Defender,Scotland,Europe
296879,Steffen Tigges,GER,Kln,Bundesliga,2022,24.0,1998.0,17.7,12,7,1,8,3,4,14,28.6,10,13,2,11,8,20,17,0,FW,20-24,Forward,Germany,Europe
605184,Jean-Clair Todibo,FRA,Nice,Ligue 1,2022,22.0,1999.0,31.9,76,48,54,19,3,41,56,73.2,15,41,19,22,41,117,110,2,DF,20-24,Defender,France,Europe
198516,Harry Toffolo,ENG,Nott'ham Forest,Premier League,2022,26.0,1995.0,10.4,17,8,10,4,3,10,14,71.4,4,16,8,8,10,27,33,0,DF,25-29,Defender,England,Europe
315110,Karl Toko Ekambi,CMR,Rennes,Ligue 1,2022,29.0,1992.0,10.8,3,1,1,1,1,3,9,33.3,6,5,0,5,9,12,3,0,"FW,MF",25-29,Forward,Cameroon,Africa
190393,Corentin Tolisso,FRA,Lyon,Ligue 1,2022,27.0,1994.0,22.6,44,27,16,23,5,25,66,37.9,41,25,5,20,24,68,23,1,MF,25-29,Midfielder,France,Europe
72441,Rafael Toli,ITA,Atalanta,Serie A,2022,31.0,1990.0,30.9,69,44,37,32,0,35,64,54.7,29,42,18,24,57,126,88,1,DF,30-34,Defender,Italy,Europe
616344,Tiago Toms,POR,Stuttgart,Bundesliga,2022,20.0,2002.0,14.3,10,4,2,4,4,8,13,61.5,5,9,2,7,1,11,5,0,"FW,MF",20-24,Forward,Portugal,Europe
61592,James Tomkins,ENG,Crystal Palace,Premier League,2022,33.0,1989.0,3.8,4,2,2,1,1,1,3,33.3,2,3,2,1,5,9,19,0,DF,30-34,Defender,England,Europe
303254,Fikayo Tomori,ENG,Milan,Serie A,2022,24.0,1997.0,30.7,70,34,44,25,1,22,34,64.7,12,46,25,21,29,99,88,1,DF,20-24,Defender,England,Europe
397033,Sandro Tonali,ITA,Milan,Serie A,2022,22.0,2000.0,30.1,64,41,35,24,5,27,44,61.4,17,34,9,25,25,89,26,1,MF,20-24,Midfielder,Italy,Europe
251664,Ivan Toney,ENG,Brentford,Premier League,2022,26.0,1996.0,32.8,23,13,4,9,10,7,23,30.4,16,24,9,15,14,37,36,0,FW,25-29,Forward,England,Europe
216181,Almamy Tour,MLI,Eint Frankfurt,Bundesliga,2022,26.0,1996.0,4.4,13,7,7,5,1,5,9,55.6,4,9,2,7,10,23,8,0,DF,25-29,Defender,Mali,Africa
229853,Birama Tour,MLI,Auxerre,Ligue 1,2022,30.0,1992.0,37.8,80,47,35,35,10,34,93,36.6,59,54,9,45,67,147,49,0,MF,30-34,Midfielder,Mali,Africa
353948,Lucas Tousart,FRA,Hertha BSC,Bundesliga,2022,25.0,1997.0,32.7,73,38,35,28,10,27,60,45.0,33,42,6,36,48,121,75,1,MF,25-29,Midfielder,France,Europe
297070,Hamari Traor,MLI,Rennes,Ligue 1,2022,30.0,1992.0,28.1,48,32,26,15,7,28,52,53.8,24,33,7,26,38,86,64,0,DF,30-34,Defender,Mali,Africa
75921,Christopher Trimmel,AUT,Union Berlin,Bundesliga,2022,35.0,1987.0,20.1,31,16,16,12,3,20,31,64.5,11,14,1,13,25,56,48,0,DF,35-39,Defender,Austria,Europe
95810,Kieran Trippier,ENG,Newcastle Utd,Premier League,2022,31.0,1990.0,37.1,71,49,36,27,8,46,90,51.1,44,45,15,30,43,114,84,2,DF,30-34,Defender,England,Europe
144028,Leandro Trossard,BEL,Arsenal,Premier League,2022,27.0,1994.0,10.3,12,7,4,2,6,6,18,33.3,12,18,0,18,6,18,3,1,FW,25-29,Forward,Belgium,Europe
654539,Adrien Truffert,FRA,Rennes,Ligue 1,2022,20.0,2001.0,21.7,62,32,36,17,9,31,46,67.4,15,32,8,24,22,84,55,0,DF,20-24,Defender,France,Europe
392545,Frank Tsadjout,ITA,Cremonese,Serie A,2022,23.0,1999.0,11.7,10,8,3,6,1,3,9,33.3,6,7,1,6,8,18,9,0,FW,20-24,Forward,Italy,Europe
73943,Alessandro Tuia,ITA,Lecce,Serie A,2022,32.0,1990.0,5.7,10,6,6,4,0,3,9,33.3,6,3,1,2,15,25,29,0,DF,30-34,Defender,Italy,Europe
546213,Tuta,BRA,Eint Frankfurt,Bundesliga,2022,23.0,1999.0,30.2,53,35,27,19,7,33,57,57.9,24,47,14,33,49,102,134,2,DF,20-24,Defender,Brazil,South America
556385,Destiny Udogie,ITA,Udinese,Serie A,2022,19.0,2002.0,30.0,71,45,42,24,5,34,59,57.6,25,34,6,28,36,107,25,0,DF,Under 20,Defender,Italy,Europe
711999,Lesley Ugochukwu,FRA,Rennes,Ligue 1,2022,18.0,2004.0,14.8,36,19,13,20,3,16,24,66.7,8,24,10,14,21,57,16,0,MF,Under 20,Midfielder,France,Europe
251106,Enes nal,TUR,Getafe,La Liga,2022,25.0,1997.0,33.0,26,14,5,19,2,7,25,28.0,18,19,2,17,6,32,35,0,FW,25-29,Forward,Turkey,Asia
339314,Deniz Undav,GER,Brighton,Premier League,2022,26.0,1996.0,7.0,7,4,2,2,3,2,8,25.0,6,4,1,3,0,7,1,0,"FW,MF",25-29,Forward,Germany,Europe
344695,Dayot Upamecano,FRA,Bayern Munich,Bundesliga,2022,23.0,1998.0,26.1,65,37,43,22,0,28,45,62.2,17,26,6,20,27,92,71,4,DF,20-24,Defender,France,Europe
448258,Josha Vagnoman,GER,Stuttgart,Bundesliga,2022,21.0,2000.0,16.4,26,15,12,11,3,15,27,55.6,12,20,2,18,8,34,29,1,DF,20-24,Defender,Germany,Europe
445126,Emanuele Valeri,ITA,Cremonese,Serie A,2022,23.0,1998.0,30.9,54,27,29,21,4,29,69,42.0,40,17,3,14,22,76,44,1,DF,20-24,Defender,Italy,Europe
369081,Federico Valverde,URU,Real Madrid,La Liga,2022,24.0,1998.0,27.8,31,20,14,11,6,13,26,50.0,13,31,4,27,17,48,15,0,"MF,FW",20-24,Midfielder,Uruguay,South America
139208,Virgil van Dijk,NED,Liverpool,Premier League,2022,31.0,1991.0,31.5,27,14,13,11,3,8,19,42.1,11,24,16,8,31,58,138,3,DF,30-34,Defender,Netherlands,Europe
789082,Vanderson,BRA,Monaco,Ligue 1,2022,21.0,2001.0,24.6,84,48,36,34,14,44,75,58.7,31,36,9,27,48,132,36,1,"DF,MF",20-24,Defender,Brazil,South America
197838,Jamie Vardy,ENG,Leicester City,Premier League,2022,35.0,1987.0,20.6,9,5,4,2,3,1,8,12.5,7,17,3,14,2,11,30,0,FW,35-39,Forward,England,Europe
532937,Johan Vsquez,MEX,Cremonese,Serie A,2022,23.0,1998.0,20.1,41,26,34,7,0,18,39,46.2,21,27,20,7,45,86,93,1,DF,20-24,Defender,Mexico,North America
111195,Jol Veltman,NED,Brighton,Premier League,2022,30.0,1992.0,24.3,62,32,44,14,4,37,57,64.9,20,27,8,19,19,81,51,0,DF,30-34,Defender,Netherlands,Europe
240219,Lorenzo Venuti,ITA,Fiorentina,Serie A,2022,27.0,1995.0,10.3,18,7,6,11,1,11,18,61.1,7,7,2,5,5,23,17,2,DF,25-29,Defender,Italy,Europe
256361,Daniele Verde,ITA,Spezia,Serie A,2022,26.0,1996.0,11.1,4,4,3,0,1,3,7,42.9,4,6,0,6,8,12,4,0,"FW,MF",25-29,Forward,Italy,Europe
130360,Simone Verdi,ITA,Hellas Verona,Serie A,2022,30.0,1992.0,12.2,15,10,7,5,3,6,17,35.3,11,8,1,7,0,15,2,0,"MF,FW",30-34,Midfielder,Italy,Europe
164771,Jordan Veretout,FRA,Marseille,Ligue 1,2022,29.0,1993.0,31.8,56,35,17,32,7,25,53,47.2,28,22,7,15,36,92,40,2,MF,25-29,Midfielder,France,Europe
162961,Valerio Verre,ITA,Sampdoria,Serie A,2022,28.0,1994.0,7.5,14,7,6,5,3,8,17,47.1,9,9,1,8,9,23,3,0,MF,25-29,Midfielder,Italy,Europe
569388,Clment Vidal,FRA,Ajaccio,Ligue 1,2022,22.0,2000.0,21.1,25,15,14,11,0,18,38,47.4,20,27,16,11,27,52,73,1,"DF,MF",20-24,Defender,France,Europe
525287,Carlos Vincius,BRA,Fulham,Premier League,2022,27.0,1995.0,12.3,4,1,0,2,2,0,4,0.0,4,7,0,7,0,4,10,0,FW,25-29,Forward,Brazil,South America
654415,Alan Virginius,FRA,Lille,Ligue 1,2022,19.0,2003.0,2.9,3,2,1,1,1,0,4,0.0,4,0,0,0,2,5,1,0,FW,Under 20,Forward,France,Europe
586853,Vitinha,POR,Marseille,Ligue 1,2022,22.0,2000.0,5.2,15,7,0,6,9,3,11,27.3,8,3,0,3,2,17,6,0,FW,20-24,Forward,Portugal,Europe
293200,Nikola Vlai,CRO,Torino,Serie A,2022,24.0,1997.0,30.3,32,21,9,16,7,15,34,44.1,19,25,2,23,10,42,14,0,"MF,FW",20-24,Midfielder,Croatia,Europe
82009,Kevin Volland,GER,Monaco,Ligue 1,2022,30.0,1992.0,7.1,8,4,1,5,2,2,8,25.0,6,8,0,8,2,10,0,0,"FW,MF",30-34,Forward,Germany,Europe
746891,Cristian Volpato,ITA,Roma,Serie A,2022,18.0,2003.0,2.5,3,2,1,1,1,0,2,0.0,2,2,0,2,2,5,0,0,MF,Under 20,Midfielder,Italy,Europe
111196,Stefan de Vrij,NED,Inter,Serie A,2022,30.0,1992.0,21.6,28,18,19,9,0,8,14,57.1,6,18,10,8,40,68,80,0,DF,30-34,Defender,Netherlands,Europe
659542,Elye Wahi,FRA,Montpellier,Ligue 1,2022,19.0,2003.0,27.9,9,3,2,3,4,5,14,35.7,9,14,2,12,3,12,5,0,FW,Under 20,Forward,France,Europe
323954,Walace,BRA,Udinese,Serie A,2022,27.0,1995.0,35.4,82,39,42,31,9,41,90,45.6,49,47,12,35,51,133,51,1,MF,25-29,Midfielder,Brazil,South America
33713,Theo Walcott,ENG,Southampton,Premier League,2022,33.0,1989.0,12.5,13,6,8,4,1,8,27,29.6,19,8,1,7,9,22,7,0,"FW,MF",30-34,Forward,England,Europe
196095,Luca Waldschmidt,GER,Wolfsburg,Bundesliga,2022,26.0,1996.0,5.8,5,2,2,1,2,2,10,20.0,8,6,0,6,3,8,5,0,"FW,MF",25-29,Forward,Germany,Europe
95424,Kyle Walker,ENG,Manchester City,Premier League,2022,32.0,1990.0,21.8,13,9,8,5,0,4,24,16.7,20,12,2,10,18,31,22,0,DF,30-34,Defender,England,Europe
341051,Kyle Walker-Peters,ENG,Southampton,Premier League,2022,25.0,1997.0,29.4,61,32,34,24,3,22,43,51.2,21,47,8,39,27,88,52,0,DF,25-29,Defender,England,Europe
477758,Aaron Wan-Bissaka,ENG,Manchester Utd,Premier League,2022,24.0,1997.0,15.9,40,25,20,17,3,23,25,92.0,2,24,8,16,22,62,41,0,DF,20-24,Defender,England,Europe
92572,Joel Ward,ENG,Crystal Palace,Premier League,2022,32.0,1989.0,25.1,50,36,30,11,9,30,41,73.2,11,32,16,16,25,75,80,1,DF,30-34,Defender,England,Europe
181579,James Ward-Prowse,ENG,Southampton,Premier League,2022,27.0,1994.0,37.5,65,37,31,27,7,21,61,34.4,40,30,10,20,55,120,48,0,MF,25-29,Midfielder,England,Europe
324358,Ollie Watkins,ENG,Aston Villa,Premier League,2022,26.0,1995.0,34.7,19,13,3,13,3,10,27,37.0,17,21,4,17,10,29,39,0,FW,25-29,Forward,England,Europe
370846,Timothy Weah,USA,Lille,Ligue 1,2022,22.0,2000.0,19.4,24,14,13,9,2,16,29,55.2,13,17,3,14,23,47,18,0,"DF,FW",20-24,Defender,United States,North America
212847,Adam Webster,ENG,Brighton,Premier League,2022,27.0,1995.0,22.1,22,12,10,9,3,11,19,57.9,8,30,19,11,19,41,55,4,DF,25-29,Defender,England,Europe
392163,Noah Weihaupt,GER,Freiburg,Bundesliga,2022,20.0,2001.0,4.7,11,6,3,7,1,2,7,28.6,5,4,0,4,6,17,8,0,"MF,DF",20-24,Midfielder,Germany,Europe
247652,Shon Weissman,ISR,Valladolid,La Liga,2022,26.0,1996.0,8.3,2,1,1,1,0,0,4,0.0,4,8,0,8,1,3,7,0,FW,25-29,Forward,Israel,Asia
67063,Danny Welbeck,ENG,Brighton,Premier League,2022,31.0,1990.0,20.6,15,7,0,7,8,4,11,36.4,7,24,2,22,5,20,20,0,FW,30-34,Forward,England,Europe
170527,Timo Werner,GER,RB Leipzig,Bundesliga,2022,26.0,1996.0,21.5,10,5,4,3,3,4,12,33.3,8,12,0,12,7,17,5,0,"FW,MF",25-29,Forward,Germany,Europe
335721,Ben White,ENG,Arsenal,Premier League,2022,24.0,1997.0,33.9,60,31,23,30,7,42,70,60.0,28,47,11,36,22,82,79,1,DF,20-24,Defender,England,Europe
168989,Silvan Widmer,SUI,Mainz 05,Bundesliga,2022,29.0,1993.0,18.8,26,17,15,10,1,20,39,51.3,19,22,8,14,31,57,28,0,DF,25-29,Defender,Switzerland,Europe
49499,Georginio Wijnaldum,NED,Roma,Serie A,2022,31.0,1990.0,8.5,4,3,1,3,0,0,2,0.0,2,7,1,6,2,6,3,0,MF,30-34,Midfielder,Netherlands,Europe
255508,Iaki Williams,GHA,Athletic Club,La Liga,2022,28.0,1994.0,31.5,22,16,5,14,3,9,24,37.5,15,18,3,15,7,29,34,0,FW,25-29,Forward,Ghana,Africa
503680,Neco Williams,WAL,Nott'ham Forest,Premier League,2022,21.0,2001.0,20.9,72,47,49,17,6,38,71,53.5,33,33,8,25,33,105,48,0,DF,20-24,Defender,Wales,Europe
55338,Willian,BRA,Fulham,Premier League,2022,33.0,1988.0,23.6,13,8,8,3,2,7,25,28.0,18,13,0,13,9,22,9,0,FW,30-34,Forward,Brazil,South America
340329,Joe Willock,ENG,Newcastle Utd,Premier League,2022,22.0,1999.0,28.4,51,30,13,26,12,25,58,43.1,33,54,8,46,25,76,17,0,MF,20-24,Midfielder,England,Europe
450826,Callum Wilson,ENG,Newcastle Utd,Premier League,2022,30.0,1992.0,20.9,9,3,0,8,1,0,3,0.0,3,8,0,8,1,10,5,0,FW,30-34,Forward,England,Europe
279455,Harry Wilson,WAL,Fulham,Premier League,2022,25.0,1997.0,12.2,21,13,9,9,3,8,18,44.4,10,17,2,15,6,27,14,0,FW,25-29,Forward,Wales,Europe
533295,Patrick Wimmer,AUT,Wolfsburg,Bundesliga,2022,21.0,2001.0,18.3,39,26,18,11,10,12,38,31.6,26,27,2,25,15,54,15,0,"FW,MF",20-24,Forward,Austria,Europe
391004,Jonas Wind,DEN,Wolfsburg,Bundesliga,2022,23.0,1999.0,14.3,14,6,2,7,5,5,10,50.0,5,14,4,10,1,15,10,0,FW,20-24,Forward,Denmark,Europe
598577,Florian Wirtz,GER,Leverkusen,Bundesliga,2022,19.0,2003.0,12.1,18,10,9,7,2,8,16,50.0,8,15,1,14,1,19,6,0,"FW,MF",Under 20,Forward,Germany,Europe
388165,Yoane Wissa,COD,Brentford,Premier League,2022,25.0,1996.0,17.8,17,12,4,7,6,6,13,46.2,7,10,0,10,6,23,15,0,FW,25-29,Forward,DR Congo,Africa
321070,Hannes Wolf,AUT,Gladbach,Bundesliga,2022,23.0,1999.0,5.0,11,8,4,5,2,5,13,38.5,8,3,0,3,3,14,9,0,FW,20-24,Forward,Austria,Europe
108725,Chris Wood,NZL,Newcastle Utd,Premier League,2022,30.0,1991.0,5.0,5,4,0,3,2,3,5,60.0,2,2,2,0,1,6,7,0,FW,30-34,Forward,New Zealand,Oceania
415970,Joe Worrall,ENG,Nott'ham Forest,Premier League,2022,25.0,1997.0,24.7,53,25,39,12,2,25,35,71.4,10,33,23,10,26,79,111,1,DF,25-29,Defender,England,Europe
111455,Granit Xhaka,SUI,Arsenal,Premier League,2022,29.0,1992.0,33.3,34,27,11,18,5,16,41,39.0,25,28,10,18,15,49,45,1,MF,25-29,Midfielder,Switzerland,Europe
235412,Jawad El Yamiq,MAR,Valladolid,La Liga,2022,30.0,1992.0,17.9,17,11,10,7,0,6,11,54.5,5,27,19,8,37,54,101,0,DF,30-34,Defender,Morocco,Africa
425902,Ryan Yates,ENG,Nott'ham Forest,Premier League,2022,24.0,1997.0,20.4,38,19,19,16,3,14,22,63.6,8,26,8,18,10,48,44,0,MF,20-24,Midfielder,England,Europe
589737,Kelvin Yeboah,ITA,Augsburg,Bundesliga,2022,22.0,2000.0,3.9,6,4,2,4,0,2,5,40.0,3,7,0,7,1,7,2,0,"FW,MF",20-24,Forward,Italy,Europe
717118,Darlin Yongwa,CMR,Lorient,Ligue 1,2022,21.0,2000.0,8.7,13,11,7,5,1,4,15,26.7,11,13,1,12,5,18,11,0,DF,20-24,Defender,Cameroon,Africa
14086,Ashley Young,ENG,Aston Villa,Premier League,2022,37.0,1985.0,22.6,50,27,34,15,1,37,50,74.0,13,25,11,14,21,71,65,0,DF,35-39,Defender,England,Europe
344598,Dan-Axel Zagadou,FRA,Stuttgart,Bundesliga,2022,23.0,1999.0,14.1,14,9,10,4,0,5,14,35.7,9,19,16,3,21,35,81,1,DF,20-24,Defender,France,Europe
810092,Warren Zare-Emery,FRA,Paris S-G,Ligue 1,2022,16.0,2006.0,10.3,17,10,5,10,2,8,29,27.6,21,11,0,11,12,29,17,0,"MF,DF",Under 20,Midfielder,France,Europe
407265,Luca Zanimacchia,ITA,Cremonese,Serie A,2022,24.0,1998.0,8.3,21,13,11,6,4,8,21,38.1,13,9,0,9,9,30,5,0,"MF,FW",20-24,Midfielder,Italy,Europe
392085,Nicol Zaniolo,ITA,Roma,Serie A,2022,23.0,1999.0,9.9,7,5,2,4,1,2,7,28.6,5,11,0,11,2,9,0,0,"MF,FW",20-24,Midfielder,Italy,Europe
73794,Duvn Zapata,COL,Atalanta,Serie A,2022,31.0,1991.0,15.4,8,4,1,3,4,3,5,60.0,2,6,2,4,4,12,17,1,FW,30-34,Forward,Colombia,South America
173859,Davide Zappacosta,ITA,Atalanta,Serie A,2022,30.0,1992.0,16.3,34,18,17,12,5,15,22,68.2,7,23,2,21,9,43,16,0,DF,30-34,Defender,Italy,Europe
433584,Alessio Zerbin,ITA,Napoli,Serie A,2022,23.0,1999.0,2.2,10,5,4,5,1,4,8,50.0,4,2,0,2,2,12,2,0,FW,20-24,Forward,Italy,Europe
203853,Oleksandr Zinchenko,UKR,Arsenal,Premier League,2022,25.0,1996.0,23.5,40,18,14,17,9,21,40,52.5,19,20,2,18,22,62,38,2,DF,25-29,Defender,Ukraine,Europe
435648,Joshua Zirkzee,NED,Bologna,Serie A,2022,21.0,2001.0,9.1,4,2,1,1,2,2,7,28.6,5,4,1,3,4,8,4,0,FW,20-24,Forward,Netherlands,Europe
79967,Simon Zoller,GER,Bochum,Bundesliga,2022,31.0,1991.0,16.2,11,4,2,8,1,4,12,33.3,8,14,1,13,6,17,21,0,FW,30-34,Forward,Germany,Europe
392966,Nadir Zortea,ITA,Atalanta,Serie A,2022,23.0,1999.0,2.5,10,5,3,7,0,3,4,75.0,1,4,0,4,0,10,4,0,"DF,MF",20-24,Defender,Italy,Europe
157509,Kurt Zouma,FRA,West Ham,Premier League,2022,27.0,1994.0,22.1,9,4,4,5,0,5,8,62.5,3,17,14,3,30,39,120,1,DF,25-29,Defender,France,Europe
126729,Patric,ESP,Lazio,Serie A,2022,29.0,1993.0,15.7,17,11,12,3,2,11,16,68.8,5,17,12,5,11,28,53,1,DF,25-29,Defender,Spain,Europe
356197,Alfonso Pedraza,ESP,Villarreal,La Liga,2022,26.0,1996.0,18.1,35,26,20,10,5,19,29,65.5,10,19,1,18,18,53,31,0,DF,25-29,Defender,Spain,Europe
683840,Pedri,ESP,Barcelona,La Liga,2022,19.0,2002.0,22.0,39,22,15,17,7,13,45,28.9,32,27,0,27,13,52,8,1,MF,Under 20,Midfielder,Spain,Europe
1004741,Pedro,ESP,Lazio,Serie A,2022,35.0,1987.0,21.1,35,24,14,10,11,11,30,36.7,19,18,2,16,6,41,4,1,FW,35-39,Forward,Spain,Europe
238868,Rubn Pea,ESP,Osasuna,La Liga,2022,31.0,1991.0,14.2,32,18,10,18,4,20,41,48.8,21,23,8,15,17,49,31,0,"DF,MF",30-34,Defender,Spain,Europe
246968,Ayoze Prez,ESP,Leicester City,Premier League,2022,29.0,1993.0,4.2,11,8,5,4,2,8,19,42.1,11,6,0,6,2,13,3,0,"MF,FW",25-29,Midfielder,Spain,Europe
282810,Carles Prez,ESP,Celta Vigo,La Liga,2022,24.0,1998.0,23.8,39,23,12,17,10,22,66,33.3,44,29,3,26,6,45,9,0,"MF,FW",20-24,Midfielder,Spain,Europe
527698,Kike Prez,ESP,Valladolid,La Liga,2022,25.0,1997.0,25.6,67,33,30,32,5,25,68,36.8,43,26,7,19,20,87,28,0,MF,25-29,Midfielder,Spain,Europe
221309,scar Plano,ESP,Valladolid,La Liga,2022,31.0,1991.0,22.6,40,25,9,17,14,12,37,32.4,25,26,2,24,29,69,23,0,"FW,MF",30-34,Forward,Spain,Europe
553875,Pedro Porro,ESP,Tottenham,Premier League,2022,22.0,1999.0,12.6,25,16,8,15,2,14,39,35.9,25,25,2,23,15,40,24,1,"DF,MF",20-24,Defender,Spain,Europe
138803,Francisco Portillo,ESP,Almera,La Liga,2022,32.0,1990.0,8.0,13,6,4,5,4,3,16,18.8,13,7,1,6,7,20,8,0,"MF,FW",30-34,Midfielder,Spain,Europe
99353,Portu,ESP,Getafe,La Liga,2022,30.0,1992.0,19.7,28,21,14,10,4,18,42,42.9,24,23,3,20,17,45,20,1,"MF,DF",30-34,Midfielder,Spain,Europe
408471,Javi Puado,ESP,Espanyol,La Liga,2022,24.0,1998.0,26.0,20,11,12,5,3,12,28,42.9,16,12,2,10,10,30,14,0,"FW,MF",20-24,Forward,Spain,Europe
536030,Arnau Puigmal,ESP,Almera,La Liga,2022,21.0,2001.0,8.5,22,14,10,7,5,12,17,70.6,5,7,0,7,11,33,6,0,"MF,FW",20-24,Midfielder,Spain,Europe
245078,Nemanja Radonji,SRB,Torino,Serie A,2022,26.0,1996.0,16.2,2,1,2,0,0,0,4,0.0,4,3,0,3,2,4,4,0,"MF,FW",25-29,Midfielder,Serbia,Europe
538810,Chris Ramos,ESP,Cdiz,La Liga,2022,25.0,1997.0,7.9,12,9,2,7,3,4,11,36.4,7,8,3,5,1,13,19,0,FW,25-29,Forward,Spain,Europe
25557,Sergio Ramos,ESP,Paris S-G,Ligue 1,2022,36.0,1986.0,30.0,34,26,14,18,2,23,44,52.3,21,29,13,16,34,68,93,3,DF,35-39,Defender,Spain,Europe
268178,Arkadiusz Reca,POL,Spezia,Serie A,2022,27.0,1995.0,24.1,44,28,22,12,10,19,32,59.4,13,21,5,16,24,68,54,0,DF,25-29,Defender,Poland,Europe
282429,Sergio Reguiln,ESP,Atltico Madrid,La Liga,2022,25.0,1996.0,3.4,7,5,5,2,0,5,7,71.4,2,3,0,3,2,9,4,0,DF,25-29,Defender,Spain,Europe
249513,Diego Rico,ESP,Real Sociedad,La Liga,2022,29.0,1993.0,18.3,35,21,17,11,7,12,27,44.4,15,18,5,13,20,55,51,1,DF,25-29,Defender,Spain,Europe
85370,Sergi Roberto,ESP,Barcelona,La Liga,2022,30.0,1992.0,14.5,22,15,12,6,4,7,18,38.9,11,15,7,8,11,33,16,0,"DF,MF",30-34,Defender,Spain,Europe
51510,ngel Rodrguez,ESP,Mallorca,La Liga,2022,35.0,1987.0,4.4,1,1,0,1,0,0,2,0.0,2,3,0,3,1,2,1,0,"FW,MF",35-39,Forward,Spain,Europe
834470,Dani Rodrguez,ESP,Mallorca,La Liga,2022,34.0,1988.0,23.3,42,23,18,22,2,21,46,45.7,25,31,8,23,21,63,14,0,MF,30-34,Midfielder,Spain,Europe
378139,Aitor Ruibal,ESP,Betis,La Liga,2022,26.0,1996.0,16.2,47,29,35,9,3,31,58,53.4,27,17,2,15,24,71,41,0,"DF,FW",25-29,Defender,Spain,Europe
370789,Julian Ryerson,NOR,Union Berlin,Bundesliga,2022,24.0,1997.0,11.5,28,17,17,10,1,15,25,60.0,10,15,3,12,12,40,19,0,DF,20-24,Defender,Norway,Europe
307519,Fede San Emeterio,ESP,Cdiz,La Liga,2022,25.0,1997.0,20.5,41,22,23,16,2,22,46,47.8,24,34,14,20,17,58,28,0,MF,25-29,Midfielder,Spain,Europe
571020,Oihan Sancet,ESP,Athletic Club,La Liga,2022,22.0,2000.0,28.1,27,16,2,19,6,11,37,29.7,26,10,0,10,4,31,9,1,MF,20-24,Midfielder,Spain,Europe
513031,Antonio Snchez,ESP,Mallorca,La Liga,2022,25.0,1997.0,12.0,19,8,13,4,2,10,34,29.4,24,18,0,18,22,41,14,1,"MF,DF",25-29,Midfielder,Spain,Europe
221311,Ivn Snchez,ESP,Valladolid,La Liga,2022,29.0,1992.0,12.8,20,14,8,8,4,10,27,37.0,17,14,1,13,8,28,4,0,"MF,FW",25-29,Midfielder,Spain,Europe
340853,Javi Snchez,ESP,Valladolid,La Liga,2022,25.0,1997.0,26.6,43,26,27,15,1,17,26,65.4,9,32,22,10,46,89,116,0,DF,25-29,Defender,Spain,Europe
74230,Pablo Sarabia,ESP,Wolves,Premier League,2022,30.0,1992.0,8.5,12,6,4,5,3,6,15,40.0,9,7,0,7,2,14,4,0,"FW,MF",30-34,Forward,Spain,Europe
242086,Patrik Schick,CZE,Leverkusen,Bundesliga,2022,26.0,1996.0,10.5,0,0,0,0,0,0,1,0.0,1,4,1,3,1,1,7,0,FW,25-29,Forward,Czech Republic,Europe
86759,David Silva,ESP,Real Sociedad,La Liga,2022,36.0,1986.0,21.5,36,21,11,18,7,11,19,57.9,8,17,2,15,15,51,16,0,MF,35-39,Midfielder,Spain,Europe
85383,Rubn Sobrino,ESP,Cdiz,La Liga,2022,30.0,1992.0,27.4,55,37,29,17,9,23,56,41.1,33,33,3,30,24,79,20,1,"MF,FW",30-34,Midfielder,Spain,Europe
431811,Ola Solbakken,NOR,Roma,Serie A,2022,23.0,1998.0,5.6,2,2,1,1,0,2,7,28.6,5,2,0,2,2,4,8,0,"MF,FW",20-24,Midfielder,Norway,Europe
372246,Carlos Soler,ESP,Valencia,La Liga,2022,25.0,1997.0,2.7,2,0,0,1,1,2,3,66.7,1,1,0,1,0,2,2,0,MF,25-29,Midfielder,Spain,Europe
183841,Petar Stojanovi,SVN,Empoli,Serie A,2022,26.0,1995.0,17.0,42,22,28,10,4,26,43,60.5,17,17,5,12,11,53,55,0,DF,25-29,Defender,Slovenia,Europe
429983,Jrgen Strand Larsen,NOR,Celta Vigo,La Liga,2022,22.0,2000.0,18.9,15,7,3,5,7,7,30,23.3,23,14,5,9,3,18,24,0,FW,20-24,Forward,Norway,Europe
165007,Denis Surez,ESP,Espanyol,La Liga,2022,28.0,1994.0,10.5,26,20,12,12,2,13,45,28.9,32,11,1,10,5,31,4,0,"MF,FW",25-29,Midfielder,Spain,Europe
111961,Suso,ESP,Sevilla,La Liga,2022,28.0,1993.0,11.8,16,10,5,7,4,10,22,45.5,12,7,1,6,2,18,3,0,"MF,FW",25-29,Midfielder,Spain,Europe
226524,Morten Thorsby,NOR,Union Berlin,Bundesliga,2022,26.0,1996.0,9.3,22,10,9,11,2,13,21,61.9,8,11,5,6,3,25,20,0,MF,25-29,Midfielder,Norway,Europe
564785,Kristian Thorstvedt,NOR,Sassuolo,Serie A,2022,23.0,1999.0,12.6,16,7,4,9,3,6,17,35.3,11,19,5,14,14,30,13,0,MF,20-24,Midfielder,Norway,Europe
214775,liver Torres,ESP,Sevilla,La Liga,2022,27.0,1994.0,23.7,39,23,12,13,14,18,59,30.5,41,26,5,21,10,49,10,0,"MF,FW",25-29,Midfielder,Spain,Europe
399776,Pau Torres,ESP,Villarreal,La Liga,2022,25.0,1997.0,33.9,43,25,25,13,5,23,36,63.9,13,36,27,9,13,56,146,3,DF,25-29,Defender,Spain,Europe
213670,Lucas Torr,ESP,Osasuna,La Liga,2022,28.0,1994.0,27.5,48,32,28,15,5,18,42,42.9,24,24,3,21,42,90,64,1,MF,25-29,Midfielder,Spain,Europe
364405,Adama Traor,ESP,Wolves,Premier League,2022,26.0,1996.0,16.6,14,7,7,4,3,4,9,44.4,5,8,1,7,3,17,17,0,"FW,MF",25-29,Forward,Spain,Europe
517753,scar Valentn,ESP,Rayo Vallecano,La Liga,2022,27.0,1994.0,28.4,92,51,29,50,13,46,121,38.0,75,60,9,51,44,136,30,0,MF,25-29,Midfielder,Spain,Europe
221316,Lucas Vzquez,ESP,Real Madrid,La Liga,2022,31.0,1991.0,12.7,34,23,22,10,2,20,28,71.4,8,10,0,10,7,41,13,0,DF,30-34,Defender,Spain,Europe
88490,Aleix Vidal,ESP,Espanyol,La Liga,2022,32.0,1989.0,11.4,11,5,6,3,2,4,22,18.2,18,21,2,19,15,26,14,0,"MF,FW",30-34,Midfielder,Spain,Europe
216870,Nacho Vidal,ESP,Osasuna,La Liga,2022,27.0,1995.0,13.9,27,14,16,6,5,17,32,53.1,15,17,4,13,19,46,33,1,DF,25-29,Defender,Spain,Europe
357498,Duan Vlahovi,SRB,Juventus,Serie A,2022,22.0,2000.0,21.4,11,6,0,7,4,4,10,40.0,6,10,3,7,3,14,8,1,FW,20-24,Forward,Serbia,Europe
345458,Sebastian Walukiewicz,POL,Empoli,Serie A,2022,22.0,2000.0,6.7,9,6,7,2,0,4,6,66.7,2,10,9,1,7,16,30,0,DF,20-24,Defender,Poland,Europe
709187,Nico Williams,ESP,Athletic Club,La Liga,2022,20.0,2002.0,29.5,31,16,10,15,6,19,41,46.3,22,40,2,38,8,39,14,1,FW,20-24,Forward,Spain,Europe
57482,Mohamed Youssouf,COM,Ajaccio,Ligue 1,2022,34.0,1988.0,27.3,72,44,41,24,7,38,61,62.3,23,32,8,24,65,137,70,0,DF,30-34,Defender,Comoros,Africa
550108,Nicola Zalewski,POL,Roma,Serie A,2022,20.0,2002.0,24.4,45,26,25,15,5,22,71,31.0,49,27,1,26,31,76,23,0,DF,20-24,Defender,Poland,Europe
524010,Oier Zarraga,ESP,Athletic Club,La Liga,2022,23.0,1999.0,9.5,14,9,5,7,2,8,20,40.0,12,7,0,7,10,24,5,0,MF,20-24,Midfielder,Spain,Europe
181136,Piotr Zieliski,POL,Napoli,Serie A,2022,28.0,1994.0,25.4,17,10,1,11,5,12,25,48.0,13,16,5,11,14,31,7,0,MF,25-29,Midfielder,Poland,Europe
544149,David Zima,CZE,Torino,Serie A,2022,21.0,2000.0,4.5,9,5,5,4,0,3,4,75.0,1,7,2,5,9,18,11,2,DF,20-24,Defender,Czech Republic,Europe
355628,Igor Zubeldia,ESP,Real Sociedad,La Liga,2022,25.0,1997.0,28.2,35,18,28,7,0,25,35,71.4,10,23,17,6,21,56,93,0,DF,25-29,Defender,Spain,Europe
163222,Grgoire Defrel,MTQ,Sassuolo,Serie A,2019,28.0,1991.0,10.9,12,8,4,6,2,4,15,26.7,11,9,0,9,3,15,5,0,"FW,MF",25-29,Forward,France,Europe
44421,Cdric Avinel,GLP,Ajaccio,Ligue 1,2022,35.0,1986.0,19.9,13,7,8,5,0,8,12,66.7,4,20,13,7,15,28,91,1,DF,35-39,Defender,France,Europe
163222,Grgoire Defrel,MTQ,Sassuolo,Serie A,2022,31.0,1991.0,13.0,9,7,5,2,2,4,13,30.8,9,11,0,11,2,11,5,0,FW,30-34,Forward,France,Europe
351843,Yoann Salmier,GUF,Troyes,Ligue 1,2022,29.0,1992.0,29.4,51,29,34,12,5,21,35,60.0,14,34,19,15,39,90,124,0,DF,25-29,Defender,France,Europe
336125,Mrgim Vojvoda,KVX,Torino,Serie A,2022,27.0,1995.0,19.1,22,12,15,6,1,12,24,50.0,12,14,2,12,10,32,31,1,DF,25-29,Defender,Germany,Europe
496857,Edon Zhegrova,KVX,Lille,Ligue 1,2022,23.0,1999.0,11.7,18,12,6,7,5,12,20,60.0,8,9,0,9,2,20,2,0,"FW,MF",20-24,Forward,Germany,Europe
16631,Ignazio Abate,ITA,Milan,Serie A,2018,31.0,1986.0,14.5,34,19,16,13,5,14,22,63.6,8,19,6,13,18,52,50,0,DF,30-34,Defender,Italy,Europe
199704,Yunis Abdelhamid,MAR,Reims,Ligue 1,2018,30.0,1987.0,38.0,60,33,48,11,1,30,40,75.0,10,44,24,20,65,125,196,0,DF,30-34,Defender,Morocco,Africa
58178,David Abraham,ARG,Eint Frankfurt,Bundesliga,2018,32.0,1986.0,15.8,22,14,13,8,1,11,25,44.0,14,23,12,11,24,46,64,0,DF,30-34,Defender,Argentina,South America
66005,Amir Abrashi,ALB,Freiburg,Bundesliga,2018,28.0,1990.0,8.8,20,11,7,10,3,6,19,31.6,13,11,3,8,14,34,15,0,MF,25-29,Midfielder,Albania,Europe
131075,Francesco Acerbi,ITA,Lazio,Serie A,2018,30.0,1988.0,36.8,40,30,22,13,5,12,16,75.0,4,50,32,18,61,101,169,1,DF,30-34,Defender,Italy,Europe
332705,Tyler Adams,USA,RB Leipzig,Bundesliga,2018,19.0,1999.0,8.0,29,17,12,16,1,11,26,42.3,15,17,1,16,16,45,8,0,MF,Under 20,Midfielder,United States,North America
337716,Claud Adjapong,ITA,Sassuolo,Serie A,2018,20.0,1998.0,3.0,4,2,1,3,0,1,2,50.0,1,3,1,2,1,5,4,0,"MF,FW",20-24,Midfielder,Italy,Europe
103890,Luis Advncula,PER,Rayo Vallecano,La Liga,2018,28.0,1990.0,26.5,52,38,38,12,2,21,31,67.7,10,22,2,20,19,71,60,1,DF,25-29,Defender,Peru,South America
361914,Nayef Aguerd,MAR,Dijon,Ligue 1,2018,22.0,1996.0,11.7,17,12,8,9,0,8,19,42.1,11,20,11,9,14,31,59,1,DF,20-24,Defender,Morocco,Africa
26399,Sergio Agero,ARG,Manchester City,Premier League,2018,30.0,1988.0,27.3,17,9,1,10,6,5,9,55.6,4,15,1,14,9,26,3,0,FW,30-34,Forward,Argentina,South America
203746,Ruben Aguilar,FRA,Montpellier,Ligue 1,2018,25.0,1993.0,28.1,88,51,40,33,15,39,69,56.5,30,23,3,20,37,125,50,1,DF,25-29,Defender,France,Europe
178313,Jean-Eudes Aholou,CIV,Monaco,Ligue 1,2018,24.0,1994.0,11.9,20,11,6,11,3,8,16,50.0,8,7,0,7,17,37,12,0,MF,20-24,Midfielder,Ivory Coast,Africa
236490,Ola Aina,NGA,Torino,Serie A,2018,21.0,1996.0,24.0,54,36,32,20,2,23,48,47.9,25,30,3,27,39,93,59,2,DF,20-24,Defender,Nigeria,Africa
283994,Ludovic Ajorque,FRA,Strasbourg,Ligue 1,2018,24.0,1994.0,17.0,17,13,1,10,6,4,9,44.4,5,5,0,5,5,22,9,0,FW,20-24,Forward,France,Europe
225015,Carlos Akapo,EQG,Huesca,La Liga,2018,25.0,1993.0,11.4,28,15,18,8,2,19,33,57.6,14,12,2,10,23,51,36,0,DF,25-29,Defender,Equatorial Guinea,Africa
177476,Nathan Ak,NED,Bournemouth,Premier League,2018,23.0,1995.0,37.9,66,35,42,21,3,22,35,62.9,13,51,35,16,32,98,241,0,DF,20-24,Defender,Netherlands,Europe
247459,Chadrac Akolo,COD,Stuttgart,Bundesliga,2018,23.0,1995.0,5.8,9,6,2,7,0,1,3,33.3,2,7,0,7,4,13,1,0,"MF,FW",20-24,Midfielder,DR Congo,Africa
59016,David Alaba,AUT,Bayern Munich,Bundesliga,2018,26.0,1992.0,28.1,34,21,13,13,8,17,26,65.4,9,24,3,21,31,65,40,0,DF,25-29,Defender,Austria,Europe
434358,Sofiane Alakouch,MAR,Nmes,Ligue 1,2018,20.0,1998.0,21.1,81,44,44,31,6,36,63,57.1,27,15,4,11,46,127,57,0,DF,20-24,Defender,Morocco,Africa
193782,Lucas Alario,ARG,Leverkusen,Bundesliga,2018,25.0,1992.0,14.1,15,8,5,6,4,4,14,28.6,10,9,0,9,1,16,16,0,"FW,MF",25-29,Forward,Argentina,South America
314353,Trent Alexander-Arnold,ENG,Liverpool,Premier League,2018,19.0,1998.0,27.4,61,39,31,22,8,36,68,52.9,32,19,3,16,35,96,68,0,DF,Under 20,Defender,England,Europe
193130,Rachid Alioui,MAR,Nmes,Ligue 1,2018,26.0,1992.0,13.9,15,5,3,9,3,4,9,44.4,5,8,1,7,10,25,11,0,FW,25-29,Forward,Morocco,Africa
207929,Dele Alli,ENG,Tottenham,Premier League,2018,22.0,1996.0,20.3,33,19,6,14,13,5,24,20.8,19,33,5,28,19,52,20,0,MF,20-24,Midfielder,England,Europe
15951,Dani Alves,BRA,Paris S-G,Ligue 1,2018,35.0,1983.0,18.0,42,22,16,23,3,13,38,34.2,25,18,5,13,8,50,11,0,"MF,DF",35-39,Midfielder,Brazil,South America
205503,Ibrahim Amadou,FRA,Sevilla,La Liga,2018,25.0,1993.0,8.5,27,20,9,15,3,2,9,22.2,7,7,4,3,11,38,24,0,"MF,DF",25-29,Midfielder,France,Europe
137841,Romain Amalfitano,FRA,Dijon,Ligue 1,2018,28.0,1989.0,28.0,52,33,20,28,4,25,67,37.3,42,45,13,32,47,99,35,0,"MF,FW",25-29,Midfielder,France,Europe
241229,Jordan Amavi,FRA,Marseille,Ligue 1,2018,24.0,1994.0,24.2,74,50,34,26,14,35,56,62.5,21,24,8,16,46,120,93,4,DF,20-24,Defender,France,Europe
344072,Kelvin Amian,FRA,Toulouse,Ligue 1,2018,20.0,1998.0,32.0,68,45,54,12,2,20,30,66.7,10,36,13,23,36,104,113,1,DF,20-24,Defender,France,Europe
232454,Nadiem Amiri,GER,Hoffenheim,Bundesliga,2018,21.0,1996.0,8.4,14,9,8,4,2,3,13,23.1,10,11,0,11,7,21,4,0,MF,20-24,Midfielder,Germany,Europe
260827,Joachim Andersen,DEN,Sampdoria,Serie A,2018,22.0,1996.0,32.0,40,27,31,8,1,19,31,61.3,12,30,15,15,35,75,147,1,DF,20-24,Defender,Denmark,Europe
159372,Felipe Anderson,BRA,West Ham,Premier League,2018,25.0,1993.0,33.8,89,49,33,44,12,31,101,30.7,70,71,0,71,41,130,18,1,"MF,FW",25-29,Midfielder,Brazil,South America
177065,Florin Andone,ROU,Brighton,Premier League,2018,25.0,1993.0,9.8,10,2,3,4,3,1,6,16.7,5,9,1,8,3,13,12,0,FW,25-29,Forward,Romania,Europe
84301,Benjamin Andr,FRA,Rennes,Ligue 1,2018,27.0,1990.0,27.7,101,60,39,50,12,33,85,38.8,52,40,6,34,54,155,58,0,MF,25-29,Midfielder,France,Europe
55854,Cristian Ansaldi,ARG,Torino,Serie A,2018,31.0,1986.0,20.1,50,26,19,21,10,15,30,50.0,15,21,4,17,15,65,31,0,"DF,MF",30-34,Defender,Argentina,South America
193004,Waldemar Anton,GER,Hannover 96,Bundesliga,2018,22.0,1996.0,34.0,49,32,33,14,2,22,50,44.0,28,56,33,23,69,118,169,3,DF,20-24,Defender,Germany,Europe
45565,Luca Antonelli,ITA,Empoli,Serie A,2018,31.0,1987.0,8.4,13,11,4,5,4,7,17,41.2,10,19,4,15,16,29,25,1,DF,30-34,Defender,Italy,Europe
327126,Anuar,MAR,Valladolid,La Liga,2018,23.0,1995.0,12.0,33,19,15,16,2,6,14,42.9,8,14,1,13,11,44,25,1,"MF,FW",20-24,Midfielder,Morocco,Africa
19354,Dennis Aogo,GER,Stuttgart,Bundesliga,2018,31.0,1987.0,11.4,15,10,6,7,2,6,15,40.0,9,8,1,7,9,24,19,0,MF,30-34,Midfielder,Germany,Europe
395693,Houssem Aouar,ALG,Lyon,Ligue 1,2018,20.0,1998.0,34.0,63,38,28,25,10,17,61,27.9,44,33,6,27,32,95,25,3,MF,20-24,Midfielder,Algeria,Africa
346766,Guilherme Arana,BRA,Sevilla,La Liga,2018,21.0,1997.0,7.0,11,6,5,5,1,6,7,85.7,1,6,3,3,9,20,8,0,DF,20-24,Defender,Brazil,South America
89701,Charles Arnguiz,CHI,Leverkusen,Bundesliga,2018,29.0,1989.0,21.0,48,30,21,22,5,21,66,31.8,45,31,2,29,25,73,27,1,MF,25-29,Midfielder,Chile,South America
435485,Luiz Arajo,BRA,Lille,Ligue 1,2018,22.0,1996.0,8.7,23,17,8,9,6,9,24,37.5,15,6,1,5,3,26,4,0,"FW,MF",20-24,Forward,Brazil,South America
120443,Santiago Arias,COL,Atltico Madrid,La Liga,2018,26.0,1992.0,19.7,48,32,31,16,1,20,31,64.5,11,14,2,12,34,82,43,0,DF,25-29,Defender,Colombia,South America
84921,Lorenzo Ariaudo,ITA,Frosinone,Serie A,2018,29.0,1989.0,18.7,20,14,15,4,1,6,10,60.0,4,31,20,11,14,34,103,0,DF,25-29,Defender,Italy,Europe
548716,Yol Armougom,FRA,Caen,Ligue 1,2018,20.0,1998.0,20.6,31,21,20,9,2,15,29,51.7,14,9,3,6,21,52,66,0,DF,20-24,Defender,France,Europe
130765,Stuart Armstrong,SCO,Southampton,Premier League,2018,26.0,1992.0,15.9,28,20,14,6,8,8,42,19.0,34,14,0,14,12,40,12,0,MF,25-29,Midfielder,Scotland,Europe
55742,Harry Arter,IRL,Cardiff City,Premier League,2018,28.0,1989.0,22.2,62,37,27,26,9,16,46,34.8,30,33,5,28,21,83,21,2,MF,25-29,Midfielder,Republic of Ireland,Europe
63531,Kwadwo Asamoah,GHA,Inter,Serie A,2018,29.0,1988.0,29.7,44,26,22,14,8,29,51,56.9,22,21,4,17,40,84,46,1,DF,25-29,Defender,Ghana,Africa
245744,Takuma Asano,JPN,Hannover 96,Bundesliga,2018,23.0,1994.0,7.8,5,3,1,1,3,1,6,16.7,5,9,0,9,2,7,2,0,"MF,FW",20-24,Midfielder,Japan,Asia
423436,Santiago Ascacbar,ARG,Stuttgart,Bundesliga,2018,21.0,1997.0,27.0,78,50,43,29,6,34,74,45.9,40,48,10,38,43,121,34,1,MF,20-24,Midfielder,Argentina,South America
58864,Pierre-Emerick Aubameyang,GAB,Arsenal,Premier League,2018,29.0,1989.0,30.3,21,17,6,9,6,8,28,28.6,20,26,0,26,8,29,22,0,FW,25-29,Forward,Gabon,Africa
264956,Jean-Kvin Augustin,FRA,RB Leipzig,Bundesliga,2018,21.0,1997.0,5.1,2,0,0,0,2,0,1,0.0,1,6,0,6,3,5,0,0,FW,20-24,Forward,France,Europe
127032,Serge Aurier,CIV,Tottenham,Premier League,2018,25.0,1992.0,6.3,20,12,12,4,4,8,15,53.3,7,8,2,6,7,27,20,0,DF,25-29,Defender,Ivory Coast,Africa
129627,Charlie Austin,ENG,Southampton,Premier League,2018,29.0,1989.0,10.9,13,7,3,6,4,6,11,54.5,5,12,2,10,2,15,13,0,FW,25-29,Forward,England,Europe
108354,Jordan Ayew,GHA,Crystal Palace,Premier League,2018,26.0,1991.0,13.1,38,23,12,19,7,6,20,30.0,14,16,0,16,7,45,6,0,FW,25-29,Forward,Ghana,Africa
119235,Carlos Bacca,COL,Villarreal,La Liga,2018,31.0,1986.0,14.1,4,2,1,2,1,0,5,0.0,5,4,0,4,8,12,5,0,FW,30-34,Forward,Colombia,South America
463603,Benot Badiashile,FRA,Monaco,Ligue 1,2018,17.0,2001.0,19.6,25,18,18,7,0,17,25,68.0,8,12,5,7,21,46,79,2,DF,Under 20,Defender,France,Europe
4018,Daniel Baier,GER,Augsburg,Bundesliga,2018,34.0,1984.0,31.3,62,39,21,37,4,24,66,36.4,42,27,8,19,60,122,48,2,MF,30-34,Midfielder,Germany,Europe
387626,Leon Bailey,JAM,Leverkusen,Bundesliga,2018,20.0,1997.0,21.3,15,11,9,2,4,6,20,30.0,14,20,0,20,14,29,11,0,FW,20-24,Forward,Jamaica,North America
286384,Eric Bailly,CIV,Manchester Utd,Premier League,2018,24.0,1994.0,7.1,15,9,14,1,0,8,10,80.0,2,9,4,5,13,28,39,1,DF,20-24,Defender,Ivory Coast,Africa
13507,Leighton Baines,ENG,Everton,Premier League,2018,33.0,1984.0,4.2,8,6,4,3,1,4,6,66.7,2,2,0,2,2,10,8,0,DF,30-34,Defender,England,Europe
238752,Keita Bald,SEN,Inter,Serie A,2018,23.0,1995.0,9.9,10,6,4,2,4,2,9,22.2,7,8,0,8,3,13,1,0,FW,20-24,Forward,Senegal,Africa
39381,Gareth Bale,WAL,Real Madrid,La Liga,2018,29.0,1989.0,19.8,16,8,5,7,4,6,20,30.0,14,19,3,16,11,27,13,0,FW,25-29,Forward,Wales,Europe
296422,Fod Ballo-Tour,SEN,Lille,Ligue 1,2018,21.0,1997.0,17.7,47,35,26,19,2,21,32,65.6,11,25,7,18,27,74,42,2,DF,20-24,Defender,Senegal,Africa
292818,Jonathan Bamba,CIV,Lille,Ligue 1,2018,22.0,1996.0,33.4,29,19,7,17,5,13,39,33.3,26,24,1,23,41,70,18,0,"FW,MF",20-24,Forward,Ivory Coast,Africa
28984,Sol Bamba,CIV,Cardiff City,Premier League,2018,33.0,1985.0,27.5,74,42,44,30,0,31,55,56.4,24,72,32,40,82,156,181,3,DF,30-34,Defender,Ivory Coast,Africa
12249,ver Banega,ARG,Sevilla,La Liga,2018,30.0,1988.0,29.6,71,50,32,35,4,20,70,28.6,50,26,5,21,28,99,28,0,MF,30-34,Midfielder,Argentina,South America
165873,Federico Barba,ITA,Chievo,Serie A,2018,24.0,1993.0,27.6,30,14,21,9,0,8,21,38.1,13,29,15,14,65,95,129,0,DF,20-24,Defender,Italy,Europe
273438,Danilo Barbosa,BRA,Nice,Ligue 1,2018,22.0,1996.0,17.2,29,20,13,13,3,6,17,35.3,11,17,2,15,15,44,25,1,MF,20-24,Midfielder,Brazil,South America
15773,Phil Bardsley,SCO,Burnley,Premier League,2018,33.0,1985.0,18.6,32,19,15,14,3,12,21,57.1,9,25,12,13,31,63,68,1,DF,30-34,Defender,Scotland,Europe
255942,Nicol Barella,ITA,Cagliari,Serie A,2018,21.0,1997.0,34.5,99,65,38,41,20,30,82,36.6,52,61,2,59,38,137,27,0,MF,20-24,Midfielder,Italy,Europe
42033,Philipp Bargfrede,GER,Werder Bremen,Bundesliga,2018,29.0,1989.0,12.0,23,15,9,12,2,10,28,35.7,18,35,11,24,34,57,45,1,"MF,DF",25-29,Midfielder,Germany,Europe
39828,Antonino Barill,ITA,Parma,Serie A,2018,30.0,1988.0,29.1,64,36,40,17,7,19,53,35.8,34,40,13,27,36,100,50,1,MF,30-34,Midfielder,Italy,Europe
131978,Ross Barkley,ENG,Chelsea,Premier League,2018,24.0,1993.0,13.8,15,10,5,7,3,4,14,28.6,10,8,1,7,9,24,17,2,MF,20-24,Midfielder,England,Europe
63200,Ashley Barnes,ENG,Burnley,Premier League,2018,28.0,1989.0,26.5,28,17,4,17,7,6,29,20.7,23,29,8,21,2,30,25,0,FW,25-29,Forward,England,Europe
398065,Harvey Barnes,ENG,Leicester City,Premier League,2018,20.0,1997.0,11.2,10,6,5,4,1,4,6,66.7,2,7,1,6,3,13,7,0,"MF,FW",20-24,Midfielder,England,Europe
486624,Musa Barrow,GAM,Atalanta,Serie A,2018,19.0,1998.0,6.7,9,5,5,3,1,4,6,66.7,2,4,0,4,0,9,2,0,FW,Under 20,Forward,Gambia,Africa
134883,Daniele Baselli,ITA,Torino,Serie A,2018,26.0,1992.0,26.4,65,45,22,34,9,16,44,36.4,28,30,6,24,34,99,32,0,MF,25-29,Midfielder,Italy,Europe
334835,Toma Bai,CRO,Bordeaux,Ligue 1,2018,21.0,1996.0,14.8,32,16,5,21,6,11,31,35.5,20,13,1,12,9,41,22,1,MF,20-24,Midfielder,Croatia,Europe
315853,Alessandro Bastoni,ITA,Parma,Serie A,2018,19.0,1999.0,18.8,25,12,20,5,0,6,15,40.0,9,26,18,8,22,47,96,0,DF,Under 20,Defender,Italy,Europe
187491,Timo Baumgartl,GER,Stuttgart,Bundesliga,2018,22.0,1996.0,18.0,33,23,21,12,0,11,19,57.9,8,31,22,9,26,59,100,0,DF,20-24,Defender,Germany,Europe
199941,Andrea Beghetto,ITA,Frosinone,Serie A,2018,23.0,1994.0,24.7,26,14,13,10,3,15,25,60.0,10,20,4,16,17,43,59,0,DF,20-24,Defender,Italy,Europe
21905,Valon Behrami,SUI,Udinese,Serie A,2018,33.0,1985.0,15.1,65,38,25,34,6,18,44,40.9,26,29,12,17,18,83,26,0,MF,30-34,Midfielder,Switzerland,Europe
57091,Hanno Behrens,GER,Nrnberg,Bundesliga,2018,28.0,1990.0,29.3,46,26,29,17,0,21,47,44.7,26,43,13,30,33,79,49,0,MF,25-29,Midfielder,Germany,Europe
111039,Ishak Belfodil,ALG,Hoffenheim,Bundesliga,2018,26.0,1992.0,20.7,13,10,5,6,2,4,16,25.0,12,6,0,6,3,16,14,0,"FW,MF",25-29,Forward,Algeria,Africa
82350,Stefan Bell,GER,Mainz 05,Bundesliga,2018,26.0,1991.0,25.0,31,20,18,13,0,15,34,44.1,19,31,11,20,54,85,122,1,DF,25-29,Defender,Germany,Europe
61087,Karim Bellarabi,GER,Leverkusen,Bundesliga,2018,28.0,1990.0,11.7,13,6,7,4,2,3,19,15.8,16,13,0,13,10,23,8,0,FW,25-29,Forward,Germany,Europe
18900,Hatem Ben Arfa,FRA,Rennes,Ligue 1,2018,31.0,1987.0,22.6,15,7,4,8,3,7,16,43.8,9,9,0,9,4,19,0,0,"FW,MF",30-34,Forward,France,Europe
146854,Wissam Ben Yedder,FRA,Sevilla,La Liga,2018,27.0,1990.0,31.2,18,16,3,11,4,2,12,16.7,10,18,0,18,11,29,2,0,FW,25-29,Forward,France,Europe
30059,Lars Bender,GER,Leverkusen,Bundesliga,2018,29.0,1989.0,15.1,43,29,20,20,3,18,35,51.4,17,26,4,22,21,64,26,0,"MF,DF",25-29,Midfielder,Germany,Europe
29993,Sven Bender,GER,Leverkusen,Bundesliga,2018,29.0,1989.0,22.1,40,25,25,15,0,18,30,60.0,12,31,14,17,52,92,98,0,DF,25-29,Defender,Germany,Europe
164230,Nicolas Benezet,FRA,Guingamp,Ligue 1,2018,27.0,1991.0,18.5,32,19,14,15,3,5,19,26.3,14,12,0,12,19,51,4,0,"MF,FW",25-29,Midfielder,France,Europe
351816,Ismal Bennacer,ALG,Empoli,Serie A,2018,20.0,1997.0,32.9,94,57,43,41,10,32,75,42.7,43,38,9,29,57,151,34,0,MF,20-24,Midfielder,Algeria,Africa
90964,Joe Bennett,ENG,Cardiff City,Premier League,2018,28.0,1990.0,29.3,50,29,34,16,0,22,38,57.9,16,30,8,22,60,110,93,0,DF,25-29,Defender,England,Europe
67252,Ryan Bennett,ENG,Wolves,Premier League,2018,28.0,1990.0,34.0,58,32,41,16,1,25,41,61.0,16,42,21,21,43,101,131,1,DF,25-29,Defender,England,Europe
284732,Ramy Bensebaini,ALG,Rennes,Ligue 1,2018,23.0,1995.0,23.9,69,48,42,19,8,40,58,69.0,18,24,10,14,41,110,98,0,DF,20-24,Defender,Algeria,Africa
245537,Nabil Bentaleb,ALG,Schalke 04,Bundesliga,2018,23.0,1994.0,19.9,32,17,8,21,3,4,18,22.2,14,28,8,20,35,67,19,0,MF,20-24,Midfielder,Algeria,Africa
50201,Christian Benteke,BEL,Crystal Palace,Premier League,2018,27.0,1990.0,9.0,5,1,0,4,1,1,4,25.0,3,7,2,5,0,5,14,0,FW,25-29,Forward,Belgium,Europe
18922,Karim Benzema,FRA,Real Madrid,La Liga,2018,30.0,1987.0,32.8,24,11,2,11,11,2,17,11.8,15,16,1,15,8,32,25,0,FW,30-34,Forward,France,Europe
177843,Domenico Berardi,ITA,Sassuolo,Serie A,2018,23.0,1994.0,31.9,38,21,16,9,13,15,73,20.5,58,31,2,29,27,65,24,0,"FW,MF",20-24,Forward,Italy,Europe
197300,Federico Bernardeschi,ITA,Juventus,Serie A,2018,24.0,1994.0,16.4,14,8,5,6,3,7,18,38.9,11,9,0,9,6,20,10,0,"MF,FW",20-24,Midfielder,Italy,Europe
719646,Bernardo,BRA,Brighton,Premier League,2018,23.0,1995.0,19.5,62,43,43,13,6,31,45,68.9,14,32,13,19,34,96,82,0,DF,20-24,Defender,Brazil,South America
40611,Ryan Bertrand,ENG,Southampton,Premier League,2018,28.0,1989.0,24.0,46,27,22,20,4,16,31,51.6,15,27,5,22,28,74,51,0,DF,25-29,Defender,England,Europe
140757,Daniel Bessa,ITA,Genoa,Serie A,2018,25.0,1993.0,27.1,60,35,28,23,9,11,39,28.2,28,30,4,26,19,79,16,1,MF,25-29,Midfielder,Italy,Europe
403898,Jordan Beyer,GER,Gladbach,Bundesliga,2018,18.0,2000.0,8.0,32,18,21,10,1,17,24,70.8,7,12,6,6,11,43,32,0,DF,Under 20,Defender,Germany,Europe
45567,Jonathan Biabiany,FRA,Parma,Serie A,2018,30.0,1988.0,11.9,30,22,18,10,2,9,17,52.9,8,8,1,7,11,41,11,1,FW,30-34,Forward,France,Europe
320411,Philip Billing,DEN,Huddersfield,Premier League,2018,22.0,1996.0,24.3,73,44,26,39,8,19,42,45.2,23,57,16,41,53,126,43,0,MF,20-24,Midfielder,Denmark,Europe
124555,Cristiano Biraghi,ITA,Fiorentina,Serie A,2018,25.0,1992.0,35.5,52,33,31,17,4,18,38,47.4,20,40,17,23,44,96,113,0,DF,25-29,Defender,Italy,Europe
410425,Yves Bissouma,MLI,Brighton,Premier League,2018,21.0,1996.0,19.7,62,30,33,27,2,20,38,52.6,18,21,5,16,33,95,29,2,MF,20-24,Midfielder,Mali,Africa
93844,Leonardo Bittencourt,GER,Hoffenheim,Bundesliga,2018,24.0,1993.0,11.9,37,26,9,22,6,8,32,25.0,24,22,1,21,13,50,7,0,MF,20-24,Midfielder,Germany,Europe
288225,Ludovic Blas,FRA,Guingamp,Ligue 1,2018,20.0,1997.0,26.4,62,38,22,32,8,20,43,46.5,23,44,7,37,26,88,14,0,"MF,FW",20-24,Midfielder,France,Europe
236041,Alexis Blin,FRA,Amiens,Ligue 1,2018,21.0,1996.0,22.1,77,45,33,36,8,35,89,39.3,54,39,14,25,33,110,48,1,MF,20-24,Midfielder,France,Europe
26485,Jrme Boateng,GER,Bayern Munich,Bundesliga,2018,29.0,1988.0,18.8,21,15,12,9,0,10,22,45.5,12,8,3,5,25,46,49,0,DF,25-29,Defender,Germany,Europe
16922,Kevin-Prince Boateng,GHA,Sassuolo,Serie A,2018,31.0,1987.0,10.4,5,4,0,4,1,1,4,25.0,3,7,3,4,3,8,13,0,FW,30-34,Forward,Ghana,Africa
344575,Antonin Bobichon,FRA,Nmes,Ligue 1,2018,22.0,1995.0,23.9,34,16,17,12,5,16,58,27.6,42,15,3,12,15,49,13,0,MF,20-24,Midfielder,France,Europe
182574,Jean-Paul Botius,NED,Mainz 05,Bundesliga,2018,24.0,1994.0,23.6,51,32,21,25,5,16,44,36.4,28,59,2,57,37,88,13,0,MF,20-24,Midfielder,Netherlands,Europe
142310,Willy Boly,CIV,Wolves,Premier League,2018,27.0,1991.0,35.2,85,52,49,34,2,34,56,60.7,22,55,32,23,72,157,177,6,DF,25-29,Defender,Ivory Coast,Africa
57280,Giacomo Bonaventura,ITA,Milan,Serie A,2018,28.0,1989.0,7.2,6,2,2,4,0,2,7,28.6,5,3,0,3,7,13,8,0,MF,25-29,Midfielder,Italy,Europe
247377,Kevin Bonifazi,ITA,SPAL,Serie A,2018,22.0,1996.0,25.6,40,24,31,8,1,15,33,45.5,18,38,21,17,36,76,79,0,DF,20-24,Defender,Italy,Europe
236045,Denis Bouanga,GAB,Nmes,Ligue 1,2018,23.0,1994.0,29.3,52,32,21,22,9,13,61,21.3,48,24,3,21,20,72,16,0,"MF,FW",20-24,Midfielder,Gabon,Africa
77826,Ryad Boudebouz,ALG,Celta Vigo,La Liga,2018,28.0,1990.0,8.0,14,4,4,6,4,3,8,37.5,5,9,1,8,3,17,9,0,"MF,FW",25-29,Midfielder,Algeria,Africa
266359,Benjamin Bourigeaud,FRA,Rennes,Ligue 1,2018,24.0,1994.0,26.9,55,35,23,21,11,20,67,29.9,47,44,5,39,32,87,34,1,"MF,FW",20-24,Midfielder,France,Europe
187492,Julian Brandt,GER,Leverkusen,Bundesliga,2018,22.0,1996.0,29.6,27,16,13,10,4,7,43,16.3,36,27,1,26,17,44,12,1,"MF,FW",20-24,Midfielder,Germany,Europe
190338,Anthony Brianon,FRA,Nmes,Ligue 1,2018,23.0,1994.0,32.5,46,27,36,10,0,27,50,54.0,23,51,38,13,70,116,184,1,DF,20-24,Defender,France,Europe
18909,Jimmy Briand,FRA,Bordeaux,Ligue 1,2018,32.0,1985.0,27.7,14,8,2,10,2,4,24,16.7,20,14,6,8,4,18,29,0,FW,30-34,Forward,France,Europe
109110,Nicol Brighenti,ITA,Frosinone,Serie A,2018,28.0,1989.0,11.0,27,17,9,15,3,6,14,42.9,8,17,8,9,31,58,37,0,DF,25-29,Defender,Italy,Europe
323147,Enrico Brignola,ITA,Sassuolo,Serie A,2018,19.0,1999.0,1.9,2,2,2,0,0,0,2,0.0,2,0,0,0,1,3,1,0,"FW,MF",Under 20,Forward,Italy,Europe
277033,David Brooks,WAL,Bournemouth,Premier League,2018,21.0,1997.0,25.1,37,26,12,19,6,19,44,43.2,25,36,7,29,24,61,28,0,"MF,FW",20-24,Midfielder,Wales,Europe
124732,John Brooks,USA,Wolfsburg,Bundesliga,2018,25.0,1993.0,29.0,29,15,18,9,2,13,27,48.1,14,28,13,15,37,66,135,3,DF,25-29,Defender,United States,North America
43984,Daniel Brosinski,GER,Mainz 05,Bundesliga,2018,30.0,1988.0,24.5,27,16,16,10,1,18,33,54.5,15,30,9,21,26,53,58,0,DF,30-34,Defender,Germany,Europe
293281,Jacob Bruun Larsen,DEN,Dortmund,Bundesliga,2018,19.0,1998.0,14.1,15,9,8,2,5,7,17,41.2,10,15,1,14,13,28,12,0,FW,Under 20,Forward,Denmark,Europe
194460,Joe Bryan,ENG,Fulham,Premier League,2018,24.0,1993.0,26.1,61,41,35,21,5,24,42,57.1,18,34,12,22,31,92,82,1,"DF,MF",20-24,Defender,England,Europe
49239,Guido Burgstaller,AUT,Schalke 04,Bundesliga,2018,29.0,1989.0,17.0,11,9,2,5,4,3,8,37.5,5,5,0,5,2,13,10,0,FW,25-29,Forward,Austria,Europe
333647,Jonathan Burkardt,GER,Mainz 05,Bundesliga,2018,18.0,2000.0,2.9,4,4,2,1,1,1,2,50.0,1,2,0,2,3,7,5,0,"FW,MF",Under 20,Forward,Germany,Europe
113707,Rmy Cabella,FRA,Saint-tienne,Ligue 1,2018,28.0,1990.0,33.3,88,51,31,38,19,30,87,34.5,57,39,1,38,19,107,5,3,"MF,FW",25-29,Midfielder,France,Europe
30677,Gustavo Cabral,ARG,Celta Vigo,La Liga,2018,32.0,1985.0,21.1,37,26,28,7,2,17,27,63.0,10,31,11,20,33,70,102,1,DF,30-34,Defender,Argentina,South America
102423,Leandro Cabrera,URU,Getafe,La Liga,2018,27.0,1991.0,31.0,47,26,28,17,2,24,41,58.5,17,29,16,13,52,99,216,2,DF,25-29,Defender,Uruguay,South America
37834,Felipe Caicedo,ECU,Lazio,Serie A,2018,29.0,1988.0,15.2,16,12,4,6,6,1,8,12.5,7,9,2,7,5,21,5,0,FW,25-29,Forward,Ecuador,South America
123275,Tom Cairney,SCO,Fulham,Premier League,2018,27.0,1991.0,24.4,37,21,9,22,6,12,16,75.0,4,21,5,16,10,47,13,1,"MF,FW",25-29,Midfielder,Scotland,Europe
54137,Caiuby,BRA,Augsburg,Bundesliga,2018,30.0,1988.0,11.2,12,10,5,6,1,3,11,27.3,8,16,1,15,5,17,10,0,"MF,FW",30-34,Midfielder,Brazil,South America
240897,Arturo Calabresi,ITA,Bologna,Serie A,2018,22.0,1996.0,15.7,46,27,22,17,7,22,40,55.0,18,18,3,15,34,80,60,0,DF,20-24,Defender,Italy,Europe
262523,Davide Calabria,ITA,Milan,Serie A,2018,21.0,1996.0,21.7,79,51,58,16,5,37,67,55.2,30,33,1,32,32,111,78,1,DF,20-24,Defender,Italy,Europe
126414,Hakan alhanolu,TUR,Milan,Serie A,2018,24.0,1994.0,32.0,52,31,27,16,9,23,46,50.0,23,27,5,22,28,80,19,0,"MF,FW",20-24,Midfielder,Turkey,Asia
38410,Daniel Caligiuri,ITA,Schalke 04,Bundesliga,2018,30.0,1988.0,30.6,93,52,55,29,9,44,103,42.7,59,66,10,56,50,143,72,1,"DF,FW",30-34,Defender,Italy,Europe
284727,Jonathan Calleri,ARG,Alavs,La Liga,2018,24.0,1993.0,31.9,20,13,3,11,6,1,24,4.2,23,34,7,27,7,27,53,0,FW,20-24,Forward,Argentina,South America
306024,Dominic Calvert-Lewin,ENG,Everton,Premier League,2018,21.0,1997.0,19.8,13,7,3,3,7,7,15,46.7,8,16,3,13,7,20,19,0,FW,20-24,Forward,England,Europe
5303,Souleymane Camara,SEN,Montpellier,Ligue 1,2018,35.0,1982.0,1.5,0,0,0,0,0,0,2,0.0,2,0,0,0,0,0,3,0,"FW,MF",35-39,Forward,Senegal,Africa
131248,Joel Campbell,CRC,Frosinone,Serie A,2018,26.0,1992.0,9.9,15,10,5,8,2,3,17,17.6,14,2,0,2,3,18,2,1,"FW,MF",25-29,Forward,Costa Rica,North America
119296,Emre Can,GER,Juventus,Serie A,2018,24.0,1994.0,20.1,64,38,28,27,9,24,40,60.0,16,43,13,30,28,92,36,2,MF,20-24,Midfielder,Germany,Europe
182712,Joo Cancelo,POR,Juventus,Serie A,2018,24.0,1994.0,21.9,43,28,18,18,7,27,49,55.1,22,14,4,10,15,58,48,0,DF,20-24,Defender,Portugal,Europe
25488,Antonio Candreva,ITA,Inter,Serie A,2018,31.0,1987.0,5.6,1,1,0,1,0,1,8,12.5,7,0,0,0,4,5,9,0,"FW,MF",30-34,Forward,Italy,Europe
214532,Pierrick Capelle,FRA,Angers,Ligue 1,2018,31.0,1987.0,20.5,51,31,23,22,6,19,54,35.2,35,23,2,21,38,89,49,0,"DF,MF",30-34,Defender,France,Europe
84442,Leonardo Capezzi,ITA,Empoli,Serie A,2018,23.0,1995.0,8.6,14,9,6,8,0,7,13,53.8,6,14,4,10,10,24,13,0,MF,20-24,Midfielder,Italy,Europe
63494,tienne Capoue,FRA,Watford,Premier League,2018,30.0,1988.0,32.7,91,56,36,48,7,33,87,37.9,54,50,13,37,85,176,96,1,MF,30-34,Midfielder,France,Europe
146752,Gianluca Caprari,ITA,Sampdoria,Serie A,2018,25.0,1993.0,11.5,15,9,4,9,2,5,12,41.7,7,7,0,7,4,19,3,0,"FW,MF",25-29,Forward,Italy,Europe
84765,Francesco Caputo,ITA,Empoli,Serie A,2018,30.0,1987.0,38.0,13,9,2,4,7,3,10,30.0,7,11,1,10,2,15,11,0,FW,30-34,Forward,Italy,Europe
37712,Daniel Carrio,POR,Sevilla,La Liga,2018,29.0,1988.0,23.7,35,18,23,11,1,12,20,60.0,8,19,12,7,31,66,104,1,DF,25-29,Defender,Portugal,Europe
184672,Guido Carrillo,ARG,Legans,La Liga,2018,27.0,1991.0,22.1,25,14,4,12,9,6,19,31.6,13,12,1,11,8,33,25,0,FW,25-29,Forward,Argentina,South America
48066,Andy Carroll,ENG,West Ham,Premier League,2018,29.0,1989.0,5.1,4,2,1,3,0,1,4,25.0,3,3,2,1,1,5,8,0,FW,25-29,Forward,England,Europe
100131,William Carvalho,POR,Betis,La Liga,2018,26.0,1992.0,26.5,45,27,20,21,4,16,29,55.2,13,8,0,8,12,57,30,0,MF,25-29,Midfielder,Portugal,Europe
16306,Casemiro,BRA,Real Madrid,La Liga,2018,26.0,1992.0,25.7,86,52,44,35,7,38,94,40.4,56,52,12,40,41,127,56,3,MF,25-29,Midfielder,Brazil,South America
466298,Santiago Cseres,ARG,Villarreal,La Liga,2018,21.0,1997.0,17.6,67,35,20,38,9,25,57,43.9,32,22,9,13,14,81,24,1,MF,20-24,Midfielder,Argentina,South America
301236,Francesco Cassata,ITA,Frosinone,Serie A,2018,21.0,1997.0,12.5,20,11,12,4,4,9,23,39.1,14,8,1,7,6,26,15,1,MF,20-24,Midfielder,Italy,Europe
262226,Timothy Castagne,BEL,Atalanta,Serie A,2018,22.0,1995.0,22.3,61,39,30,22,9,32,57,56.1,25,32,6,26,28,89,50,0,DF,20-24,Defender,Belgium,Europe
28947,Gonzalo Castro,GER,Stuttgart,Bundesliga,2018,31.0,1987.0,18.8,50,28,21,25,4,19,43,44.2,24,23,5,18,29,79,22,1,MF,30-34,Midfielder,Germany,Europe
199733,Danilo Cataldi,ITA,Lazio,Serie A,2018,23.0,1994.0,6.4,12,7,4,5,3,2,9,22.2,7,3,0,3,7,19,6,0,"MF,FW",20-24,Midfielder,Italy,Europe
149716,Ivan Cavaleiro,POR,Wolves,Premier League,2018,24.0,1993.0,7.7,5,4,3,1,1,1,14,7.1,13,12,0,12,4,9,5,0,"FW,MF",20-24,Forward,Portugal,Europe
48280,Edinson Cavani,URU,Paris S-G,Ligue 1,2018,31.0,1987.0,18.6,11,8,1,4,6,3,13,23.1,10,11,2,9,6,17,16,0,FW,30-34,Forward,Uruguay,South America
251075,Zeki elik,TUR,Lille,Ligue 1,2018,21.0,1997.0,33.0,90,59,40,39,11,36,89,40.4,53,34,5,29,34,124,89,1,DF,20-24,Defender,Turkey,Asia
102745,Luca Ceppitelli,ITA,Cagliari,Serie A,2018,28.0,1989.0,22.8,40,24,28,11,1,13,22,59.1,9,34,24,10,20,60,111,2,DF,25-29,Defender,Italy,Europe
35743,Fabio Ceravolo,ITA,Parma,Serie A,2018,31.0,1987.0,13.2,5,1,2,1,2,1,11,9.1,10,9,1,8,2,7,19,0,FW,30-34,Forward,Italy,Europe
197751,Alberto Cerri,ITA,Cagliari,Serie A,2018,22.0,1996.0,7.4,3,2,2,1,0,0,7,0.0,7,7,1,6,2,5,4,0,FW,20-24,Forward,Italy,Europe
216499,Fouad Chafik,MAR,Dijon,Ligue 1,2018,31.0,1986.0,20.5,44,31,29,12,3,23,36,63.9,13,17,3,14,25,69,71,0,DF,30-34,Defender,Morocco,Africa
128900,Nathaniel Chalobah,ENG,Watford,Premier League,2018,23.0,1994.0,3.0,3,2,1,2,0,2,7,28.6,5,2,1,1,5,8,7,0,MF,20-24,Midfielder,England,Europe
215118,Calum Chambers,ENG,Fulham,Premier League,2018,23.0,1995.0,28.8,64,36,32,27,5,16,48,33.3,32,37,12,25,69,133,113,4,"MF,DF",20-24,Midfielder,England,Europe
486078,Charles,BRA,Eibar,La Liga,2018,34.0,1984.0,19.3,7,5,1,3,3,2,13,15.4,11,14,1,13,4,11,14,0,FW,30-34,Forward,Brazil,South America
118278,Xavier Chavalerin,FRA,Reims,Ligue 1,2018,27.0,1991.0,36.0,106,61,56,39,11,28,72,38.9,44,44,12,32,72,178,39,1,MF,25-29,Midfielder,France,Europe
118732,Pablo Chavarra,ARG,Reims,Ligue 1,2018,30.0,1988.0,21.9,20,12,8,6,6,3,15,20.0,12,11,0,11,4,24,19,0,FW,30-34,Forward,Argentina,South America
98322,Denis Cheryshev,RUS,Valencia,La Liga,2018,27.0,1990.0,19.0,46,32,15,22,9,17,37,45.9,20,35,3,32,15,61,16,0,MF,25-29,Midfielder,Russia,Europe
29260,Giorgio Chiellini,ITA,Juventus,Serie A,2018,33.0,1984.0,22.1,24,13,20,2,2,5,8,62.5,3,22,15,7,30,54,96,1,DF,30-34,Defender,Italy,Europe
341092,Federico Chiesa,ITA,Fiorentina,Serie A,2018,20.0,1997.0,33.7,46,27,8,17,21,10,40,25.0,30,24,1,23,10,56,12,0,FW,20-24,Forward,Italy,Europe
316125,Ben Chilwell,ENG,Leicester City,Premier League,2018,21.0,1996.0,36.0,55,29,34,18,3,24,55,43.6,31,37,7,30,38,93,156,0,DF,20-24,Defender,England,Europe
341501,Hamza Choudhury,ENG,Leicester City,Premier League,2018,20.0,1997.0,6.6,24,10,13,10,1,9,15,60.0,6,12,3,9,15,39,13,0,MF,20-24,Midfielder,England,Europe
158623,Cyrus Christie,IRL,Fulham,Premier League,2018,25.0,1992.0,21.6,43,23,26,13,4,18,41,43.9,23,25,11,14,29,72,96,1,"DF,MF",25-29,Defender,Republic of Ireland,Europe
401922,Samuel Chukwueze,NGA,Villarreal,La Liga,2018,19.0,1999.0,19.0,19,11,7,10,2,9,31,29.0,22,11,2,9,10,29,2,0,"MF,FW",Under 20,Midfielder,Nigeria,Africa
61511,Camillo Ciano,ITA,Frosinone,Serie A,2018,28.0,1990.0,27.3,33,15,12,10,11,8,50,16.0,42,28,4,24,8,41,16,0,"FW,MF",25-29,Forward,Italy,Europe
33218,Luca Cigarini,ITA,Cagliari,Serie A,2018,32.0,1986.0,18.7,54,33,27,22,5,28,63,44.4,35,28,5,23,26,80,41,0,MF,30-34,Midfielder,Italy,Europe
29605,Daniel Ciofani,ITA,Frosinone,Serie A,2018,33.0,1985.0,18.0,8,6,2,5,1,3,7,42.9,4,4,0,4,3,11,9,0,FW,30-34,Forward,Italy,Europe
73484,Tom Cleverley,ENG,Watford,Premier League,2018,28.0,1989.0,5.3,17,9,11,4,2,6,22,27.3,16,4,0,4,5,22,11,0,MF,25-29,Midfielder,England,Europe
68390,Samus Coleman,IRL,Everton,Premier League,2018,29.0,1988.0,28.4,44,25,23,18,3,19,30,63.3,11,14,5,9,26,70,86,0,DF,25-29,Defender,Republic of Ireland,Europe
243714,Kingsley Coman,FRA,Bayern Munich,Bundesliga,2018,22.0,1996.0,15.3,11,6,4,4,3,6,19,31.6,13,20,0,20,5,16,3,0,"FW,MF",20-24,Forward,France,Europe
22386,Daniel Congr,FRA,Montpellier,Ligue 1,2018,33.0,1985.0,36.6,75,45,46,26,3,38,65,58.5,27,35,15,20,67,142,106,1,DF,30-34,Defender,France,Europe
90836,Steve Cook,ENG,Bournemouth,Premier League,2018,27.0,1991.0,31.0,36,19,31,5,0,20,27,74.1,7,36,21,15,50,86,202,1,DF,25-29,Defender,England,Europe
74869,Francis Coquelin,FRA,Valencia,La Liga,2018,27.0,1991.0,19.6,46,31,25,14,7,17,35,48.6,18,21,5,16,49,95,29,1,MF,25-29,Midfielder,France,Europe
154171,Benjamin Corgnet,FRA,Strasbourg,Ligue 1,2018,31.0,1987.0,7.5,21,12,7,9,5,4,11,36.4,7,1,0,1,6,27,9,0,"MF,FW",30-34,Midfielder,France,Europe
40613,Jack Cork,ENG,Burnley,Premier League,2018,29.0,1989.0,36.8,51,27,12,34,5,18,46,39.1,28,39,16,23,29,80,82,2,MF,25-29,Midfielder,England,Europe
266807,ngel Correa,ARG,Atltico Madrid,La Liga,2018,23.0,1995.0,21.3,38,19,19,12,7,10,53,18.9,43,28,5,23,17,55,20,0,"MF,FW",20-24,Midfielder,Argentina,South America
227081,Joaqun Correa,ARG,Lazio,Serie A,2018,23.0,1994.0,21.4,21,13,6,12,3,5,18,27.8,13,14,3,11,2,23,7,0,"FW,MF",20-24,Forward,Argentina,South America
85906,Danny da Costa,GER,Eint Frankfurt,Bundesliga,2018,25.0,1993.0,33.7,61,35,29,25,7,18,42,42.9,24,51,9,42,32,93,67,0,"DF,FW",25-29,Defender,Germany,Europe
75615,Douglas Costa,BRA,Juventus,Serie A,2018,27.0,1990.0,6.9,10,8,2,8,0,4,9,44.4,5,8,0,8,4,14,2,0,"FW,MF",25-29,Forward,Brazil,South America
173900,Hlder Costa,ANG,Wolves,Premier League,2018,24.0,1994.0,14.9,18,14,7,7,4,7,23,30.4,16,15,0,15,9,27,6,0,"FW,MF",20-24,Forward,Angola,Africa
184935,Kalifa Coulibaly,MLI,Nantes,Ligue 1,2018,26.0,1991.0,19.5,15,7,1,10,4,4,11,36.4,7,8,1,7,4,19,22,0,FW,25-29,Forward,Mali,Africa
596240,Senou Coulibaly,MLI,Dijon,Ligue 1,2018,23.0,1994.0,4.6,13,7,10,3,0,3,8,37.5,5,8,2,6,11,24,20,0,DF,20-24,Defender,Mali,Africa
80444,Philippe Coutinho,BRA,Barcelona,La Liga,2018,26.0,1992.0,22.4,16,11,1,6,9,7,22,31.8,15,21,2,19,12,28,8,0,"FW,MF",25-29,Forward,Brazil,South America
44136,Domenico Criscito,ITA,Genoa,Serie A,2018,31.0,1986.0,34.1,111,75,64,36,11,57,83,68.7,26,40,11,29,70,181,142,0,DF,30-34,Defender,Italy,Europe
199248,Bryan Cristante,ITA,Roma,Serie A,2018,23.0,1995.0,26.9,63,34,21,35,7,19,49,38.8,30,37,5,32,29,92,48,0,MF,20-24,Midfielder,Italy,Europe
188157,Sebastin Cristforo,URU,Getafe,La Liga,2018,24.0,1993.0,5.0,15,8,4,8,3,5,14,35.7,9,13,0,13,8,23,5,0,MF,20-24,Midfielder,Uruguay,South America
91970,Juan Cuadrado,COL,Juventus,Serie A,2018,30.0,1988.0,13.6,20,15,6,9,5,5,23,21.7,18,14,3,11,18,38,11,0,"MF,DF",30-34,Midfielder,Colombia,South America
114093,Greg Cunningham,IRL,Cardiff City,Premier League,2018,27.0,1991.0,7.0,18,7,11,4,3,9,16,56.3,7,9,3,6,17,35,16,1,DF,25-29,Defender,Republic of Ireland,Europe
265078,Patrick Cutrone,ITA,Milan,Serie A,2018,20.0,1998.0,16.2,9,5,0,3,6,2,16,12.5,14,13,2,11,7,16,13,0,FW,20-24,Forward,Italy,Europe
182889,Wylan Cyprien,FRA,Nice,Ligue 1,2018,23.0,1995.0,26.2,40,20,16,21,3,15,43,34.9,28,20,5,15,11,51,15,0,MF,20-24,Midfielder,France,Europe
55769,Danilo D'Ambrosio,ITA,Inter,Serie A,2018,29.0,1988.0,28.7,69,40,34,27,8,24,57,42.1,33,25,8,17,27,96,39,0,DF,25-29,Defender,Italy,Europe
57370,Damien Da Silva,FRA,Rennes,Ligue 1,2018,30.0,1988.0,31.9,41,25,31,9,1,18,24,75.0,6,42,36,6,39,80,152,0,DF,30-34,Defender,France,Europe
61819,Charlie Daniels,ENG,Bournemouth,Premier League,2018,31.0,1986.0,17.6,25,15,18,6,1,13,22,59.1,9,14,4,10,20,45,56,2,DF,30-34,Defender,England,Europe
808509,Danilo,BRA,Manchester City,Premier League,2018,27.0,1991.0,9.0,20,16,6,12,2,12,17,70.6,5,5,0,5,15,35,22,1,DF,25-29,Defender,Brazil,South America
62688,Scott Dann,ENG,Crystal Palace,Premier League,2018,31.0,1987.0,7.4,6,2,5,1,0,3,7,42.9,4,16,12,4,5,11,46,0,DF,30-34,Defender,England,Europe
263236,Kevin Danso,AUT,Augsburg,Bundesliga,2018,19.0,1998.0,13.9,25,14,21,3,1,11,14,78.6,3,25,17,8,19,44,72,0,DF,Under 20,Defender,Austria,Europe
16136,Dante,BRA,Nice,Ligue 1,2018,34.0,1983.0,35.8,54,40,36,16,2,24,41,58.5,17,56,30,26,38,92,156,2,DF,30-34,Defender,Brazil,South America
257097,Ben Davies,WAL,Tottenham,Premier League,2018,25.0,1993.0,20.5,56,30,39,13,4,38,54,70.4,16,23,10,13,23,79,68,1,DF,25-29,Defender,Wales,Europe
854853,Tom Davies,ENG,Everton,Premier League,2018,20.0,1998.0,10.9,27,17,9,17,1,7,23,30.4,16,15,1,14,16,43,9,1,MF,20-24,Midfielder,England,Europe
88755,Kevin De Bruyne,BEL,Manchester City,Premier League,2018,27.0,1991.0,10.8,22,15,6,12,4,7,21,33.3,14,13,1,12,3,25,2,1,MF,25-29,Midfielder,Belgium,Europe
5947,Daniele De Rossi,ITA,Roma,Serie A,2018,35.0,1983.0,14.1,16,10,6,7,3,3,14,21.4,11,18,12,6,26,42,33,0,MF,35-39,Midfielder,Italy,Europe
33571,Lorenzo De Silvestri,ITA,Torino,Serie A,2018,30.0,1988.0,26.8,15,11,8,5,2,7,24,29.2,17,53,3,50,22,37,69,2,DF,30-34,Defender,Italy,Europe
57372,Lucas Deaux,FRA,Guingamp,Ligue 1,2018,29.0,1988.0,13.2,41,28,21,18,2,20,41,48.8,21,10,0,10,11,52,7,0,MF,25-29,Midfielder,France,Europe
65477,Troy Deeney,ENG,Watford,Premier League,2018,30.0,1988.0,28.3,24,14,8,10,6,7,32,21.9,25,22,4,18,7,31,29,0,FW,30-34,Forward,England,Europe
235931,Alessandro Deiola,ITA,Cagliari,Serie A,2018,22.0,1995.0,5.0,7,3,1,6,0,3,13,23.1,10,14,0,14,6,13,8,0,MF,20-24,Midfielder,Italy,Europe
353399,Romain Del Castillo,FRA,Rennes,Ligue 1,2018,22.0,1996.0,14.9,36,20,15,13,8,13,37,35.1,24,19,0,19,20,56,7,1,"MF,FW",20-24,Midfielder,France,Europe
122797,Andy Delort,ALG,Montpellier,Ligue 1,2018,26.0,1991.0,34.6,34,20,7,20,7,8,34,23.5,26,28,7,21,4,38,7,0,FW,25-29,Forward,Algeria,Africa
50362,Fabian Delph,ENG,Manchester City,Premier League,2018,28.0,1989.0,8.1,23,14,11,7,5,12,23,52.2,11,3,0,3,13,36,19,1,DF,25-29,Defender,England,Europe
229004,Moussa Dembl,FRA,Lyon,Ligue 1,2018,22.0,1996.0,22.4,12,4,0,8,4,4,14,28.6,10,15,2,13,2,14,13,0,FW,20-24,Forward,France,Europe
288230,Ousmane Dembl,FRA,Barcelona,La Liga,2018,21.0,1997.0,18.5,23,15,4,13,6,6,18,33.3,12,13,0,13,5,28,4,0,"FW,MF",20-24,Forward,France,Europe
539232,Jessy Deminguet,FRA,Caen,Ligue 1,2018,20.0,1998.0,14.1,37,25,18,17,2,15,40,37.5,25,19,3,16,18,55,28,1,MF,20-24,Midfielder,France,Europe
82070,Diego Demme,GER,RB Leipzig,Bundesliga,2018,26.0,1991.0,22.8,75,47,24,43,8,33,67,49.3,34,36,3,33,26,101,15,0,MF,25-29,Midfielder,Germany,Europe
277114,Jason Denayer,BEL,Lyon,Ligue 1,2018,23.0,1995.0,30.6,33,21,22,11,0,16,24,66.7,8,36,32,4,26,59,122,1,DF,20-24,Defender,Belgium,Europe
324282,Fabio Depaoli,ITA,Chievo,Serie A,2018,21.0,1997.0,27.4,74,43,37,32,5,34,67,50.7,33,42,16,26,35,109,99,3,DF,20-24,Defender,Italy,Europe
347595,Clment Depres,FRA,Nmes,Ligue 1,2018,23.0,1994.0,4.9,2,2,1,1,0,1,4,25.0,3,3,0,3,0,2,6,0,FW,20-24,Forward,France,Europe
29962,Daniele Dessena,ITA,Cagliari,Serie A,2018,31.0,1987.0,3.9,2,2,0,2,0,1,3,33.3,2,3,1,2,3,5,5,0,MF,30-34,Midfielder,Italy,Europe
165531,Jacopo Dezi,ITA,Parma,Serie A,2018,26.0,1992.0,1.0,1,1,1,0,0,0,1,0.0,1,1,0,1,3,4,2,0,MF,25-29,Midfielder,Italy,Europe
38607,Federico Di Francesco,ITA,Sassuolo,Serie A,2018,24.0,1994.0,11.9,10,6,3,4,3,4,7,57.1,3,12,1,11,5,15,5,0,"FW,MF",20-24,Forward,Italy,Europe
165722,Antonio Di Gaudio,ITA,Parma,Serie A,2018,28.0,1989.0,7.8,2,0,0,1,1,1,5,20.0,4,6,1,5,3,5,5,0,FW,25-29,Forward,Italy,Europe
169880,Giovanni Di Lorenzo,ITA,Empoli,Serie A,2018,24.0,1993.0,37.0,66,43,38,23,5,24,44,54.5,20,34,13,21,36,102,93,3,"DF,FW",20-24,Defender,Italy,Europe
395516,Moussa Diaby,FRA,Paris S-G,Ligue 1,2018,19.0,1999.0,12.7,14,8,7,2,5,2,11,18.2,9,7,1,6,12,26,6,0,"MF,DF",Under 20,Midfielder,France,Europe
453594,Adama Diakhaby,FRA,Huddersfield,Premier League,2018,22.0,1996.0,6.1,6,3,4,1,1,3,11,27.3,8,7,0,7,1,7,2,0,"FW,MF",20-24,Forward,France,Europe
346289,Mouctar Diakhaby,GUI,Valencia,La Liga,2018,21.0,1996.0,17.6,14,8,10,4,0,5,10,50.0,5,24,16,8,20,34,94,1,DF,20-24,Defender,Guinea,Africa
229005,Abdou Diallo,SEN,Dortmund,Bundesliga,2018,22.0,1996.0,26.4,36,20,20,13,3,11,15,73.3,4,28,15,13,26,62,91,1,DF,20-24,Defender,Senegal,Africa
70950,Mohamed Diam,SEN,Newcastle Utd,Premier League,2018,31.0,1987.0,24.1,76,46,35,36,5,16,54,29.6,38,42,9,33,30,106,39,1,MF,30-34,Midfielder,Senegal,Africa
342048,Grady Diangana,COD,West Ham,Premier League,2018,20.0,1998.0,6.8,20,9,8,8,4,5,14,35.7,9,11,0,11,1,21,4,0,"MF,FW",20-24,Midfielder,DR Congo,Africa
314678,Brahim Daz,MAR,Real Madrid,La Liga,2018,18.0,1999.0,4.2,9,7,5,4,0,3,8,37.5,5,2,0,2,0,9,0,0,FW,Under 20,Forward,Morocco,Africa
410059,Bakaye Dibassy,MLI,Amiens,Ligue 1,2018,28.0,1989.0,32.7,38,26,18,16,4,18,27,66.7,9,40,21,19,44,82,102,0,DF,25-29,Defender,Mali,Africa
57995,Daniel Didavi,GER,Stuttgart,Bundesliga,2018,28.0,1990.0,10.6,21,15,8,10,3,7,20,35.0,13,11,1,10,4,25,5,0,"MF,FW",25-29,Midfielder,Germany,Europe
5672,tienne Didot,FRA,Guingamp,Ligue 1,2018,35.0,1983.0,23.4,41,29,12,27,2,17,44,38.6,27,37,10,27,37,78,35,0,MF,35-39,Midfielder,France,Europe
175722,Eric Dier,ENG,Tottenham,Premier League,2018,24.0,1994.0,16.7,26,16,7,15,4,19,47,40.4,28,27,12,15,21,47,46,1,"MF,DF",20-24,Midfielder,England,Europe
126664,Lucas Digne,FRA,Everton,Premier League,2018,25.0,1993.0,32.9,71,46,45,18,8,28,45,62.2,17,43,9,34,60,131,116,0,DF,25-29,Defender,France,Europe
198116,Federico Dimarco,ITA,Parma,Serie A,2018,20.0,1997.0,9.9,22,7,10,8,4,10,20,50.0,10,13,6,7,15,37,27,0,"DF,MF",20-24,Defender,Italy,Europe
126683,Tristan Dingom,CMR,Reims,Ligue 1,2018,27.0,1991.0,14.9,27,15,11,10,6,7,24,29.2,17,16,3,13,11,38,5,0,MF,25-29,Midfielder,Cameroon,Africa
119369,Federico Dionisi,ITA,Frosinone,Serie A,2018,31.0,1987.0,2.3,3,1,0,2,1,0,2,0.0,2,0,0,0,0,3,0,0,"FW,MF",30-34,Forward,Italy,Europe
272622,Issa Diop,FRA,West Ham,Premier League,2018,21.0,1997.0,33.0,68,38,47,21,0,37,57,64.9,20,58,36,22,64,132,161,4,DF,20-24,Defender,France,Europe
569389,Sofiane Diop,FRA,Monaco,Ligue 1,2018,18.0,2000.0,8.2,12,7,3,6,3,1,15,6.7,14,6,0,6,8,20,6,0,"MF,FW",Under 20,Midfielder,France,Europe
165513,Berat Djimsiti,ALB,Atalanta,Serie A,2018,25.0,1993.0,20.1,32,22,18,12,2,13,29,44.8,16,21,11,10,34,66,96,0,DF,25-29,Defender,Albania,Europe
243606,Anastasios Donis,GRE,Stuttgart,Bundesliga,2018,21.0,1996.0,10.7,15,13,8,4,3,3,11,27.3,8,7,0,7,4,19,0,0,"FW,MF",20-24,Forward,Greece,Europe
127187,Abdoulaye Doucour,MLI,Watford,Premier League,2018,25.0,1993.0,34.0,71,38,27,32,12,19,57,33.3,38,31,8,23,34,105,55,5,MF,25-29,Midfielder,Mali,Africa
316137,Moussa Doumbia,MLI,Reims,Ligue 1,2018,23.0,1994.0,17.8,28,13,13,13,2,11,39,28.2,28,7,2,5,7,35,13,0,"FW,MF",20-24,Forward,Mali,Africa
75287,Seydou Doumbia,CIV,Girona,La Liga,2018,30.0,1987.0,6.0,5,1,1,2,2,0,2,0.0,2,2,0,2,3,8,1,0,FW,30-34,Forward,Ivory Coast,Africa
232418,Ondrej Duda,SVK,Hertha BSC,Bundesliga,2018,23.0,1994.0,28.5,54,33,13,35,6,15,55,27.3,40,36,4,32,15,69,17,1,MF,20-24,Midfielder,Slovakia,Europe
119269,Shane Duffy,IRL,Brighton,Premier League,2018,26.0,1992.0,34.3,35,20,23,7,5,14,25,56.0,11,57,47,10,36,71,244,3,DF,25-29,Defender,Republic of Ireland,Europe
170321,Paul Dummett,WAL,Newcastle Utd,Premier League,2018,26.0,1991.0,22.1,34,22,24,9,1,19,32,59.4,13,25,11,14,37,71,133,0,DF,25-29,Defender,Wales,Europe
184894,Alfred Duncan,GHA,Sassuolo,Serie A,2018,25.0,1993.0,20.5,33,21,15,15,3,19,48,39.6,29,20,6,14,15,48,18,0,MF,25-29,Midfielder,Ghana,Africa
148153,Lewis Dunk,ENG,Brighton,Premier League,2018,26.0,1991.0,35.0,42,26,31,10,1,17,39,43.6,22,49,38,11,46,88,196,5,DF,25-29,Defender,England,Europe
206050,Paulo Dybala,ARG,Juventus,Serie A,2018,24.0,1993.0,23.7,17,8,3,9,5,7,23,30.4,16,20,2,18,14,31,1,0,"FW,MF",20-24,Forward,Argentina,South America
296359,Flix Eboa Eboa,CMR,Guingamp,Ligue 1,2018,21.0,1997.0,27.0,47,33,26,20,1,16,22,72.7,6,37,24,13,39,86,136,2,DF,20-24,Defender,Cameroon,Africa
60990,Bruno Ecuele Manga,GAB,Cardiff City,Premier League,2018,30.0,1988.0,37.5,69,36,48,16,5,29,58,50.0,29,62,28,34,81,150,179,4,DF,30-34,Defender,Gabon,Africa
251303,Johannes Eggestein,GER,Werder Bremen,Bundesliga,2018,20.0,1998.0,12.4,13,9,7,4,2,5,19,26.3,14,13,0,13,4,17,7,0,"FW,MF",20-24,Forward,Germany,Europe
49275,Albin Ekdal,SWE,Sampdoria,Serie A,2018,29.0,1989.0,29.4,61,39,16,38,7,37,68,54.4,31,42,12,30,53,114,62,1,MF,25-29,Midfielder,Sweden,Europe
192635,Nico Elvedi,SUI,Gladbach,Bundesliga,2018,21.0,1996.0,29.1,41,19,34,7,0,23,33,69.7,10,30,13,17,47,88,135,6,DF,20-24,Defender,Switzerland,Europe
237662,Breel Embolo,SUI,Schalke 04,Bundesliga,2018,21.0,1997.0,14.9,22,17,4,13,5,1,9,11.1,8,11,0,11,4,26,6,0,FW,20-24,Forward,Switzerland,Europe
181778,Emerson,BRA,Betis,La Liga,2018,19.0,1999.0,3.5,9,7,6,1,2,3,10,30.0,7,6,0,6,7,16,12,0,"FW,DF",Under 20,Forward,Brazil,South America
69633,Christian Eriksen,DEN,Tottenham,Premier League,2018,26.0,1992.0,30.8,41,25,8,20,13,17,59,28.8,42,26,3,23,15,56,13,0,MF,25-29,Midfielder,Denmark,Europe
266795,Gonzalo Escalante,ARG,Eibar,La Liga,2018,25.0,1993.0,19.9,49,28,11,35,3,19,46,41.3,27,37,2,35,21,70,21,0,MF,25-29,Midfielder,Argentina,South America
64598,Bernardo Espinosa,COL,Girona,La Liga,2018,29.0,1989.0,30.3,20,14,16,4,0,8,17,47.1,9,46,31,15,40,60,197,5,DF,25-29,Defender,Colombia,South America
45662,Alexander Esswein,GER,Stuttgart,Bundesliga,2018,28.0,1990.0,13.9,17,11,6,4,7,6,21,28.6,15,17,0,17,12,29,16,0,"MF,FW",25-29,Midfielder,Germany,Europe
214070,Ewerton,BRA,Nrnberg,Bundesliga,2018,29.0,1989.0,14.9,24,20,21,3,0,8,14,57.1,6,23,16,7,25,49,108,1,DF,25-29,Defender,Brazil,South America
697714,Fabinho,BRA,Liverpool,Premier League,2018,24.0,1993.0,22.4,59,31,17,38,4,24,59,40.7,35,34,6,28,28,87,27,2,MF,20-24,Midfielder,Brazil,South America
39152,Radamel Falcao,COL,Monaco,Ligue 1,2018,32.0,1986.0,28.4,34,15,6,16,12,8,27,29.6,19,11,6,5,3,37,23,2,FW,30-34,Forward,Colombia,South America
119115,Diego Falcinelli,ITA,Bologna,Serie A,2018,27.0,1991.0,7.8,8,5,1,3,4,2,3,66.7,1,4,1,3,1,9,5,0,FW,25-29,Forward,Italy,Europe
167796,Paolo Farag,ITA,Cagliari,Serie A,2018,25.0,1993.0,18.9,46,29,20,16,10,13,43,30.2,30,28,2,26,15,61,38,0,"MF,DF",25-29,Midfielder,Italy,Europe
83877,Diego Farias,BRA,Empoli,Serie A,2018,28.0,1990.0,13.3,11,4,2,8,1,3,10,30.0,7,7,1,6,0,11,4,0,FW,25-29,Forward,Brazil,South America
340151,Andrea Favilli,ITA,Genoa,Serie A,2018,21.0,1997.0,1.9,1,1,0,0,1,0,1,0.0,1,1,0,1,0,1,1,0,"FW,DF",20-24,Forward,Italy,Europe
45314,Federico Fazio,ARG,Roma,Serie A,2018,31.0,1987.0,31.2,28,20,14,11,3,12,25,48.0,13,45,33,12,53,81,171,2,DF,30-34,Defender,Argentina,South America
203496,Nabil Fekir,FRA,Lyon,Ligue 1,2018,25.0,1993.0,22.1,51,31,16,19,16,13,38,34.2,25,42,0,42,7,58,3,0,MF,25-29,Midfielder,France,Europe
156501,Felipe,BRA,Hannover 96,Bundesliga,2018,31.0,1987.0,12.2,23,15,21,2,0,9,17,52.9,8,17,9,8,35,58,71,0,DF,30-34,Defender,Brazil,South America
573907,Luiz Felipe,ITA,Lazio,Serie A,2018,21.0,1997.0,14.3,27,18,20,7,0,13,20,65.0,7,27,15,12,26,53,57,1,DF,20-24,Defender,Italy,Europe
247555,Edimilson Fernandes,SUI,Fiorentina,Serie A,2018,22.0,1996.0,21.9,36,24,17,16,3,14,36,38.9,22,31,6,25,26,62,31,0,MF,20-24,Midfielder,Switzerland,Europe
20081,Gelson Fernandes,SUI,Eint Frankfurt,Bundesliga,2018,31.0,1986.0,24.7,74,48,33,38,3,23,65,35.4,42,45,9,36,53,127,16,0,MF,30-34,Midfielder,Switzerland,Europe
389324,Fernandinho,BRA,Manchester City,Premier League,2018,33.0,1985.0,26.4,57,43,19,30,8,26,47,55.3,21,28,4,24,41,98,70,0,MF,30-34,Midfielder,Brazil,South America
11268,Oliver Fink,GER,Dsseldorf,Bundesliga,2018,36.0,1982.0,11.7,38,22,17,17,4,12,38,31.6,26,20,3,17,13,51,19,0,MF,35-39,Midfielder,Germany,Europe
374139,Junior Firpo,DOM,Betis,La Liga,2018,21.0,1996.0,21.5,38,25,16,14,8,10,24,41.7,14,27,2,25,23,61,48,0,"DF,FW",20-24,Defender,Dominican Republic,North America
30638,Sergio Floccari,ITA,SPAL,Serie A,2018,36.0,1981.0,10.8,13,5,1,5,7,1,7,14.3,6,6,2,4,2,15,6,0,FW,35-39,Forward,Italy,Europe
130365,Alessandro Florenzi,ITA,Roma,Serie A,2018,27.0,1991.0,24.2,38,21,22,11,5,17,37,45.9,20,27,5,22,46,84,58,0,"DF,FW",25-29,Defender,Italy,Europe
406635,Phil Foden,ENG,Manchester City,Premier League,2018,18.0,2000.0,3.7,7,6,1,3,3,2,9,22.2,7,1,0,1,4,11,1,0,MF,Under 20,Midfielder,England,Europe
182893,Seko Fofana,CIV,Udinese,Serie A,2018,23.0,1995.0,29.3,25,13,14,10,1,6,36,16.7,30,20,7,13,29,54,18,3,MF,20-24,Midfielder,Ivory Coast,Africa
569598,Youssouf Fofana,FRA,Strasbourg,Ligue 1,2018,19.0,1999.0,10.1,28,20,5,20,3,9,27,33.3,18,7,0,7,11,39,8,0,MF,Under 20,Midfielder,France,Europe
111078,Emil Forsberg,SWE,RB Leipzig,Bundesliga,2018,26.0,1991.0,13.9,12,7,0,12,0,5,16,31.3,11,16,1,15,3,15,6,0,"MF,FW",25-29,Midfielder,Sweden,Europe
315131,Timothy Fosu-Mensah,NED,Fulham,Premier League,2018,20.0,1998.0,8.8,18,7,12,6,0,8,13,61.5,5,11,5,6,12,30,30,1,DF,20-24,Defender,Netherlands,Europe
170472,Dimitri Foulquier,FRA,Getafe,La Liga,2018,25.0,1993.0,20.0,29,12,10,14,5,11,22,50.0,11,23,2,21,20,49,38,0,"MF,DF",25-29,Midfielder,France,Europe
480763,Juan Foyth,ARG,Tottenham,Premier League,2018,20.0,1998.0,9.9,31,17,20,11,0,14,19,73.7,5,12,5,7,10,41,50,1,DF,20-24,Defender,Argentina,South America
13573,Simon Francis,ENG,Bournemouth,Premier League,2018,33.0,1985.0,13.7,25,14,19,5,1,12,24,50.0,12,15,7,8,19,44,73,1,DF,30-34,Defender,England,Europe
146795,Ryan Fraser,SCO,Bournemouth,Premier League,2018,24.0,1994.0,35.2,19,11,9,8,2,10,32,31.3,22,23,6,17,22,41,33,0,"MF,FW",20-24,Midfielder,Scotland,Europe
140191,Ryan Fredericks,ENG,West Ham,Premier League,2018,25.0,1992.0,12.1,38,23,33,5,0,21,32,65.6,11,15,5,10,13,51,49,1,DF,25-29,Defender,England,Europe
278323,Alexander Fuchs,GER,Nrnberg,Bundesliga,2018,21.0,1997.0,7.3,14,12,5,7,2,5,15,33.3,10,9,1,8,5,19,10,0,"MF,FW",20-24,Midfielder,Germany,Europe
250013,Angelo Fulgini,FRA,Angers,Ligue 1,2018,21.0,1996.0,18.2,38,22,18,13,7,12,31,38.7,19,21,3,18,28,66,15,0,"MF,FW",20-24,Midfielder,France,Europe
75489,Niclas Fllkrug,GER,Hannover 96,Bundesliga,2018,25.0,1993.0,12.4,3,0,0,1,2,1,5,20.0,4,10,4,6,1,4,17,0,FW,25-29,Forward,Germany,Europe
11111,Ramiro Funes Mori,ARG,Villarreal,La Liga,2018,27.0,1991.0,29.2,41,29,30,9,2,19,44,43.2,25,36,24,12,42,83,149,2,"DF,MF",25-29,Defender,Argentina,South America
27389,Kvin Gameiro,FRA,Valencia,La Liga,2018,31.0,1987.0,17.9,14,9,4,6,4,1,6,16.7,5,12,2,10,5,19,3,0,FW,30-34,Forward,France,Europe
531949,Ignatius Ganago,CMR,Nice,Ligue 1,2018,19.0,1999.0,11.5,3,1,0,2,1,0,7,0.0,7,2,0,2,1,4,7,0,FW,Under 20,Forward,Cameroon,Africa
35939,Ezequiel Garay,ARG,Valencia,La Liga,2018,31.0,1986.0,23.7,20,17,15,3,2,9,18,50.0,9,30,23,7,16,36,140,0,DF,30-34,Defender,Argentina,South America
251309,Dennis Geiger,GER,Hoffenheim,Bundesliga,2018,20.0,1998.0,2.7,2,1,1,1,0,1,6,16.7,5,1,0,1,3,5,1,0,MF,20-24,Midfielder,Germany,Europe
19112,Christian Gentner,GER,Stuttgart,Bundesliga,2018,32.0,1985.0,22.4,61,38,29,26,6,16,50,32.0,34,30,3,27,31,92,41,1,"MF,FW",30-34,Midfielder,Germany,Europe
119277,Yannick Gerhardt,GER,Wolfsburg,Bundesliga,2018,24.0,1994.0,27.3,52,34,22,20,10,16,43,37.2,27,35,7,28,30,82,34,0,MF,20-24,Midfielder,Germany,Europe
60540,Valre Germain,FRA,Marseille,Ligue 1,2018,28.0,1990.0,24.1,38,25,8,22,8,8,33,24.2,25,20,5,15,6,44,30,0,FW,25-29,Forward,France,Europe
341705,Gerson,BRA,Fiorentina,Serie A,2018,21.0,1997.0,27.0,42,26,22,15,5,12,38,31.6,26,46,9,37,16,58,32,0,"MF,FW",20-24,Midfielder,Brazil,South America
313477,Paolo Ghiglione,ITA,Frosinone,Serie A,2018,21.0,1997.0,5.7,8,4,6,1,1,6,14,42.9,8,2,0,2,4,12,22,0,DF,20-24,Defender,Italy,Europe
204294,Saman Ghoddos,IRN,Amiens,Ligue 1,2018,24.0,1993.0,20.3,33,17,14,15,4,13,32,40.6,19,15,2,13,7,40,13,0,"FW,MF",20-24,Forward,Iran,Asia
84835,Emanuele Giaccherini,ITA,Chievo,Serie A,2018,33.0,1985.0,22.3,14,8,5,7,2,6,31,19.4,25,21,2,19,16,30,10,2,"MF,FW",30-34,Midfielder,Italy,Europe
429014,Morgan Gibbs-White,ENG,Wolves,Premier League,2018,18.0,2000.0,7.4,6,3,2,4,0,1,4,25.0,3,6,0,6,1,7,0,0,"MF,FW",Under 20,Midfielder,England,Europe
72792,Niko Gieelmann,GER,Dsseldorf,Bundesliga,2018,26.0,1991.0,28.8,57,37,38,14,5,26,59,44.1,33,25,6,19,36,93,85,1,DF,25-29,Defender,Germany,Europe
79501,Daniel Ginczek,GER,Wolfsburg,Bundesliga,2018,27.0,1991.0,14.2,9,7,4,3,2,5,19,26.3,14,12,2,10,3,12,23,1,FW,25-29,Forward,Germany,Europe
270051,Andrei Girotto,BRA,Nantes,Ligue 1,2018,26.0,1992.0,16.4,57,40,18,36,3,20,44,45.5,24,22,6,16,29,86,43,1,MF,25-29,Midfielder,Brazil,South America
82442,Olivier Giroud,FRA,Chelsea,Premier League,2018,31.0,1986.0,9.4,3,2,0,1,2,1,4,25.0,3,6,1,5,3,6,7,0,FW,30-34,Forward,France,Europe
159471,Serge Gnabry,GER,Bayern Munich,Bundesliga,2018,23.0,1995.0,19.6,36,20,12,13,11,5,30,16.7,25,18,0,18,11,47,3,0,"FW,MF",20-24,Forward,Germany,Europe
378954,Joris Gnagnon,FRA,Sevilla,La Liga,2018,21.0,1997.0,5.0,11,8,6,4,1,4,7,57.1,3,2,2,0,10,21,16,0,"DF,MF",20-24,Defender,France,Europe
168933,Eddy Gnahor,FRA,Amiens,Ligue 1,2018,24.0,1993.0,24.9,39,27,17,17,5,9,39,23.1,30,29,4,25,23,62,23,1,MF,20-24,Midfielder,France,Europe
54928,Diego Godn,URU,Atltico Madrid,La Liga,2018,32.0,1986.0,27.9,52,30,33,19,0,20,42,47.6,22,22,9,13,45,97,141,2,DF,30-34,Defender,Uruguay,South America
242940,Edoardo Goldaniga,ITA,Frosinone,Serie A,2018,24.0,1993.0,29.0,43,28,34,7,2,19,32,59.4,13,29,16,13,57,100,119,0,DF,20-24,Defender,Italy,Europe
263918,Aleksandr Golovin,RUS,Monaco,Ligue 1,2018,22.0,1996.0,25.4,36,17,3,20,13,10,44,22.7,34,34,3,31,22,58,12,0,"MF,FW",20-24,Midfielder,Russia,Europe
670710,Andr Gomes,POR,Everton,Premier League,2018,25.0,1993.0,22.0,39,23,12,24,3,13,59,22.0,46,27,4,23,20,59,18,0,MF,25-29,Midfielder,Portugal,Europe
256178,Joe Gomez,ENG,Liverpool,Premier League,2018,21.0,1997.0,11.8,18,11,10,7,1,9,15,60.0,6,10,5,5,14,32,42,0,DF,20-24,Defender,England,Europe
20005,Papu Gmez,ARG,Atalanta,Serie A,2018,30.0,1988.0,32.2,19,14,5,10,4,6,30,20.0,24,21,0,21,16,35,4,0,"MF,FW",30-34,Midfielder,Argentina,South America
111528,Anthony Gonalves,FRA,Strasbourg,Ligue 1,2018,32.0,1986.0,11.8,22,15,12,8,2,7,22,31.8,15,21,2,19,10,32,17,0,"MF,FW",30-34,Midfielder,France,Europe
77108,Jrme Gondorf,GER,Freiburg,Bundesliga,2018,30.0,1988.0,14.4,33,18,12,19,2,14,28,50.0,14,29,5,24,19,52,23,1,"MF,FW",30-34,Midfielder,Germany,Europe
153084,Leon Goretzka,GER,Bayern Munich,Bundesliga,2018,23.0,1995.0,22.5,41,22,7,27,7,14,38,36.8,24,25,4,21,26,67,14,1,MF,20-24,Midfielder,Germany,Europe
44983,Dan Gosling,ENG,Bournemouth,Premier League,2018,28.0,1990.0,19.3,57,23,27,21,9,28,53,52.8,25,33,11,22,20,77,46,1,MF,25-29,Midfielder,England,Europe
106405,Jeffrey Gouweleeuw,NED,Augsburg,Bundesliga,2018,27.0,1991.0,23.2,42,31,23,19,0,24,39,61.5,15,44,21,23,56,98,71,1,DF,25-29,Defender,Netherlands,Europe
432772,Samuel Grandsir,FRA,Strasbourg,Ligue 1,2018,21.0,1996.0,2.6,9,6,5,3,1,3,7,42.9,4,2,0,2,1,10,0,0,"MF,FW",20-24,Midfielder,France,Europe
197473,Alberto Grassi,ITA,Parma,Serie A,2018,23.0,1995.0,5.1,20,12,7,10,3,2,10,20.0,8,8,2,6,8,28,10,0,MF,20-24,Midfielder,Italy,Europe
292417,Demarai Gray,JAM,Leicester City,Premier League,2018,22.0,1996.0,22.1,25,12,7,14,4,6,16,37.5,10,19,0,19,9,34,15,0,"FW,MF",20-24,Forward,Jamaica,North America
72479,Clment Grenier,FRA,Rennes,Ligue 1,2018,27.0,1991.0,29.6,44,27,7,33,4,21,61,34.4,40,28,4,24,29,73,34,1,MF,25-29,Midfielder,France,Europe
125781,Antoine Griezmann,FRA,Atltico Madrid,La Liga,2018,27.0,1991.0,35.5,31,19,8,13,10,8,28,28.6,20,18,1,17,12,43,21,0,"FW,MF",25-29,Forward,France,Europe
185077,Vincenzo Grifo,ITA,Hoffenheim,Bundesliga,2018,25.0,1993.0,3.7,6,3,2,3,1,0,5,0.0,5,2,1,1,2,8,5,0,"MF,FW",25-29,Midfielder,Italy,Europe
195736,Florian Grillitsch,AUT,Hoffenheim,Bundesliga,2018,22.0,1995.0,26.6,77,49,30,38,9,36,80,45.0,44,34,8,26,72,149,56,1,MF,20-24,Midfielder,Austria,Europe
82873,Pascal Gro,GER,Brighton,Premier League,2018,27.0,1991.0,20.7,27,12,12,12,3,11,36,30.6,25,20,8,12,13,40,23,0,"MF,FW",25-29,Midfielder,Germany,Europe
20506,Andrs Guardado,MEX,Betis,La Liga,2018,31.0,1986.0,25.9,24,15,9,12,3,11,47,23.4,36,27,1,26,28,52,28,1,"MF,DF",30-34,Midfielder,Mexico,North America
225122,Gonalo Guedes,POR,Valencia,La Liga,2018,21.0,1996.0,16.3,31,13,16,12,3,14,43,32.6,29,15,0,15,7,38,1,0,"MF,FW",20-24,Midfielder,Portugal,Europe
98596,John Guidetti,SWE,Alavs,La Liga,2018,26.0,1992.0,7.0,4,1,0,3,1,0,4,0.0,4,4,0,4,1,5,6,0,FW,25-29,Forward,Sweden,Europe
93704,Josuha Guilavogui,FRA,Wolfsburg,Bundesliga,2018,27.0,1990.0,17.4,31,16,18,13,0,14,25,56.0,11,17,8,9,43,74,56,2,MF,25-29,Midfielder,France,Europe
270541,Serhou Guirassy,GUI,Amiens,Ligue 1,2018,22.0,1996.0,12.3,7,5,1,5,1,0,4,0.0,4,7,0,7,4,11,14,0,FW,20-24,Forward,Guinea,Africa
53622,lkay Gndoan,GER,Manchester City,Premier League,2018,27.0,1990.0,23.7,19,12,4,12,3,6,31,19.4,25,12,3,9,28,47,19,1,MF,25-29,Midfielder,Germany,Europe
63821,Aron Gunnarsson,ISL,Cardiff City,Premier League,2018,29.0,1989.0,25.2,51,29,23,25,3,23,84,27.4,61,40,12,28,38,89,55,1,MF,25-29,Midfielder,Iceland,Europe
93707,Christian Gnter,GER,Freiburg,Bundesliga,2018,25.0,1993.0,32.0,38,26,16,16,6,20,43,46.5,23,31,7,24,14,52,55,0,"DF,MF",25-29,Defender,Germany,Europe
177779,Janik Haberer,GER,Freiburg,Bundesliga,2018,24.0,1994.0,26.0,71,47,37,24,10,30,75,40.0,45,31,4,27,36,107,49,0,"MF,FW",20-24,Midfielder,Germany,Europe
126281,Alexander Hack,GER,Mainz 05,Bundesliga,2018,24.0,1993.0,11.3,29,13,20,9,0,19,28,67.9,9,26,15,11,41,70,59,2,DF,20-24,Defender,Germany,Europe
223725,Munir El Haddadi,MAR,Sevilla,La Liga,2018,22.0,1995.0,11.6,17,10,5,7,5,2,7,28.6,5,15,0,15,6,23,9,0,"FW,MF",20-24,Forward,Morocco,Africa
42783,Andr Hahn,GER,Augsburg,Bundesliga,2018,27.0,1990.0,22.8,64,38,22,39,3,22,53,41.5,31,28,2,26,27,91,32,0,"FW,MF",25-29,Forward,Germany,Europe
402008,Amadou Haidara,MLI,RB Leipzig,Bundesliga,2018,20.0,1998.0,4.2,13,11,4,8,1,8,14,57.1,6,9,1,8,4,17,7,0,MF,20-24,Midfielder,Mali,Africa
398073,Achraf Hakimi,MAR,Dortmund,Bundesliga,2018,19.0,1998.0,19.3,34,19,25,8,1,17,36,47.2,19,27,4,23,29,63,45,2,DF,Under 20,Defender,Morocco,Africa
98349,Romain Hamouma,FRA,Saint-tienne,Ligue 1,2018,31.0,1987.0,17.6,30,19,6,18,6,12,32,37.5,20,12,1,11,9,39,7,0,"FW,MF",30-34,Forward,France,Europe
79377,Genki Haraguchi,JPN,Hannover 96,Bundesliga,2018,27.0,1991.0,23.7,44,26,21,20,3,17,66,25.8,49,34,5,29,21,65,33,0,"MF,DF",25-29,Midfielder,Japan,Asia
372711,Amine Harit,MAR,Schalke 04,Bundesliga,2018,21.0,1997.0,12.0,15,8,4,9,2,8,24,33.3,16,11,1,10,9,24,2,0,"MF,FW",20-24,Midfielder,Morocco,Africa
136501,Kadeem Harris,ENG,Cardiff City,Premier League,2018,25.0,1993.0,4.2,12,5,6,4,2,7,8,87.5,1,3,0,3,3,15,5,0,MF,25-29,Midfielder,England,Europe
275303,Hans Hateboer,NED,Atalanta,Serie A,2018,24.0,1994.0,33.0,43,31,19,19,5,17,34,50.0,17,29,5,24,23,66,47,1,DF,20-24,Defender,Netherlands,Europe
309400,Kai Havertz,GER,Leverkusen,Bundesliga,2018,19.0,1999.0,32.2,26,17,10,11,5,8,32,25.0,24,31,4,27,16,42,29,0,"MF,FW",Under 20,Midfielder,Germany,Europe
206225,Isaac Hayden,ENG,Newcastle Utd,Premier League,2018,23.0,1995.0,20.7,73,43,19,45,9,23,41,56.1,18,32,4,28,40,113,30,0,MF,20-24,Midfielder,England,Europe
50202,Eden Hazard,BEL,Chelsea,Premier League,2018,27.0,1991.0,32.5,14,9,2,1,11,5,17,29.4,12,10,0,10,13,27,6,1,FW,25-29,Forward,Belgium,Europe
110036,Dominique Heintz,GER,Freiburg,Bundesliga,2018,24.0,1993.0,33.9,41,21,34,6,1,18,32,56.3,14,45,22,23,45,86,214,0,DF,20-24,Defender,Germany,Europe
148262,Jeff Hendrick,IRL,Burnley,Premier League,2018,26.0,1992.0,22.9,24,12,13,7,4,9,32,28.1,23,20,5,15,12,36,31,0,"MF,FW",25-29,Midfielder,Republic of Ireland,Europe
16311,Rouwen Hennings,GER,Dsseldorf,Bundesliga,2018,30.0,1987.0,20.4,14,10,1,8,5,2,13,15.4,11,16,1,15,4,18,20,0,FW,30-34,Forward,Germany,Europe
281963,Lucas Hernndez,FRA,Atltico Madrid,La Liga,2018,22.0,1996.0,12.4,35,25,20,14,1,17,20,85.0,3,17,9,8,14,49,49,0,DF,20-24,Defender,France,Europe
339808,Theo Hernndez,FRA,Real Sociedad,La Liga,2018,20.0,1997.0,22.0,54,33,30,15,9,28,44,63.6,16,21,5,16,33,87,42,3,DF,20-24,Defender,France,Europe
378293,Yangel Herrera,VEN,Huesca,La Liga,2018,20.0,1998.0,12.8,48,24,18,25,5,23,43,53.5,20,13,1,12,14,62,32,0,"MF,DF",20-24,Midfielder,Venezuela,South America
32711,Patrick Herrmann,GER,Gladbach,Bundesliga,2018,27.0,1991.0,12.0,20,14,8,7,5,6,17,35.3,11,6,3,3,6,26,12,0,"FW,DF",25-29,Forward,Germany,Europe
39153,Gonzalo Higuan,ARG,Chelsea,Premier League,2018,30.0,1987.0,12.1,10,7,2,4,4,2,11,18.2,9,4,0,4,1,11,5,0,FW,30-34,Forward,Argentina,South America
55099,Nicolas Hfler,GER,Freiburg,Bundesliga,2018,28.0,1990.0,17.9,45,22,19,22,4,14,36,38.9,22,21,4,17,32,77,41,0,MF,25-29,Midfielder,Germany,Europe
227085,Jonas Hofmann,GER,Gladbach,Bundesliga,2018,26.0,1992.0,21.2,37,18,11,19,7,9,37,24.3,28,33,2,31,16,53,14,1,MF,25-29,Midfielder,Germany,Europe
61573,Jonathan Hogg,ENG,Huddersfield,Premier League,2018,29.0,1988.0,26.3,78,41,18,51,9,27,69,39.1,42,46,7,39,73,151,19,1,MF,25-29,Midfielder,England,Europe
248999,Lucas Hler,GER,Freiburg,Bundesliga,2018,24.0,1994.0,11.2,18,13,6,9,3,4,18,22.2,14,10,1,9,3,21,15,2,FW,20-24,Forward,Germany,Europe
52348,Benjamin Hbner,GER,Hoffenheim,Bundesliga,2018,29.0,1989.0,9.0,29,18,18,9,2,14,18,77.8,4,16,7,9,21,50,35,0,DF,25-29,Defender,Germany,Europe
207014,Will Hughes,ENG,Watford,Premier League,2018,23.0,1995.0,26.9,74,43,27,35,12,25,59,42.4,34,55,6,49,25,99,30,0,MF,20-24,Midfielder,England,Europe
203507,Adrien Hunou,FRA,Rennes,Ligue 1,2018,24.0,1994.0,13.8,11,7,3,5,3,2,9,22.2,7,14,0,14,5,16,8,0,"FW,MF",20-24,Forward,France,Europe
200056,Elseid Hysaj,ALB,Napoli,Serie A,2018,24.0,1994.0,23.4,40,28,22,15,3,25,49,51.0,24,11,3,8,24,64,51,0,DF,20-24,Defender,Albania,Europe
59699,Simone Iacoponi,ITA,Parma,Serie A,2018,31.0,1987.0,37.2,62,43,50,11,1,27,47,57.4,20,40,26,14,37,99,178,3,DF,30-34,Defender,Italy,Europe
195652,Jordon Ibe,ENG,Bournemouth,Premier League,2018,22.0,1995.0,8.9,6,5,0,5,1,2,7,28.6,5,2,0,2,4,10,4,0,"MF,DF",20-24,Midfielder,England,Europe
295330,Kelechi Iheanacho,NGA,Leicester City,Premier League,2018,21.0,1996.0,10.5,6,5,4,1,1,1,5,20.0,4,5,0,5,2,8,3,0,"FW,MF",20-24,Forward,Nigeria,Africa
157491,Jordan Ikoko,COD,Guingamp,Ligue 1,2018,24.0,1994.0,19.0,37,24,22,14,1,16,28,57.1,12,18,5,13,24,61,30,0,DF,20-24,Defender,DR Congo,Africa
74709,Emmanuel Imorou,BEN,Caen,Ligue 1,2018,29.0,1988.0,12.4,18,13,10,7,1,11,17,64.7,6,14,4,10,28,46,49,1,DF,25-29,Defender,Benin,Africa
134294,Danny Ings,ENG,Southampton,Premier League,2018,26.0,1992.0,18.3,30,14,5,19,6,11,28,39.3,17,30,2,28,5,35,9,0,FW,25-29,Forward,England,Europe
133964,Lorenzo Insigne,ITA,Napoli,Serie A,2018,27.0,1991.0,23.0,14,4,5,6,3,6,18,33.3,12,7,0,7,8,22,3,0,"FW,MF",25-29,Forward,Italy,Europe
45599,Emiliano Insa,ARG,Stuttgart,Bundesliga,2018,29.0,1989.0,23.5,51,33,26,18,7,25,42,59.5,17,29,2,27,31,82,55,1,DF,25-29,Defender,Argentina,South America
98249,Takashi Inui,JPN,Alavs,La Liga,2018,30.0,1988.0,9.2,9,5,6,2,1,5,18,27.8,13,5,0,5,4,13,3,0,"MF,FW",30-34,Midfielder,Japan,Asia
242631,Alex Iwobi,NGA,Arsenal,Premier League,2018,22.0,1996.0,21.9,28,14,10,16,2,6,25,24.0,19,21,1,20,12,40,13,1,"FW,MF",20-24,Forward,Nigeria,Africa
32113,Armando Izzo,ITA,Torino,Serie A,2018,26.0,1992.0,36.3,76,50,35,35,6,33,53,62.3,20,52,24,28,88,164,149,2,DF,25-29,Defender,Italy,Europe
28335,Christophe Jallet,FRA,Nice,Ligue 1,2018,34.0,1983.0,9.8,29,21,12,13,4,16,27,59.3,11,21,5,16,14,43,32,0,DF,30-34,Defender,France,Europe
177847,Adnan Januzaj,BEL,Real Sociedad,La Liga,2018,23.0,1995.0,13.9,11,8,5,2,4,3,13,23.1,10,7,0,7,6,17,6,0,"FW,MF",20-24,Forward,Belgium,Europe
20463,Corentin Jean,FRA,Toulouse,Ligue 1,2018,23.0,1995.0,7.0,9,6,3,6,0,2,8,25.0,6,8,0,8,2,11,5,0,"FW,MF",20-24,Forward,France,Europe
111048,Benjamin Jeannot,FRA,Dijon,Ligue 1,2018,26.0,1992.0,16.0,17,12,5,7,5,6,19,31.6,13,15,3,12,12,29,14,0,"FW,MF",25-29,Forward,France,Europe
363205,Gabriel Jesus,BRA,Manchester City,Premier League,2018,21.0,1997.0,11.5,10,3,5,2,3,0,5,0.0,5,16,2,14,3,13,4,0,FW,20-24,Forward,Brazil,South America
121985,Juan Jesus,BRA,Roma,Serie A,2018,27.0,1991.0,15.6,37,29,30,5,2,17,30,56.7,13,20,12,8,16,53,41,0,DF,25-29,Defender,Brazil,South America
333241,Joelinton,BRA,Hoffenheim,Bundesliga,2018,21.0,1996.0,23.7,35,22,9,20,6,10,30,33.3,20,36,3,33,14,49,8,0,"FW,MF",20-24,Forward,Brazil,South America
358421,Jakob Johansson,SWE,Rennes,Ligue 1,2018,28.0,1990.0,7.9,17,9,5,12,0,10,20,50.0,10,7,3,4,3,20,17,1,MF,25-29,Midfielder,Sweden,Europe
31041,Fabian Johnson,USA,Gladbach,Bundesliga,2018,30.0,1987.0,11.2,13,5,2,8,3,6,8,75.0,2,8,3,5,10,23,16,0,"DF,FW",30-34,Defender,United States,North America
58345,Jonathas,BRA,Hannover 96,Bundesliga,2018,29.0,1989.0,6.7,7,4,3,4,0,3,10,30.0,7,9,1,8,3,10,4,0,FW,25-29,Forward,Brazil,South America
117996,Phil Jones,ENG,Manchester Utd,Premier League,2018,26.0,1992.0,14.0,19,13,12,7,0,8,13,61.5,5,16,11,5,23,42,67,3,DF,25-29,Defender,England,Europe
512356,Jorginho,ITA,Chelsea,Premier League,2018,26.0,1991.0,35.1,76,38,27,41,8,45,96,46.9,51,46,7,39,64,140,38,1,MF,25-29,Midfielder,Italy,Europe
122155,Willian Jos,BRA,Real Sociedad,La Liga,2018,26.0,1991.0,26.3,5,3,1,3,1,2,7,28.6,5,11,5,6,1,6,27,0,FW,25-29,Forward,Brazil,South America
340950,Diogo Jota,POR,Wolves,Premier League,2018,21.0,1996.0,26.2,28,16,11,11,6,10,38,26.3,28,20,1,19,13,41,11,0,"FW,MF",20-24,Forward,Portugal,Europe
386315,Nathal Julan,FRA,Guingamp,Ligue 1,2018,22.0,1996.0,4.8,1,0,0,0,1,0,3,0.0,3,6,1,5,0,1,2,0,"FW,MF",20-24,Forward,France,Europe
201737,Christopher Jullien,FRA,Toulouse,Ligue 1,2018,25.0,1993.0,33.5,35,24,23,10,2,12,32,37.5,20,39,27,12,41,76,203,4,DF,25-29,Defender,France,Europe
361260,Ozan Kabak,TUR,Stuttgart,Bundesliga,2018,18.0,2000.0,15.0,33,19,22,9,2,9,19,47.4,10,15,8,7,23,56,58,1,DF,Under 20,Defender,Turkey,Asia
81512,Christian Kabasele,BEL,Watford,Premier League,2018,27.0,1991.0,17.6,25,14,20,5,0,10,23,43.5,13,21,16,5,38,63,111,0,DF,25-29,Defender,Belgium,Europe
49501,Elias Kachunga,COD,Huddersfield,Premier League,2018,26.0,1992.0,13.1,22,9,8,12,2,9,25,36.0,16,16,1,15,4,26,10,0,"FW,MF",25-29,Forward,DR Congo,Africa
106270,Florian Kainz,AUT,Werder Bremen,Bundesliga,2018,25.0,1992.0,4.1,6,5,5,1,0,3,6,50.0,3,4,1,3,3,9,5,0,FW,25-29,Forward,Austria,Europe
7971,Salomon Kalou,CIV,Hertha BSC,Bundesliga,2018,32.0,1985.0,25.7,21,12,5,11,5,6,24,25.0,18,23,1,22,6,27,25,0,"FW,MF",30-34,Forward,Ivory Coast,Africa
424051,Samuel Kalu,NGA,Bordeaux,Ligue 1,2018,20.0,1997.0,14.2,27,18,15,7,5,4,11,36.4,7,11,3,8,8,35,4,1,FW,20-24,Forward,Nigeria,Africa
394327,Boubacar Kamara,FRA,Marseille,Ligue 1,2018,18.0,1999.0,26.8,67,39,38,24,5,32,49,65.3,17,24,13,11,45,112,95,2,DF,Under 20,Defender,France,Europe
290017,Hassane Kamara,CIV,Reims,Ligue 1,2018,24.0,1994.0,10.3,29,21,22,5,2,16,19,84.2,3,6,1,5,14,43,41,0,"DF,FW",20-24,Defender,Ivory Coast,Africa
132098,Harry Kane,ENG,Tottenham,Premier League,2018,25.0,1993.0,26.9,10,6,2,8,0,1,14,7.1,13,16,6,10,1,11,14,0,FW,25-29,Forward,England,Europe
225083,N'Golo Kant,FRA,Chelsea,Premier League,2018,27.0,1991.0,34.4,75,41,21,41,13,23,67,34.3,44,63,6,57,44,119,32,1,MF,25-29,Midfielder,France,Europe
256120,Wilfrid Kaptoum,CMR,Betis,La Liga,2018,22.0,1996.0,8.6,15,6,4,10,1,5,11,45.5,6,9,1,8,10,25,6,2,MF,20-24,Midfielder,Cameroon,Africa
44741,Beram Kayal,ISR,Brighton,Premier League,2018,30.0,1988.0,10.4,28,17,16,11,1,5,21,23.8,16,17,10,7,15,43,25,0,MF,30-34,Midfielder,Israel,Asia
364135,Moise Kean,ITA,Juventus,Serie A,2018,18.0,2000.0,6.0,0,0,0,0,0,0,1,0.0,1,1,0,1,2,2,1,0,FW,Under 20,Forward,Italy,Europe
228948,Thilo Kehrer,GER,Paris S-G,Ligue 1,2018,21.0,1996.0,21.1,64,43,27,31,6,31,55,56.4,24,32,17,15,31,95,69,1,DF,20-24,Defender,Germany,Europe
402117,Jules Keita,GUI,Dijon,Ligue 1,2018,20.0,1998.0,5.1,10,4,0,3,7,5,12,41.7,7,2,0,2,2,12,1,0,"FW,MF",20-24,Forward,Guinea,Africa
302215,Naby Keta,GUI,Liverpool,Premier League,2018,23.0,1995.0,15.4,37,15,13,19,5,14,42,33.3,28,29,4,25,12,49,16,1,"MF,FW",20-24,Midfielder,Guinea,Africa
281404,Kenedy,BRA,Newcastle Utd,Premier League,2018,22.0,1996.0,15.0,30,22,11,16,3,12,29,41.4,17,10,0,10,32,62,24,1,"MF,DF",20-24,Midfielder,Brazil,South America
124517,Sebastian Kerk,GER,Nrnberg,Bundesliga,2018,24.0,1994.0,13.1,16,9,8,5,3,7,23,30.4,16,14,5,9,3,19,22,1,"MF,FW",20-24,Midfielder,Germany,Europe
294808,Franck Kessi,CIV,Milan,Serie A,2018,21.0,1996.0,33.5,42,27,16,20,6,18,38,47.4,20,35,10,25,27,69,53,2,MF,20-24,Midfielder,Ivory Coast,Africa
270411,Saf-Eddine Khaoui,TUN,Caen,Ligue 1,2018,23.0,1995.0,15.0,20,14,5,11,4,8,27,29.6,19,9,1,8,20,40,4,0,"MF,FW",20-24,Midfielder,Tunisia,Africa
103565,Wahbi Khazri,TUN,Saint-tienne,Ligue 1,2018,27.0,1991.0,31.3,41,26,8,14,19,17,49,34.7,32,27,2,25,11,52,5,0,"FW,MF",25-29,Forward,Tunisia,Africa
124410,Rani Khedira,GER,Augsburg,Bundesliga,2018,24.0,1994.0,29.2,56,39,22,28,6,18,36,50.0,18,44,22,22,80,136,95,1,"DF,MF",20-24,Defender,Germany,Europe
29401,Sami Khedira,GER,Juventus,Serie A,2018,31.0,1987.0,7.8,10,9,6,2,2,5,9,55.6,4,8,3,5,5,15,6,0,MF,30-34,Midfielder,Germany,Europe
161056,Joshua Kimmich,GER,Bayern Munich,Bundesliga,2018,23.0,1995.0,34.0,46,26,17,22,7,25,54,46.3,29,35,9,26,34,80,41,3,"DF,MF",20-24,Defender,Germany,Europe
282041,Presnel Kimpembe,FRA,Paris S-G,Ligue 1,2018,22.0,1995.0,22.3,55,34,26,25,4,24,40,60.0,16,17,10,7,30,85,48,5,DF,20-24,Defender,France,Europe
89591,Felix Klaus,GER,Wolfsburg,Bundesliga,2018,25.0,1992.0,4.9,10,7,4,5,1,2,7,28.6,5,5,0,5,4,14,0,0,"FW,MF",25-29,Forward,Germany,Europe
193033,Tim Kleindienst,GER,Freiburg,Bundesliga,2018,22.0,1995.0,2.2,4,3,1,2,1,1,3,33.3,2,3,0,3,0,4,7,0,FW,20-24,Forward,Germany,Europe
215599,Lukas Klostermann,GER,RB Leipzig,Bundesliga,2018,22.0,1996.0,22.3,50,29,33,12,5,29,45,64.4,16,37,5,32,29,79,74,0,DF,20-24,Defender,Germany,Europe
330659,Justin Kluivert,NED,Roma,Serie A,2018,19.0,1999.0,14.9,28,27,12,9,7,10,23,43.5,13,17,0,17,7,35,12,0,FW,Under 20,Forward,Netherlands,Europe
282577,Lukas Klnter,GER,Hertha BSC,Bundesliga,2018,22.0,1996.0,6.6,11,8,6,5,0,4,5,80.0,1,6,2,4,12,23,20,0,DF,20-24,Defender,Germany,Europe
284737,Trles Knll,GER,Nrnberg,Bundesliga,2018,20.0,1997.0,4.1,3,2,1,1,1,0,4,0.0,4,5,1,4,0,3,2,0,"FW,MF",20-24,Forward,Germany,Europe
118847,Dominik Kohr,GER,Leverkusen,Bundesliga,2018,24.0,1994.0,10.8,42,29,21,21,0,14,35,40.0,21,25,12,13,15,57,17,1,MF,20-24,Midfielder,Germany,Europe
84085,Timothe Kolodziejczak,FRA,Saint-tienne,Ligue 1,2018,26.0,1991.0,35.4,34,22,21,10,3,20,45,44.4,25,25,11,14,53,87,118,2,DF,25-29,Defender,France,Europe
357119,Ibrahima Konat,FRA,RB Leipzig,Bundesliga,2018,19.0,1999.0,27.0,44,32,30,14,0,17,27,63.0,10,29,18,11,58,102,126,0,DF,Under 20,Defender,France,Europe
127189,Geoffrey Kondogbia,CTA,Valencia,La Liga,2018,25.0,1993.0,13.8,47,33,18,23,6,12,27,44.4,15,20,7,13,27,74,22,2,MF,25-29,Midfielder,Central African Republic,Africa
57420,Lamine Kon,CIV,Strasbourg,Ligue 1,2018,29.0,1989.0,23.9,21,16,9,9,3,6,9,66.7,3,18,13,5,33,54,66,3,DF,25-29,Defender,Ivory Coast,Africa
193877,Pascal Kpke,GER,Hertha BSC,Bundesliga,2018,22.0,1995.0,0.8,1,0,1,0,0,1,2,50.0,1,0,0,0,0,1,0,0,"FW,MF",20-24,Forward,Germany,Europe
76277,Laurent Koscielny,FRA,Arsenal,Premier League,2018,32.0,1985.0,14.8,19,11,9,9,1,10,16,62.5,6,20,15,5,30,49,72,0,DF,30-34,Defender,France,Europe
337725,Christian Kouam,CIV,Genoa,Serie A,2018,20.0,1997.0,34.1,31,22,8,16,7,2,13,15.4,11,23,3,20,25,56,28,0,FW,20-24,Forward,Ivory Coast,Africa
93128,Kalidou Koulibaly,SEN,Napoli,Serie A,2018,27.0,1991.0,34.8,61,40,37,22,2,19,36,52.8,17,55,33,22,40,101,144,0,DF,25-29,Defender,Senegal,Africa
411975,Jules Kound,FRA,Bordeaux,Ligue 1,2018,19.0,1998.0,37.0,48,31,37,11,0,27,41,65.9,14,44,23,21,50,98,193,7,DF,Under 20,Defender,France,Europe
66934,Cheikhou Kouyat,SEN,Crystal Palace,Premier League,2018,28.0,1989.0,21.1,59,33,23,31,5,9,33,27.3,24,29,11,18,16,75,33,0,MF,25-29,Midfielder,Senegal,Africa
184528,Emil Krafth,SWE,Amiens,Ligue 1,2018,23.0,1994.0,33.0,55,35,34,14,7,32,65,49.2,33,27,12,15,23,78,94,4,DF,20-24,Defender,Sweden,Europe
82097,Christoph Kramer,GER,Gladbach,Bundesliga,2018,27.0,1991.0,12.6,41,22,17,23,1,15,40,37.5,25,19,4,15,21,62,23,0,MF,25-29,Midfielder,Germany,Europe
31909,Toni Kroos,GER,Real Madrid,La Liga,2018,28.0,1990.0,24.7,51,35,18,24,9,14,57,24.6,43,25,4,21,14,65,13,1,MF,25-29,Midfielder,Germany,Europe
93604,Lukas Kbler,GER,Freiburg,Bundesliga,2018,25.0,1992.0,13.2,35,22,23,12,0,16,26,61.5,10,15,5,10,30,65,50,1,"DF,MF",25-29,Defender,Germany,Europe
74943,Juraj Kucka,SVK,Parma,Serie A,2018,31.0,1987.0,17.1,51,32,17,29,5,19,53,35.8,34,27,7,20,17,68,37,1,MF,30-34,Midfielder,Slovakia,Europe
287876,Antonino La Gumina,ITA,Empoli,Serie A,2018,22.0,1996.0,12.1,5,4,1,2,2,2,6,33.3,4,8,2,6,6,11,5,0,"FW,MF",20-24,Forward,Italy,Europe
93720,Alexandre Lacazette,FRA,Arsenal,Premier League,2018,27.0,1991.0,27.8,35,16,6,19,10,5,28,17.9,23,27,1,26,15,50,31,0,FW,25-29,Forward,France,Europe
223967,Konrad Laimer,AUT,RB Leipzig,Bundesliga,2018,21.0,1997.0,20.8,72,38,21,34,17,20,71,28.2,51,67,2,65,32,104,23,0,"MF,DF",20-24,Midfielder,Austria,Europe
174196,Kenny Lala,MAD,Strasbourg,Ligue 1,2018,26.0,1991.0,34.0,78,45,48,23,7,30,53,56.6,23,26,9,17,28,106,62,2,"DF,FW",25-29,Defender,Madagascar,Africa
43530,Adam Lallana,ENG,Liverpool,Premier League,2018,30.0,1988.0,5.2,16,9,6,7,3,5,12,41.7,7,10,1,9,5,21,4,0,"MF,FW",30-34,Midfielder,England,Europe
39094,Sebastian Langkamp,GER,Werder Bremen,Bundesliga,2018,30.0,1988.0,15.7,24,15,18,6,0,7,14,50.0,7,17,11,6,20,44,79,1,DF,30-34,Defender,Germany,Europe
130394,Gianluca Lapadula,PER,Genoa,Serie A,2018,28.0,1990.0,4.5,2,1,2,0,0,1,5,20.0,4,2,0,2,1,3,2,0,FW,25-29,Forward,Peru,South America
183318,Jamaal Lascelles,ENG,Newcastle Utd,Premier League,2018,24.0,1993.0,30.5,32,21,25,5,2,11,14,78.6,3,43,28,15,39,71,218,3,DF,20-24,Defender,England,Europe
93726,Paul Lasne,FRA,Montpellier,Ligue 1,2018,29.0,1989.0,19.9,53,33,32,16,5,24,43,55.8,19,22,2,20,22,75,23,1,"MF,DF",25-29,Midfielder,France,Europe
39025,Danny Latza,GER,Mainz 05,Bundesliga,2018,28.0,1989.0,20.7,41,22,16,23,2,20,61,32.8,41,49,10,39,20,61,31,0,MF,25-29,Midfielder,Germany,Europe
94936,Vincent Laurini,FRA,Fiorentina,Serie A,2018,29.0,1989.0,10.2,13,5,6,5,2,6,10,60.0,4,11,5,6,13,26,30,0,DF,25-29,Defender,France,Europe
154199,Wesley Lautoa,NCL,Dijon,Ligue 1,2018,30.0,1987.0,33.6,81,55,46,31,4,34,75,45.3,41,37,14,23,87,168,110,1,"DF,MF",30-34,Defender,New Caledonia,Oceania
186368,Valentino Lazaro,AUT,Hertha BSC,Bundesliga,2018,22.0,1996.0,30.5,46,31,23,17,6,21,53,39.6,32,52,12,40,44,90,65,0,"DF,FW",20-24,Defender,Austria,Europe
357164,Rafael Leo,POR,Lille,Ligue 1,2018,19.0,1999.0,14.3,5,2,0,4,1,2,15,13.3,13,13,4,9,4,9,12,0,FW,Under 20,Forward,Portugal,Europe
377393,Pierre Lees-Melou,FRA,Nice,Ligue 1,2018,25.0,1993.0,26.6,74,46,31,36,7,25,62,40.3,37,44,8,36,36,110,37,0,MF,25-29,Midfielder,France,Europe
192492,Jordan Lefort,FRA,Amiens,Ligue 1,2018,24.0,1993.0,20.0,33,18,23,6,4,16,25,64.0,9,11,8,3,46,79,107,0,DF,20-24,Defender,France,Europe
185699,Tim Leibold,GER,Nrnberg,Bundesliga,2018,24.0,1993.0,30.7,62,42,45,16,1,33,71,46.5,38,23,3,20,38,100,57,0,DF,20-24,Defender,Germany,Europe
41414,Lucas Leiva,BRA,Lazio,Serie A,2018,31.0,1987.0,22.1,91,54,40,46,5,38,79,48.1,41,27,11,16,52,143,43,3,MF,30-34,Midfielder,Brazil,South America
127108,Florian Lejeune,FRA,Newcastle Utd,Premier League,2018,27.0,1991.0,11.7,25,15,17,7,1,11,24,45.8,13,16,5,11,21,46,49,0,DF,25-29,Defender,France,Europe
205562,Thomas Lemar,FRA,Atltico Madrid,La Liga,2018,22.0,1995.0,20.2,38,21,23,11,4,19,42,45.2,23,26,1,25,22,60,7,1,MF,20-24,Midfielder,France,Europe
182904,Clment Lenglet,FRA,Barcelona,La Liga,2018,23.0,1995.0,21.5,47,29,26,19,2,22,36,61.1,14,30,20,10,21,68,70,0,DF,20-24,Defender,France,Europe
14221,Aaron Lennon,ENG,Burnley,Premier League,2018,31.0,1987.0,13.5,26,16,11,12,3,6,14,42.9,8,24,0,24,10,36,18,0,MF,30-34,Midfielder,England,Europe
262980,Jefferson Lerma,COL,Bournemouth,Premier League,2018,23.0,1994.0,27.8,45,31,20,20,5,14,54,25.9,40,35,19,16,54,99,88,1,MF,20-24,Midfielder,Colombia,South America
314940,Dimitri Linard,FRA,Strasbourg,Ligue 1,2018,30.0,1988.0,14.3,33,18,20,9,4,21,45,46.7,24,11,2,9,18,51,22,0,"MF,DF",30-34,Midfielder,France,Europe
184573,Victor Lindelf,SWE,Manchester Utd,Premier League,2018,24.0,1994.0,28.9,40,27,28,12,0,13,23,56.5,10,21,12,9,24,64,121,3,DF,20-24,Defender,Sweden,Europe
141660,Jesse Lingard,ENG,Manchester Utd,Premier League,2018,25.0,1992.0,18.5,29,18,8,11,10,7,28,25.0,21,18,2,16,10,39,9,1,"FW,MF",25-29,Forward,England,Europe
192735,Stanislav Lobotka,SVK,Celta Vigo,La Liga,2018,23.0,1994.0,27.7,30,19,10,17,3,9,32,28.1,23,15,1,14,26,56,18,1,MF,20-24,Midfielder,Slovakia,Europe
166240,Jrgen Locadia,CUW,Brighton,Premier League,2018,24.0,1993.0,13.7,15,10,5,8,2,3,7,42.9,4,8,0,8,9,24,13,0,"FW,MF",20-24,Forward,Curaao,Europe
202886,Ruben Loftus-Cheek,ENG,Chelsea,Premier League,2018,22.0,1996.0,11.1,18,12,7,7,4,3,12,25.0,9,10,4,6,11,29,5,0,"MF,FW",20-24,Midfielder,England,Europe
581781,Enzo Loiodice,FRA,Dijon,Ligue 1,2018,17.0,2000.0,9.4,25,14,8,15,2,10,21,47.6,11,7,0,7,11,36,7,0,MF,Under 20,Midfielder,France,Europe
37304,Shane Long,IRL,Southampton,Premier League,2018,31.0,1987.0,14.1,15,8,4,5,6,3,16,18.8,13,10,1,9,7,22,18,0,"FW,MF",30-34,Forward,Republic of Ireland,Europe
406040,Ademola Lookman,NGA,Everton,Premier League,2018,20.0,1997.0,6.9,15,7,7,5,3,4,6,66.7,2,10,0,10,7,22,2,0,"FW,MF",20-24,Forward,Nigeria,Africa
55125,Chris Lwe,GER,Huddersfield,Premier League,2018,29.0,1989.0,22.9,34,18,17,15,2,12,33,36.4,21,21,3,18,23,57,56,0,"DF,MF",25-29,Defender,Germany,Europe
260655,Eduard Lwen,GER,Nrnberg,Bundesliga,2018,21.0,1997.0,18.0,30,22,14,13,3,11,34,32.4,23,15,2,13,8,38,23,0,"MF,FW",20-24,Midfielder,Germany,Europe
21725,Filipe Lus,BRA,Atltico Madrid,La Liga,2018,32.0,1985.0,22.6,66,36,33,25,8,32,58,55.2,26,18,3,15,44,110,47,0,DF,30-34,Defender,Brazil,South America
125020,Jos Luis Palomino,ARG,Atalanta,Serie A,2018,28.0,1990.0,25.1,49,31,31,15,3,23,38,60.5,15,34,17,17,68,117,79,0,DF,25-29,Defender,Argentina,South America
46741,David Luiz,BRA,Chelsea,Premier League,2018,31.0,1987.0,36.0,41,31,27,13,1,21,28,75.0,7,33,18,15,35,76,149,1,DF,30-34,Defender,Brazil,South America
96341,Romelu Lukaku,BEL,Manchester Utd,Premier League,2018,25.0,1993.0,23.7,8,4,0,6,2,2,10,20.0,8,12,1,11,2,10,19,0,FW,25-29,Forward,Belgium,Europe
95336,Herv Lybohy,NIG,Nmes,Ligue 1,2018,35.0,1983.0,16.4,22,13,13,9,0,11,16,68.8,5,17,11,6,14,36,70,0,DF,35-39,Defender,Niger,Africa
211251,Darwin Machs,VEN,Udinese,Serie A,2018,25.0,1993.0,5.1,7,6,4,3,0,0,4,0.0,4,6,0,6,2,9,8,0,"FW,MF",25-29,Forward,Venezuela,South America
294057,James Maddison,ENG,Leicester City,Premier League,2018,21.0,1996.0,31.5,48,32,20,25,3,14,58,24.1,44,20,4,16,12,60,10,1,"MF,FW",20-24,Midfielder,England,Europe
435338,Gabriel Magalhes,BRA,Lille,Ligue 1,2018,20.0,1997.0,11.8,18,11,13,4,1,4,7,57.1,3,14,6,8,19,37,60,2,DF,20-24,Defender,Brazil,South America
177907,Harry Maguire,ENG,Leicester City,Premier League,2018,25.0,1993.0,28.8,31,17,21,9,1,11,17,64.7,6,32,18,14,36,67,155,4,DF,25-29,Defender,England,Europe
294873,Thiago Maia,BRA,Lille,Ligue 1,2018,21.0,1997.0,11.3,32,19,17,13,2,13,33,39.4,20,14,5,9,23,55,23,0,MF,20-24,Midfielder,Brazil,South America
140559,Raffaele Maiello,ITA,Frosinone,Serie A,2018,27.0,1991.0,22.7,42,27,30,8,4,16,27,59.3,11,23,10,13,30,72,41,0,MF,25-29,Midfielder,Italy,Europe
296397,Arne Maier,GER,Hertha BSC,Bundesliga,2018,19.0,1999.0,22.9,31,16,12,19,0,6,25,24.0,19,32,9,23,28,59,35,0,MF,Under 20,Midfielder,Germany,Europe
22140,Domenico Maietta,ITA,Empoli,Serie A,2018,35.0,1982.0,19.0,33,15,22,10,1,16,36,44.4,20,19,14,5,24,57,78,2,DF,35-39,Defender,Italy,Europe
335103,Linton Maina,GER,Hannover 96,Bundesliga,2018,19.0,1999.0,15.7,28,14,13,10,5,12,23,52.2,11,20,0,20,14,42,4,0,"FW,MF",Under 20,Forward,Germany,Europe
285845,Ainsley Maitland-Niles,ENG,Arsenal,Premier League,2018,20.0,1997.0,11.0,33,22,19,12,2,14,28,50.0,14,22,4,18,19,52,15,2,DF,20-24,Defender,England,Europe
322305,Jean-Victor Makengo,FRA,Nice,Ligue 1,2018,20.0,1998.0,11.4,10,8,3,6,1,1,5,20.0,4,5,1,4,9,19,5,0,"MF,FW",20-24,Midfielder,France,Europe
83132,Vincent Manceau,FRA,Angers,Ligue 1,2018,29.0,1989.0,31.0,98,65,64,23,11,33,62,53.2,29,41,10,31,44,142,87,0,DF,25-29,Defender,France,Europe
256448,Gianluca Mancini,ITA,Atalanta,Serie A,2018,22.0,1996.0,25.0,40,30,22,17,1,16,29,55.2,13,19,4,15,48,88,77,1,DF,20-24,Defender,Italy,Europe
80293,Assa Mandi,ALG,Betis,La Liga,2018,26.0,1991.0,34.0,52,34,27,20,5,12,29,41.4,17,39,23,16,41,93,71,2,DF,25-29,Defender,Algeria,Africa
308279,Rolando Mandragora,ITA,Udinese,Serie A,2018,21.0,1997.0,32.4,66,35,25,34,7,24,69,34.8,45,49,9,40,43,109,59,0,MF,20-24,Midfielder,Italy,Europe
200512,Sadio Man,SEN,Liverpool,Premier League,2018,26.0,1992.0,34.2,35,29,12,17,6,14,43,32.6,29,28,4,24,15,50,10,1,FW,25-29,Forward,Senegal,Africa
18934,Thomas Mangani,FRA,Angers,Ligue 1,2018,31.0,1987.0,17.8,42,27,13,26,3,19,62,30.6,43,13,2,11,23,65,24,0,MF,30-34,Midfielder,France,Europe
357072,Faitout Maouassa,FRA,Nmes,Ligue 1,2018,20.0,1998.0,23.7,55,30,35,15,5,23,39,59.0,16,24,5,19,23,78,81,1,DF,20-24,Defender,France,Europe
209212,Solly March,ENG,Brighton,Premier League,2018,24.0,1994.0,27.4,56,24,27,16,13,19,45,42.2,26,34,4,30,27,83,44,0,"FW,MF",20-24,Forward,England,Europe
277167,Gian Marco Ferrari,ITA,Sassuolo,Serie A,2018,26.0,1992.0,31.0,41,23,27,12,2,12,16,75.0,4,36,20,16,36,77,97,1,DF,25-29,Defender,Italy,Europe
51325,Georg Margreitter,AUT,Nrnberg,Bundesliga,2018,29.0,1988.0,22.9,39,24,28,8,3,31,38,81.6,7,29,26,3,26,65,141,0,DF,25-29,Defender,Austria,Europe
250845,Jos Mara Gimnez,URU,Atltico Madrid,La Liga,2018,23.0,1995.0,19.7,26,15,20,6,0,13,26,50.0,13,27,14,13,44,70,128,2,DF,20-24,Defender,Uruguay,South America
38145,Adrian Mariappa,JAM,Watford,Premier League,2018,31.0,1986.0,21.4,35,22,29,6,0,16,32,50.0,16,23,15,8,26,61,120,2,DF,30-34,Defender,Jamaica,North America
231025,Jordan Mari,FRA,Dijon,Ligue 1,2018,26.0,1991.0,20.0,52,28,15,31,6,21,58,36.2,37,28,5,23,40,92,32,0,MF,25-29,Midfielder,France,Europe
249730,Guillermo Maripn,CHI,Alavs,La Liga,2018,24.0,1994.0,22.3,46,26,34,12,0,26,38,68.4,12,35,19,16,40,86,133,2,DF,20-24,Defender,Chile,South America
127142,Jonas Martin,FRA,Strasbourg,Ligue 1,2018,28.0,1990.0,22.9,46,28,23,18,5,17,33,51.5,16,30,12,18,30,76,42,0,MF,25-29,Midfielder,France,Europe
406625,Lautaro Martnez,ARG,Inter,Serie A,2018,20.0,1997.0,14.9,6,5,0,2,4,2,6,33.3,4,16,0,16,3,9,7,0,"FW,MF",20-24,Forward,Argentina,South America
420002,Jean-Philippe Mateta,FRA,Mainz 05,Bundesliga,2018,21.0,1997.0,27.6,13,9,4,4,5,1,10,10.0,9,15,2,13,3,16,22,0,FW,20-24,Forward,France,Europe
40660,Alessandro Matri,ITA,Sassuolo,Serie A,2018,33.0,1984.0,6.7,2,1,0,0,2,0,3,0.0,3,4,2,2,4,6,7,0,FW,30-34,Forward,Italy,Europe
33923,Blaise Matuidi,FRA,Juventus,Serie A,2018,31.0,1987.0,26.9,59,33,25,21,13,20,36,55.6,16,33,8,25,26,85,21,1,MF,30-34,Midfielder,France,Europe
342229,Kylian Mbapp,FRA,Paris S-G,Ligue 1,2018,19.0,1998.0,26.0,8,4,2,1,5,1,6,16.7,5,2,0,2,5,13,2,0,FW,Under 20,Forward,France,Europe
207715,Ibrahima Mbaye,SEN,Bologna,Serie A,2018,23.0,1994.0,22.3,48,32,30,16,2,19,32,59.4,13,21,12,9,19,67,66,1,DF,20-24,Defender,Senegal,Africa
230066,Adama Mbengue,SEN,Caen,Ligue 1,2018,24.0,1993.0,8.2,48,32,34,12,2,19,26,73.1,7,15,4,11,7,55,22,0,DF,20-24,Defender,Senegal,Africa
41416,James McArthur,SCO,Crystal Palace,Premier League,2018,30.0,1987.0,34.0,84,51,38,32,14,30,78,38.5,48,64,22,42,39,123,55,0,MF,30-34,Midfielder,Scotland,Europe
56912,Levan Mchedlidze,GEO,Empoli,Serie A,2018,28.0,1990.0,2.3,1,1,0,0,1,0,1,0.0,1,2,0,2,0,1,5,0,FW,25-29,Forward,Georgia,Asia
332697,Weston McKennie,USA,Schalke 04,Bundesliga,2018,19.0,1998.0,19.4,28,14,5,17,6,11,35,31.4,24,28,9,19,36,64,46,1,"MF,FW",Under 20,Midfielder,United States,North America
315969,Scott McTominay,SCO,Manchester Utd,Premier League,2018,21.0,1996.0,9.6,10,9,3,6,1,4,10,40.0,6,9,4,5,15,25,16,0,"MF,DF",20-24,Midfielder,Scotland,Europe
74810,Ben Mee,ENG,Burnley,Premier League,2018,28.0,1989.0,38.0,55,24,38,17,0,35,44,79.5,9,59,50,9,48,103,235,4,DF,25-29,Defender,England,Europe
425400,Farid El Melali,ALG,Angers,Ligue 1,2018,21.0,1997.0,3.6,8,4,3,4,1,3,12,25.0,9,2,0,2,5,13,1,0,"MF,FW",20-24,Midfielder,Algeria,Africa
362842,Arthur Melo,BRA,Barcelona,La Liga,2018,21.0,1996.0,15.9,15,10,5,6,4,6,13,46.2,7,8,0,8,9,24,9,1,MF,20-24,Midfielder,Brazil,South America
135617,Thiago Mendes,BRA,Lille,Ligue 1,2018,26.0,1992.0,34.2,85,47,42,41,2,39,71,54.9,32,44,11,33,68,153,49,0,MF,25-29,Midfielder,Brazil,South America
125409,Nathaniel Mendez-Laing,GUA,Cardiff City,Premier League,2018,26.0,1992.0,10.9,34,25,18,12,4,12,26,46.2,14,17,1,16,13,47,20,0,"MF,FW",25-29,Midfielder,Guatemala,North America
290561,Alexandre Mendy,GNB,Guingamp,Ligue 1,2018,24.0,1994.0,8.5,5,3,0,4,1,3,8,37.5,5,3,0,3,1,6,6,0,FW,20-24,Forward,Guinea-Bissau,Africa
157495,Benjamin Mendy,FRA,Manchester City,Premier League,2018,24.0,1994.0,10.0,16,10,10,5,1,9,17,52.9,8,13,4,9,10,26,18,0,DF,20-24,Defender,France,Europe
291417,Ferland Mendy,FRA,Lyon,Ligue 1,2018,23.0,1995.0,28.1,44,28,25,14,5,14,17,82.4,3,22,5,17,34,78,53,2,DF,20-24,Defender,France,Europe
45319,Gabriel Mercado,ARG,Sevilla,La Liga,2018,31.0,1987.0,19.3,35,23,21,12,2,18,36,50.0,18,24,12,12,26,61,75,1,DF,30-34,Defender,Argentina,South America
28003,Lionel Messi,ARG,Barcelona,La Liga,2018,31.0,1987.0,30.1,12,7,5,3,4,1,17,5.9,16,10,0,10,3,15,1,0,FW,30-34,Forward,Argentina,South America
154209,Romain Mtanire,MAD,Reims,Ligue 1,2018,28.0,1990.0,3.5,12,9,10,1,1,5,7,71.4,2,4,3,1,6,18,13,0,DF,25-29,Defender,Madagascar,Africa
100986,Thomas Meunier,BEL,Paris S-G,Ligue 1,2018,26.0,1991.0,17.9,44,33,25,15,4,21,35,60.0,14,13,2,11,19,63,29,0,DF,25-29,Defender,Belgium,Europe
3333,James Milner,ENG,Liverpool,Premier League,2018,32.0,1986.0,19.9,43,23,14,24,5,15,41,36.6,26,40,5,35,18,61,30,0,"MF,DF",30-34,Midfielder,England,Europe
35747,Simone Missiroli,ITA,SPAL,Serie A,2018,32.0,1986.0,30.5,58,43,31,22,5,25,49,51.0,24,44,11,33,46,104,46,0,MF,30-34,Midfielder,Italy,Europe
55735,Henrikh Mkhitaryan,ARM,Arsenal,Premier League,2018,29.0,1989.0,18.2,28,22,8,17,3,6,22,27.3,16,34,2,32,16,44,13,0,"FW,MF",25-29,Forward,Armenia,Asia
5017,Niklas Moisander,FIN,Werder Bremen,Bundesliga,2018,32.0,1985.0,29.3,34,23,26,8,0,22,51,43.1,29,42,19,23,39,73,140,2,DF,30-34,Defender,Finland,Europe
222859,Florent Mollet,FRA,Montpellier,Ligue 1,2018,26.0,1991.0,28.5,36,20,8,20,8,13,51,25.5,38,32,1,31,23,59,7,0,MF,25-29,Midfielder,France,Europe
127182,Thomas Monconduit,FRA,Amiens,Ligue 1,2018,27.0,1991.0,31.3,76,47,38,33,5,26,63,41.3,37,46,17,29,36,112,77,1,MF,25-29,Midfielder,France,Europe
44045,Kvin Monnet-Paquet,FRA,Saint-tienne,Ligue 1,2018,29.0,1988.0,16.5,46,25,23,16,7,20,36,55.6,16,22,4,18,14,60,28,0,"DF,MF",25-29,Defender,France,Europe
58500,Alfredo Morales,USA,Dsseldorf,Bundesliga,2018,28.0,1990.0,17.0,32,18,16,15,1,6,24,25.0,18,18,9,9,24,56,31,0,MF,25-29,Midfielder,United States,North America
203517,Steven Moreira,CPV,Toulouse,Ligue 1,2018,23.0,1994.0,9.6,19,8,13,5,1,10,17,58.8,7,14,0,14,10,29,19,1,"DF,MF",20-24,Defender,Cape Verde,Africa
51046,Hctor Moreno,MEX,Real Sociedad,La Liga,2018,30.0,1988.0,21.5,16,9,12,4,0,9,17,52.9,8,34,19,15,31,47,73,0,DF,30-34,Defender,Mexico,North America
10003,Wes Morgan,JAM,Leicester City,Premier League,2018,34.0,1984.0,21.4,27,15,14,12,1,6,7,85.7,1,24,10,14,32,59,109,1,DF,30-34,Defender,Jamaica,North America
79723,Sean Morrison,ENG,Cardiff City,Premier League,2018,27.0,1991.0,33.8,35,17,29,4,2,15,28,53.6,13,47,30,17,52,87,204,5,DF,25-29,Defender,England,Europe
238639,Steve Mouni,BEN,Huddersfield,Premier League,2018,23.0,1994.0,19.8,9,6,3,4,2,2,12,16.7,10,10,1,9,5,14,15,0,FW,20-24,Forward,Benin,Africa
77100,Lucas Moura,BRA,Tottenham,Premier League,2018,25.0,1992.0,23.6,35,18,8,20,7,9,27,33.3,18,15,1,14,24,59,24,0,"FW,MF",25-29,Forward,Brazil,South America
461906,Joo Moutinho,POR,Wolves,Premier League,2018,31.0,1986.0,33.7,113,58,50,56,7,44,126,34.9,82,56,11,45,40,153,50,0,MF,30-34,Midfielder,Portugal,Europe
279079,Lukas Mhl,GER,Nrnberg,Bundesliga,2018,21.0,1997.0,31.0,57,34,49,6,2,32,51,62.7,19,53,18,35,48,105,139,2,DF,20-24,Defender,Germany,Europe
348026,Nordi Mukiele,FRA,RB Leipzig,Bundesliga,2018,20.0,1997.0,13.6,38,21,23,12,3,19,22,86.4,3,17,3,14,24,62,35,0,DF,20-24,Defender,France,Europe
39426,Nicolai Mller,GER,Hannover 96,Bundesliga,2018,30.0,1987.0,10.0,18,9,7,7,4,8,27,29.6,19,9,1,8,1,19,7,0,"MF,FW",30-34,Midfielder,Germany,Europe
58358,Thomas Mller,GER,Bayern Munich,Bundesliga,2018,28.0,1989.0,26.4,42,23,13,15,14,10,38,26.3,28,46,6,40,9,51,12,0,"MF,FW",25-29,Midfielder,Germany,Europe
119228,Luis Muriel,COL,Fiorentina,Serie A,2018,27.0,1991.0,16.0,19,11,4,13,2,6,18,33.3,12,10,0,10,3,22,1,0,FW,25-29,Forward,Colombia,South America
199527,Jacob Murphy,ENG,Newcastle Utd,Premier League,2018,23.0,1995.0,3.4,6,2,4,2,0,2,4,50.0,2,5,2,3,1,7,7,0,"MF,DF",20-24,Midfielder,England,Europe
199528,Josh Murphy,ENG,Cardiff City,Premier League,2018,23.0,1995.0,20.2,26,17,15,7,4,9,29,31.0,20,30,0,30,11,37,17,0,"MF,FW",20-24,Midfielder,England,Europe
45693,Glenn Murray,ENG,Brighton,Premier League,2018,34.0,1983.0,27.9,17,7,4,7,6,4,20,20.0,16,20,3,17,2,19,17,1,FW,30-34,Forward,England,Europe
171399,Nicola Murru,ITA,Sampdoria,Serie A,2018,23.0,1994.0,32.6,83,59,42,25,16,41,54,75.9,13,50,22,28,41,124,99,0,DF,20-24,Defender,Italy,Europe
88590,Shkodran Mustafi,GER,Arsenal,Premier League,2018,26.0,1992.0,29.0,62,45,42,17,3,31,40,77.5,9,34,17,17,58,120,168,1,DF,25-29,Defender,Germany,Europe
67823,Damin Musto,ARG,Huesca,La Liga,2018,31.0,1987.0,18.7,52,34,22,27,3,16,33,48.5,17,30,11,19,34,86,54,1,"MF,DF",30-34,Midfielder,Argentina,South America
282058,Cheikh N'Doye,SEN,Angers,Ligue 1,2018,32.0,1986.0,25.9,25,15,14,11,0,10,32,31.3,22,33,8,25,25,50,61,0,MF,30-34,Midfielder,Senegal,Africa
368559,dm Nagy,HUN,Bologna,Serie A,2018,23.0,1995.0,10.8,29,21,15,13,1,11,21,52.4,10,13,5,8,25,54,12,2,MF,20-24,Midfielder,Hungary,Europe
274839,Wilfred Ndidi,NGA,Leicester City,Premier League,2018,21.0,1996.0,36.6,142,98,66,67,9,46,95,48.4,49,64,9,55,83,225,85,2,MF,20-24,Midfielder,Nigeria,Africa
278332,Florian Neuhaus,GER,Gladbach,Bundesliga,2018,21.0,1997.0,22.9,22,15,9,9,4,10,36,27.8,26,20,1,19,10,32,23,0,MF,20-24,Midfielder,Germany,Europe
225161,Rben Neves,POR,Wolves,Premier League,2018,21.0,1997.0,33.4,75,32,33,36,6,27,83,32.5,56,57,18,39,73,148,46,3,MF,20-24,Midfielder,Portugal,Europe
68290,Neymar,BRA,Paris S-G,Ligue 1,2018,26.0,1992.0,16.0,14,9,3,10,1,4,21,19.0,17,8,0,8,5,19,1,1,"MF,FW",25-29,Midfielder,Brazil,South America
209781,Oumar Niasse,SEN,Cardiff City,Premier League,2018,28.0,1990.0,10.3,12,3,1,5,6,4,8,50.0,4,7,0,7,2,14,7,0,FW,25-29,Forward,Senegal,Africa
152963,Florian Niederlechner,GER,Freiburg,Bundesliga,2018,27.0,1990.0,10.8,7,5,1,4,2,0,5,0.0,5,12,4,8,6,13,10,0,"FW,MF",25-29,Forward,Germany,Europe
392810,Casimir Ninga,CHA,Caen,Ligue 1,2018,25.0,1993.0,27.4,53,30,23,21,9,20,49,40.8,29,22,1,21,22,75,12,0,"FW,MF",25-29,Forward,Chad,Africa
344381,Christopher Nkunku,FRA,Paris S-G,Ligue 1,2018,20.0,1997.0,12.8,21,16,8,10,3,7,16,43.8,9,12,2,10,9,30,7,1,"MF,FW",20-24,Midfielder,France,Europe
324811,Arnaud Nordin,FRA,Saint-tienne,Ligue 1,2018,20.0,1998.0,11.7,14,12,4,4,6,4,11,36.4,7,13,2,11,5,19,9,0,"FW,MF",20-24,Forward,France,Europe
111508,Allan Nyom,CMR,Legans,La Liga,2018,30.0,1988.0,19.0,32,24,20,10,2,12,17,70.6,5,7,2,5,20,52,35,0,"DF,FW",30-34,Defender,Cameroon,Africa
45581,Joel Obi,NGA,Chievo,Serie A,2018,27.0,1991.0,7.3,22,15,9,11,2,7,17,41.2,10,12,1,11,14,36,15,0,MF,25-29,Midfielder,Nigeria,Africa
101213,Pedro Obiang,EQG,West Ham,Premier League,2018,26.0,1992.0,12.5,41,23,23,16,2,18,43,41.9,25,27,9,18,12,53,18,0,MF,25-29,Midfielder,Equatorial Guinea,Africa
189441,Lucas Ocampos,ARG,Marseille,Ligue 1,2018,24.0,1994.0,30.1,80,54,37,33,10,34,80,42.5,46,40,5,35,29,109,30,0,"FW,MF",20-24,Forward,Argentina,South America
53437,Bastian Oczipka,GER,Schalke 04,Bundesliga,2018,29.0,1989.0,20.8,41,27,20,19,2,21,26,80.8,5,23,5,18,24,65,24,2,"DF,FW",25-29,Defender,Germany,Europe
48002,Angelo Ogbonna,ITA,West Ham,Premier League,2018,30.0,1988.0,20.8,31,13,23,6,2,14,23,60.9,9,29,19,10,35,66,101,0,DF,30-34,Defender,Italy,Europe
60578,Prince Oniangu,CGO,Caen,Ligue 1,2018,29.0,1988.0,26.0,59,33,22,34,3,24,57,42.1,33,30,10,20,29,88,42,0,MF,25-29,Midfielder,Congo,Africa
119234,Karim Onisiwo,AUT,Mainz 05,Bundesliga,2018,26.0,1992.0,12.9,23,15,6,12,5,4,12,33.3,8,14,3,11,9,32,13,0,"FW,MF",25-29,Forward,Austria,Europe
60890,Fabin Orellana,CHI,Eibar,La Liga,2018,32.0,1986.0,30.4,44,21,14,16,14,9,42,21.4,33,17,0,17,19,63,4,0,"MF,FW",30-34,Midfielder,Chile,South America
148368,Divock Origi,BEL,Liverpool,Premier League,2018,23.0,1995.0,4.1,6,1,2,3,1,1,4,25.0,3,2,0,2,0,6,2,0,FW,20-24,Forward,Belgium,Europe
108650,Yuya Osako,JPN,Werder Bremen,Bundesliga,2018,28.0,1990.0,15.0,23,11,6,12,5,7,22,31.8,15,15,3,12,7,30,8,0,"FW,MF",25-29,Forward,Japan,Asia
818495,Otvio,BRA,Bordeaux,Ligue 1,2018,24.0,1994.0,31.9,127,74,59,64,4,49,109,45.0,60,45,11,34,43,170,54,1,MF,20-24,Midfielder,Brazil,South America
400485,Adam Ounas,ALG,Napoli,Serie A,2018,21.0,1996.0,6.0,5,2,0,3,2,2,11,18.2,9,6,0,6,2,7,0,1,"MF,FW",20-24,Midfielder,Algeria,Africa
184922,Ambroise Oyongo,CMR,Montpellier,Ligue 1,2018,27.0,1991.0,23.7,44,21,23,16,5,20,38,52.6,18,26,6,20,38,82,60,0,DF,25-29,Defender,Cameroon,Africa
181547,Gonalo Pacincia,POR,Eint Frankfurt,Bundesliga,2018,23.0,1994.0,4.3,3,2,0,2,1,1,2,50.0,1,8,1,7,0,3,1,0,FW,20-24,Forward,Portugal,Europe
56703,Simone Padoin,ITA,Cagliari,Serie A,2018,34.0,1984.0,21.3,34,25,12,18,4,14,33,42.4,19,18,5,13,14,48,54,0,"DF,MF",30-34,Defender,Italy,Europe
167444,Luca Paganini,ITA,Frosinone,Serie A,2018,25.0,1993.0,12.5,25,13,8,13,4,8,23,34.8,15,19,4,15,19,44,17,1,"DF,MF",25-29,Defender,Italy,Europe
139279,Nicolas Pallois,FRA,Nantes,Ligue 1,2018,30.0,1987.0,24.0,77,48,60,17,0,40,69,58.0,29,30,14,16,34,111,114,0,DF,30-34,Defender,France,Europe
68306,Alberto Paloschi,ITA,SPAL,Serie A,2018,28.0,1990.0,9.6,13,9,3,5,5,1,2,50.0,1,2,0,2,1,14,0,0,FW,25-29,Forward,Italy,Europe
12563,Goran Pandev,MKD,Genoa,Serie A,2018,35.0,1983.0,12.5,14,10,0,10,4,2,8,25.0,6,7,0,7,1,15,3,0,"FW,MF",35-39,Forward,North Macedonia,Europe
34322,Sokratis Papastathopoulos,GRE,Arsenal,Premier League,2018,30.0,1988.0,24.4,42,25,30,11,1,15,28,53.6,13,34,17,17,26,68,112,1,DF,30-34,Defender,Greece,Europe
444523,Lucas Paquet,BRA,Milan,Serie A,2018,20.0,1997.0,9.4,18,9,9,8,1,7,24,29.2,17,12,0,12,4,22,11,2,MF,20-24,Midfielder,Brazil,South America
412092,Gatan Paquiez,FRA,Nmes,Ligue 1,2018,24.0,1994.0,14.8,43,29,30,10,3,23,48,47.9,25,24,6,18,22,65,50,0,DF,20-24,Defender,France,Europe
166237,Leandro Paredes,ARG,Paris S-G,Ligue 1,2018,24.0,1994.0,13.9,34,19,16,15,3,13,30,43.3,17,17,5,12,14,48,20,2,MF,20-24,Midfielder,Argentina,South America
238981,Vittorio Parigini,ITA,Torino,Serie A,2018,22.0,1996.0,4.2,11,10,3,6,2,6,9,66.7,3,3,0,3,1,12,5,0,"MF,DF",20-24,Midfielder,Italy,Europe
230784,Thomas Partey,GHA,Atltico Madrid,La Liga,2018,25.0,1993.0,23.0,66,42,32,25,9,21,49,42.9,28,26,5,21,49,115,22,2,MF,25-29,Midfielder,Ghana,Africa
55215,Javier Pastore,ARG,Roma,Serie A,2018,29.0,1989.0,6.6,10,4,4,3,3,4,16,25.0,12,7,0,7,3,13,5,0,"MF,FW",25-29,Midfielder,Argentina,South America
169555,Callum Paterson,SCO,Cardiff City,Premier League,2018,23.0,1994.0,22.2,21,14,7,7,7,5,26,19.2,21,23,2,21,8,29,29,0,"FW,MF",20-24,Forward,Scotland,Europe
353366,Benjamin Pavard,FRA,Stuttgart,Bundesliga,2018,22.0,1996.0,29.0,28,20,21,6,1,12,19,63.2,7,27,19,8,48,76,189,2,DF,20-24,Defender,France,Europe
64793,Leonardo Pavoletti,ITA,Cagliari,Serie A,2018,29.0,1988.0,30.4,32,21,6,17,9,6,16,37.5,10,12,3,9,7,39,26,0,FW,25-29,Forward,Italy,Europe
37647,Dimitri Payet,FRA,Marseille,Ligue 1,2018,31.0,1987.0,21.2,11,9,2,8,1,5,22,22.7,17,14,0,14,8,19,8,0,"MF,FW",30-34,Midfielder,France,Europe
286297,Lorenzo Pellegrini,ITA,Roma,Serie A,2018,22.0,1996.0,20.2,39,23,16,18,5,10,30,33.3,20,20,2,18,12,51,21,0,MF,20-24,Midfielder,Italy,Europe
238716,Tho Pellenard,FRA,Angers,Ligue 1,2018,24.0,1994.0,5.5,11,6,7,2,2,5,8,62.5,3,6,2,4,5,16,16,0,DF,20-24,Defender,France,Europe
5928,Sergio Pellissier,ITA,Chievo,Serie A,2018,39.0,1979.0,10.6,4,3,1,1,2,3,4,75.0,1,8,1,7,2,6,8,0,FW,35-39,Forward,Italy,Europe
38094,Lee Peltier,ENG,Cardiff City,Premier League,2018,31.0,1986.0,17.2,39,25,27,11,1,15,27,55.6,12,18,12,6,18,57,60,0,DF,30-34,Defender,England,Europe
21763,Federico Peluso,ITA,Sassuolo,Serie A,2018,34.0,1984.0,15.1,23,14,15,5,3,13,16,81.3,3,8,3,5,23,46,70,0,DF,30-34,Defender,Italy,Europe
343052,Nicolas Pp,CIV,Lille,Ligue 1,2018,23.0,1995.0,36.9,27,10,6,15,6,8,35,22.9,27,33,0,33,13,40,11,1,"FW,MF",20-24,Forward,Ivory Coast,Africa
203394,Andreas Pereira,BRA,Manchester Utd,Premier League,2018,22.0,1996.0,6.7,8,6,5,2,1,4,15,26.7,11,9,2,7,11,19,8,1,MF,20-24,Midfielder,Brazil,South America
73636,Hernn Prez,PAR,Espanyol,La Liga,2018,29.0,1989.0,8.8,13,10,8,3,2,6,27,22.2,21,14,3,11,5,18,13,0,"FW,MF",25-29,Forward,Paraguay,South America
54984,Diego Perotti,ARG,Roma,Serie A,2018,30.0,1988.0,7.4,14,12,5,5,4,6,19,31.6,13,4,0,4,4,18,2,0,"FW,MF",30-34,Forward,Argentina,South America
22390,Loc Perrin,FRA,Saint-tienne,Ligue 1,2018,32.0,1985.0,30.0,53,36,34,17,2,20,33,60.6,13,37,24,13,44,97,118,2,DF,30-34,Defender,France,Europe
199258,Andrea Petagna,ITA,SPAL,Serie A,2018,23.0,1995.0,33.7,15,6,5,5,5,2,9,22.2,7,23,8,15,4,19,15,0,FW,20-24,Forward,Italy,Europe
42936,Nils Petersen,GER,Freiburg,Bundesliga,2018,29.0,1988.0,21.4,29,21,10,16,3,4,24,16.7,20,28,2,26,13,42,34,0,FW,25-29,Forward,Germany,Europe
113133,Germn Pezzella,ARG,Fiorentina,Serie A,2018,27.0,1991.0,31.7,56,36,42,13,1,31,51,60.8,20,42,30,12,60,116,159,1,DF,25-29,Defender,Argentina,South America
56067,Pablo Piatti,ARG,Espanyol,La Liga,2018,29.0,1989.0,8.3,21,15,8,10,3,8,16,50.0,8,15,0,15,2,23,8,0,"FW,MF",25-29,Forward,Argentina,South America
163086,Cristiano Piccini,ITA,Valencia,La Liga,2018,25.0,1992.0,20.8,32,23,25,7,0,13,26,50.0,13,27,7,20,27,59,64,1,DF,25-29,Defender,Italy,Europe
43763,Erik Pieters,NED,Amiens,Ligue 1,2018,29.0,1988.0,14.0,49,28,28,18,3,25,33,75.8,8,21,13,8,17,66,56,0,DF,25-29,Defender,Netherlands,Europe
315865,Andrea Pinamonti,ITA,Frosinone,Serie A,2018,19.0,1999.0,18.1,14,6,6,5,3,4,20,20.0,16,16,3,13,5,19,17,0,FW,Under 20,Forward,Italy,Europe
101922,Fabio Pisacane,ITA,Cagliari,Serie A,2018,32.0,1986.0,25.2,33,17,22,8,3,18,31,58.1,13,36,23,13,23,56,108,0,DF,30-34,Defender,Italy,Europe
532,Claudio Pizarro,PER,Werder Bremen,Bundesliga,2018,39.0,1978.0,7.7,10,6,4,2,4,4,7,57.1,3,14,1,13,1,11,7,0,FW,35-39,Forward,Peru,South America
167329,Alassane Pla,FRA,Gladbach,Bundesliga,2018,25.0,1993.0,27.8,14,10,7,4,3,5,22,22.7,17,17,2,15,3,17,15,2,FW,25-29,Forward,France,Europe
122153,Paul Pogba,FRA,Manchester Utd,Premier League,2018,25.0,1993.0,33.4,47,30,21,21,5,17,43,39.5,26,30,9,21,18,65,39,0,MF,25-29,Midfielder,France,Europe
223974,Stefan Posch,AUT,Hoffenheim,Bundesliga,2018,21.0,1997.0,15.6,45,32,28,15,2,17,28,60.7,11,26,11,15,21,66,58,0,DF,20-24,Defender,Austria,Europe
157635,Yussuf Poulsen,DEN,RB Leipzig,Bundesliga,2018,24.0,1994.0,27.2,20,10,5,10,5,3,25,12.0,22,33,2,31,7,27,28,0,FW,20-24,Forward,Denmark,Europe
122116,Nicolas de Prville,FRA,Bordeaux,Ligue 1,2018,27.0,1991.0,14.1,28,19,10,15,3,8,29,27.6,21,23,1,22,10,38,21,1,"FW,MF",25-29,Forward,France,Europe
60028,Edgar Prib,GER,Hannover 96,Bundesliga,2018,28.0,1989.0,2.2,10,9,3,5,2,2,4,50.0,2,4,0,4,2,12,1,0,MF,25-29,Midfielder,Germany,Europe
215616,Erick Pulgar,CHI,Bologna,Serie A,2018,24.0,1994.0,26.2,65,36,35,23,7,22,73,30.1,51,35,5,30,50,115,54,1,MF,20-24,Midfielder,Chile,South America
315779,Christian Pulisic,USA,Dortmund,Bundesliga,2018,19.0,1998.0,10.4,10,6,2,6,2,2,6,33.3,4,12,2,10,6,16,10,0,FW,Under 20,Forward,United States,North America
283528,Ignacio Pussetto,ARG,Udinese,Serie A,2018,22.0,1995.0,24.2,65,40,25,30,10,15,43,34.9,28,28,3,25,29,94,34,0,"FW,MF",20-24,Forward,Argentina,South America
22328,Fabio Quagliarella,ITA,Sampdoria,Serie A,2018,35.0,1983.0,35.5,14,8,6,4,4,2,15,13.3,13,32,1,31,8,22,17,0,FW,35-39,Forward,Italy,Europe
391719,Domingos Quina,POR,Watford,Premier League,2018,18.0,1999.0,3.8,9,7,3,5,1,3,11,27.3,8,6,0,6,3,12,1,0,MF,Under 20,Midfielder,Portugal,Europe
182913,Adrien Rabiot,FRA,Paris S-G,Ligue 1,2018,23.0,1995.0,11.8,35,20,13,17,5,9,12,75.0,3,9,2,7,10,45,20,0,MF,20-24,Midfielder,France,Europe
84467,Rafael,BRA,Lyon,Ligue 1,2018,28.0,1990.0,11.4,31,19,14,12,5,17,24,70.8,7,19,2,17,15,46,30,2,DF,25-29,Defender,Brazil,South America
19819,Raffael,BRA,Gladbach,Bundesliga,2018,33.0,1985.0,6.0,8,4,2,4,2,2,7,28.6,5,5,0,5,1,9,0,0,FW,30-34,Forward,Brazil,South America
195680,Joe Ralls,ENG,Cardiff City,Premier League,2018,24.0,1993.0,21.8,45,23,21,21,3,10,33,30.3,23,21,6,15,29,74,30,0,MF,20-24,Midfielder,England,Europe
51118,Adil Rami,FRA,Marseille,Ligue 1,2018,32.0,1985.0,15.7,14,9,12,2,0,8,12,66.7,4,14,14,0,18,32,52,3,DF,30-34,Defender,France,Europe
123742,Gastn Ramrez,URU,Sampdoria,Serie A,2018,27.0,1990.0,17.5,38,22,12,18,8,11,31,35.5,20,28,4,24,8,46,27,0,MF,25-29,Midfielder,Uruguay,South America
646658,Aaron Ramsey,WAL,Arsenal,Premier League,2018,27.0,1990.0,14.8,34,18,11,15,8,7,25,28.0,18,7,1,6,9,43,3,0,MF,25-29,Midfielder,Wales,Europe
187587,Ante Rebi,CRO,Eint Frankfurt,Bundesliga,2018,24.0,1993.0,22.0,22,9,5,12,5,5,12,41.7,7,18,1,17,8,30,3,0,"FW,MF",20-24,Forward,Croatia,Europe
129078,Nathan Redmond,ENG,Southampton,Premier League,2018,24.0,1994.0,36.3,45,22,14,19,12,14,41,34.1,27,54,2,52,20,65,23,1,"MF,FW",20-24,Midfielder,England,Europe
29124,Aritz Aduriz,ESP,Athletic Club,La Liga,2018,37.0,1981.0,10.5,4,2,1,1,2,1,7,14.3,6,2,1,1,0,4,4,0,FW,35-39,Forward,Spain,Europe
75820,Juan Aguilera,ESP,Huesca,La Liga,2018,32.0,1985.0,3.8,2,2,0,1,1,1,4,25.0,3,4,2,2,4,6,2,0,MF,30-34,Midfielder,Spain,Europe
69751,Jordi Alba,ESP,Barcelona,La Liga,2018,29.0,1989.0,33.2,42,22,20,15,7,20,48,41.7,28,24,6,18,60,102,76,1,DF,25-29,Defender,Spain,Europe
128220,Luis Alberto,ESP,Lazio,Serie A,2018,25.0,1992.0,22.1,53,22,15,29,9,21,55,38.2,34,23,3,20,10,63,10,0,"MF,FW",25-29,Midfielder,Spain,Europe
126716,Paco Alccer,ESP,Dortmund,Bundesliga,2018,24.0,1993.0,13.5,3,1,2,0,1,0,6,0.0,6,5,0,5,6,9,7,0,FW,20-24,Forward,Spain,Europe
51663,Pedro Alcal,ESP,Girona,La Liga,2018,29.0,1989.0,20.8,32,23,23,9,0,15,23,65.2,8,21,18,3,36,68,120,0,DF,25-29,Defender,Spain,Europe
60444,Thiago Alcntara,ESP,Bayern Munich,Bundesliga,2018,27.0,1991.0,26.8,87,65,31,44,12,25,48,52.1,23,23,4,19,44,131,17,1,MF,25-29,Midfielder,Spain,Europe
247250,Rubn Alcaraz,ESP,Valladolid,La Liga,2018,27.0,1991.0,33.1,96,54,50,40,6,32,89,36.0,57,59,10,49,38,134,52,1,MF,25-29,Midfielder,Spain,Europe
178187,lex Alegra,ESP,Rayo Vallecano,La Liga,2018,25.0,1992.0,1.6,1,1,0,1,0,0,3,0.0,3,1,0,1,0,1,0,0,"FW,MF",25-29,Forward,Spain,Europe
284854,Carles Ale,ESP,Barcelona,La Liga,2018,20.0,1998.0,7.1,7,4,0,6,1,2,8,25.0,6,4,0,4,2,9,0,0,MF,20-24,Midfielder,Spain,Europe
255488,Yeray lvarez,ESP,Athletic Club,La Liga,2018,23.0,1995.0,29.0,55,30,39,14,2,19,33,57.6,14,35,16,19,63,118,149,1,DF,20-24,Defender,Spain,Europe
160182,Jos ngel,ESP,Eibar,La Liga,2018,28.0,1989.0,33.6,66,46,36,23,7,31,56,55.4,25,24,5,19,41,107,113,1,DF,25-29,Defender,Spain,Europe
62144,Antoito,ESP,Valladolid,La Liga,2018,30.0,1987.0,20.7,35,21,16,15,4,18,42,42.9,24,21,8,13,18,53,31,0,"DF,MF",30-34,Defender,Spain,Europe
71548,Anaitz Arbilla,ESP,Eibar,La Liga,2018,31.0,1987.0,21.7,31,24,25,5,1,17,27,63.0,10,12,5,7,46,77,92,2,DF,30-34,Defender,Spain,Europe
72047,Iago Aspas,ESP,Celta Vigo,La Liga,2018,30.0,1987.0,25.0,16,11,4,8,4,4,20,20.0,16,14,0,14,16,32,5,0,"FW,MF",30-34,Forward,Spain,Europe
57500,Csar Azpilicueta,ESP,Chelsea,Premier League,2018,28.0,1989.0,37.8,105,60,52,40,13,38,67,56.7,29,63,16,47,43,148,91,3,DF,25-29,Defender,Spain,Europe
85324,Borja Bastn,ESP,Alavs,La Liga,2018,25.0,1992.0,16.0,16,7,4,9,3,2,24,8.3,22,16,5,11,4,20,10,0,FW,25-29,Forward,Spain,Europe
289236,Jon Bautista,ESP,Real Sociedad,La Liga,2018,23.0,1995.0,6.6,5,3,0,3,2,0,3,0.0,3,8,1,7,5,10,4,0,FW,20-24,Forward,Spain,Europe
237164,Ihlas Bebou,TOG,Hannover 96,Bundesliga,2018,24.0,1994.0,11.8,15,9,4,10,1,4,9,44.4,5,18,2,16,9,24,9,0,"MF,FW",20-24,Midfielder,Togo,Africa
243028,Jan Bednarek,POL,Southampton,Premier League,2018,22.0,1996.0,23.9,41,25,25,16,0,21,37,56.8,16,44,27,17,71,112,171,0,DF,20-24,Defender,Poland,Europe
191217,Hctor Bellern,ESP,Arsenal,Premier League,2018,23.0,1995.0,17.0,15,12,8,4,3,6,13,46.2,7,17,5,12,20,35,37,3,DF,20-24,Defender,Spain,Europe
423444,Fran Beltrn,ESP,Celta Vigo,La Liga,2018,19.0,1999.0,16.9,23,17,8,12,3,13,31,41.9,18,19,2,17,19,42,15,1,MF,Under 20,Midfielder,Spain,Europe
61812,Yuri Berchiche,ESP,Athletic Club,La Liga,2018,28.0,1990.0,34.7,46,31,26,11,9,23,46,50.0,23,34,9,25,42,88,82,0,"DF,FW",25-29,Defender,Spain,Europe
338425,lex Berenguer,ESP,Torino,Serie A,2018,23.0,1995.0,16.5,31,20,12,17,2,14,34,41.2,20,20,1,19,8,39,14,0,"MF,DF",20-24,Midfielder,Spain,Europe
144143,Bartosz Bereszyski,POL,Sampdoria,Serie A,2018,26.0,1992.0,24.4,46,30,27,15,4,24,51,47.1,27,22,7,15,31,77,76,0,DF,25-29,Defender,Poland,Europe
126719,Juan Bernat,ESP,Paris S-G,Ligue 1,2018,25.0,1993.0,20.4,47,32,22,19,6,22,46,47.8,24,19,5,14,20,67,41,1,"DF,MF",25-29,Defender,Spain,Europe
26105,Valter Birsa,SVN,Cagliari,Serie A,2018,31.0,1986.0,3.9,5,3,1,3,1,4,8,50.0,4,5,0,5,4,9,3,0,"MF,FW",30-34,Midfielder,Slovenia,Europe
246277,Burgui,ESP,Alavs,La Liga,2018,24.0,1993.0,6.2,6,6,4,2,0,1,3,33.3,2,4,0,4,0,6,2,1,"MF,FW",20-24,Midfielder,Spain,Europe
156808,Unai Bustinza,ESP,Legans,La Liga,2018,26.0,1992.0,22.5,41,31,25,14,2,17,33,51.5,16,31,13,18,53,94,110,2,DF,25-29,Defender,Spain,Europe
357884,Fernando Calero,ESP,Valladolid,La Liga,2018,22.0,1995.0,34.8,51,31,33,18,0,23,38,60.5,15,55,31,24,55,106,170,0,DF,20-24,Defender,Spain,Europe
61253,Jos Callejn,ESP,Napoli,Serie A,2018,31.0,1987.0,29.4,34,18,12,14,8,18,57,31.6,39,34,5,29,22,56,11,0,"MF,FW",30-34,Midfielder,Spain,Europe
58874,Ignacio Camacho,ESP,Wolfsburg,Bundesliga,2018,28.0,1990.0,6.0,15,9,9,6,0,3,7,42.9,4,7,2,5,18,33,12,0,MF,25-29,Midfielder,Spain,Europe
26148,Juanjo Camacho,ESP,Huesca,La Liga,2018,37.0,1980.0,0.4,1,1,1,0,0,1,1,100.0,0,0,0,0,0,1,1,0,"MF,DF",35-39,Midfielder,Spain,Europe
263856,Vctor Camarasa,ESP,Cardiff City,Premier League,2018,24.0,1994.0,28.5,28,15,8,15,5,6,31,19.4,25,17,2,15,33,61,28,1,MF,20-24,Midfielder,Spain,Europe
120095,Jos Campaa,ESP,Levante,La Liga,2018,25.0,1993.0,35.7,65,45,31,29,5,27,86,31.4,59,51,7,44,48,113,46,1,MF,25-29,Midfielder,Spain,Europe
66106,Sergio Canales,ESP,Betis,La Liga,2018,27.0,1991.0,29.5,44,30,19,18,7,11,53,20.8,42,34,3,31,9,53,8,1,MF,25-29,Midfielder,Spain,Europe
197545,Ander Capa,ESP,Athletic Club,La Liga,2018,26.0,1992.0,18.2,43,27,32,8,3,13,27,48.1,14,20,2,18,30,73,47,0,"DF,FW",25-29,Defender,Spain,Europe
195171,Samu Castillejo,ESP,Milan,Serie A,2018,23.0,1995.0,11.4,15,10,10,2,3,4,25,16.0,21,16,0,16,8,23,11,0,"FW,MF",20-24,Forward,Spain,Europe
59606,Craig Cathcart,NIR,Watford,Premier League,2018,29.0,1989.0,34.4,50,31,36,11,3,21,37,56.8,16,42,30,12,38,88,184,4,DF,25-29,Defender,Northern Ireland,Europe
15799,Santi Cazorla,ESP,Villarreal,La Liga,2018,33.0,1984.0,29.4,69,34,32,26,11,24,69,34.8,45,35,6,29,28,97,17,1,"MF,FW",30-34,Midfielder,Spain,Europe
319745,Dani Ceballos,ESP,Real Madrid,La Liga,2018,21.0,1996.0,13.9,32,21,9,16,7,11,31,35.5,20,26,1,25,15,47,6,0,"MF,FW",20-24,Midfielder,Spain,Europe
18918,Per Ciljan Skjelbred,NOR,Hertha BSC,Bundesliga,2018,31.0,1987.0,11.1,26,18,13,12,1,5,22,22.7,17,10,1,9,20,46,14,0,MF,30-34,Midfielder,Norway,Europe
79510,Thiago Cionek,POL,SPAL,Serie A,2018,32.0,1986.0,28.2,75,44,46,25,4,29,56,51.8,27,34,22,12,55,130,144,0,DF,30-34,Defender,Poland,Europe
71905,Coke,ESP,Levante,La Liga,2018,31.0,1987.0,20.2,44,27,24,17,3,26,56,46.4,30,18,8,10,40,84,54,1,DF,30-34,Defender,Spain,Europe
380598,Santi Comesaa,ESP,Rayo Vallecano,La Liga,2018,21.0,1996.0,22.6,56,35,29,25,2,22,61,36.1,39,30,5,25,30,86,45,2,MF,20-24,Midfielder,Spain,Europe
546212,Diego Costa,ESP,Atltico Madrid,La Liga,2018,29.0,1988.0,12.4,4,1,0,4,0,1,8,12.5,7,5,0,5,2,6,6,0,FW,25-29,Forward,Spain,Europe
65318,Jaume Costa,ESP,Villarreal,La Liga,2018,30.0,1988.0,16.6,33,21,26,5,2,20,33,60.6,13,12,3,9,21,54,61,0,DF,30-34,Defender,Spain,Europe
276111,David Costas,ESP,Celta Vigo,La Liga,2018,23.0,1995.0,13.0,25,13,21,4,0,10,15,66.7,5,12,6,6,18,43,58,1,DF,20-24,Defender,Spain,Europe
142021,Sergi Darder,ESP,Espanyol,La Liga,2018,24.0,1993.0,30.1,60,35,23,32,5,25,69,36.2,44,18,3,15,22,82,30,0,MF,20-24,Midfielder,Spain,Europe
129476,Gerard Deulofeu,ESP,Watford,Premier League,2018,24.0,1994.0,23.0,11,6,5,3,3,4,26,15.4,22,16,0,16,14,25,3,0,"FW,MF",20-24,Forward,Spain,Europe
355335,Adrin Diguez,ESP,Huesca,La Liga,2018,22.0,1996.0,8.3,16,10,11,4,1,9,16,56.3,7,9,4,5,12,28,46,1,DF,20-24,Defender,Spain,Europe
221150,Djen,TOG,Getafe,La Liga,2018,26.0,1991.0,33.1,54,34,43,11,0,26,43,60.5,17,27,11,16,74,128,154,3,DF,25-29,Defender,Togo,Africa
177046,Rubn Duarte,ESP,Alavs,La Liga,2018,22.0,1995.0,30.8,72,35,45,20,7,34,64,53.1,30,46,12,34,57,129,130,1,DF,20-24,Defender,Spain,Europe
229804,Aritz Elustondo,ESP,Real Sociedad,La Liga,2018,24.0,1994.0,25.0,47,29,31,14,2,26,41,63.4,15,23,7,16,39,86,150,0,DF,20-24,Defender,Spain,Europe
81988,Sergi Enrich,ESP,Eibar,La Liga,2018,28.0,1990.0,28.7,27,17,3,11,13,7,30,23.3,23,11,1,10,6,33,14,0,FW,25-29,Forward,Spain,Europe
93935,Sergio Escudero,ESP,Sevilla,La Liga,2018,28.0,1989.0,17.2,43,29,20,18,5,18,35,51.4,17,22,4,18,24,67,52,0,"DF,FW",25-29,Defender,Spain,Europe
40888,Beat Etxebarria,ESP,Athletic Club,La Liga,2018,31.0,1987.0,22.6,47,24,14,25,8,19,59,32.2,40,18,1,17,24,71,11,0,MF,30-34,Midfielder,Spain,Europe
59340,Iago Falque,ESP,Torino,Serie A,2018,28.0,1990.0,17.9,13,8,3,8,2,3,16,18.8,13,14,0,14,3,16,2,0,"FW,MF",25-29,Forward,Spain,Europe
76467,Kiko Femena,ESP,Watford,Premier League,2018,27.0,1991.0,22.8,48,30,34,12,2,24,51,47.1,27,24,6,18,36,84,68,0,DF,25-29,Defender,Spain,Europe
271988,Borja Fernndez,ESP,Valladolid,La Liga,2018,37.0,1981.0,9.3,17,12,7,9,1,6,16,37.5,10,14,2,12,14,31,25,0,"MF,DF",35-39,Midfielder,Spain,Europe
331496,Valery Fernndez,ESP,Girona,La Liga,2018,18.0,1999.0,9.9,20,15,13,6,1,10,17,58.8,7,15,1,14,8,28,10,0,"DF,FW",Under 20,Defender,Spain,Europe
71918,David Ferreiro,ESP,Huesca,La Liga,2018,30.0,1988.0,25.3,36,22,13,19,4,11,64,17.2,53,27,1,26,24,60,14,2,"MF,FW",30-34,Midfielder,Spain,Europe
357885,Pablo Fornals,ESP,Villarreal,La Liga,2018,22.0,1996.0,27.5,49,26,14,26,9,15,54,27.8,39,32,4,28,24,73,19,0,"MF,FW",20-24,Midfielder,Spain,Europe
210143,lex Gallar,ESP,Huesca,La Liga,2018,26.0,1992.0,11.2,15,9,6,5,4,8,19,42.1,11,9,1,8,9,24,5,0,"MF,FW",25-29,Midfielder,Spain,Europe
114060,Enric Gallego,ESP,Huesca,La Liga,2018,31.0,1986.0,17.1,21,15,3,13,5,3,19,15.8,16,17,2,15,8,29,32,0,FW,30-34,Forward,Spain,Europe
261504,Aleix Garca,ESP,Girona,La Liga,2018,21.0,1997.0,18.5,37,19,17,20,0,13,36,36.1,23,21,6,15,21,58,18,0,MF,20-24,Midfielder,Spain,Europe
1064403,lvaro Garca,ESP,Rayo Vallecano,La Liga,2018,25.0,1992.0,19.6,22,19,11,7,4,4,25,16.0,21,24,0,24,19,41,30,0,"FW,MF",25-29,Forward,Spain,Europe
67808,Borja Garca,ESP,Girona,La Liga,2018,27.0,1990.0,29.2,39,27,17,15,7,22,44,50.0,22,23,2,21,38,77,17,0,"MF,FW",25-29,Midfielder,Spain,Europe
323169,Sergio Garca,ESP,Espanyol,La Liga,2018,35.0,1983.0,16.5,18,10,4,11,3,3,16,18.8,13,6,1,5,10,28,4,0,"FW,MF",35-39,Forward,Spain,Europe
60632,Theodor Gebre Selassie,CZE,Werder Bremen,Bundesliga,2018,31.0,1986.0,31.3,53,38,27,16,10,22,51,43.1,29,33,8,25,69,122,100,0,DF,30-34,Defender,Czech Republic,Europe
537382,Bryan Gil,ESP,Sevilla,La Liga,2018,17.0,2001.0,1.9,6,4,4,1,1,1,5,20.0,4,0,0,0,1,7,0,0,"MF,FW",Under 20,Midfielder,Spain,Europe
46552,Kamil Glik,POL,Monaco,Ligue 1,2018,30.0,1988.0,33.0,32,23,26,5,1,16,32,50.0,16,25,17,8,61,93,200,1,DF,30-34,Defender,Poland,Europe
127837,Ibai Gmez,ESP,Athletic Club,La Liga,2018,28.0,1989.0,6.4,6,3,3,2,1,4,9,44.4,5,8,1,7,2,8,8,0,FW,25-29,Forward,Spain,Europe
175449,Moi Gmez,ESP,Huesca,La Liga,2018,24.0,1994.0,33.9,42,28,15,25,2,11,46,23.9,35,27,3,24,28,70,27,0,MF,20-24,Midfielder,Spain,Europe
183647,lvaro Gonzlez,ESP,Villarreal,La Liga,2018,28.0,1990.0,32.9,49,35,33,14,2,25,35,71.4,10,34,24,10,37,86,177,2,DF,25-29,Defender,Spain,Europe
188838,Bruno Gonzlez,ESP,Getafe,La Liga,2018,28.0,1990.0,18.9,23,10,14,8,1,9,18,50.0,9,13,6,7,22,45,110,0,DF,25-29,Defender,Spain,Europe
255284,lex Granell,ESP,Girona,La Liga,2018,29.0,1988.0,26.6,64,28,30,31,3,34,83,41.0,49,34,5,29,35,99,36,1,"MF,DF",25-29,Midfielder,Spain,Europe
44065,Esteban Granero,ESP,Espanyol,La Liga,2018,31.0,1987.0,22.4,50,32,26,18,6,17,50,34.0,33,42,8,34,26,76,34,2,MF,30-34,Midfielder,Spain,Europe
370691,Francis Guerrero,ESP,Betis,La Liga,2018,22.0,1996.0,19.8,51,28,25,16,10,23,41,56.1,18,15,1,14,21,72,47,4,"DF,FW",20-24,Defender,Spain,Europe
268670,Gerard Gumbau,ESP,Legans,La Liga,2018,23.0,1994.0,13.3,22,16,9,13,0,6,25,24.0,19,15,2,13,13,35,13,0,MF,20-24,Midfielder,Spain,Europe
99343,Ander Herrera,ESP,Manchester Utd,Premier League,2018,28.0,1989.0,15.6,54,28,24,22,8,21,61,34.4,40,38,6,32,37,91,25,1,MF,25-29,Midfielder,Spain,Europe
142027,Pablo Hervas,ESP,Valladolid,La Liga,2018,25.0,1993.0,1.8,1,0,0,1,0,0,1,0.0,1,0,0,0,2,3,0,0,MF,25-29,Midfielder,Spain,Europe
278359,Borja Iglesias,ESP,Espanyol,La Liga,2018,25.0,1993.0,34.2,23,14,7,8,8,5,24,20.8,19,14,6,8,7,30,41,0,FW,25-29,Forward,Spain,Europe
59344,Asier Illarramendi,ESP,Real Sociedad,La Liga,2018,28.0,1990.0,20.2,39,24,22,14,3,21,51,41.2,30,36,9,27,31,70,46,1,MF,25-29,Midfielder,Spain,Europe
171362,Pablo Insua,ESP,Huesca,La Liga,2018,24.0,1993.0,8.6,23,10,14,9,0,8,15,53.3,7,2,0,2,12,35,40,0,DF,20-24,Defender,Spain,Europe
85288,Isco,ESP,Real Madrid,La Liga,2018,26.0,1992.0,13.2,29,14,14,8,7,14,34,41.2,20,9,1,8,6,35,3,0,"MF,FW",25-29,Midfielder,Spain,Europe
319160,Jakub Jankto,CZE,Sampdoria,Serie A,2018,22.0,1996.0,10.7,7,4,5,2,0,4,15,26.7,11,18,2,16,9,16,16,0,MF,20-24,Midfielder,Czech Republic,Europe
134936,Jes,ESP,Betis,La Liga,2018,25.0,1993.0,8.7,7,4,3,3,1,2,8,25.0,6,8,0,8,1,8,1,0,"FW,MF",25-29,Forward,Spain,Europe
7663,Joaqun,ESP,Betis,La Liga,2018,37.0,1981.0,18.8,10,4,4,2,4,3,7,42.9,4,13,2,11,14,24,31,1,"FW,MF",35-39,Forward,Spain,Europe
228761,Jony,ESP,Alavs,La Liga,2018,27.0,1991.0,33.0,20,14,6,7,7,7,37,18.9,30,18,0,18,22,42,12,2,"MF,FW",25-29,Midfielder,Spain,Europe
263727,Joan Jordn,ESP,Eibar,La Liga,2018,24.0,1994.0,31.9,63,40,16,38,9,28,80,35.0,52,38,4,34,32,95,18,1,MF,20-24,Midfielder,Spain,Europe
81999,Joselu,ESP,Newcastle Utd,Premier League,2018,28.0,1990.0,6.6,14,8,4,5,5,4,9,44.4,5,5,0,5,3,17,15,0,FW,25-29,Forward,Spain,Europe
257462,Luka Jovi,SRB,Eint Frankfurt,Bundesliga,2018,20.0,1997.0,24.9,10,5,1,8,1,1,12,8.3,11,8,0,8,3,13,30,0,"FW,MF",20-24,Forward,Serbia,Europe
126737,Juanmi,ESP,Real Sociedad,La Liga,2018,25.0,1993.0,16.9,21,12,7,11,3,8,22,36.4,14,12,0,12,16,37,13,0,"FW,MF",25-29,Forward,Spain,Europe
115333,Juanpe,ESP,Girona,La Liga,2018,27.0,1991.0,30.7,48,25,32,15,1,24,45,53.3,21,31,15,16,57,105,138,0,DF,25-29,Defender,Spain,Europe
164055,David Junc,ESP,Celta Vigo,La Liga,2018,24.0,1993.0,19.5,55,30,40,13,2,28,46,60.9,18,27,6,21,35,90,63,1,DF,20-24,Defender,Spain,Europe
53418,Kevin Kampl,SVN,RB Leipzig,Bundesliga,2018,27.0,1990.0,23.5,41,24,16,21,4,8,28,28.6,20,32,2,30,33,74,22,0,MF,25-29,Midfielder,Slovenia,Europe
91059,Joshua King,NOR,Bournemouth,Premier League,2018,26.0,1992.0,32.9,30,19,7,19,4,8,29,27.6,21,28,4,24,7,37,14,0,"FW,MF",25-29,Forward,Norway,Europe
74229,Koke,ESP,Atltico Madrid,La Liga,2018,26.0,1992.0,28.7,84,46,41,32,11,34,86,39.5,52,25,5,20,31,115,37,1,MF,25-29,Midfielder,Spain,Europe
46156,Aleksandar Kolarov,SRB,Roma,Serie A,2018,32.0,1985.0,32.3,38,26,22,10,6,21,34,61.8,13,23,15,8,41,79,82,2,DF,30-34,Defender,Serbia,Europe
208167,Dawid Kownacki,POL,Sampdoria,Serie A,2018,21.0,1997.0,1.9,2,1,0,1,1,1,4,25.0,3,0,0,0,0,2,0,0,FW,20-24,Forward,Poland,Europe
138584,Luka Krajnc,SVN,Frosinone,Serie A,2018,23.0,1994.0,8.8,10,8,6,3,1,5,6,83.3,1,11,3,8,11,21,42,0,DF,20-24,Defender,Slovenia,Europe
176553,Aymeric Laporte,ESP,Manchester City,Premier League,2018,24.0,1994.0,34.0,42,20,27,14,1,22,34,64.7,12,16,9,7,39,81,98,2,DF,20-24,Defender,Spain,Europe
70411,Darko Lazovi,SRB,Genoa,Serie A,2018,27.0,1990.0,28.2,28,17,13,8,7,14,31,45.2,17,21,6,15,20,48,33,0,"DF,FW",25-29,Defender,Serbia,Europe
145769,Sergio Len,ESP,Betis,La Liga,2018,29.0,1989.0,7.1,4,2,2,1,1,2,8,25.0,6,4,0,4,2,6,6,0,"FW,MF",25-29,Forward,Spain,Europe
225873,Karol Linetty,POL,Sampdoria,Serie A,2018,23.0,1995.0,27.9,72,48,26,32,14,15,69,21.7,54,39,4,35,25,97,17,0,MF,20-24,Midfielder,Poland,Europe
298975,Pol Lirola,ESP,Sassuolo,Serie A,2018,20.0,1997.0,33.1,35,22,19,11,5,21,34,61.8,13,25,5,20,32,67,89,0,"DF,MF",20-24,Defender,Spain,Europe
710131,Diego Llorente,ESP,Real Sociedad,La Liga,2018,24.0,1993.0,19.5,26,15,16,8,2,17,29,58.6,12,27,15,12,26,52,83,2,DF,20-24,Defender,Spain,Europe
35564,Fernando Llorente,ESP,Tottenham,Premier League,2018,33.0,1985.0,7.7,4,2,3,0,1,2,3,66.7,1,7,2,5,1,5,10,0,FW,30-34,Forward,Spain,Europe
947431,David Lpez,ESP,Espanyol,La Liga,2018,28.0,1989.0,20.2,27,18,15,10,2,10,22,45.5,12,18,12,6,28,55,65,2,DF,25-29,Defender,Spain,Europe
568158,Javi Lpez,ESP,Espanyol,La Liga,2018,32.0,1986.0,21.6,63,40,37,22,4,28,60,46.7,32,27,5,22,40,103,90,0,DF,30-34,Defender,Spain,Europe
192009,Unai Lpez,ESP,Athletic Club,La Liga,2018,22.0,1995.0,3.6,7,5,3,2,2,2,12,16.7,10,10,3,7,1,8,2,0,MF,20-24,Midfielder,Spain,Europe
252677,Jos Luis Morales,ESP,Levante,La Liga,2018,31.0,1987.0,35.5,21,15,6,10,5,8,49,16.3,41,22,1,21,12,33,17,0,"FW,MF",30-34,Forward,Spain,Europe
245056,Saa Luki,SRB,Torino,Serie A,2018,21.0,1996.0,11.0,21,11,5,11,5,5,16,31.3,11,13,4,9,12,33,11,0,MF,20-24,Midfielder,Serbia,Europe
251876,Pablo Maffeo,ESP,Stuttgart,Bundesliga,2018,21.0,1997.0,6.6,15,13,10,5,0,6,13,46.2,7,8,4,4,13,28,17,0,"DF,MF",20-24,Defender,Spain,Europe
124715,Nikola Maksimovi,SRB,Napoli,Serie A,2018,26.0,1991.0,15.3,20,13,14,6,0,6,12,50.0,6,16,10,6,28,48,56,1,DF,25-29,Defender,Serbia,Europe
162029,Javier Manquillo,ESP,Newcastle Utd,Premier League,2018,24.0,1994.0,12.2,27,19,14,11,2,9,14,64.3,5,9,1,8,17,44,58,0,DF,20-24,Defender,Spain,Europe
96718,scar de Marcos,ESP,Athletic Club,La Liga,2018,29.0,1989.0,26.9,60,32,34,17,9,29,62,46.8,33,29,4,25,27,87,62,0,"DF,FW",25-29,Defender,Spain,Europe
212391,Roger Mart,ESP,Levante,La Liga,2018,27.0,1991.0,21.0,8,6,1,4,3,1,19,5.3,18,14,1,13,4,12,9,0,FW,25-29,Forward,Spain,Europe
251878,Aarn Martn,ESP,Mainz 05,Bundesliga,2018,21.0,1997.0,32.0,55,30,29,21,5,20,38,52.6,18,38,11,27,38,93,75,1,DF,20-24,Defender,Spain,Europe
158863,Iigo Martnez,ESP,Athletic Club,La Liga,2018,27.0,1991.0,32.2,53,26,36,16,1,23,37,62.2,14,24,14,10,69,122,144,0,DF,25-29,Defender,Spain,Europe
471474,Javi Martnez,ESP,Bayern Munich,Bundesliga,2018,29.0,1988.0,14.5,26,15,7,17,2,5,16,31.3,11,17,5,12,31,57,13,0,MF,25-29,Midfielder,Spain,Europe
227961,Jaime Mata,ESP,Getafe,La Liga,2018,29.0,1988.0,27.0,30,21,8,14,8,7,26,26.9,19,14,0,14,17,47,27,0,"FW,MF",25-29,Forward,Spain,Europe
298976,Borja Mayoral,ESP,Levante,La Liga,2018,21.0,1997.0,18.0,9,4,1,6,2,5,16,31.3,11,10,1,9,5,14,5,0,FW,20-24,Forward,Spain,Europe
253839,lvaro Medrn,ESP,Rayo Vallecano,La Liga,2018,24.0,1994.0,12.8,15,8,5,6,4,6,21,28.6,15,10,1,9,17,32,9,0,MF,20-24,Midfielder,Spain,Europe
448344,scar Melendo,ESP,Espanyol,La Liga,2018,20.0,1997.0,22.2,17,8,7,6,4,10,26,38.5,16,17,1,16,13,30,9,0,"MF,FW",20-24,Midfielder,Spain,Europe
162056,Gonzalo Melero,ESP,Huesca,La Liga,2018,24.0,1994.0,14.9,26,23,5,19,2,11,48,22.9,37,14,4,10,2,28,23,0,MF,20-24,Midfielder,Spain,Europe
309110,Brais Mndez,ESP,Celta Vigo,La Liga,2018,21.0,1997.0,26.1,61,31,23,29,9,14,53,26.4,39,32,3,29,24,85,24,0,"MF,FW",20-24,Midfielder,Spain,Europe
192736,Sabin Merino,ESP,Legans,La Liga,2018,26.0,1992.0,3.3,1,1,0,0,1,1,1,100.0,0,1,0,1,0,1,4,0,"FW,MF",25-29,Forward,Spain,Europe
202984,Roque Mesa,ESP,Sevilla,La Liga,2018,29.0,1989.0,19.4,46,27,16,22,8,15,38,39.5,23,16,0,16,14,60,12,4,MF,25-29,Midfielder,Spain,Europe
413507,Nikola Milenkovi,SRB,Fiorentina,Serie A,2018,20.0,1997.0,33.4,59,40,36,21,2,17,33,51.5,16,39,21,18,48,107,143,0,DF,20-24,Defender,Serbia,Europe
191891,Arkadiusz Milik,POL,Napoli,Serie A,2018,24.0,1994.0,26.6,19,9,1,8,10,1,20,5.0,19,7,2,5,3,22,15,0,FW,20-24,Forward,Poland,Europe
266302,Sergej Milinkovi-Savi,SRB,Lazio,Serie A,2018,23.0,1995.0,26.6,44,28,17,21,6,23,60,38.3,37,28,4,24,27,71,48,0,MF,20-24,Midfielder,Serbia,Europe
255653,Santi Mina,ESP,Valencia,La Liga,2018,22.0,1995.0,20.6,17,10,1,15,1,3,25,12.0,22,19,2,17,4,21,20,0,FW,20-24,Forward,Spain,Europe
228917,Jorge Miramn,ESP,Huesca,La Liga,2018,29.0,1989.0,27.7,73,55,49,17,7,34,53,64.2,19,34,11,23,44,117,65,1,DF,25-29,Defender,Spain,Europe
51152,Aleksandar Mitrovi,SRB,Fulham,Premier League,2018,23.0,1994.0,36.4,19,9,3,13,3,5,15,33.3,10,22,8,14,6,25,53,0,FW,20-24,Forward,Serbia,Europe
57825,Jorge Molina,ESP,Getafe,La Liga,2018,36.0,1982.0,29.4,12,9,1,4,7,2,15,13.3,13,22,0,22,7,19,26,1,FW,35-39,Forward,Spain,Europe
43003,Nacho Monreal,ESP,Arsenal,Premier League,2018,32.0,1986.0,20.7,35,17,21,9,5,15,25,60.0,10,28,10,18,31,66,62,0,DF,30-34,Defender,Spain,Europe
193098,lex Moreno,ESP,Rayo Vallecano,La Liga,2018,25.0,1993.0,34.8,63,40,41,18,4,29,53,54.7,24,35,9,26,41,104,97,0,DF,25-29,Defender,Spain,Europe
177467,Gerard Moreno,ESP,Villarreal,La Liga,2018,26.0,1992.0,25.7,22,12,2,15,5,8,27,29.6,19,23,9,14,9,31,39,0,FW,25-29,Forward,Spain,Europe
71204,Javi Moyano,ESP,Valladolid,La Liga,2018,32.0,1986.0,23.3,25,17,17,6,2,15,30,50.0,15,20,9,11,25,50,88,2,DF,30-34,Defender,Spain,Europe
54235,Iker Muniain,ESP,Athletic Club,La Liga,2018,25.0,1992.0,26.5,29,20,10,14,5,6,29,20.7,23,17,3,14,12,41,6,0,"MF,FW",25-29,Midfielder,Spain,Europe
15956,Jess Navas,ESP,Sevilla,La Liga,2018,32.0,1985.0,30.1,28,21,15,11,2,16,24,66.7,8,23,5,18,29,57,62,0,"DF,FW",30-34,Defender,Spain,Europe
148928,Sal guez,ESP,Atltico Madrid,La Liga,2018,23.0,1994.0,32.5,83,56,35,41,7,32,81,39.5,49,57,10,47,42,125,86,1,"MF,DF",20-24,Midfielder,Spain,Europe
447052,Peru Nolaskoain,ESP,Athletic Club,La Liga,2018,19.0,1998.0,5.2,11,8,7,4,0,5,9,55.6,4,11,6,5,10,21,18,0,DF,Under 20,Defender,Spain,Europe
70934,Nolito,ESP,Sevilla,La Liga,2018,31.0,1986.0,0.8,3,2,1,1,1,1,2,50.0,1,2,0,2,0,3,1,0,"FW,DF",30-34,Forward,Spain,Europe
338285,Unai Nez,ESP,Athletic Club,La Liga,2018,21.0,1997.0,11.8,15,11,11,4,0,7,11,63.6,4,20,12,8,28,43,60,2,DF,20-24,Defender,Spain,Europe
280730,lvaro Odriozola,ESP,Real Madrid,La Liga,2018,22.0,1995.0,13.1,28,25,13,11,4,14,18,77.8,4,11,1,10,11,39,17,1,DF,20-24,Defender,Spain,Europe
111621,Dani Ojeda,ESP,Legans,La Liga,2018,23.0,1994.0,2.1,3,2,2,0,1,1,3,33.3,2,2,0,2,2,5,2,0,"MF,DF",20-24,Midfielder,Spain,Europe
51667,Kiko Olivas,ESP,Valladolid,La Liga,2018,29.0,1988.0,34.4,51,38,35,15,1,22,48,45.8,26,31,18,13,46,97,173,2,DF,25-29,Defender,Spain,Europe
268176,Sergi Palencia,ESP,Bordeaux,Ligue 1,2018,22.0,1996.0,22.1,74,50,46,20,8,27,55,49.1,28,22,3,19,17,91,70,1,DF,20-24,Defender,Spain,Europe
126729,Patric,ESP,Lazio,Serie A,2018,25.0,1993.0,12.1,19,11,8,8,3,8,15,53.3,7,14,7,7,12,31,29,1,DF,25-29,Defender,Spain,Europe
356197,Alfonso Pedraza,ESP,Villarreal,La Liga,2018,22.0,1996.0,23.3,59,44,34,19,6,22,62,35.5,40,33,7,26,29,88,55,0,"DF,FW",20-24,Defender,Spain,Europe
1004741,Pedro,ESP,Chelsea,Premier League,2018,31.0,1987.0,19.8,27,14,11,10,6,9,35,25.7,26,13,2,11,18,45,8,1,FW,30-34,Forward,Spain,Europe
501418,Adri Pedrosa,ESP,Espanyol,La Liga,2018,20.0,1998.0,8.5,14,9,11,2,1,7,14,50.0,7,10,4,6,8,22,27,0,DF,20-24,Defender,Spain,Europe
238868,Rubn Pea,ESP,Eibar,La Liga,2018,27.0,1991.0,29.7,63,46,24,27,12,24,53,45.3,29,37,9,28,35,98,57,0,DF,25-29,Defender,Spain,Europe
246968,Ayoze Prez,ESP,Newcastle Utd,Premier League,2018,25.0,1993.0,32.4,59,22,24,28,7,17,63,27.0,46,55,4,51,42,101,33,1,"MF,FW",25-29,Midfielder,Spain,Europe
18944,Gerard Piqu,ESP,Barcelona,La Liga,2018,31.0,1987.0,35.0,42,27,25,17,0,24,37,64.9,13,41,27,14,36,78,154,5,DF,30-34,Defender,Spain,Europe
242497,Pere Pons,ESP,Girona,La Liga,2018,25.0,1993.0,31.0,83,46,34,38,11,30,82,36.6,52,48,12,36,35,118,39,0,MF,25-29,Midfielder,Spain,Europe
553875,Pedro Porro,ESP,Girona,La Liga,2018,18.0,1999.0,24.6,51,31,28,16,7,32,80,40.0,48,36,2,34,39,90,60,1,DF,Under 20,Defender,Spain,Europe
138803,Francisco Portillo,ESP,Getafe,La Liga,2018,28.0,1990.0,22.2,26,16,6,15,5,9,29,31.0,20,14,0,14,17,43,9,0,MF,25-29,Midfielder,Spain,Europe
99353,Portu,ESP,Girona,La Liga,2018,26.0,1992.0,31.3,33,24,8,15,10,12,43,27.9,31,16,1,15,8,41,5,0,"FW,MF",25-29,Forward,Spain,Europe
158791,Sergio Postigo,ESP,Levante,La Liga,2018,29.0,1988.0,16.1,25,15,22,3,0,15,19,78.9,4,21,12,9,20,45,77,0,DF,25-29,Defender,Spain,Europe
195605,Jos Pozo,ESP,Rayo Vallecano,La Liga,2018,22.0,1996.0,18.0,13,10,4,5,4,4,25,16.0,21,7,1,6,4,17,6,0,MF,20-24,Midfielder,Spain,Europe
408471,Javi Puado,ESP,Espanyol,La Liga,2018,20.0,1998.0,4.0,2,1,0,2,0,0,7,0.0,7,5,1,4,6,8,4,0,"FW,MF",20-24,Forward,Spain,Europe
67546,Jorge Pulido,ESP,Huesca,La Liga,2018,27.0,1991.0,30.9,63,42,40,19,4,32,51,62.7,19,39,18,21,50,113,158,0,DF,25-29,Defender,Spain,Europe
245078,Nemanja Radonji,SRB,Marseille,Ligue 1,2018,22.0,1996.0,7.6,8,5,1,5,2,5,16,31.3,11,3,0,3,5,13,4,0,"FW,MF",20-24,Forward,Serbia,Europe
69660,Jons Ramalho,ESP,Girona,La Liga,2018,25.0,1993.0,18.0,13,6,12,1,0,8,14,57.1,6,24,11,13,16,29,80,1,DF,25-29,Defender,Spain,Europe
199369,Sandro Ramrez,ESP,Real Sociedad,La Liga,2018,23.0,1995.0,11.7,19,10,7,10,2,4,11,36.4,7,12,1,11,9,28,3,0,"FW,MF",20-24,Forward,Spain,Europe
26066,Ivn Ramis,ESP,Eibar,La Liga,2018,33.0,1984.0,18.6,23,13,10,11,2,17,23,73.9,6,10,5,5,18,41,65,2,DF,30-34,Defender,Spain,Europe
25557,Sergio Ramos,ESP,Real Madrid,La Liga,2018,32.0,1986.0,27.5,41,32,25,12,4,22,39,56.4,17,29,15,14,37,78,90,2,DF,30-34,Defender,Spain,Europe
326300,Jeff Reine-Adlade,FRA,Angers,Ligue 1,2018,20.0,1998.0,28.4,40,22,18,19,3,16,39,41.0,23,20,0,20,19,59,10,0,"FW,MF",20-24,Forward,France,Europe
182579,Karim Rekik,NED,Hertha BSC,Bundesliga,2018,23.0,1994.0,23.0,36,22,23,12,1,12,18,66.7,6,24,16,8,34,70,88,0,DF,20-24,Defender,Netherlands,Europe
45121,Loc Rmy,FRA,Lille,Ligue 1,2018,31.0,1987.0,13.4,2,1,0,2,0,0,3,0.0,3,3,1,2,2,4,17,1,FW,30-34,Forward,France,Europe
22068,Franck Ribry,FRA,Bayern Munich,Bundesliga,2018,35.0,1983.0,13.0,15,7,7,6,2,4,10,40.0,6,9,0,9,7,22,1,0,"MF,FW",35-39,Midfielder,France,Europe
357662,Declan Rice,ENG,West Ham,Premier League,2018,19.0,1999.0,33.4,98,60,35,58,5,38,88,43.2,50,51,12,39,52,150,56,0,MF,Under 20,Midfielder,England,Europe
22210,Luca Rigoni,ITA,Parma,Serie A,2018,33.0,1984.0,19.6,42,25,25,15,2,9,26,34.6,17,19,2,17,18,60,39,0,MF,30-34,Midfielder,Italy,Europe
61757,Nicola Rigoni,ITA,Chievo,Serie A,2018,27.0,1990.0,21.7,43,25,22,15,6,22,51,43.1,29,20,5,15,23,66,45,1,MF,25-29,Midfielder,Italy,Europe
75942,Toms Rincn,VEN,Torino,Serie A,2018,30.0,1988.0,31.1,75,44,25,41,9,31,68,45.6,37,35,5,30,42,117,71,1,MF,30-34,Midfielder,Venezuela,South America
225452,Patrick Roberts,ENG,Girona,La Liga,2018,21.0,1997.0,6.7,7,6,5,2,0,3,15,20.0,12,5,0,5,3,10,2,1,"MF,FW",20-24,Midfielder,England,Europe
234803,Andrew Robertson,SCO,Liverpool,Premier League,2018,24.0,1994.0,35.7,80,49,41,31,8,39,70,55.7,31,33,6,27,29,109,57,3,DF,20-24,Defender,Scotland,Europe
44466,Sebastian Rode,GER,Eint Frankfurt,Bundesliga,2018,27.0,1990.0,10.3,31,19,17,9,5,16,35,45.7,19,17,0,17,19,50,14,0,MF,25-29,Midfielder,Germany,Europe
76055,Ronny Rodelin,FRA,Guingamp,Ligue 1,2018,28.0,1989.0,8.8,13,5,2,7,4,3,8,37.5,5,8,1,7,8,21,13,0,"MF,FW",25-29,Midfielder,France,Europe
889683,Rogrio,BRA,Sassuolo,Serie A,2018,20.0,1998.0,29.7,55,38,35,13,7,30,55,54.5,25,32,7,25,37,92,109,1,"DF,MF",20-24,Defender,Brazil,South America
399887,Esteban Roln,ARG,Genoa,Serie A,2018,23.0,1995.0,11.6,46,29,14,20,12,20,44,45.5,24,18,2,16,16,62,12,0,MF,20-24,Midfielder,Argentina,South America
197747,Alessio Romagnoli,ITA,Milan,Serie A,2018,23.0,1995.0,31.6,34,19,26,6,2,16,19,84.2,3,48,32,16,37,71,173,1,DF,20-24,Defender,Italy,Europe
355915,Cristian Romero,ARG,Genoa,Serie A,2018,20.0,1998.0,26.0,61,35,38,18,5,27,40,67.5,13,49,27,22,37,98,128,1,DF,20-24,Defender,Argentina,South America
957874,Rmulo,ITA,Genoa,Serie A,2018,31.0,1987.0,15.0,26,18,9,10,7,7,17,41.2,10,16,3,13,18,44,20,0,"MF,FW",30-34,Midfielder,Italy,Europe
8198,Cristiano Ronaldo,POR,Juventus,Serie A,2018,33.0,1985.0,29.9,10,7,5,4,1,1,11,9.1,10,7,2,5,6,16,32,0,FW,30-34,Forward,Portugal,Europe
80197,Salomn Rondn,VEN,Newcastle Utd,Premier League,2018,28.0,1989.0,28.9,8,3,2,4,2,4,24,16.7,20,14,3,11,5,13,39,0,FW,25-29,Forward,Venezuela,South America
332889,Valentin Rongier,FRA,Nantes,Ligue 1,2018,23.0,1994.0,35.8,86,54,24,46,16,26,65,40.0,39,46,6,40,33,119,19,0,MF,20-24,Midfielder,France,Europe
50174,Danny Rose,ENG,Tottenham,Premier League,2018,28.0,1990.0,20.0,49,31,26,16,7,20,32,62.5,12,24,4,20,24,73,28,3,DF,25-29,Defender,England,Europe
441170,Valentin Rosier,FRA,Dijon,Ligue 1,2018,21.0,1996.0,16.2,44,25,22,19,3,16,31,51.6,15,25,4,21,32,76,45,1,"DF,MF",20-24,Defender,France,Europe
127076,Jrme Roussillon,FRA,Wolfsburg,Bundesliga,2018,25.0,1993.0,27.3,42,29,25,15,2,20,30,66.7,10,50,7,43,31,73,54,0,DF,25-29,Defender,France,Europe
81460,Nolan Roux,FRA,Guingamp,Ligue 1,2018,30.0,1988.0,17.1,11,9,0,6,5,4,14,28.6,10,6,2,4,4,15,21,0,FW,30-34,Forward,France,Europe
86202,Antonio Rdiger,GER,Chelsea,Premier League,2018,25.0,1993.0,31.9,34,16,27,6,1,15,27,55.6,12,15,8,7,32,66,96,1,DF,25-29,Defender,Germany,Europe
57051,Sebastian Rudy,GER,Schalke 04,Bundesliga,2018,28.0,1990.0,15.1,44,24,11,27,6,11,41,26.8,30,23,2,21,15,59,15,0,MF,25-29,Midfielder,Germany,Europe
87884,Mrio Rui,POR,Napoli,Serie A,2018,27.0,1991.0,15.7,24,18,9,12,3,14,25,56.0,11,15,3,12,21,45,38,0,DF,25-29,Defender,Portugal,Europe
135492,Youssouf Sabaly,SEN,Bordeaux,Ligue 1,2018,25.0,1993.0,21.2,46,32,32,12,2,25,46,54.3,21,19,2,17,26,72,42,0,DF,25-29,Defender,Senegal,Africa
412095,Ihsan Sacko,FRA,Nice,Ligue 1,2018,21.0,1997.0,4.9,7,2,2,5,0,2,5,40.0,3,5,0,5,2,9,2,0,FW,20-24,Forward,France,Europe
182916,Wesley Sad,FRA,Dijon,Ligue 1,2018,23.0,1995.0,25.0,25,18,6,11,8,5,20,25.0,15,9,0,9,9,34,9,0,"FW,MF",20-24,Forward,France,Europe
83002,Hiroki Sakai,JPN,Marseille,Ligue 1,2018,28.0,1990.0,26.4,59,41,30,23,6,29,54,53.7,25,25,10,15,37,96,77,0,DF,25-29,Defender,Japan,Asia
190780,Emiliano Sala,ARG,Nantes,Ligue 1,2018,27.0,1990.0,15.2,7,5,0,2,5,1,8,12.5,7,8,1,7,2,9,20,0,FW,25-29,Forward,Argentina,South America
96806,Jacopo Sala,ITA,Sampdoria,Serie A,2018,26.0,1991.0,16.9,38,23,20,14,4,23,41,56.1,18,11,3,8,20,58,47,2,DF,25-29,Defender,Italy,Europe
148455,Mohamed Salah,EGY,Liverpool,Premier League,2018,26.0,1992.0,36.1,21,9,3,11,7,5,16,31.3,11,9,0,9,5,26,6,0,FW,25-29,Forward,Egypt,Africa
256866,Carlos Salcedo,MEX,Eint Frankfurt,Bundesliga,2018,24.0,1993.0,5.1,7,3,4,3,0,4,7,57.1,3,7,3,4,9,16,22,0,DF,20-24,Defender,Mexico,North America
335147,Junior Sambia,FRA,Montpellier,Ligue 1,2018,21.0,1996.0,10.3,15,7,7,7,1,6,15,40.0,9,14,2,12,5,20,3,0,"MF,FW",20-24,Midfielder,France,Europe
7101,Paolo Sammarco,ITA,Frosinone,Serie A,2018,35.0,1983.0,6.1,16,7,7,6,3,6,9,66.7,3,5,0,5,3,19,1,2,MF,35-39,Midfielder,Italy,Europe
80173,Frdric Sammaritano,FRA,Dijon,Ligue 1,2018,32.0,1986.0,6.0,11,5,5,5,1,5,13,38.5,8,8,1,7,8,19,2,1,"FW,MF",30-34,Forward,France,Europe
234523,Antonio Sanabria,PAR,Genoa,Serie A,2018,22.0,1996.0,8.5,6,3,1,1,4,0,1,0.0,1,8,0,8,4,10,3,0,FW,20-24,Forward,Paraguay,South America
40433,Alexis Snchez,CHI,Manchester Utd,Premier League,2018,29.0,1988.0,9.8,17,10,5,9,3,5,13,38.5,8,7,0,7,9,26,2,0,"FW,MF",25-29,Forward,Chile,South America
401173,Jadon Sancho,ENG,Dortmund,Bundesliga,2018,18.0,2000.0,27.3,19,10,7,6,6,10,31,32.3,21,21,1,20,14,33,12,1,"FW,MF",Under 20,Forward,England,Europe
79960,Alex Sandro,BRA,Juventus,Serie A,2018,27.0,1991.0,26.5,68,45,28,33,7,21,36,58.3,15,32,8,24,38,106,71,0,DF,25-29,Defender,Brazil,South America
192565,Leroy San,GER,Manchester City,Premier League,2018,22.0,1996.0,20.7,24,15,8,7,9,2,23,8.7,21,21,2,19,8,32,2,0,FW,20-24,Forward,Germany,Europe
126534,Salif San,SEN,Schalke 04,Bundesliga,2018,27.0,1990.0,29.0,54,37,34,19,1,27,46,58.7,19,44,29,15,68,122,146,3,DF,25-29,Defender,Senegal,Africa
375885,Ibrahim Sangar,CIV,Toulouse,Ligue 1,2018,20.0,1997.0,27.4,102,66,50,44,8,32,63,50.8,31,52,20,32,29,131,49,2,MF,20-24,Midfielder,Ivory Coast,Africa
127194,Yaya Sanogo,FRA,Toulouse,Ligue 1,2018,25.0,1993.0,13.8,4,2,0,2,2,2,4,50.0,2,3,0,3,3,7,15,0,FW,25-29,Forward,France,Europe
174094,Morgan Sanson,FRA,Marseille,Ligue 1,2018,23.0,1994.0,26.7,70,47,27,35,8,21,77,27.3,56,40,1,39,42,112,8,1,MF,20-24,Midfielder,France,Europe
285323,Baptiste Santamaria,FRA,Angers,Ligue 1,2018,23.0,1995.0,36.1,118,60,48,63,7,51,106,48.1,55,41,4,37,57,175,57,2,MF,20-24,Midfielder,France,Europe
99180,Federico Santander,PAR,Bologna,Serie A,2018,27.0,1991.0,22.9,18,10,6,8,4,2,23,8.7,21,20,2,18,9,27,30,0,FW,25-29,Forward,Paraguay,South America
84344,Davide Santon,ITA,Roma,Serie A,2018,27.0,1991.0,11.2,14,6,8,6,0,8,12,66.7,4,11,7,4,15,29,27,0,DF,25-29,Defender,Italy,Europe
393325,Josh Sargent,USA,Werder Bremen,Bundesliga,2018,18.0,2000.0,2.4,2,1,1,0,1,2,2,100.0,0,2,0,2,0,2,3,0,FW,Under 20,Forward,United States,North America
190685,Bouna Sarr,SEN,Marseille,Ligue 1,2018,26.0,1992.0,24.9,67,48,27,27,13,26,42,61.9,16,28,3,25,39,106,56,1,"DF,MF",25-29,Defender,Senegal,Africa
127156,Tji Savanier,FRA,Nmes,Ligue 1,2018,26.0,1991.0,31.8,95,58,35,52,8,43,116,37.1,73,32,15,17,64,159,53,2,MF,25-29,Midfielder,France,Europe
135343,Fabian Schr,SUI,Newcastle Utd,Premier League,2018,26.0,1991.0,22.2,60,39,37,19,4,24,50,48.0,26,40,16,24,67,127,145,2,DF,25-29,Defender,Switzerland,Europe
119164,Ezequiel Schelotto,ITA,Chievo,Serie A,2018,29.0,1989.0,1.6,3,0,3,0,0,2,3,66.7,1,1,0,1,2,5,8,0,DF,25-29,Defender,Italy,Europe
56762,Pasquale Schiattarella,ITA,SPAL,Serie A,2018,31.0,1987.0,20.5,43,27,18,21,4,13,38,34.2,25,17,5,12,22,65,25,1,MF,30-34,Midfielder,Italy,Europe
58124,Julian Schieber,GER,Augsburg,Bundesliga,2018,29.0,1989.0,2.9,3,2,1,2,0,0,1,0.0,1,1,0,1,1,4,3,0,FW,25-29,Forward,Germany,Europe
57842,Christopher Schindler,GER,Huddersfield,Premier League,2018,28.0,1990.0,36.2,61,36,46,14,1,27,47,57.4,20,69,34,35,70,131,138,4,DF,25-29,Defender,Germany,Europe
413843,Keven Schlotterbeck,GER,Freiburg,Bundesliga,2018,21.0,1997.0,8.6,22,16,19,2,1,8,12,66.7,4,17,11,6,13,35,26,0,DF,20-24,Defender,Germany,Europe
70285,Jonathan Schmid,FRA,Augsburg,Bundesliga,2018,28.0,1990.0,28.0,44,22,23,19,2,16,28,57.1,12,22,8,14,43,87,70,2,DF,25-29,Defender,France,Europe
118397,Alessandro Schpf,AUT,Schalke 04,Bundesliga,2018,24.0,1994.0,11.2,26,16,12,13,1,12,29,41.4,17,14,0,14,9,35,12,0,"MF,DF",20-24,Midfielder,Austria,Europe
85867,Nico Schulz,GER,Hoffenheim,Bundesliga,2018,25.0,1993.0,28.2,34,20,19,12,3,15,36,41.7,21,32,4,28,24,58,36,0,DF,25-29,Defender,Germany,Europe
14533,Pirmin Schwegler,SUI,Hannover 96,Bundesliga,2018,31.0,1987.0,23.1,63,34,30,29,4,34,60,56.7,26,21,5,16,41,104,54,0,MF,30-34,Midfielder,Switzerland,Europe
178459,Davie Selke,GER,Hertha BSC,Bundesliga,2018,23.0,1995.0,19.3,5,2,1,4,0,2,9,22.2,7,11,0,11,1,6,7,0,FW,20-24,Forward,Germany,Europe
252345,Ken Sema,SWE,Watford,Premier League,2018,24.0,1993.0,8.4,15,7,7,5,3,9,21,42.9,12,7,0,7,8,23,5,0,"MF,FW",20-24,Midfielder,Sweden,Europe
231572,Nlson Semedo,POR,Barcelona,La Liga,2018,24.0,1993.0,17.8,38,27,23,12,3,12,18,66.7,6,23,7,16,22,60,26,0,DF,20-24,Defender,Portugal,Europe
216179,Stefano Sensi,ITA,Sassuolo,Serie A,2018,22.0,1995.0,21.9,36,20,15,18,3,6,30,20.0,24,36,7,29,33,69,17,0,MF,20-24,Midfielder,Italy,Europe
261905,Suat Serdar,GER,Schalke 04,Bundesliga,2018,21.0,1997.0,19.2,51,32,20,26,5,14,49,28.6,35,37,6,31,23,74,5,1,MF,20-24,Midfielder,Germany,Europe
392775,Ryan Sessegnon,ENG,Fulham,Premier League,2018,18.0,2000.0,25.6,22,14,8,8,6,6,22,27.3,16,25,2,23,19,41,49,1,"FW,DF",Under 20,Forward,England,Europe
94529,Stephan El Shaarawy,ITA,Roma,Serie A,2018,25.0,1992.0,23.4,27,14,14,8,5,9,24,37.5,15,11,2,9,20,47,9,0,"FW,MF",25-29,Forward,Italy,Europe
86792,Xherdan Shaqiri,SUI,Liverpool,Premier League,2018,26.0,1991.0,11.8,14,4,3,9,2,9,19,47.4,10,6,1,5,6,20,6,0,"FW,MF",25-29,Forward,Switzerland,Europe
183288,Luke Shaw,ENG,Manchester Utd,Premier League,2018,23.0,1995.0,28.8,55,29,17,31,7,28,47,59.6,19,42,12,30,21,76,93,2,DF,20-24,Defender,England,Europe
129693,Gaku Shibasaki,JPN,Getafe,La Liga,2018,26.0,1992.0,4.3,7,3,2,4,1,3,6,50.0,3,2,0,2,3,10,4,0,"MF,FW",25-29,Midfielder,Japan,Asia
161869,Djibril Sidib,FRA,Monaco,Ligue 1,2018,26.0,1992.0,23.1,50,34,27,12,11,26,48,54.2,22,25,9,16,30,80,51,0,"DF,MF",25-29,Defender,France,Europe
27374,Sidnei,BRA,Betis,La Liga,2018,28.0,1989.0,19.4,48,29,33,12,3,18,34,52.9,16,21,8,13,41,89,57,0,DF,25-29,Defender,Brazil,South America
86079,Luca Siligardi,ITA,Parma,Serie A,2018,30.0,1988.0,18.2,30,20,10,13,7,8,23,34.8,15,19,3,16,15,45,11,0,FW,30-34,Forward,Italy,Europe
700646,Andr Silva,POR,Sevilla,La Liga,2018,22.0,1995.0,24.0,8,5,1,4,3,1,11,9.1,10,17,1,16,3,11,32,0,FW,20-24,Forward,Portugal,Europe
241641,Bernardo Silva,POR,Manchester City,Premier League,2018,23.0,1994.0,31.7,52,39,18,21,13,16,67,23.9,51,47,3,44,25,77,26,1,"MF,FW",20-24,Midfielder,Portugal,Europe
627224,Gabriel Silva,BRA,Saint-tienne,Ligue 1,2018,27.0,1991.0,15.9,19,10,13,6,0,6,17,35.3,11,15,3,12,14,33,60,1,DF,25-29,Defender,Brazil,South America
1074917,Jonathan Silva,ARG,Legans,La Liga,2018,24.0,1994.0,30.0,51,38,30,17,4,23,52,44.2,29,23,2,21,29,80,86,0,"DF,FW",20-24,Defender,Argentina,South America
282388,Giovanni Simeone,ARG,Fiorentina,Serie A,2018,23.0,1995.0,27.3,43,27,10,23,10,7,29,24.1,22,26,2,24,4,47,14,0,FW,20-24,Forward,Argentina,South America
274862,Moses Simon,NGA,Levante,La Liga,2018,23.0,1995.0,8.7,14,8,10,2,2,5,9,55.6,4,10,1,9,12,26,14,0,"DF,MF",20-24,Defender,Nigeria,Africa
372712,Ibrahima Sissoko,MLI,Strasbourg,Ligue 1,2018,20.0,1997.0,29.6,60,41,23,34,3,23,55,41.8,32,37,3,34,34,94,39,1,MF,20-24,Midfielder,Mali,Africa
46001,Moussa Sissoko,FRA,Tottenham,Premier League,2018,28.0,1989.0,25.9,36,25,18,14,4,15,29,51.7,14,31,4,27,16,52,25,2,"MF,FW",25-29,Midfielder,France,Europe
290587,Ellyes Skhiri,TUN,Montpellier,Ligue 1,2018,23.0,1995.0,34.3,105,58,31,64,10,43,91,47.3,48,60,7,53,60,165,41,0,MF,20-24,Midfielder,Tunisia,Africa
93827,Steven Skrzybski,GER,Schalke 04,Bundesliga,2018,25.0,1992.0,7.4,9,3,0,6,3,3,11,27.3,8,8,1,7,3,12,2,0,"FW,MF",25-29,Forward,Germany,Europe
184491,Nam Sliti,TUN,Dijon,Ligue 1,2018,26.0,1992.0,25.4,56,33,24,19,13,15,46,32.6,31,18,0,18,11,67,9,0,"MF,FW",25-29,Midfielder,Tunisia,Africa
103427,Chris Smalling,ENG,Manchester Utd,Premier League,2018,28.0,1989.0,23.6,30,17,21,9,0,11,17,64.7,6,37,25,12,26,56,109,1,DF,25-29,Defender,England,Europe
163532,Adam Smith,ENG,Bournemouth,Premier League,2018,27.0,1991.0,23.0,46,32,26,14,6,19,41,46.3,22,26,7,19,31,77,68,1,"DF,MF",25-29,Defender,England,Europe
39690,Danilo Soddimo,ITA,Frosinone,Serie A,2018,30.0,1987.0,2.8,11,9,3,6,2,3,6,50.0,3,2,1,1,7,18,3,0,"MF,FW",30-34,Midfielder,Italy,Europe
258889,Dominic Solanke,ENG,Bournemouth,Premier League,2018,20.0,1997.0,3.9,8,3,1,4,3,1,8,12.5,7,4,1,3,2,10,9,0,"FW,MF",20-24,Forward,England,Europe
56820,Jrmy Sorbon,FRA,Guingamp,Ligue 1,2018,34.0,1983.0,29.4,33,20,23,10,0,14,22,63.6,8,33,23,10,34,67,105,2,DF,30-34,Defender,France,Europe
55114,Oliver Sorg,GER,Hannover 96,Bundesliga,2018,28.0,1990.0,17.6,42,28,26,16,0,20,43,46.5,23,16,9,7,46,88,47,0,DF,25-29,Defender,Germany,Europe
293194,Borna Sosa,CRO,Stuttgart,Bundesliga,2018,20.0,1998.0,6.8,13,7,8,4,1,4,9,44.4,5,5,1,4,6,19,34,0,"DF,MF",20-24,Defender,Croatia,Europe
344605,Boubakary Soumar,FRA,Lille,Ligue 1,2018,19.0,1999.0,6.3,20,15,9,11,0,10,18,55.6,8,9,3,6,7,27,5,0,MF,Under 20,Midfielder,France,Europe
51186,Nicols Spolli,ARG,Genoa,Serie A,2018,35.0,1983.0,6.0,7,6,3,4,0,0,2,0.0,2,8,6,2,7,14,39,1,DF,35-39,Defender,Argentina,South America
14942,Darijo Srna,CRO,Cagliari,Serie A,2018,36.0,1982.0,23.2,24,16,6,13,5,9,14,64.3,5,24,5,19,18,42,66,0,DF,35-39,Defender,Croatia,Europe
87672,Junior Stanislas,ENG,Bournemouth,Premier League,2018,28.0,1989.0,11.5,12,6,5,4,3,3,7,42.9,4,8,1,7,2,14,15,0,"MF,FW",25-29,Midfielder,England,Europe
162434,Niklas Stark,GER,Hertha BSC,Bundesliga,2018,23.0,1995.0,20.8,34,19,23,11,0,9,24,37.5,15,45,26,19,37,71,141,1,DF,20-24,Defender,Germany,Europe
195246,Pascal Stenzel,GER,Freiburg,Bundesliga,2018,22.0,1996.0,16.1,42,26,26,14,2,24,43,55.8,19,16,3,13,30,72,48,1,"DF,MF",20-24,Defender,Germany,Europe
49755,Dale Stephens,ENG,Brighton,Premier League,2018,29.0,1989.0,27.6,83,57,37,41,5,28,74,37.8,46,33,13,20,46,129,47,0,MF,25-29,Midfielder,England,Europe
163744,Jack Stephens,ENG,Southampton,Premier League,2018,24.0,1994.0,18.9,25,13,17,7,1,16,28,57.1,12,25,13,12,37,62,96,2,DF,20-24,Defender,England,Europe
134425,Raheem Sterling,ENG,Manchester City,Premier League,2018,23.0,1994.0,30.8,32,16,11,12,9,9,25,36.0,16,28,3,25,17,49,4,0,FW,20-24,Forward,England,Europe
48298,Lars Stindl,GER,Gladbach,Bundesliga,2018,29.0,1988.0,16.8,21,14,8,11,2,3,15,20.0,12,22,2,20,14,35,13,0,"FW,MF",25-29,Forward,Germany,Europe
106872,Kevin Stger,AUT,Dsseldorf,Bundesliga,2018,24.0,1993.0,23.5,63,35,28,27,8,30,67,44.8,37,32,5,27,31,94,19,1,MF,20-24,Midfielder,Austria,Europe
186590,John Stones,ENG,Manchester City,Premier League,2018,24.0,1994.0,19.6,16,11,9,5,2,4,9,44.4,5,15,9,6,14,30,64,1,DF,20-24,Defender,England,Europe
57845,Tobias Strobl,GER,Gladbach,Bundesliga,2018,28.0,1990.0,25.5,31,17,17,13,1,9,29,31.0,20,36,14,22,29,60,35,1,"MF,DF",25-29,Midfielder,Germany,Europe
59323,Cristhian Stuani,URU,Girona,La Liga,2018,31.0,1986.0,30.3,23,13,7,13,3,5,20,25.0,15,13,1,12,4,27,39,0,FW,30-34,Forward,Uruguay,South America
76746,Damin Surez,URU,Getafe,La Liga,2018,30.0,1988.0,36.0,96,62,43,41,12,53,120,44.2,67,47,6,41,46,142,57,2,DF,30-34,Defender,Uruguay,South America
424784,Luis Surez,URU,Barcelona,La Liga,2018,31.0,1987.0,31.4,18,11,1,6,11,4,10,40.0,6,12,4,8,8,26,24,0,FW,30-34,Forward,Uruguay,South America
295331,Isaac Success,NGA,Watford,Premier League,2018,22.0,1996.0,11.7,15,12,4,8,3,2,5,40.0,3,6,0,6,2,17,11,0,"FW,MF",20-24,Forward,Nigeria,Africa
166601,Niklas Sle,GER,Bayern Munich,Bundesliga,2018,22.0,1995.0,29.5,28,23,17,10,1,18,25,72.0,7,23,13,10,40,68,83,0,DF,20-24,Defender,Germany,Europe
29975,Andrew Surman,ENG,Bournemouth,Premier League,2018,31.0,1986.0,16.0,11,6,6,5,0,3,13,23.1,10,20,7,13,10,21,34,1,MF,30-34,Midfielder,England,Europe
220878,Issiaga Sylla,GUI,Toulouse,Ligue 1,2018,24.0,1994.0,22.2,54,36,30,24,0,28,53,52.8,25,36,10,26,39,93,77,0,"DF,MF",20-24,Defender,Guinea,Africa
39106,dm Szalai,HUN,Hoffenheim,Bundesliga,2018,30.0,1987.0,18.1,19,13,3,12,4,4,11,36.4,7,8,1,7,4,23,8,0,FW,30-34,Forward,Hungary,Europe
196357,Jonathan Tah,GER,Leverkusen,Bundesliga,2018,22.0,1996.0,32.6,44,30,30,10,4,17,32,53.1,15,39,26,13,45,89,142,1,DF,20-24,Defender,Germany,Europe
173504,James Tarkowski,ENG,Burnley,Premier League,2018,25.0,1992.0,34.3,71,36,52,18,1,29,50,58.0,21,72,56,16,42,113,240,2,DF,25-29,Defender,England,Europe
413112,Aurlien Tchouamni,FRA,Bordeaux,Ligue 1,2018,18.0,2000.0,7.8,24,12,10,14,0,7,18,38.9,11,11,5,6,21,45,14,0,MF,Under 20,Midfielder,France,Europe
81698,Georg Teigl,AUT,Augsburg,Bundesliga,2018,27.0,1991.0,3.3,5,3,4,0,1,2,2,100.0,0,1,0,1,7,12,5,1,"MF,FW",25-29,Midfielder,Austria,Europe
206746,Kenny Tete,NED,Lyon,Ligue 1,2018,22.0,1995.0,11.6,30,23,11,16,3,13,19,68.4,6,13,5,8,18,48,29,0,DF,20-24,Defender,Netherlands,Europe
184892,Florian Thauvin,FRA,Marseille,Ligue 1,2018,25.0,1993.0,29.0,42,23,10,21,11,16,35,45.7,19,19,1,18,8,50,4,0,"FW,MF",25-29,Forward,France,Europe
290593,Sada Thioub,SEN,Nmes,Ligue 1,2018,23.0,1995.0,27.5,30,19,13,10,7,20,45,44.4,25,29,1,28,16,46,11,0,"MF,FW",20-24,Midfielder,Senegal,Africa
215977,Adrien Thomasson,FRA,Strasbourg,Ligue 1,2018,24.0,1993.0,27.5,54,27,18,23,13,21,66,31.8,45,29,5,24,18,72,12,1,"MF,FW",20-24,Midfielder,France,Europe
156779,Erik Thommy,GER,Stuttgart,Bundesliga,2018,23.0,1994.0,8.8,5,3,3,1,1,1,7,14.3,6,16,1,15,14,19,4,0,"MF,FW",20-24,Midfielder,Germany,Europe
249565,Youri Tielemans,BEL,Leicester City,Premier League,2018,21.0,1997.0,12.1,17,8,5,9,3,5,17,29.4,12,13,2,11,5,22,13,1,MF,20-24,Midfielder,Belgium,Europe
424709,Cheick Timite,CIV,Amiens,Ligue 1,2018,20.0,1997.0,16.2,18,13,5,7,6,3,16,18.8,13,14,2,12,12,30,13,0,"FW,MF",20-24,Forward,Ivory Coast,Africa
315110,Karl Toko Ekambi,CMR,Villarreal,La Liga,2018,25.0,1992.0,23.8,11,8,1,6,4,2,14,14.3,12,8,0,8,11,22,9,1,"FW,MF",25-29,Forward,Cameroon,Africa
72441,Rafael Toli,ITA,Atalanta,Serie A,2018,27.0,1990.0,19.4,27,17,15,9,3,16,24,66.7,8,28,10,18,33,60,54,1,DF,25-29,Defender,Italy,Europe
61592,James Tomkins,ENG,Crystal Palace,Premier League,2018,29.0,1989.0,28.4,34,20,27,7,0,15,28,53.6,13,23,10,13,34,68,184,3,DF,25-29,Defender,England,Europe
111347,Lorenzo Tonelli,ITA,Sampdoria,Serie A,2018,28.0,1990.0,18.4,31,22,19,9,3,15,19,78.9,4,27,21,6,24,55,92,0,DF,25-29,Defender,Italy,Europe
530902,Abdoulaye Tour,GUI,Nantes,Ligue 1,2018,24.0,1994.0,30.5,48,31,14,28,6,19,56,33.9,37,25,10,15,47,95,29,1,MF,20-24,Midfielder,Guinea,Africa
353948,Lucas Tousart,FRA,Lyon,Ligue 1,2018,21.0,1997.0,19.2,74,38,33,34,7,25,59,42.4,34,30,13,17,26,100,27,0,MF,20-24,Midfielder,France,Europe
364405,Adama Traor,MLI,Monaco,Ligue 1,2018,23.0,1995.0,2.7,2,1,1,0,1,1,4,25.0,3,4,0,4,3,5,1,0,MF,20-24,Midfielder,Mali,Africa
378965,Cheick Traor,MLI,Guingamp,Ligue 1,2018,23.0,1995.0,16.8,37,21,23,11,3,15,25,60.0,10,13,3,10,23,60,46,1,DF,20-24,Defender,Mali,Africa
606450,Gaoussou Traor,MLI,Amiens,Ligue 1,2018,18.0,1999.0,1.2,10,5,6,4,0,4,8,50.0,4,1,0,1,0,10,0,0,MF,Under 20,Midfielder,Mali,Africa
297070,Hamari Traor,MLI,Rennes,Ligue 1,2018,26.0,1992.0,33.0,61,33,32,27,2,36,71,50.7,35,39,11,28,44,105,82,0,DF,25-29,Defender,Mali,Africa
47285,Ibrahima Traor,GUI,Gladbach,Bundesliga,2018,30.0,1988.0,6.1,12,6,8,2,2,3,11,27.3,8,3,1,2,3,15,1,0,"FW,MF",30-34,Forward,Guinea,Africa
57216,Ismal Traor,CIV,Angers,Ligue 1,2018,31.0,1986.0,29.3,27,11,19,8,0,9,24,37.5,15,27,16,11,42,69,120,2,DF,30-34,Defender,Ivory Coast,Africa
95810,Kieran Trippier,ENG,Tottenham,Premier League,2018,27.0,1990.0,25.3,67,37,43,16,8,37,62,59.7,25,38,5,33,23,90,77,2,DF,25-29,Defender,England,Europe
142281,Anthony Ujah,NGA,Mainz 05,Bundesliga,2018,27.0,1990.0,8.2,2,0,0,1,1,1,2,50.0,1,7,2,5,1,3,10,0,FW,25-29,Forward,Nigeria,Africa
251106,Enes nal,TUR,Valladolid,La Liga,2018,21.0,1997.0,23.9,17,10,3,4,10,4,24,16.7,20,17,4,13,2,19,18,0,FW,20-24,Forward,Turkey,Asia
344695,Dayot Upamecano,FRA,RB Leipzig,Bundesliga,2018,19.0,1998.0,14.4,22,16,14,8,0,15,18,83.3,3,19,5,14,33,55,47,0,DF,Under 20,Defender,France,Europe
111881,Takashi Usami,JPN,Dsseldorf,Bundesliga,2018,26.0,1992.0,9.8,18,12,7,11,0,9,26,34.6,17,15,2,13,8,26,13,1,"MF,FW",25-29,Midfielder,Japan,Asia
40605,Enrico Valentini,ITA,Nrnberg,Bundesliga,2018,29.0,1989.0,14.4,44,27,31,10,3,22,40,55.0,18,17,3,14,13,57,58,0,DF,25-29,Defender,Italy,Europe
369081,Federico Valverde,URU,Real Madrid,La Liga,2018,20.0,1998.0,7.3,12,8,3,7,2,5,11,45.5,6,10,2,8,21,33,10,0,MF,20-24,Midfielder,Uruguay,South America
139208,Virgil van Dijk,NED,Liverpool,Premier League,2018,27.0,1991.0,37.6,38,28,26,11,1,14,14,100.0,0,29,18,11,40,78,201,1,DF,25-29,Defender,Netherlands,Europe
197838,Jamie Vardy,ENG,Leicester City,Premier League,2018,31.0,1987.0,30.3,14,8,3,6,5,4,17,23.5,13,16,1,15,6,20,28,0,FW,30-34,Forward,England,Europe
76163,Franco Vzquez,ARG,Sevilla,La Liga,2018,29.0,1989.0,25.3,51,37,21,21,9,23,66,34.8,43,25,2,23,23,74,27,1,MF,25-29,Midfielder,Argentina,South America
189458,Emiliano Velzquez,URU,Rayo Vallecano,La Liga,2018,24.0,1994.0,14.2,49,32,38,9,2,20,34,58.8,14,29,7,22,47,96,106,1,DF,20-24,Defender,Uruguay,South America
256361,Daniele Verde,ITA,Valladolid,La Liga,2018,22.0,1996.0,7.3,6,3,2,2,2,1,6,16.7,5,3,0,3,7,13,3,1,"MF,FW",20-24,Midfielder,Italy,Europe
130360,Simone Verdi,ITA,Napoli,Serie A,2018,26.0,1992.0,7.8,16,11,5,9,2,8,16,50.0,8,6,0,6,4,20,3,0,"MF,FW",25-29,Midfielder,Italy,Europe
164771,Jordan Veretout,FRA,Fiorentina,Serie A,2018,25.0,1993.0,32.7,64,40,22,31,11,21,52,40.4,31,33,7,26,46,110,54,2,MF,25-29,Midfielder,France,Europe
99331,Jannik Vestergaard,DEN,Southampton,Premier League,2018,25.0,1992.0,22.5,53,33,37,13,3,28,45,62.2,17,35,20,15,35,88,174,1,DF,25-29,Defender,Denmark,Europe
240158,Francesco Vicari,ITA,SPAL,Serie A,2018,23.0,1994.0,25.9,28,24,21,7,0,18,28,64.3,10,31,24,7,34,62,139,1,DF,20-24,Defender,Italy,Europe
37666,Arturo Vidal,CHI,Barcelona,La Liga,2018,31.0,1987.0,21.4,78,44,32,37,9,30,69,43.5,39,46,5,41,29,107,23,1,MF,30-34,Midfielder,Chile,South America
434676,Ronaldo Vieira,ENG,Sampdoria,Serie A,2018,20.0,1998.0,6.7,19,10,3,14,2,5,9,55.6,4,10,2,8,8,27,24,1,MF,20-24,Midfielder,England,Europe
394346,Emanuel Vignato,ITA,Chievo,Serie A,2018,17.0,2000.0,7.3,8,4,4,3,1,0,6,0.0,6,4,0,4,10,18,0,0,"MF,FW",Under 20,Midfielder,Italy,Europe
357158,Rben Vinagre,POR,Wolves,Premier League,2018,19.0,1999.0,7.9,14,9,7,7,0,2,5,40.0,3,10,2,8,14,28,16,1,"DF,MF",Under 20,Defender,Portugal,Europe
525287,Carlos Vincius,BRA,Monaco,Ligue 1,2018,23.0,1995.0,5.8,4,1,1,2,1,0,1,0.0,1,7,0,7,1,5,2,0,"FW,MF",20-24,Forward,Brazil,South America
84435,Kevin Vogt,GER,Hoffenheim,Bundesliga,2018,26.0,1991.0,26.6,24,15,20,4,0,12,32,37.5,20,28,11,17,33,57,103,3,DF,25-29,Defender,Germany,Europe
82009,Kevin Volland,GER,Leverkusen,Bundesliga,2018,26.0,1992.0,31.3,33,20,7,14,12,13,27,48.1,14,17,1,16,6,39,33,0,FW,25-29,Forward,Germany,Europe
111196,Stefan de Vrij,NED,Inter,Serie A,2018,26.0,1992.0,28.0,25,16,14,10,1,8,15,53.3,7,32,23,9,25,50,95,1,DF,25-29,Defender,Netherlands,Europe
323954,Walace,BRA,Hannover 96,Bundesliga,2018,23.0,1995.0,22.2,52,22,17,28,7,27,61,44.3,34,30,4,26,45,97,36,1,MF,20-24,Midfielder,Brazil,South America
33713,Theo Walcott,ENG,Everton,Premier League,2018,29.0,1989.0,23.5,27,17,11,9,7,10,22,45.5,12,17,1,16,22,49,8,0,"FW,MF",25-29,Forward,England,Europe
196095,Luca Waldschmidt,GER,Freiburg,Bundesliga,2018,22.0,1996.0,19.1,20,13,7,10,3,2,20,10.0,18,20,3,17,13,33,8,1,"FW,MF",20-24,Forward,Germany,Europe
95424,Kyle Walker,ENG,Manchester City,Premier League,2018,28.0,1990.0,30.9,40,26,20,20,0,24,38,63.2,14,19,5,14,36,76,58,2,DF,25-29,Defender,England,Europe
77760,Victor Wanyama,KEN,Tottenham,Premier League,2018,27.0,1991.0,5.7,13,13,8,5,0,6,12,50.0,6,9,3,6,7,20,11,0,MF,25-29,Midfielder,Kenya,Africa
203026,Danny Ward,ENG,Cardiff City,Premier League,2018,26.0,1991.0,4.9,2,1,0,1,1,0,3,0.0,3,3,1,2,0,2,9,0,FW,25-29,Forward,England,Europe
92572,Joel Ward,ENG,Crystal Palace,Premier League,2018,28.0,1989.0,6.1,12,7,7,4,1,3,10,30.0,7,2,0,2,10,22,35,0,DF,25-29,Defender,England,Europe
34691,Stephen Ward,IRL,Burnley,Premier League,2018,32.0,1985.0,2.5,4,2,1,2,1,1,4,25.0,3,3,1,2,4,8,14,0,DF,30-34,Defender,Republic of Ireland,Europe
181579,James Ward-Prowse,ENG,Southampton,Premier League,2018,23.0,1994.0,21.6,36,17,19,13,4,14,43,32.6,29,30,6,24,27,63,59,0,"MF,DF",20-24,Midfielder,England,Europe
196792,Julian Weigl,GER,Dortmund,Bundesliga,2018,22.0,1995.0,16.2,32,18,19,12,1,24,41,58.5,17,18,10,8,16,48,56,2,"DF,MF",20-24,Defender,Germany,Europe
19305,Oscar Wendt,SWE,Gladbach,Bundesliga,2018,32.0,1985.0,30.3,45,34,34,8,3,31,53,58.5,22,37,11,26,19,64,90,0,DF,30-34,Defender,Sweden,Europe
170527,Timo Werner,GER,RB Leipzig,Bundesliga,2018,22.0,1996.0,27.9,18,12,6,8,4,3,16,18.8,13,18,2,16,3,21,7,0,FW,20-24,Forward,Germany,Europe
91317,Ashley Westwood,ENG,Burnley,Premier League,2018,28.0,1990.0,31.4,58,30,24,27,7,14,39,35.9,25,38,9,29,47,105,42,2,MF,25-29,Midfielder,England,Europe
330223,Hendrik Weydandt,GER,Hannover 96,Bundesliga,2018,23.0,1995.0,19.1,18,12,7,8,3,3,24,12.5,21,14,4,10,5,23,44,0,FW,20-24,Forward,Germany,Europe
49499,Georginio Wijnaldum,NED,Liverpool,Premier League,2018,27.0,1990.0,30.3,41,28,14,20,7,14,27,51.9,13,21,7,14,21,62,24,0,MF,25-29,Midfielder,Netherlands,Europe
341710,William,BRA,Wolfsburg,Bundesliga,2018,23.0,1995.0,29.7,82,57,52,21,9,35,75,46.7,40,41,2,39,85,167,127,3,DF,20-24,Defender,Brazil,South America
255508,Iaki Williams,GHA,Athletic Club,La Liga,2018,24.0,1994.0,33.6,27,18,9,7,11,5,22,22.7,17,22,1,21,7,34,33,0,FW,20-24,Forward,Ghana,Africa
55338,Willian,BRA,Chelsea,Premier League,2018,29.0,1988.0,23.3,35,21,11,15,9,9,25,36.0,16,16,1,15,14,49,12,2,FW,25-29,Forward,Brazil,South America
450826,Callum Wilson,ENG,Bournemouth,Premier League,2018,26.0,1992.0,28.1,9,7,4,3,2,0,8,0.0,8,14,4,10,4,13,16,0,FW,25-29,Forward,England,Europe
249126,Harry Winks,ENG,Tottenham,Premier League,2018,22.0,1996.0,17.7,22,13,12,9,1,5,30,16.7,25,19,3,16,21,43,19,0,MF,20-24,Midfielder,England,Europe
35047,Axel Witsel,BEL,Dortmund,Bundesliga,2018,29.0,1989.0,31.9,47,33,19,24,4,17,28,60.7,11,33,6,27,47,94,49,0,MF,25-29,Midfielder,Belgium,Europe
72519,Bobby Wood,USA,Hannover 96,Bundesliga,2018,25.0,1992.0,13.1,13,10,2,10,1,5,8,62.5,3,2,0,2,4,17,6,0,"FW,MF",25-29,Forward,United States,North America
108725,Chris Wood,NZL,Burnley,Premier League,2018,26.0,1991.0,28.8,12,8,0,7,5,5,17,29.4,12,17,4,13,3,15,26,0,FW,25-29,Forward,New Zealand,Oceania
111455,Granit Xhaka,SUI,Arsenal,Premier League,2018,25.0,1992.0,27.8,52,29,29,20,3,24,59,40.7,35,35,9,26,36,88,56,3,"MF,DF",25-29,Midfielder,Switzerland,Europe
439914,John Yeboah,ECU,Wolfsburg,Bundesliga,2018,18.0,2000.0,0.6,0,0,0,0,0,0,3,0.0,3,1,0,1,1,1,0,0,"MF,FW",Under 20,Midfielder,Ecuador,South America
14086,Ashley Young,ENG,Manchester Utd,Premier League,2018,33.0,1985.0,28.5,52,32,34,16,2,20,39,51.3,19,36,10,26,55,107,74,0,DF,30-34,Defender,England,Europe
20007,Pablo Zabaleta,ARG,West Ham,Premier League,2018,33.0,1985.0,23.2,47,24,26,15,6,17,44,38.6,27,39,15,24,48,95,96,3,DF,30-34,Defender,Argentina,South America
344598,Dan-Axel Zagadou,FRA,Dortmund,Bundesliga,2018,19.0,1999.0,14.1,13,10,10,2,1,4,6,66.7,2,17,11,6,25,38,70,2,DF,Under 20,Defender,France,Europe
334526,Denis Zakaria,SUI,Gladbach,Bundesliga,2018,21.0,1996.0,21.8,40,21,15,24,1,12,30,40.0,18,38,9,29,26,66,20,0,MF,20-24,Midfielder,Switzerland,Europe
216872,Francesco Zampano,ITA,Frosinone,Serie A,2018,24.0,1993.0,23.4,35,25,23,9,3,15,31,48.4,16,24,4,20,13,48,48,0,"DF,MF",20-24,Defender,Italy,Europe
392085,Nicol Zaniolo,ITA,Roma,Serie A,2018,19.0,1999.0,19.6,35,21,7,18,10,7,37,18.9,30,14,0,14,13,48,8,0,"MF,FW",Under 20,Midfielder,Italy,Europe
34344,Cristin Zapata,COL,Milan,Serie A,2018,31.0,1986.0,11.4,23,16,15,7,1,9,10,90.0,1,18,15,3,8,31,59,0,DF,30-34,Defender,Colombia,South America
73794,Duvn Zapata,COL,Atalanta,Serie A,2018,27.0,1991.0,32.2,9,5,3,2,4,1,9,11.1,8,26,6,20,4,13,25,0,FW,25-29,Forward,Colombia,South America
173859,Davide Zappacosta,ITA,Chelsea,Premier League,2018,26.0,1992.0,1.4,0,0,0,0,0,0,1,0.0,1,0,0,0,3,3,5,0,DF,25-29,Defender,Italy,Europe
96828,Simone Zaza,ITA,Torino,Serie A,2018,27.0,1991.0,16.0,20,9,3,12,5,1,8,12.5,7,12,1,11,4,24,9,0,"FW,MF",25-29,Forward,Italy,Europe
37917,Nabil El Zhar,MAR,Legans,La Liga,2018,31.0,1986.0,10.7,8,4,2,4,2,0,5,0.0,5,4,0,4,4,12,1,0,"MF,FW",30-34,Midfielder,Morocco,Africa
118196,Jean Zimmer,GER,Dsseldorf,Bundesliga,2018,24.0,1993.0,15.9,17,11,11,5,1,6,16,37.5,10,13,2,11,11,28,32,1,"DF,FW",20-24,Defender,Germany,Europe
203853,Oleksandr Zinchenko,UKR,Manchester City,Premier League,2018,21.0,1996.0,12.8,34,20,13,15,6,14,33,42.4,19,14,3,11,20,54,19,1,DF,20-24,Defender,Ukraine,Europe
157509,Kurt Zouma,FRA,Everton,Premier League,2018,23.0,1994.0,29.0,32,21,16,14,2,4,11,36.4,7,27,12,15,54,86,126,2,DF,20-24,Defender,France,Europe
85370,Sergi Roberto,ESP,Barcelona,La Liga,2018,26.0,1992.0,23.2,28,20,15,9,4,16,24,66.7,8,18,3,15,43,71,31,0,"DF,MF",25-29,Defender,Spain,Europe
67548,Rubn Rochina,ESP,Levante,La Liga,2018,27.0,1991.0,20.0,51,33,26,16,9,23,81,28.4,58,29,0,29,21,72,19,1,MF,25-29,Midfielder,Spain,Europe
51510,ngel Rodrguez,ESP,Getafe,La Liga,2018,31.0,1987.0,20.2,16,7,1,6,9,6,26,23.1,20,15,1,14,8,24,8,0,FW,30-34,Forward,Spain,Europe
66100,Oriol Romeu,ESP,Southampton,Premier League,2018,26.0,1991.0,23.7,81,46,39,38,4,32,77,41.6,45,43,17,26,52,133,44,1,MF,25-29,Midfielder,Spain,Europe
62920,Vctor Ruiz,ESP,Villarreal,La Liga,2018,29.0,1989.0,21.9,28,19,20,6,2,13,18,72.2,5,28,16,12,38,66,67,1,DF,25-29,Defender,Spain,Europe
71019,Bartosz Salamon,POL,Frosinone,Serie A,2018,27.0,1991.0,19.2,17,10,12,5,0,6,14,42.9,8,27,19,8,27,44,143,1,DF,25-29,Defender,Poland,Europe
63290,Vctor Snchez,ESP,Espanyol,La Liga,2018,30.0,1987.0,14.1,45,30,21,17,7,14,67,20.9,53,17,2,15,25,70,25,0,MF,30-34,Midfielder,Spain,Europe
289286,Luca Sangalli,ESP,Real Sociedad,La Liga,2018,23.0,1995.0,11.1,19,13,6,11,2,5,22,22.7,17,9,1,8,5,24,5,0,"MF,FW",20-24,Midfielder,Spain,Europe
74230,Pablo Sarabia,ESP,Sevilla,La Liga,2018,26.0,1992.0,30.3,30,15,6,15,9,6,47,12.8,41,30,3,27,22,52,20,0,"MF,FW",25-29,Midfielder,Spain,Europe
242086,Patrik Schick,CZE,Roma,Serie A,2018,22.0,1996.0,14.6,11,5,3,5,3,1,19,5.3,18,19,2,17,3,14,15,1,"FW,MF",20-24,Forward,Czech Republic,Europe
86759,David Silva,ESP,Manchester City,Premier League,2018,32.0,1986.0,26.7,30,18,12,11,7,1,20,5.0,19,18,1,17,22,52,15,0,MF,30-34,Midfielder,Spain,Europe
372246,Carlos Soler,ESP,Valencia,La Liga,2018,21.0,1997.0,27.3,41,28,15,23,3,16,65,24.6,49,46,6,40,19,60,37,0,MF,20-24,Midfielder,Spain,Europe
111961,Suso,ESP,Milan,Serie A,2018,24.0,1993.0,33.5,28,18,10,14,4,10,41,24.4,31,26,1,25,16,44,3,0,"FW,MF",20-24,Forward,Spain,Europe
238407,Alexander Srloth,NOR,Crystal Palace,Premier League,2018,22.0,1995.0,2.1,2,1,0,0,2,1,2,50.0,1,0,0,0,0,2,3,0,FW,20-24,Forward,Norway,Europe
141834,Cristian Tello,ESP,Betis,La Liga,2018,26.0,1991.0,17.5,32,20,18,9,5,17,35,48.6,18,19,0,19,16,48,17,1,"DF,FW",25-29,Defender,Spain,Europe
128295,Tito,ESP,Rayo Vallecano,La Liga,2018,33.0,1985.0,12.2,14,9,12,2,0,7,22,31.8,15,22,2,20,17,31,41,0,DF,30-34,Defender,Spain,Europe
47085,Nenad Tomovi,SRB,Chievo,Serie A,2018,30.0,1987.0,8.2,9,7,5,4,0,7,10,70.0,3,5,1,4,13,22,34,0,DF,30-34,Defender,Serbia,Europe
76285,Too,ESP,Levante,La Liga,2018,28.0,1989.0,19.6,17,13,12,3,2,10,21,47.6,11,20,5,15,14,31,42,0,"DF,FW",25-29,Defender,Spain,Europe
213670,Lucas Torr,ESP,Eint Frankfurt,Bundesliga,2018,24.0,1994.0,6.2,14,7,5,7,2,5,11,45.5,6,12,1,11,14,28,13,0,MF,20-24,Midfielder,Spain,Europe
40372,Borja Valero,ESP,Inter,Serie A,2018,33.0,1985.0,13.7,22,19,9,10,3,8,30,26.7,22,11,1,10,16,38,27,2,MF,30-34,Midfielder,Spain,Europe
221316,Lucas Vzquez,ESP,Real Madrid,La Liga,2018,27.0,1991.0,16.8,43,26,11,21,11,15,41,36.6,26,16,1,15,12,55,11,0,"FW,MF",25-29,Forward,Spain,Europe
88490,Aleix Vidal,ESP,Sevilla,La Liga,2018,28.0,1989.0,5.9,13,11,5,5,3,5,14,35.7,9,5,0,5,4,17,12,0,"DF,MF",25-29,Defender,Spain,Europe
67090,Ddac Vil,ESP,Espanyol,La Liga,2018,29.0,1989.0,26.2,67,31,33,26,8,31,58,53.4,27,41,12,29,53,120,94,1,DF,25-29,Defender,Spain,Europe
337066,Toni Villa,ESP,Valladolid,La Liga,2018,23.0,1995.0,19.6,51,32,24,18,9,20,47,42.6,27,15,0,15,12,63,10,0,"MF,FW",20-24,Midfielder,Spain,Europe
67082,Vitolo,ESP,Atltico Madrid,La Liga,2018,28.0,1989.0,8.4,17,13,8,6,3,6,19,31.6,13,8,1,7,10,27,6,0,"MF,FW",25-29,Midfielder,Spain,Europe
181136,Piotr Zieliski,POL,Napoli,Serie A,2018,24.0,1994.0,31.9,41,25,11,20,10,13,34,38.2,21,30,4,26,20,61,18,0,MF,20-24,Midfielder,Poland,Europe
355628,Igor Zubeldia,ESP,Real Sociedad,La Liga,2018,21.0,1997.0,28.3,61,35,32,24,5,22,54,40.7,32,30,6,24,45,106,60,0,MF,20-24,Midfielder,Spain,Europe
59375,David Zurutuza,ESP,Real Sociedad,La Liga,2018,32.0,1986.0,13.6,27,16,9,15,3,8,22,36.4,14,19,4,15,24,51,26,1,MF,30-34,Midfielder,Spain,Europe
199704,Yunis Abdelhamid,MAR,Reims,Ligue 1,2021,33.0,1987.0,33.1,48,27,34,14,0,16,32,50.0,16,50,25,25,68,116,104,0,DF,30-34,Defender,Morocco,Africa
688707,Salis Abdul Samed,GHA,Clermont Foot,Ligue 1,2021,21.0,2000.0,27.4,43,23,25,16,2,20,57,35.1,37,18,1,17,42,85,15,0,MF,20-24,Midfielder,Ghana,Africa
238626,Laurent Abergel,FRA,Lorient,Ligue 1,2021,28.0,1993.0,32.8,110,60,44,53,13,71,166,42.8,95,58,1,57,55,165,13,0,MF,25-29,Midfielder,France,Europe
596813,Dickson Abiama,NGA,Greuther Frth,Bundesliga,2021,22.0,1998.0,8.1,11,7,4,5,2,2,10,20.0,8,12,1,11,4,15,8,0,FW,20-24,Forward,Nigeria,Africa
331726,Tammy Abraham,ENG,Roma,Serie A,2021,23.0,1997.0,34.3,27,13,7,14,6,9,22,40.9,13,17,3,14,5,32,27,0,FW,20-24,Forward,England,Europe
131075,Francesco Acerbi,ITA,Lazio,Serie A,2021,33.0,1988.0,28.2,25,12,15,9,1,12,19,63.2,7,37,28,9,34,59,92,0,DF,30-34,Defender,Italy,Europe
416380,Ragnar Ache,GER,Eint Frankfurt,Bundesliga,2021,23.0,1998.0,2.9,2,0,0,1,1,1,4,25.0,3,3,0,3,0,2,1,0,"MF,FW",20-24,Midfielder,Germany,Europe
125614,Sargis Adamyan,ARM,Hoffenheim,Bundesliga,2021,28.0,1993.0,3.7,8,6,3,4,1,3,11,27.3,8,4,0,4,1,9,2,0,"FW,MF",25-29,Forward,Armenia,Asia
532776,Amine Adli,MAR,Leverkusen,Bundesliga,2021,21.0,2000.0,14.0,27,14,10,14,3,8,15,53.3,7,26,2,24,11,38,12,0,"FW,MF",20-24,Forward,Morocco,Africa
395236,Yacine Adli,FRA,Bordeaux,Ligue 1,2021,21.0,2000.0,25.1,43,27,22,14,7,19,68,27.9,49,33,3,30,37,80,11,2,"MF,FW",20-24,Midfielder,France,Europe
872380,Felix Afena-Gyan,GHA,Roma,Serie A,2021,18.0,2003.0,7.4,10,3,1,6,3,4,7,57.1,3,4,0,4,3,13,0,0,"FW,MF",Under 20,Forward,Ghana,Africa
587458,Kevin Agudelo,COL,Spezia,Serie A,2021,22.0,1998.0,13.7,44,26,13,26,5,7,20,35.0,13,22,0,22,8,52,6,0,"MF,FW",20-24,Midfielder,Colombia,South America
361914,Nayef Aguerd,MAR,Rennes,Ligue 1,2021,25.0,1996.0,30.4,27,18,16,11,0,14,24,58.3,10,24,14,10,24,51,127,1,DF,25-29,Defender,Morocco,Africa
203746,Ruben Aguilar,FRA,Monaco,Ligue 1,2021,28.0,1993.0,23.8,78,53,39,32,7,43,68,63.2,25,19,4,15,44,122,57,0,DF,25-29,Defender,France,Europe
178313,Jean-Eudes Aholou,CIV,Strasbourg,Ligue 1,2021,27.0,1994.0,11.2,16,9,4,9,3,5,19,26.3,14,8,1,7,19,35,7,0,MF,25-29,Midfielder,Ivory Coast,Africa
358250,Joseph Aidoo,GHA,Celta Vigo,La Liga,2021,25.0,1995.0,29.3,39,26,28,10,1,17,31,54.8,14,23,13,10,38,77,96,3,DF,25-29,Defender,Ghana,Africa
236490,Ola Aina,NGA,Torino,Serie A,2021,24.0,1996.0,16.0,27,19,11,10,6,15,23,65.2,8,17,3,14,28,55,30,0,DF,20-24,Defender,Nigeria,Africa
283994,Ludovic Ajorque,FRA,Strasbourg,Ligue 1,2021,27.0,1994.0,30.4,36,25,5,19,12,7,40,17.5,33,28,3,25,8,44,31,1,FW,25-29,Forward,France,Europe
225015,Carlos Akapo,EQG,Cdiz,La Liga,2021,28.0,1993.0,20.5,43,31,26,15,2,21,37,56.8,16,26,7,19,51,94,61,0,DF,25-29,Defender,Equatorial Guinea,Africa
177476,Nathan Ak,NED,Manchester City,Premier League,2021,26.0,1995.0,10.3,16,9,7,8,1,6,8,75.0,2,7,5,2,8,24,23,0,DF,25-29,Defender,Netherlands,Europe
160241,Kevin Akpoguma,NGA,Hoffenheim,Bundesliga,2021,26.0,1995.0,17.0,33,19,16,11,6,16,28,57.1,12,32,2,30,20,53,29,2,"DF,FW",25-29,Defender,Nigeria,Africa
59016,David Alaba,AUT,Real Madrid,La Liga,2021,29.0,1992.0,29.4,23,13,15,6,2,9,19,47.4,10,26,15,11,22,45,70,1,DF,25-29,Defender,Austria,Europe
454238,Toms Alarcn,CHI,Cdiz,La Liga,2021,22.0,1999.0,15.8,31,20,17,10,4,10,31,32.3,21,19,7,12,30,61,31,0,MF,20-24,Midfielder,Chile,South America
193782,Lucas Alario,ARG,Leverkusen,Bundesliga,2021,28.0,1992.0,7.3,6,5,0,2,4,2,5,40.0,3,5,0,5,1,7,6,0,FW,25-29,Forward,Argentina,South America
353032,Omar Alderete,PAR,Valencia,La Liga,2021,24.0,1996.0,26.7,53,34,34,17,2,34,53,64.2,19,30,18,12,35,88,153,0,DF,20-24,Defender,Paraguay,South America
314353,Trent Alexander-Arnold,ENG,Liverpool,Premier League,2021,22.0,1998.0,31.7,40,23,19,13,8,27,60,45.0,33,22,4,18,43,83,40,0,DF,20-24,Defender,England,Europe
385271,Allan,BRA,Everton,Premier League,2021,30.0,1991.0,24.3,74,44,28,39,7,34,105,32.4,71,40,9,31,23,97,39,1,MF,30-34,Midfielder,Brazil,South America
646733,Jim Allevinah,GAB,Clermont Foot,Ligue 1,2021,26.0,1995.0,16.5,18,13,8,8,2,5,18,27.8,13,11,0,11,6,24,4,0,FW,25-29,Forward,Gabon,Africa
354909,Giorgio Altare,ITA,Cagliari,Serie A,2021,22.0,1998.0,16.3,39,28,18,18,3,21,26,80.8,5,17,5,12,30,69,70,0,DF,20-24,Defender,Italy,Europe
15951,Dani Alves,BRA,Barcelona,La Liga,2021,38.0,1983.0,12.2,30,19,13,13,4,14,26,53.8,12,10,3,7,11,41,10,2,DF,35-39,Defender,Brazil,South America
476237,Steven Alzate,COL,Brighton,Premier League,2021,22.0,1998.0,4.5,10,4,4,5,1,4,7,57.1,3,2,1,1,10,20,10,0,MF,20-24,Midfielder,Colombia,South America
205503,Ibrahim Amadou,FRA,Metz,Ligue 1,2021,28.0,1993.0,9.0,16,8,10,6,0,8,15,53.3,7,4,2,2,14,30,26,0,"DF,MF",25-29,Defender,France,Europe
344072,Kelvin Amian,FRA,Spezia,Serie A,2021,23.0,1998.0,29.4,66,42,43,18,5,30,41,73.2,11,39,21,18,32,98,75,0,DF,20-24,Defender,France,Europe
232454,Nadiem Amiri,GER,Genoa,Serie A,2021,24.0,1996.0,7.6,6,4,2,2,2,2,9,22.2,7,7,0,7,0,6,0,0,"MF,FW",20-24,Midfielder,Germany,Europe
392771,Ethan Ampadu,WAL,Venezia,Serie A,2021,20.0,2000.0,25.4,67,43,37,27,3,24,58,41.4,34,49,19,30,51,118,76,0,"MF,DF",20-24,Midfielder,Wales,Europe
260827,Joachim Andersen,DEN,Crystal Palace,Premier League,2021,25.0,1996.0,32.4,30,23,21,9,0,16,27,59.3,11,29,19,10,37,67,125,3,DF,25-29,Defender,Denmark,Europe
159372,Felipe Anderson,BRA,Lazio,Serie A,2021,28.0,1993.0,32.1,71,45,30,33,8,27,99,27.3,72,65,6,59,20,91,16,0,FW,25-29,Forward,Brazil,South America
147573,Sebastian Andersson,SWE,Kln,Bundesliga,2021,30.0,1991.0,14.0,11,7,0,3,8,3,9,33.3,6,8,0,8,3,14,14,0,FW,30-34,Forward,Sweden,Europe
177065,Florin Andone,ROU,Cdiz,La Liga,2021,28.0,1993.0,2.0,1,1,1,0,0,0,1,0.0,1,2,0,2,0,1,1,0,FW,25-29,Forward,Romania,Europe
84301,Benjamin Andr,FRA,Lille,Ligue 1,2021,30.0,1990.0,30.6,123,69,49,65,9,51,113,45.1,62,49,11,38,50,173,56,0,MF,30-34,Midfielder,France,Europe
55854,Cristian Ansaldi,ARG,Torino,Serie A,2021,34.0,1986.0,7.7,20,9,11,7,2,10,13,76.9,3,9,1,8,6,26,10,0,DF,30-34,Defender,Argentina,South America
538974,Janis Antiste,FRA,Spezia,Serie A,2021,18.0,2002.0,8.8,18,11,6,6,6,5,13,38.5,8,7,1,6,4,22,6,0,FW,Under 20,Forward,France,Europe
193004,Waldemar Anton,GER,Stuttgart,Bundesliga,2021,25.0,1996.0,28.8,40,26,22,15,3,19,32,59.4,13,27,16,11,32,72,116,1,DF,25-29,Defender,Germany,Europe
289182,Christopher Antwi-Adjei,GHA,Bochum,Bundesliga,2021,27.0,1994.0,12.6,21,18,7,8,6,6,26,23.1,20,12,0,12,1,22,8,0,"FW,MF",25-29,Forward,Ghana,Africa
395693,Houssem Aouar,ALG,Lyon,Ligue 1,2021,23.0,1998.0,27.8,46,30,9,25,12,27,54,50.0,27,26,1,25,20,66,5,0,"MF,FW",20-24,Midfielder,Algeria,Africa
569385,Adil Aouchiche,FRA,Saint-tienne,Ligue 1,2021,19.0,2002.0,12.0,13,6,5,5,3,5,33,15.2,28,18,1,17,17,30,4,0,"MF,FW",Under 20,Midfielder,France,Europe
89701,Charles Arnguiz,CHI,Leverkusen,Bundesliga,2021,32.0,1989.0,17.5,45,25,18,21,6,22,52,42.3,30,24,4,20,33,78,21,0,MF,30-34,Midfielder,Chile,South America
120443,Santiago Arias,COL,Granada,La Liga,2021,29.0,1992.0,4.9,12,5,8,3,1,4,9,44.4,5,8,4,4,5,17,10,0,DF,25-29,Defender,Colombia,South America
250426,Adam Armstrong,ENG,Southampton,Premier League,2021,24.0,1997.0,15.7,10,4,2,2,6,0,6,0.0,6,13,1,12,3,13,6,0,FW,20-24,Forward,England,Europe
130765,Stuart Armstrong,SCO,Southampton,Premier League,2021,29.0,1992.0,16.4,27,19,15,6,6,9,23,39.1,14,10,1,9,8,35,15,0,MF,25-29,Midfielder,Scotland,Europe
53536,Tolgay Arslan,GER,Udinese,Serie A,2021,30.0,1990.0,18.4,35,20,15,16,4,19,50,38.0,31,17,4,13,13,48,23,1,MF,30-34,Midfielder,Germany,Europe
520947,Santiago Arzamendia,PAR,Cdiz,La Liga,2021,23.0,1998.0,5.2,14,6,6,5,3,6,13,46.2,7,6,0,6,4,18,7,0,MF,20-24,Midfielder,Paraguay,South America
245744,Takuma Asano,JPN,Bochum,Bundesliga,2021,26.0,1994.0,17.9,11,6,3,6,2,5,19,26.3,14,14,1,13,7,18,7,0,"FW,MF",25-29,Forward,Japan,Asia
423436,Santiago Ascacbar,ARG,Hertha BSC,Bundesliga,2021,24.0,1997.0,26.4,93,54,50,37,6,38,89,42.7,51,31,6,25,41,134,42,0,MF,20-24,Midfielder,Argentina,South America
543771,Kristjan Asllani,ALB,Empoli,Serie A,2021,19.0,2002.0,15.0,18,9,9,8,1,11,29,37.9,18,16,7,9,19,37,15,1,MF,Under 20,Midfielder,Albania,Europe
58864,Pierre-Emerick Aubameyang,GAB,Arsenal,Premier League,2021,32.0,1989.0,11.5,11,5,6,4,1,3,10,30.0,7,12,1,11,0,11,4,0,FW,30-34,Forward,Gabon,Africa
284595,Tommaso Augello,ITA,Sampdoria,Serie A,2021,26.0,1994.0,26.6,36,20,22,8,6,17,29,58.6,12,19,4,15,29,65,68,1,DF,25-29,Defender,Italy,Europe
127032,Serge Aurier,CIV,Villarreal,La Liga,2021,28.0,1992.0,11.2,14,9,11,2,1,4,7,57.1,3,14,7,7,11,25,25,0,DF,25-29,Defender,Ivory Coast,Africa
295313,Taiwo Awoniyi,NGA,Union Berlin,Bundesliga,2021,23.0,1997.0,24.2,11,7,3,6,2,1,9,11.1,8,11,2,9,2,13,29,0,FW,20-24,Forward,Nigeria,Africa
108354,Jordan Ayew,GHA,Crystal Palace,Premier League,2021,29.0,1991.0,22.4,47,30,20,20,7,17,31,54.8,14,33,3,30,15,62,15,0,FW,25-29,Forward,Ghana,Africa
67420,Luke Ayling,ENG,Leeds United,Premier League,2021,29.0,1991.0,25.2,74,42,46,23,5,51,97,52.6,46,46,25,21,28,102,52,1,DF,25-29,Defender,England,Europe
275361,Karim Azamoum,FRA,Troyes,Ligue 1,2021,31.0,1990.0,4.3,6,5,4,2,0,3,5,60.0,2,4,2,2,1,7,10,0,DF,30-34,Defender,France,Europe
180337,Sardar Azmoun,IRN,Leverkusen,Bundesliga,2021,26.0,1995.0,4.0,3,1,0,2,1,0,5,0.0,5,2,0,2,0,3,8,0,"FW,MF",25-29,Forward,Iran,Asia
442805,Iddrisu Baba,GHA,Mallorca,La Liga,2021,25.0,1996.0,21.5,57,30,31,23,3,25,43,58.1,18,19,5,14,24,81,34,1,MF,25-29,Midfielder,Ghana,Africa
119235,Carlos Bacca,COL,Granada,La Liga,2021,34.0,1986.0,5.7,4,4,2,0,2,0,3,0.0,3,5,0,5,1,5,5,0,FW,30-34,Forward,Colombia,South America
463603,Benot Badiashile,FRA,Monaco,Ligue 1,2021,20.0,2001.0,20.4,36,19,21,15,0,14,23,60.9,9,18,12,6,28,64,68,1,DF,20-24,Defender,France,Europe
387626,Leon Bailey,JAM,Aston Villa,Premier League,2021,23.0,1997.0,8.5,17,11,6,8,3,6,13,46.2,7,10,1,9,1,18,2,0,"FW,MF",20-24,Forward,Jamaica,North America
127048,Cdric Bakambu,COD,Marseille,Ligue 1,2021,30.0,1991.0,4.0,2,0,1,0,1,0,3,0.0,3,2,0,2,0,2,1,0,FW,30-34,Forward,DR Congo,Africa
540664,Dilane Bakwa,FRA,Bordeaux,Ligue 1,2021,18.0,2002.0,0.5,1,1,0,1,0,1,2,50.0,1,0,0,0,0,1,1,0,"FW,MF",Under 20,Forward,France,Europe
238752,Keita Bald,SEN,Cagliari,Serie A,2021,26.0,1995.0,13.7,8,4,1,5,2,1,10,10.0,9,6,0,6,4,12,6,0,FW,25-29,Forward,Senegal,Africa
39381,Gareth Bale,WAL,Real Madrid,La Liga,2021,32.0,1989.0,3.1,2,1,1,0,1,1,4,25.0,3,2,0,2,2,4,1,0,FW,30-34,Forward,Wales,Europe
85295,Ivn Balliu,ALB,Rayo Vallecano,La Liga,2021,29.0,1992.0,35.0,45,22,25,11,9,19,31,61.3,12,24,5,19,39,84,64,0,DF,25-29,Defender,Albania,Europe
296422,Fod Ballo-Tour,SEN,Milan,Serie A,2021,24.0,1997.0,5.0,18,14,5,13,0,4,9,44.4,5,6,2,4,3,21,5,0,DF,20-24,Defender,Senegal,Africa
292818,Jonathan Bamba,CIV,Lille,Ligue 1,2021,25.0,1996.0,27.0,30,12,13,9,8,13,36,36.1,23,24,1,23,21,51,10,0,"MF,FW",25-29,Midfielder,Ivory Coast,Africa
183334,Patrick Bamford,ENG,Leeds United,Premier League,2021,27.0,1993.0,6.2,1,0,0,1,0,0,3,0.0,3,8,2,6,2,3,8,0,FW,25-29,Forward,England,Europe
240934,Filippo Bandinelli,ITA,Empoli,Serie A,2021,26.0,1995.0,21.7,33,20,10,17,6,15,31,48.4,16,22,5,17,10,43,37,2,MF,25-29,Midfielder,Italy,Europe
533916,Shandon Baptiste,GRN,Brentford,Premier League,2021,23.0,1998.0,10.1,14,4,9,4,1,6,15,40.0,9,10,0,10,11,25,12,0,MF,20-24,Midfielder,Grenada,North America
295622,Keidi Bare,ALB,Espanyol,La Liga,2021,23.0,1997.0,16.5,27,17,14,12,1,11,31,35.5,20,20,10,10,15,42,26,1,MF,20-24,Midfielder,Albania,Europe
255942,Nicol Barella,ITA,Inter,Serie A,2021,24.0,1997.0,32.4,63,42,17,35,11,29,55,52.7,26,26,2,24,21,84,8,2,MF,20-24,Midfielder,Italy,Europe
131978,Ross Barkley,ENG,Chelsea,Premier League,2021,27.0,1993.0,2.0,0,0,0,0,0,0,1,0.0,1,1,0,1,1,1,0,0,"MF,FW",25-29,Midfielder,England,Europe
315332,Aymen Barkok,MAR,Eint Frankfurt,Bundesliga,2021,23.0,1998.0,1.8,6,2,2,3,1,2,7,28.6,5,4,1,3,5,11,6,0,"MF,DF",20-24,Midfielder,Morocco,Africa
63200,Ashley Barnes,ENG,Burnley,Premier League,2021,31.0,1989.0,9.0,11,2,2,7,2,2,9,22.2,7,8,1,7,2,13,5,0,FW,30-34,Forward,England,Europe
398065,Harvey Barnes,ENG,Leicester City,Premier League,2021,23.0,1997.0,23.3,31,16,9,11,11,7,23,30.4,16,24,1,23,5,36,7,0,"FW,MF",20-24,Forward,England,Europe
486624,Musa Barrow,GAM,Bologna,Serie A,2021,22.0,1998.0,23.7,12,4,4,4,4,6,20,30.0,14,20,1,19,6,18,8,0,"FW,MF",20-24,Forward,Gambia,Africa
506009,Amine Bassi,FRA,Metz,Ligue 1,2021,23.0,1997.0,2.0,6,3,2,3,1,1,3,33.3,2,5,0,5,0,6,0,0,"MF,FW",20-24,Midfielder,France,Europe
315853,Alessandro Bastoni,ITA,Inter,Serie A,2021,22.0,1999.0,25.7,44,25,28,13,3,17,34,50.0,17,22,12,10,35,79,59,1,DF,20-24,Defender,Italy,Europe
257751,Simone Bastoni,ITA,Spezia,Serie A,2021,24.0,1996.0,25.4,52,34,28,17,7,21,65,32.3,44,38,11,27,30,82,31,0,"MF,DF",20-24,Midfielder,Italy,Europe
187491,Timo Baumgartl,GER,Union Berlin,Bundesliga,2021,25.0,1996.0,24.1,59,28,34,21,4,31,47,66.0,16,27,11,16,37,96,58,0,DF,25-29,Defender,Germany,Europe
324278,Christoph Baumgartner,AUT,Hoffenheim,Bundesliga,2021,21.0,1999.0,21.0,28,15,14,7,7,13,32,40.6,19,24,3,21,8,36,16,0,"MF,FW",20-24,Midfielder,Austria,Europe
283001,Noah Joel Sarenren Bazee,NGA,Augsburg,Bundesliga,2021,24.0,1996.0,2.7,5,2,2,2,1,3,4,75.0,1,8,2,6,1,6,4,0,"MF,FW",20-24,Midfielder,Nigeria,Africa
153427,Beb,CPV,Rayo Vallecano,La Liga,2021,31.0,1990.0,9.6,6,5,1,3,2,4,16,25.0,12,18,0,18,3,9,6,0,FW,30-34,Forward,Cape Verde,Africa
188888,Sheraldo Becker,SUR,Union Berlin,Bundesliga,2021,26.0,1995.0,19.5,9,6,3,4,2,6,18,33.3,12,11,0,11,2,11,4,0,"FW,MF",25-29,Forward,Suriname,South America
288255,Donny van de Beek,NED,Manchester Utd,Premier League,2021,24.0,1997.0,0.8,6,4,4,1,1,1,2,50.0,1,5,1,4,2,8,1,0,MF,20-24,Midfielder,Netherlands,Europe
117432,Kevin Behrens,GER,Union Berlin,Bundesliga,2021,30.0,1991.0,5.5,3,2,1,1,1,0,4,0.0,4,3,0,3,3,6,7,0,FW,30-34,Forward,Germany,Europe
175014,Youcef Belali,ALG,Brest,Ligue 1,2021,29.0,1992.0,9.2,2,1,0,0,2,2,9,22.2,7,5,1,4,7,9,4,0,"MF,FW",25-29,Midfielder,Algeria,Africa
111039,Ishak Belfodil,ALG,Hertha BSC,Bundesliga,2021,29.0,1992.0,18.2,9,6,4,4,1,4,8,50.0,4,9,1,8,5,14,16,0,FW,25-29,Forward,Algeria,Africa
138055,Haris Belkebla,ALG,Brest,Ligue 1,2021,27.0,1994.0,25.7,46,23,21,21,4,18,39,46.2,21,26,6,20,48,94,30,1,MF,25-29,Midfielder,Algeria,Africa
82350,Stefan Bell,GER,Mainz 05,Bundesliga,2021,29.0,1991.0,31.8,54,23,37,16,1,30,63,47.6,33,26,15,11,41,95,112,1,DF,25-29,Defender,Germany,Europe
61087,Karim Bellarabi,GER,Leverkusen,Bundesliga,2021,31.0,1990.0,7.6,9,4,4,4,1,3,13,23.1,10,5,0,5,9,18,4,0,"FW,MF",30-34,Forward,Germany,Europe
450050,Jean-Ricner Bellegarde,FRA,Strasbourg,Ligue 1,2021,23.0,1998.0,25.9,51,32,21,21,9,17,41,41.5,24,29,4,25,27,78,19,0,MF,20-24,Midfielder,France,Europe
581678,Jude Bellingham,ENG,Dortmund,Bundesliga,2021,18.0,2003.0,31.0,52,34,15,31,6,21,53,39.6,32,50,4,46,42,94,32,0,MF,Under 20,Midfielder,England,Europe
18900,Hatem Ben Arfa,FRA,Lille,Ligue 1,2021,34.0,1987.0,3.5,4,2,2,1,1,2,4,50.0,2,3,0,3,0,4,1,0,"FW,MF",30-34,Forward,France,Europe
146854,Wissam Ben Yedder,FRA,Monaco,Ligue 1,2021,30.0,1990.0,28.1,18,8,1,11,6,6,15,40.0,9,12,1,11,0,18,1,0,FW,30-34,Forward,France,Europe
351816,Ismal Bennacer,ALG,Milan,Serie A,2021,23.0,1997.0,16.9,44,30,22,15,7,21,50,42.0,29,20,4,16,25,69,15,0,MF,20-24,Midfielder,Algeria,Africa
290532,Sad Benrahma,ALG,West Ham,Premier League,2021,25.0,1995.0,24.1,28,17,16,9,3,15,38,39.5,23,17,1,16,9,37,8,0,"FW,MF",25-29,Forward,Algeria,Africa
284732,Ramy Bensebaini,ALG,Gladbach,Bundesliga,2021,26.0,1995.0,22.4,42,30,24,15,3,27,44,61.4,17,33,7,26,39,81,77,1,DF,25-29,Defender,Algeria,Africa
245537,Nabil Bentaleb,ALG,Angers,Ligue 1,2021,26.0,1994.0,16.8,42,24,15,20,7,16,29,55.2,13,24,9,15,28,70,13,0,MF,25-29,Midfielder,Algeria,Africa
50201,Christian Benteke,BEL,Crystal Palace,Premier League,2021,30.0,1990.0,12.7,3,2,1,2,0,2,6,33.3,4,7,3,4,2,5,33,0,FW,30-34,Forward,Belgium,Europe
18922,Karim Benzema,FRA,Real Madrid,La Liga,2021,33.0,1987.0,28.8,11,9,5,3,3,2,9,22.2,7,10,0,10,4,15,13,0,FW,30-34,Forward,France,Europe
177843,Domenico Berardi,ITA,Sassuolo,Serie A,2021,26.0,1994.0,31.3,32,19,9,16,7,15,57,26.3,42,39,2,37,31,63,23,0,FW,25-29,Forward,Italy,Europe
197300,Federico Bernardeschi,ITA,Juventus,Serie A,2021,27.0,1994.0,16.4,16,10,7,4,5,6,13,46.2,7,12,4,8,5,21,15,0,"MF,FW",25-29,Midfielder,Italy,Europe
306191,Jason Berthomier,FRA,Clermont Foot,Ligue 1,2021,31.0,1990.0,19.2,29,14,5,17,7,12,34,35.3,22,14,2,12,8,37,4,1,MF,30-34,Midfielder,France,Europe
140757,Daniel Bessa,ITA,Hellas Verona,Serie A,2021,28.0,1993.0,8.5,7,2,3,3,1,4,15,26.7,11,13,3,10,5,12,11,0,MF,25-29,Midfielder,Italy,Europe
595809,Beto,GNB,Udinese,Serie A,2021,23.0,1998.0,24.1,21,6,2,14,5,9,19,47.4,10,16,1,15,5,26,25,1,FW,20-24,Forward,Guinea-Bissau,Africa
649016,El Bilal Tour,MLI,Reims,Ligue 1,2021,19.0,2001.0,13.3,13,6,4,6,3,2,7,28.6,5,10,3,7,6,19,19,0,FW,Under 20,Forward,Mali,Africa
391192,Jean-Claude Billong,CMR,Clermont Foot,Ligue 1,2021,27.0,1993.0,10.9,17,8,14,1,2,8,11,72.7,3,9,1,8,10,27,35,0,DF,25-29,Defender,Cameroon,Africa
124555,Cristiano Biraghi,ITA,Fiorentina,Serie A,2021,28.0,1992.0,35.0,37,24,17,15,5,22,53,41.5,31,28,10,18,19,56,31,1,DF,25-29,Defender,Italy,Europe
410425,Yves Bissouma,MLI,Brighton,Premier League,2021,24.0,1996.0,23.5,76,49,35,37,4,21,37,56.8,16,33,3,30,50,126,49,0,MF,20-24,Midfielder,Mali,Africa
288225,Ludovic Blas,FRA,Nantes,Ligue 1,2021,23.0,1997.0,32.9,33,18,7,20,6,15,44,34.1,29,33,3,30,31,64,6,1,"MF,FW",20-24,Midfielder,France,Europe
41541,Danny Blum,GER,Bochum,Bundesliga,2021,30.0,1991.0,3.8,2,1,0,0,2,0,2,0.0,2,4,0,4,2,4,1,0,FW,30-34,Forward,Germany,Europe
412932,Myron Boadu,NED,Monaco,Ligue 1,2021,20.0,2001.0,10.7,9,7,2,3,4,1,5,20.0,4,6,0,6,2,11,1,0,FW,20-24,Forward,Netherlands,Europe
26485,Jrme Boateng,GER,Lyon,Ligue 1,2021,32.0,1988.0,18.0,20,15,11,9,0,9,17,52.9,8,20,10,10,20,40,73,0,DF,30-34,Defender,Germany,Europe
16922,Kevin-Prince Boateng,GHA,Hertha BSC,Bundesliga,2021,34.0,1987.0,7.7,6,5,1,4,1,3,9,33.3,6,7,2,5,6,12,11,0,"MF,FW",30-34,Midfielder,Ghana,Africa
186477,Herbert Bockhorn,GER,Bochum,Bundesliga,2021,26.0,1995.0,9.4,20,14,13,4,3,12,20,60.0,8,10,1,9,14,34,18,0,DF,25-29,Defender,Germany,Europe
182574,Jean-Paul Botius,NED,Mainz 05,Bundesliga,2021,27.0,1994.0,20.0,40,23,18,17,5,22,53,41.5,31,41,3,38,25,65,11,0,MF,25-29,Midfielder,Netherlands,Europe
412671,Quentin Boisgard,FRA,Lorient,Ligue 1,2021,24.0,1997.0,10.6,19,11,6,10,3,8,17,47.1,9,15,0,15,6,25,5,0,"MF,FW",20-24,Midfielder,France,Europe
142310,Willy Boly,CIV,Wolves,Premier League,2021,30.0,1991.0,10.0,25,19,18,7,0,8,15,53.3,7,14,6,8,14,39,35,0,DF,30-34,Defender,Ivory Coast,Africa
57280,Giacomo Bonaventura,ITA,Fiorentina,Serie A,2021,31.0,1989.0,25.2,33,17,12,16,5,21,46,45.7,25,20,2,18,14,47,9,1,MF,30-34,Midfielder,Italy,Europe
241527,Federico Bonazzoli,ITA,Salernitana,Serie A,2021,24.0,1997.0,20.7,24,12,9,8,7,6,25,24.0,19,17,1,16,6,30,7,0,"FW,MF",20-24,Forward,Italy,Europe
338629,Sebastiaan Bornauw,BEL,Wolfsburg,Bundesliga,2021,22.0,1999.0,22.3,30,19,23,5,2,16,25,64.0,9,29,8,21,42,72,97,1,DF,20-24,Defender,Belgium,Europe
323831,Rafael Borr,COL,Eint Frankfurt,Bundesliga,2021,25.0,1995.0,26.4,31,22,4,13,14,7,33,21.2,26,24,4,20,5,36,9,0,FW,25-29,Forward,Colombia,South America
361093,Sven Botman,NED,Lille,Ligue 1,2021,21.0,2000.0,25.0,24,11,13,11,0,12,18,66.7,6,32,21,11,26,50,116,0,DF,20-24,Defender,Netherlands,Europe
236045,Denis Bouanga,GAB,Saint-tienne,Ligue 1,2021,26.0,1994.0,27.1,46,25,14,13,19,22,63,34.9,41,30,0,30,8,54,34,1,"FW,MF",25-29,Forward,Gabon,Africa
560593,Hicham Boudaoui,ALG,Nice,Ligue 1,2021,21.0,1999.0,18.0,31,18,15,10,6,13,36,36.1,23,17,4,13,18,49,15,0,MF,20-24,Midfielder,Algeria,Africa
77826,Ryad Boudebouz,ALG,Saint-tienne,Ligue 1,2021,31.0,1990.0,25.0,27,15,11,12,4,12,29,41.4,17,17,2,15,10,37,5,0,"MF,FW",30-34,Midfielder,Algeria,Africa
202318,Farid Boulaya,ALG,Metz,Ligue 1,2021,28.0,1993.0,17.0,18,10,7,9,2,14,38,36.8,24,8,2,6,12,30,5,0,"MF,FW",25-29,Midfielder,Algeria,Africa
266359,Benjamin Bourigeaud,FRA,Rennes,Ligue 1,2021,27.0,1994.0,35.5,46,24,16,18,12,24,67,35.8,43,33,3,30,30,76,44,0,"FW,MF",25-29,Forward,France,Europe
562049,Edoardo Bove,ITA,Roma,Serie A,2021,19.0,2002.0,0.8,1,1,1,0,0,0,2,0.0,2,1,0,1,1,2,0,0,"MF,DF",Under 20,Midfielder,Italy,Europe
314875,Jarrod Bowen,ENG,West Ham,Premier League,2021,24.0,1996.0,33.1,36,20,20,11,5,17,44,38.6,27,29,2,27,21,57,14,0,FW,20-24,Forward,England,Europe
334222,Lucas Boy,ARG,Elche,La Liga,2021,25.0,1996.0,19.0,27,13,5,15,7,9,24,37.5,15,24,1,23,2,29,23,0,FW,25-29,Forward,Argentina,South America
187492,Julian Brandt,GER,Dortmund,Bundesliga,2021,25.0,1996.0,23.1,37,19,13,20,4,17,54,31.5,37,19,2,17,24,61,14,1,"MF,FW",25-29,Midfielder,Germany,Europe
661053,Jarrad Branthwaite,ENG,Everton,Premier League,2021,19.0,2002.0,4.3,4,1,3,1,0,3,8,37.5,5,3,2,1,1,5,20,0,DF,Under 20,Defender,England,Europe
485960,Lilian Brassier,FRA,Brest,Ligue 1,2021,21.0,1999.0,25.1,40,24,23,13,4,10,21,47.6,11,31,21,10,32,72,86,0,DF,20-24,Defender,France,Europe
18909,Jimmy Briand,FRA,Bordeaux,Ligue 1,2021,35.0,1985.0,2.5,2,0,2,0,0,0,2,0.0,2,0,0,0,1,3,2,0,"FW,MF",35-39,Forward,France,Europe
571743,Armando Broja,ALB,Southampton,Premier League,2021,19.0,2001.0,21.9,12,5,2,7,3,2,9,22.2,7,17,1,16,3,15,11,0,FW,Under 20,Forward,Albania,Europe
450417,Dylan Bronn,TUN,Metz,Ligue 1,2021,26.0,1995.0,28.3,47,29,33,13,1,20,31,64.5,11,32,19,13,40,87,78,1,DF,25-29,Defender,Tunisia,Africa
124732,John Brooks,USA,Wolfsburg,Bundesliga,2021,28.0,1993.0,29.1,47,25,25,18,4,36,60,60.0,24,33,19,14,41,88,125,1,DF,25-29,Defender,United States,North America
293569,Josh Brownhill,ENG,Burnley,Premier League,2021,25.0,1995.0,32.8,73,37,25,42,6,21,53,39.6,32,37,12,25,68,141,42,1,MF,25-29,Midfielder,England,Europe
293281,Jacob Bruun Larsen,DEN,Hoffenheim,Bundesliga,2021,22.0,1998.0,9.0,2,1,1,1,0,0,5,0.0,5,14,3,11,5,7,5,2,"FW,MF",20-24,Forward,Denmark,Europe
46413,Ante Budimir,CRO,Osasuna,La Liga,2021,30.0,1991.0,19.3,24,10,3,15,6,6,19,31.6,13,22,4,18,3,27,16,0,FW,30-34,Forward,Croatia,Europe
548650,Osman Bukari,GHA,Nantes,Ligue 1,2021,22.0,1998.0,11.2,18,8,7,6,5,8,22,36.4,14,8,0,8,8,26,1,0,"FW,MF",20-24,Forward,Ghana,Africa
386446,Alessandro Buongiorno,ITA,Torino,Serie A,2021,22.0,1999.0,13.1,20,9,9,8,3,9,13,69.2,4,12,6,6,31,51,44,0,DF,20-24,Defender,Italy,Europe
333647,Jonathan Burkardt,GER,Mainz 05,Bundesliga,2021,21.0,2000.0,29.0,17,8,0,10,7,6,25,24.0,19,31,5,26,8,25,16,0,"FW,MF",20-24,Forward,Germany,Europe
504209,Gianluca Busio,USA,Venezia,Serie A,2021,19.0,2002.0,21.7,53,28,27,20,6,28,63,44.4,35,45,13,32,21,74,30,1,MF,Under 20,Midfielder,United States,North America
236953,Sam Byram,ENG,Norwich City,Premier League,2021,27.0,1993.0,11.4,24,15,17,6,1,19,27,70.4,8,21,11,10,22,46,48,0,DF,25-29,Defender,England,Europe
206912,Jimmy Cabot,FRA,Angers,Ligue 1,2021,27.0,1994.0,22.3,81,44,59,15,7,47,83,56.6,36,29,0,29,32,113,30,0,DF,25-29,Defender,France,Europe
102423,Leandro Cabrera,URU,Espanyol,La Liga,2021,30.0,1991.0,37.0,37,24,27,10,0,21,34,61.8,13,32,23,9,44,81,222,2,DF,30-34,Defender,Uruguay,South America
453016,Anthony Caci,FRA,Strasbourg,Ligue 1,2021,24.0,1997.0,26.6,65,34,35,24,6,33,55,60.0,22,22,3,19,33,98,49,1,DF,20-24,Defender,France,Europe
687626,Moiss Caicedo,ECU,Brighton,Premier League,2021,19.0,2001.0,7.3,16,10,7,7,2,5,12,41.7,7,18,4,14,10,26,7,0,MF,Under 20,Midfielder,Ecuador,South America
468066,Jens Cajuste,SWE,Reims,Ligue 1,2021,21.0,1999.0,4.0,10,6,6,2,2,6,17,35.3,11,7,2,5,5,15,6,0,"MF,FW",20-24,Midfielder,Sweden,Europe
262523,Davide Calabria,ITA,Milan,Serie A,2021,24.0,1996.0,23.5,62,37,31,23,8,37,72,51.4,35,25,5,20,23,85,40,1,DF,20-24,Defender,Italy,Europe
126414,Hakan alhanolu,TUR,Inter,Serie A,2021,27.0,1994.0,27.6,41,23,16,19,6,11,40,27.5,29,29,5,24,25,66,12,0,MF,25-29,Midfielder,Turkey,Asia
38410,Daniel Caligiuri,ITA,Augsburg,Bundesliga,2021,33.0,1988.0,22.3,46,30,17,26,3,27,72,37.5,45,36,5,31,18,64,33,0,"DF,MF",30-34,Defender,Italy,Europe
306024,Dominic Calvert-Lewin,ENG,Everton,Premier League,2021,24.0,1997.0,14.3,11,8,1,6,4,3,8,37.5,5,5,2,3,3,14,12,0,FW,20-24,Forward,England,Europe
459658,Andrea Cambiaso,ITA,Genoa,Serie A,2021,21.0,2000.0,19.9,46,20,28,14,4,18,32,56.3,14,33,8,25,23,69,37,1,DF,20-24,Defender,Italy,Europe
119296,Emre Can,GER,Dortmund,Bundesliga,2021,27.0,1994.0,18.8,36,22,20,16,0,15,30,50.0,15,26,10,16,36,72,40,2,"DF,MF",25-29,Defender,Germany,Europe
182712,Joo Cancelo,POR,Manchester City,Premier League,2021,27.0,1994.0,35.9,83,54,33,35,15,46,91,50.5,45,25,3,22,59,142,45,1,DF,25-29,Defender,Portugal,Europe
520530,Fali Cand,GNB,Metz,Ligue 1,2021,23.0,1998.0,10.8,30,18,13,15,2,13,31,41.9,18,11,2,9,6,36,21,0,DF,20-24,Defender,Guinea-Bissau,Africa
25488,Antonio Candreva,ITA,Sampdoria,Serie A,2021,34.0,1987.0,34.7,27,16,9,11,7,19,55,34.5,36,23,2,21,33,60,19,0,"MF,FW",30-34,Midfielder,Italy,Europe
214532,Pierrick Capelle,FRA,Angers,Ligue 1,2021,34.0,1987.0,13.3,36,24,16,17,3,18,52,34.6,34,12,1,11,16,52,20,0,"MF,DF",30-34,Midfielder,France,Europe
63494,tienne Capoue,FRA,Villarreal,La Liga,2021,33.0,1988.0,25.4,44,26,18,23,3,15,28,53.6,13,17,5,12,35,79,51,0,MF,30-34,Midfielder,France,Europe
146752,Gianluca Caprari,ITA,Hellas Verona,Serie A,2021,28.0,1993.0,30.4,43,25,10,22,11,17,51,33.3,34,32,0,32,4,47,7,0,"MF,FW",25-29,Midfielder,Italy,Europe
481834,Andrea Carboni,ITA,Cagliari,Serie A,2021,20.0,2001.0,24.6,53,24,33,16,4,19,42,45.2,23,42,15,27,27,80,87,0,DF,20-24,Defender,Italy,Europe
342226,Irvin Cardona,FRA,Brest,Ligue 1,2021,23.0,1997.0,14.8,13,7,5,4,4,3,16,18.8,13,10,0,10,5,18,17,0,"FW,MF",20-24,Forward,France,Europe
140776,Yannick Carrasco,BEL,Atltico Madrid,La Liga,2021,27.0,1993.0,28.7,34,19,16,12,6,19,44,43.2,25,26,5,21,19,53,12,2,"FW,MF",25-29,Forward,Belgium,Europe
184672,Guido Carrillo,ARG,Elche,La Liga,2021,30.0,1991.0,13.0,7,4,2,4,1,3,13,23.1,10,9,2,7,1,8,27,0,FW,30-34,Forward,Argentina,South America
100131,William Carvalho,POR,Betis,La Liga,2021,29.0,1992.0,20.1,49,33,20,25,4,15,40,37.5,25,18,7,11,16,65,20,0,MF,25-29,Midfielder,Portugal,Europe
16306,Casemiro,BRA,Real Madrid,La Liga,2021,29.0,1992.0,28.5,79,51,45,30,4,30,67,44.8,37,65,19,46,38,117,65,3,MF,25-29,Midfielder,Brazil,South America
262226,Timothy Castagne,BEL,Leicester City,Premier League,2021,25.0,1995.0,23.6,67,31,38,22,7,27,43,62.8,16,28,9,19,29,96,54,1,DF,25-29,Defender,Belgium,Europe
182875,Jean-Charles Castelletto,CMR,Nantes,Ligue 1,2021,26.0,1995.0,27.9,45,24,27,17,1,25,35,71.4,10,38,27,11,30,75,73,0,DF,25-29,Defender,Cameroon,Africa
28947,Gonzalo Castro,GER,Arminia,Bundesliga,2021,34.0,1987.0,4.8,8,3,4,4,0,1,5,20.0,4,3,0,3,3,11,3,0,"MF,FW",30-34,Midfielder,Germany,Europe
303116,Gaetano Castrovilli,ITA,Fiorentina,Serie A,2021,24.0,1997.0,15.5,25,17,15,6,4,12,23,52.2,11,18,4,14,11,36,6,0,MF,20-24,Midfielder,Italy,Europe
199733,Danilo Cataldi,ITA,Lazio,Serie A,2021,26.0,1994.0,19.0,36,17,15,17,4,12,38,31.6,26,24,12,12,17,53,19,1,MF,25-29,Midfielder,Italy,Europe
48280,Edinson Cavani,URU,Manchester Utd,Premier League,2021,34.0,1987.0,8.5,4,1,0,3,1,2,8,25.0,6,6,0,6,2,6,8,0,FW,30-34,Forward,Uruguay,South America
239099,Pietro Ceccaroni,ITA,Venezia,Serie A,2021,25.0,1995.0,34.7,55,31,33,18,4,25,36,69.4,11,45,32,13,30,85,143,0,DF,25-29,Defender,Italy,Europe
251075,Zeki elik,TUR,Lille,Ligue 1,2021,24.0,1997.0,30.0,64,37,43,17,4,36,63,57.1,27,32,9,23,43,107,62,2,DF,20-24,Defender,Turkey,Asia
384859,Fabien Centonze,FRA,Metz,Ligue 1,2021,25.0,1996.0,17.6,33,21,22,9,2,13,32,40.6,19,37,8,29,32,65,51,0,DF,25-29,Defender,France,Europe
102745,Luca Ceppitelli,ITA,Cagliari,Serie A,2021,31.0,1989.0,16.1,23,12,13,10,0,16,27,59.3,11,21,14,7,25,48,54,0,DF,30-34,Defender,Italy,Europe
341110,Franco Cervi,ARG,Celta Vigo,La Liga,2021,27.0,1994.0,20.0,73,41,35,22,16,33,77,42.9,44,38,2,36,21,94,19,0,MF,25-29,Midfielder,Argentina,South America
346314,Trevoh Chalobah,ENG,Chelsea,Premier League,2021,22.0,1999.0,16.1,40,27,22,18,0,24,31,77.4,7,16,6,10,19,59,43,2,DF,20-24,Defender,England,Europe
508941,Dylan Chambost,FRA,Troyes,Ligue 1,2021,23.0,1997.0,8.4,16,11,6,9,1,4,25,16.0,21,9,2,7,8,24,4,0,"MF,FW",20-24,Midfielder,France,Europe
49723,Timothy Chandler,USA,Eint Frankfurt,Bundesliga,2021,31.0,1990.0,13.5,18,12,10,8,0,11,24,45.8,13,10,3,7,19,37,28,1,DF,30-34,Defender,United States,North America
250779,Brendan Chardonnet,FRA,Brest,Ligue 1,2021,26.0,1994.0,29.8,44,25,32,11,1,29,40,72.5,11,42,29,13,55,99,141,0,DF,25-29,Defender,France,Europe
98322,Denis Cheryshev,RUS,Valencia,La Liga,2021,30.0,1990.0,6.3,14,5,6,1,7,6,15,40.0,9,9,1,8,9,23,9,0,"MF,FW",30-34,Midfielder,Russia,Europe
341092,Federico Chiesa,ITA,Juventus,Serie A,2021,23.0,1997.0,9.6,26,19,9,9,8,12,26,46.2,14,7,0,7,4,30,3,0,"MF,FW",20-24,Midfielder,Italy,Europe
316125,Ben Chilwell,ENG,Chelsea,Premier League,2021,24.0,1996.0,6.0,8,3,2,6,0,2,5,40.0,3,7,0,7,4,12,14,1,DF,20-24,Defender,England,Europe
695454,Chiquinho,POR,Wolves,Premier League,2021,21.0,2000.0,2.3,9,6,4,5,0,4,5,80.0,1,5,0,5,2,11,1,0,"DF,FW",20-24,Defender,Portugal,Europe
624037,Joris Chotard,FRA,Montpellier,Ligue 1,2021,19.0,2001.0,32.6,59,30,33,23,3,36,78,46.2,42,27,15,12,42,101,56,0,MF,Under 20,Midfielder,France,Europe
659459,Carney Chukwuemeka,ENG,Aston Villa,Premier League,2021,17.0,2003.0,3.3,7,1,2,5,0,3,5,60.0,2,3,0,3,1,8,2,1,"MF,FW",Under 20,Midfielder,England,Europe
401922,Samuel Chukwueze,NGA,Villarreal,La Liga,2021,22.0,1999.0,14.8,13,9,6,5,2,3,6,50.0,3,7,0,7,5,18,4,0,"MF,FW",20-24,Midfielder,Nigeria,Africa
525578,Path Ciss,SEN,Rayo Vallecano,La Liga,2021,27.0,1994.0,12.2,31,15,20,8,3,12,26,46.2,14,16,6,10,30,61,27,0,MF,25-29,Midfielder,Senegal,Africa
98240,Ciaran Clark,IRL,Newcastle Utd,Premier League,2021,31.0,1989.0,11.3,13,10,4,7,2,9,14,64.3,5,14,11,3,13,26,43,1,DF,30-34,Defender,Republic of Ireland,Europe
384593,Alexis Claude-Maurice,FRA,Nice,Ligue 1,2021,23.0,1998.0,2.3,2,0,1,0,1,1,4,25.0,3,7,0,7,3,5,1,0,MF,20-24,Midfielder,France,Europe
175639,Jonathan Clauss,FRA,Lens,Ligue 1,2021,28.0,1992.0,33.8,63,34,33,20,10,22,55,40.0,33,43,1,42,73,136,51,0,DF,25-29,Defender,France,Europe
73484,Tom Cleverley,ENG,Watford,Premier League,2021,31.0,1989.0,18.0,37,20,19,17,1,18,33,54.5,15,23,6,17,18,55,19,3,MF,30-34,Midfielder,England,Europe
85177,Nathaniel Clyne,ENG,Crystal Palace,Premier League,2021,30.0,1991.0,15.0,21,10,11,9,1,10,20,50.0,10,7,2,5,15,36,32,0,DF,30-34,Defender,England,Europe
128901,Conor Coady,ENG,Wolves,Premier League,2021,28.0,1993.0,37.3,31,14,23,7,1,16,28,57.1,12,46,40,6,28,59,140,0,DF,25-29,Defender,England,Europe
68390,Samus Coleman,IRL,Everton,Premier League,2021,32.0,1988.0,29.5,61,36,35,16,10,33,51,64.7,18,30,11,19,32,93,80,2,DF,30-34,Defender,Republic of Ireland,Europe
469050,Nathan Collins,IRL,Burnley,Premier League,2021,20.0,2001.0,18.6,37,15,27,8,2,17,27,63.0,10,38,25,13,24,61,83,2,DF,20-24,Defender,Republic of Ireland,Europe
243714,Kingsley Coman,FRA,Bayern Munich,Bundesliga,2021,25.0,1996.0,15.1,14,8,1,9,4,5,16,31.3,11,14,0,14,8,22,5,0,"FW,DF",25-29,Forward,France,Europe
337798,Abdu Cont,POR,Troyes,Ligue 1,2021,23.0,1998.0,15.0,22,12,16,5,1,12,24,50.0,12,12,2,10,4,26,10,0,DF,20-24,Defender,Portugal,Europe
75067,Liam Cooper,SCO,Leeds United,Premier League,2021,29.0,1991.0,20.2,41,23,27,13,1,23,33,69.7,10,29,18,11,43,84,72,2,DF,25-29,Defender,Scotland,Europe
74869,Francis Coquelin,FRA,Villarreal,La Liga,2021,30.0,1991.0,9.2,26,17,9,11,6,11,20,55.0,9,15,5,10,19,45,11,0,MF,30-34,Midfielder,France,Europe
102744,Sbastien Corchia,FRA,Nantes,Ligue 1,2021,30.0,1990.0,14.7,33,20,17,11,5,24,42,57.1,18,24,3,21,13,46,36,0,DF,30-34,Defender,France,Europe
40613,Jack Cork,ENG,Burnley,Premier League,2021,32.0,1989.0,18.6,20,6,6,11,3,7,20,35.0,13,17,4,13,17,37,29,1,MF,30-34,Midfielder,England,Europe
125165,Jess Corona,MEX,Sevilla,La Liga,2021,28.0,1993.0,12.9,12,7,7,5,0,3,6,50.0,3,4,0,4,8,20,6,0,"FW,DF",25-29,Forward,Mexico,North America
266807,ngel Correa,ARG,Atltico Madrid,La Liga,2021,26.0,1995.0,20.6,16,8,5,10,1,7,29,24.1,22,25,2,23,10,26,4,0,"FW,MF",25-29,Forward,Argentina,South America
227081,Joaqun Correa,ARG,Inter,Serie A,2021,26.0,1994.0,11.4,11,5,2,6,3,1,13,7.7,12,8,1,7,3,14,2,0,FW,25-29,Forward,Argentina,South America
367466,Thierry Correia,POR,Valencia,La Liga,2021,22.0,1999.0,15.7,35,23,26,6,3,14,29,48.3,15,20,5,15,19,54,27,0,DF,20-24,Defender,Portugal,Europe
184935,Kalifa Coulibaly,MLI,Nantes,Ligue 1,2021,29.0,1991.0,9.4,5,1,1,1,3,0,4,0.0,4,2,2,0,0,5,11,0,FW,25-29,Forward,Mali,Africa
386552,Lassana Coulibaly,MLI,Salernitana,Serie A,2021,25.0,1996.0,25.9,58,32,29,26,3,24,62,38.7,38,40,13,27,22,80,27,0,MF,25-29,Midfielder,Mali,Africa
618425,Tanguy Coulibaly,FRA,Stuttgart,Bundesliga,2021,20.0,2001.0,12.0,27,15,14,11,2,9,19,47.4,10,14,2,12,4,31,10,0,"FW,MF",20-24,Forward,France,Europe
80444,Philippe Coutinho,BRA,Aston Villa,Premier League,2021,29.0,1992.0,14.8,17,12,4,11,2,6,21,28.6,15,11,1,10,7,24,4,0,"MF,FW",25-29,Midfielder,Brazil,South America
485965,Nicolas Cozza,FRA,Montpellier,Ligue 1,2021,22.0,1999.0,30.8,80,47,50,23,7,35,65,53.8,30,35,19,16,38,118,82,1,DF,20-24,Defender,France,Europe
199248,Bryan Cristante,ITA,Roma,Serie A,2021,26.0,1995.0,29.8,79,39,31,39,9,37,69,53.6,32,31,5,26,40,119,45,0,MF,25-29,Midfielder,Italy,Europe
91970,Juan Cuadrado,COL,Juventus,Serie A,2021,33.0,1988.0,27.6,48,23,30,13,5,30,55,54.5,25,23,5,18,29,77,34,0,"DF,MF",30-34,Defender,Colombia,South America
265078,Patrick Cutrone,ITA,Empoli,Serie A,2021,23.0,1998.0,15.6,5,2,0,3,2,1,9,11.1,8,11,1,10,5,10,1,0,FW,20-24,Forward,Italy,Europe
182889,Wylan Cyprien,FRA,Nantes,Ligue 1,2021,26.0,1995.0,16.6,33,17,12,18,3,13,32,40.6,19,16,6,10,10,43,14,2,MF,25-29,Midfielder,France,Europe
55769,Danilo D'Ambrosio,ITA,Inter,Serie A,2021,32.0,1988.0,11.1,30,15,21,8,1,11,22,50.0,11,21,10,11,8,38,20,0,DF,30-34,Defender,Italy,Europe
495667,Lucas Da Cunha,FRA,Nice,Ligue 1,2021,20.0,2001.0,4.4,13,7,2,7,4,6,11,54.5,5,2,0,2,1,14,2,0,MF,20-24,Midfielder,France,Europe
57370,Damien Da Silva,FRA,Lyon,Ligue 1,2021,33.0,1988.0,12.5,13,9,7,5,1,5,9,55.6,4,15,10,5,22,35,53,1,DF,30-34,Defender,France,Europe
365172,Patson Daka,ZAM,Leicester City,Premier League,2021,22.0,1998.0,12.9,15,10,2,8,5,2,19,10.5,17,7,0,7,2,17,8,0,FW,20-24,Forward,Zambia,Africa
357147,Diogo Dalot,POR,Manchester Utd,Premier League,2021,22.0,1999.0,20.0,55,41,35,12,8,31,57,54.4,26,24,13,11,29,84,59,0,DF,20-24,Defender,Portugal,Europe
808509,Danilo,BRA,Juventus,Serie A,2021,30.0,1991.0,21.0,37,26,20,13,4,18,28,64.3,10,21,12,9,32,69,53,1,"DF,MF",30-34,Defender,Brazil,South America
355861,Arnaut Danjuma,NED,Villarreal,La Liga,2021,24.0,1997.0,16.4,7,6,3,0,4,2,4,50.0,2,5,0,5,2,9,3,0,FW,20-24,Forward,Netherlands,Europe
263236,Kevin Danso,AUT,Lens,Ligue 1,2021,22.0,1998.0,31.0,41,29,29,12,0,23,34,67.6,11,38,25,13,40,81,111,0,DF,20-24,Defender,Austria,Europe
16136,Dante,BRA,Nice,Ligue 1,2021,37.0,1983.0,31.9,42,29,30,12,0,23,33,69.7,10,43,27,16,49,91,96,1,DF,35-39,Defender,Brazil,South America
432281,Mrton Drdai,HUN,Hertha BSC,Bundesliga,2021,19.0,2002.0,8.4,10,4,8,2,0,8,18,44.4,10,16,6,10,20,30,33,2,DF,Under 20,Defender,Hungary,Europe
533738,Jonathan David,CAN,Lille,Ligue 1,2021,21.0,2000.0,31.2,24,9,7,11,6,9,30,30.0,21,14,4,10,5,29,15,0,FW,20-24,Forward,Canada,North America
424204,Alphonso Davies,CAN,Bayern Munich,Bundesliga,2021,20.0,2000.0,19.3,34,17,17,8,9,13,31,41.9,18,27,1,26,23,57,26,1,DF,20-24,Defender,Canada,North America
257097,Ben Davies,WAL,Tottenham,Premier League,2021,28.0,1993.0,28.2,36,21,20,12,4,13,26,50.0,13,32,19,13,30,66,75,1,DF,25-29,Defender,Wales,Europe
854853,Tom Davies,ENG,Everton,Premier League,2021,23.0,1998.0,2.6,3,1,1,1,1,2,5,40.0,3,2,1,1,2,5,9,0,MF,20-24,Midfielder,England,Europe
121477,Craig Dawson,ENG,West Ham,Premier League,2021,31.0,1990.0,30.6,29,17,20,8,1,14,25,56.0,11,59,52,7,29,58,139,0,DF,30-34,Defender,England,Europe
88755,Kevin De Bruyne,BEL,Manchester City,Premier League,2021,30.0,1991.0,24.5,32,16,4,15,13,12,37,32.4,25,32,2,30,6,38,16,0,MF,30-34,Midfielder,Belgium,Europe
33571,Lorenzo De Silvestri,ITA,Bologna,Serie A,2021,33.0,1988.0,25.5,23,14,13,8,2,9,31,29.0,22,25,7,18,26,49,52,0,DF,30-34,Defender,Italy,Europe
235931,Alessandro Deiola,ITA,Cagliari,Serie A,2021,25.0,1995.0,23.7,47,22,15,25,7,23,58,39.7,35,28,10,18,26,73,45,0,MF,25-29,Midfielder,Italy,Europe
170961,Thomas Delaine,FRA,Metz,Ligue 1,2021,29.0,1992.0,25.7,48,35,34,12,2,22,42,52.4,20,20,7,13,27,75,31,0,DF,25-29,Defender,France,Europe
393904,Filippo Delli Carri,ITA,Salernitana,Serie A,2021,22.0,1999.0,3.7,6,4,4,2,0,5,14,35.7,9,6,2,4,4,10,14,0,DF,20-24,Defender,Italy,Europe
122797,Andy Delort,ALG,Nice,Ligue 1,2021,29.0,1991.0,27.2,15,9,3,5,7,7,12,58.3,5,13,4,9,9,24,14,0,FW,25-29,Forward,Algeria,Africa
229004,Moussa Dembl,FRA,Lyon,Ligue 1,2021,25.0,1996.0,24.5,18,9,5,5,8,6,15,40.0,9,13,0,13,8,26,30,1,FW,25-29,Forward,France,Europe
288230,Ousmane Dembl,FRA,Barcelona,La Liga,2021,24.0,1997.0,15.7,24,16,6,10,8,7,23,30.4,16,8,0,8,8,32,3,0,FW,20-24,Forward,France,Europe
82070,Diego Demme,GER,Napoli,Serie A,2021,29.0,1991.0,7.7,21,12,4,13,4,10,21,47.6,11,11,2,9,9,30,2,0,MF,25-29,Midfielder,Germany,Europe
277114,Jason Denayer,BEL,Lyon,Ligue 1,2021,26.0,1995.0,11.1,11,4,8,3,0,6,7,85.7,1,8,7,1,16,27,52,0,DF,25-29,Defender,Belgium,Europe
448854,Emmanuel Dennis,NGA,Watford,Premier League,2021,23.0,1997.0,28.7,51,35,20,22,9,17,52,32.7,35,36,2,34,15,66,13,0,"FW,MF",20-24,Forward,Nigeria,Africa
475188,Kiernan Dewsbury-Hall,ENG,Leicester City,Premier League,2021,22.0,1998.0,23.4,39,24,20,14,5,19,40,47.5,21,37,8,29,21,60,26,1,MF,20-24,Midfielder,England,Europe
38607,Federico Di Francesco,ITA,Empoli,Serie A,2021,27.0,1994.0,15.2,16,5,2,8,6,9,23,39.1,14,17,1,16,9,25,11,0,"FW,MF",25-29,Forward,Italy,Europe
169880,Giovanni Di Lorenzo,ITA,Napoli,Serie A,2021,27.0,1993.0,31.9,58,36,30,20,8,33,58,56.9,25,28,10,18,38,96,46,1,DF,25-29,Defender,Italy,Europe
84766,Francesco Di Tacchio,ITA,Salernitana,Serie A,2021,31.0,1990.0,13.9,17,7,5,10,2,9,25,36.0,16,16,8,8,22,39,25,0,MF,30-34,Midfielder,Italy,Europe
626913,Boulaye Dia,SEN,Villarreal,La Liga,2021,24.0,1996.0,14.1,8,6,3,4,1,2,5,40.0,3,6,1,5,5,13,4,0,FW,20-24,Forward,Senegal,Africa
395516,Moussa Diaby,FRA,Leverkusen,Bundesliga,2021,22.0,1999.0,30.7,20,11,8,9,3,5,38,13.2,33,11,0,11,8,28,2,0,"FW,MF",20-24,Forward,France,Europe
346289,Mouctar Diakhaby,GUI,Valencia,La Liga,2021,24.0,1996.0,21.6,35,24,18,15,2,13,23,56.5,10,29,17,12,30,65,87,3,DF,20-24,Defender,Guinea,Africa
229005,Abdou Diallo,SEN,Paris S-G,Ligue 1,2021,25.0,1996.0,9.7,22,14,10,9,3,8,14,57.1,6,6,2,4,10,32,19,1,DF,25-29,Defender,Senegal,Africa
344888,Habib Diallo,SEN,Strasbourg,Ligue 1,2021,26.0,1995.0,17.1,9,5,0,8,1,0,8,0.0,8,13,4,9,4,13,11,0,FW,25-29,Forward,Senegal,Africa
413032,Ibrahima Diallo,FRA,Southampton,Premier League,2021,22.0,1999.0,11.4,22,11,10,9,3,10,24,41.7,14,7,0,7,9,31,10,0,MF,20-24,Midfielder,France,Europe
428954,Stphane Diarra,FRA,Lorient,Ligue 1,2021,22.0,1998.0,5.8,11,9,7,3,1,5,10,50.0,5,4,0,4,7,18,1,0,"MF,FW",20-24,Midfielder,France,Europe
258004,Rben Dias,POR,Manchester City,Premier League,2021,24.0,1997.0,26.7,26,19,11,12,3,8,15,53.3,7,19,13,6,23,49,66,0,DF,20-24,Defender,Portugal,Europe
490426,Krpin Diatta,SEN,Monaco,Ligue 1,2021,22.0,1999.0,3.2,3,2,1,0,2,1,3,33.3,2,2,0,2,1,4,0,0,"MF,DF",20-24,Midfielder,Senegal,Africa
314678,Brahim Daz,MAR,Milan,Serie A,2021,21.0,1999.0,20.6,23,17,3,11,9,8,22,36.4,14,11,0,11,8,31,4,0,MF,20-24,Midfielder,Morocco,Africa
480692,Luis Daz,COL,Liverpool,Premier League,2021,24.0,1997.0,10.6,9,7,3,5,1,2,8,25.0,6,7,0,7,4,13,2,0,FW,20-24,Forward,Colombia,South America
57995,Daniel Didavi,GER,Stuttgart,Bundesliga,2021,31.0,1990.0,3.1,6,2,0,4,2,4,7,57.1,3,4,1,3,1,7,1,0,"MF,FW",30-34,Midfielder,Germany,Europe
822458,Bamba Dieng,SEN,Marseille,Ligue 1,2021,21.0,2000.0,10.8,17,11,5,5,7,4,14,28.6,10,7,0,7,5,22,8,0,FW,20-24,Forward,Senegal,Africa
175722,Eric Dier,ENG,Tottenham,Premier League,2021,27.0,1994.0,34.1,15,9,6,8,1,7,14,50.0,7,37,32,5,27,42,142,1,DF,25-29,Defender,England,Europe
126664,Lucas Digne,FRA,Aston Villa,Premier League,2021,28.0,1993.0,14.1,13,10,8,3,2,9,19,47.4,10,15,8,7,23,36,40,0,DF,25-29,Defender,France,Europe
198116,Federico Dimarco,ITA,Inter,Serie A,2021,23.0,1997.0,15.9,28,15,10,15,3,13,24,54.2,11,6,1,5,19,47,19,0,DF,20-24,Defender,Italy,Europe
536482,Junior Dina Ebimbe,FRA,Paris S-G,Ligue 1,2021,20.0,2000.0,3.5,9,4,3,4,2,2,3,66.7,1,5,3,2,2,11,1,0,MF,20-24,Midfielder,France,Europe
126683,Tristan Dingom,CMR,Troyes,Ligue 1,2021,30.0,1991.0,12.0,23,11,10,12,1,10,18,55.6,8,7,1,6,9,32,3,0,"MF,FW",30-34,Midfielder,Cameroon,Africa
569389,Sofiane Diop,FRA,Monaco,Ligue 1,2021,21.0,2000.0,21.6,38,20,12,19,7,15,47,31.9,32,10,0,10,23,61,4,0,"MF,FW",20-24,Midfielder,France,Europe
386047,Axel Disasi,FRA,Monaco,Ligue 1,2021,23.0,1998.0,30.2,42,27,20,21,1,23,39,59.0,16,40,30,10,26,68,75,0,DF,20-24,Defender,France,Europe
183031,Koffi Djidji,CIV,Torino,Serie A,2021,28.0,1992.0,19.3,48,29,21,23,4,14,18,77.8,4,20,9,11,34,82,60,0,DF,25-29,Defender,Ivory Coast,Africa
165513,Berat Djimsiti,ALB,Atalanta,Serie A,2021,28.0,1993.0,25.1,43,24,21,20,2,29,46,63.0,17,21,11,10,31,74,56,0,DF,25-29,Defender,Albania,Europe
497291,Nicols Domnguez,ARG,Bologna,Serie A,2021,23.0,1998.0,22.4,76,45,36,32,8,32,76,42.1,44,38,9,29,32,108,34,1,MF,20-24,Midfielder,Argentina,South America
251302,Niklas Dorsch,GER,Augsburg,Bundesliga,2021,23.0,1998.0,25.8,76,47,47,23,6,30,60,50.0,30,34,12,22,35,111,36,3,MF,20-24,Midfielder,Germany,Europe
221151,Jodel Dossou,BEN,Clermont Foot,Ligue 1,2021,29.0,1992.0,22.3,36,17,15,14,7,15,43,34.9,28,14,0,14,5,41,7,0,FW,25-29,Forward,Benin,Africa
127187,Abdoulaye Doucour,MLI,Everton,Premier League,2021,28.0,1993.0,28.2,75,43,30,37,8,32,71,45.1,39,33,8,25,28,103,32,0,MF,25-29,Midfielder,Mali,Africa
543387,Cheick Doucour,MLI,Lens,Ligue 1,2021,21.0,2000.0,32.7,75,43,34,34,7,35,79,44.3,44,30,7,23,68,143,24,0,MF,20-24,Midfielder,Mali,Africa
316137,Moussa Doumbia,MLI,Reims,Ligue 1,2021,26.0,1994.0,1.0,0,0,0,0,0,0,1,0.0,1,0,0,0,0,0,0,0,FW,25-29,Forward,Mali,Africa
257376,Domingos Duarte,POR,Granada,La Liga,2021,26.0,1995.0,18.7,18,14,9,9,0,6,11,54.5,5,27,20,7,22,40,82,0,DF,25-29,Defender,Portugal,Europe
175323,scar Duarte,CRC,Levante,La Liga,2021,32.0,1989.0,19.7,18,8,12,6,0,8,23,34.8,15,18,9,9,24,42,102,0,DF,30-34,Defender,Costa Rica,North America
232418,Ondrej Duda,SVK,Kln,Bundesliga,2021,26.0,1994.0,17.9,23,16,4,12,7,6,23,26.1,17,14,2,12,17,40,9,0,"MF,FW",25-29,Midfielder,Slovakia,Europe
119269,Shane Duffy,IRL,Brighton,Premier League,2021,29.0,1992.0,16.0,15,12,12,3,0,8,14,57.1,6,24,18,6,16,31,76,1,DF,25-29,Defender,Republic of Ireland,Europe
321528,Denzel Dumfries,NED,Inter,Serie A,2021,25.0,1996.0,22.5,32,12,9,14,9,16,32,50.0,16,15,6,9,9,41,26,0,DF,25-29,Defender,Netherlands,Europe
184894,Alfred Duncan,GHA,Fiorentina,Serie A,2021,28.0,1993.0,21.5,34,19,13,16,5,11,32,34.4,21,32,3,29,10,44,7,0,MF,25-29,Midfielder,Ghana,Africa
148153,Lewis Dunk,ENG,Brighton,Premier League,2021,29.0,1991.0,28.6,10,8,5,5,0,5,11,45.5,6,32,28,4,27,37,113,3,DF,25-29,Defender,England,Europe
206050,Paulo Dybala,ARG,Juventus,Serie A,2021,27.0,1993.0,22.9,30,13,7,14,9,8,35,22.9,27,19,0,19,9,39,4,3,"FW,MF",25-29,Forward,Argentina,South America
309944,Tyronne Ebuehi,NGA,Venezia,Serie A,2021,25.0,1995.0,12.6,28,12,16,8,4,10,18,55.6,8,13,3,10,16,44,38,1,DF,25-29,Defender,Nigeria,Africa
607854,derson,BRA,Salernitana,Serie A,2021,22.0,1999.0,12.7,29,18,11,14,4,14,26,53.8,12,11,2,9,19,48,8,0,MF,20-24,Midfielder,Brazil,South America
49275,Albin Ekdal,SWE,Sampdoria,Serie A,2021,32.0,1989.0,18.2,43,28,17,21,5,26,56,46.4,30,27,7,20,29,72,25,0,MF,30-34,Midfielder,Sweden,Europe
361068,Jurgen Ekkelenkamp,NED,Hertha BSC,Bundesliga,2021,21.0,2000.0,8.0,8,3,2,6,0,2,7,28.6,5,9,2,7,4,12,5,0,"MF,FW",20-24,Midfielder,Netherlands,Europe
199953,Caleb Ekuban,GHA,Genoa,Serie A,2021,27.0,1994.0,19.1,19,12,2,12,5,7,23,30.4,16,19,5,14,9,28,6,0,"FW,MF",25-29,Forward,Ghana,Africa
583189,Anthony Elanga,SWE,Manchester Utd,Premier League,2021,19.0,2002.0,13.5,26,20,12,12,2,15,29,51.7,14,17,1,16,9,35,7,0,FW,Under 20,Forward,Sweden,Europe
565822,Harvey Elliott,ENG,Liverpool,Premier League,2021,18.0,2003.0,3.8,3,0,1,1,1,0,6,0.0,6,8,1,7,4,7,2,0,MF,Under 20,Midfielder,England,Europe
160438,Mohamed Elneny,EGY,Arsenal,Premier League,2021,29.0,1992.0,9.0,16,8,10,5,1,7,12,58.3,5,7,1,6,14,30,13,0,MF,25-29,Midfielder,Egypt,Africa
192635,Nico Elvedi,SUI,Gladbach,Bundesliga,2021,24.0,1996.0,27.0,40,24,23,17,0,22,36,61.1,14,33,22,11,34,74,83,1,DF,20-24,Defender,Switzerland,Europe
237662,Breel Embolo,SUI,Gladbach,Bundesliga,2021,24.0,1997.0,24.1,16,11,1,12,3,3,8,37.5,5,14,2,12,6,22,7,0,FW,20-24,Forward,Switzerland,Europe
146310,Wataru Endo,JPN,Stuttgart,Bundesliga,2021,28.0,1993.0,32.2,73,41,34,34,5,31,72,43.1,41,43,12,31,30,103,64,0,MF,25-29,Midfielder,Japan,Asia
69633,Christian Eriksen,DEN,Brentford,Premier League,2021,29.0,1992.0,10.4,13,6,4,5,4,8,17,47.1,9,9,1,8,9,22,14,0,MF,25-29,Midfielder,Denmark,Europe
311044,Alfonso Espino,URU,Cdiz,La Liga,2021,29.0,1992.0,37.0,107,63,58,39,10,44,112,39.3,68,45,10,35,54,161,87,1,DF,25-29,Defender,Uruguay,South America
349599,Pervis Estupin,ECU,Villarreal,La Liga,2021,23.0,1998.0,17.5,36,22,20,11,5,17,24,70.8,7,13,5,8,25,61,29,2,DF,20-24,Defender,Ecuador,South America
479999,Eberechi Eze,ENG,Crystal Palace,Premier League,2021,23.0,1998.0,6.7,10,6,5,2,3,6,11,54.5,5,4,1,3,5,15,1,0,"MF,FW",20-24,Midfielder,England,Europe
724520,Abde Ezzalzouli,MAR,Barcelona,La Liga,2021,19.0,2001.0,6.4,17,9,9,5,3,5,8,62.5,3,3,0,3,9,26,0,0,FW,Under 20,Forward,Morocco,Africa
697714,Fabinho,BRA,Liverpool,Premier League,2021,27.0,1993.0,25.7,46,25,17,23,6,24,70,34.3,46,33,10,23,39,85,25,1,MF,25-29,Midfielder,Brazil,South America
61891,Fbio,BRA,Nantes,Ligue 1,2021,31.0,1990.0,18.5,61,40,31,23,7,36,74,48.6,38,29,7,22,35,96,31,1,DF,30-34,Defender,Brazil,South America
292808,Wout Faes,BEL,Reims,Ligue 1,2021,23.0,1998.0,37.0,40,24,30,9,1,25,33,75.8,8,47,37,10,53,93,169,2,DF,20-24,Defender,Belgium,Europe
610431,Wahid Faghir,DEN,Stuttgart,Bundesliga,2021,18.0,2003.0,1.4,0,0,0,0,0,0,1,0.0,1,2,0,2,0,0,0,0,FW,Under 20,Forward,Denmark,Europe
555076,Romain Faivre,FRA,Lyon,Ligue 1,2021,23.0,1998.0,9.9,10,4,2,6,2,4,13,30.8,9,4,0,4,3,13,2,0,"FW,MF",20-24,Forward,France,Europe
39152,Radamel Falcao,COL,Rayo Vallecano,La Liga,2021,35.0,1986.0,9.3,2,1,0,1,1,1,4,25.0,3,4,1,3,2,4,11,0,FW,35-39,Forward,Colombia,South America
73926,Davide Faraoni,ITA,Hellas Verona,Serie A,2021,29.0,1991.0,28.6,62,40,38,21,3,29,62,46.8,33,38,5,33,23,85,62,1,DF,25-29,Defender,Italy,Europe
78917,Julien Faussurier,FRA,Brest,Ligue 1,2021,34.0,1987.0,5.4,10,6,3,3,4,6,13,46.2,7,12,1,11,5,15,6,0,"MF,DF",30-34,Midfielder,France,Europe
45314,Federico Fazio,ARG,Salernitana,Serie A,2021,34.0,1987.0,15.9,17,11,10,6,1,9,12,75.0,3,21,16,5,27,44,67,1,DF,30-34,Defender,Argentina,South America
203496,Nabil Fekir,FRA,Betis,La Liga,2021,28.0,1993.0,31.0,43,29,5,25,13,7,36,19.4,29,14,0,14,7,50,7,0,MF,25-29,Midfielder,France,Europe
156501,Felipe,BRA,Atltico Madrid,La Liga,2021,32.0,1989.0,16.7,20,15,11,8,1,8,18,44.4,10,17,11,6,28,48,77,0,DF,30-34,Defender,Brazil,South America
573907,Luiz Felipe,ITA,Lazio,Serie A,2021,24.0,1997.0,27.7,41,23,21,16,4,20,34,58.8,14,40,33,7,33,74,102,1,DF,20-24,Defender,Italy,Europe
462250,Joo Flix,POR,Atltico Madrid,La Liga,2021,21.0,1999.0,14.0,5,2,1,4,0,1,5,20.0,4,4,1,3,7,12,8,0,"FW,MF",20-24,Forward,Portugal,Europe
240306,Bruno Fernandes,POR,Manchester Utd,Premier League,2021,26.0,1994.0,34.6,54,28,26,22,6,26,91,28.6,65,36,0,36,17,71,42,2,MF,25-29,Midfielder,Portugal,Europe
247555,Edimilson Fernandes,SUI,Arminia,Bundesliga,2021,25.0,1996.0,3.1,2,0,1,1,0,1,4,25.0,3,2,2,0,2,4,6,0,"MF,FW",25-29,Midfielder,Switzerland,Europe
389324,Fernandinho,BRA,Manchester City,Premier League,2021,36.0,1985.0,10.7,21,10,7,10,4,9,27,33.3,18,8,2,6,8,29,13,1,"MF,DF",35-39,Midfielder,Brazil,South America
550495,Fernando,BRA,Sevilla,La Liga,2021,34.0,1987.0,20.6,24,17,14,9,1,12,33,36.4,21,21,13,8,29,53,32,2,"MF,DF",30-34,Midfielder,Brazil,South America
197491,Alex Ferrari,ITA,Sampdoria,Serie A,2021,27.0,1994.0,18.3,40,22,28,9,3,19,33,57.6,14,31,22,9,39,79,63,1,DF,25-29,Defender,Italy,Europe
118284,Jordan Ferri,FRA,Montpellier,Ligue 1,2021,29.0,1992.0,32.3,55,35,28,23,4,29,87,33.3,58,21,5,16,30,85,35,0,MF,25-29,Midfielder,France,Europe
287875,Luca Fiordilino,ITA,Venezia,Serie A,2021,25.0,1996.0,7.3,21,13,11,6,4,13,27,48.1,14,14,4,10,11,32,12,0,MF,25-29,Midfielder,Italy,Europe
374139,Junior Firpo,DOM,Leeds United,Premier League,2021,24.0,1996.0,19.0,61,29,30,26,5,31,59,52.5,28,22,6,16,24,85,37,0,"DF,MF",20-24,Defender,Dominican Republic,North America
130365,Alessandro Florenzi,ITA,Milan,Serie A,2021,30.0,1991.0,12.8,28,14,14,7,7,14,32,43.8,18,9,2,7,27,55,10,1,"DF,FW",30-34,Defender,Italy,Europe
406635,Phil Foden,ENG,Manchester City,Premier League,2021,21.0,2000.0,23.6,16,8,10,4,2,7,17,41.2,10,9,0,9,11,27,5,0,FW,20-24,Forward,England,Europe
182893,Seko Fofana,CIV,Lens,Ligue 1,2021,26.0,1995.0,37.3,27,19,11,13,3,12,58,20.7,46,24,2,22,26,53,17,1,MF,25-29,Midfielder,Ivory Coast,Africa
475411,Wesley Fofana,FRA,Leicester City,Premier League,2021,20.0,2000.0,7.0,12,8,11,1,0,7,11,63.6,4,5,2,3,12,24,26,1,DF,20-24,Defender,France,Europe
569598,Youssouf Fofana,FRA,Monaco,Ligue 1,2021,22.0,1999.0,24.3,69,43,19,41,9,29,56,51.8,27,29,7,22,32,101,22,2,MF,20-24,Midfielder,France,Europe
44948,Fernando Forestieri,ITA,Udinese,Serie A,2021,31.0,1990.0,0.6,0,0,0,0,0,0,1,0.0,1,1,0,1,0,0,1,0,"FW,MF",30-34,Forward,Italy,Europe
111078,Emil Forsberg,SWE,RB Leipzig,Bundesliga,2021,29.0,1991.0,19.0,21,12,2,11,8,7,22,31.8,15,18,0,18,2,23,2,1,MF,25-29,Midfielder,Sweden,Europe
121257,Adam Forshaw,ENG,Leeds United,Premier League,2021,29.0,1991.0,17.0,53,23,21,27,5,21,54,38.9,33,17,1,16,19,72,12,2,MF,25-29,Midfielder,England,Europe
179635,Philipp Frster,GER,Stuttgart,Bundesliga,2021,26.0,1995.0,10.7,20,13,4,12,4,11,26,42.3,15,12,1,11,3,23,2,0,"MF,FW",25-29,Midfielder,Germany,Europe
382571,Francesco Forte,ITA,Venezia,Serie A,2021,28.0,1993.0,4.7,3,2,0,2,1,2,5,40.0,3,1,0,1,0,3,2,0,FW,25-29,Forward,Italy,Europe
480763,Juan Foyth,ARG,Villarreal,La Liga,2021,23.0,1998.0,21.4,69,49,35,28,6,35,47,74.5,12,29,7,22,20,89,50,0,DF,20-24,Defender,Argentina,South America
146795,Ryan Fraser,SCO,Newcastle Utd,Premier League,2021,27.0,1994.0,16.3,10,3,5,3,2,5,13,38.5,8,11,1,10,11,21,11,0,"FW,MF",25-29,Forward,Scotland,Europe
394300,Davide Frattesi,ITA,Sassuolo,Serie A,2021,21.0,1999.0,31.7,46,16,26,18,2,26,52,50.0,26,44,12,32,29,75,62,1,MF,20-24,Midfielder,Italy,Europe
503871,Morten Frendrup,DEN,Genoa,Serie A,2021,20.0,2001.0,7.7,40,24,19,13,8,13,29,44.8,16,19,2,17,17,57,7,1,"DF,MF",20-24,Defender,Denmark,Europe
484547,Jeremie Frimpong,NED,Leverkusen,Bundesliga,2021,20.0,2000.0,22.8,32,18,19,12,1,12,23,52.2,11,24,6,18,17,49,40,2,DF,20-24,Defender,Netherlands,Europe
272278,Chris Fhrich,GER,Stuttgart,Bundesliga,2021,23.0,1998.0,19.0,28,16,10,10,8,18,39,46.2,21,31,2,29,8,36,9,0,"FW,MF",20-24,Forward,Germany,Europe
250013,Angelo Fulgini,FRA,Angers,Ligue 1,2021,24.0,1996.0,32.5,35,25,8,18,9,14,44,31.8,30,21,5,16,22,57,5,1,"MF,FW",20-24,Midfielder,France,Europe
186399,Thiago Galhardo,BRA,Celta Vigo,La Liga,2021,32.0,1989.0,12.8,12,6,3,3,6,2,12,16.7,10,15,2,13,6,18,9,0,"FW,MF",30-34,Forward,Brazil,South America
488362,Conor Gallagher,ENG,Crystal Palace,Premier League,2021,21.0,2000.0,31.6,69,38,35,20,14,21,69,30.4,48,58,9,49,29,98,26,0,MF,20-24,Midfielder,England,Europe
121686,Cristian Gamboa,CRC,Bochum,Bundesliga,2021,31.0,1989.0,19.1,59,36,40,16,3,30,61,49.2,31,22,7,15,32,91,35,1,DF,30-34,Defender,Costa Rica,North America
27389,Kvin Gameiro,FRA,Strasbourg,Ligue 1,2021,34.0,1987.0,26.5,19,10,5,9,5,6,18,33.3,12,22,1,21,6,25,1,0,FW,30-34,Forward,France,Europe
531949,Ignatius Ganago,CMR,Lens,Ligue 1,2021,22.0,1999.0,11.4,3,2,1,2,0,2,6,33.3,4,4,0,4,2,5,3,0,FW,20-24,Forward,Cameroon,Africa
72121,Johan Gastien,FRA,Clermont Foot,Ligue 1,2021,33.0,1988.0,30.5,56,34,26,25,5,27,74,36.5,47,45,11,34,53,109,49,1,MF,30-34,Midfielder,France,Europe
692734,Linus Gechter,GER,Hertha BSC,Bundesliga,2021,17.0,2004.0,8.0,15,8,13,2,0,7,14,50.0,7,12,7,5,11,26,29,0,DF,Under 20,Defender,Germany,Europe
251309,Dennis Geiger,GER,Hoffenheim,Bundesliga,2021,23.0,1998.0,15.3,34,23,9,20,5,17,30,56.7,13,15,1,14,14,48,7,1,MF,20-24,Midfielder,Germany,Europe
503980,Joe Gelhardt,ENG,Leeds United,Premier League,2021,19.0,2002.0,8.3,4,3,1,0,3,2,10,20.0,8,9,0,9,0,4,3,0,"FW,MF",Under 20,Forward,England,Europe
119277,Yannick Gerhardt,GER,Wolfsburg,Bundesliga,2021,27.0,1994.0,17.5,42,20,18,17,7,22,36,61.1,14,24,1,23,25,67,25,1,"MF,DF",25-29,Midfielder,Germany,Europe
60540,Valre Germain,FRA,Montpellier,Ligue 1,2021,31.0,1990.0,21.9,23,14,6,11,6,8,31,25.8,23,13,1,12,9,32,27,0,FW,30-34,Forward,France,Europe
341705,Gerson,BRA,Marseille,Ligue 1,2021,24.0,1997.0,28.3,42,17,16,20,6,8,35,22.9,27,26,4,22,16,58,16,2,"MF,FW",20-24,Midfielder,Brazil,South America
463620,Willem Geubbels,FRA,Nantes,Ligue 1,2021,19.0,2001.0,6.0,8,5,4,2,2,5,12,41.7,7,5,0,5,6,14,5,0,"FW,MF",Under 20,Forward,France,Europe
193534,Hamadi Al Ghaddioui,MAR,Stuttgart,Bundesliga,2021,30.0,1990.0,5.5,5,4,2,1,2,0,4,0.0,4,3,1,2,0,5,4,0,FW,30-34,Forward,Morocco,Africa
313477,Paolo Ghiglione,ITA,Genoa,Serie A,2021,24.0,1997.0,6.7,17,12,8,6,3,9,14,64.3,5,11,5,6,10,27,12,1,DF,20-24,Defender,Italy,Europe
204294,Saman Ghoddos,IRN,Brentford,Premier League,2021,27.0,1993.0,6.0,17,10,8,6,3,9,15,60.0,6,2,0,2,3,20,16,0,"MF,DF",25-29,Midfielder,Iran,Asia
128904,Ben Gibson,ENG,Norwich City,Premier League,2021,28.0,1993.0,27.7,23,16,17,6,0,7,12,58.3,5,36,30,6,27,50,139,2,DF,25-29,Defender,England,Europe
72792,Niko Gieelmann,GER,Union Berlin,Bundesliga,2021,29.0,1991.0,23.1,24,17,10,11,3,15,38,39.5,23,26,4,22,18,42,29,1,"DF,FW",25-29,Defender,Germany,Europe
423744,Billy Gilmour,SCO,Norwich City,Premier League,2021,20.0,2001.0,20.6,41,21,16,21,4,14,52,26.9,38,21,4,17,17,58,29,0,MF,20-24,Midfielder,Scotland,Europe
270051,Andrei Girotto,BRA,Nantes,Ligue 1,2021,29.0,1992.0,35.0,85,52,49,32,4,52,103,50.5,51,67,33,34,69,154,143,0,"DF,MF",25-29,Defender,Brazil,South America
82442,Olivier Giroud,FRA,Milan,Serie A,2021,34.0,1986.0,21.0,15,11,4,6,5,3,17,17.6,14,13,4,9,3,18,19,0,FW,30-34,Forward,France,Europe
159471,Serge Gnabry,GER,Bayern Munich,Bundesliga,2021,26.0,1995.0,24.3,47,31,16,20,11,22,57,38.6,35,26,0,26,14,61,3,0,"FW,DF",25-29,Forward,Germany,Europe
343475,Ben Godfrey,ENG,Everton,Premier League,2021,23.0,1998.0,22.5,47,32,29,14,4,24,39,61.5,15,41,19,22,15,62,100,2,DF,20-24,Defender,England,Europe
263918,Aleksandr Golovin,RUS,Monaco,Ligue 1,2021,25.0,1996.0,16.7,40,22,10,18,12,18,41,43.9,23,26,1,25,12,52,8,0,"FW,MF",25-29,Forward,Russia,Europe
670710,Andr Gomes,POR,Everton,Premier League,2021,28.0,1993.0,6.9,16,4,6,6,4,8,32,25.0,24,8,2,6,1,17,7,1,MF,25-29,Midfielder,Portugal,Europe
392770,Angel Gomes,ENG,Lille,Ligue 1,2021,20.0,2000.0,10.6,23,13,6,12,5,10,15,66.7,5,4,0,4,3,26,4,0,"MF,FW",20-24,Midfielder,England,Europe
20005,Papu Gmez,ARG,Sevilla,La Liga,2021,33.0,1988.0,19.8,19,11,9,5,5,9,35,25.7,26,15,2,13,7,26,12,2,"FW,MF",30-34,Forward,Argentina,South America
213854,Cedric Gondo,CIV,Salernitana,Serie A,2021,24.0,1996.0,7.8,5,2,2,2,1,2,5,40.0,3,2,0,2,3,8,2,0,FW,20-24,Forward,Ivory Coast,Africa
503733,Anthony Gordon,ENG,Everton,Premier League,2021,20.0,2001.0,25.4,54,32,20,30,4,21,59,35.6,38,49,3,46,22,76,17,0,"MF,FW",20-24,Midfielder,England,Europe
153084,Leon Goretzka,GER,Bayern Munich,Bundesliga,2021,26.0,1995.0,15.5,25,15,12,9,4,11,26,42.3,15,11,1,10,17,42,23,2,MF,25-29,Midfielder,Germany,Europe
44983,Dan Gosling,ENG,Watford,Premier League,2021,31.0,1990.0,1.8,2,1,1,1,0,2,6,33.3,4,2,0,2,0,2,3,0,MF,30-34,Midfielder,England,Europe
418659,Amine Gouiri,ALG,Nice,Ligue 1,2021,21.0,2000.0,30.6,22,13,2,13,7,10,32,31.3,22,22,5,17,11,33,17,1,"FW,MF",20-24,Forward,Algeria,Africa
620313,Lucas Gourna-Douath,FRA,Saint-tienne,Ligue 1,2021,17.0,2003.0,20.0,45,26,22,18,5,21,36,58.3,15,22,3,19,13,58,9,2,MF,Under 20,Midfielder,France,Europe
106405,Jeffrey Gouweleeuw,NED,Augsburg,Bundesliga,2021,30.0,1991.0,28.6,50,27,33,17,0,22,36,61.1,14,35,18,17,49,99,116,0,DF,30-34,Defender,Netherlands,Europe
197473,Alberto Grassi,ITA,Cagliari,Serie A,2021,26.0,1995.0,24.2,47,26,13,30,4,16,38,42.1,22,27,9,18,63,110,33,1,MF,25-29,Midfielder,Italy,Europe
292417,Demarai Gray,JAM,Everton,Premier League,2021,25.0,1996.0,26.0,30,19,13,10,7,10,22,45.5,12,30,2,28,15,45,21,1,"MF,FW",25-29,Midfielder,Jamaica,North America
203460,Jack Grealish,ENG,Manchester City,Premier League,2021,25.0,1995.0,21.3,18,17,4,10,4,5,13,38.5,8,11,1,10,8,26,7,0,FW,25-29,Forward,England,Europe
161204,Julian Green,USA,Greuther Frth,Bundesliga,2021,26.0,1995.0,11.7,9,5,0,8,1,2,8,25.0,6,10,2,8,7,16,10,0,MF,25-29,Midfielder,United States,North America
185077,Vincenzo Grifo,ITA,Freiburg,Bundesliga,2021,28.0,1993.0,30.8,27,15,9,13,5,9,26,34.6,17,12,2,10,13,40,28,0,"MF,FW",25-29,Midfielder,Italy,Europe
195736,Florian Grillitsch,AUT,Hoffenheim,Bundesliga,2021,25.0,1995.0,16.6,37,19,15,21,1,17,31,54.8,14,18,7,11,29,66,36,1,"DF,MF",25-29,Defender,Austria,Europe
82873,Pascal Gro,GER,Brighton,Premier League,2021,30.0,1991.0,22.6,28,15,15,11,2,12,33,36.4,21,34,8,26,18,46,23,0,"MF,DF",30-34,Midfielder,Germany,Europe
20506,Andrs Guardado,MEX,Betis,La Liga,2021,34.0,1986.0,15.5,30,13,12,17,1,13,34,38.2,21,18,4,14,21,51,29,1,MF,30-34,Midfielder,Mexico,North America
362108,Gabriel Gudmundsson,SWE,Lille,Ligue 1,2021,22.0,1999.0,14.9,43,31,24,16,3,17,35,48.6,18,15,3,12,20,63,13,0,"DF,MF",20-24,Defender,Sweden,Europe
225122,Gonalo Guedes,POR,Valencia,La Liga,2021,24.0,1996.0,29.0,21,14,6,7,8,2,22,9.1,20,14,0,14,9,30,1,0,"FW,MF",20-24,Forward,Portugal,Europe
500689,Evann Guessand,CIV,Nice,Ligue 1,2021,20.0,2001.0,4.9,9,8,2,5,2,3,8,37.5,5,4,0,4,0,9,1,0,FW,20-24,Forward,Ivory Coast,Africa
568701,Lamine Gueye,SEN,Metz,Ligue 1,2021,23.0,1998.0,6.2,5,5,1,1,3,3,7,42.9,4,4,0,4,6,11,1,0,"FW,MF",20-24,Forward,Senegal,Africa
485963,Pape Gueye,SEN,Marseille,Ligue 1,2021,22.0,1999.0,17.0,38,19,15,22,1,16,31,51.6,15,15,3,12,24,62,16,0,MF,20-24,Midfielder,Senegal,Africa
98596,John Guidetti,SWE,Alavs,La Liga,2021,29.0,1992.0,3.1,2,1,0,0,2,0,1,0.0,1,1,0,1,0,2,0,0,"FW,MF",25-29,Forward,Sweden,Europe
93704,Josuha Guilavogui,FRA,Bordeaux,Ligue 1,2021,30.0,1990.0,14.8,39,16,18,17,4,14,29,48.3,15,16,8,8,36,75,23,0,"MF,DF",30-34,Midfielder,France,Europe
520624,Bruno Guimares,BRA,Newcastle Utd,Premier League,2021,23.0,1997.0,11.5,44,23,18,22,4,21,38,55.3,17,25,6,19,9,53,13,0,MF,20-24,Midfielder,Brazil,South America
270541,Serhou Guirassy,GUI,Rennes,Ligue 1,2021,25.0,1996.0,11.3,4,2,1,2,1,1,7,14.3,6,4,0,4,1,5,8,0,FW,25-29,Forward,Guinea,Africa
93707,Christian Gnter,GER,Freiburg,Bundesliga,2021,28.0,1993.0,34.0,34,20,16,15,3,18,50,36.0,32,23,6,17,17,51,49,2,"DF,MF",25-29,Defender,Germany,Europe
241076,Emmanuel Gyasi,GHA,Spezia,Serie A,2021,27.0,1994.0,33.7,47,30,31,9,7,21,41,51.2,20,22,4,18,16,63,43,1,"FW,MF",25-29,Forward,Ghana,Africa
205054,Norbert Gymbr,SVK,Salernitana,Serie A,2021,29.0,1992.0,28.5,53,32,40,11,2,33,50,66.0,17,38,24,14,44,97,126,1,DF,25-29,Defender,Slovakia,Europe
192638,Nicolas Haas,SUI,Empoli,Serie A,2021,25.0,1996.0,11.1,35,22,15,10,10,17,39,43.6,22,24,4,20,9,44,17,1,MF,25-29,Midfielder,Switzerland,Europe
177779,Janik Haberer,GER,Freiburg,Bundesliga,2021,27.0,1994.0,9.1,14,8,5,6,3,7,19,36.8,12,11,4,7,16,30,11,0,MF,25-29,Midfielder,Germany,Europe
126281,Alexander Hack,GER,Mainz 05,Bundesliga,2021,27.0,1993.0,23.0,52,26,35,17,0,29,46,63.0,17,31,14,17,51,103,95,1,DF,25-29,Defender,Germany,Europe
223725,Munir El Haddadi,MAR,Sevilla,La Liga,2021,25.0,1995.0,5.3,8,4,1,6,1,2,8,25.0,6,7,1,6,5,13,2,0,"FW,MF",25-29,Forward,Morocco,Africa
42783,Andr Hahn,GER,Augsburg,Bundesliga,2021,30.0,1990.0,23.3,36,20,9,15,12,17,50,34.0,33,38,5,33,15,51,43,0,"MF,FW",30-34,Midfielder,Germany,Europe
402008,Amadou Haidara,MLI,RB Leipzig,Bundesliga,2021,23.0,1998.0,14.7,30,14,11,19,0,17,37,45.9,20,22,6,16,16,46,8,1,MF,20-24,Midfielder,Mali,Africa
283127,Oualid El Hajjam,MAR,Troyes,Ligue 1,2021,30.0,1991.0,11.9,22,11,12,6,4,15,23,65.2,8,12,6,6,22,44,28,0,DF,30-34,Defender,Morocco,Africa
398073,Achraf Hakimi,MAR,Paris S-G,Ligue 1,2021,22.0,1998.0,27.5,74,51,38,27,9,40,72,55.6,32,26,5,21,28,102,23,2,DF,20-24,Defender,Morocco,Africa
98349,Romain Hamouma,FRA,Saint-tienne,Ligue 1,2021,34.0,1987.0,9.8,10,7,1,5,4,2,13,15.4,11,8,0,8,4,14,1,0,"FW,MF",30-34,Forward,France,Europe
121385,Grant Hanley,SCO,Norwich City,Premier League,2021,29.0,1991.0,32.2,44,25,28,14,2,18,35,51.4,17,56,45,11,56,100,176,2,DF,25-29,Defender,Scotland,Europe
79377,Genki Haraguchi,JPN,Union Berlin,Bundesliga,2021,30.0,1991.0,19.5,37,20,12,22,3,15,48,31.3,33,25,3,22,26,63,15,0,MF,30-34,Midfielder,Japan,Asia
372711,Amine Harit,MAR,Marseille,Ligue 1,2021,24.0,1997.0,12.9,18,11,9,9,0,9,17,52.9,8,10,0,10,4,22,2,0,"FW,MF",20-24,Forward,Morocco,Africa
155423,Varazdat Haroyan,ARM,Cdiz,La Liga,2021,28.0,1992.0,16.0,31,21,20,10,1,19,29,65.5,10,22,12,10,15,46,62,0,DF,25-29,Defender,Armenia,Asia
417346,Jack Harrison,ENG,Leeds United,Premier League,2021,24.0,1996.0,29.3,57,37,22,22,13,31,76,40.8,45,35,1,34,21,78,19,0,"FW,MF",20-24,Forward,England,Europe
416386,Abdou Harroui,NED,Sassuolo,Serie A,2021,23.0,1998.0,5.0,11,4,4,7,0,8,11,72.7,3,14,0,14,4,15,5,0,MF,20-24,Midfielder,Netherlands,Europe
275303,Hans Hateboer,NED,Atalanta,Serie A,2021,27.0,1994.0,15.4,22,14,10,8,4,11,26,42.3,15,11,1,10,7,29,20,0,"DF,MF",25-29,Defender,Netherlands,Europe
233124,Kortney Hause,ENG,Aston Villa,Premier League,2021,26.0,1995.0,4.4,3,3,2,0,1,3,4,75.0,1,8,5,3,6,9,13,0,DF,25-29,Defender,England,Europe
309400,Kai Havertz,GER,Chelsea,Premier League,2021,22.0,1999.0,20.1,17,8,5,7,5,4,14,28.6,10,28,1,27,4,21,32,1,"FW,MF",20-24,Forward,Germany,Europe
206225,Isaac Hayden,ENG,Newcastle Utd,Premier League,2021,26.0,1995.0,11.1,28,14,11,14,3,12,29,41.4,17,17,8,9,14,42,24,0,"MF,DF",25-29,Midfielder,England,Europe
50202,Eden Hazard,BEL,Real Madrid,La Liga,2021,30.0,1991.0,8.0,6,3,3,2,1,3,7,42.9,4,3,0,3,2,8,0,0,"FW,MF",30-34,Forward,Belgium,Europe
108537,Jonas Hector,GER,Kln,Bundesliga,2021,31.0,1990.0,28.4,76,39,36,26,14,29,74,39.2,45,59,8,51,50,126,68,1,DF,30-34,Defender,Germany,Europe
237666,Silvan Hefti,SUI,Genoa,Serie A,2021,23.0,1997.0,14.3,50,30,23,22,5,32,58,55.2,26,20,4,16,20,70,34,1,DF,20-24,Defender,Switzerland,Europe
193867,Liam Henderson,SCO,Empoli,Serie A,2021,25.0,1996.0,22.4,22,13,7,8,7,9,31,29.0,22,14,4,10,9,31,13,0,MF,25-29,Midfielder,Scotland,Europe
148262,Jeff Hendrick,IRL,Newcastle Utd,Premier League,2021,29.0,1992.0,0.8,1,1,0,1,0,1,1,100.0,0,0,0,0,0,1,1,0,MF,25-29,Midfielder,Republic of Ireland,Europe
202591,Benjamin Henrichs,GER,RB Leipzig,Bundesliga,2021,24.0,1997.0,12.7,30,21,18,6,6,12,22,54.5,10,16,1,15,19,49,14,0,DF,20-24,Defender,Germany,Europe
691316,Luis Henrique,BRA,Marseille,Ligue 1,2021,19.0,2001.0,7.8,4,3,2,1,1,2,5,40.0,3,2,0,2,5,9,1,0,"FW,MF",Under 20,Forward,Brazil,South America
412513,Thomas Henry,FRA,Venezia,Serie A,2021,26.0,1994.0,23.5,9,4,2,3,4,5,13,38.5,8,11,5,6,2,11,25,0,FW,25-29,Forward,France,Europe
281963,Lucas Hernndez,FRA,Bayern Munich,Bundesliga,2021,25.0,1996.0,22.6,50,31,20,24,6,26,42,61.9,16,22,11,11,28,78,54,1,DF,25-29,Defender,France,Europe
339808,Theo Hernndez,FRA,Milan,Serie A,2021,23.0,1997.0,30.1,53,35,34,14,5,29,40,72.5,11,16,3,13,23,76,29,3,DF,20-24,Defender,France,Europe
181768,Hernani,BRA,Genoa,Serie A,2021,27.0,1994.0,7.6,20,10,8,9,3,13,32,40.6,19,17,4,13,13,33,5,1,"MF,FW",25-29,Midfielder,Brazil,South America
122043,Hctor Herrera,MEX,Atltico Madrid,La Liga,2021,31.0,1990.0,9.5,16,8,11,4,1,7,20,35.0,13,13,2,11,12,28,16,0,MF,30-34,Midfielder,Mexico,North America
378293,Yangel Herrera,VEN,Espanyol,La Liga,2021,23.0,1998.0,18.3,41,31,19,19,3,18,39,46.2,21,27,5,22,19,60,33,1,MF,20-24,Midfielder,Venezuela,South America
32711,Patrick Herrmann,GER,Gladbach,Bundesliga,2021,30.0,1991.0,8.4,15,7,5,6,4,9,24,37.5,15,10,1,9,6,21,8,0,"DF,FW",30-34,Defender,Germany,Europe
591949,Aaron Hickey,SCO,Bologna,Serie A,2021,19.0,2002.0,31.3,46,29,24,15,7,20,30,66.7,10,36,13,23,29,75,44,0,DF,Under 20,Defender,Scotland,Europe
659813,Piero Hincapi,ECU,Leverkusen,Bundesliga,2021,19.0,2002.0,19.5,33,23,23,8,2,19,25,76.0,6,34,15,19,33,66,56,2,DF,Under 20,Defender,Ecuador,South America
55099,Nicolas Hfler,GER,Freiburg,Bundesliga,2021,31.0,1990.0,28.9,73,42,37,29,7,28,62,45.2,34,50,21,29,46,119,42,0,MF,30-34,Midfielder,Germany,Europe
227085,Jonas Hofmann,GER,Gladbach,Bundesliga,2021,29.0,1992.0,23.1,30,20,6,17,7,17,42,40.5,25,23,0,23,12,42,10,0,"MF,FW",25-29,Midfielder,Germany,Europe
248999,Lucas Hler,GER,Freiburg,Bundesliga,2021,27.0,1994.0,28.7,41,25,10,17,14,13,28,46.4,15,25,4,21,17,58,39,2,FW,25-29,Forward,Germany,Europe
190289,Gerrit Holtmann,PHI,Bochum,Bundesliga,2021,26.0,1995.0,20.4,15,9,5,3,7,6,22,27.3,16,26,2,24,8,23,6,0,"FW,MF",25-29,Forward,Philippines,Asia
229006,Franck Honorat,FRA,Brest,Ligue 1,2021,24.0,1996.0,32.2,54,38,25,13,16,27,47,57.4,20,24,2,22,15,69,25,0,"FW,MF",20-24,Forward,France,Europe
231586,Jannes Horn,GER,Kln,Bundesliga,2021,24.0,1997.0,5.3,6,4,4,2,0,4,8,50.0,4,1,1,0,3,9,9,0,DF,20-24,Defender,Germany,Europe
388160,Fraser Hornby,SCO,Reims,Ligue 1,2021,21.0,1999.0,3.9,3,1,1,2,0,0,2,0.0,2,3,0,3,4,7,5,0,"FW,MF",20-24,Forward,Scotland,Europe
171209,Branimir Hrgota,SWE,Greuther Frth,Bundesliga,2021,28.0,1993.0,30.9,46,29,10,31,5,21,72,29.2,51,27,1,26,11,57,3,1,FW,25-29,Forward,Sweden,Europe
372809,Petko Hristov,BUL,Spezia,Serie A,2021,22.0,1999.0,13.9,17,10,11,6,0,10,16,62.5,6,29,23,6,19,36,47,0,DF,20-24,Defender,Bulgaria,Europe
236981,Timo Hbers,GER,Kln,Bundesliga,2021,25.0,1996.0,19.3,45,27,28,17,0,27,45,60.0,18,31,19,12,52,97,95,0,DF,25-29,Defender,Germany,Europe
52348,Benjamin Hbner,GER,Hoffenheim,Bundesliga,2021,32.0,1989.0,4.2,9,5,0,7,2,3,5,60.0,2,2,2,0,9,18,7,0,DF,30-34,Defender,Germany,Europe
392768,Callum Hudson-Odoi,ENG,Chelsea,Premier League,2021,20.0,2000.0,10.7,14,10,5,6,3,8,23,34.8,15,8,0,8,2,16,6,1,"MF,FW",20-24,Midfielder,England,Europe
200056,Elseid Hysaj,ALB,Lazio,Serie A,2021,27.0,1994.0,22.5,46,30,25,17,4,29,45,64.4,16,18,6,12,24,70,34,1,DF,25-29,Defender,Albania,Europe
520468,Iago,BRA,Augsburg,Bundesliga,2021,24.0,1997.0,24.2,49,29,25,19,5,15,34,44.1,19,28,6,22,27,76,62,0,DF,20-24,Defender,Brazil,South America
3455,Zlatan Ibrahimovi,SWE,Milan,Serie A,2021,39.0,1981.0,11.3,0,0,0,0,0,0,2,0.0,2,2,1,1,3,3,9,0,FW,35-39,Forward,Sweden,Europe
380350,Igor,BRA,Fiorentina,Serie A,2021,23.0,1998.0,24.9,53,31,34,16,3,30,40,75.0,10,37,19,18,31,84,46,4,DF,20-24,Defender,Brazil,South America
295330,Kelechi Iheanacho,NGA,Leicester City,Premier League,2021,24.0,1996.0,14.0,10,7,2,5,3,3,14,21.4,11,19,0,19,4,14,10,0,FW,20-24,Forward,Nigeria,Africa
134294,Danny Ings,ENG,Aston Villa,Premier League,2021,29.0,1992.0,21.1,23,16,2,16,5,13,37,35.1,24,31,2,29,6,29,22,0,FW,25-29,Forward,England,Europe
333383,Bonke Innocent,NGA,Lorient,Ligue 1,2021,25.0,1996.0,9.7,27,16,10,16,1,11,26,42.3,15,11,3,8,16,43,14,0,MF,25-29,Midfielder,Nigeria,Africa
133964,Lorenzo Insigne,ITA,Napoli,Serie A,2021,30.0,1991.0,25.4,23,14,8,12,3,8,44,18.2,36,30,1,29,20,43,3,1,FW,30-34,Forward,Italy,Europe
349066,Alexander Isak,SWE,Real Sociedad,La Liga,2021,21.0,1999.0,23.8,7,4,1,3,3,2,12,16.7,10,14,2,12,3,10,10,0,FW,20-24,Forward,Sweden,Europe
435228,Ardian Ismajli,ALB,Empoli,Serie A,2021,24.0,1996.0,14.1,13,9,8,4,1,5,14,35.7,9,21,11,10,24,37,80,0,DF,20-24,Defender,Albania,Europe
353892,Hiroki Ito,JPN,Stuttgart,Bundesliga,2021,22.0,1999.0,26.1,43,31,21,19,3,25,43,58.1,18,40,19,21,53,96,95,0,DF,20-24,Defender,Japan,Asia
243856,Cedric Itten,SUI,Greuther Frth,Bundesliga,2021,24.0,1996.0,7.1,5,2,1,2,2,1,6,16.7,5,3,0,3,2,7,4,0,FW,20-24,Forward,Switzerland,Europe
242631,Alex Iwobi,NGA,Everton,Premier League,2021,25.0,1996.0,22.6,40,19,23,12,5,21,52,40.4,31,39,3,36,20,60,25,2,"MF,DF",25-29,Midfielder,Nigeria,Africa
270171,Vitaly Janelt,GER,Brentford,Premier League,2021,23.0,1998.0,25.5,61,32,26,27,8,27,53,50.9,26,23,7,16,28,89,35,0,MF,20-24,Midfielder,Germany,Europe
125314,Pontus Jansson,SWE,Brentford,Premier League,2021,30.0,1991.0,36.9,40,21,32,8,0,22,34,64.7,12,37,27,10,52,92,187,0,DF,30-34,Defender,Sweden,Europe
177847,Adnan Januzaj,BEL,Real Sociedad,La Liga,2021,26.0,1995.0,18.1,17,11,5,8,4,9,24,37.5,15,15,3,12,12,29,15,0,"FW,MF",25-29,Forward,Belgium,Europe
20463,Corentin Jean,FRA,Lens,Ligue 1,2021,26.0,1995.0,2.8,9,6,4,4,1,3,6,50.0,3,5,0,5,1,10,0,0,"FW,MF",25-29,Forward,France,Europe
258254,Jemerson,BRA,Metz,Ligue 1,2021,28.0,1992.0,13.4,37,25,30,7,0,18,26,69.2,8,23,8,15,25,62,33,1,DF,25-29,Defender,Brazil,South America
249157,Fredrik Jensen,FIN,Augsburg,Bundesliga,2021,23.0,1997.0,4.6,5,4,1,3,1,4,7,57.1,3,5,1,4,2,7,4,0,"MF,FW",20-24,Midfielder,Finland,Europe
460245,Moritz Jenz,GER,Lorient,Ligue 1,2021,22.0,1999.0,15.3,26,12,18,6,2,11,24,45.8,13,19,11,8,28,54,55,0,DF,20-24,Defender,Germany,Europe
363205,Gabriel Jesus,BRA,Manchester City,Premier League,2021,24.0,1997.0,20.9,18,12,2,4,12,6,26,23.1,20,18,0,18,15,33,8,0,FW,20-24,Forward,Brazil,South America
121985,Juan Jesus,BRA,Napoli,Serie A,2021,30.0,1991.0,14.2,25,17,14,11,0,12,18,66.7,6,21,16,5,9,34,34,0,DF,30-34,Defender,Brazil,South America
876440,Joo Pedro,BRA,Watford,Premier League,2021,19.0,2001.0,18.3,20,14,7,8,5,6,23,26.1,17,23,3,20,15,35,17,0,"FW,MF",Under 20,Forward,Brazil,South America
333241,Joelinton,BRA,Newcastle Utd,Premier League,2021,24.0,1996.0,28.4,72,38,30,33,9,26,61,42.6,35,46,11,35,34,106,50,2,"MF,FW",20-24,Midfielder,Brazil,South America
468002,Ben Johnson,ENG,West Ham,Premier League,2021,21.0,2000.0,15.5,33,16,15,15,3,21,28,75.0,7,16,8,8,22,55,55,0,DF,20-24,Defender,England,Europe
433188,Curtis Jones,ENG,Liverpool,Premier League,2021,20.0,2001.0,9.5,11,9,3,6,2,1,10,10.0,9,4,0,4,6,17,4,0,MF,20-24,Midfielder,England,Europe
326330,Frenkie de Jong,NED,Barcelona,La Liga,2021,24.0,1997.0,27.5,35,19,12,18,5,12,23,52.2,11,19,5,14,20,55,16,0,MF,20-24,Midfielder,Netherlands,Europe
620477,Kaio Jorge,BRA,Juventus,Serie A,2021,19.0,2002.0,1.3,2,1,0,2,0,1,3,33.3,2,1,0,1,0,2,2,0,"MF,FW",Under 20,Midfielder,Brazil,South America
512356,Jorginho,ITA,Chelsea,Premier League,2021,29.0,1991.0,25.3,64,33,27,31,6,29,83,34.9,54,27,4,23,36,100,21,1,MF,25-29,Midfielder,Italy,Europe
122155,Willian Jos,BRA,Betis,La Liga,2021,29.0,1991.0,17.8,15,13,2,10,3,2,8,25.0,6,10,2,8,3,18,16,0,FW,25-29,Forward,Brazil,South America
340950,Diogo Jota,POR,Liverpool,Premier League,2021,24.0,1996.0,26.3,39,18,12,18,9,13,55,23.6,42,19,2,17,6,45,6,0,FW,20-24,Forward,Portugal,Europe
413220,James Justin,ENG,Leicester City,Premier League,2021,23.0,1998.0,11.1,22,13,11,8,3,7,15,46.7,8,16,4,12,17,39,34,0,DF,20-24,Defender,England,Europe
361260,Ozan Kabak,TUR,Norwich City,Premier League,2021,21.0,2000.0,10.2,10,5,4,6,0,5,9,55.6,4,19,11,8,16,26,26,0,DF,20-24,Defender,Turkey,Asia
649452,Issa Kabor,BFA,Troyes,Ligue 1,2021,20.0,2001.0,25.0,45,22,22,14,9,20,38,52.6,18,27,2,25,20,65,38,1,"DF,MF",20-24,Defender,Burkina Faso,Africa
384060,Tino Kadewere,ZIM,Lyon,Ligue 1,2021,25.0,1996.0,5.6,7,5,2,2,3,4,13,30.8,9,7,0,7,4,11,1,1,FW,25-29,Forward,Zimbabwe,Africa
106270,Florian Kainz,AUT,Kln,Bundesliga,2021,28.0,1992.0,25.8,41,26,9,25,7,23,51,45.1,28,27,3,24,32,73,24,0,"MF,FW",25-29,Midfielder,Austria,Europe
74297,Gal Kakuta,COD,Lens,Ligue 1,2021,30.0,1991.0,18.6,22,14,2,13,7,4,20,20.0,16,10,0,10,4,26,3,0,"MF,FW",30-34,Midfielder,DR Congo,Africa
369567,Sasa Kalajdzic,AUT,Stuttgart,Bundesliga,2021,24.0,1997.0,13.6,10,6,2,5,3,3,11,27.3,8,5,0,5,2,12,14,0,FW,20-24,Forward,Austria,Europe
623040,Yayah Kallon,SLE,Genoa,Serie A,2021,20.0,2001.0,7.1,15,11,5,6,4,3,11,27.3,8,7,1,6,1,16,5,0,"FW,MF",20-24,Forward,Sierra Leone,Africa
424051,Samuel Kalu,NGA,Watford,Premier League,2021,23.0,1997.0,2.5,2,2,0,2,0,1,1,100.0,0,2,0,2,3,5,3,0,FW,20-24,Forward,Nigeria,Africa
585949,Pierre Kalulu,FRA,Milan,Serie A,2021,21.0,2000.0,21.6,61,36,36,21,4,17,22,77.3,5,36,15,21,26,87,54,0,DF,20-24,Defender,France,Europe
356141,Daichi Kamada,JPN,Eint Frankfurt,Bundesliga,2021,24.0,1996.0,23.8,40,21,7,26,7,11,40,27.5,29,18,0,18,8,48,10,0,MF,20-24,Midfielder,Japan,Asia
394327,Boubacar Kamara,FRA,Marseille,Ligue 1,2021,21.0,1999.0,30.9,68,38,27,36,5,26,47,55.3,21,29,10,19,46,114,44,1,"MF,DF",20-24,Midfielder,France,Europe
290017,Hassane Kamara,CIV,Watford,Premier League,2021,27.0,1994.0,18.0,53,34,31,16,6,27,43,62.8,16,20,4,16,69,122,67,0,DF,25-29,Defender,Ivory Coast,Africa
132098,Harry Kane,ENG,Tottenham,Premier League,2021,28.0,1993.0,35.9,15,5,2,10,3,7,18,38.9,11,26,8,18,3,18,39,0,FW,25-29,Forward,England,Europe
225083,N'Golo Kant,FRA,Chelsea,Premier League,2021,30.0,1991.0,19.7,59,31,20,27,12,25,40,62.5,15,37,2,35,31,90,8,0,MF,30-34,Midfielder,France,Europe
298635,Grigoris Kastanos,CYP,Salernitana,Serie A,2021,23.0,1998.0,15.0,30,19,9,19,2,7,23,30.4,16,21,5,16,22,52,8,0,"MF,FW",20-24,Midfielder,Cyprus,Asia
739769,Ilan Kebbal,ALG,Reims,Ligue 1,2021,23.0,1998.0,19.7,31,15,13,10,8,12,44,27.3,32,16,0,16,13,44,3,0,"MF,FW",20-24,Midfielder,Algeria,Africa
228948,Thilo Kehrer,GER,Paris S-G,Ligue 1,2021,24.0,1996.0,16.8,21,14,9,11,1,9,21,42.9,12,19,11,8,24,45,29,0,DF,20-24,Defender,Germany,Europe
302215,Naby Keta,GUI,Liverpool,Premier League,2021,26.0,1995.0,13.0,46,23,17,19,10,26,42,61.9,16,33,2,31,14,60,8,0,MF,25-29,Midfielder,Guinea,Africa
342039,Yannik Keitel,GER,Freiburg,Bundesliga,2021,21.0,2000.0,5.6,11,4,5,4,2,5,15,33.3,10,7,1,6,1,12,8,0,MF,20-24,Midfielder,Germany,Europe
294808,Franck Kessi,CIV,Milan,Serie A,2021,24.0,1996.0,25.6,41,23,12,24,5,17,26,65.4,9,39,10,29,23,64,22,0,MF,20-24,Midfielder,Ivory Coast,Africa
270411,Saf-Eddine Khaoui,TUN,Clermont Foot,Ligue 1,2021,26.0,1995.0,10.3,19,10,5,10,4,9,18,50.0,9,9,0,9,14,33,5,0,"MF,FW",25-29,Midfielder,Tunisia,Africa
103565,Wahbi Khazri,TUN,Saint-tienne,Ligue 1,2021,30.0,1991.0,24.7,33,18,7,17,9,9,34,26.5,25,21,0,21,12,45,7,0,"FW,MF",30-34,Forward,Tunisia,Africa
161056,Joshua Kimmich,GER,Bayern Munich,Bundesliga,2021,26.0,1995.0,27.5,39,20,14,17,8,18,58,31.0,40,34,8,26,52,91,29,1,MF,25-29,Midfielder,Germany,Europe
282041,Presnel Kimpembe,FRA,Paris S-G,Ligue 1,2021,25.0,1995.0,28.6,34,19,18,15,1,14,23,60.9,9,20,14,6,38,72,73,1,DF,25-29,Defender,France,Europe
60394,Philipp Klement,GER,Stuttgart,Bundesliga,2021,28.0,1992.0,3.8,7,3,1,4,2,3,3,100.0,0,6,1,5,1,8,0,0,MF,25-29,Midfielder,Germany,Europe
78147,Fabian Klos,GER,Arminia,Bundesliga,2021,33.0,1987.0,15.8,7,5,0,5,2,2,10,20.0,8,17,4,13,0,7,31,0,FW,30-34,Forward,Germany,Europe
215599,Lukas Klostermann,GER,RB Leipzig,Bundesliga,2021,25.0,1996.0,18.3,29,16,11,15,3,13,19,68.4,6,16,3,13,26,55,58,0,DF,25-29,Defender,Germany,Europe
330659,Justin Kluivert,NED,Nice,Ligue 1,2021,22.0,1999.0,20.8,19,9,6,12,1,5,21,23.8,16,13,1,12,14,33,6,0,MF,20-24,Midfielder,Netherlands,Europe
118847,Dominik Kohr,GER,Mainz 05,Bundesliga,2021,27.0,1994.0,17.9,40,20,18,19,3,16,42,38.1,26,21,2,19,35,75,22,0,MF,25-29,Midfielder,Germany,Europe
487969,Randal Kolo Muani,FRA,Nantes,Ligue 1,2021,22.0,1998.0,32.8,28,14,7,10,11,10,25,40.0,15,14,3,11,6,34,31,0,"FW,MF",20-24,Forward,France,Europe
84085,Timothe Kolodziejczak,FRA,Saint-tienne,Ligue 1,2021,29.0,1991.0,28.5,43,24,22,14,7,20,36,55.6,16,29,7,22,60,103,72,1,DF,25-29,Defender,France,Europe
422850,Ghislain Konan,CIV,Reims,Ligue 1,2021,25.0,1995.0,26.9,35,19,19,15,1,16,30,53.3,14,35,8,27,28,63,45,0,DF,25-29,Defender,Ivory Coast,Africa
127189,Geoffrey Kondogbia,CTA,Atltico Madrid,La Liga,2021,28.0,1993.0,20.9,74,44,25,40,9,21,49,42.9,28,16,5,11,44,118,24,0,"MF,DF",25-29,Midfielder,Central African Republic,Africa
413403,Ezri Konsa,ENG,Aston Villa,Premier League,2021,23.0,1997.0,27.5,25,15,13,11,1,10,13,76.9,3,31,22,9,15,40,86,2,DF,20-24,Defender,England,Europe
360518,Teun Koopmeiners,NED,Atalanta,Serie A,2021,23.0,1998.0,23.6,40,24,10,19,11,22,54,40.7,32,31,2,29,15,55,19,0,MF,20-24,Midfielder,Netherlands,Europe
644771,Odilon Kossounou,CIV,Leverkusen,Bundesliga,2021,20.0,2001.0,19.9,23,17,16,6,1,15,25,60.0,10,36,14,22,26,49,66,0,DF,20-24,Defender,Ivory Coast,Africa
277635,Rominigue Kouam,MLI,Troyes,Ligue 1,2021,24.0,1996.0,33.0,47,22,24,20,3,19,58,32.8,39,33,5,28,46,93,22,2,MF,20-24,Midfielder,Mali,Africa
93128,Kalidou Koulibaly,SEN,Napoli,Serie A,2021,30.0,1991.0,26.7,39,23,31,6,2,25,38,65.8,13,41,25,16,29,68,90,1,DF,30-34,Defender,Senegal,Africa
411975,Jules Kound,FRA,Sevilla,La Liga,2021,22.0,1998.0,30.4,40,17,27,10,3,18,28,64.3,10,33,18,15,21,61,101,2,DF,20-24,Defender,France,Europe
203842,Viktor Kovalenko,UKR,Spezia,Serie A,2021,25.0,1996.0,14.7,16,10,7,8,1,9,21,42.9,12,16,3,13,13,29,8,0,MF,25-29,Midfielder,Ukraine,Europe
184528,Emil Krafth,SWE,Newcastle Utd,Premier League,2021,26.0,1994.0,18.2,37,16,25,11,1,27,36,75.0,9,16,10,6,25,62,56,0,DF,25-29,Defender,Sweden,Europe
82097,Christoph Kramer,GER,Gladbach,Bundesliga,2021,30.0,1991.0,8.3,28,11,15,10,3,12,28,42.9,16,18,5,13,12,40,9,0,MF,30-34,Midfielder,Germany,Europe
358515,Jean-Philippe Krasso,CIV,Saint-tienne,Ligue 1,2021,24.0,1997.0,5.0,7,5,0,5,2,2,10,20.0,8,7,1,6,0,7,1,0,FW,20-24,Forward,Ivory Coast,Africa
31909,Toni Kroos,GER,Real Madrid,La Liga,2021,31.0,1990.0,23.4,34,26,13,17,4,14,36,38.9,22,16,3,13,12,46,13,1,MF,30-34,Midfielder,Germany,Europe
93604,Lukas Kbler,GER,Freiburg,Bundesliga,2021,28.0,1992.0,25.9,62,35,38,16,8,28,49,57.1,21,24,8,16,44,106,70,0,"DF,MF",25-29,Defender,Germany,Europe
405398,Takefusa Kubo,JPN,Mallorca,La Liga,2021,20.0,2001.0,17.8,31,19,12,14,5,10,24,41.7,14,24,3,21,8,39,4,0,"FW,MF",20-24,Forward,Japan,Asia
74943,Juraj Kucka,SVK,Watford,Premier League,2021,34.0,1987.0,21.3,59,39,32,25,2,27,73,37.0,46,30,9,21,27,86,46,2,MF,30-34,Midfielder,Slovakia,Europe
431755,Dejan Kulusevski,SWE,Tottenham,Premier League,2021,21.0,2000.0,14.0,19,13,7,10,2,5,23,21.7,18,14,0,14,13,32,3,0,"MF,FW",20-24,Midfielder,Sweden,Europe
334186,Fabian Kunze,GER,Arminia,Bundesliga,2021,23.0,1998.0,14.0,35,21,14,20,1,15,32,46.9,17,17,2,15,19,54,27,1,MF,20-24,Midfielder,Germany,Europe
181378,Gatan Laborde,FRA,Montpellier,Ligue 1,2021,27.0,1994.0,3.8,2,2,1,1,0,2,4,50.0,2,3,0,3,5,7,5,0,FW,25-29,Forward,France,Europe
93720,Alexandre Lacazette,FRA,Arsenal,Premier League,2021,30.0,1991.0,19.8,27,10,8,13,6,7,21,33.3,14,12,1,11,5,32,6,0,FW,30-34,Forward,France,Europe
223967,Konrad Laimer,AUT,RB Leipzig,Bundesliga,2021,24.0,1997.0,13.8,38,24,11,22,5,24,53,45.3,29,29,3,26,4,42,9,0,MF,20-24,Midfielder,Austria,Europe
85791,Stefan Lainer,AUT,Gladbach,Bundesliga,2021,28.0,1992.0,16.3,19,11,9,7,3,12,28,42.9,16,24,5,19,14,33,31,0,DF,25-29,Defender,Austria,Europe
43530,Adam Lallana,ENG,Brighton,Premier League,2021,33.0,1988.0,17.3,34,17,14,14,6,12,41,29.3,29,16,6,10,16,50,13,1,MF,30-34,Midfielder,England,Europe
504148,Tariq Lamptey,GHA,Brighton,Premier League,2021,20.0,2000.0,17.3,36,25,14,17,5,15,25,60.0,10,13,3,10,21,57,23,0,"DF,FW",20-24,Defender,Ghana,Africa
386057,Julien Laporte,FRA,Lorient,Ligue 1,2021,27.0,1993.0,32.1,63,45,35,26,2,32,64,50.0,32,37,22,15,54,117,174,0,DF,25-29,Defender,France,Europe
554251,Yasser Larouci,ALG,Troyes,Ligue 1,2021,20.0,2001.0,3.8,6,5,2,4,0,3,3,100.0,0,1,0,1,7,13,5,0,DF,20-24,Defender,Algeria,Africa
183318,Jamaal Lascelles,ENG,Newcastle Utd,Premier League,2021,27.0,1993.0,22.9,15,7,9,5,1,4,12,33.3,8,38,28,10,22,37,121,1,DF,25-29,Defender,England,Europe
477109,Bryan Lasme,FRA,Arminia,Bundesliga,2021,22.0,1998.0,9.7,6,6,1,2,3,0,3,0.0,3,7,0,7,1,7,9,0,FW,20-24,Forward,France,Europe
93726,Paul Lasne,FRA,Brest,Ligue 1,2021,32.0,1989.0,9.4,26,12,6,16,4,8,18,44.4,10,11,2,9,24,50,10,0,MF,30-34,Midfielder,France,Europe
737781,Jrmy Le Douaron,FRA,Brest,Ligue 1,2021,23.0,1998.0,16.1,11,5,4,4,3,1,17,5.9,16,15,0,15,4,15,14,0,"FW,MF",20-24,Forward,France,Europe
633992,Enzo Le Fe,FRA,Lorient,Ligue 1,2021,21.0,2000.0,24.4,70,44,25,36,9,41,90,45.6,49,25,1,24,29,99,18,0,"MF,FW",20-24,Midfielder,France,Europe
120651,Vincent Le Goff,FRA,Lorient,Ligue 1,2021,31.0,1989.0,34.0,61,38,38,19,4,37,62,59.7,25,18,3,15,37,98,50,0,DF,30-34,Defender,France,Europe
357164,Rafael Leo,POR,Milan,Serie A,2021,22.0,1999.0,28.9,17,7,3,9,5,10,20,50.0,10,12,1,11,12,29,8,0,FW,20-24,Forward,Portugal,Europe
377393,Pierre Lees-Melou,FRA,Norwich City,Premier League,2021,28.0,1993.0,25.2,58,36,23,29,6,25,92,27.2,67,37,11,26,25,83,23,0,MF,25-29,Midfielder,France,Europe
127108,Florian Lejeune,FRA,Alavs,La Liga,2021,30.0,1991.0,30.0,33,24,22,10,1,12,20,60.0,8,30,19,11,31,64,158,0,DF,30-34,Defender,France,Europe
205562,Thomas Lemar,FRA,Atltico Madrid,La Liga,2021,25.0,1995.0,16.0,24,14,9,12,3,8,23,34.8,15,18,0,18,8,32,11,0,MF,25-29,Midfielder,France,Europe
553285,Tim Lemperle,GER,Kln,Bundesliga,2021,19.0,2002.0,1.7,4,1,2,1,1,1,3,33.3,2,1,0,1,2,6,2,0,"FW,MF",Under 20,Forward,Germany,Europe
182904,Clment Lenglet,FRA,Barcelona,La Liga,2021,26.0,1995.0,9.2,20,11,11,7,2,8,13,61.5,5,7,3,4,13,33,21,0,DF,25-29,Defender,France,Europe
14221,Aaron Lennon,ENG,Burnley,Premier League,2021,34.0,1987.0,17.2,33,17,10,13,10,10,34,29.4,24,26,4,22,9,42,14,0,"MF,FW",30-34,Midfielder,England,Europe
518505,Jamie Leweling,GER,Greuther Frth,Bundesliga,2021,20.0,2001.0,21.8,13,8,3,7,3,3,16,18.8,13,9,0,9,13,26,5,0,"FW,MF",20-24,Forward,Germany,Europe
314940,Dimitri Linard,FRA,Strasbourg,Ligue 1,2021,33.0,1988.0,22.7,71,43,40,21,10,46,77,59.7,31,12,0,12,21,92,28,0,"DF,MF",30-34,Defender,France,Europe
225657,Philipp Lienhart,AUT,Freiburg,Bundesliga,2021,25.0,1996.0,31.9,24,13,17,6,1,13,24,54.2,11,33,23,10,50,74,158,1,DF,25-29,Defender,Austria,Europe
557610,Isaac Lihadji,FRA,Lille,Ligue 1,2021,19.0,2002.0,2.6,3,3,1,1,1,1,5,20.0,4,1,0,1,2,5,0,0,"MF,FW",Under 20,Midfielder,France,Europe
184573,Victor Lindelf,SWE,Manchester Utd,Premier League,2021,27.0,1994.0,26.2,16,11,9,7,0,9,14,64.3,5,26,17,9,25,41,96,0,DF,25-29,Defender,Sweden,Europe
513245,Jesper Lindstrm,DEN,Eint Frankfurt,Bundesliga,2021,21.0,2000.0,22.0,28,13,6,13,9,12,36,33.3,24,30,0,30,24,52,11,1,"MF,FW",20-24,Midfielder,Denmark,Europe
141660,Jesse Lingard,ENG,Manchester Utd,Premier League,2021,28.0,1992.0,4.1,9,7,4,3,2,2,6,33.3,4,4,0,4,0,9,1,0,"FW,MF",25-29,Forward,England,Europe
287188,Dejan Ljubicic,AUT,Kln,Bundesliga,2021,23.0,1997.0,21.9,33,19,12,13,8,13,49,26.5,36,19,1,18,15,48,11,0,"MF,FW",20-24,Midfielder,Austria,Europe
192735,Stanislav Lobotka,SVK,Napoli,Serie A,2021,26.0,1994.0,18.7,39,24,16,20,3,14,36,38.9,22,9,1,8,12,51,13,1,MF,25-29,Midfielder,Slovakia,Europe
805908,Bradley Locko,FRA,Reims,Ligue 1,2021,19.0,2002.0,11.2,28,19,13,11,4,14,24,58.3,10,20,8,12,14,42,15,0,"MF,DF",Under 20,Midfielder,France,Europe
202886,Ruben Loftus-Cheek,ENG,Chelsea,Premier League,2021,25.0,1996.0,15.5,29,10,16,11,2,10,19,52.6,9,15,6,9,11,40,17,0,"MF,DF",25-29,Midfielder,England,Europe
37304,Shane Long,IRL,Southampton,Premier League,2021,34.0,1987.0,3.4,9,5,2,4,3,1,1,100.0,0,4,0,4,0,9,2,0,FW,30-34,Forward,Republic of Ireland,Europe
346707,Sean Longstaff,ENG,Newcastle Utd,Premier League,2021,23.0,1997.0,16.3,54,34,18,31,5,24,65,36.9,41,18,6,12,9,63,18,0,MF,20-24,Midfielder,England,Europe
406040,Ademola Lookman,NGA,Leicester City,Premier League,2021,23.0,1997.0,16.1,32,14,10,13,9,10,28,35.7,18,19,1,18,10,42,4,0,"FW,MF",20-24,Forward,Nigeria,Africa
649033,Dion Lopy,SEN,Reims,Ligue 1,2021,19.0,2002.0,18.2,53,29,22,24,7,21,53,39.6,32,20,4,16,22,75,17,0,MF,Under 20,Midfielder,Senegal,Africa
111266,Anthony Losilla,FRA,Bochum,Bundesliga,2021,35.0,1986.0,32.6,65,39,29,30,6,34,69,49.3,35,32,9,23,70,135,53,1,MF,35-39,Midfielder,France,Europe
260655,Eduard Lwen,GER,Bochum,Bundesliga,2021,24.0,1997.0,15.7,28,22,12,11,5,10,43,23.3,33,17,2,15,9,37,15,1,MF,20-24,Midfielder,Germany,Europe
316889,Hirving Lozano,MEX,Napoli,Serie A,2021,26.0,1995.0,17.9,28,20,12,11,5,8,30,26.7,22,24,0,24,9,37,9,0,FW,25-29,Forward,Mexico,North America
578872,Jean Lucas,BRA,Monaco,Ligue 1,2021,23.0,1998.0,16.1,43,25,14,24,5,17,40,42.5,23,15,5,10,13,56,4,1,MF,20-24,Midfielder,Brazil,South America
240274,Anderson Lucoqui,ANG,Mainz 05,Bundesliga,2021,24.0,1997.0,8.3,22,10,11,6,5,11,22,50.0,11,15,3,12,11,33,10,0,DF,20-24,Defender,Angola,Africa
125020,Jos Luis Palomino,ARG,Atalanta,Serie A,2021,31.0,1990.0,29.7,78,40,42,33,3,32,50,64.0,18,43,21,22,100,178,80,2,DF,30-34,Defender,Argentina,South America
447661,Douglas Luiz,BRA,Aston Villa,Premier League,2021,23.0,1998.0,30.2,59,39,30,24,5,21,72,29.2,51,30,7,23,34,93,28,1,MF,20-24,Midfielder,Brazil,South America
96341,Romelu Lukaku,BEL,Chelsea,Premier League,2021,28.0,1993.0,17.7,2,1,0,1,1,1,5,20.0,4,11,1,10,0,2,20,0,FW,25-29,Forward,Belgium,Europe
618472,Castello Lukeba,FRA,Lyon,Ligue 1,2021,18.0,2002.0,23.3,34,19,27,7,0,15,23,65.2,8,18,9,9,38,72,64,2,DF,Under 20,Defender,France,Europe
278531,Sebastiano Luperto,ITA,Empoli,Serie A,2021,24.0,1996.0,21.8,29,17,17,10,2,10,20,50.0,10,32,26,6,45,74,132,0,DF,20-24,Defender,Italy,Europe
379807,Lyanco,BRA,Southampton,Premier League,2021,24.0,1997.0,10.1,18,15,11,7,0,10,18,55.6,8,18,13,5,13,31,50,1,DF,20-24,Defender,Brazil,South America
534033,Alexis Mac Allister,ARG,Brighton,Premier League,2021,22.0,1998.0,23.6,65,40,23,30,12,29,68,42.6,39,37,7,30,13,78,22,0,"MF,FW",20-24,Midfielder,Argentina,South America
211251,Darwin Machs,VEN,Granada,La Liga,2021,28.0,1993.0,15.3,23,13,11,8,4,9,23,39.1,14,10,0,10,15,38,17,0,"MF,FW",25-29,Midfielder,Venezuela,South America
294057,James Maddison,ENG,Leicester City,Premier League,2021,24.0,1996.0,27.3,40,20,8,24,8,14,46,30.4,32,18,3,15,11,51,12,0,"MF,FW",20-24,Midfielder,England,Europe
461790,Louis Mafouta,CTA,Metz,Ligue 1,2021,27.0,1994.0,5.8,0,0,0,0,0,0,5,0.0,5,1,0,1,0,0,4,0,FW,25-29,Forward,Central African Republic,Africa
435338,Gabriel Magalhes,BRA,Arsenal,Premier League,2021,23.0,1997.0,34.0,50,30,36,12,2,30,41,73.2,11,34,26,8,13,63,112,4,DF,20-24,Defender,Brazil,South America
353796,Giulio Maggiore,ITA,Spezia,Serie A,2021,23.0,1998.0,31.3,58,32,20,32,6,31,77,40.3,46,30,5,25,29,87,33,0,MF,20-24,Midfielder,Italy,Europe
474662,Hugo Magnetti,FRA,Brest,Ligue 1,2021,23.0,1998.0,16.3,50,34,27,20,3,22,50,44.0,28,14,3,11,25,75,13,0,MF,20-24,Midfielder,France,Europe
594997,Yohann Magnin,FRA,Clermont Foot,Ligue 1,2021,24.0,1997.0,19.1,53,31,22,26,5,24,42,57.1,18,17,7,10,20,73,36,0,"MF,DF",20-24,Midfielder,France,Europe
177907,Harry Maguire,ENG,Manchester Utd,Premier League,2021,28.0,1993.0,27.9,34,21,22,8,4,19,31,61.3,12,36,29,7,32,66,101,3,DF,25-29,Defender,England,Europe
296397,Arne Maier,GER,Augsburg,Bundesliga,2021,22.0,1999.0,20.7,20,13,6,10,4,8,26,30.8,18,18,1,17,15,35,13,0,MF,20-24,Midfielder,Germany,Europe
293944,Habib Maga,CIV,Metz,Ligue 1,2021,25.0,1996.0,14.1,47,28,29,13,5,24,48,50.0,24,20,7,13,14,61,18,0,MF,25-29,Midfielder,Ivory Coast,Africa
387106,Lovro Majer,CRO,Rennes,Ligue 1,2021,23.0,1998.0,20.4,32,21,9,14,9,11,42,26.2,31,26,2,24,11,43,9,0,"MF,FW",20-24,Midfielder,Croatia,Europe
322305,Jean-Victor Makengo,FRA,Udinese,Serie A,2021,23.0,1998.0,26.1,30,21,7,17,6,15,29,51.7,14,26,6,20,19,49,17,0,MF,20-24,Midfielder,France,Europe
539134,Daniel Maldini,ITA,Milan,Serie A,2021,19.0,2001.0,1.6,8,3,4,3,1,2,6,33.3,4,4,0,4,1,9,0,0,MF,Under 20,Midfielder,Italy,Europe
324377,Youssef Maleh,MAR,Fiorentina,Serie A,2021,22.0,1998.0,11.3,27,16,8,13,6,12,25,48.0,13,14,1,13,6,33,2,0,MF,20-24,Midfielder,Morocco,Africa
326029,Donyell Malen,NED,Dortmund,Bundesliga,2021,22.0,1999.0,18.7,13,10,4,5,4,7,13,53.8,6,10,0,10,10,23,11,0,FW,20-24,Forward,Netherlands,Europe
207877,Ruslan Malinovskyi,UKR,Atalanta,Serie A,2021,28.0,1993.0,17.7,18,10,3,10,5,5,19,26.3,14,27,3,24,5,23,1,0,"MF,FW",25-29,Midfielder,Ukraine,Europe
256448,Gianluca Mancini,ITA,Roma,Serie A,2021,25.0,1996.0,32.0,41,25,22,18,1,18,33,54.5,15,38,19,19,39,80,69,0,DF,25-29,Defender,Italy,Europe
308279,Rolando Mandragora,ITA,Torino,Serie A,2021,24.0,1997.0,14.7,21,10,3,16,2,12,21,57.1,9,18,4,14,10,31,13,0,MF,20-24,Midfielder,Italy,Europe
200512,Sadio Man,SEN,Liverpool,Premier League,2021,29.0,1992.0,31.3,33,20,7,14,12,8,26,30.8,18,30,1,29,8,41,15,0,FW,25-29,Forward,Senegal,Africa
289592,Orel Mangala,BEL,Stuttgart,Bundesliga,2021,23.0,1998.0,20.6,17,10,5,7,5,11,22,50.0,11,11,4,7,12,29,19,1,MF,20-24,Midfielder,Belgium,Europe
18934,Thomas Mangani,FRA,Angers,Ligue 1,2021,34.0,1987.0,24.4,58,30,23,34,1,31,68,45.6,37,38,11,27,36,94,29,0,MF,30-34,Midfielder,France,Europe
209212,Solly March,ENG,Brighton,Premier League,2021,27.0,1994.0,19.4,30,17,11,9,10,7,22,31.8,15,22,3,19,17,47,25,0,"DF,FW",25-29,Defender,England,Europe
277167,Gian Marco Ferrari,ITA,Sassuolo,Serie A,2021,29.0,1992.0,34.7,16,11,10,6,0,10,23,43.5,13,37,27,10,43,59,114,2,DF,25-29,Defender,Italy,Europe
250845,Jos Mara Gimnez,URU,Atltico Madrid,La Liga,2021,26.0,1995.0,22.7,18,12,12,6,0,8,16,50.0,8,25,19,6,25,43,96,1,DF,25-29,Defender,Uruguay,South America
295183,Rzvan Marin,ROU,Cagliari,Serie A,2021,25.0,1996.0,31.3,42,21,16,22,4,24,54,44.4,30,23,5,18,10,52,17,1,MF,25-29,Midfielder,Romania,Europe
249730,Guillermo Maripn,CHI,Monaco,Ligue 1,2021,27.0,1994.0,20.4,36,24,27,9,0,20,40,50.0,20,21,14,7,25,61,66,1,DF,25-29,Defender,Chile,South America
127142,Jonas Martin,FRA,Rennes,Ligue 1,2021,31.0,1990.0,23.4,35,20,12,21,2,19,53,35.8,34,17,3,14,22,57,28,1,MF,30-34,Midfielder,France,Europe
655488,Gabriel Martinelli,BRA,Arsenal,Premier League,2021,20.0,2001.0,20.7,27,19,7,14,6,10,29,34.5,19,26,1,25,20,47,15,0,"FW,MF",20-24,Forward,Brazil,South America
406625,Lautaro Martnez,ARG,Inter,Serie A,2021,23.0,1997.0,25.4,20,10,3,10,7,6,11,54.5,5,21,1,20,18,38,6,0,FW,20-24,Forward,Argentina,South America
373373,Lucas Martnez Quarta,ARG,Fiorentina,Serie A,2021,25.0,1996.0,15.9,36,25,23,11,2,21,34,61.8,13,22,9,13,19,55,46,0,DF,25-29,Defender,Argentina,South America
142031,Omar Mascarell,EQG,Elche,La Liga,2021,28.0,1993.0,27.7,46,26,16,23,7,24,60,40.0,36,42,14,28,48,94,52,2,MF,25-29,Midfielder,Equatorial Guinea,Africa
568693,Pape Matar Sarr,SEN,Metz,Ligue 1,2021,18.0,2002.0,23.7,45,26,21,23,1,18,39,46.2,21,33,3,30,29,74,22,0,MF,Under 20,Midfielder,Senegal,Africa
535834,Eliot Matazo,BEL,Monaco,Ligue 1,2021,19.0,2002.0,8.8,8,7,4,4,0,2,11,18.2,9,11,3,8,13,21,9,0,MF,Under 20,Midfielder,Belgium,Europe
420002,Jean-Philippe Mateta,FRA,Crystal Palace,Premier League,2021,24.0,1997.0,12.7,8,4,2,5,1,3,18,16.7,15,11,3,8,4,12,13,0,FW,20-24,Forward,France,Europe
315145,Azor Matusiwa,NED,Reims,Ligue 1,2021,23.0,1998.0,27.4,58,32,28,26,4,26,55,47.3,29,49,19,30,62,120,43,0,MF,20-24,Midfielder,Netherlands,Europe
217115,Neal Maupay,FRA,Brighton,Premier League,2021,24.0,1996.0,25.3,17,10,2,6,9,4,18,22.2,14,21,2,19,2,19,2,0,FW,20-24,Forward,France,Europe
340328,Stephy Mavididi,ENG,Montpellier,Ligue 1,2021,23.0,1998.0,25.5,24,13,11,7,6,14,39,35.9,25,23,2,21,8,32,11,0,"FW,MF",20-24,Forward,England,Europe
415912,Konstantinos Mavropanos,GRE,Stuttgart,Bundesliga,2021,23.0,1997.0,30.1,57,39,35,21,1,30,51,58.8,21,46,23,23,69,126,174,2,DF,20-24,Defender,Greece,Europe
342229,Kylian Mbapp,FRA,Paris S-G,Ligue 1,2021,22.0,1998.0,33.6,11,8,1,4,6,7,13,53.8,6,6,0,6,5,16,13,0,FW,20-24,Forward,France,Europe
413039,Bryan Mbeumo,CMR,Brentford,Premier League,2021,21.0,1999.0,32.3,28,16,1,12,15,6,20,30.0,14,21,6,15,11,39,20,0,FW,20-24,Forward,Cameroon,Africa
41416,James McArthur,SCO,Crystal Palace,Premier League,2021,33.0,1987.0,16.0,33,23,13,19,1,16,44,36.4,28,23,9,14,30,63,27,0,MF,30-34,Midfielder,Scotland,Europe
193116,John McGinn,SCO,Aston Villa,Premier League,2021,26.0,1994.0,34.3,106,64,35,55,16,54,104,51.9,50,53,6,47,35,141,34,0,MF,25-29,Midfielder,Scotland,Europe
332697,Weston McKennie,USA,Juventus,Serie A,2021,22.0,1998.0,15.2,20,11,11,7,2,8,26,30.8,18,17,8,9,23,43,20,0,MF,20-24,Midfielder,United States,North America
126600,Kenny McLean,SCO,Norwich City,Premier League,2021,29.0,1992.0,30.1,42,22,18,20,4,17,59,28.8,42,29,7,22,34,76,54,0,MF,25-29,Midfielder,Scotland,Europe
584769,Dwight McNeil,ENG,Burnley,Premier League,2021,21.0,1999.0,34.5,78,49,27,38,13,33,73,45.2,40,64,11,53,35,113,31,1,MF,20-24,Midfielder,England,Europe
315969,Scott McTominay,SCO,Manchester Utd,Premier League,2021,24.0,1996.0,26.5,65,33,32,24,9,30,61,49.2,31,45,10,35,31,96,60,1,MF,20-24,Midfielder,Scotland,Europe
474800,Facundo Medina,ARG,Lens,Ligue 1,2021,22.0,1999.0,28.8,61,42,34,23,4,38,62,61.3,24,24,8,16,37,98,78,3,DF,20-24,Defender,Argentina,South America
285951,Nathan de Medina,BEL,Arminia,Bundesliga,2021,23.0,1997.0,8.6,17,10,11,6,0,6,10,60.0,4,14,3,11,10,27,28,0,DF,20-24,Defender,Belgium,Europe
74810,Ben Mee,ENG,Burnley,Premier League,2021,31.0,1989.0,20.4,26,12,16,7,3,12,19,63.2,7,28,22,6,24,50,94,1,DF,30-34,Defender,England,Europe
315862,Filippo Melegoni,ITA,Genoa,Serie A,2021,22.0,1999.0,10.9,20,12,5,8,7,8,16,50.0,8,10,1,9,11,31,8,1,"MF,FW",20-24,Midfielder,Italy,Europe
442552,Houboulang Mendes,GNB,Lorient,Ligue 1,2021,23.0,1998.0,35.8,58,28,37,18,3,40,57,70.2,17,41,21,20,41,99,128,4,DF,20-24,Defender,Guinea-Bissau,Africa
616341,Nuno Mendes,POR,Paris S-G,Ligue 1,2021,19.0,2002.0,18.4,48,29,23,18,7,25,47,53.2,22,27,5,22,21,69,17,1,DF,Under 20,Defender,Portugal,Europe
135617,Thiago Mendes,BRA,Lyon,Ligue 1,2021,29.0,1992.0,20.7,36,22,18,16,2,12,30,40.0,18,24,5,19,34,70,56,1,"MF,DF",25-29,Midfielder,Brazil,South America
422715,Arial Mendy,SEN,Clermont Foot,Ligue 1,2021,26.0,1994.0,8.8,6,4,4,2,0,2,11,18.2,9,6,1,5,7,13,17,0,"DF,FW",25-29,Defender,Senegal,Africa
291417,Ferland Mendy,FRA,Real Madrid,La Liga,2021,26.0,1995.0,19.3,24,14,11,10,3,8,14,57.1,6,8,2,6,18,42,27,3,DF,25-29,Defender,France,Europe
111051,Nampalys Mendy,SEN,Leicester City,Premier League,2021,29.0,1992.0,11.5,12,6,8,4,0,6,17,35.3,11,7,4,3,11,23,11,1,MF,25-29,Midfielder,Senegal,Africa
557613,Quentin Merlin,FRA,Nantes,Ligue 1,2021,19.0,2002.0,21.4,45,28,19,20,6,26,49,53.1,23,25,4,21,27,72,29,2,"DF,MF",Under 20,Defender,France,Europe
28003,Lionel Messi,ARG,Paris S-G,Ligue 1,2021,34.0,1987.0,23.9,10,3,1,5,4,3,13,23.1,10,5,0,5,4,14,0,0,"FW,MF",30-34,Forward,Argentina,South America
449151,Junior Messias,BRA,Milan,Serie A,2021,30.0,1991.0,15.9,34,18,11,14,9,15,34,44.1,19,11,1,10,17,51,17,0,"FW,MF",30-34,Forward,Brazil,South America
100986,Thomas Meunier,BEL,Dortmund,Bundesliga,2021,29.0,1991.0,15.6,29,19,13,12,4,16,33,48.5,17,10,2,8,12,41,25,1,DF,25-29,Defender,Belgium,Europe
186988,Sven Michel,GER,Union Berlin,Bundesliga,2021,31.0,1990.0,3.8,10,6,5,3,2,2,8,25.0,6,3,0,3,1,11,1,0,FW,30-34,Forward,Germany,Europe
743500,William Mikelbrencis,FRA,Metz,Ligue 1,2021,17.0,2004.0,6.8,11,5,6,4,1,6,9,66.7,3,6,3,3,5,16,9,0,DF,Under 20,Defender,France,Europe
401530,der Milito,BRA,Real Madrid,La Liga,2021,23.0,1998.0,33.7,50,32,30,12,8,20,39,51.3,19,42,20,22,52,102,107,3,DF,20-24,Defender,Brazil,South America
3333,James Milner,ENG,Liverpool,Premier League,2021,35.0,1986.0,9.5,28,16,12,11,5,12,29,41.4,17,19,5,14,17,45,20,0,"MF,DF",35-39,Midfielder,England,Europe
165793,Takumi Minamino,JPN,Liverpool,Premier League,2021,26.0,1995.0,2.1,3,2,1,1,1,2,8,25.0,6,2,0,2,1,4,2,0,"FW,MF",25-29,Forward,Japan,Asia
253677,Tyrone Mings,ENG,Aston Villa,Premier League,2021,28.0,1993.0,35.4,23,12,17,3,3,14,22,63.6,8,47,30,17,46,69,153,2,DF,25-29,Defender,England,Europe
55735,Henrikh Mkhitaryan,ARM,Roma,Serie A,2021,32.0,1989.0,27.7,45,29,11,27,7,17,52,32.7,35,33,2,31,22,67,33,0,"MF,FW",30-34,Midfielder,Armenia,Asia
50512,Anthony Modeste,FRA,Kln,Bundesliga,2021,33.0,1988.0,29.0,10,6,4,5,1,3,18,16.7,15,11,2,9,4,14,29,0,FW,30-34,Forward,France,Europe
538874,Terem Moffi,NGA,Lorient,Ligue 1,2021,22.0,1999.0,30.1,17,10,3,12,2,9,32,28.1,23,11,2,9,4,21,22,0,FW,20-24,Forward,Nigeria,Africa
262939,Johan Mojica,COL,Elche,La Liga,2021,28.0,1992.0,31.7,46,25,34,7,5,23,31,74.2,8,22,3,19,25,71,61,3,DF,25-29,Defender,Colombia,South America
424042,Nahuel Molina,ARG,Udinese,Serie A,2021,23.0,1998.0,29.3,41,24,17,21,3,16,48,33.3,32,24,3,21,22,63,44,2,DF,20-24,Defender,Argentina,South America
222859,Florent Mollet,FRA,Montpellier,Ligue 1,2021,29.0,1991.0,29.2,31,22,14,12,5,14,57,24.6,43,27,4,23,24,55,13,0,"FW,MF",25-29,Forward,France,Europe
127182,Thomas Monconduit,FRA,Lorient,Ligue 1,2021,30.0,1991.0,25.0,41,25,19,17,5,20,57,35.1,37,21,10,11,22,63,51,1,MF,30-34,Midfielder,France,Europe
402733,Gonzalo Montiel,ARG,Sevilla,La Liga,2021,24.0,1997.0,11.8,15,4,8,5,2,12,24,50.0,12,8,2,6,10,25,22,0,DF,20-24,Defender,Argentina,South America
617074,Ilaix Moriba,GUI,Valencia,La Liga,2021,18.0,2003.0,9.1,26,18,10,13,3,14,35,40.0,21,15,0,15,12,38,14,0,MF,Under 20,Midfielder,Guinea,Africa
238639,Steve Mouni,BEN,Brest,Ligue 1,2021,26.0,1994.0,25.7,17,6,3,12,2,4,27,14.8,23,13,1,12,6,23,12,0,FW,25-29,Forward,Benin,Africa
77100,Lucas Moura,BRA,Tottenham,Premier League,2021,28.0,1992.0,19.7,25,10,7,14,4,8,35,22.9,27,19,0,19,18,43,19,0,"FW,MF",25-29,Forward,Brazil,South America
461906,Joo Moutinho,POR,Wolves,Premier League,2021,34.0,1986.0,33.0,74,39,34,27,13,30,106,28.3,76,48,8,40,34,108,36,2,MF,30-34,Midfielder,Portugal,Europe
348026,Nordi Mukiele,FRA,RB Leipzig,Bundesliga,2021,23.0,1997.0,20.5,35,22,23,9,3,14,27,51.9,13,31,5,26,31,66,44,2,"DF,FW",20-24,Defender,France,Europe
58358,Thomas Mller,GER,Bayern Munich,Bundesliga,2021,31.0,1989.0,28.4,35,20,7,16,12,16,54,29.6,38,32,1,31,15,50,12,0,MF,30-34,Midfielder,Germany,Europe
119228,Luis Muriel,COL,Atalanta,Serie A,2021,30.0,1991.0,17.1,15,4,2,7,6,3,19,15.8,16,12,0,12,4,19,5,0,"FW,MF",30-34,Forward,Colombia,South America
131102,Jeison Murillo,COL,Celta Vigo,La Liga,2021,29.0,1992.0,12.4,15,10,13,2,0,9,13,69.2,4,11,8,3,17,32,37,0,DF,25-29,Defender,Colombia,South America
199527,Jacob Murphy,ENG,Newcastle Utd,Premier League,2021,26.0,1995.0,16.4,49,26,34,11,4,26,41,63.4,15,20,2,18,23,72,17,0,"FW,DF",25-29,Forward,England,Europe
171399,Nicola Murru,ITA,Sampdoria,Serie A,2021,26.0,1994.0,10.9,22,17,10,11,1,8,13,61.5,5,17,3,14,7,29,20,1,DF,25-29,Defender,Italy,Europe
503991,Yunus Musah,USA,Valencia,La Liga,2021,18.0,2002.0,14.0,23,13,8,8,7,6,20,30.0,14,19,1,18,14,37,11,0,"MF,FW",Under 20,Midfielder,United States,North America
580195,Jamal Musiala,GER,Bayern Munich,Bundesliga,2021,18.0,2003.0,16.3,40,26,11,16,13,15,36,41.7,21,25,0,25,19,59,2,1,"MF,FW",Under 20,Midfielder,Germany,Europe
88590,Shkodran Mustafi,GER,Levante,La Liga,2021,29.0,1992.0,7.3,9,6,6,3,0,5,9,55.6,4,6,3,3,15,24,40,0,DF,25-29,Defender,Germany,Europe
490307,Enock Mwepu,ZAM,Brighton,Premier League,2021,23.0,1998.0,11.1,22,12,10,10,2,5,27,18.5,22,20,2,18,12,34,19,0,MF,20-24,Midfielder,Zambia,Africa
404842,Vitaliy Mykolenko,UKR,Everton,Premier League,2021,22.0,1999.0,11.7,25,15,15,7,3,12,21,57.1,9,15,2,13,16,41,37,0,DF,20-24,Defender,Ukraine,Europe
342209,Kvin N'Doram,FRA,Metz,Ligue 1,2021,25.0,1996.0,13.7,10,8,3,5,2,3,20,15.0,17,24,5,19,19,29,21,0,MF,25-29,Midfielder,France,Europe
315063,Nahitan Nndez,URU,Cagliari,Serie A,2021,25.0,1995.0,16.9,39,21,16,15,8,18,33,54.5,15,16,1,15,9,48,15,1,"MF,DF",25-29,Midfielder,Uruguay,South America
274839,Wilfred Ndidi,NGA,Leicester City,Premier League,2021,24.0,1996.0,18.0,60,32,32,27,1,22,55,40.0,33,36,8,28,42,102,54,1,"MF,DF",20-24,Midfielder,Nigeria,Africa
503160,Paul Nebel,GER,Mainz 05,Bundesliga,2021,18.0,2002.0,2.5,5,3,3,1,1,2,3,66.7,1,0,0,0,0,5,1,0,"MF,FW",Under 20,Midfielder,Germany,Europe
54581,Ilija Nestorovski,MKD,Udinese,Serie A,2021,31.0,1990.0,2.1,0,0,0,0,0,0,3,0.0,3,0,0,0,0,0,4,0,FW,30-34,Forward,North Macedonia,Europe
487465,Pedro Neto,POR,Wolves,Premier League,2021,21.0,2000.0,5.2,4,4,2,0,2,0,9,0.0,9,0,0,0,6,10,1,0,"FW,MF",20-24,Forward,Portugal,Europe
524285,Luca Netz,GER,Gladbach,Bundesliga,2021,18.0,2003.0,15.5,24,11,12,10,2,11,40,27.5,29,24,4,20,13,37,33,1,"DF,FW",Under 20,Defender,Germany,Europe
278332,Florian Neuhaus,GER,Gladbach,Bundesliga,2021,24.0,1997.0,23.6,55,28,24,26,5,27,64,42.2,37,38,6,32,31,86,19,4,MF,20-24,Midfielder,Germany,Europe
225161,Rben Neves,POR,Wolves,Premier League,2021,24.0,1997.0,29.6,68,37,23,41,4,24,87,27.6,63,39,5,34,41,109,49,3,MF,20-24,Midfielder,Portugal,Europe
68290,Neymar,BRA,Paris S-G,Ligue 1,2021,29.0,1992.0,20.6,29,19,5,12,12,12,36,33.3,24,9,1,8,4,33,2,1,"FW,MF",25-29,Forward,Brazil,South America
469669,Yvan Neyou,CMR,Saint-tienne,Ligue 1,2021,24.0,1997.0,10.4,29,13,14,12,3,9,27,33.3,18,8,3,5,23,52,13,0,MF,20-24,Midfielder,Cameroon,Africa
448177,Jessic Ngankam,GER,Greuther Frth,Bundesliga,2021,21.0,2000.0,3.8,3,1,1,1,1,1,2,50.0,1,3,0,3,0,3,1,0,FW,20-24,Forward,Germany,Europe
205587,Opa Nguette,SEN,Metz,Ligue 1,2021,27.0,1994.0,11.6,21,14,9,6,6,5,14,35.7,9,13,3,10,2,23,9,0,"FW,MF",25-29,Forward,Senegal,Africa
490417,Ibrahima Niane,SEN,Metz,Ligue 1,2021,22.0,1999.0,17.6,1,1,0,1,0,0,5,0.0,5,6,1,5,3,4,16,0,FW,20-24,Forward,Senegal,Africa
538996,Tanguy Nianzou,FRA,Bayern Munich,Bundesliga,2021,19.0,2002.0,6.5,11,7,7,3,1,7,11,63.6,4,7,2,5,7,18,17,0,DF,Under 20,Defender,France,Europe
152963,Florian Niederlechner,GER,Augsburg,Bundesliga,2021,30.0,1990.0,12.9,6,5,1,3,2,4,13,30.8,9,9,0,9,4,10,7,0,FW,30-34,Forward,Germany,Europe
216804,Joakim Nilsson,SWE,Arminia,Bundesliga,2021,27.0,1994.0,30.4,37,19,24,13,0,20,26,76.9,6,36,23,13,56,93,143,1,DF,25-29,Defender,Sweden,Europe
392810,Casimir Ninga,CHA,Angers,Ligue 1,2021,28.0,1993.0,4.5,5,1,1,4,0,2,5,40.0,3,2,0,2,1,6,0,0,FW,25-29,Forward,Chad,Africa
340324,Eddie Nketiah,ENG,Arsenal,Premier League,2021,22.0,1999.0,9.3,9,4,1,4,4,1,4,25.0,3,9,2,7,4,13,5,0,FW,20-24,Forward,England,Europe
344381,Christopher Nkunku,FRA,RB Leipzig,Bundesliga,2021,23.0,1997.0,30.3,23,10,10,11,2,9,35,25.7,26,23,2,21,15,38,15,0,"FW,MF",20-24,Forward,France,Europe
406640,Felix Nmecha,GER,Wolfsburg,Bundesliga,2021,20.0,2000.0,3.6,3,1,1,1,1,0,2,0.0,2,2,0,2,7,10,6,0,"MF,FW",20-24,Midfielder,Germany,Europe
314288,Lukas Nmecha,GER,Wolfsburg,Bundesliga,2021,22.0,1998.0,18.1,12,5,5,5,2,5,19,26.3,14,9,1,8,4,16,10,0,"FW,MF",20-24,Forward,Germany,Europe
324811,Arnaud Nordin,FRA,Saint-tienne,Ligue 1,2021,23.0,1998.0,20.8,21,11,8,8,5,8,22,36.4,14,19,0,19,6,27,8,0,"FW,MF",20-24,Forward,France,Europe
560483,Randy Nteka,ANG,Rayo Vallecano,La Liga,2021,23.0,1997.0,16.2,24,13,9,11,4,8,19,42.1,11,21,1,20,8,32,12,0,"FW,MF",20-24,Forward,Angola,Africa
148367,Christian Nrgaard,DEN,Brentford,Premier League,2021,27.0,1994.0,33.9,109,60,42,58,9,52,101,51.5,49,48,9,39,64,173,58,1,MF,25-29,Midfielder,Denmark,Europe
45581,Joel Obi,NGA,Salernitana,Serie A,2021,30.0,1991.0,12.7,23,14,5,14,4,5,12,41.7,7,17,6,11,10,33,7,0,"MF,DF",30-34,Midfielder,Nigeria,Africa
189441,Lucas Ocampos,ARG,Sevilla,La Liga,2021,27.0,1994.0,23.6,45,24,23,18,4,23,55,41.8,32,35,1,34,9,54,24,1,FW,25-29,Forward,Argentina,South America
53437,Bastian Oczipka,GER,Union Berlin,Bundesliga,2021,32.0,1989.0,10.4,24,15,15,7,2,10,13,76.9,3,10,2,8,12,36,21,0,DF,30-34,Defender,Germany,Europe
48002,Angelo Ogbonna,ITA,West Ham,Premier League,2021,33.0,1988.0,10.2,7,4,5,2,0,3,7,42.9,4,5,4,1,11,18,29,0,DF,30-34,Defender,Italy,Europe
91473,Florent Ogier,FRA,Clermont Foot,Ligue 1,2021,32.0,1989.0,27.0,31,17,18,12,1,17,31,54.8,14,41,27,14,37,68,89,0,DF,30-34,Defender,France,Europe
485706,Amadou Onana,BEL,Lille,Ligue 1,2021,19.0,2001.0,15.1,48,31,17,27,4,18,25,72.0,7,10,3,7,30,78,19,0,MF,Under 20,Midfielder,Belgium,Europe
656441,Jean Onana,CMR,Bordeaux,Ligue 1,2021,21.0,2000.0,20.4,70,49,33,33,4,35,86,40.7,51,37,5,32,36,106,23,1,MF,20-24,Midfielder,Cameroon,Africa
119234,Karim Onisiwo,AUT,Mainz 05,Bundesliga,2021,29.0,1992.0,26.2,18,10,4,6,8,7,22,31.8,15,27,2,25,7,25,8,0,FW,25-29,Forward,Austria,Europe
421637,Frank Onyeka,NGA,Brentford,Premier League,2021,23.0,1998.0,11.6,25,17,13,9,3,8,27,29.6,19,16,2,14,14,39,13,0,MF,20-24,Midfielder,Nigeria,Africa
148368,Divock Origi,BEL,Liverpool,Premier League,2021,26.0,1995.0,1.5,0,0,0,0,0,0,2,0.0,2,1,0,1,1,1,2,0,FW,25-29,Forward,Belgium,Europe
443331,Patrick Osterhage,GER,Bochum,Bundesliga,2021,21.0,2000.0,6.7,9,6,3,5,1,3,7,42.9,4,7,1,6,11,20,8,0,MF,20-24,Midfielder,Germany,Europe
818495,Otvio,BRA,Bordeaux,Ligue 1,2021,27.0,1994.0,12.7,36,23,13,21,2,16,39,41.0,23,9,3,6,18,54,11,0,MF,25-29,Midfielder,Brazil,South America
823231,Dango Ouattara,BFA,Lorient,Ligue 1,2021,19.0,2002.0,9.0,21,15,9,11,1,11,23,47.8,12,10,1,9,14,35,15,1,"MF,FW",Under 20,Midfielder,Burkina Faso,Africa
400485,Adam Ounas,ALG,Napoli,Serie A,2021,24.0,1996.0,3.6,6,1,0,3,3,3,7,42.9,4,3,0,3,2,8,3,0,"MF,FW",20-24,Midfielder,Algeria,Africa
184922,Ambroise Oyongo,CMR,Montpellier,Ligue 1,2021,30.0,1991.0,7.3,13,4,7,4,2,9,15,60.0,6,5,1,4,6,19,17,0,DF,30-34,Defender,Cameroon,Africa
244940,Salih zcan,TUR,Kln,Bundesliga,2021,23.0,1998.0,25.7,42,30,14,23,5,22,51,43.1,29,37,5,32,51,93,35,1,MF,20-24,Midfielder,Turkey,Asia
181547,Gonalo Pacincia,POR,Eint Frankfurt,Bundesliga,2021,26.0,1994.0,5.7,4,2,2,1,1,1,3,33.3,2,2,0,2,1,5,4,0,FW,25-29,Forward,Portugal,Europe
126699,Vincent Pajot,FRA,Metz,Ligue 1,2021,30.0,1990.0,25.7,86,56,35,47,4,20,46,43.5,26,33,6,27,51,137,38,0,MF,30-34,Midfielder,France,Europe
401578,Exequiel Palacios,ARG,Leverkusen,Bundesliga,2021,22.0,1998.0,12.2,30,19,12,14,4,15,38,39.5,23,20,1,19,28,58,11,2,MF,20-24,Midfielder,Argentina,South America
139279,Nicolas Pallois,FRA,Nantes,Ligue 1,2021,33.0,1987.0,27.2,51,33,40,11,0,34,59,57.6,25,40,19,21,53,104,116,1,DF,30-34,Defender,France,Europe
568177,Cole Palmer,ENG,Manchester City,Premier League,2021,19.0,2002.0,1.4,2,1,1,1,0,0,2,0.0,2,3,0,3,1,3,0,0,"FW,MF",Under 20,Forward,England,Europe
12563,Goran Pandev,MKD,Genoa,Serie A,2021,38.0,1983.0,9.4,2,0,1,0,1,0,9,0.0,9,3,1,2,2,4,0,0,"FW,MF",35-39,Forward,North Macedonia,Europe
444523,Lucas Paquet,BRA,Lyon,Ligue 1,2021,23.0,1997.0,30.0,68,38,24,26,18,17,51,33.3,34,43,5,38,9,77,22,0,"MF,FW",20-24,Midfielder,Brazil,South America
166237,Leandro Paredes,ARG,Paris S-G,Ligue 1,2021,27.0,1994.0,9.3,23,13,9,11,3,12,24,50.0,12,10,6,4,10,33,5,2,MF,25-29,Midfielder,Argentina,South America
547985,Fabiano Parisi,ITA,Empoli,Serie A,2021,20.0,2000.0,16.4,35,19,25,5,5,13,31,41.9,18,30,10,20,22,57,42,0,DF,20-24,Defender,Italy,Europe
328658,Kristoffer Ajer,NOR,Brentford,Premier League,2021,23.0,1998.0,22.2,29,18,21,6,2,13,21,61.9,8,19,11,8,26,55,74,0,DF,20-24,Defender,Norway,Europe
69751,Jordi Alba,ESP,Barcelona,La Liga,2021,32.0,1989.0,29.4,47,34,12,26,9,27,47,57.4,20,26,6,20,33,80,41,1,DF,30-34,Defender,Spain,Europe
128220,Luis Alberto,ESP,Lazio,Serie A,2021,28.0,1992.0,26.1,29,17,8,11,10,8,52,15.4,44,32,4,28,13,42,7,0,MF,25-29,Midfielder,Spain,Europe
126716,Paco Alccer,ESP,Villarreal,La Liga,2021,27.0,1993.0,8.7,9,3,2,4,3,1,5,20.0,4,7,0,7,6,15,1,0,FW,25-29,Forward,Spain,Europe
60444,Thiago Alcntara,ESP,Liverpool,Premier League,2021,30.0,1991.0,17.0,48,29,14,24,10,10,42,23.8,32,22,2,20,26,74,13,2,MF,30-34,Midfielder,Spain,Europe
247250,Rubn Alcaraz,ESP,Cdiz,La Liga,2021,30.0,1991.0,12.3,41,20,14,24,3,22,45,48.9,23,10,2,8,13,54,14,0,MF,30-34,Midfielder,Spain,Europe
281755,Ivn Alejo,ESP,Cdiz,La Liga,2021,26.0,1995.0,11.8,33,15,21,10,2,15,44,34.1,29,12,0,12,8,41,17,0,"MF,FW",25-29,Midfielder,Spain,Europe
284854,Carles Ale,ESP,Getafe,La Liga,2021,23.0,1998.0,25.8,27,19,11,13,3,9,48,18.8,39,21,2,19,15,42,16,0,MF,20-24,Midfielder,Spain,Europe
160182,Jos ngel,ESP,Osasuna,La Liga,2021,31.0,1989.0,12.0,20,13,9,9,2,9,14,64.3,5,6,1,5,10,30,21,0,DF,30-34,Defender,Spain,Europe
277179,Angelio,ESP,RB Leipzig,Bundesliga,2021,24.0,1997.0,25.5,28,21,14,13,1,14,30,46.7,16,24,3,21,29,57,40,0,DF,20-24,Defender,Spain,Europe
72047,Iago Aspas,ESP,Celta Vigo,La Liga,2021,33.0,1987.0,34.3,14,7,1,5,8,4,24,16.7,20,23,2,21,11,25,19,0,FW,30-34,Forward,Spain,Europe
711969,Lorenz Assignon,TOG,Rennes,Ligue 1,2021,21.0,2000.0,6.8,15,10,11,3,1,5,9,55.6,4,3,1,2,11,26,19,0,DF,20-24,Defender,Togo,Africa
57500,Csar Azpilicueta,ESP,Chelsea,Premier League,2021,31.0,1989.0,23.0,51,28,18,27,6,16,35,45.7,19,32,9,23,23,74,65,1,DF,30-34,Defender,Spain,Europe
298575,Kike Barja,ESP,Osasuna,La Liga,2021,24.0,1997.0,9.6,15,11,4,7,4,8,22,36.4,14,10,1,9,9,24,4,0,"MF,FW",20-24,Midfielder,Spain,Europe
616369,Ander Barrenetxea,ESP,Real Sociedad,La Liga,2021,19.0,2001.0,6.1,15,10,9,6,0,8,18,44.4,10,7,0,7,2,17,2,0,"FW,MF",Under 20,Forward,Spain,Europe
237164,Ihlas Bebou,TOG,Hoffenheim,Bundesliga,2021,27.0,1994.0,23.2,22,14,5,12,5,7,21,33.3,14,20,3,17,12,34,25,0,"FW,DF",25-29,Forward,Togo,Africa
243028,Jan Bednarek,POL,Southampton,Premier League,2021,25.0,1996.0,29.2,32,15,18,13,1,19,33,57.6,14,48,27,21,72,104,141,0,DF,25-29,Defender,Poland,Europe
191217,Hctor Bellern,ESP,Betis,La Liga,2021,26.0,1995.0,22.0,52,32,29,20,3,31,44,70.5,13,11,2,9,23,75,57,1,DF,25-29,Defender,Spain,Europe
423444,Fran Beltrn,ESP,Celta Vigo,La Liga,2021,22.0,1999.0,28.9,56,41,27,23,6,28,68,41.2,40,29,5,24,32,88,39,0,MF,20-24,Midfielder,Spain,Europe
61812,Yuri Berchiche,ESP,Athletic Club,La Liga,2021,31.0,1990.0,11.3,25,11,10,11,4,7,14,50.0,7,19,6,13,13,38,25,0,DF,30-34,Defender,Spain,Europe
338425,lex Berenguer,ESP,Athletic Club,La Liga,2021,26.0,1995.0,24.1,45,26,23,14,8,11,51,21.6,40,40,2,38,16,61,20,0,MF,25-29,Midfielder,Spain,Europe
126719,Juan Bernat,ESP,Paris S-G,Ligue 1,2021,28.0,1993.0,10.6,24,14,10,10,4,13,18,72.2,5,8,0,8,8,32,16,0,"DF,MF",25-29,Defender,Spain,Europe
203043,Pedro Bigas,ESP,Elche,La Liga,2021,30.0,1990.0,17.2,24,10,16,8,0,9,20,45.0,11,21,16,5,18,42,77,1,DF,30-34,Defender,Spain,Europe
406806,Emil Bohinen,NOR,Salernitana,Serie A,2021,22.0,1999.0,7.8,15,9,4,9,2,10,20,50.0,10,17,3,14,12,27,14,0,MF,20-24,Midfielder,Norway,Europe
65230,Sergio Busquets,ESP,Barcelona,La Liga,2021,33.0,1988.0,35.5,93,49,31,48,14,46,83,55.4,37,44,8,36,45,138,31,0,MF,30-34,Midfielder,Spain,Europe
61253,Jos Callejn,ESP,Fiorentina,Serie A,2021,34.0,1987.0,14.4,15,6,6,6,3,13,31,41.9,18,6,0,6,3,18,1,1,FW,30-34,Forward,Spain,Europe
120095,Jos Campaa,ESP,Levante,La Liga,2021,28.0,1993.0,15.8,27,16,13,10,4,12,32,37.5,20,13,2,11,21,48,19,1,MF,25-29,Midfielder,Spain,Europe
66106,Sergio Canales,ESP,Betis,La Liga,2021,30.0,1991.0,31.0,24,14,8,12,4,10,35,28.6,25,16,1,15,10,34,12,0,"FW,MF",30-34,Forward,Spain,Europe
251845,Sergi Cans,ESP,Brentford,Premier League,2021,24.0,1997.0,23.1,56,25,32,15,9,33,60,55.0,27,32,3,29,22,78,38,0,"DF,FW",20-24,Defender,Spain,Europe
495625,Vctor Chust,ESP,Cdiz,La Liga,2021,21.0,2000.0,20.3,19,10,14,4,1,11,17,64.7,6,20,8,12,16,35,87,0,DF,20-24,Defender,Spain,Europe
71905,Coke,ESP,Levante,La Liga,2021,34.0,1987.0,1.3,3,2,1,1,1,3,4,75.0,1,1,0,1,2,5,7,0,DF,30-34,Defender,Spain,Europe
282722,lex Collado,ESP,Granada,La Liga,2021,22.0,1999.0,11.3,27,12,6,16,5,12,31,38.7,19,28,2,26,6,33,11,0,"MF,FW",20-24,Midfielder,Spain,Europe
380598,Santi Comesaa,ESP,Rayo Vallecano,La Liga,2021,24.0,1996.0,29.8,87,56,45,33,9,40,104,38.5,64,46,6,40,33,120,30,0,MF,20-24,Midfielder,Spain,Europe
65318,Jaume Costa,ESP,Mallorca,La Liga,2021,33.0,1988.0,20.3,35,26,23,7,5,23,31,74.2,8,22,7,15,23,58,55,0,DF,30-34,Defender,Spain,Europe
157672,Vladimr Coufal,CZE,West Ham,Premier League,2021,28.0,1992.0,24.5,45,25,24,14,7,18,36,50.0,18,31,9,22,22,67,64,1,DF,25-29,Defender,Czech Republic,Europe
494880,Jorge Cuenca,ESP,Getafe,La Liga,2021,21.0,1999.0,29.8,46,32,30,15,1,21,28,75.0,7,29,14,15,39,85,155,0,DF,20-24,Defender,Spain,Europe
158764,Stuart Dallas,NIR,Leeds United,Premier League,2021,30.0,1991.0,32.4,93,55,58,31,4,56,105,53.3,49,45,14,31,57,150,63,2,"DF,MF",30-34,Defender,Northern Ireland,Europe
142021,Sergi Darder,ESP,Espanyol,La Liga,2021,27.0,1993.0,34.7,45,22,16,19,10,18,54,33.3,36,16,1,15,26,71,32,1,MF,25-29,Midfielder,Spain,Europe
129476,Gerard Deulofeu,ESP,Udinese,Serie A,2021,27.0,1994.0,29.1,11,6,2,3,6,7,29,24.1,22,14,0,14,9,20,4,0,"FW,MF",25-29,Forward,Spain,Europe
58330,Vctor Daz,ESP,Granada,La Liga,2021,33.0,1988.0,16.7,23,15,14,9,0,12,25,48.0,13,19,11,8,17,40,71,1,DF,30-34,Defender,Spain,Europe
221150,Djen,TOG,Getafe,La Liga,2021,29.0,1991.0,34.6,44,26,24,16,4,23,34,67.6,11,24,5,19,59,103,109,2,DF,25-29,Defender,Togo,Africa
177046,Rubn Duarte,ESP,Alavs,La Liga,2021,25.0,1995.0,29.1,76,47,43,27,6,43,85,50.6,42,40,6,34,57,133,82,0,DF,25-29,Defender,Spain,Europe
281319,Alberth Elis,HON,Bordeaux,Ligue 1,2021,25.0,1996.0,15.7,19,10,5,5,9,11,25,44.0,14,9,0,9,7,26,10,0,"FW,MF",25-29,Forward,Honduras,North America
229804,Aritz Elustondo,ESP,Real Sociedad,La Liga,2021,27.0,1994.0,23.4,21,14,16,5,0,10,20,50.0,10,19,13,6,29,50,86,0,DF,25-29,Defender,Spain,Europe
93935,Sergio Escudero,ESP,Granada,La Liga,2021,31.0,1989.0,15.9,46,24,25,17,4,26,54,48.1,28,18,3,15,26,72,35,0,"DF,MF",30-34,Defender,Spain,Europe
42412,Jonny Evans,NIR,Leicester City,Premier League,2021,33.0,1988.0,15.0,24,14,14,8,2,14,22,63.6,8,17,13,4,20,44,59,0,DF,30-34,Defender,Northern Ireland,Europe
466810,Ansu Fati,ESP,Barcelona,La Liga,2021,18.0,2002.0,3.7,3,2,0,2,1,1,1,100.0,0,4,0,4,1,4,0,0,FW,Under 20,Forward,Spain,Europe
76467,Kiko Femena,ESP,Watford,Premier League,2021,30.0,1991.0,23.8,35,22,23,10,2,21,37,56.8,16,24,8,16,37,72,51,0,DF,30-34,Defender,Spain,Europe
89733,lex Fernndez,ESP,Cdiz,La Liga,2021,28.0,1992.0,22.8,47,31,22,17,8,21,61,34.4,40,30,7,23,30,77,31,0,MF,25-29,Midfielder,Spain,Europe
149231,Fidel,ESP,Elche,La Liga,2021,31.0,1989.0,25.1,44,23,18,17,9,14,57,24.6,43,9,1,8,7,51,20,0,MF,30-34,Midfielder,Spain,Europe
357885,Pablo Fornals,ESP,West Ham,Premier League,2021,25.0,1996.0,31.1,54,28,21,21,12,22,84,26.2,62,49,2,47,27,81,16,1,"FW,MF",25-29,Forward,Spain,Europe
455181,Jorge de Frutos,ESP,Levante,La Liga,2021,24.0,1997.0,19.6,33,15,14,11,8,10,51,19.6,41,11,1,10,12,45,13,0,"MF,FW",20-24,Midfielder,Spain,Europe
448628,Javi Galn,ESP,Celta Vigo,La Liga,2021,26.0,1994.0,36.6,108,66,60,37,11,42,99,42.4,57,48,8,40,45,153,52,0,DF,25-29,Defender,Spain,Europe
126751,Iigo Ruiz de Galarreta,ESP,Mallorca,La Liga,2021,27.0,1993.0,15.3,40,21,14,21,5,14,30,46.7,16,16,2,14,20,60,21,0,MF,25-29,Midfielder,Spain,Europe
1064403,lvaro Garca,ESP,Rayo Vallecano,La Liga,2021,28.0,1992.0,33.3,42,23,15,18,9,8,35,22.9,27,27,3,24,42,84,24,0,"FW,MF",25-29,Forward,Spain,Europe
298589,David Garca,ESP,Osasuna,La Liga,2021,27.0,1994.0,34.5,28,14,15,11,2,12,22,54.5,10,27,21,6,52,80,168,0,DF,25-29,Defender,Spain,Europe
466794,Eric Garca,ESP,Barcelona,La Liga,2021,20.0,2001.0,22.7,27,18,13,13,1,11,26,42.3,15,22,12,10,44,71,53,3,DF,20-24,Defender,Spain,Europe
361238,Rubn Garca,ESP,Osasuna,La Liga,2021,28.0,1993.0,26.4,43,26,12,23,8,16,49,32.7,33,31,4,27,24,67,16,0,"MF,FW",25-29,Midfielder,Spain,Europe
646740,Gavi,ESP,Barcelona,La Liga,2021,16.0,2004.0,25.7,38,18,13,18,7,9,33,27.3,24,36,0,36,25,63,13,0,"MF,FW",Under 20,Midfielder,Spain,Europe
537382,Bryan Gil,ESP,Tottenham,Premier League,2021,20.0,2001.0,1.0,3,0,1,0,2,1,2,50.0,1,2,0,2,0,3,0,0,"FW,MF",20-24,Forward,Spain,Europe
544106,scar Gil,ESP,Espanyol,La Liga,2021,24.0,1997.0,18.8,52,35,27,20,5,25,46,54.3,21,33,9,24,19,71,33,2,DF,20-24,Defender,Spain,Europe
422460,Dani Gmez,ESP,Levante,La Liga,2021,23.0,1998.0,11.8,7,4,3,2,2,4,12,33.3,8,3,0,3,3,10,5,0,FW,20-24,Forward,Spain,Europe
175449,Moi Gmez,ESP,Villarreal,La Liga,2021,27.0,1994.0,14.3,15,7,8,3,4,5,17,29.4,12,5,0,5,6,21,6,0,"MF,FW",25-29,Midfielder,Spain,Europe
92947,Sergi Gmez,ESP,Espanyol,La Liga,2021,29.0,1992.0,30.2,33,24,29,3,1,18,27,66.7,9,33,23,10,40,73,125,2,DF,25-29,Defender,Spain,Europe
873981,Diego Gonzlez,ESP,Elche,La Liga,2021,26.0,1995.0,19.9,25,16,18,7,0,9,16,56.3,7,21,13,8,19,44,87,0,DF,25-29,Defender,Spain,Europe
256429,Sergi Guardiola,ESP,Rayo Vallecano,La Liga,2021,30.0,1991.0,19.0,10,9,3,5,2,1,21,4.8,20,14,2,12,4,14,17,0,FW,30-34,Forward,Spain,Europe
495629,Hugo Guillamn,ESP,Valencia,La Liga,2021,21.0,2000.0,26.2,43,27,20,16,7,18,44,40.9,26,26,10,16,30,73,53,1,"MF,DF",20-24,Midfielder,Spain,Europe
268670,Gerard Gumbau,ESP,Elche,La Liga,2021,26.0,1994.0,21.0,46,19,22,19,5,22,51,43.1,29,18,4,14,23,69,25,0,MF,25-29,Midfielder,Spain,Europe
289257,Jon Guridi,ESP,Real Sociedad,La Liga,2021,26.0,1995.0,2.3,5,3,2,3,0,1,4,25.0,3,3,1,2,3,8,4,0,MF,25-29,Midfielder,Spain,Europe
418560,Erling Haaland,NOR,Dortmund,Bundesliga,2021,21.0,2000.0,21.2,2,1,0,1,1,0,1,0.0,1,8,1,7,1,3,31,0,FW,20-24,Forward,Norway,Europe
531824,Kike Hermoso,ESP,Betis,La Liga,2021,21.0,1999.0,1.0,2,1,2,0,0,2,2,100.0,0,2,1,1,0,2,5,1,DF,20-24,Defender,Spain,Europe
99343,Ander Herrera,ESP,Paris S-G,Ligue 1,2021,31.0,1989.0,12.1,29,17,7,16,6,14,39,35.9,25,22,8,14,14,43,8,0,MF,30-34,Midfielder,Spain,Europe
278359,Borja Iglesias,ESP,Betis,La Liga,2021,28.0,1993.0,17.5,6,4,1,2,3,0,8,0.0,8,11,1,10,4,10,7,0,FW,25-29,Forward,Spain,Europe
470794,Ivan Ili,SRB,Hellas Verona,Serie A,2021,20.0,2001.0,28.1,39,18,16,19,4,20,54,37.0,34,34,12,22,22,61,55,0,MF,20-24,Midfielder,Serbia,Europe
85288,Isco,ESP,Real Madrid,La Liga,2021,29.0,1992.0,3.7,9,5,4,4,1,5,12,41.7,7,1,0,1,2,11,1,0,"MF,FW",25-29,Midfielder,Spain,Europe
282406,lvaro Jimnez,ESP,Cdiz,La Liga,2021,26.0,1995.0,2.6,6,3,3,2,1,4,7,57.1,3,3,0,3,3,9,0,0,"MF,FW",25-29,Midfielder,Spain,Europe
7663,Joaqun,ESP,Betis,La Liga,2021,40.0,1981.0,5.2,6,2,4,2,0,3,8,37.5,5,5,2,3,3,9,10,0,"FW,MF",Over 40,Forward,Spain,Europe
406042,Dennis Johnsen,NOR,Venezia,Serie A,2021,23.0,1998.0,16.1,14,10,8,4,2,6,18,33.3,12,14,1,13,5,19,3,0,"FW,MF",20-24,Forward,Norway,Europe
263727,Joan Jordn,ESP,Sevilla,La Liga,2021,27.0,1994.0,27.9,61,30,22,31,8,28,65,43.1,37,27,6,21,30,91,18,1,MF,25-29,Midfielder,Spain,Europe
277533,Josan,ESP,Elche,La Liga,2021,31.0,1989.0,13.5,36,22,23,9,4,26,44,59.1,18,11,4,7,10,46,21,0,"DF,MF",30-34,Defender,Spain,Europe
81999,Joselu,ESP,Alavs,La Liga,2021,31.0,1990.0,34.7,16,11,1,9,6,7,25,28.0,18,21,4,17,7,23,45,0,FW,30-34,Forward,Spain,Europe
257462,Luka Jovi,SRB,Real Madrid,La Liga,2021,23.0,1997.0,4.1,1,1,0,1,0,0,1,0.0,1,3,0,3,1,2,4,0,FW,20-24,Forward,Serbia,Europe
126737,Juanmi,ESP,Betis,La Liga,2021,28.0,1993.0,23.7,39,25,11,19,9,19,49,38.8,30,24,1,23,9,48,10,1,FW,25-29,Forward,Spain,Europe
53418,Kevin Kampl,SVN,RB Leipzig,Bundesliga,2021,30.0,1990.0,21.1,41,19,16,20,5,10,42,23.8,32,24,5,19,24,65,17,0,MF,30-34,Midfielder,Slovenia,Europe
91059,Joshua King,NOR,Watford,Premier League,2021,29.0,1992.0,25.0,19,15,7,6,6,4,17,23.5,13,15,4,11,8,27,31,0,FW,25-29,Forward,Norway,Europe
425918,Jakub Kiwior,POL,Spezia,Serie A,2021,21.0,2000.0,21.8,50,27,25,19,6,26,57,45.6,31,38,15,23,40,90,53,0,MF,20-24,Midfielder,Poland,Europe
74229,Koke,ESP,Atltico Madrid,La Liga,2021,29.0,1992.0,27.9,55,30,19,29,7,26,63,41.3,37,21,5,16,24,79,31,1,MF,25-29,Midfielder,Spain,Europe
176553,Aymeric Laporte,ESP,Manchester City,Premier League,2021,27.0,1994.0,31.4,33,15,22,10,1,14,20,70.0,6,15,10,5,20,53,64,2,DF,25-29,Defender,Spain,Europe
70411,Darko Lazovi,SRB,Hellas Verona,Serie A,2021,30.0,1990.0,30.7,36,23,20,8,8,21,39,53.8,18,28,4,24,19,55,49,1,DF,30-34,Defender,Serbia,Europe
255501,Iigo Lekue,ESP,Athletic Club,La Liga,2021,28.0,1993.0,21.4,32,23,16,12,4,22,44,50.0,22,37,12,25,23,55,63,0,DF,25-29,Defender,Spain,Europe
225873,Karol Linetty,POL,Torino,Serie A,2021,26.0,1995.0,10.0,14,8,3,4,7,6,18,33.3,12,8,0,8,3,17,2,0,"MF,FW",25-29,Midfielder,Poland,Europe
298975,Pol Lirola,ESP,Marseille,Ligue 1,2021,23.0,1997.0,19.7,28,16,15,9,4,13,28,46.4,15,15,0,15,13,41,22,0,"DF,FW",20-24,Defender,Spain,Europe
710131,Diego Llorente,ESP,Leeds United,Premier League,2021,27.0,1993.0,26.0,53,31,32,19,2,33,47,70.2,14,35,17,18,40,93,77,2,DF,25-29,Defender,Spain,Europe
947431,David Lpez,ESP,Espanyol,La Liga,2021,31.0,1989.0,8.3,18,13,9,8,1,9,16,56.3,7,10,8,2,10,28,25,2,"MF,DF",30-34,Midfielder,Spain,Europe
192009,Unai Lpez,ESP,Rayo Vallecano,La Liga,2021,25.0,1995.0,12.9,19,9,6,10,3,10,33,30.3,23,7,0,7,10,29,8,1,MF,25-29,Midfielder,Spain,Europe
252677,Jos Luis Morales,ESP,Levante,La Liga,2021,34.0,1987.0,30.2,27,17,6,9,12,12,42,28.6,30,29,0,29,4,31,7,0,"FW,MF",30-34,Forward,Spain,Europe
245056,Saa Luki,SRB,Torino,Serie A,2021,24.0,1996.0,33.1,51,34,17,27,7,19,43,44.2,24,34,6,28,24,75,41,0,MF,20-24,Midfielder,Serbia,Europe
251876,Pablo Maffeo,ESP,Mallorca,La Liga,2021,24.0,1997.0,32.7,84,47,48,28,8,38,69,55.1,31,30,13,17,46,130,74,0,DF,20-24,Defender,Spain,Europe
162029,Javier Manquillo,ESP,Newcastle Utd,Premier League,2021,27.0,1994.0,14.0,39,29,28,10,1,21,36,58.3,15,15,6,9,10,49,32,0,DF,25-29,Defender,Spain,Europe
225462,Jos Mari,ESP,Cdiz,La Liga,2021,33.0,1987.0,4.3,14,7,3,10,1,7,8,87.5,1,4,1,3,7,21,2,0,MF,30-34,Midfielder,Spain,Europe
212391,Roger Mart,ESP,Levante,La Liga,2021,30.0,1991.0,23.5,23,14,3,13,7,8,30,26.7,22,14,0,14,2,25,8,0,FW,30-34,Forward,Spain,Europe
251878,Aarn Martn,ESP,Mainz 05,Bundesliga,2021,24.0,1997.0,25.5,54,33,32,18,4,24,55,43.6,31,24,4,20,20,74,35,0,DF,20-24,Defender,Spain,Europe
531277,Andrs Martn,ESP,Rayo Vallecano,La Liga,2021,22.0,1999.0,2.1,0,0,0,0,0,0,1,0.0,1,1,0,1,0,0,0,0,"FW,MF",20-24,Forward,Spain,Europe
158863,Iigo Martnez,ESP,Athletic Club,La Liga,2021,30.0,1991.0,26.0,28,13,18,7,3,14,23,60.9,9,22,10,12,39,67,143,0,DF,30-34,Defender,Spain,Europe
471474,Javi Martnez,ESP,Osasuna,La Liga,2021,21.0,1999.0,9.8,21,14,8,11,2,10,29,34.5,19,6,0,6,9,30,10,0,"MF,FW",20-24,Midfielder,Spain,Europe
568835,Pablo Martnez,ESP,Levante,La Liga,2021,23.0,1998.0,7.3,15,8,7,8,0,4,13,30.8,9,6,3,3,15,30,5,0,MF,20-24,Midfielder,Spain,Europe
227961,Jaime Mata,ESP,Getafe,La Liga,2021,32.0,1988.0,7.5,7,5,3,1,3,1,9,11.1,8,4,1,3,1,8,5,0,FW,30-34,Forward,Spain,Europe
162056,Gonzalo Melero,ESP,Levante,La Liga,2021,27.0,1994.0,18.8,29,16,10,15,4,16,36,44.4,20,21,8,13,7,36,22,0,MF,25-29,Midfielder,Spain,Europe
309110,Brais Mndez,ESP,Celta Vigo,La Liga,2021,24.0,1997.0,33.6,68,35,24,35,9,26,87,29.9,61,52,6,46,37,105,30,0,MF,20-24,Midfielder,Spain,Europe
413507,Nikola Milenkovi,SRB,Fiorentina,Serie A,2021,23.0,1997.0,32.5,54,32,31,20,3,29,34,85.3,5,30,15,15,39,93,94,0,DF,20-24,Defender,Serbia,Europe
191891,Arkadiusz Milik,POL,Marseille,Ligue 1,2021,27.0,1994.0,15.7,9,2,0,5,4,4,18,22.2,14,9,1,8,3,12,10,1,FW,25-29,Forward,Poland,Europe
266302,Sergej Milinkovi-Savi,SRB,Lazio,Serie A,2021,26.0,1995.0,34.4,67,44,20,32,15,29,67,43.3,38,50,9,41,34,101,43,1,MF,25-29,Midfielder,Serbia,Europe
281989,Luis Milla,ESP,Granada,La Liga,2021,26.0,1994.0,30.8,59,29,25,30,4,25,64,39.1,39,28,4,24,25,84,34,0,MF,25-29,Midfielder,Spain,Europe
225593,Pere Milla,ESP,Elche,La Liga,2021,28.0,1992.0,18.3,20,15,14,5,1,8,44,18.2,36,21,1,20,5,25,21,0,"MF,FW",25-29,Midfielder,Spain,Europe
255653,Santi Mina,ESP,Celta Vigo,La Liga,2021,25.0,1995.0,26.3,27,17,8,15,4,5,32,15.6,27,28,2,26,6,33,22,0,FW,25-29,Forward,Spain,Europe
331505,scar Mingueza,ESP,Barcelona,La Liga,2021,22.0,1999.0,9.9,25,11,12,11,2,16,23,69.6,7,5,0,5,9,34,22,1,DF,20-24,Defender,Spain,Europe
361254,Rafa Mir,ESP,Sevilla,La Liga,2021,24.0,1997.0,20.1,4,3,1,1,2,0,11,0.0,11,4,3,1,0,4,17,0,FW,20-24,Forward,Spain,Europe
228917,Jorge Miramn,ESP,Levante,La Liga,2021,32.0,1989.0,22.0,36,19,16,12,8,15,44,34.1,29,15,3,12,35,71,58,0,DF,30-34,Defender,Spain,Europe
341227,Juan Miranda,ESP,Betis,La Liga,2021,21.0,2000.0,8.7,21,11,16,4,1,12,22,54.5,10,10,4,6,15,36,22,0,DF,20-24,Defender,Spain,Europe
57825,Jorge Molina,ESP,Granada,La Liga,2021,39.0,1982.0,21.8,4,2,2,1,1,2,18,11.1,16,13,2,11,6,10,11,0,FW,35-39,Forward,Spain,Europe
552425,Jon Moncayola,ESP,Osasuna,La Liga,2021,23.0,1998.0,32.4,40,20,18,18,4,17,44,38.6,27,26,9,17,20,60,43,0,MF,20-24,Midfielder,Spain,Europe
59551,ngel Montoro,ESP,Granada,La Liga,2021,33.0,1988.0,14.8,26,13,16,7,3,17,27,63.0,10,11,1,10,11,37,29,1,MF,30-34,Midfielder,Spain,Europe
568149,Alberto Moreno,ESP,Villarreal,La Liga,2021,29.0,1992.0,13.6,13,7,5,7,1,5,18,27.8,13,13,1,12,27,40,15,0,"MF,DF",25-29,Midfielder,Spain,Europe
193098,lex Moreno,ESP,Betis,La Liga,2021,28.0,1993.0,26.7,76,40,53,15,8,33,60,55.0,27,28,6,22,34,110,82,1,DF,25-29,Defender,Spain,Europe
177467,Gerard Moreno,ESP,Villarreal,La Liga,2021,29.0,1992.0,13.2,5,2,2,2,1,1,7,14.3,6,6,1,5,6,11,14,0,FW,25-29,Forward,Spain,Europe
339816,Tete Morente,ESP,Elche,La Liga,2021,24.0,1996.0,18.1,21,14,13,7,1,7,28,25.0,21,30,1,29,12,33,12,0,MF,20-24,Midfielder,Spain,Europe
295065,Toni Moya,ESP,Alavs,La Liga,2021,23.0,1998.0,15.4,23,10,7,13,3,13,43,30.2,30,18,5,13,20,43,18,0,MF,20-24,Midfielder,Spain,Europe
54235,Iker Muniain,ESP,Athletic Club,La Liga,2021,28.0,1992.0,30.9,32,10,8,19,5,12,40,30.0,28,20,1,19,17,49,8,1,MF,25-29,Midfielder,Spain,Europe
15956,Jess Navas,ESP,Sevilla,La Liga,2021,35.0,1985.0,19.8,18,13,11,5,2,9,17,52.9,8,15,2,13,17,35,26,1,DF,35-39,Defender,Spain,Europe
18644,lvaro Negredo,ESP,Cdiz,La Liga,2021,35.0,1985.0,24.0,5,3,1,4,0,3,6,50.0,3,11,5,6,2,7,23,0,FW,35-39,Forward,Spain,Europe
448844,Carlos Neva,ESP,Granada,La Liga,2021,25.0,1996.0,23.4,31,19,24,7,0,16,28,57.1,12,27,9,18,32,63,81,0,DF,25-29,Defender,Spain,Europe
70934,Nolito,ESP,Celta Vigo,La Liga,2021,34.0,1986.0,15.4,25,15,14,7,4,13,47,27.7,34,20,1,19,9,34,5,0,MF,30-34,Midfielder,Spain,Europe
668276,Hugo Novoa,ESP,RB Leipzig,Bundesliga,2021,18.0,2003.0,1.5,4,4,2,0,2,2,7,28.6,5,2,0,2,1,5,0,0,"MF,FW",Under 20,Midfielder,Spain,Europe
338285,Unai Nez,ESP,Athletic Club,La Liga,2021,24.0,1997.0,6.9,4,4,2,2,0,3,6,50.0,3,9,8,1,8,12,26,2,DF,20-24,Defender,Spain,Europe
280730,lvaro Odriozola,ESP,Fiorentina,Serie A,2021,25.0,1995.0,19.3,25,15,12,6,7,15,32,46.9,17,17,6,11,8,33,25,2,DF,25-29,Defender,Spain,Europe
166677,Brian Olivn,ESP,Mallorca,La Liga,2021,27.0,1994.0,24.3,33,20,22,9,2,12,23,52.2,11,17,7,10,28,61,63,0,DF,25-29,Defender,Spain,Europe
293385,Dani Olmo,ESP,RB Leipzig,Bundesliga,2021,23.0,1998.0,8.3,14,6,5,7,2,5,18,27.8,13,5,1,4,4,18,1,0,"MF,FW",20-24,Midfielder,Spain,Europe
230784,Thomas Partey,GHA,Arsenal,Premier League,2021,28.0,1993.0,22.5,43,29,22,17,4,18,44,40.9,26,22,4,18,23,66,35,2,MF,25-29,Midfielder,Ghana,Africa
274461,Felix Passlack,GER,Dortmund,Bundesliga,2021,23.0,1998.0,5.2,13,9,8,4,1,6,12,50.0,6,5,1,4,4,17,7,0,DF,20-24,Defender,Germany,Europe
55215,Javier Pastore,ARG,Elche,La Liga,2021,32.0,1989.0,5.8,7,3,3,2,2,3,12,25.0,9,5,1,4,4,11,2,0,"MF,FW",30-34,Midfielder,Argentina,South America
842718,Paulinho,BRA,Leverkusen,Bundesliga,2021,21.0,2000.0,13.5,22,13,6,13,3,13,27,48.1,14,14,1,13,6,28,7,0,"FW,MF",20-24,Forward,Brazil,South America
353366,Benjamin Pavard,FRA,Bayern Munich,Bundesliga,2021,25.0,1996.0,23.1,35,20,21,13,1,19,29,65.5,10,28,16,12,36,71,50,1,DF,25-29,Defender,France,Europe
64793,Leonardo Pavoletti,ITA,Cagliari,Serie A,2021,32.0,1988.0,16.9,10,6,2,5,3,3,9,33.3,6,9,5,4,2,12,12,0,FW,30-34,Forward,Italy,Europe
37647,Dimitri Payet,FRA,Marseille,Ligue 1,2021,34.0,1987.0,28.8,16,8,4,10,2,7,31,22.6,24,9,0,9,9,25,3,0,"FW,MF",30-34,Forward,France,Europe
286297,Lorenzo Pellegrini,ITA,Roma,Serie A,2021,25.0,1996.0,25.4,35,14,10,17,8,16,60,26.7,44,29,1,28,27,62,20,0,MF,25-29,Midfielder,Italy,Europe
346567,Luca Pellegrini,ITA,Juventus,Serie A,2021,22.0,1999.0,12.3,23,10,13,5,5,12,19,63.2,7,9,1,8,5,28,23,0,DF,20-24,Defender,Italy,Europe
343052,Nicolas Pp,CIV,Arsenal,Premier League,2021,26.0,1995.0,7.7,8,5,3,5,0,3,9,33.3,6,9,1,8,8,16,2,0,"FW,MF",25-29,Forward,Ivory Coast,Africa
141050,Danilo Pereira,POR,Paris S-G,Ligue 1,2021,29.0,1991.0,22.6,33,17,10,20,3,14,28,50.0,14,19,10,9,37,70,29,1,MF,25-29,Midfielder,Portugal,Europe
264116,Gastn Pereiro,URU,Cagliari,Serie A,2021,26.0,1995.0,10.8,13,5,7,4,2,5,18,27.8,13,12,1,11,1,14,8,0,"FW,MF",25-29,Forward,Uruguay,South America
54984,Diego Perotti,ARG,Salernitana,Serie A,2021,33.0,1988.0,3.2,11,5,7,1,3,4,13,30.8,9,1,0,1,2,13,6,0,"MF,FW",30-34,Midfielder,Argentina,South America
318523,Romain Perraud,FRA,Southampton,Premier League,2021,23.0,1997.0,18.0,34,22,18,14,2,16,29,55.2,13,24,6,18,17,51,42,0,DF,20-24,Defender,France,Europe
199258,Andrea Petagna,ITA,Napoli,Serie A,2021,26.0,1995.0,6.5,3,3,0,3,0,1,4,25.0,3,1,0,1,0,3,5,0,FW,25-29,Forward,Italy,Europe
42936,Nils Petersen,GER,Freiburg,Bundesliga,2021,32.0,1988.0,6.4,5,3,2,3,0,1,13,7.7,12,7,0,7,2,7,17,0,FW,30-34,Forward,Germany,Europe
113133,Germn Pezzella,ARG,Betis,La Liga,2021,30.0,1991.0,22.1,21,9,16,5,0,16,29,55.2,13,29,18,11,39,60,106,0,DF,30-34,Defender,Argentina,South America
336960,Giuseppe Pezzella,ITA,Atalanta,Serie A,2021,23.0,1997.0,11.9,28,13,15,7,6,8,18,44.4,10,13,5,8,9,37,16,0,"DF,MF",20-24,Defender,Italy,Europe
351749,Kalvin Phillips,ENG,Leeds United,Premier League,2021,25.0,1995.0,17.7,54,25,24,25,5,24,57,42.1,33,37,9,28,24,78,18,0,MF,25-29,Midfielder,England,Europe
56067,Pablo Piatti,ARG,Elche,La Liga,2021,32.0,1989.0,3.5,9,4,5,3,1,3,8,37.5,5,5,1,4,2,11,3,0,"MF,FW",30-34,Midfielder,Argentina,South America
163086,Cristiano Piccini,ITA,Valencia,La Liga,2021,28.0,1992.0,3.6,14,8,9,5,0,5,7,71.4,2,3,2,1,1,15,11,0,DF,25-29,Defender,Italy,Europe
334221,Amos Pieper,GER,Arminia,Bundesliga,2021,23.0,1998.0,26.4,58,29,38,19,1,32,51,62.7,19,37,23,14,50,108,132,1,DF,20-24,Defender,Germany,Europe
410185,Ronal Pierre-Gabriel,FRA,Brest,Ligue 1,2021,23.0,1998.0,28.3,79,45,52,21,6,42,73,57.5,31,22,7,15,48,127,74,0,DF,20-24,Defender,France,Europe
315865,Andrea Pinamonti,ITA,Empoli,Serie A,2021,22.0,1999.0,31.9,11,6,0,7,4,2,18,11.1,16,24,3,21,7,18,23,0,FW,20-24,Forward,Italy,Europe
442248,Ethan Pinnock,JAM,Brentford,Premier League,2021,28.0,1993.0,29.9,51,35,37,12,2,25,38,65.8,13,30,11,19,44,95,154,1,DF,25-29,Defender,Jamaica,North America
167329,Alassane Pla,FRA,Gladbach,Bundesliga,2021,28.0,1993.0,23.0,18,14,6,9,3,7,20,35.0,13,9,1,8,4,22,9,0,"MF,FW",25-29,Midfielder,France,Europe
392538,Tommaso Pobega,ITA,Torino,Serie A,2021,22.0,1999.0,24.9,48,30,17,20,11,21,40,52.5,19,32,3,29,25,73,38,0,MF,20-24,Midfielder,Italy,Europe
122153,Paul Pogba,FRA,Manchester Utd,Premier League,2021,28.0,1993.0,15.0,13,9,5,7,1,6,28,21.4,22,11,0,11,13,26,16,0,"MF,FW",25-29,Midfielder,France,Europe
60957,Sebastian Polter,GER,Bochum,Bundesliga,2021,30.0,1991.0,26.0,9,3,1,4,4,2,11,18.2,9,15,5,10,2,11,24,0,FW,30-34,Forward,Germany,Europe
223974,Stefan Posch,AUT,Hoffenheim,Bundesliga,2021,24.0,1997.0,24.4,48,30,20,26,2,22,39,56.4,17,43,18,25,28,76,71,2,DF,20-24,Defender,Austria,Europe
157635,Yussuf Poulsen,DEN,RB Leipzig,Bundesliga,2021,27.0,1994.0,12.0,13,4,3,6,4,3,13,23.1,10,13,0,13,3,16,9,0,"FW,MF",25-29,Forward,Denmark,Europe
122116,Nicolas de Prville,FRA,Metz,Ligue 1,2021,30.0,1991.0,21.9,17,8,7,8,2,3,19,15.8,16,12,4,8,5,22,11,0,"FW,MF",30-34,Forward,France,Europe
234029,Grischa Prmel,GER,Union Berlin,Bundesliga,2021,26.0,1995.0,26.9,36,22,14,17,5,22,52,42.3,30,18,3,15,23,59,22,0,MF,25-29,Midfielder,Germany,Europe
46972,Teemu Pukki,FIN,Norwich City,Premier League,2021,31.0,1990.0,36.1,23,11,2,14,7,6,29,20.7,23,21,1,20,4,27,3,0,FW,30-34,Forward,Finland,Europe
215616,Erick Pulgar,CHI,Fiorentina,Serie A,2021,27.0,1994.0,3.8,6,6,4,2,0,4,9,44.4,5,5,1,4,5,11,2,1,MF,25-29,Midfielder,Chile,South America
315779,Christian Pulisic,USA,Chelsea,Premier League,2021,22.0,1998.0,14.3,10,7,6,3,1,3,17,17.6,14,12,0,12,5,15,10,0,"MF,FW",20-24,Midfielder,United States,North America
283528,Ignacio Pussetto,ARG,Udinese,Serie A,2021,25.0,1995.0,13.4,17,9,2,9,6,2,10,20.0,8,18,2,16,4,21,13,0,"FW,MF",25-29,Forward,Argentina,South America
22328,Fabio Quagliarella,ITA,Sampdoria,Serie A,2021,38.0,1983.0,18.5,6,2,2,2,2,2,15,13.3,13,14,1,13,3,9,12,0,FW,35-39,Forward,Italy,Europe
182913,Adrien Rabiot,FRA,Juventus,Serie A,2021,26.0,1995.0,25.4,64,43,32,24,8,15,34,44.1,19,34,8,26,20,84,41,1,MF,25-29,Midfielder,France,Europe
51118,Adil Rami,FRA,Troyes,Ligue 1,2021,35.0,1985.0,13.0,10,9,6,4,0,7,8,87.5,1,17,9,8,16,26,43,0,DF,35-39,Defender,France,Europe
503749,Jacob Ramsey,ENG,Aston Villa,Premier League,2021,20.0,2001.0,27.4,67,44,31,28,8,30,69,43.5,39,36,7,29,24,91,28,0,MF,20-24,Midfielder,England,Europe
346561,Luca Ranieri,ITA,Salernitana,Serie A,2021,22.0,1999.0,23.4,38,21,23,11,4,19,33,57.6,14,18,8,10,22,60,67,0,DF,20-24,Defender,Italy,Europe
384745,Tobias Raschl,GER,Greuther Frth,Bundesliga,2021,21.0,2000.0,6.6,12,9,4,8,0,5,7,71.4,2,10,1,9,3,15,1,0,MF,20-24,Midfielder,Germany,Europe
405885,Giacomo Raspadori,ITA,Sassuolo,Serie A,2021,21.0,2000.0,30.4,29,18,5,15,9,11,38,28.9,27,29,3,26,9,38,11,0,"MF,FW",20-24,Midfielder,Italy,Europe
318204,David Raum,GER,Hoffenheim,Bundesliga,2021,23.0,1998.0,30.6,52,29,30,10,12,30,64,46.9,34,38,5,33,27,79,39,1,"DF,FW",20-24,Defender,Germany,Europe
187587,Ante Rebi,CRO,Milan,Serie A,2021,27.0,1993.0,9.9,14,8,3,6,5,7,20,35.0,13,14,0,14,3,17,3,1,FW,25-29,Forward,Croatia,Europe
129078,Nathan Redmond,ENG,Southampton,Premier League,2021,27.0,1994.0,20.4,22,14,9,9,4,7,30,23.3,23,21,2,19,8,30,16,0,"MF,FW",25-29,Midfielder,England,Europe
326300,Jeff Reine-Adlade,FRA,Lyon,Ligue 1,2021,23.0,1998.0,2.2,5,3,4,1,0,4,5,80.0,1,2,0,2,0,5,0,1,"MF,DF",20-24,Midfielder,France,Europe
22068,Franck Ribry,FRA,Salernitana,Serie A,2021,38.0,1983.0,15.8,17,10,6,6,5,8,13,61.5,5,12,0,12,3,20,1,0,"MF,FW",35-39,Midfielder,France,Europe
467992,Samuele Ricci,ITA,Torino,Serie A,2021,19.0,2001.0,8.0,8,4,4,2,2,2,5,40.0,3,7,1,6,14,22,9,0,MF,Under 20,Midfielder,Italy,Europe
357662,Declan Rice,ENG,West Ham,Premier League,2021,22.0,1999.0,35.3,80,42,45,32,3,38,71,53.5,33,45,21,24,63,143,52,1,MF,20-24,Midfielder,England,Europe
214666,Connor Roberts,WAL,Burnley,Premier League,2021,25.0,1995.0,18.8,20,13,10,7,3,10,15,66.7,5,25,5,20,22,42,62,1,DF,25-29,Defender,Wales,Europe
296986,Tyler Roberts,WAL,Leeds United,Premier League,2021,22.0,1999.0,11.0,16,7,6,7,3,9,16,56.3,7,11,1,10,5,21,11,0,"MF,FW",20-24,Midfielder,Wales,Europe
234803,Andrew Robertson,SCO,Liverpool,Premier League,2021,27.0,1994.0,28.2,36,21,16,15,5,20,35,57.1,15,24,3,21,23,59,61,0,DF,25-29,Defender,Scotland,Europe
186862,Enzo Roco,CHI,Elche,La Liga,2021,28.0,1992.0,28.4,36,20,24,11,1,15,24,62.5,9,38,27,11,28,64,110,3,DF,25-29,Defender,Chile,South America
44466,Sebastian Rode,GER,Eint Frankfurt,Bundesliga,2021,30.0,1990.0,8.4,15,7,5,8,2,5,17,29.4,12,11,1,10,13,28,8,0,MF,30-34,Midfielder,Germany,Europe
342385,Guido Rodrguez,ARG,Betis,La Liga,2021,27.0,1994.0,28.1,97,53,46,45,6,54,98,55.1,44,55,12,43,31,128,56,0,MF,25-29,Midfielder,Argentina,South America
412363,Rodrygo,BRA,Real Madrid,La Liga,2021,20.0,2001.0,16.9,18,14,7,4,7,3,18,16.7,15,21,0,21,11,29,3,0,FW,20-24,Forward,Brazil,South America
889683,Rogrio,BRA,Sassuolo,Serie A,2021,23.0,1998.0,19.2,21,13,12,5,4,15,22,68.2,7,20,8,12,18,39,42,1,DF,20-24,Defender,Brazil,South America
197747,Alessio Romagnoli,ITA,Milan,Serie A,2021,26.0,1995.0,15.7,24,14,14,10,0,14,18,77.8,4,21,12,9,19,43,45,0,DF,25-29,Defender,Italy,Europe
88706,Simone Romagnoli,ITA,Empoli,Serie A,2021,31.0,1990.0,16.6,28,12,14,12,2,15,20,75.0,5,34,28,6,9,37,86,0,DF,30-34,Defender,Italy,Europe
355915,Cristian Romero,ARG,Tottenham,Premier League,2021,23.0,1998.0,20.5,62,39,39,21,2,22,34,64.7,12,46,21,25,33,95,74,1,DF,20-24,Defender,Argentina,South America
769063,Luka Romero,ARG,Lazio,Serie A,2021,16.0,2004.0,0.9,2,1,0,1,1,0,2,0.0,2,0,0,0,1,3,0,0,FW,Under 20,Forward,Argentina,South America
80197,Salomn Rondn,VEN,Everton,Premier League,2021,31.0,1989.0,8.8,6,1,1,2,3,4,14,28.6,10,5,0,5,0,6,10,0,FW,30-34,Forward,Venezuela,South America
332889,Valentin Rongier,FRA,Marseille,Ligue 1,2021,26.0,1994.0,24.4,77,51,36,36,5,28,60,46.7,32,26,5,21,33,110,14,0,"MF,DF",25-29,Midfielder,France,Europe
370791,Pablo Rosario,NED,Nice,Ligue 1,2021,24.0,1997.0,30.3,59,37,18,32,9,26,66,39.4,40,33,7,26,38,97,43,0,MF,20-24,Midfielder,Netherlands,Europe
50174,Danny Rose,ENG,Watford,Premier League,2021,31.0,1990.0,7.7,16,10,11,4,1,10,24,41.7,14,8,5,3,14,30,11,1,DF,30-34,Defender,England,Europe
127076,Jrme Roussillon,FRA,Wolfsburg,Bundesliga,2021,28.0,1993.0,19.7,14,9,8,6,0,10,16,62.5,6,24,5,19,14,28,34,2,DF,25-29,Defender,France,Europe
525704,Nicol Rovella,ITA,Genoa,Serie A,2021,19.0,2001.0,16.3,37,26,16,14,7,15,40,37.5,25,21,1,20,20,57,20,0,MF,Under 20,Midfielder,Italy,Europe
86202,Antonio Rdiger,GER,Chelsea,Premier League,2021,28.0,1993.0,33.7,48,28,29,15,4,36,48,75.0,12,20,11,9,28,76,91,1,DF,25-29,Defender,Germany,Europe
57051,Sebastian Rudy,GER,Hoffenheim,Bundesliga,2021,31.0,1990.0,8.6,22,12,9,13,0,11,21,52.4,10,8,3,5,11,33,8,1,MF,30-34,Midfielder,Germany,Europe
87884,Mrio Rui,POR,Napoli,Serie A,2021,30.0,1991.0,33.2,68,43,32,28,8,39,84,46.4,45,31,7,24,40,108,50,0,DF,30-34,Defender,Portugal,Europe
538977,Georginio Rutter,FRA,Hoffenheim,Bundesliga,2021,19.0,2002.0,17.9,18,13,4,8,6,6,17,35.3,11,29,1,28,6,24,11,1,"FW,MF",Under 20,Forward,France,Europe
243737,Roli Pereira de Sa,FRA,Nantes,Ligue 1,2021,24.0,1996.0,6.4,12,4,3,5,4,3,20,15.0,17,6,0,6,6,18,3,0,MF,20-24,Midfielder,France,Europe
135492,Youssouf Sabaly,SEN,Betis,La Liga,2021,28.0,1993.0,8.8,12,10,11,0,1,7,13,53.8,6,11,4,7,13,25,16,1,DF,25-29,Defender,Senegal,Africa
167491,Stefano Sabelli,ITA,Genoa,Serie A,2021,28.0,1993.0,3.9,6,3,3,2,1,3,9,33.3,6,5,1,4,3,9,12,0,DF,25-29,Defender,Italy,Europe
340394,Abdelhamid Sabiri,MAR,Sampdoria,Serie A,2021,24.0,1996.0,9.9,34,18,10,15,9,7,25,28.0,18,10,2,8,7,41,3,0,"MF,FW",20-24,Midfielder,Morocco,Africa
381950,Alexis Saelemaekers,BEL,Milan,Serie A,2021,22.0,1999.0,20.7,43,22,12,17,14,15,51,29.4,36,19,0,19,15,58,8,0,FW,20-24,Forward,Belgium,Europe
182916,Wesley Sad,FRA,Lens,Ligue 1,2021,26.0,1995.0,7.3,10,5,1,8,1,1,9,11.1,8,4,0,4,2,12,0,0,"FW,MF",25-29,Forward,France,Europe
433177,Bukayo Saka,ENG,Arsenal,Premier League,2021,19.0,2001.0,33.1,40,21,12,17,11,13,39,33.3,26,28,2,26,22,62,23,0,"FW,MF",Under 20,Forward,England,Europe
96806,Jacopo Sala,ITA,Spezia,Serie A,2021,29.0,1991.0,9.8,22,11,10,10,2,13,30,43.3,17,6,0,6,14,36,11,0,MF,25-29,Midfielder,Italy,Europe
148455,Mohamed Salah,EGY,Liverpool,Premier League,2021,29.0,1992.0,30.7,17,8,5,9,3,6,19,31.6,13,7,1,6,6,23,5,0,FW,25-29,Forward,Egypt,Africa
495666,William Saliba,FRA,Marseille,Ligue 1,2021,20.0,2001.0,36.0,54,32,36,16,2,27,35,77.1,8,24,16,8,48,102,85,0,DF,20-24,Defender,France,Europe
563963,Mohammed Salisu,GHA,Southampton,Premier League,2021,22.0,1999.0,33.0,80,47,54,22,4,40,65,61.5,25,49,26,23,78,158,158,4,DF,20-24,Defender,Ghana,Africa
381967,Albert Sambi Lokonga,BEL,Arsenal,Premier League,2021,21.0,1999.0,12.6,22,18,11,9,2,12,14,85.7,2,12,7,5,13,35,12,4,MF,20-24,Midfielder,Belgium,Europe
335147,Junior Sambia,FRA,Montpellier,Ligue 1,2021,24.0,1996.0,17.0,22,13,12,7,3,13,22,59.1,9,22,3,19,21,43,31,0,"DF,FW",20-24,Defender,France,Europe
234523,Antonio Sanabria,PAR,Torino,Serie A,2021,25.0,1996.0,20.0,3,2,0,1,2,1,4,25.0,3,11,4,7,2,5,10,0,FW,25-29,Forward,Paraguay,South America
40433,Alexis Snchez,CHI,Inter,Serie A,2021,32.0,1988.0,9.8,9,8,0,6,3,2,11,18.2,9,4,0,4,2,11,3,0,FW,30-34,Forward,Chile,South America
401173,Jadon Sancho,ENG,Manchester Utd,Premier League,2021,21.0,2000.0,21.1,14,8,9,4,1,8,22,36.4,14,19,0,19,15,29,5,3,"FW,MF",20-24,Forward,England,Europe
79960,Alex Sandro,BRA,Juventus,Serie A,2021,30.0,1991.0,19.8,27,16,15,9,3,11,25,44.0,14,17,6,11,27,54,40,0,DF,30-34,Defender,Brazil,South America
192565,Leroy San,GER,Bayern Munich,Bundesliga,2021,25.0,1996.0,22.0,28,16,5,19,4,9,24,37.5,15,18,0,18,12,40,2,1,"FW,MF",25-29,Forward,Germany,Europe
82048,Nicola Sansone,ITA,Bologna,Serie A,2021,29.0,1991.0,10.0,13,7,5,6,2,3,15,20.0,12,1,0,1,4,17,2,0,"FW,MF",25-29,Forward,Italy,Europe
99180,Federico Santander,PAR,Bologna,Serie A,2021,30.0,1991.0,0.7,2,1,1,1,0,1,1,100.0,0,0,0,0,0,2,0,0,"FW,DF",30-34,Forward,Paraguay,South America
393325,Josh Sargent,USA,Norwich City,Premier League,2021,21.0,2000.0,17.5,26,14,15,7,4,14,39,35.9,25,29,2,27,11,37,18,2,"FW,MF",20-24,Forward,United States,North America
127156,Tji Savanier,FRA,Montpellier,Ligue 1,2021,29.0,1991.0,26.8,46,27,18,19,9,21,59,35.6,38,23,1,22,25,71,12,1,MF,25-29,Midfielder,France,Europe
240360,Esteban Saveljich,MNE,Rayo Vallecano,La Liga,2021,30.0,1991.0,18.9,18,11,11,7,0,9,15,60.0,6,20,12,8,16,34,69,0,DF,30-34,Defender,Montenegro,Europe
504153,Joe Scally,USA,Gladbach,Bundesliga,2021,18.0,2002.0,21.2,40,30,21,14,5,17,41,41.5,24,27,4,23,22,62,38,0,DF,Under 20,Defender,United States,North America
571604,Giorgio Scalvini,ITA,Atalanta,Serie A,2021,17.0,2003.0,8.5,22,11,13,8,1,9,19,47.4,10,12,1,11,22,44,16,0,"DF,MF",Under 20,Defender,Italy,Europe
315867,Gianluca Scamacca,ITA,Sassuolo,Serie A,2021,22.0,1999.0,23.8,19,14,2,5,12,5,21,23.8,16,16,1,15,5,24,22,1,FW,20-24,Forward,Italy,Europe
473050,Kevin Schade,GER,Freiburg,Bundesliga,2021,19.0,2001.0,9.2,9,7,6,2,1,3,10,30.0,7,15,3,12,3,12,16,0,"MF,FW",Under 20,Midfielder,Germany,Europe
454863,Andrs Schfer,HUN,Union Berlin,Bundesliga,2021,22.0,1999.0,2.7,4,1,3,1,0,0,5,0.0,5,7,1,6,2,6,4,0,MF,20-24,Midfielder,Hungary,Europe
135343,Fabian Schr,SUI,Newcastle Utd,Premier League,2021,29.0,1991.0,24.0,16,11,11,3,2,8,16,50.0,8,27,18,9,32,48,95,2,DF,25-29,Defender,Switzerland,Europe
147485,Louis Schaub,AUT,Kln,Bundesliga,2021,26.0,1994.0,7.3,16,10,7,7,2,11,20,55.0,9,17,3,14,3,19,3,0,"MF,FW",25-29,Midfielder,Austria,Europe
136133,Andrea Schiavone,ITA,Salernitana,Serie A,2021,28.0,1993.0,6.3,14,8,5,9,0,10,23,43.5,13,13,3,10,8,22,12,0,MF,25-29,Midfielder,Italy,Europe
223979,Xaver Schlager,AUT,Wolfsburg,Bundesliga,2021,23.0,1997.0,11.6,43,20,20,20,3,20,49,40.8,29,25,2,23,9,52,14,0,MF,20-24,Midfielder,Austria,Europe
388198,Nico Schlotterbeck,GER,Freiburg,Bundesliga,2021,21.0,1999.0,30.9,72,43,36,34,2,33,48,68.8,15,41,32,9,56,128,154,1,DF,20-24,Defender,Germany,Europe
70285,Jonathan Schmid,FRA,Freiburg,Bundesliga,2021,31.0,1990.0,6.5,12,6,6,3,3,5,7,71.4,2,7,1,6,6,18,15,0,DF,30-34,Defender,France,Europe
160968,Benno Schmitz,GER,Kln,Bundesliga,2021,26.0,1994.0,26.9,57,37,21,27,9,42,86,48.8,44,44,8,36,39,96,39,0,DF,25-29,Defender,Germany,Europe
118397,Alessandro Schpf,AUT,Arminia,Bundesliga,2021,27.0,1994.0,26.6,40,22,19,16,5,14,30,46.7,16,31,5,26,30,70,21,1,MF,25-29,Midfielder,Austria,Europe
85867,Nico Schulz,GER,Dortmund,Bundesliga,2021,28.0,1993.0,9.3,21,12,9,7,5,9,21,42.9,12,8,1,7,11,32,8,0,DF,25-29,Defender,Germany,Europe
183780,Paul Seguin,GER,Greuther Frth,Bundesliga,2021,26.0,1995.0,23.4,50,31,15,32,3,26,56,46.4,30,27,3,24,19,69,30,1,MF,25-29,Midfielder,Germany,Europe
798404,Alidu Seidu,GHA,Clermont Foot,Ligue 1,2021,21.0,2000.0,15.7,34,20,20,13,1,16,27,59.3,11,25,11,14,34,68,49,1,DF,20-24,Defender,Ghana,Africa
178459,Davie Selke,GER,Hertha BSC,Bundesliga,2021,26.0,1995.0,11.2,5,4,1,3,1,1,3,33.3,2,6,1,5,1,6,11,0,FW,25-29,Forward,Germany,Europe
252345,Ken Sema,SWE,Watford,Premier League,2021,27.0,1993.0,9.5,16,6,11,4,1,9,20,45.0,11,10,0,10,5,21,11,0,"MF,FW",25-29,Midfielder,Sweden,Europe
231572,Nlson Semedo,POR,Wolves,Premier League,2021,27.0,1993.0,23.7,58,39,39,17,2,25,49,51.0,24,23,4,19,21,79,64,1,"MF,DF",25-29,Midfielder,Portugal,Europe
261905,Suat Serdar,GER,Hertha BSC,Bundesliga,2021,24.0,1997.0,24.6,64,30,24,29,11,25,55,45.5,30,32,3,29,20,84,14,0,"MF,FW",20-24,Midfielder,Germany,Europe
392775,Ryan Sessegnon,ENG,Tottenham,Premier League,2021,21.0,2000.0,11.6,25,19,14,7,4,11,22,50.0,11,18,3,15,7,32,26,0,"DF,MF",20-24,Defender,England,Europe
94529,Stephan El Shaarawy,ITA,Roma,Serie A,2021,28.0,1992.0,11.7,13,8,4,9,0,4,6,66.7,2,10,2,8,11,24,8,0,"FW,DF",25-29,Forward,Italy,Europe
534700,Jamie Shackleton,ENG,Leeds United,Premier League,2021,21.0,1999.0,7.9,27,16,19,7,1,13,25,52.0,12,11,7,4,8,35,12,1,"DF,MF",20-24,Defender,England,Europe
86792,Xherdan Shaqiri,SUI,Lyon,Ligue 1,2021,29.0,1991.0,7.5,7,3,0,5,2,2,10,20.0,8,2,0,2,2,9,2,0,"FW,MF",25-29,Forward,Switzerland,Europe
183288,Luke Shaw,ENG,Manchester Utd,Premier League,2021,26.0,1995.0,17.8,21,13,9,9,3,12,21,57.1,9,22,11,11,9,30,22,2,DF,25-29,Defender,England,Europe
358166,Eldor Shomurodov,UZB,Roma,Serie A,2021,26.0,1995.0,8.7,5,4,0,4,1,1,10,10.0,9,8,0,8,2,7,5,0,"FW,MF",25-29,Forward,Uzbekistan,Asia
161869,Djibril Sidib,FRA,Monaco,Ligue 1,2021,29.0,1992.0,10.5,24,13,13,8,3,9,24,37.5,15,10,1,9,16,40,13,0,DF,25-29,Defender,France,Europe
371436,Francisco Sierralta,CHI,Watford,Premier League,2021,24.0,1997.0,4.7,7,3,7,0,0,5,8,62.5,3,7,2,5,6,13,35,0,DF,20-24,Defender,Chile,South America
700646,Andr Silva,POR,RB Leipzig,Bundesliga,2021,25.0,1995.0,23.1,13,9,2,3,8,4,13,30.8,9,20,2,18,2,15,15,0,FW,25-29,Forward,Portugal,Europe
241641,Bernardo Silva,POR,Manchester City,Premier League,2021,26.0,1994.0,31.7,57,29,19,19,19,31,67,46.3,36,24,2,22,20,77,19,0,"MF,FW",25-29,Midfielder,Portugal,Europe
505653,Fbio Silva,POR,Wolves,Premier League,2021,19.0,2002.0,6.4,3,2,0,2,1,0,8,0.0,8,2,0,2,1,4,1,0,FW,Under 20,Forward,Portugal,Europe
1074917,Jonathan Silva,ARG,Getafe,La Liga,2021,27.0,1994.0,2.5,10,8,4,4,2,7,12,58.3,5,4,0,4,3,13,7,0,"DF,FW",25-29,Defender,Argentina,South America
294817,Thiago Silva,BRA,Chelsea,Premier League,2021,36.0,1984.0,29.4,32,21,19,12,1,11,22,50.0,11,54,31,23,44,76,100,0,DF,35-39,Defender,Brazil,South America
666234,Mohamed Simakan,FRA,RB Leipzig,Bundesliga,2021,21.0,2000.0,22.3,48,27,25,21,2,27,41,65.9,14,22,11,11,40,88,46,1,DF,20-24,Defender,France,Europe
274862,Moses Simon,NGA,Nantes,Ligue 1,2021,26.0,1995.0,25.9,17,11,6,5,6,11,23,47.8,12,14,3,11,12,29,5,0,"FW,MF",25-29,Forward,Nigeria,Africa
648779,Wilfried Singo,CIV,Torino,Serie A,2021,20.0,2000.0,29.0,55,35,24,24,7,24,34,70.6,10,26,6,20,23,78,47,0,DF,20-24,Defender,Ivory Coast,Africa
740674,Issouf Sissokho,MLI,Bordeaux,Ligue 1,2021,19.0,2002.0,4.8,17,8,2,13,2,8,17,47.1,9,8,1,7,7,24,0,0,MF,Under 20,Midfielder,Mali,Africa
372712,Ibrahima Sissoko,MLI,Strasbourg,Ligue 1,2021,23.0,1997.0,25.6,47,23,18,20,9,19,46,41.3,27,32,11,21,35,82,31,0,"MF,DF",20-24,Midfielder,Mali,Africa
46001,Moussa Sissoko,FRA,Watford,Premier League,2021,31.0,1989.0,35.8,53,27,27,20,6,28,42,66.7,14,42,13,29,30,83,64,0,MF,30-34,Midfielder,France,Europe
290587,Ellyes Skhiri,TUN,Kln,Bundesliga,2021,26.0,1995.0,20.2,55,33,25,26,4,22,41,53.7,19,41,7,34,37,92,35,1,MF,25-29,Midfielder,Tunisia,Africa
406638,Oliver Skipp,ENG,Tottenham,Premier League,2021,20.0,2000.0,15.0,33,19,14,18,1,15,31,48.4,16,19,7,12,12,45,10,1,MF,20-24,Midfielder,England,Europe
432982,Andreas Skov Olsen,DEN,Bologna,Serie A,2021,21.0,1999.0,8.3,12,10,4,4,4,5,11,45.5,6,9,1,8,3,15,11,0,"FW,DF",20-24,Forward,Denmark,Europe
103427,Chris Smalling,ENG,Roma,Serie A,2021,31.0,1989.0,23.2,36,23,28,8,0,18,25,72.0,7,32,24,8,26,62,92,1,DF,30-34,Defender,England,Europe
392765,Emile Smith Rowe,ENG,Arsenal,Premier League,2021,21.0,2000.0,21.3,14,7,7,7,0,4,20,20.0,16,18,1,17,15,29,10,1,"MF,FW",20-24,Midfielder,England,Europe
112988,Cdric Soares,POR,Arsenal,Premier League,2021,29.0,1991.0,16.5,38,26,23,9,6,16,25,64.0,9,18,7,11,16,54,31,1,DF,25-29,Defender,Portugal,Europe
154396,Danilo Soares,BRA,Bochum,Bundesliga,2021,29.0,1991.0,28.5,109,71,61,39,9,56,84,66.7,28,63,9,54,62,171,65,2,DF,25-29,Defender,Brazil,South America
282694,Augusto Solari,ARG,Celta Vigo,La Liga,2021,29.0,1992.0,7.9,24,12,9,12,3,12,32,37.5,20,14,4,10,7,31,10,1,"MF,DF",25-29,Midfielder,Argentina,South America
546880,Brandon Soppy,FRA,Udinese,Serie A,2021,19.0,2002.0,8.6,20,9,8,10,2,11,16,68.8,5,10,2,8,5,25,9,1,"DF,MF",Under 20,Defender,France,Europe
293194,Borna Sosa,CRO,Stuttgart,Bundesliga,2021,23.0,1998.0,27.8,22,12,14,5,3,12,26,46.2,14,30,3,27,26,48,61,0,"DF,FW",20-24,Defender,Croatia,Europe
354726,Florian Sotoca,FRA,Lens,Ligue 1,2021,30.0,1990.0,27.6,31,19,7,20,4,12,51,23.5,39,31,4,27,25,56,41,0,"FW,MF",30-34,Forward,France,Europe
126673,Adama Soumaoro,FRA,Bologna,Serie A,2021,29.0,1992.0,25.2,15,5,5,8,2,4,9,44.4,5,22,16,6,34,49,95,0,DF,25-29,Defender,France,Europe
344605,Boubakary Soumar,FRA,Leicester City,Premier League,2021,22.0,1999.0,12.2,19,13,10,8,1,8,17,47.1,9,13,1,12,14,33,18,0,MF,20-24,Midfielder,France,Europe
111058,Arnaud Souquet,FRA,Montpellier,Ligue 1,2021,29.0,1992.0,25.9,56,35,30,17,9,32,65,49.2,33,21,7,14,34,90,60,1,DF,25-29,Defender,France,Europe
212723,Djibril Sow,SUI,Eint Frankfurt,Bundesliga,2021,24.0,1997.0,26.8,57,33,28,25,4,22,60,36.7,38,35,8,27,50,107,20,1,MF,20-24,Midfielder,Switzerland,Europe
344069,Anton Stach,GER,Mainz 05,Bundesliga,2021,22.0,1998.0,20.7,28,19,14,13,1,15,38,39.5,23,24,5,19,51,79,25,0,MF,20-24,Midfielder,Germany,Europe
162434,Niklas Stark,GER,Hertha BSC,Bundesliga,2021,26.0,1995.0,22.6,28,16,18,10,0,12,17,70.6,5,27,17,10,36,64,122,2,DF,25-29,Defender,Germany,Europe
195246,Pascal Stenzel,GER,Stuttgart,Bundesliga,2021,25.0,1996.0,10.0,24,11,15,5,4,17,33,51.5,16,13,3,10,11,35,25,0,DF,25-29,Defender,Germany,Europe
134425,Raheem Sterling,ENG,Manchester City,Premier League,2021,26.0,1994.0,23.6,23,10,3,11,9,10,23,43.5,13,12,0,12,12,35,3,0,FW,25-29,Forward,England,Europe
443710,Angelo Stiller,GER,Hoffenheim,Bundesliga,2021,20.0,2001.0,18.8,30,17,11,15,4,9,23,39.1,14,32,6,26,9,39,16,2,MF,20-24,Midfielder,Germany,Europe
48298,Lars Stindl,GER,Gladbach,Bundesliga,2021,32.0,1988.0,18.1,23,15,6,14,3,9,33,27.3,24,28,2,26,10,33,14,0,"MF,FW",30-34,Midfielder,Germany,Europe
106872,Kevin Stger,AUT,Mainz 05,Bundesliga,2021,27.0,1993.0,4.7,10,5,5,5,0,4,10,40.0,6,6,0,6,5,15,1,1,MF,25-29,Midfielder,Austria,Europe
186590,John Stones,ENG,Manchester City,Premier League,2021,27.0,1994.0,12.4,5,3,3,2,0,2,3,66.7,1,3,3,0,11,16,27,1,DF,25-29,Defender,England,Europe
57845,Tobias Strobl,GER,Augsburg,Bundesliga,2021,31.0,1990.0,3.6,8,3,3,5,0,3,11,27.3,8,7,2,5,7,15,3,0,"MF,DF",30-34,Midfielder,Germany,Europe
410708,Pascal Struijk,NED,Leeds United,Premier League,2021,21.0,1999.0,22.8,61,39,34,23,4,30,50,60.0,20,35,23,12,33,94,60,2,"DF,MF",20-24,Defender,Netherlands,Europe
76746,Damin Surez,URU,Getafe,La Liga,2021,33.0,1988.0,30.1,74,47,34,30,10,42,91,46.2,49,46,5,41,31,105,30,0,DF,30-34,Defender,Uruguay,South America
424784,Luis Surez,URU,Atltico Madrid,La Liga,2021,34.0,1987.0,20.4,8,5,2,4,2,2,10,20.0,8,8,1,7,1,9,14,0,FW,30-34,Forward,Uruguay,South America
295331,Isaac Success,NGA,Udinese,Serie A,2021,25.0,1996.0,10.1,5,2,0,3,2,1,5,20.0,4,2,0,2,2,7,6,0,"FW,MF",25-29,Forward,Nigeria,Africa
166601,Niklas Sle,GER,Bayern Munich,Bundesliga,2021,25.0,1995.0,20.4,29,23,21,7,1,18,24,75.0,6,16,12,4,28,57,49,0,DF,25-29,Defender,Germany,Europe
746695,Kamaldeen Sulemana,GHA,Rennes,Ligue 1,2021,19.0,2002.0,11.3,23,12,7,9,7,10,17,58.8,7,10,1,9,4,27,5,0,"MF,FW",Under 20,Midfielder,Ghana,Africa
39106,dm Szalai,HUN,Mainz 05,Bundesliga,2021,33.0,1987.0,2.9,3,2,0,2,1,0,2,0.0,2,2,0,2,0,3,0,0,FW,30-34,Forward,Hungary,Europe
451276,Dominik Szoboszlai,HUN,RB Leipzig,Bundesliga,2021,20.0,2000.0,17.1,17,12,5,9,3,8,27,29.6,19,30,3,27,10,27,15,0,"MF,FW",20-24,Midfielder,Hungary,Europe
196357,Jonathan Tah,GER,Leverkusen,Bundesliga,2021,25.0,1996.0,32.0,25,18,19,5,1,17,33,51.5,16,31,20,11,43,68,156,0,DF,25-29,Defender,Germany,Europe
346478,Japhet Tanganga,ENG,Tottenham,Premier League,2021,22.0,1999.0,8.2,14,8,7,6,1,9,19,47.4,10,13,5,8,9,23,31,0,DF,20-24,Defender,England,Europe
564545,Edmond Tapsoba,BFA,Leverkusen,Bundesliga,2021,22.0,1999.0,20.2,35,17,24,10,1,20,32,62.5,12,27,15,12,29,64,72,1,DF,20-24,Defender,Burkina Faso,Africa
212804,Florian Tardieu,FRA,Troyes,Ligue 1,2021,29.0,1992.0,29.2,58,25,31,21,6,31,71,43.7,40,31,9,22,42,100,38,0,MF,25-29,Midfielder,France,Europe
173504,James Tarkowski,ENG,Burnley,Premier League,2021,28.0,1992.0,34.5,65,45,47,17,1,33,47,70.2,14,75,61,14,48,113,186,4,DF,25-29,Defender,England,Europe
470815,Niklas Tauer,GER,Mainz 05,Bundesliga,2021,20.0,2001.0,5.4,16,9,9,7,0,9,14,64.3,5,6,2,4,9,25,14,0,"DF,MF",20-24,Defender,Germany,Europe
535955,Nuno Tavares,POR,Arsenal,Premier League,2021,21.0,2000.0,13.1,21,14,10,7,4,8,18,44.4,10,15,5,10,9,30,33,1,DF,20-24,Defender,Portugal,Europe
607226,Loum Tchaouna,FRA,Rennes,Ligue 1,2021,17.0,2003.0,1.0,3,1,1,2,0,1,5,20.0,4,0,0,0,2,5,0,0,"FW,MF",Under 20,Forward,France,Europe
413112,Aurlien Tchouamni,FRA,Monaco,Ligue 1,2021,21.0,2000.0,32.5,86,45,33,49,4,29,55,52.7,26,39,7,32,101,187,34,0,MF,20-24,Midfielder,France,Europe
340322,Nathan Tella,NGA,Southampton,Premier League,2021,22.0,1999.0,8.9,13,9,5,7,1,6,17,35.3,11,13,0,13,6,19,9,0,"MF,FW",20-24,Midfielder,Nigeria,Africa
255755,Alex Telles,BRA,Manchester Utd,Premier League,2021,28.0,1992.0,18.4,48,27,35,9,4,27,43,62.8,16,17,4,13,26,74,45,0,DF,25-29,Defender,Brazil,South America
533568,Nahuel Tenaglia,ARG,Alavs,La Liga,2021,25.0,1996.0,11.9,42,27,30,9,3,24,37,64.9,13,10,2,8,26,68,42,0,DF,25-29,Defender,Argentina,South America
670096,Tanner Tessmann,USA,Venezia,Serie A,2021,19.0,2001.0,7.6,11,5,4,6,1,5,14,35.7,9,19,9,10,5,16,22,0,MF,Under 20,Midfielder,United States,North America
207597,Cedric Teuchert,GER,Union Berlin,Bundesliga,2021,24.0,1997.0,1.2,3,2,3,0,0,2,6,33.3,4,1,0,1,0,3,0,0,"MF,FW",20-24,Midfielder,Germany,Europe
368891,Arthur Theate,BEL,Bologna,Serie A,2021,21.0,2000.0,26.9,33,19,26,3,4,14,31,45.2,17,29,16,13,42,75,69,0,DF,20-24,Defender,Belgium,Europe
472249,Jan Thielmann,GER,Kln,Bundesliga,2021,19.0,2002.0,13.2,24,16,6,12,6,8,23,34.8,15,23,2,21,10,34,11,0,"MF,FW",Under 20,Midfielder,Germany,Europe
57467,Romain Thomas,FRA,Angers,Ligue 1,2021,33.0,1988.0,28.5,49,37,28,21,0,30,57,52.6,27,35,19,16,44,93,126,0,DF,30-34,Defender,France,Europe
215977,Adrien Thomasson,FRA,Strasbourg,Ligue 1,2021,27.0,1993.0,26.5,64,31,18,27,19,30,93,32.3,63,56,4,52,29,93,16,1,MF,25-29,Midfielder,France,Europe
156779,Erik Thommy,GER,Stuttgart,Bundesliga,2021,26.0,1994.0,3.0,2,0,0,2,0,1,2,50.0,1,3,0,3,4,6,0,0,"FW,MF",25-29,Forward,Germany,Europe
463618,Khphren Thuram,FRA,Nice,Ligue 1,2021,20.0,2001.0,21.1,33,19,11,18,4,17,35,48.6,18,31,11,20,28,61,19,0,MF,20-24,Midfielder,France,Europe
249565,Youri Tielemans,BEL,Leicester City,Premier League,2021,24.0,1997.0,29.2,74,38,23,45,6,42,100,42.0,58,47,13,34,21,95,41,3,MF,20-24,Midfielder,Belgium,Europe
300716,Kieran Tierney,SCO,Arsenal,Premier League,2021,24.0,1997.0,21.3,18,14,11,7,0,10,11,90.9,1,23,5,18,15,33,54,0,DF,20-24,Defender,Scotland,Europe
605184,Jean-Clair Todibo,FRA,Nice,Ligue 1,2021,21.0,1999.0,34.6,59,37,43,15,1,39,60,65.0,21,45,21,24,51,110,130,2,DF,20-24,Defender,France,Europe
315110,Karl Toko Ekambi,CMR,Lyon,Ligue 1,2021,28.0,1992.0,25.5,13,7,4,6,3,4,21,19.0,17,26,0,26,20,33,5,0,FW,25-29,Forward,Cameroon,Africa
190393,Corentin Tolisso,FRA,Bayern Munich,Bundesliga,2021,26.0,1994.0,7.8,11,5,1,9,1,7,17,41.2,10,5,1,4,9,20,10,0,MF,25-29,Midfielder,France,Europe
129674,Jeremy Toljan,GER,Sassuolo,Serie A,2021,26.0,1994.0,15.5,18,10,12,4,2,13,20,65.0,7,12,5,7,12,30,41,0,DF,25-29,Defender,Germany,Europe
72441,Rafael Toli,ITA,Atalanta,Serie A,2021,30.0,1990.0,16.0,38,15,12,15,11,24,39,61.5,15,23,11,12,26,64,35,0,DF,30-34,Defender,Italy,Europe
616344,Tiago Toms,POR,Stuttgart,Bundesliga,2021,19.0,2002.0,11.9,8,4,0,7,1,0,6,0.0,6,3,0,3,4,12,1,0,FW,Under 20,Forward,Portugal,Europe
61592,James Tomkins,ENG,Crystal Palace,Premier League,2021,32.0,1989.0,6.1,8,3,6,2,0,6,8,75.0,2,8,8,0,4,12,18,0,DF,30-34,Defender,England,Europe
303254,Fikayo Tomori,ENG,Milan,Serie A,2021,23.0,1997.0,30.2,73,44,36,34,3,18,26,69.2,8,37,23,14,45,118,84,1,DF,20-24,Defender,England,Europe
397033,Sandro Tonali,ITA,Milan,Serie A,2021,21.0,2000.0,28.9,54,37,23,25,6,21,41,51.2,20,26,8,18,34,88,19,0,MF,20-24,Midfielder,Italy,Europe
111347,Lorenzo Tonelli,ITA,Empoli,Serie A,2021,31.0,1990.0,9.7,17,9,11,4,2,6,13,46.2,7,14,8,6,19,36,28,2,DF,30-34,Defender,Italy,Europe
251664,Ivan Toney,ENG,Brentford,Premier League,2021,25.0,1996.0,32.3,33,21,5,20,8,12,38,31.6,26,16,2,14,14,47,44,1,FW,25-29,Forward,England,Europe
216181,Almamy Tour,MLI,Eint Frankfurt,Bundesliga,2021,25.0,1996.0,5.6,12,9,8,3,1,4,17,23.5,13,10,3,7,5,17,19,0,"DF,MF",25-29,Defender,Mali,Africa
353948,Lucas Tousart,FRA,Hertha BSC,Bundesliga,2021,24.0,1997.0,21.8,42,25,15,22,5,10,34,29.4,24,30,6,24,35,77,55,0,MF,20-24,Midfielder,France,Europe
68718,Yoann Touzghar,TUN,Troyes,Ligue 1,2021,34.0,1986.0,16.2,5,2,1,3,1,1,3,33.3,2,3,1,2,3,8,8,0,FW,30-34,Forward,Tunisia,Africa
649020,Boubacar Traor,MLI,Metz,Ligue 1,2021,19.0,2001.0,19.2,43,26,18,23,2,10,39,25.6,29,29,5,24,25,68,11,1,MF,Under 20,Midfielder,Mali,Africa
297070,Hamari Traor,MLI,Rennes,Ligue 1,2021,29.0,1992.0,32.1,63,36,25,26,12,41,59,69.5,18,29,8,21,37,100,81,1,DF,25-29,Defender,Mali,Africa
57216,Ismal Traor,CIV,Angers,Ligue 1,2021,34.0,1986.0,35.7,28,17,16,11,1,13,28,46.4,15,25,17,8,44,72,122,1,DF,30-34,Defender,Ivory Coast,Africa
75921,Christopher Trimmel,AUT,Union Berlin,Bundesliga,2021,34.0,1987.0,22.1,49,30,25,19,5,26,45,57.8,19,20,3,17,34,83,75,0,"DF,FW",30-34,Defender,Austria,Europe
144028,Leandro Trossard,BEL,Brighton,Premier League,2021,26.0,1994.0,31.2,34,20,12,9,13,4,31,12.9,27,33,4,29,15,49,10,0,"FW,MF",25-29,Forward,Belgium,Europe
654539,Adrien Truffert,FRA,Rennes,Ligue 1,2021,19.0,2001.0,18.2,29,21,17,9,3,11,24,45.8,13,25,5,20,19,48,30,0,DF,Under 20,Defender,France,Europe
546213,Tuta,BRA,Eint Frankfurt,Bundesliga,2021,22.0,1999.0,24.3,46,28,20,22,4,26,47,55.3,21,43,15,28,41,87,76,1,DF,20-24,Defender,Brazil,South America
556385,Destiny Udogie,ITA,Udinese,Serie A,2021,18.0,2002.0,27.5,64,40,30,27,7,33,60,55.0,27,39,6,33,27,91,42,0,DF,Under 20,Defender,Italy,Europe
711999,Lesley Ugochukwu,FRA,Rennes,Ligue 1,2021,17.0,2004.0,4.5,13,9,5,5,3,9,19,47.4,10,7,2,5,4,17,2,0,MF,Under 20,Midfielder,France,Europe
251106,Enes nal,TUR,Getafe,La Liga,2021,24.0,1997.0,31.1,37,22,2,18,17,5,42,11.9,37,25,5,20,5,42,36,0,FW,20-24,Forward,Turkey,Asia
344695,Dayot Upamecano,FRA,Bayern Munich,Bundesliga,2021,22.0,1998.0,24.6,66,42,42,21,3,24,36,66.7,12,20,10,10,32,98,71,6,DF,20-24,Defender,France,Europe
131827,Jere Uronen,FIN,Brest,Ligue 1,2021,27.0,1994.0,9.8,28,15,15,10,3,14,24,58.3,10,12,3,9,16,44,21,0,DF,25-29,Defender,Finland,Europe
315289,Myrto Uzuni,ALB,Granada,La Liga,2021,26.0,1995.0,9.5,7,4,6,1,0,0,2,0.0,2,13,1,12,10,17,7,0,"FW,MF",25-29,Forward,Albania,Europe
369081,Federico Valverde,URU,Real Madrid,La Liga,2021,23.0,1998.0,20.4,36,16,11,16,9,12,31,38.7,19,23,5,18,24,60,12,0,MF,20-24,Midfielder,Uruguay,South America
139208,Virgil van Dijk,NED,Liverpool,Premier League,2021,30.0,1991.0,34.0,16,10,11,5,0,11,16,68.8,5,21,14,7,31,47,109,0,DF,30-34,Defender,Netherlands,Europe
789082,Vanderson,BRA,Monaco,Ligue 1,2021,20.0,2001.0,12.4,35,19,10,19,6,15,23,65.2,8,17,4,13,13,48,12,0,"FW,DF",20-24,Forward,Brazil,South America
197838,Jamie Vardy,ENG,Leicester City,Premier League,2021,34.0,1987.0,20.1,6,5,0,4,2,1,7,14.3,6,9,0,9,1,7,17,0,FW,30-34,Forward,England,Europe
333516,Sebastian Vasiliadis,GRE,Arminia,Bundesliga,2021,23.0,1997.0,13.3,31,17,12,15,4,15,42,35.7,27,15,2,13,25,56,31,1,MF,20-24,Midfielder,Greece,Europe
532937,Johan Vsquez,MEX,Genoa,Serie A,2021,22.0,1998.0,25.3,79,46,44,32,3,48,75,64.0,27,32,10,22,42,121,85,0,DF,20-24,Defender,Mexico,North America
111195,Jol Veltman,NED,Brighton,Premier League,2021,29.0,1992.0,31.9,74,48,47,21,6,21,53,39.6,32,46,16,30,45,119,89,0,DF,25-29,Defender,Netherlands,Europe
240219,Lorenzo Venuti,ITA,Fiorentina,Serie A,2021,26.0,1995.0,17.5,25,10,13,10,2,14,24,58.3,10,13,4,9,5,30,27,0,DF,25-29,Defender,Italy,Europe
256361,Daniele Verde,ITA,Spezia,Serie A,2021,25.0,1996.0,21.7,11,4,8,2,1,9,20,45.0,11,17,2,15,18,29,8,0,"FW,MF",25-29,Forward,Italy,Europe
164771,Jordan Veretout,FRA,Roma,Serie A,2021,28.0,1993.0,25.8,34,25,20,12,2,15,39,38.5,24,12,1,11,27,61,22,1,MF,25-29,Midfielder,France,Europe
162961,Valerio Verre,ITA,Sampdoria,Serie A,2021,27.0,1994.0,4.7,7,5,1,4,2,4,9,44.4,5,7,0,7,0,7,5,0,"MF,FW",25-29,Midfielder,Italy,Europe
37666,Arturo Vidal,CHI,Inter,Serie A,2021,34.0,1987.0,8.2,26,10,16,9,1,9,26,34.6,17,13,5,8,7,33,7,1,MF,30-34,Midfielder,Chile,South America
394346,Emanuel Vignato,ITA,Bologna,Serie A,2021,20.0,2000.0,6.6,12,7,5,7,0,6,13,46.2,7,2,0,2,2,14,5,0,"MF,DF",20-24,Midfielder,Italy,Europe
293200,Nikola Vlai,CRO,West Ham,Premier League,2021,23.0,1997.0,6.2,11,7,4,6,1,5,20,25.0,15,4,0,4,2,13,1,0,"FW,MF",20-24,Forward,Croatia,Europe
94771,Andreas Voglsammer,GER,Union Berlin,Bundesliga,2021,29.0,1992.0,9.8,14,9,8,3,3,6,14,42.9,8,9,2,7,2,16,7,0,"FW,MF",25-29,Forward,Germany,Europe
82009,Kevin Volland,GER,Monaco,Ligue 1,2021,29.0,1992.0,27.1,24,10,2,18,4,6,31,19.4,25,20,0,20,3,27,9,0,"MF,FW",25-29,Midfielder,Germany,Europe
503881,Aster Vranckx,BEL,Wolfsburg,Bundesliga,2021,18.0,2002.0,12.7,34,13,14,16,4,14,26,53.8,12,19,7,12,13,47,16,0,MF,Under 20,Midfielder,Belgium,Europe
111196,Stefan de Vrij,NED,Inter,Serie A,2021,29.0,1992.0,26.8,38,29,22,16,0,12,17,70.6,5,17,8,9,32,70,52,0,DF,25-29,Defender,Netherlands,Europe
659542,Elye Wahi,FRA,Montpellier,Ligue 1,2021,18.0,2003.0,19.8,18,10,9,6,3,6,16,37.5,10,7,0,7,4,22,4,0,FW,Under 20,Forward,France,Europe
323954,Walace,BRA,Udinese,Serie A,2021,26.0,1995.0,33.0,83,49,37,38,8,50,113,44.2,63,51,5,46,54,137,32,1,MF,25-29,Midfielder,Brazil,South America
196095,Luca Waldschmidt,GER,Wolfsburg,Bundesliga,2021,25.0,1996.0,8.0,9,1,3,5,1,5,13,38.5,8,5,0,5,8,17,3,0,"MF,FW",25-29,Midfielder,Germany,Europe
95424,Kyle Walker,ENG,Manchester City,Premier League,2021,31.0,1990.0,19.5,15,6,7,7,1,8,17,47.1,9,14,4,10,14,29,16,1,DF,30-34,Defender,England,Europe
341051,Kyle Walker-Peters,ENG,Southampton,Premier League,2021,24.0,1997.0,29.3,57,33,28,21,8,26,38,68.4,12,29,8,21,37,94,53,1,DF,20-24,Defender,England,Europe
477758,Aaron Wan-Bissaka,ENG,Manchester Utd,Premier League,2021,23.0,1997.0,19.9,49,36,25,18,6,14,20,70.0,6,24,14,10,34,83,41,2,DF,20-24,Defender,England,Europe
92572,Joel Ward,ENG,Crystal Palace,Premier League,2021,31.0,1989.0,27.6,44,26,30,11,3,30,57,52.6,27,24,11,13,32,76,107,1,DF,30-34,Defender,England,Europe
181579,James Ward-Prowse,ENG,Southampton,Premier League,2021,26.0,1994.0,35.7,41,24,12,24,5,19,70,27.1,51,43,15,28,40,81,45,1,MF,25-29,Midfielder,England,Europe
324358,Ollie Watkins,ENG,Aston Villa,Premier League,2021,25.0,1995.0,32.8,17,13,2,7,8,2,15,13.3,13,25,3,22,12,29,27,0,FW,25-29,Forward,England,Europe
370846,Timothy Weah,USA,Lille,Ligue 1,2021,21.0,2000.0,18.0,19,7,8,8,3,10,20,50.0,10,16,1,15,10,29,7,0,"MF,FW",20-24,Midfielder,United States,North America
212847,Adam Webster,ENG,Brighton,Premier League,2021,26.0,1995.0,15.9,26,8,17,7,2,13,20,65.0,7,25,17,8,17,43,66,2,DF,25-29,Defender,England,Europe
67063,Danny Welbeck,ENG,Brighton,Premier League,2021,30.0,1990.0,16.4,14,7,2,8,4,3,10,30.0,7,18,2,16,5,19,18,0,"FW,MF",30-34,Forward,England,Europe
170527,Timo Werner,GER,Chelsea,Premier League,2021,25.0,1996.0,14.3,8,4,3,3,2,2,20,10.0,18,9,0,9,2,10,4,0,"FW,MF",25-29,Forward,Germany,Europe
91317,Ashley Westwood,ENG,Burnley,Premier League,2021,31.0,1990.0,25.4,21,12,8,12,1,10,31,32.3,21,21,9,12,30,51,16,1,MF,30-34,Midfielder,England,Europe
335721,Ben White,ENG,Arsenal,Premier League,2021,23.0,1997.0,32.0,44,23,30,8,6,28,45,62.2,17,42,24,18,42,86,102,0,DF,20-24,Defender,England,Europe
168989,Silvan Widmer,SUI,Mainz 05,Bundesliga,2021,28.0,1993.0,32.4,60,28,32,20,8,36,61,59.0,25,44,16,28,43,103,59,2,DF,25-29,Defender,Switzerland,Europe
49499,Georginio Wijnaldum,NED,Paris S-G,Ligue 1,2021,30.0,1990.0,18.4,15,9,2,12,1,11,19,57.9,8,13,3,10,9,24,7,0,MF,30-34,Midfielder,Netherlands,Europe
507700,Brandon Williams,ENG,Norwich City,Premier League,2021,20.0,2000.0,23.6,55,37,35,18,2,36,64,56.3,28,26,6,20,44,99,50,0,DF,20-24,Defender,England,Europe
255508,Iaki Williams,GHA,Athletic Club,La Liga,2021,27.0,1994.0,30.9,14,5,1,6,7,5,17,29.4,12,18,3,15,3,17,20,0,FW,25-29,Forward,Ghana,Africa
340329,Joe Willock,ENG,Newcastle Utd,Premier League,2021,21.0,1999.0,22.6,64,37,30,28,6,29,68,42.6,39,37,6,31,21,85,10,1,MF,20-24,Midfielder,England,Europe
450826,Callum Wilson,ENG,Newcastle Utd,Premier League,2021,29.0,1992.0,15.4,9,8,1,5,3,1,4,25.0,3,7,2,5,3,12,10,0,FW,25-29,Forward,England,Europe
533295,Patrick Wimmer,AUT,Arminia,Bundesliga,2021,20.0,2001.0,22.8,53,31,13,31,9,22,61,36.1,39,30,1,29,27,80,13,0,"FW,MF",20-24,Forward,Austria,Europe
391004,Jonas Wind,DEN,Wolfsburg,Bundesliga,2021,22.0,1999.0,13.1,10,6,1,7,2,1,4,25.0,3,8,3,5,6,16,13,0,"FW,MF",20-24,Forward,Denmark,Europe
249126,Harry Winks,ENG,Tottenham,Premier League,2021,25.0,1996.0,10.1,15,10,4,9,2,8,21,38.1,13,14,3,11,16,31,10,2,MF,25-29,Midfielder,England,Europe
598577,Florian Wirtz,GER,Leverkusen,Bundesliga,2021,18.0,2003.0,20.6,25,10,6,16,3,10,28,35.7,18,12,1,11,13,38,4,0,"MF,FW",Under 20,Midfielder,Germany,Europe
388165,Yoane Wissa,COD,Brentford,Premier League,2021,24.0,1996.0,14.3,12,6,5,4,3,1,16,6.3,15,12,5,7,8,20,6,0,FW,20-24,Forward,DR Congo,Africa
35047,Axel Witsel,BEL,Dortmund,Bundesliga,2021,32.0,1989.0,21.6,42,27,12,23,7,18,30,60.0,12,24,9,15,27,69,38,0,"MF,DF",30-34,Midfielder,Belgium,Europe
321070,Hannes Wolf,AUT,Gladbach,Bundesliga,2021,22.0,1999.0,3.4,23,12,4,13,6,10,20,50.0,10,10,0,10,2,25,1,0,"FW,MF",20-24,Forward,Austria,Europe
108725,Chris Wood,NZL,Burnley,Premier League,2021,29.0,1991.0,15.2,7,5,0,3,4,3,10,30.0,7,13,4,9,0,7,3,0,FW,25-29,Forward,New Zealand,Oceania
572326,Christopher Wooh,CMR,Lens,Ligue 1,2021,19.0,2001.0,11.7,29,11,20,8,1,11,18,61.1,7,21,14,7,21,50,40,1,DF,Under 20,Defender,Cameroon,Africa
111455,Granit Xhaka,SUI,Arsenal,Premier League,2021,28.0,1992.0,25.9,32,18,16,12,4,16,41,39.0,25,21,6,15,21,53,31,0,"MF,DF",25-29,Midfielder,Switzerland,Europe
589737,Kelvin Yeboah,ITA,Genoa,Serie A,2021,21.0,2000.0,9.4,14,7,5,7,2,9,19,47.4,10,22,1,21,1,15,7,0,"FW,MF",20-24,Forward,Italy,Europe
14086,Ashley Young,ENG,Aston Villa,Premier League,2021,36.0,1985.0,13.9,18,6,9,6,3,11,16,68.8,5,10,4,6,13,31,25,1,"DF,FW",35-39,Defender,England,Europe
344598,Dan-Axel Zagadou,FRA,Dortmund,Bundesliga,2021,22.0,1999.0,10.6,13,7,11,1,1,7,10,70.0,3,14,4,10,15,28,38,2,DF,20-24,Defender,France,Europe
334526,Denis Zakaria,SUI,Juventus,Serie A,2021,24.0,1996.0,6.6,11,7,3,6,2,3,11,27.3,8,16,3,13,11,22,7,0,MF,20-24,Midfielder,Switzerland,Europe
392085,Nicol Zaniolo,ITA,Roma,Serie A,2021,22.0,1999.0,21.9,24,15,0,15,9,6,28,21.4,22,19,0,19,7,31,6,0,"FW,MF",20-24,Forward,Italy,Europe
73794,Duvn Zapata,COL,Atalanta,Serie A,2021,30.0,1991.0,19.1,6,2,0,4,2,4,8,50.0,4,8,1,7,3,9,5,0,FW,30-34,Forward,Colombia,South America
392569,Gabriele Zappa,ITA,Cagliari,Serie A,2021,21.0,1999.0,12.7,21,9,12,6,3,6,24,25.0,18,15,5,10,14,35,28,0,DF,20-24,Defender,Italy,Europe
173859,Davide Zappacosta,ITA,Atalanta,Serie A,2021,29.0,1992.0,26.1,32,22,12,13,7,19,37,51.4,18,32,2,30,12,44,22,0,DF,25-29,Defender,Italy,Europe
96828,Simone Zaza,ITA,Torino,Serie A,2021,30.0,1991.0,1.4,2,2,1,1,0,1,1,100.0,0,3,0,3,0,2,3,0,"FW,DF",30-34,Forward,Italy,Europe
327863,Akim Zedadka,ALG,Clermont Foot,Ligue 1,2021,26.0,1995.0,37.1,72,44,34,29,9,37,71,52.1,34,32,8,24,58,130,48,0,DF,25-29,Defender,Algeria,Africa
77812,Christoph Zimmermann,GER,Norwich City,Premier League,2021,28.0,1993.0,1.7,6,3,5,1,0,3,4,75.0,1,0,0,0,1,7,4,0,DF,25-29,Defender,Germany,Europe
203853,Oleksandr Zinchenko,UKR,Manchester City,Premier League,2021,24.0,1996.0,11.6,20,14,7,10,3,11,20,55.0,9,11,3,8,14,34,15,1,DF,20-24,Defender,Ukraine,Europe
79967,Simon Zoller,GER,Bochum,Bundesliga,2021,30.0,1991.0,6.6,4,2,2,1,1,1,3,33.3,2,3,0,3,4,8,2,0,FW,30-34,Forward,Germany,Europe
392966,Nadir Zortea,ITA,Salernitana,Serie A,2021,22.0,1999.0,15.7,21,15,9,7,5,11,19,57.9,8,14,2,12,7,28,33,0,"DF,MF",20-24,Defender,Italy,Europe
157509,Kurt Zouma,FRA,West Ham,Premier League,2021,26.0,1994.0,23.1,11,6,8,3,0,4,7,57.1,3,31,26,5,34,45,132,0,DF,25-29,Defender,France,Europe
126729,Patric,ESP,Lazio,Serie A,2021,28.0,1993.0,18.3,21,15,17,4,0,9,20,45.0,11,22,11,11,12,33,44,2,DF,25-29,Defender,Spain,Europe
574671,Strahinja Pavlovi,SRB,Monaco,Ligue 1,2021,20.0,2001.0,5.0,23,16,8,13,2,8,12,66.7,4,5,3,2,9,32,15,0,DF,20-24,Defender,Serbia,Europe
356197,Alfonso Pedraza,ESP,Villarreal,La Liga,2021,25.0,1996.0,18.9,34,16,17,12,5,10,28,35.7,18,12,3,9,31,65,32,0,DF,25-29,Defender,Spain,Europe
683840,Pedri,ESP,Barcelona,La Liga,2021,18.0,2002.0,9.8,20,12,9,8,3,7,20,35.0,13,13,0,13,5,25,7,1,MF,Under 20,Midfielder,Spain,Europe
1004741,Pedro,ESP,Lazio,Serie A,2021,34.0,1987.0,22.6,36,23,8,19,9,16,47,34.0,31,18,2,16,6,42,8,0,FW,30-34,Forward,Spain,Europe
501418,Adri Pedrosa,ESP,Espanyol,La Liga,2021,23.0,1998.0,30.2,58,30,38,14,6,26,57,45.6,31,25,7,18,25,83,92,2,DF,20-24,Defender,Spain,Europe
238868,Rubn Pea,ESP,Villarreal,La Liga,2021,30.0,1991.0,1.5,2,0,1,1,0,2,6,33.3,4,1,0,1,5,7,2,0,"MF,FW",30-34,Midfielder,Spain,Europe
99559,Alberto Perea,ESP,Cdiz,La Liga,2021,30.0,1990.0,8.6,19,9,7,9,3,6,20,30.0,14,15,1,14,9,28,4,0,MF,30-34,Midfielder,Spain,Europe
246968,Ayoze Prez,ESP,Leicester City,Premier League,2021,28.0,1993.0,4.9,4,2,0,3,1,0,13,0.0,13,11,1,10,2,6,5,0,"MF,FW",25-29,Midfielder,Spain,Europe
282810,Carles Prez,ESP,Roma,Serie A,2021,23.0,1998.0,6.2,8,3,3,1,4,3,12,25.0,9,10,0,10,2,10,2,0,"MF,FW",20-24,Midfielder,Spain,Europe
71579,Iigo Prez,ESP,Osasuna,La Liga,2021,33.0,1988.0,3.8,3,2,2,1,0,2,4,50.0,2,1,0,1,0,3,3,0,MF,30-34,Midfielder,Spain,Europe
527698,Kike Prez,ESP,Elche,La Liga,2021,24.0,1997.0,5.8,8,6,1,3,4,0,10,0.0,10,6,1,5,3,11,4,0,"MF,FW",20-24,Midfielder,Spain,Europe
422355,Jens Petter Hauge,NOR,Eint Frankfurt,Bundesliga,2021,21.0,1999.0,11.6,14,5,6,7,1,7,23,30.4,16,7,0,7,3,17,5,0,"MF,FW",20-24,Midfielder,Norway,Europe
18944,Gerard Piqu,ESP,Barcelona,La Liga,2021,34.0,1987.0,23.2,22,12,18,4,0,11,14,78.6,3,19,16,3,34,56,86,1,DF,30-34,Defender,Spain,Europe
242497,Pere Pons,ESP,Alavs,La Liga,2021,28.0,1993.0,15.2,26,18,4,20,2,7,21,33.3,14,10,1,9,6,32,11,0,MF,25-29,Midfielder,Spain,Europe
99353,Portu,ESP,Real Sociedad,La Liga,2021,29.0,1992.0,17.7,16,7,2,6,8,3,19,15.8,16,21,3,18,7,23,8,0,"FW,MF",25-29,Forward,Spain,Europe
177452,Abdn Prats,ESP,Mallorca,La Liga,2021,28.0,1992.0,7.1,2,2,1,0,1,1,5,20.0,4,5,0,5,1,3,6,0,FW,25-29,Forward,Spain,Europe
408471,Javi Puado,ESP,Espanyol,La Liga,2021,23.0,1998.0,24.9,24,14,18,5,1,12,37,32.4,25,18,2,16,11,35,24,0,"MF,FW",20-24,Midfielder,Spain,Europe
262365,Antonio Puertas,ESP,Granada,La Liga,2021,29.0,1992.0,25.1,34,20,18,12,4,17,44,38.6,27,33,3,30,11,45,36,0,"MF,FW",25-29,Midfielder,Spain,Europe
168959,Nemanja Radoja,SRB,Levante,La Liga,2021,28.0,1993.0,13.5,25,8,9,13,3,8,20,40.0,12,16,9,7,22,47,16,2,MF,25-29,Midfielder,Serbia,Europe
199369,Sandro Ramrez,ESP,Getafe,La Liga,2021,26.0,1995.0,16.2,7,3,1,3,3,1,12,8.3,11,14,3,11,2,9,3,0,FW,25-29,Forward,Spain,Europe
25557,Sergio Ramos,ESP,Paris S-G,Ligue 1,2021,35.0,1986.0,8.9,12,5,6,6,0,8,15,53.3,7,4,2,2,8,20,27,0,DF,35-39,Defender,Spain,Europe
268178,Arkadiusz Reca,POL,Spezia,Serie A,2021,26.0,1995.0,19.7,31,19,21,3,7,20,30,66.7,10,20,7,13,32,63,47,2,DF,25-29,Defender,Poland,Europe
282429,Sergio Reguiln,ESP,Tottenham,Premier League,2021,24.0,1996.0,21.3,40,24,15,18,7,22,43,51.2,21,20,8,12,31,71,45,1,"DF,MF",20-24,Defender,Spain,Europe
249513,Diego Rico,ESP,Real Sociedad,La Liga,2021,28.0,1993.0,18.3,41,20,19,17,5,22,45,48.9,23,29,4,25,30,71,54,0,DF,25-29,Defender,Spain,Europe
278837,Luis Rioja,ESP,Alavs,La Liga,2021,27.0,1993.0,34.6,28,15,11,10,7,14,58,24.1,44,22,1,21,25,53,20,0,"MF,FW",25-29,Midfielder,Spain,Europe
85370,Sergi Roberto,ESP,Barcelona,La Liga,2021,29.0,1992.0,4.4,5,1,2,3,0,3,5,60.0,2,2,0,2,4,9,6,0,"MF,DF",25-29,Midfielder,Spain,Europe
67548,Rubn Rochina,ESP,Granada,La Liga,2021,30.0,1991.0,8.3,21,13,7,8,6,8,28,28.6,20,11,1,10,6,27,5,1,"MF,FW",30-34,Midfielder,Spain,Europe
51510,ngel Rodrguez,ESP,Mallorca,La Liga,2021,34.0,1987.0,17.2,15,9,6,7,2,4,21,19.0,17,15,1,14,3,18,13,0,"FW,MF",30-34,Forward,Spain,Europe
834470,Dani Rodrguez,ESP,Mallorca,La Liga,2021,33.0,1988.0,31.5,53,31,20,24,9,15,46,32.6,31,28,3,25,20,73,27,0,"MF,FW",30-34,Midfielder,Spain,Europe
66100,Oriol Romeu,ESP,Southampton,Premier League,2021,29.0,1991.0,32.1,77,39,25,45,7,28,73,38.4,45,39,8,31,51,128,43,0,MF,25-29,Midfielder,Spain,Europe
378139,Aitor Ruibal,ESP,Betis,La Liga,2021,25.0,1996.0,9.5,21,15,13,3,5,10,34,29.4,24,8,0,8,8,29,6,0,"FW,DF",25-29,Forward,Spain,Europe
631221,Isma Ruiz,ESP,Granada,La Liga,2021,20.0,2001.0,3.1,3,1,3,0,0,1,9,11.1,8,5,2,3,3,6,2,0,MF,20-24,Midfielder,Spain,Europe
62920,Vctor Ruiz,ESP,Betis,La Liga,2021,32.0,1989.0,15.8,11,9,7,2,2,6,9,66.7,3,18,13,5,29,40,71,1,DF,30-34,Defender,Spain,Europe
370789,Julian Ryerson,NOR,Union Berlin,Bundesliga,2021,23.0,1997.0,15.9,27,15,11,12,4,17,25,68.0,8,12,4,8,16,43,32,0,DF,20-24,Defender,Norway,Europe
571020,Oihan Sancet,ESP,Athletic Club,La Liga,2021,21.0,2000.0,15.8,12,7,2,8,2,5,20,25.0,15,2,0,2,5,17,13,0,FW,20-24,Forward,Spain,Europe
513031,Antonio Snchez,ESP,Mallorca,La Liga,2021,24.0,1997.0,18.0,53,24,29,17,7,19,49,38.8,30,32,2,30,32,85,32,1,"MF,FW",20-24,Midfielder,Spain,Europe
95963,Germn Snchez,ESP,Granada,La Liga,2021,34.0,1986.0,25.5,27,19,18,9,0,11,20,55.0,9,19,16,3,28,55,137,0,DF,30-34,Defender,Spain,Europe
63040,Oier Sanjurjo,ESP,Osasuna,La Liga,2021,35.0,1986.0,8.4,10,6,3,7,0,2,19,10.5,17,8,3,5,1,11,9,0,MF,35-39,Midfielder,Spain,Europe
242086,Patrik Schick,CZE,Leverkusen,Bundesliga,2021,25.0,1996.0,23.1,5,2,2,2,1,1,9,11.1,8,6,1,5,3,8,28,0,FW,25-29,Forward,Czech Republic,Europe
58799,Salva Sevilla,ESP,Mallorca,La Liga,2021,37.0,1984.0,16.7,18,12,8,8,2,6,17,35.3,11,12,6,6,14,32,11,0,MF,35-39,Midfielder,Spain,Europe
86759,David Silva,ESP,Real Sociedad,La Liga,2021,35.0,1986.0,19.1,28,17,10,11,7,3,20,15.0,17,13,3,10,7,35,12,0,MF,35-39,Midfielder,Spain,Europe
372246,Carlos Soler,ESP,Valencia,La Liga,2021,24.0,1997.0,27.5,29,19,10,15,4,11,37,29.7,26,19,4,15,14,43,28,0,MF,20-24,Midfielder,Spain,Europe
349856,Son,ESP,Levante,La Liga,2021,27.0,1994.0,21.9,28,18,16,7,5,17,34,50.0,17,11,5,6,19,47,33,1,DF,25-29,Defender,Spain,Europe
487688,Alberto Soro,ESP,Granada,La Liga,2021,22.0,1999.0,6.4,12,10,3,6,3,1,7,14.3,6,21,2,19,3,15,4,0,"MF,FW",20-24,Midfielder,Spain,Europe
183841,Petar Stojanovi,SVN,Empoli,Serie A,2021,25.0,1995.0,30.4,96,63,55,32,9,59,114,51.8,55,39,13,26,27,123,65,1,DF,25-29,Defender,Slovenia,Europe
50617,Stefan Strandberg,NOR,Salernitana,Serie A,2021,31.0,1990.0,10.4,13,8,10,3,0,8,11,72.7,3,15,13,2,9,22,49,0,DF,30-34,Defender,Norway,Europe
165007,Denis Surez,ESP,Celta Vigo,La Liga,2021,27.0,1994.0,31.3,61,29,20,33,8,25,82,30.5,57,32,4,28,16,77,11,0,MF,25-29,Midfielder,Spain,Europe
111961,Suso,ESP,Sevilla,La Liga,2021,27.0,1993.0,4.3,4,3,1,3,0,3,13,23.1,10,4,0,4,0,4,0,0,FW,25-29,Forward,Spain,Europe
238407,Alexander Srloth,NOR,Real Sociedad,La Liga,2021,25.0,1995.0,19.6,20,7,4,10,6,7,17,41.2,10,14,1,13,4,24,15,0,FW,25-29,Forward,Norway,Europe
141834,Cristian Tello,ESP,Betis,La Liga,2021,29.0,1991.0,9.1,17,11,6,7,4,13,31,41.9,18,9,0,9,10,27,6,0,FW,25-29,Forward,Spain,Europe
226524,Morten Thorsby,NOR,Sampdoria,Serie A,2021,25.0,1996.0,32.7,46,26,15,23,8,28,56,50.0,28,37,12,25,25,71,39,0,MF,25-29,Midfielder,Norway,Europe
214775,liver Torres,ESP,Sevilla,La Liga,2021,26.0,1994.0,11.2,22,12,8,7,7,8,25,32.0,17,10,1,9,6,28,4,0,"MF,FW",25-29,Midfielder,Spain,Europe
399776,Pau Torres,ESP,Villarreal,La Liga,2021,24.0,1997.0,31.7,32,19,23,7,2,18,25,72.0,7,32,23,9,19,51,105,2,DF,20-24,Defender,Spain,Europe
213670,Lucas Torr,ESP,Osasuna,La Liga,2021,27.0,1994.0,30.3,71,40,25,38,8,29,57,50.9,28,32,11,21,47,118,55,0,MF,25-29,Midfielder,Spain,Europe
364405,Adama Traor,ESP,Wolves,Premier League,2021,25.0,1996.0,11.9,8,3,6,0,2,3,7,42.9,4,4,1,3,2,10,1,0,"FW,MF",25-29,Forward,Spain,Europe
634431,Beat Turrientes,ESP,Real Sociedad,La Liga,2021,19.0,2002.0,2.3,0,0,0,0,0,0,4,0.0,4,1,0,1,2,2,2,0,MF,Under 20,Midfielder,Spain,Europe
517753,scar Valentn,ESP,Rayo Vallecano,La Liga,2021,26.0,1994.0,28.5,102,53,46,51,5,44,105,41.9,61,56,10,46,39,141,43,0,MF,25-29,Midfielder,Spain,Europe
221315,Kevin Vzquez,ESP,Celta Vigo,La Liga,2021,28.0,1993.0,14.8,34,24,12,13,9,14,28,50.0,14,20,7,13,36,70,34,0,DF,25-29,Defender,Spain,Europe
221316,Lucas Vzquez,ESP,Real Madrid,La Liga,2021,30.0,1991.0,20.4,43,22,24,9,10,17,35,48.6,18,25,7,18,20,63,41,1,DF,30-34,Defender,Spain,Europe
88490,Aleix Vidal,ESP,Espanyol,La Liga,2021,31.0,1989.0,21.1,31,25,17,9,5,19,39,48.7,20,19,6,13,25,56,35,2,"DF,MF",30-34,Defender,Spain,Europe
216870,Nacho Vidal,ESP,Osasuna,La Liga,2021,26.0,1995.0,32.2,83,47,49,25,9,39,77,50.6,38,32,14,18,58,141,79,0,DF,25-29,Defender,Spain,Europe
251897,Asier Villalibre,ESP,Athletic Club,La Liga,2021,23.0,1997.0,6.1,4,3,2,1,1,1,2,50.0,1,3,1,2,1,5,7,0,FW,20-24,Forward,Spain,Europe
398163,Gonzalo Villar,ESP,Getafe,La Liga,2021,23.0,1998.0,3.3,5,3,4,1,0,2,5,40.0,3,4,1,3,1,6,1,0,MF,20-24,Midfielder,Spain,Europe
357498,Duan Vlahovi,SRB,Fiorentina,Serie A,2021,21.0,2000.0,20.6,5,0,0,2,3,2,11,18.2,9,6,2,4,1,6,16,0,FW,20-24,Forward,Serbia,Europe
709187,Nico Williams,ESP,Athletic Club,La Liga,2021,19.0,2002.0,14.9,20,10,6,11,3,10,31,32.3,21,18,2,16,5,25,9,0,MF,Under 20,Midfielder,Spain,Europe
550108,Nicola Zalewski,POL,Roma,Serie A,2021,19.0,2002.0,8.8,32,19,17,11,4,21,35,60.0,14,18,1,17,16,48,4,0,DF,Under 20,Defender,Poland,Europe
524010,Oier Zarraga,ESP,Athletic Club,La Liga,2021,22.0,1999.0,13.0,13,5,4,7,2,3,28,10.7,25,17,10,7,19,32,10,0,MF,20-24,Midfielder,Spain,Europe
181136,Piotr Zieliski,POL,Napoli,Serie A,2021,27.0,1994.0,23.2,19,12,5,9,5,6,21,28.6,15,13,2,11,8,27,4,0,MF,25-29,Midfielder,Poland,Europe
544149,David Zima,CZE,Torino,Serie A,2021,20.0,2000.0,14.6,20,12,8,11,1,9,20,45.0,11,15,13,2,23,43,42,0,DF,20-24,Defender,Czech Republic,Europe
355628,Igor Zubeldia,ESP,Real Sociedad,La Liga,2021,24.0,1997.0,18.3,20,10,12,8,0,12,18,66.7,6,16,6,10,27,47,53,0,DF,20-24,Defender,Spain,Europe
387234,Szymon urkowski,POL,Empoli,Serie A,2021,23.0,1997.0,25.6,58,33,24,21,13,29,68,42.6,39,43,10,33,35,93,32,1,MF,20-24,Midfielder,Poland,Europe
199704,Yunis Abdelhamid,MAR,Saint-tienne,Ligue 1,2024,37.0,1987.0,10.4,17,11,15,2,0,10,16,62.5,6,22,15,7,12,29,54,1,DF,35-39,Defender,Morocco,Africa
592979,Himad Abdelli,ALG,Angers,Ligue 1,2024,25.0,1999.0,14.8,23,17,7,8,8,8,23,34.8,15,8,0,8,12,35,11,1,"MF,FW",25-29,Midfielder,Algeria,Africa
211474,Ali Abdi,TUN,Nice,Ligue 1,2024,31.0,1993.0,6.5,16,10,7,4,5,14,21,66.7,7,13,3,10,3,19,13,0,"DF,MF",30-34,Defender,Tunisia,Africa
646402,Abner,BRA,Lyon,Ligue 1,2024,24.0,2000.0,7.3,17,12,7,7,3,12,17,70.6,5,10,1,9,5,22,22,0,DF,20-24,Defender,Brazil,South America
393238,Zakaria Aboukhlal,MAR,Toulouse,Ligue 1,2024,24.0,2000.0,13.1,12,7,5,4,3,4,14,28.6,10,10,0,10,6,18,5,0,"MF,FW",20-24,Midfielder,Morocco,Africa
559979,Abdel Abqar,MAR,Alavs,La Liga,2024,25.0,1999.0,15.5,23,14,14,8,1,11,20,55.0,9,15,10,5,24,47,80,0,DF,25-29,Defender,Morocco,Africa
131075,Francesco Acerbi,ITA,Inter,Serie A,2024,36.0,1988.0,7.4,6,4,5,1,0,2,3,66.7,1,6,6,0,15,21,28,0,DF,35-39,Defender,Italy,Europe
607034,Akor Adams,NGA,Montpellier,Ligue 1,2024,24.0,2000.0,10.2,3,2,1,1,1,2,3,66.7,1,2,1,1,1,4,4,1,FW,20-24,Forward,Nigeria,Africa
332705,Tyler Adams,USA,Bournemouth,Premier League,2024,25.0,1999.0,5.1,26,18,10,13,3,11,16,68.8,5,6,3,3,18,44,11,0,MF,25-29,Midfielder,United States,North America
452477,Junior Adamu,AUT,Freiburg,Bundesliga,2024,23.0,2001.0,9.1,3,0,1,1,1,0,4,0.0,4,7,0,7,6,9,9,0,FW,20-24,Forward,Austria,Europe
496094,Karim Adeyemi,GER,Dortmund,Bundesliga,2024,22.0,2002.0,3.9,7,5,3,1,3,2,4,50.0,2,6,0,6,1,8,1,0,"FW,MF",20-24,Forward,Germany,Europe
658536,Simon Adingra,CIV,Brighton,Premier League,2024,22.0,2002.0,3.9,9,4,5,3,1,4,10,40.0,6,5,0,5,4,13,1,0,"FW,MF",20-24,Forward,Ivory Coast,Africa
395236,Yacine Adli,FRA,Fiorentina,Serie A,2024,24.0,2000.0,7.9,19,10,8,7,4,11,23,47.8,12,8,1,7,3,22,14,0,MF,20-24,Midfielder,France,Europe
944570,Vasilije Adi,MNE,Juventus,Serie A,2024,18.0,2006.0,0.3,2,2,0,1,1,0,1,0.0,1,0,0,0,0,2,0,0,"MF,FW",Under 20,Midfielder,Montenegro,Europe
487850,Oladapo Afolayan,ENG,St. Pauli,Bundesliga,2024,26.0,1998.0,11.6,15,8,4,7,4,5,12,41.7,7,9,1,8,7,22,10,0,"FW,MF",25-29,Forward,England,Europe
683895,Emmanuel Agbadou,CIV,Reims,Ligue 1,2024,27.0,1997.0,14.0,25,17,19,3,3,19,26,73.1,7,22,13,9,19,44,64,1,DF,25-29,Defender,Ivory Coast,Africa
393512,Felix Agu,GER,Werder Bremen,Bundesliga,2024,25.0,1999.0,8.9,10,5,6,3,1,5,11,45.5,6,6,2,4,8,18,23,0,DF,25-29,Defender,Germany,Europe
361914,Nayef Aguerd,MAR,Real Sociedad,La Liga,2024,28.0,1996.0,12.2,19,15,11,8,0,7,13,53.8,6,11,6,5,9,28,46,0,DF,25-29,Defender,Morocco,Africa
178313,Jean-Eudes Aholou,CIV,Angers,Ligue 1,2024,30.0,1994.0,12.2,34,22,17,9,8,15,27,55.6,12,21,11,10,24,58,13,0,MF,30-34,Midfielder,Ivory Coast,Africa
236490,Ola Aina,NGA,Nott'ham Forest,Premier League,2024,28.0,1996.0,16.3,36,25,27,8,1,23,35,65.7,12,17,5,12,23,59,45,1,DF,25-29,Defender,Nigeria,Africa
283994,Ludovic Ajorque,FRA,Brest,Ligue 1,2024,30.0,1994.0,10.8,11,8,1,5,5,4,12,33.3,8,5,2,3,3,14,8,0,FW,30-34,Forward,France,Europe
709969,Ilias Akhomach,MAR,Villarreal,La Liga,2024,20.0,2004.0,6.5,12,7,4,4,4,6,12,50.0,6,8,0,8,3,15,13,0,"MF,FW",20-24,Midfielder,Morocco,Africa
806793,Clment Akpa,CIV,Auxerre,Ligue 1,2024,23.0,2001.0,12.0,26,17,15,6,5,16,25,64.0,9,21,5,16,16,42,50,1,DF,20-24,Defender,Ivory Coast,Africa
88647,Andreas Albers,DEN,St. Pauli,Bundesliga,2024,34.0,1990.0,0.6,1,1,0,0,1,0,1,0.0,1,0,0,0,0,1,1,0,FW,30-34,Forward,Denmark,Europe
353032,Omar Alderete,PAR,Getafe,La Liga,2024,28.0,1996.0,16.8,26,17,18,6,2,13,17,76.5,4,17,11,6,21,47,74,1,DF,25-29,Defender,Paraguay,South America
314353,Trent Alexander-Arnold,ENG,Liverpool,Premier League,2024,26.0,1998.0,12.6,38,29,25,9,4,25,50,50.0,25,14,5,9,12,50,23,0,DF,25-29,Defender,England,Europe
646733,Jim Allevinah,GAB,Angers,Ligue 1,2024,29.0,1995.0,8.3,7,5,3,2,2,2,13,15.4,11,2,0,2,4,11,8,0,FW,25-29,Forward,Gabon,Africa
300532,Pontus Almqvist,SWE,Parma,Serie A,2024,25.0,1999.0,5.3,8,6,4,2,2,4,6,66.7,2,4,0,4,6,14,2,0,"FW,MF",25-29,Forward,Sweden,Europe
354909,Giorgio Altare,ITA,Venezia,Serie A,2024,26.0,1998.0,6.4,9,8,5,2,2,4,11,36.4,7,13,5,8,11,20,31,0,DF,25-29,Defender,Italy,Europe
401356,Edson lvarez,MEX,West Ham,Premier League,2024,27.0,1997.0,8.8,20,10,11,5,4,11,16,68.8,5,12,5,7,11,31,22,0,MF,25-29,Midfielder,Mexico,North America
377219,Selim Amallah,MAR,Valladolid,La Liga,2024,28.0,1996.0,7.8,13,8,4,8,1,1,7,14.3,6,13,0,13,7,20,2,1,"MF,FW",25-29,Midfielder,Morocco,Africa
241229,Jordan Amavi,FRA,Brest,Ligue 1,2024,30.0,1994.0,8.3,24,17,10,11,3,15,21,71.4,6,8,2,6,7,31,16,0,DF,30-34,Defender,France,Europe
344072,Kelvin Amian,FRA,Nantes,Ligue 1,2024,26.0,1998.0,9.9,26,15,23,3,0,13,16,81.3,3,8,4,4,2,28,23,0,"DF,MF",25-29,Defender,France,Europe
232454,Nadiem Amiri,GER,Mainz 05,Bundesliga,2024,28.0,1996.0,12.3,19,9,8,9,2,5,21,23.8,16,12,2,10,12,31,16,1,MF,25-29,Midfielder,Germany,Europe
746910,Mohamed Amoura,ALG,Wolfsburg,Bundesliga,2024,24.0,2000.0,11.7,9,6,3,1,5,4,15,26.7,11,18,0,18,4,13,6,0,FW,20-24,Forward,Algeria,Africa
567576,Elliot Anderson,ENG,Nott'ham Forest,Premier League,2024,22.0,2002.0,10.8,38,28,21,11,6,18,34,52.9,16,21,4,17,9,47,22,1,"MF,FW",20-24,Midfielder,England,Europe
800176,Andr,BRA,Wolves,Premier League,2024,23.0,2001.0,9.1,33,24,16,12,5,17,24,70.8,7,21,5,16,6,39,15,1,MF,20-24,Midfielder,Brazil,South America
84301,Benjamin Andr,FRA,Lille,Ligue 1,2024,34.0,1990.0,12.9,36,14,14,19,3,23,41,56.1,18,18,3,15,18,54,25,0,MF,30-34,Midfielder,France,Europe
327126,Anuar,MAR,Valladolid,La Liga,2024,29.0,1995.0,6.7,11,8,6,2,3,2,10,20.0,8,9,3,6,6,17,7,1,"FW,MF",25-29,Forward,Morocco,Africa
661145,Jon Aramburu,VEN,Real Sociedad,La Liga,2024,22.0,2002.0,13.3,54,39,30,18,6,38,59,64.4,21,21,3,18,19,73,44,0,DF,20-24,Defender,Venezuela,South America
533662,Cameron Archer,ENG,Southampton,Premier League,2024,23.0,2001.0,10.0,8,5,4,2,2,1,4,25.0,3,5,1,4,2,10,5,0,FW,20-24,Forward,England,Europe
468198,Joe Aribo,NGA,Southampton,Premier League,2024,28.0,1996.0,10.7,20,14,6,9,5,9,19,47.4,10,11,6,5,9,29,15,1,MF,25-29,Midfielder,Nigeria,Africa
652275,Hkon Arnar Haraldsson,ISL,Lille,Ligue 1,2024,21.0,2003.0,3.8,12,5,3,7,2,5,9,55.6,4,2,1,1,3,15,0,0,MF,20-24,Midfielder,Iceland,Europe
245744,Takuma Asano,JPN,Mallorca,La Liga,2024,30.0,1994.0,4.4,6,4,1,4,1,3,5,60.0,2,5,0,5,3,9,4,0,"FW,MF",30-34,Forward,Japan,Asia
585982,Carlos Augusto,BRA,Inter,Serie A,2024,25.0,1999.0,4.2,7,5,2,3,2,4,8,50.0,4,3,2,1,2,9,10,0,DF,25-29,Defender,Brazil,South America
295313,Taiwo Awoniyi,NGA,Nott'ham Forest,Premier League,2024,27.0,1997.0,2.3,3,1,0,2,1,2,2,100.0,0,1,0,1,0,3,3,0,FW,25-29,Forward,Nigeria,Africa
667287,Yasin Ayari,SWE,Brighton,Premier League,2024,21.0,2003.0,9.2,32,15,5,21,6,14,26,53.8,12,9,2,7,8,40,10,0,MF,20-24,Midfielder,Sweden,Europe
372713,Florian Ay,FRA,Auxerre,Ligue 1,2024,27.0,1997.0,3.5,2,2,0,0,2,0,1,0.0,1,3,0,3,3,5,5,0,FW,25-29,Forward,France,Europe
45403,Andr Ayew,GHA,Le Havre,Ligue 1,2024,35.0,1989.0,5.6,6,4,1,3,2,3,5,60.0,2,2,1,1,1,7,4,0,FW,35-39,Forward,Ghana,Africa
901019,Neil El Aynaoui,FRA,Lens,Ligue 1,2024,23.0,2001.0,3.2,11,8,9,2,0,4,14,28.6,10,7,3,4,2,13,5,0,MF,20-24,Midfielder,France,Europe
310527,Paulo Azzi,BRA,Cagliari,Serie A,2024,30.0,1994.0,4.7,11,9,3,6,2,5,9,55.6,4,5,2,3,5,16,11,0,DF,30-34,Defender,Brazil,South America
916920,Shavy Babicka,GAB,Toulouse,Ligue 1,2024,24.0,2000.0,5.6,12,9,3,5,4,7,11,63.6,4,9,0,9,1,13,3,2,"MF,FW",20-24,Midfielder,Gabon,Africa
387626,Leon Bailey,JAM,Aston Villa,Premier League,2024,27.0,1997.0,8.1,3,1,0,1,2,0,3,0.0,3,6,0,6,2,5,7,0,"FW,MF",25-29,Forward,Jamaica,North America
540664,Dilane Bakwa,FRA,Strasbourg,Ligue 1,2024,22.0,2002.0,14.5,13,9,7,3,3,6,14,42.9,8,13,0,13,6,19,16,0,"FW,MF",20-24,Forward,France,Europe
641537,Tommaso Baldanzi,ITA,Roma,Serie A,2024,21.0,2003.0,4.3,6,1,3,1,2,1,4,25.0,3,2,0,2,4,10,2,0,"MF,FW",20-24,Midfielder,Italy,Europe
973085,Carlos Baleba,CMR,Brighton,Premier League,2024,20.0,2004.0,11.0,30,16,5,17,8,18,29,62.1,11,17,4,13,23,53,7,0,MF,20-24,Midfielder,Cameroon,Africa
503770,Folarin Balogun,USA,Monaco,Ligue 1,2024,23.0,2001.0,5.2,0,0,0,0,0,0,2,0.0,2,0,0,0,0,0,0,0,FW,20-24,Forward,United States,North America
292818,Jonathan Bamba,CIV,Celta Vigo,La Liga,2024,28.0,1996.0,8.3,10,5,3,5,2,4,10,40.0,6,6,0,6,5,15,6,0,"FW,MF",25-29,Forward,Ivory Coast,Africa
545538,Lameck Banda,ZAM,Lecce,Serie A,2024,23.0,2001.0,5.6,5,4,4,1,0,3,10,30.0,7,6,0,6,1,6,6,0,"FW,MF",20-24,Forward,Zambia,Africa
708265,Bradley Barcola,FRA,Paris S-G,Ligue 1,2024,22.0,2002.0,11.7,12,6,5,5,2,1,13,7.7,12,11,0,11,8,20,4,0,FW,20-24,Forward,France,Europe
255942,Nicol Barella,ITA,Inter,Serie A,2024,27.0,1997.0,11.4,22,12,6,11,5,10,27,37.0,17,11,0,11,5,27,5,1,MF,25-29,Midfielder,Italy,Europe
131978,Ross Barkley,ENG,Aston Villa,Premier League,2024,31.0,1993.0,5.0,9,2,4,5,0,7,10,70.0,3,7,2,5,5,14,4,0,MF,30-34,Midfielder,England,Europe
398065,Harvey Barnes,ENG,Newcastle Utd,Premier League,2024,27.0,1997.0,8.3,9,5,3,4,2,3,5,60.0,2,4,1,3,4,13,5,1,FW,25-29,Forward,England,Europe
671915,Enzo Barrenechea,ARG,Valencia,La Liga,2024,23.0,2001.0,8.0,16,8,8,5,3,7,14,50.0,7,11,3,8,7,23,14,0,MF,20-24,Midfielder,Argentina,South America
937941,Thierno Barry,FRA,Villarreal,La Liga,2024,22.0,2002.0,12.4,6,4,2,3,1,2,5,40.0,3,11,2,9,0,6,6,0,FW,20-24,Forward,France,Europe
351955,Federico Baschirotto,ITA,Lecce,Serie A,2024,28.0,1996.0,17.0,20,16,14,4,2,12,15,80.0,3,24,18,6,15,35,71,0,DF,25-29,Defender,Italy,Europe
461883,Calvin Bassey,NGA,Fulham,Premier League,2024,24.0,1999.0,16.0,19,12,12,7,0,8,11,72.7,3,27,13,14,7,26,51,3,DF,20-24,Defender,Nigeria,Africa
315853,Alessandro Bastoni,ITA,Inter,Serie A,2024,25.0,1999.0,12.7,22,13,10,9,3,10,15,66.7,5,10,4,6,11,33,17,1,DF,25-29,Defender,Italy,Europe
289432,Dylan Batubinsika,COD,Saint-tienne,Ligue 1,2024,28.0,1996.0,13.6,15,8,11,3,1,7,13,53.8,6,16,8,8,29,44,72,3,DF,25-29,Defender,DR Congo,Africa
324278,Christoph Baumgartner,AUT,RB Leipzig,Bundesliga,2024,25.0,1999.0,9.0,19,13,3,10,6,7,26,26.9,19,20,6,14,9,28,9,1,MF,25-29,Midfielder,Austria,Europe
273669,Adrian Beck,GER,Heidenheim,Bundesliga,2024,27.0,1997.0,4.8,16,6,11,5,0,5,15,33.3,10,16,1,15,4,20,10,0,"FW,MF",25-29,Forward,Germany,Europe
188888,Sheraldo Becker,SUR,Real Sociedad,La Liga,2024,29.0,1995.0,7.6,2,2,0,2,0,0,2,0.0,2,4,0,4,1,3,8,0,"FW,MF",25-29,Forward,Suriname,South America
282349,Timo Becker,GER,Holstein Kiel,Bundesliga,2024,27.0,1997.0,11.5,19,12,14,5,0,13,19,68.4,6,9,6,3,7,26,32,0,DF,25-29,Defender,Germany,Europe
288255,Donny van de Beek,NED,Girona,La Liga,2024,27.0,1997.0,9.7,20,11,12,4,4,9,16,56.3,7,13,2,11,4,24,7,0,MF,25-29,Midfielder,Netherlands,Europe
117432,Kevin Behrens,GER,Wolfsburg,Bundesliga,2024,33.0,1991.0,1.2,1,1,0,1,0,0,1,0.0,1,0,0,0,0,1,1,0,FW,30-34,Forward,Germany,Europe
807688,Yassin Belkhdim,FRA,Angers,Ligue 1,2024,22.0,2002.0,6.4,30,15,13,11,6,13,29,44.8,16,11,2,9,9,39,13,0,"MF,FW",20-24,Midfielder,France,Europe
82350,Stefan Bell,GER,Mainz 05,Bundesliga,2024,33.0,1991.0,8.8,11,5,9,2,0,4,8,50.0,4,8,8,0,18,29,59,0,DF,30-34,Defender,Germany,Europe
450050,Jean-Ricner Bellegarde,FRA,Wolves,Premier League,2024,26.0,1998.0,8.1,10,6,4,4,2,4,6,66.7,2,9,2,7,6,16,7,0,"MF,FW",25-29,Midfielder,France,Europe
581678,Jude Bellingham,ENG,Real Madrid,La Liga,2024,21.0,2003.0,12.7,29,16,12,12,5,14,20,70.0,6,20,2,18,13,42,12,0,MF,20-24,Midfielder,England,Europe
628366,Lucas Beltrn,ARG,Fiorentina,Serie A,2024,23.0,2001.0,8.4,11,6,4,5,2,3,7,42.9,4,7,1,6,3,14,3,0,"MF,FW",20-24,Midfielder,Argentina,South America
810895,Eliesse Ben Seghir,MAR,Monaco,Ligue 1,2024,19.0,2005.0,11.6,20,16,6,10,4,12,19,63.2,7,12,0,12,6,26,1,0,"MF,FW",Under 20,Midfielder,Morocco,Africa
284732,Ramy Bensebaini,ALG,Dortmund,Bundesliga,2024,29.0,1995.0,9.8,24,11,14,8,2,14,22,63.6,8,26,3,23,13,37,31,1,DF,25-29,Defender,Algeria,Africa
633454,Alexander Bernhardsson,SWE,Holstein Kiel,Bundesliga,2024,26.0,1998.0,3.5,5,4,1,1,3,4,6,66.7,2,4,0,4,0,5,5,0,"DF,FW",25-29,Defender,Sweden,Europe
595809,Beto,GNB,Everton,Premier League,2024,26.0,1998.0,2.3,3,0,0,2,1,1,2,50.0,1,1,0,1,0,3,2,0,FW,25-29,Forward,Guinea-Bissau,Africa
649016,El Bilal Tour,MLI,Stuttgart,Bundesliga,2024,23.0,2001.0,3.5,3,1,1,1,1,3,3,100.0,0,1,0,1,0,3,1,0,"FW,MF",20-24,Forward,Mali,Africa
461019,Samuele Birindelli,ITA,Monza,Serie A,2024,25.0,1999.0,4.2,10,8,2,4,4,3,5,60.0,2,2,1,1,2,12,7,0,"DF,MF",25-29,Defender,Italy,Europe
822959,Tom Bischof,GER,Hoffenheim,Bundesliga,2024,19.0,2005.0,11.4,50,27,15,28,7,20,35,57.1,15,26,5,21,13,63,20,0,MF,Under 20,Midfielder,Germany,Europe
410425,Yves Bissouma,MLI,Tottenham,Premier League,2024,28.0,1996.0,9.2,29,19,12,15,2,14,23,60.9,9,5,2,3,11,40,20,2,MF,25-29,Midfielder,Mali,Africa
93844,Leonardo Bittencourt,GER,Werder Bremen,Bundesliga,2024,31.0,1993.0,5.3,8,3,4,3,1,3,8,37.5,5,6,0,6,7,15,7,0,MF,30-34,Midfielder,Germany,Europe
1071956,Emmanuel Biumla,FRA,Angers,Ligue 1,2024,19.0,2005.0,8.1,14,7,10,4,0,9,14,64.3,5,11,5,6,6,20,37,0,DF,Under 20,Defender,France,Europe
288225,Ludovic Blas,FRA,Rennes,Ligue 1,2024,26.0,1997.0,13.5,18,13,3,6,9,12,23,52.2,11,11,2,9,4,22,3,0,"MF,FW",25-29,Midfielder,France,Europe
12282,Daley Blind,NED,Girona,La Liga,2024,34.0,1990.0,13.1,21,10,10,10,1,12,17,70.6,5,17,6,11,14,35,38,1,DF,30-34,Defender,Netherlands,Europe
579263,Augustine Boakye,GHA,Saint-tienne,Ligue 1,2024,24.0,2000.0,3.7,4,2,1,3,0,2,8,25.0,6,1,0,1,4,8,2,0,"MF,FW",20-24,Midfielder,Ghana,Africa
1089202,Mose Bombito,CAN,Nice,Ligue 1,2024,24.0,2000.0,12.7,17,12,9,8,0,14,21,66.7,7,18,10,8,9,26,67,1,DF,20-24,Defender,Canada,North America
659516,Warren Bondo,FRA,Monza,Serie A,2024,21.0,2003.0,14.9,29,18,18,7,4,11,16,68.8,5,15,6,9,5,34,6,3,MF,20-24,Midfielder,France,Europe
656681,Victor Boniface,NGA,Leverkusen,Bundesliga,2024,24.0,2000.0,7.3,4,3,0,3,1,2,2,100.0,0,1,0,1,0,4,4,0,FW,20-24,Forward,Nigeria,Africa
827734,Ange-Yoan Bonny,FRA,Parma,Serie A,2024,21.0,2003.0,13.0,14,8,2,9,3,4,8,50.0,4,7,0,7,0,14,5,0,FW,20-24,Forward,France,Europe
338629,Sebastiaan Bornauw,BEL,Wolfsburg,Bundesliga,2024,25.0,1999.0,7.0,7,4,2,4,1,2,6,33.3,4,13,12,1,9,16,26,0,DF,25-29,Defender,Belgium,Europe
1097139,Ayyoub Bouaddi,FRA,Lille,Ligue 1,2024,17.0,2007.0,5.8,23,15,12,6,5,7,13,53.8,6,4,0,4,6,29,4,0,MF,Under 20,Midfielder,France,Europe
707242,Badredine Bouanani,ALG,Nice,Ligue 1,2024,20.0,2004.0,5.5,3,1,1,1,1,0,5,0.0,5,9,2,7,3,6,3,0,"MF,FW",20-24,Midfielder,Algeria,Africa
783094,Benjamin Bouchouari,MAR,Saint-tienne,Ligue 1,2024,23.0,2001.0,7.2,14,11,5,6,3,9,18,50.0,9,7,1,6,8,22,6,1,MF,20-24,Midfielder,Morocco,Africa
560593,Hicham Boudaoui,ALG,Nice,Ligue 1,2024,25.0,1999.0,10.9,35,19,15,14,6,15,26,57.7,11,17,4,13,12,47,23,0,MF,25-29,Midfielder,Algeria,Africa
329373,Carlo Boukhalfa,MAR,St. Pauli,Bundesliga,2024,25.0,1999.0,10.3,19,6,5,13,1,5,10,50.0,5,13,3,10,10,29,15,1,MF,25-29,Midfielder,Morocco,Africa
266359,Benjamin Bourigeaud,FRA,Rennes,Ligue 1,2024,30.0,1994.0,0.9,1,0,0,1,0,0,2,0.0,2,2,1,1,2,3,1,0,MF,30-34,Midfielder,France,Europe
562049,Edoardo Bove,ITA,Fiorentina,Serie A,2024,22.0,2002.0,9.3,24,17,7,14,3,14,28,50.0,14,12,0,12,6,30,8,0,"MF,FW",20-24,Midfielder,Italy,Europe
314875,Jarrod Bowen,ENG,West Ham,Premier League,2024,28.0,1996.0,16.7,25,15,8,6,11,11,26,42.3,15,11,2,9,11,36,17,0,"FW,MF",25-29,Forward,England,Europe
357796,Domagoj Bradari,CRO,Hellas Verona,Serie A,2024,25.0,1999.0,6.4,12,9,10,1,1,7,12,58.3,5,5,2,3,2,14,18,0,DF,25-29,Defender,Croatia,Europe
187492,Julian Brandt,GER,Dortmund,Bundesliga,2024,28.0,1996.0,10.9,10,4,6,3,1,7,18,38.9,11,6,0,6,4,14,7,0,MF,25-29,Midfielder,Germany,Europe
485960,Lilian Brassier,FRA,Marseille,Ligue 1,2024,25.0,1999.0,7.0,6,5,6,0,0,3,4,75.0,1,7,2,5,4,10,25,1,DF,25-29,Defender,France,Europe
973703,Brenner,BRA,Udinese,Serie A,2024,24.0,2000.0,4.3,6,4,2,3,1,3,8,37.5,5,4,0,4,1,7,6,0,"MF,FW",20-24,Midfielder,Brazil,South America
344009,Nathan Broadhead,WAL,Ipswich Town,Premier League,2024,26.0,1998.0,0.6,2,2,1,1,0,1,1,100.0,0,1,0,1,0,2,0,0,"FW,MF",25-29,Forward,Wales,Europe
277033,David Brooks,WAL,Bournemouth,Premier League,2024,27.0,1997.0,2.0,3,1,0,3,0,1,3,33.3,2,4,1,3,2,5,1,1,"FW,MF",25-29,Forward,Wales,Europe
406973,Moritz Broschinski,GER,Bochum,Bundesliga,2024,24.0,2000.0,9.7,13,9,4,4,5,1,9,11.1,8,12,0,12,0,13,10,0,"FW,MF",20-24,Forward,Germany,Europe
691892,Nathaniel Brown,GER,Eint Frankfurt,Bundesliga,2024,21.0,2003.0,6.3,17,12,7,6,4,10,14,71.4,4,7,0,7,2,19,18,0,"DF,MF",20-24,Defender,Germany,Europe
293281,Jacob Bruun Larsen,DEN,Hoffenheim,Bundesliga,2024,26.0,1998.0,4.4,4,3,1,2,1,3,8,37.5,5,5,1,4,1,5,2,0,"FW,MF",25-29,Forward,Denmark,Europe
46413,Ante Budimir,CRO,Osasuna,La Liga,2024,33.0,1991.0,15.3,10,5,1,7,2,2,5,40.0,3,12,3,9,1,11,12,0,FW,30-34,Forward,Croatia,Europe
438001,Santiago Bueno,URU,Wolves,Premier League,2024,26.0,1998.0,8.8,13,7,9,4,0,8,11,72.7,3,16,10,6,4,17,25,0,DF,25-29,Defender,Uruguay,South America
983989,Facundo Buonanotte,ARG,Leicester City,Premier League,2024,20.0,2004.0,10.2,27,13,9,10,8,12,44,27.3,32,24,5,19,7,34,7,0,"MF,FW",20-24,Midfielder,Argentina,South America
386446,Alessandro Buongiorno,ITA,Napoli,Serie A,2024,25.0,1999.0,15.0,25,16,16,9,0,17,20,85.0,3,21,13,8,24,49,43,1,DF,25-29,Defender,Italy,Europe
333647,Jonathan Burkardt,GER,Mainz 05,Bundesliga,2024,24.0,2000.0,11.7,5,3,1,2,2,1,4,25.0,3,6,1,5,0,5,11,0,FW,20-24,Forward,Germany,Europe
341317,Oliver Burke,SCO,Werder Bremen,Bundesliga,2024,27.0,1997.0,1.3,6,2,3,0,3,2,3,66.7,1,2,0,2,0,6,1,0,"FW,MF",25-29,Forward,Scotland,Europe
134270,Dan Burn,ENG,Newcastle Utd,Premier League,2024,32.0,1992.0,16.0,17,11,11,6,0,11,20,55.0,9,15,11,4,11,28,70,1,DF,30-34,Defender,England,Europe
255731,Wes Burns,WAL,Ipswich Town,Premier League,2024,30.0,1994.0,8.1,7,7,1,5,1,3,9,33.3,6,5,1,4,7,14,7,2,FW,30-34,Forward,Wales,Europe
504209,Gianluca Busio,USA,Venezia,Serie A,2024,22.0,2002.0,12.5,16,11,9,4,3,9,22,40.9,13,13,2,11,4,20,21,0,MF,20-24,Midfielder,United States,North America
258039,Aurlio Buta,POR,Reims,Ligue 1,2024,27.0,1997.0,9.9,25,16,15,8,2,14,25,56.0,11,4,0,4,11,36,24,0,DF,25-29,Defender,Portugal,Europe
113707,Rmy Cabella,FRA,Lille,Ligue 1,2024,34.0,1990.0,5.2,17,11,3,8,6,10,16,62.5,6,4,0,4,6,23,1,0,"MF,FW",30-34,Midfielder,France,Europe
102423,Leandro Cabrera,URU,Espanyol,La Liga,2024,33.0,1991.0,13.0,22,13,16,5,1,8,15,53.3,7,13,6,7,14,36,72,1,DF,30-34,Defender,Uruguay,South America
469211,Liberato Cacace,NZL,Empoli,Serie A,2024,24.0,2000.0,7.4,11,5,7,3,1,7,10,70.0,3,14,5,9,1,12,20,0,"DF,MF",20-24,Defender,New Zealand,Oceania
453016,Anthony Caci,FRA,Mainz 05,Bundesliga,2024,27.0,1997.0,13.6,26,16,7,12,7,13,21,61.9,8,13,4,9,12,38,23,1,DF,25-29,Defender,France,Europe
687626,Moiss Caicedo,ECU,Chelsea,Premier League,2024,23.0,2001.0,16.7,54,33,24,25,5,28,42,66.7,14,18,5,13,28,82,23,0,MF,20-24,Midfielder,Ecuador,South America
123275,Tom Cairney,SCO,Fulham,Premier League,2024,33.0,1991.0,2.8,5,1,1,1,3,1,2,50.0,1,3,1,2,4,9,1,1,MF,30-34,Midfielder,Scotland,Europe
88680,Luca Caldirola,ITA,Monza,Serie A,2024,33.0,1991.0,4.4,5,3,4,1,0,2,5,40.0,3,4,4,0,2,7,17,0,DF,30-34,Defender,Italy,Europe
126414,Hakan alhanolu,TUR,Inter,Serie A,2024,30.0,1994.0,8.8,23,10,4,11,8,12,21,57.1,9,3,2,1,5,28,7,0,MF,30-34,Midfielder,Turkey,Asia
306024,Dominic Calvert-Lewin,ENG,Everton,Premier League,2024,27.0,1997.0,13.7,7,5,1,3,3,0,2,0.0,2,5,2,3,6,13,15,0,FW,25-29,Forward,England,Europe
614742,Drissa Camara,CIV,Parma,Serie A,2024,22.0,2002.0,1.5,3,2,1,2,0,0,3,0.0,3,2,0,2,2,5,1,0,"MF,FW",20-24,Midfielder,Ivory Coast,Africa
918969,Lamine Camara,SEN,Monaco,Ligue 1,2024,20.0,2004.0,10.3,41,29,14,21,6,17,30,56.7,13,20,4,16,18,59,11,1,MF,20-24,Midfielder,Senegal,Africa
1058368,Francesco Camarda,ITA,Milan,Serie A,2024,16.0,2008.0,1.2,2,0,0,0,2,1,3,33.3,2,0,0,0,0,2,3,0,"FW,MF",Under 20,Forward,Italy,Europe
459658,Andrea Cambiaso,ITA,Juventus,Serie A,2024,24.0,2000.0,13.5,23,15,15,5,3,16,24,66.7,8,13,2,11,8,31,17,2,"DF,FW",20-24,Defender,Italy,Europe
146752,Gianluca Caprari,ITA,Monza,Serie A,2024,31.0,1993.0,7.7,10,7,3,6,1,2,5,40.0,3,7,0,7,3,13,1,1,MF,30-34,Midfielder,Italy,Europe
342226,Irvin Cardona,FRA,Espanyol,La Liga,2024,27.0,1997.0,6.6,8,5,2,4,2,6,15,40.0,9,5,1,4,3,11,10,0,"FW,MF",25-29,Forward,France,Europe
100131,William Carvalho,POR,Betis,La Liga,2024,32.0,1992.0,2.7,3,2,0,3,0,2,4,50.0,2,4,1,3,3,6,4,0,MF,30-34,Midfielder,Portugal,Europe
16306,Casemiro,BRA,Manchester Utd,Premier League,2024,32.0,1992.0,8.3,35,22,20,9,6,17,35,48.6,18,20,5,15,7,42,27,3,MF,30-34,Midfielder,Brazil,South America
763182,Josu Casimir,FRA,Le Havre,Ligue 1,2024,23.0,2001.0,7.5,15,9,5,8,2,4,9,44.4,5,7,0,7,1,16,16,1,"FW,DF",20-24,Forward,France,Europe
467632,Cristian Csseres Jr.,VEN,Toulouse,Ligue 1,2024,24.0,2000.0,12.3,44,30,23,18,3,17,37,45.9,20,16,3,13,19,63,14,1,MF,20-24,Midfielder,Venezuela,South America
262226,Timothy Castagne,BEL,Fulham,Premier League,2024,29.0,1995.0,3.0,7,4,4,2,1,6,9,66.7,3,2,1,1,3,10,15,0,DF,25-29,Defender,Belgium,Europe
849520,Santiago Castro,ARG,Bologna,Serie A,2024,20.0,2004.0,13.5,10,4,3,6,1,2,7,28.6,5,10,2,8,2,12,11,0,FW,20-24,Forward,Argentina,South America
199733,Danilo Cataldi,ITA,Fiorentina,Serie A,2024,30.0,1994.0,9.0,18,13,7,9,2,8,16,50.0,8,7,4,3,9,27,16,0,MF,30-34,Midfielder,Italy,Europe
251075,Zeki elik,TUR,Roma,Serie A,2024,27.0,1997.0,13.3,29,19,10,12,7,13,23,56.5,10,14,3,11,6,35,37,1,DF,25-29,Defender,Turkey,Asia
787912,El Chadaille Bitshiabu,FRA,RB Leipzig,Bundesliga,2024,19.0,2005.0,2.5,8,4,3,5,0,3,5,60.0,2,4,2,2,5,13,13,1,DF,Under 20,Defender,France,Europe
346314,Trevoh Chalobah,ENG,Crystal Palace,Premier League,2024,25.0,1999.0,9.8,18,14,7,10,1,10,20,50.0,10,18,9,9,17,35,49,3,DF,25-29,Defender,England,Europe
349503,Conor Chaplin,ENG,Ipswich Town,Premier League,2024,27.0,1997.0,6.8,11,5,3,6,2,6,13,46.2,7,8,1,7,3,14,2,0,"MF,FW",25-29,Midfielder,England,Europe
660342,Gabriel Charpentier,CGO,Parma,Serie A,2024,25.0,1999.0,3.0,4,3,2,1,1,3,4,75.0,1,3,0,3,0,4,9,0,FW,25-29,Forward,Congo,Africa
713787,Jhoanner Chvez,ECU,Lens,Ligue 1,2024,22.0,2002.0,6.5,9,5,4,4,1,2,7,28.6,5,10,1,9,6,15,13,0,"DF,MF",20-24,Defender,Ecuador,South America
624037,Joris Chotard,FRA,Montpellier,Ligue 1,2024,23.0,2001.0,7.5,20,13,7,13,0,11,19,57.9,8,10,2,8,9,29,16,0,MF,20-24,Midfielder,France,Europe
188077,Ryan Christie,SCO,Bournemouth,Premier League,2024,29.0,1995.0,12.6,24,15,10,9,5,12,27,44.4,15,23,7,16,13,37,29,1,MF,25-29,Midfielder,Scotland,Europe
401922,Samuel Chukwueze,NGA,Milan,Serie A,2024,25.0,1999.0,7.5,10,5,4,3,3,5,14,35.7,9,3,0,3,0,10,4,0,FW,25-29,Forward,Nigeria,Africa
525578,Path Ciss,SEN,Rayo Vallecano,La Liga,2024,30.0,1994.0,8.2,16,9,7,9,0,7,17,41.2,10,10,4,6,13,29,29,0,MF,30-34,Midfielder,Senegal,Africa
543537,Seydouba Ciss,GUI,Legans,La Liga,2024,23.0,2001.0,12.6,26,15,8,13,5,9,20,45.0,11,13,1,12,7,33,17,1,MF,20-24,Midfielder,Guinea,Africa
559794,Jack Clarke,ENG,Ipswich Town,Premier League,2024,24.0,2000.0,5.6,18,10,8,8,2,10,17,58.8,7,4,0,4,3,21,6,0,FW,20-24,Forward,England,Europe
384593,Alexis Claude-Maurice,FRA,Augsburg,Bundesliga,2024,26.0,1998.0,6.4,13,8,4,6,3,4,7,57.1,3,2,0,2,5,18,1,0,"FW,MF",25-29,Forward,France,Europe
175639,Jonathan Clauss,FRA,Nice,Ligue 1,2024,32.0,1992.0,9.5,27,19,15,11,1,16,26,61.5,10,12,2,10,19,46,30,0,"DF,MF",30-34,Defender,France,Europe
588426,Sal Coco,EQG,Torino,Serie A,2024,25.0,1999.0,15.0,16,7,12,4,0,3,9,33.3,6,21,13,8,23,39,73,3,DF,25-29,Defender,Equatorial Guinea,Africa
68390,Samus Coleman,IRL,Everton,Premier League,2024,36.0,1988.0,1.2,1,0,0,1,0,1,2,50.0,1,2,1,1,0,1,2,0,DF,35-39,Defender,Republic of Ireland,Europe
469050,Nathan Collins,IRL,Brentford,Premier League,2024,23.0,2001.0,17.0,21,13,14,5,2,14,18,77.8,4,36,27,9,17,38,88,0,DF,20-24,Defender,Republic of Ireland,Europe
487843,Lorenzo Colombo,ITA,Empoli,Serie A,2024,22.0,2002.0,12.5,13,8,4,5,4,5,13,38.5,8,14,1,13,1,14,8,0,"FW,MF",20-24,Forward,Italy,Europe
392959,Andrea Colpani,ITA,Fiorentina,Serie A,2024,25.0,1999.0,12.2,10,5,5,4,1,1,7,14.3,6,5,0,5,6,16,9,0,"FW,MF",25-29,Forward,Italy,Europe
614258,Levi Colwill,ENG,Chelsea,Premier League,2024,21.0,2003.0,16.0,13,9,10,3,0,4,9,44.4,5,23,17,6,16,29,50,1,DF,20-24,Defender,England,Europe
243714,Kingsley Coman,FRA,Bayern Munich,Bundesliga,2024,28.0,1996.0,6.9,10,6,3,2,5,3,5,60.0,2,6,0,6,6,16,12,0,FW,25-29,Forward,France,Europe
487474,Francisco Conceio,POR,Juventus,Serie A,2024,22.0,2002.0,8.2,11,6,3,4,4,4,15,26.7,11,2,0,2,4,15,2,0,"FW,MF",20-24,Forward,Portugal,Europe
401571,Toms Conechny,ARG,Alavs,La Liga,2024,26.0,1998.0,5.3,4,2,2,2,0,2,10,20.0,8,9,1,8,4,8,5,0,"FW,MF",25-29,Forward,Argentina,South America
307183,Sirlord Conteh,GER,Heidenheim,Bundesliga,2024,28.0,1996.0,3.9,7,4,3,4,0,2,3,66.7,1,1,1,0,0,7,1,0,"FW,MF",25-29,Forward,Germany,Europe
249089,Lewis Cook,ENG,Bournemouth,Premier League,2024,27.0,1997.0,14.6,39,22,20,17,2,16,32,50.0,16,18,6,12,25,64,27,0,"MF,DF",25-29,Midfielder,England,Europe
660860,Diego Coppola,ITA,Hellas Verona,Serie A,2024,20.0,2003.0,12.5,23,14,17,4,2,11,16,68.8,5,22,11,11,31,54,56,1,DF,20-24,Defender,Italy,Europe
266807,ngel Correa,ARG,Atltico Madrid,La Liga,2024,29.0,1995.0,5.1,4,0,2,0,2,1,6,16.7,5,5,0,5,3,7,3,0,"FW,MF",25-29,Forward,Argentina,South America
367466,Thierry Correia,POR,Valencia,La Liga,2024,25.0,1999.0,8.5,27,18,19,5,3,13,23,56.5,10,10,1,9,4,31,18,0,DF,25-29,Defender,Portugal,Europe
386552,Lassana Coulibaly,MLI,Lecce,Serie A,2024,28.0,1996.0,11.6,18,13,7,11,0,7,22,31.8,15,19,6,13,8,26,15,0,MF,25-29,Midfielder,Mali,Africa
618425,Tanguy Coulibaly,FRA,Montpellier,Ligue 1,2024,23.0,2001.0,4.9,9,6,2,6,1,2,8,25.0,6,3,0,3,4,13,0,0,"FW,MF",20-24,Forward,France,Europe
627228,Yan Couto,BRA,Dortmund,Bundesliga,2024,22.0,2002.0,4.4,9,5,7,1,1,6,10,60.0,4,9,0,9,5,14,13,1,DF,20-24,Defender,Brazil,South America
485965,Nicolas Cozza,FRA,Nantes,Ligue 1,2024,25.0,1999.0,10.3,27,18,14,10,3,12,21,57.1,9,11,3,8,11,38,28,0,"DF,MF",25-29,Defender,France,Europe
597659,Charlie Cresswell,ENG,Toulouse,Ligue 1,2024,22.0,2002.0,11.8,14,6,7,7,0,13,24,54.2,11,17,10,7,15,29,63,2,DF,20-24,Defender,England,Europe
199248,Bryan Cristante,ITA,Roma,Serie A,2024,29.0,1995.0,11.1,23,17,7,13,3,9,16,56.3,7,12,7,5,11,34,20,0,MF,25-29,Midfielder,Italy,Europe
91970,Juan Cuadrado,COL,Atalanta,Serie A,2024,36.0,1988.0,2.4,1,0,0,0,1,1,6,16.7,5,3,1,2,1,2,3,0,"DF,MF",35-39,Defender,Colombia,South America
265078,Patrick Cutrone,ITA,Como,Serie A,2024,26.0,1998.0,12.9,10,8,0,6,4,5,9,55.6,4,5,0,5,2,12,6,0,FW,25-29,Forward,Italy,Europe
55769,Danilo D'Ambrosio,ITA,Monza,Serie A,2024,36.0,1988.0,3.3,9,3,8,0,1,3,7,42.9,4,5,3,2,2,11,7,0,DF,35-39,Defender,Italy,Europe
495667,Lucas Da Cunha,FRA,Como,Serie A,2024,23.0,2001.0,9.7,20,9,7,9,4,8,13,61.5,5,5,0,5,8,28,14,0,MF,20-24,Midfielder,France,Europe
538964,Thijs Dallinga,NED,Bologna,Serie A,2024,24.0,2000.0,3.0,6,3,0,1,5,2,2,100.0,0,4,1,3,0,6,4,0,"FW,MF",20-24,Forward,Netherlands,Europe
357147,Diogo Dalot,POR,Manchester Utd,Premier League,2024,25.0,1999.0,16.6,38,26,23,11,4,17,27,63.0,10,14,7,7,24,62,33,0,DF,25-29,Defender,Portugal,Europe
322655,Flavius Daniliuc,AUT,Hellas Verona,Serie A,2024,23.0,2001.0,7.0,18,13,11,5,2,10,17,58.8,7,6,1,5,6,24,16,0,DF,20-24,Defender,Austria,Europe
355861,Arnaut Danjuma,NED,Villarreal,La Liga,2024,27.0,1997.0,2.2,2,1,0,1,1,0,1,0.0,1,1,0,1,0,2,0,0,FW,25-29,Forward,Netherlands,Europe
263236,Kevin Danso,AUT,Lens,Ligue 1,2024,26.0,1998.0,10.0,16,6,12,4,0,9,11,81.8,2,23,18,5,18,34,56,1,DF,25-29,Defender,Austria,Europe
789252,Bence Drdai,GER,Wolfsburg,Bundesliga,2024,18.0,2006.0,5.2,8,6,2,6,0,4,8,50.0,4,8,2,6,3,11,10,0,MF,Under 20,Midfielder,Germany,Europe
334213,Lukas Daschner,GER,Bochum,Bundesliga,2024,26.0,1998.0,4.2,4,2,1,2,1,2,9,22.2,7,5,0,5,0,4,4,0,"MF,FW",25-29,Midfielder,Germany,Europe
533738,Jonathan David,CAN,Lille,Ligue 1,2024,24.0,2000.0,13.1,12,3,2,7,3,4,10,40.0,6,6,2,4,3,15,3,0,FW,20-24,Forward,Canada,North America
424204,Alphonso Davies,CAN,Bayern Munich,Bundesliga,2024,24.0,2000.0,12.1,20,12,6,11,3,11,16,68.8,5,12,1,11,8,28,15,1,DF,20-24,Defender,Canada,North America
412660,Keinan Davis,ENG,Udinese,Serie A,2024,26.0,1998.0,7.6,6,3,1,3,2,1,2,50.0,1,2,1,1,1,7,4,0,FW,25-29,Forward,England,Europe
596446,Leif Davis,ENG,Ipswich Town,Premier League,2024,24.0,2000.0,17.0,25,15,19,3,3,18,30,60.0,12,12,2,10,13,38,45,0,DF,20-24,Defender,England,Europe
427572,Zuriko Davitashvili,GEO,Saint-tienne,Ligue 1,2024,23.0,2001.0,14.2,10,5,3,5,2,8,23,34.8,15,8,0,8,9,19,3,0,"MF,FW",20-24,Midfielder,Georgia,Asia
121477,Craig Dawson,ENG,Wolves,Premier League,2024,34.0,1990.0,9.9,14,3,8,5,1,11,14,78.6,3,14,11,3,9,23,48,1,DF,30-34,Defender,England,Europe
88755,Kevin De Bruyne,BEL,Manchester City,Premier League,2024,33.0,1991.0,7.0,5,3,2,1,2,1,8,12.5,7,3,0,3,3,8,2,1,MF,30-34,Midfielder,Belgium,Europe
435772,Charles De Ketelaere,BEL,Atalanta,Serie A,2024,23.0,2001.0,12.1,5,5,0,4,1,1,6,16.7,5,4,2,2,1,6,6,0,"MF,FW",20-24,Midfielder,Belgium,Europe
490384,Koni De Winter,BEL,Genoa,Serie A,2024,22.0,2002.0,7.0,12,9,6,5,1,4,6,66.7,2,2,1,1,8,20,34,0,DF,20-24,Defender,Belgium,Europe
353399,Romain Del Castillo,FRA,Brest,Ligue 1,2024,28.0,1996.0,8.8,18,11,4,8,6,11,19,57.9,8,11,0,11,5,23,0,0,FW,25-29,Forward,France,Europe
610849,Liam Delap,ENG,Ipswich Town,Premier League,2024,21.0,2003.0,13.2,6,4,2,1,3,0,7,0.0,7,4,0,4,2,8,14,0,FW,20-24,Forward,England,Europe
288230,Ousmane Dembl,FRA,Paris S-G,Ligue 1,2024,27.0,1997.0,10.0,5,2,0,2,3,2,6,33.3,4,1,0,1,7,12,0,1,FW,25-29,Forward,France,Europe
541231,Sepp van den Berg,NED,Brentford,Premier League,2024,23.0,2001.0,13.0,22,13,14,6,2,11,20,55.0,9,23,14,9,10,32,50,2,DF,20-24,Defender,Netherlands,Europe
169880,Giovanni Di Lorenzo,ITA,Napoli,Serie A,2024,31.0,1993.0,17.0,38,26,20,15,3,24,34,70.6,10,6,3,3,17,55,43,1,DF,30-34,Defender,Italy,Europe
626913,Boulaye Dia,SEN,Lazio,Serie A,2024,28.0,1996.0,9.5,9,3,4,1,4,5,10,50.0,5,2,0,2,3,12,3,1,"MF,FW",25-29,Midfielder,Senegal,Africa
463605,Bafod Diakit,FRA,Lille,Ligue 1,2024,23.0,2001.0,15.0,15,9,9,4,2,11,17,64.7,6,13,6,7,16,31,42,3,DF,20-24,Defender,France,Europe
847279,Oumar Diakit,CIV,Reims,Ligue 1,2024,21.0,2003.0,11.8,15,10,7,5,3,7,14,50.0,7,8,1,7,2,17,6,0,FW,20-24,Forward,Ivory Coast,Africa
536835,Amad Diallo,CIV,Manchester Utd,Premier League,2024,22.0,2002.0,10.8,24,20,4,12,8,12,18,66.7,6,3,0,3,8,32,11,0,"FW,DF",20-24,Forward,Ivory Coast,Africa
876631,Habib Diarra,SEN,Strasbourg,Ligue 1,2024,20.0,2004.0,13.2,10,6,1,7,2,5,9,55.6,4,8,2,6,4,14,19,1,"MF,FW",20-24,Midfielder,Senegal,Africa
258004,Rben Dias,POR,Manchester City,Premier League,2024,27.0,1997.0,12.1,9,5,3,5,1,3,4,75.0,1,10,9,1,12,21,32,1,DF,25-29,Defender,Portugal,Europe
490426,Krpin Diatta,SEN,Monaco,Ligue 1,2024,25.0,1999.0,2.2,11,7,8,1,2,7,13,53.8,6,4,1,3,3,14,7,1,DF,25-29,Defender,Senegal,Africa
314678,Brahim Daz,MAR,Real Madrid,La Liga,2024,25.0,1999.0,6.5,14,10,6,7,1,1,6,16.7,5,8,0,8,2,16,1,0,"FW,MF",25-29,Forward,Morocco,Africa
480692,Luis Daz,COL,Liverpool,Premier League,2024,27.0,1997.0,10.7,13,7,5,7,1,6,14,42.9,8,10,0,10,3,16,4,1,FW,25-29,Forward,Colombia,South America
866655,Tyler Dibling,ENG,Southampton,Premier League,2024,18.0,2006.0,10.8,18,12,6,10,2,8,14,57.1,6,8,2,6,4,22,6,0,"FW,MF",Under 20,Forward,England,Europe
126664,Lucas Digne,FRA,Aston Villa,Premier League,2024,31.0,1993.0,13.9,33,20,19,8,6,22,34,64.7,12,13,3,10,19,52,42,1,DF,30-34,Defender,France,Europe
198116,Federico Dimarco,ITA,Inter,Serie A,2024,27.0,1997.0,13.2,9,4,4,3,2,5,8,62.5,3,11,2,9,9,18,13,0,"DF,FW",25-29,Defender,Italy,Europe
645774,Eren Dinki,GER,Freiburg,Bundesliga,2024,23.0,2001.0,6.9,13,7,3,6,4,3,13,23.1,10,14,2,12,4,17,1,0,MF,20-24,Midfielder,Germany,Europe
272622,Issa Diop,FRA,Fulham,Premier League,2024,27.0,1997.0,9.4,14,8,10,4,0,6,9,66.7,3,7,6,1,2,16,44,0,DF,25-29,Defender,France,Europe
569389,Sofiane Diop,FRA,Nice,Ligue 1,2024,24.0,2000.0,5.3,14,11,9,2,3,7,14,50.0,7,15,2,13,5,19,4,0,"MF,FW",20-24,Midfielder,France,Europe
711976,Andy Diouf,FRA,Lens,Ligue 1,2024,21.0,2003.0,11.4,17,11,4,10,3,10,20,50.0,10,16,1,15,8,25,8,0,MF,20-24,Midfielder,France,Europe
386047,Axel Disasi,FRA,Chelsea,Premier League,2024,26.0,1998.0,3.0,5,4,4,0,1,4,7,57.1,3,3,1,2,1,6,9,0,DF,25-29,Defender,France,Europe
165513,Berat Djimsiti,ALB,Atalanta,Serie A,2024,31.0,1993.0,12.5,29,18,15,14,0,15,18,83.3,3,15,9,6,23,52,42,1,DF,30-34,Defender,Albania,Europe
401529,Dod,BRA,Fiorentina,Serie A,2024,26.0,1998.0,14.9,15,12,8,4,3,9,18,50.0,9,10,3,7,20,35,28,1,DF,25-29,Defender,Brazil,South America
387047,Danilho Doekhi,NED,Union Berlin,Bundesliga,2024,26.0,1998.0,15.0,19,11,10,7,2,8,11,72.7,3,19,7,12,22,41,46,0,DF,25-29,Defender,Netherlands,Europe
497291,Nicols Domnguez,ARG,Nott'ham Forest,Premier League,2024,26.0,1998.0,9.0,29,13,13,11,5,14,29,48.3,15,17,4,13,16,45,15,0,"MF,FW",25-29,Midfielder,Argentina,South America
926952,Patrick Dorgu,DEN,Lecce,Serie A,2024,20.0,2004.0,15.4,30,17,13,13,4,16,30,53.3,14,16,3,13,13,43,32,2,"FW,DF",20-24,Forward,Denmark,Europe
385394,Alberto Dossena,ITA,Como,Serie A,2024,26.0,1998.0,12.6,17,9,13,4,0,7,12,58.3,5,12,9,3,13,30,63,1,DF,25-29,Defender,Italy,Europe
127187,Abdoulaye Doucour,MLI,Everton,Premier League,2024,31.0,1993.0,11.9,21,9,12,7,2,6,13,46.2,7,17,4,13,5,26,10,0,MF,30-34,Midfielder,Mali,Africa
914562,Dsir Dou,FRA,Paris S-G,Ligue 1,2024,19.0,2005.0,6.5,8,6,2,5,1,3,13,23.1,10,5,0,5,3,11,4,0,FW,Under 20,Forward,France,Europe
671594,Kamory Doumbia,MLI,Brest,Ligue 1,2024,21.0,2003.0,6.2,18,13,7,9,2,8,18,44.4,10,4,0,4,11,29,6,0,"MF,FW",20-24,Midfielder,Mali,Africa
523318,Anastasios Douvikas,GRE,Celta Vigo,La Liga,2024,25.0,1999.0,7.0,8,3,2,5,1,3,5,60.0,2,5,2,3,3,11,5,0,FW,25-29,Forward,Greece,Europe
343537,Artem Dovbyk,UKR,Roma,Serie A,2024,27.0,1997.0,13.8,3,2,0,1,2,0,2,0.0,2,6,2,4,1,4,7,0,FW,25-29,Forward,Ukraine,Europe
506189,Flynn Downes,ENG,Southampton,Premier League,2024,25.0,1999.0,14.5,32,17,16,14,2,10,26,38.5,16,17,4,13,19,51,27,3,MF,25-29,Midfielder,England,Europe
433183,Tommy Doyle,ENG,Wolves,Premier League,2024,23.0,2001.0,3.8,7,3,2,3,2,3,9,33.3,6,5,2,3,3,10,6,0,MF,20-24,Midfielder,England,Europe
568559,Radu Drguin,ROU,Tottenham,Premier League,2024,22.0,2002.0,9.0,9,5,7,2,0,6,10,60.0,4,13,9,4,12,21,34,4,DF,20-24,Defender,Romania,Europe
232418,Ondrej Duda,SVK,Hellas Verona,Serie A,2024,30.0,1994.0,9.9,15,10,6,8,1,10,22,45.5,12,8,2,6,13,28,7,3,MF,30-34,Midfielder,Slovakia,Europe
321528,Denzel Dumfries,NED,Inter,Serie A,2024,28.0,1996.0,8.3,9,7,2,5,2,5,12,41.7,7,11,0,11,2,11,9,0,"DF,FW",25-29,Defender,Netherlands,Europe
184894,Alfred Duncan,GHA,Venezia,Serie A,2024,31.0,1993.0,8.8,14,5,3,9,2,4,12,33.3,8,4,2,2,8,22,6,0,MF,30-34,Midfielder,Ghana,Africa
148153,Lewis Dunk,ENG,Brighton,Premier League,2024,33.0,1991.0,12.0,8,4,4,3,1,2,3,66.7,1,14,9,5,9,17,34,0,DF,30-34,Defender,England,Europe
649317,Jhon Durn,COL,Aston Villa,Premier League,2024,21.0,2003.0,6.3,8,7,1,2,5,1,4,25.0,3,5,0,5,0,8,12,0,FW,20-24,Forward,Colombia,South America
206050,Paulo Dybala,ARG,Roma,Serie A,2024,31.0,1993.0,9.7,12,5,2,6,4,6,10,60.0,4,4,0,4,1,13,0,0,"FW,MF",30-34,Forward,Argentina,South America
607854,derson,BRA,Atalanta,Serie A,2024,25.0,1999.0,15.8,19,14,8,10,1,9,15,60.0,6,8,1,7,20,39,16,0,MF,25-29,Midfielder,Brazil,South America
251303,Johannes Eggestein,GER,St. Pauli,Bundesliga,2024,26.0,1998.0,13.4,3,2,0,1,2,0,2,0.0,2,2,0,2,0,3,5,0,FW,25-29,Forward,Germany,Europe
272812,Kingsley Ehizibue,NED,Udinese,Serie A,2024,29.0,1995.0,15.4,34,24,19,13,2,17,27,63.0,10,19,5,14,12,46,36,4,DF,25-29,Defender,Netherlands,Europe
500067,Chidera Ejuke,NGA,Sevilla,La Liga,2024,26.0,1998.0,6.0,5,3,0,3,2,3,9,33.3,6,6,0,6,1,6,2,0,"FW,MF",25-29,Forward,Nigeria,Africa
361068,Jurgen Ekkelenkamp,NED,Udinese,Serie A,2024,24.0,2000.0,7.4,18,12,5,12,1,10,19,52.6,9,10,3,7,5,23,13,0,MF,20-24,Midfielder,Netherlands,Europe
583189,Anthony Elanga,SWE,Nott'ham Forest,Premier League,2024,22.0,2002.0,9.8,8,5,4,3,1,2,6,33.3,4,4,0,4,4,12,16,0,"FW,MF",20-24,Forward,Sweden,Europe
237662,Breel Embolo,SUI,Monaco,Ligue 1,2024,27.0,1997.0,9.1,5,4,1,2,2,1,8,12.5,7,4,0,4,1,6,3,0,FW,25-29,Forward,Switzerland,Europe
559328,Emanuel Emegha,NED,Strasbourg,Ligue 1,2024,21.0,2003.0,8.7,4,4,0,2,2,1,2,50.0,1,7,4,3,0,4,9,0,FW,20-24,Forward,Netherlands,Europe
181778,Emerson,BRA,Milan,Serie A,2024,25.0,1999.0,12.5,32,20,16,12,4,15,32,46.9,17,8,2,6,13,45,43,0,DF,25-29,Defender,Brazil,South America
660867,Julio Enciso,PAR,Brighton,Premier League,2024,20.0,2004.0,1.8,0,0,0,0,0,0,1,0.0,1,2,0,2,0,0,1,0,"MF,FW",20-24,Midfielder,Paraguay,South America
971570,Endrick,BRA,Real Madrid,La Liga,2024,18.0,2006.0,1.0,0,0,0,0,0,0,1,0.0,1,0,0,0,1,1,0,0,FW,Under 20,Forward,Brazil,South America
405670,Yannik Engelhardt,GER,Como,Serie A,2024,23.0,2001.0,6.6,18,7,6,11,1,10,14,71.4,4,1,0,1,4,22,14,0,MF,20-24,Midfielder,Germany,Europe
311044,Alfonso Espino,URU,Rayo Vallecano,La Liga,2024,32.0,1992.0,4.4,22,13,16,5,1,13,25,52.0,12,10,3,7,9,31,13,0,DF,30-34,Defender,Uruguay,South America
538918,Sebastiano Esposito,ITA,Empoli,Serie A,2024,22.0,2002.0,9.2,20,10,5,12,3,8,16,50.0,8,6,1,5,8,28,4,0,"FW,MF",20-24,Forward,Italy,Europe
349599,Pervis Estupin,ECU,Brighton,Premier League,2024,26.0,1998.0,11.8,28,19,16,8,4,12,19,63.2,7,5,2,3,15,43,32,0,DF,25-29,Defender,Ecuador,South America
711337,Evanilson,BRA,Bournemouth,Premier League,2024,25.0,1999.0,13.1,8,4,1,4,3,3,7,42.9,4,7,1,6,0,8,11,0,FW,25-29,Forward,Brazil,South America
479999,Eberechi Eze,ENG,Crystal Palace,Premier League,2024,26.0,1998.0,12.0,20,12,9,8,3,9,19,47.4,10,11,0,11,6,26,3,1,"MF,FW",25-29,Midfielder,England,Europe
724520,Abde Ezzalzouli,MAR,Betis,La Liga,2024,23.0,2001.0,14.3,28,19,13,12,3,10,17,58.8,7,16,3,13,5,33,9,0,"FW,MF",20-24,Forward,Morocco,Africa
633668,Giovanni Fabbian,ITA,Bologna,Serie A,2024,21.0,2003.0,5.2,8,5,1,2,5,5,8,62.5,3,1,1,0,2,10,4,0,MF,20-24,Midfielder,Italy,Europe
749552,Alieu Fadera,GAM,Como,Serie A,2024,23.0,2001.0,11.9,40,32,14,16,10,14,31,45.2,17,10,1,9,5,45,6,0,FW,20-24,Forward,Gambia,Africa
292808,Wout Faes,BEL,Leicester City,Premier League,2024,26.0,1998.0,14.0,21,13,15,5,1,9,24,37.5,15,26,18,8,11,32,85,3,DF,25-29,Defender,Belgium,Europe
432090,Nicol Fagioli,ITA,Juventus,Serie A,2024,23.0,2001.0,6.2,13,9,7,5,1,6,8,75.0,2,4,0,4,2,15,5,0,MF,20-24,Midfielder,Italy,Europe
555076,Romain Faivre,FRA,Brest,Ligue 1,2024,26.0,1998.0,5.4,8,8,3,4,1,4,9,44.4,5,1,0,1,3,11,2,1,"FW,MF",25-29,Forward,France,Europe
782630,Khalil Fayad,FRA,Montpellier,Ligue 1,2024,20.0,2004.0,2.8,14,7,5,9,0,5,8,62.5,3,4,0,4,1,15,4,0,"MF,FW",20-24,Midfielder,France,Europe
691482,Jacopo Fazzini,ITA,Empoli,Serie A,2024,21.0,2003.0,6.3,17,9,8,8,1,10,14,71.4,4,7,1,6,2,19,10,0,MF,20-24,Midfielder,Italy,Europe
710004,Peter Federico,DOM,Getafe,La Liga,2024,22.0,2002.0,3.4,6,3,1,3,2,3,4,75.0,1,5,0,5,0,6,3,0,"MF,FW",20-24,Midfielder,Dominican Republic,North America
203496,Nabil Fekir,FRA,Betis,La Liga,2024,31.0,1993.0,2.0,3,2,1,1,1,1,2,50.0,1,2,0,2,0,3,0,0,MF,30-34,Midfielder,France,Europe
462250,Joo Flix,POR,Chelsea,Premier League,2024,25.0,1999.0,3.3,7,3,2,4,1,5,8,62.5,3,2,0,2,3,10,2,0,"FW,MF",25-29,Forward,Portugal,Europe
648046,Evan Ferguson,IRL,Brighton,Premier League,2024,20.0,2004.0,2.5,3,2,0,3,0,2,5,40.0,3,3,1,2,0,3,4,0,FW,20-24,Forward,Republic of Ireland,Europe
428563,Lewis Ferguson,SCO,Bologna,Serie A,2024,25.0,1999.0,1.1,3,2,0,1,2,2,4,50.0,2,1,0,1,0,3,1,0,MF,25-29,Midfielder,Scotland,Europe
232895,Zinedine Ferhat,ALG,Angers,Ligue 1,2024,31.0,1993.0,2.5,1,0,0,1,0,0,2,0.0,2,1,0,1,2,3,2,0,"FW,MF",30-34,Forward,Algeria,Africa
240306,Bruno Fernandes,POR,Manchester Utd,Premier League,2024,30.0,1994.0,15.9,38,24,8,22,8,13,38,34.2,25,15,2,13,13,51,18,1,"MF,FW",30-34,Midfielder,Portugal,Europe
247555,Edimilson Fernandes,SUI,Brest,Ligue 1,2024,28.0,1996.0,4.7,4,3,2,2,0,4,7,57.1,3,8,3,5,9,13,11,1,MF,25-29,Midfielder,Switzerland,Europe
648195,Enzo Fernndez,ARG,Chelsea,Premier League,2024,23.0,2001.0,12.8,38,17,10,17,11,19,45,42.2,26,16,2,14,6,44,10,3,MF,20-24,Midfielder,Argentina,South America
118284,Jordan Ferri,FRA,Montpellier,Ligue 1,2024,32.0,1992.0,8.8,21,10,9,11,1,10,17,58.8,7,7,1,6,4,25,7,0,MF,30-34,Midfielder,France,Europe
406635,Phil Foden,ENG,Manchester City,Premier League,2024,24.0,2000.0,9.0,2,1,2,0,0,2,7,28.6,5,4,1,3,4,6,3,0,"MF,FW",20-24,Midfielder,England,Europe
569598,Youssouf Fofana,FRA,Milan,Serie A,2024,25.0,1999.0,13.6,24,15,5,17,2,12,24,50.0,12,13,3,10,10,34,14,2,MF,25-29,Midfielder,France,Europe
192169,Jonas Fhrenbach,GER,Heidenheim,Bundesliga,2024,28.0,1996.0,14.1,26,13,15,10,1,13,20,65.0,7,20,3,17,11,37,40,0,DF,25-29,Defender,Germany,Europe
170472,Dimitri Foulquier,FRA,Valencia,La Liga,2024,31.0,1993.0,10.1,26,18,16,7,3,13,20,65.0,7,9,1,8,4,30,23,1,DF,30-34,Defender,France,Europe
146795,Ryan Fraser,SCO,Southampton,Premier League,2024,30.0,1994.0,3.4,6,2,2,4,0,4,6,66.7,2,1,1,0,1,7,9,0,"FW,DF",30-34,Forward,Scotland,Europe
394300,Davide Frattesi,ITA,Inter,Serie A,2024,25.0,1999.0,6.5,8,4,3,4,1,6,11,54.5,5,4,2,2,2,10,2,1,MF,25-29,Midfielder,Italy,Europe
503871,Morten Frendrup,DEN,Genoa,Serie A,2024,23.0,2001.0,15.5,62,40,15,29,18,23,43,53.5,20,29,10,19,20,82,26,0,MF,20-24,Midfielder,Denmark,Europe
484547,Jeremie Frimpong,NED,Leverkusen,Bundesliga,2024,24.0,2000.0,11.9,15,12,7,5,3,8,16,50.0,8,11,0,11,6,21,9,0,"DF,MF",20-24,Defender,Netherlands,Europe
272278,Chris Fhrich,GER,Stuttgart,Bundesliga,2024,26.0,1998.0,8.5,5,3,1,3,1,5,12,41.7,7,10,2,8,1,6,10,0,"FW,MF",25-29,Forward,Germany,Europe
250013,Angelo Fulgini,FRA,Lens,Ligue 1,2024,28.0,1996.0,6.5,5,4,2,1,2,3,5,60.0,2,7,1,6,0,5,2,0,"MF,FW",25-29,Midfielder,France,Europe
75489,Niclas Fllkrug,GER,West Ham,Premier League,2024,31.0,1993.0,1.9,1,1,0,0,1,1,1,100.0,0,0,0,0,0,1,3,0,FW,30-34,Forward,Germany,Europe
358008,Gianluca Gaetano,ITA,Cagliari,Serie A,2024,24.0,2000.0,6.3,6,4,3,3,0,3,11,27.3,8,5,0,5,4,10,7,0,"MF,FW",20-24,Midfielder,Italy,Europe
434675,Cody Gakpo,NED,Liverpool,Premier League,2024,25.0,1999.0,8.4,15,9,4,6,5,8,13,61.5,5,9,0,9,6,21,9,1,FW,25-29,Forward,Netherlands,Europe
488362,Conor Gallagher,ENG,Atltico Madrid,La Liga,2024,24.0,2000.0,9.0,23,16,7,12,4,11,24,45.8,13,11,2,9,7,30,14,0,MF,20-24,Midfielder,England,Europe
392516,Antonino Gallo,ITA,Lecce,Serie A,2024,24.0,2000.0,12.3,26,16,17,6,3,10,20,50.0,10,15,1,14,9,35,51,0,DF,20-24,Defender,Italy,Europe
121686,Cristian Gamboa,CRC,Bochum,Bundesliga,2024,35.0,1989.0,1.3,1,1,1,0,0,1,2,50.0,1,0,0,0,0,1,2,0,DF,35-39,Defender,Costa Rica,North America
192616,Ulisses Garcia,SUI,Marseille,Ligue 1,2024,28.0,1996.0,4.4,9,7,4,4,1,3,10,30.0,7,3,0,3,2,11,8,0,DF,25-29,Defender,Switzerland,Europe
811779,Alejandro Garnacho,ARG,Manchester Utd,Premier League,2024,20.0,2004.0,10.9,13,10,4,4,5,3,13,23.1,10,8,0,8,6,19,8,1,"FW,MF",20-24,Forward,Argentina,South America
509022,Federico Gatti,ITA,Juventus,Serie A,2024,26.0,1998.0,13.5,13,10,11,2,0,8,12,66.7,4,14,11,3,8,21,32,1,DF,25-29,Defender,Italy,Europe
463613,Yann Gboho,FRA,Toulouse,Ligue 1,2024,23.0,2001.0,13.3,18,6,5,8,5,9,17,52.9,8,10,0,10,3,21,3,0,"MF,FW",20-24,Midfielder,France,Europe
420210,Lutsharel Geertruida,NED,RB Leipzig,Bundesliga,2024,24.0,2000.0,10.2,21,13,14,7,0,9,21,42.9,12,7,1,6,12,33,32,3,DF,20-24,Defender,Netherlands,Europe
251309,Dennis Geiger,GER,Hoffenheim,Bundesliga,2024,26.0,1998.0,2.6,10,7,2,7,1,3,6,50.0,3,5,0,5,1,11,2,0,MF,25-29,Midfielder,Germany,Europe
119277,Yannick Gerhardt,GER,Wolfsburg,Bundesliga,2024,30.0,1994.0,5.2,10,6,6,4,0,4,8,50.0,4,11,1,10,7,17,15,0,"MF,DF",30-34,Midfielder,Germany,Europe
701819,Daniele Ghilardi,ITA,Hellas Verona,Serie A,2024,21.0,2003.0,7.1,12,7,7,5,0,7,16,43.8,9,9,6,3,7,19,36,0,DF,20-24,Defender,Italy,Europe
429014,Morgan Gibbs-White,ENG,Nott'ham Forest,Premier League,2024,24.0,2000.0,11.2,23,8,10,10,3,7,11,63.6,4,4,2,2,8,31,11,0,MF,20-24,Midfielder,England,Europe
276896,Samuel Gigot,FRA,Lazio,Serie A,2024,31.0,1993.0,0.9,0,0,0,0,0,0,1,0.0,1,2,1,1,1,1,3,0,DF,30-34,Defender,France,Europe
651269,Armin Gigovic,BIH,Holstein Kiel,Bundesliga,2024,22.0,2002.0,9.2,11,7,6,4,1,2,14,14.3,12,9,0,9,12,23,16,0,MF,20-24,Midfielder,Bosnia and Herzegovina,Europe
798929,Gvidas Gineitis,LTU,Torino,Serie A,2024,20.0,2004.0,6.8,11,5,5,4,2,5,13,38.5,8,7,2,5,5,16,15,0,MF,20-24,Midfielder,Lithuania,Europe
670882,Jamie Gittens,ENG,Dortmund,Bundesliga,2024,20.0,2004.0,10.7,19,10,7,8,4,9,13,69.2,4,8,0,8,6,25,3,0,"FW,MF",20-24,Forward,England,Europe
159471,Serge Gnabry,GER,Bayern Munich,Bundesliga,2024,29.0,1995.0,5.5,7,5,3,1,3,3,7,42.9,4,4,0,4,4,11,3,0,"FW,MF",25-29,Forward,Germany,Europe
242940,Edoardo Goldaniga,ITA,Como,Serie A,2024,31.0,1993.0,10.5,15,9,11,2,2,7,8,87.5,1,9,4,5,12,27,36,0,DF,30-34,Defender,Italy,Europe
263918,Aleksandr Golovin,RUS,Monaco,Ligue 1,2024,28.0,1996.0,10.8,33,22,8,18,7,16,31,51.6,15,14,4,10,9,42,6,0,"MF,FW",25-29,Midfielder,Russia,Europe
392770,Angel Gomes,ENG,Lille,Ligue 1,2024,24.0,2000.0,6.8,7,4,3,2,2,1,7,14.3,6,0,0,0,0,7,2,0,MF,20-24,Midfielder,England,Europe
735570,Joo Gomes,BRA,Wolves,Premier League,2024,23.0,2001.0,15.1,52,26,29,22,1,14,45,31.1,31,14,1,13,12,64,13,0,MF,20-24,Midfielder,Brazil,South America
667121,Rodrigo Gomes,POR,Wolves,Premier League,2024,21.0,2003.0,3.9,10,5,7,3,0,3,9,33.3,6,5,1,4,3,13,8,1,"DF,FW",20-24,Defender,Portugal,Europe
503733,Anthony Gordon,ENG,Newcastle Utd,Premier League,2024,23.0,2001.0,14.1,18,9,7,9,2,6,17,35.3,11,19,1,18,5,23,3,1,FW,20-24,Forward,England,Europe
153084,Leon Goretzka,GER,Bayern Munich,Bundesliga,2024,29.0,1995.0,5.2,8,5,2,6,0,3,8,37.5,5,10,1,9,5,13,6,0,"MF,DF",25-29,Midfielder,Germany,Europe
418659,Amine Gouiri,ALG,Rennes,Ligue 1,2024,24.0,2000.0,9.5,8,5,4,3,1,2,7,28.6,5,7,0,7,1,9,2,0,"MF,FW",20-24,Midfielder,Algeria,Africa
126557,Jonathan Gradit,FRA,Lens,Ligue 1,2024,32.0,1992.0,8.3,18,9,10,7,1,10,19,52.6,9,9,4,5,12,30,26,0,DF,30-34,Defender,France,Europe
197473,Alberto Grassi,ITA,Empoli,Serie A,2024,29.0,1995.0,6.9,16,7,5,9,2,5,6,83.3,1,5,3,2,8,24,12,1,MF,25-29,Midfielder,Italy,Europe
478573,Ryan Gravenberch,NED,Liverpool,Premier League,2024,22.0,2002.0,15.7,31,18,11,14,6,17,28,60.7,11,20,5,15,33,64,17,0,MF,20-24,Midfielder,Netherlands,Europe
922693,Archie Gray,ENG,Tottenham,Premier League,2024,18.0,2006.0,3.7,7,2,1,3,3,2,6,33.3,4,8,4,4,4,11,7,2,"DF,MF",Under 20,Defender,England,Europe
203460,Jack Grealish,ENG,Manchester City,Premier League,2024,29.0,1995.0,6.4,9,5,4,2,3,2,4,50.0,2,9,2,7,2,11,4,1,"FW,MF",25-29,Forward,England,Europe
693095,Jacob Greaves,ENG,Ipswich Town,Premier League,2024,24.0,2000.0,8.0,17,7,7,9,1,7,12,58.3,5,9,7,2,9,26,48,1,DF,20-24,Defender,England,Europe
125781,Antoine Griezmann,FRA,Atltico Madrid,La Liga,2024,33.0,1991.0,14.8,16,11,9,5,2,5,17,29.4,12,11,0,11,5,21,13,1,"FW,MF",30-34,Forward,France,Europe
185077,Vincenzo Grifo,ITA,Freiburg,Bundesliga,2024,31.0,1993.0,12.3,8,7,3,4,1,2,16,12.5,14,9,1,8,2,10,8,0,"FW,MF",30-34,Forward,Italy,Europe
195736,Florian Grillitsch,AUT,Hoffenheim,Bundesliga,2024,29.0,1995.0,6.7,15,9,5,9,1,8,14,57.1,6,6,2,4,8,23,18,0,MF,25-29,Midfielder,Austria,Europe
503866,Albert Grnbaek,DEN,Rennes,Ligue 1,2024,23.0,2001.0,8.3,21,11,10,7,4,10,26,38.5,16,7,0,7,4,25,6,0,"MF,FW",20-24,Midfielder,Denmark,Europe
362108,Gabriel Gudmundsson,SWE,Lille,Ligue 1,2024,25.0,1999.0,10.9,20,14,6,10,4,14,24,58.3,10,14,4,10,7,27,20,2,DF,25-29,Defender,Sweden,Europe
225122,Gonalo Guedes,POR,Wolves,Premier League,2024,28.0,1996.0,3.8,11,3,1,3,7,2,8,25.0,6,7,0,7,2,13,2,0,"FW,MF",25-29,Forward,Portugal,Europe
500689,Evann Guessand,CIV,Nice,Ligue 1,2024,23.0,2001.0,14.4,18,9,2,9,7,0,2,0.0,2,10,1,9,6,24,9,0,"FW,MF",20-24,Forward,Ivory Coast,Africa
485963,Pape Gueye,SEN,Villarreal,La Liga,2024,25.0,1999.0,11.8,28,15,13,11,4,11,13,84.6,2,9,2,7,12,40,24,0,"MF,FW",25-29,Midfielder,Senegal,Africa
691786,Morgan Guilavogui,GUI,St. Pauli,Bundesliga,2024,26.0,1998.0,9.9,21,12,7,12,2,10,19,52.6,9,15,0,15,7,28,20,0,"FW,MF",25-29,Forward,Guinea,Africa
520624,Bruno Guimares,BRA,Newcastle Utd,Premier League,2024,27.0,1997.0,16.4,37,21,18,14,5,16,29,55.2,13,15,5,10,15,52,14,2,MF,25-29,Midfielder,Brazil,South America
270541,Serhou Guirassy,GUI,Dortmund,Bundesliga,2024,28.0,1996.0,11.8,3,2,1,0,2,0,1,0.0,1,6,3,3,2,5,16,0,FW,25-29,Forward,Guinea,Africa
861410,Arda Gler,TUR,Real Madrid,La Liga,2024,19.0,2005.0,6.4,15,6,6,2,7,6,13,46.2,7,9,0,9,3,18,6,0,"MF,FW",Under 20,Midfielder,Turkey,Asia
93707,Christian Gnter,GER,Freiburg,Bundesliga,2024,31.0,1993.0,14.3,12,10,8,4,0,8,17,47.1,9,13,7,6,7,19,27,0,DF,30-34,Defender,Germany,Europe
241076,Emmanuel Gyasi,GHA,Empoli,Serie A,2024,30.0,1994.0,16.8,27,14,17,8,2,13,21,61.9,8,14,5,9,4,31,46,0,"DF,FW",30-34,Defender,Ghana,Africa
177779,Janik Haberer,GER,Union Berlin,Bundesliga,2024,30.0,1994.0,5.3,10,6,4,5,1,10,18,55.6,8,2,0,2,1,11,8,0,"DF,MF",30-34,Defender,Germany,Europe
223725,Munir El Haddadi,MAR,Legans,La Liga,2024,29.0,1995.0,4.8,11,8,5,4,2,3,9,33.3,6,6,1,5,0,11,1,0,"MF,FW",25-29,Midfielder,Morocco,Africa
917375,Antoine Hainaut,FRA,Parma,Serie A,2024,22.0,2002.0,6.6,12,9,7,4,1,6,7,85.7,1,8,2,6,5,17,31,0,DF,20-24,Defender,France,Europe
398073,Achraf Hakimi,MAR,Paris S-G,Ligue 1,2024,26.0,1998.0,13.4,32,25,14,11,7,20,32,62.5,12,13,0,13,19,51,9,2,DF,25-29,Defender,Morocco,Africa
372711,Amine Harit,MAR,Marseille,Ligue 1,2024,27.0,1997.0,5.2,7,6,0,5,2,1,2,50.0,1,6,0,6,3,10,1,1,MF,25-29,Midfielder,Morocco,Africa
606119,Phil Harres,GER,Holstein Kiel,Bundesliga,2024,22.0,2002.0,6.4,3,3,0,2,1,2,2,100.0,0,7,3,4,2,5,5,0,FW,20-24,Forward,Germany,Europe
417346,Jack Harrison,ENG,Everton,Premier League,2024,28.0,1996.0,8.9,16,11,8,3,5,9,19,47.4,10,4,0,4,5,21,16,2,FW,25-29,Forward,England,Europe
416386,Abdou Harroui,NED,Hellas Verona,Serie A,2024,26.0,1998.0,5.1,9,6,6,3,0,4,4,100.0,0,5,0,5,2,11,5,0,"MF,FW",25-29,Midfielder,Netherlands,Europe
503977,Taylor Harwood-Bellis,ENG,Southampton,Premier League,2024,22.0,2002.0,14.6,11,7,6,4,1,8,12,66.7,4,36,23,13,16,27,63,3,DF,20-24,Defender,England,Europe
309400,Kai Havertz,GER,Arsenal,Premier League,2024,25.0,1999.0,15.4,12,8,2,6,4,3,10,30.0,7,16,3,13,6,18,28,1,"FW,MF",25-29,Forward,Germany,Europe
576314,Jan Paul van Hecke,NED,Brighton,Premier League,2024,24.0,2000.0,13.9,20,13,12,8,0,12,20,60.0,8,18,11,7,9,29,51,2,DF,20-24,Defender,Netherlands,Europe
202591,Benjamin Henrichs,GER,RB Leipzig,Bundesliga,2024,27.0,1997.0,10.4,32,16,18,10,4,14,27,51.9,13,22,3,19,15,47,33,0,DF,25-29,Defender,Germany,Europe
339808,Theo Hernndez,FRA,Milan,Serie A,2024,27.0,1997.0,11.0,14,10,13,0,1,7,13,53.8,6,9,5,4,12,26,29,2,DF,25-29,Defender,France,Europe
181768,Hernani,BRA,Parma,Serie A,2024,30.0,1994.0,6.4,16,10,7,7,2,8,19,42.1,11,10,2,8,4,20,2,1,MF,30-34,Midfielder,Brazil,South America
378293,Yangel Herrera,VEN,Girona,La Liga,2024,26.0,1998.0,9.0,28,17,12,14,2,13,23,56.5,10,7,1,6,12,40,17,0,MF,25-29,Midfielder,Venezuela,South America
503075,Isak Hien,SWE,Atalanta,Serie A,2024,25.0,1999.0,11.5,25,15,14,11,0,12,19,63.2,7,14,8,6,15,40,37,1,DF,25-29,Defender,Sweden,Europe
659813,Piero Hincapi,ECU,Leverkusen,Bundesliga,2024,22.0,2002.0,13.6,22,18,10,8,4,13,21,61.9,8,18,9,9,18,40,36,1,DF,20-24,Defender,Ecuador,South America
867688,Jack Hinshelwood,ENG,Brighton,Premier League,2024,19.0,2005.0,9.3,12,9,4,6,2,5,11,45.5,6,4,2,2,4,16,14,1,"MF,DF",Under 20,Midfielder,England,Europe
485583,Ki-Jana Hoever,NED,Auxerre,Ligue 1,2024,22.0,2002.0,10.5,22,16,14,6,2,13,22,59.1,9,16,1,15,11,33,29,0,DF,20-24,Defender,Netherlands,Europe
227085,Jonas Hofmann,GER,Leverkusen,Bundesliga,2024,32.0,1992.0,2.5,0,0,0,0,0,0,1,0.0,1,2,0,2,0,0,2,0,"MF,DF",30-34,Midfielder,Germany,Europe
119037,Philipp Hofmann,GER,Bochum,Bundesliga,2024,31.0,1993.0,11.5,10,8,3,3,4,4,7,57.1,3,5,0,5,1,11,17,0,FW,30-34,Forward,Germany,Europe
248999,Lucas Hler,GER,Freiburg,Bundesliga,2024,30.0,1994.0,6.3,14,8,6,7,1,3,13,23.1,10,10,3,7,1,15,11,0,"MF,FW",30-34,Midfielder,Germany,Europe
453870,Benedict Hollerbach,GER,Union Berlin,Bundesliga,2024,23.0,2001.0,12.4,19,12,5,9,5,10,19,52.6,9,15,0,15,1,20,4,0,"MF,FW",20-24,Midfielder,Germany,Europe
190289,Gerrit Holtmann,PHI,Bochum,Bundesliga,2024,29.0,1995.0,3.8,7,6,4,2,1,4,9,44.4,5,5,0,5,7,14,5,0,"DF,FW",25-29,Defender,Philippines,Asia
229006,Franck Honorat,FRA,Gladbach,Bundesliga,2024,28.0,1996.0,10.9,9,2,4,2,3,1,4,25.0,3,7,1,6,4,13,21,1,FW,25-29,Forward,France,Europe
392768,Callum Hudson-Odoi,ENG,Nott'ham Forest,Premier League,2024,24.0,2000.0,13.7,13,8,4,6,3,6,9,66.7,3,4,0,4,9,22,4,1,"FW,MF",20-24,Forward,England,Europe
207014,Will Hughes,ENG,Crystal Palace,Premier League,2024,29.0,1995.0,10.6,38,19,12,17,9,14,35,40.0,21,11,5,6,6,44,7,0,MF,25-29,Midfielder,England,Europe
741238,Omari Hutchinson,ENG,Ipswich Town,Premier League,2024,21.0,2003.0,15.1,18,8,8,7,3,9,28,32.1,19,14,1,13,6,24,7,1,"MF,FW",20-24,Midfielder,England,Europe
846310,Oscar Hjlund,DEN,Eint Frankfurt,Bundesliga,2024,19.0,2005.0,1.6,5,3,3,1,1,0,1,0.0,1,3,2,1,1,6,1,0,MF,Under 20,Midfielder,Denmark,Europe
743387,Stanis Idumbo,BEL,Sevilla,La Liga,2024,19.0,2005.0,2.2,8,5,3,3,2,2,4,50.0,2,3,1,2,4,12,1,0,"FW,MF",Under 20,Forward,Belgium,Europe
546926,Jay Idzes,IDN,Venezia,Serie A,2024,24.0,2000.0,14.7,22,15,14,6,2,7,13,53.8,6,23,11,12,11,33,51,0,DF,20-24,Defender,Indonesia,Asia
1004834,George Ilenikhena,FRA,Monaco,Ligue 1,2024,18.0,2006.0,6.1,1,1,0,1,0,0,1,0.0,1,0,0,0,1,2,0,0,FW,Under 20,Forward,France,Europe
581672,Samuel Iling-Junior,ENG,Bologna,Serie A,2024,21.0,2003.0,1.2,3,2,1,1,1,0,1,0.0,1,0,0,0,2,5,1,0,"FW,MF",20-24,Forward,England,Europe
134294,Danny Ings,ENG,West Ham,Premier League,2024,32.0,1992.0,2.0,2,1,2,0,0,1,2,50.0,1,0,0,0,1,3,2,0,FW,30-34,Forward,England,Europe
192557,Jackson Irvine,AUS,St. Pauli,Bundesliga,2024,31.0,1993.0,15.0,32,15,13,16,3,11,24,45.8,13,13,2,11,25,57,40,0,MF,30-34,Midfielder,Australia,Oceania
349066,Alexander Isak,SWE,Newcastle Utd,Premier League,2024,25.0,1999.0,13.3,5,3,0,2,3,3,7,42.9,4,10,1,9,1,6,5,1,FW,25-29,Forward,Sweden,Europe
462823,Gustav Isaksen,DEN,Lazio,Serie A,2024,23.0,2001.0,10.5,8,3,4,4,0,3,13,23.1,10,4,0,4,5,13,6,0,FW,20-24,Forward,Denmark,Europe
355816,Ko Itakura,JPN,Gladbach,Bundesliga,2024,27.0,1997.0,15.0,21,14,11,9,1,12,18,66.7,6,20,10,10,13,34,78,0,DF,25-29,Defender,Japan,Asia
348791,Junya Ito,JPN,Reims,Ligue 1,2024,31.0,1993.0,14.6,20,15,6,9,5,6,29,20.7,23,18,0,18,6,26,3,1,FW,30-34,Forward,Japan,Asia
242631,Alex Iwobi,NGA,Fulham,Premier League,2024,28.0,1996.0,16.4,22,13,9,10,3,9,15,60.0,6,12,1,11,6,28,20,0,"FW,MF",25-29,Forward,Nigeria,Africa
32113,Armando Izzo,ITA,Monza,Serie A,2024,32.0,1992.0,13.4,23,11,16,7,0,10,22,45.5,12,21,15,6,23,46,37,0,DF,30-34,Defender,Italy,Europe
776890,Nicolas Jackson,SEN,Chelsea,Premier League,2024,23.0,2001.0,14.0,11,7,2,4,5,1,5,20.0,4,8,1,7,2,13,12,0,FW,20-24,Forward,Senegal,Africa
667517,Jordan James,WAL,Rennes,Ligue 1,2024,20.0,2004.0,3.4,6,3,3,2,1,5,7,71.4,2,4,0,4,4,10,4,0,MF,20-24,Midfielder,Wales,Europe
270171,Vitaly Janelt,GER,Brentford,Premier League,2024,26.0,1998.0,13.6,17,10,7,6,4,9,18,50.0,9,19,4,15,13,30,32,1,MF,25-29,Midfielder,Germany,Europe
177847,Adnan Januzaj,BEL,Las Palmas,La Liga,2024,29.0,1995.0,3.3,4,2,1,3,0,2,3,66.7,1,3,0,3,0,4,2,0,"MF,FW",25-29,Midfielder,Belgium,Europe
460245,Moritz Jenz,GER,Mainz 05,Bundesliga,2024,25.0,1999.0,7.1,14,6,6,8,0,5,8,62.5,3,10,7,3,9,23,52,0,DF,25-29,Defender,Germany,Europe
363205,Gabriel Jesus,BRA,Arsenal,Premier League,2024,27.0,1997.0,4.0,6,5,4,2,0,3,5,60.0,2,7,1,6,4,10,5,0,FW,25-29,Forward,Brazil,South America
876440,Joo Pedro,BRA,Brighton,Premier League,2024,23.0,2001.0,8.5,7,4,1,4,2,1,4,25.0,3,5,0,5,5,12,6,0,"MF,FW",20-24,Midfielder,Brazil,South America
333241,Joelinton,BRA,Newcastle Utd,Premier League,2024,28.0,1996.0,14.7,33,19,13,13,7,13,24,54.2,11,22,3,19,12,45,26,1,"MF,FW",25-29,Midfielder,Brazil,South America
468002,Ben Johnson,ENG,Ipswich Town,Premier League,2024,24.0,2000.0,5.7,22,13,14,7,1,13,21,61.9,8,9,3,6,9,31,10,0,"DF,FW",20-24,Defender,England,Europe
470607,Brennan Johnson,WAL,Tottenham,Premier League,2024,23.0,2001.0,13.4,26,16,4,14,8,11,22,50.0,11,13,2,11,3,29,8,0,FW,20-24,Forward,Wales,Europe
806168,Paul Joly,FRA,Auxerre,Ligue 1,2024,24.0,2000.0,5.7,20,13,14,6,0,11,23,47.8,12,6,0,6,14,34,19,5,DF,20-24,Defender,France,Europe
433188,Curtis Jones,ENG,Liverpool,Premier League,2024,23.0,2001.0,7.3,14,7,2,10,2,5,10,50.0,5,8,4,4,2,16,5,0,MF,20-24,Midfielder,England,Europe
326330,Frenkie de Jong,NED,Barcelona,La Liga,2024,27.0,1997.0,2.6,1,1,0,1,0,0,1,0.0,1,3,0,3,1,2,0,0,MF,25-29,Midfielder,Netherlands,Europe
340950,Diogo Jota,POR,Liverpool,Premier League,2024,28.0,1996.0,5.9,4,2,0,3,1,3,8,37.5,5,2,0,2,3,7,4,0,FW,25-29,Forward,Portugal,Europe
1028162,Antoine Joujou,FRA,Le Havre,Ligue 1,2024,21.0,2003.0,3.9,6,5,4,1,1,2,4,50.0,2,8,2,6,3,9,3,0,"MF,FW",20-24,Midfielder,France,Europe
149928,Jubal,BRA,Auxerre,Ligue 1,2024,31.0,1993.0,12.4,27,19,24,3,0,13,22,59.1,9,29,14,15,9,36,71,1,DF,30-34,Defender,Brazil,South America
413220,James Justin,ENG,Leicester City,Premier League,2024,26.0,1998.0,15.5,35,21,19,12,4,19,33,57.6,14,23,6,17,24,59,66,1,DF,25-29,Defender,England,Europe
81512,Christian Kabasele,BEL,Udinese,Serie A,2024,33.0,1991.0,8.2,9,5,5,4,0,4,5,80.0,1,8,2,6,8,17,37,1,DF,30-34,Defender,Belgium,Europe
384060,Tino Kadewere,ZIM,Nantes,Ligue 1,2024,28.0,1996.0,5.3,13,7,4,3,6,6,12,50.0,6,3,0,3,5,18,8,0,"MF,FW",25-29,Midfielder,Zimbabwe,Africa
585959,Arnaud Kalimuendo,FRA,Rennes,Ligue 1,2024,22.0,2002.0,12.1,6,4,2,2,2,2,3,66.7,1,4,1,3,1,7,2,0,FW,20-24,Forward,France,Europe
356141,Daichi Kamada,JPN,Crystal Palace,Premier League,2024,28.0,1996.0,7.9,22,11,7,13,2,6,21,28.6,15,9,2,7,8,30,8,0,MF,25-29,Midfielder,Japan,Asia
290017,Hassane Kamara,CIV,Udinese,Serie A,2024,30.0,1994.0,7.3,15,10,5,8,2,4,10,40.0,6,9,2,7,9,24,15,0,DF,30-34,Defender,Ivory Coast,Africa
132098,Harry Kane,ENG,Bayern Munich,Bundesliga,2024,31.0,1993.0,11.6,2,2,0,1,1,0,2,0.0,2,3,0,3,0,2,5,0,FW,30-34,Forward,England,Europe
324804,Yann Karamoh,FRA,Torino,Serie A,2024,26.0,1998.0,2.9,3,1,2,0,1,3,5,60.0,2,2,1,1,0,3,1,0,"FW,MF",25-29,Forward,France,Europe
367992,Jesper Karlsson,SWE,Bologna,Serie A,2024,26.0,1998.0,3.3,1,0,0,0,1,0,2,0.0,2,4,0,4,0,1,3,0,FW,25-29,Forward,Sweden,Europe
298635,Grigoris Kastanos,CYP,Hellas Verona,Serie A,2024,26.0,1998.0,5.9,12,6,3,4,5,5,11,45.5,6,12,2,10,5,17,3,0,"MF,FW",25-29,Midfielder,Cyprus,Asia
364135,Moise Kean,ITA,Fiorentina,Serie A,2024,24.0,2000.0,13.5,5,3,0,2,3,2,3,66.7,1,4,0,4,0,5,9,1,FW,20-24,Forward,Italy,Europe
667967,Yassine Kechta,MAR,Le Havre,Ligue 1,2024,22.0,2002.0,10.7,30,19,14,13,3,15,39,38.5,24,13,2,11,12,42,7,1,"MF,FW",20-24,Midfielder,Morocco,Africa
228948,Thilo Kehrer,GER,Monaco,Ligue 1,2024,28.0,1996.0,13.0,27,19,20,7,0,16,26,61.5,10,7,5,2,14,41,66,1,DF,25-29,Defender,Germany,Europe
342039,Yannik Keitel,GER,Stuttgart,Bundesliga,2024,24.0,2000.0,1.1,2,1,0,1,1,2,3,66.7,1,3,1,2,1,3,2,0,"MF,DF",20-24,Midfielder,Germany,Europe
692737,Aljoscha Kemlein,GER,Union Berlin,Bundesliga,2024,20.0,2004.0,6.9,7,2,3,3,1,4,12,33.3,8,9,1,8,4,11,8,0,MF,20-24,Midfielder,Germany,Europe
809498,Luca Kerber,GER,Heidenheim,Bundesliga,2024,22.0,2002.0,2.1,8,6,6,2,0,5,7,71.4,2,4,1,3,0,8,7,0,"MF,DF",20-24,Midfielder,Germany,Europe
654982,Bilal El Khannouss,MAR,Leicester City,Premier League,2024,20.0,2004.0,6.3,16,6,5,8,3,4,7,57.1,3,6,0,6,3,19,2,0,"MF,FW",20-24,Midfielder,Morocco,Africa
103565,Wahbi Khazri,TUN,Montpellier,Ligue 1,2024,33.0,1991.0,7.2,15,10,4,8,3,4,10,40.0,6,5,1,4,4,19,4,0,"FW,MF",30-34,Forward,Tunisia,Africa
763079,Abdukodir Khusanov,UZB,Lens,Ligue 1,2024,20.0,2004.0,10.8,15,11,9,5,1,7,11,63.6,4,17,11,6,26,41,57,0,DF,20-24,Defender,Uzbekistan,Asia
161056,Joshua Kimmich,GER,Bayern Munich,Bundesliga,2024,29.0,1995.0,15.0,25,17,6,15,4,17,25,68.0,8,7,0,7,10,35,14,2,"MF,DF",25-29,Midfielder,Germany,Europe
364827,Cdric Kipr,CIV,Reims,Ligue 1,2024,28.0,1996.0,9.8,22,15,17,5,0,17,22,77.3,5,15,7,8,15,37,57,1,DF,25-29,Defender,Ivory Coast,Africa
193033,Tim Kleindienst,GER,Gladbach,Bundesliga,2024,29.0,1995.0,14.7,14,7,1,7,6,5,20,25.0,15,20,2,18,7,21,26,0,FW,25-29,Forward,Germany,Europe
330659,Justin Kluivert,NED,Bournemouth,Premier League,2024,25.0,1999.0,11.7,13,8,3,6,4,3,8,37.5,5,13,0,13,8,21,13,1,"MF,FW",25-29,Midfielder,Netherlands,Europe
429874,Ansgar Knauff,GER,Eint Frankfurt,Bundesliga,2024,22.0,2002.0,7.6,24,13,12,7,5,5,7,71.4,2,12,1,11,7,31,11,0,"MF,DF",20-24,Midfielder,Germany,Europe
391780,Derrick Khn,GER,Werder Bremen,Bundesliga,2024,25.0,1999.0,8.8,9,6,3,4,2,4,6,66.7,2,15,4,11,5,14,16,0,DF,25-29,Defender,Germany,Europe
118847,Dominik Kohr,GER,Mainz 05,Bundesliga,2024,30.0,1994.0,13.8,31,24,18,10,3,16,27,59.3,11,23,12,11,24,55,72,0,DF,30-34,Defender,Germany,Europe
487969,Randal Kolo Muani,FRA,Paris S-G,Ligue 1,2024,26.0,1998.0,4.0,4,4,1,1,2,0,2,0.0,2,1,0,1,0,4,5,0,FW,25-29,Forward,France,Europe
357119,Ibrahima Konat,FRA,Liverpool,Premier League,2024,25.0,1999.0,10.8,14,10,10,3,1,9,12,75.0,3,13,5,8,4,18,44,1,DF,25-29,Defender,France,Europe
1178474,Amadou Kon,MLI,Reims,Ligue 1,2024,19.0,2005.0,5.2,21,14,12,9,0,10,13,76.9,3,9,2,7,6,27,7,0,MF,Under 20,Midfielder,Mali,Africa
413403,Ezri Konsa,ENG,Aston Villa,Premier League,2024,27.0,1997.0,14.1,19,11,11,4,4,11,13,84.6,2,6,3,3,11,30,45,0,DF,25-29,Defender,England,Europe
360518,Teun Koopmeiners,NED,Juventus,Serie A,2024,26.0,1998.0,10.4,15,10,3,10,2,5,16,31.3,11,11,5,6,5,20,9,0,"MF,FW",25-29,Midfielder,Netherlands,Europe
644771,Odilon Kossounou,CIV,Atalanta,Serie A,2024,23.0,2001.0,7.0,10,6,7,3,0,4,7,57.1,3,10,2,8,7,17,11,0,DF,20-24,Defender,Ivory Coast,Africa
337725,Christian Kouam,CIV,Fiorentina,Serie A,2024,27.0,1997.0,6.5,12,7,4,3,5,0,3,0.0,3,2,0,2,2,14,9,0,"FW,MF",25-29,Forward,Ivory Coast,Africa
669380,Konstantinos Koulierakis,GRE,Wolfsburg,Bundesliga,2024,21.0,2003.0,11.3,19,9,11,6,2,9,16,56.3,7,20,9,11,13,32,61,0,DF,20-24,Defender,Greece,Europe
411975,Jules Kound,FRA,Barcelona,La Liga,2024,26.0,1998.0,16.9,42,30,17,19,6,33,45,73.3,12,22,3,19,9,51,39,2,DF,25-29,Defender,France,Europe
434433,Nikola Krstovi,MNE,Lecce,Serie A,2024,24.0,2000.0,15.6,13,6,4,4,5,5,11,45.5,6,8,5,3,5,18,10,0,FW,20-24,Forward,Montenegro,Europe
93604,Lukas Kbler,GER,Freiburg,Bundesliga,2024,32.0,1992.0,12.7,24,11,11,11,2,17,26,65.4,9,24,10,14,31,55,32,3,DF,30-34,Defender,Germany,Europe
405398,Takefusa Kubo,JPN,Real Sociedad,La Liga,2024,23.0,2001.0,13.2,20,13,7,7,6,12,23,52.2,11,26,1,25,8,28,5,1,"MF,FW",20-24,Midfielder,Japan,Asia
543499,Mohammed Kudus,GHA,West Ham,Premier League,2024,24.0,2000.0,11.0,18,13,5,9,4,5,14,35.7,9,14,1,13,1,19,1,0,"MF,FW",20-24,Midfielder,Ghana,Africa
431755,Dejan Kulusevski,SWE,Tottenham,Premier League,2024,24.0,2000.0,14.7,19,11,6,5,8,7,22,31.8,15,17,3,14,8,27,8,0,"MF,FW",20-24,Midfielder,Sweden,Europe
279570,Daler Kuzyaev,RUS,Le Havre,Ligue 1,2024,31.0,1993.0,5.7,12,7,6,4,2,2,9,22.2,7,7,4,3,9,21,7,0,MF,30-34,Midfielder,Russia,Europe
502670,Khvicha Kvaratskhelia,GEO,Napoli,Serie A,2024,23.0,2001.0,12.3,14,8,4,9,1,4,14,28.6,10,12,0,12,2,16,7,0,"FW,MF",20-24,Forward,Georgia,Asia
316575,Moritz-Broni Kwarteng,GHA,Bochum,Bundesliga,2024,26.0,1998.0,1.9,4,3,1,1,2,1,2,50.0,1,0,0,0,0,4,1,0,"MF,FW",25-29,Midfielder,Ghana,Africa
181378,Gatan Laborde,FRA,Nice,Ligue 1,2024,30.0,1994.0,4.3,6,4,4,2,0,4,10,40.0,6,5,0,5,2,8,3,0,FW,30-34,Forward,France,Europe
93720,Alexandre Lacazette,FRA,Lyon,Ligue 1,2024,33.0,1991.0,10.5,5,2,1,3,1,3,10,30.0,7,5,0,5,3,8,1,0,FW,30-34,Forward,France,Europe
223967,Konrad Laimer,AUT,Bayern Munich,Bundesliga,2024,27.0,1997.0,5.4,18,10,5,10,3,6,18,33.3,12,6,0,6,1,19,8,0,DF,25-29,Defender,Austria,Europe
174196,Kenny Lala,MAD,Brest,Ligue 1,2024,33.0,1991.0,11.8,33,21,19,10,4,23,36,63.9,13,18,8,10,11,44,26,0,DF,30-34,Defender,Madagascar,Africa
504148,Tariq Lamptey,GHA,Brighton,Premier League,2024,24.0,2000.0,2.9,4,4,2,2,0,2,7,28.6,5,7,1,6,4,8,9,0,DF,20-24,Defender,Ghana,Africa
343463,Cyle Larin,CAN,Mallorca,La Liga,2024,29.0,1995.0,10.9,5,2,1,2,2,0,3,0.0,3,7,1,6,1,6,4,0,FW,25-29,Forward,Canada,North America
931838,Hugo Larsson,SWE,Eint Frankfurt,Bundesliga,2024,20.0,2004.0,10.8,16,8,8,5,3,11,25,44.0,14,17,6,11,14,30,16,1,MF,20-24,Midfielder,Sweden,Europe
186368,Valentino Lazaro,AUT,Torino,Serie A,2024,28.0,1996.0,11.9,17,7,9,6,2,10,14,71.4,4,11,3,8,3,20,17,1,DF,25-29,Defender,Austria,Europe
794349,Julien Le Cardinal,FRA,Brest,Ligue 1,2024,27.0,1997.0,8.8,14,9,8,6,0,6,10,60.0,4,11,8,3,24,38,39,0,DF,25-29,Defender,France,Europe
737781,Jrmy Le Douaron,FRA,Brest,Ligue 1,2024,26.0,1998.0,1.1,1,0,0,0,1,0,1,0.0,1,1,0,1,0,1,0,0,FW,25-29,Forward,France,Europe
633992,Enzo Le Fe,FRA,Roma,Serie A,2024,24.0,2000.0,3.5,7,4,5,2,0,2,6,33.3,4,9,3,6,5,12,2,0,MF,20-24,Midfielder,France,Europe
357164,Rafael Leo,POR,Milan,Serie A,2024,25.0,1999.0,11.5,7,6,1,4,2,5,10,50.0,5,8,0,8,4,11,0,0,FW,25-29,Forward,Portugal,Europe
377393,Pierre Lees-Melou,FRA,Brest,Ligue 1,2024,31.0,1993.0,3.9,11,7,3,5,3,7,10,70.0,3,4,2,2,4,15,2,0,MF,30-34,Midfielder,France,Europe
357156,Diogo Leite,POR,Union Berlin,Bundesliga,2024,25.0,1999.0,13.1,41,22,24,14,3,19,30,63.3,11,30,9,21,29,70,56,1,DF,25-29,Defender,Portugal,Europe
127108,Florian Lejeune,FRA,Rayo Vallecano,La Liga,2024,33.0,1991.0,17.9,26,17,15,9,2,10,18,55.6,8,21,16,5,13,39,83,0,DF,30-34,Defender,France,Europe
182904,Clment Lenglet,FRA,Atltico Madrid,La Liga,2024,29.0,1995.0,8.3,8,4,7,1,0,2,3,66.7,1,9,6,3,11,19,41,0,DF,25-29,Defender,France,Europe
585973,Johann Lepenant,FRA,Nantes,Ligue 1,2024,22.0,2002.0,9.7,27,14,10,11,6,9,25,36.0,16,10,2,8,10,37,8,0,MF,20-24,Midfielder,France,Europe
262980,Jefferson Lerma,COL,Crystal Palace,Premier League,2024,30.0,1994.0,9.2,10,3,4,5,1,6,12,50.0,6,16,10,6,15,25,18,0,MF,30-34,Midfielder,Colombia,South America
518505,Jamie Leweling,GER,Stuttgart,Bundesliga,2024,23.0,2001.0,7.3,5,2,2,0,3,3,9,33.3,6,10,0,10,4,9,7,0,"FW,MF",20-24,Forward,Germany,Europe
644401,Keane Lewis-Potter,ENG,Brentford,Premier League,2024,23.0,2001.0,14.3,21,10,8,9,4,11,17,64.7,6,10,4,6,7,28,26,1,"DF,FW",20-24,Defender,England,Europe
225657,Philipp Lienhart,AUT,Freiburg,Bundesliga,2024,28.0,1996.0,14.2,11,9,7,4,0,8,17,47.1,9,16,9,7,21,32,44,2,DF,25-29,Defender,Austria,Europe
513245,Jesper Lindstrm,DEN,Everton,Premier League,2024,24.0,2000.0,6.0,20,10,9,11,0,11,30,36.7,19,9,3,6,3,23,6,0,FW,20-24,Forward,Denmark,Europe
694928,Samuel Lino,BRA,Atltico Madrid,La Liga,2024,25.0,1999.0,7.9,9,3,6,2,1,6,21,28.6,15,12,1,11,4,13,4,0,"MF,DF",25-29,Midfielder,Brazil,South America
249636,Gautier Lloris,FRA,Le Havre,Ligue 1,2024,29.0,1995.0,15.0,36,24,25,11,0,20,31,64.5,11,13,5,8,7,43,77,0,DF,25-29,Defender,France,Europe
348795,Giovani Lo Celso,ARG,Betis,La Liga,2024,28.0,1996.0,9.7,24,13,5,12,7,13,17,76.5,4,8,1,7,4,28,3,1,MF,25-29,Midfielder,Argentina,South America
202886,Ruben Loftus-Cheek,ENG,Milan,Serie A,2024,28.0,1996.0,7.6,14,6,3,7,4,4,7,57.1,3,1,0,1,2,16,9,0,MF,25-29,Midfielder,England,Europe
346707,Sean Longstaff,ENG,Newcastle Utd,Premier League,2024,27.0,1997.0,7.9,27,16,10,9,8,18,26,69.2,8,13,2,11,5,32,4,0,MF,25-29,Midfielder,England,Europe
406040,Ademola Lookman,NGA,Atalanta,Serie A,2024,27.0,1997.0,10.4,17,7,8,7,2,7,12,58.3,5,11,0,11,1,18,1,1,"FW,MF",25-29,Forward,Nigeria,Africa
750904,Tom Louchet,FRA,Nice,Ligue 1,2024,21.0,2003.0,5.3,18,12,12,2,4,12,14,85.7,2,8,3,5,6,24,13,0,"DF,MF",20-24,Defender,France,Europe
572265,Lorenzo Lucca,ITA,Udinese,Serie A,2024,24.0,2000.0,12.3,8,5,2,2,4,4,7,57.1,3,6,0,6,2,10,16,0,FW,20-24,Forward,Italy,Europe
125020,Jos Luis Palomino,ARG,Cagliari,Serie A,2024,34.0,1990.0,3.2,5,4,0,3,2,2,3,66.7,1,4,4,0,6,11,8,0,DF,30-34,Defender,Argentina,South America
447661,Douglas Luiz,BRA,Juventus,Serie A,2024,26.0,1998.0,3.3,7,3,3,3,1,4,6,66.7,2,3,0,3,2,9,0,0,MF,25-29,Midfielder,Brazil,South America
96341,Romelu Lukaku,BEL,Napoli,Serie A,2024,31.0,1993.0,12.4,1,1,0,1,0,0,2,0.0,2,2,1,1,0,1,8,0,FW,30-34,Forward,Belgium,Europe
278531,Sebastiano Luperto,ITA,Cagliari,Serie A,2024,28.0,1996.0,17.0,27,14,18,8,1,8,13,61.5,5,11,7,4,16,43,76,1,DF,25-29,Defender,Italy,Europe
666547,Zito Luvumbo,ANG,Cagliari,Serie A,2024,22.0,2002.0,11.0,5,2,1,3,1,2,10,20.0,8,2,0,2,1,6,4,0,"FW,MF",20-24,Forward,Angola,Africa
338668,Senne Lynen,BEL,Werder Bremen,Bundesliga,2024,25.0,1999.0,13.6,35,18,16,15,4,23,30,76.7,7,25,7,18,26,61,29,5,MF,25-29,Midfielder,Belgium,Europe
485585,Ian Maatsen,NED,Aston Villa,Premier League,2024,22.0,2002.0,3.2,11,7,5,5,1,4,6,66.7,2,2,0,2,3,14,7,1,DF,20-24,Defender,Netherlands,Europe
534033,Alexis Mac Allister,ARG,Liverpool,Premier League,2024,26.0,1998.0,11.7,43,28,13,25,5,24,46,52.2,22,29,0,29,8,51,10,1,MF,25-29,Midfielder,Argentina,South America
332560,Deiver Machado,COL,Lens,Ligue 1,2024,31.0,1993.0,6.0,13,10,8,4,1,9,10,90.0,1,7,1,6,5,18,7,0,"DF,MF",30-34,Defender,Colombia,South America
550580,Shuto Machino,JPN,Holstein Kiel,Bundesliga,2024,25.0,1999.0,8.0,4,3,2,1,1,3,6,50.0,3,3,0,3,4,8,3,0,"FW,MF",25-29,Forward,Japan,Asia
294057,James Maddison,ENG,Tottenham,Premier League,2024,28.0,1996.0,12.0,18,11,5,9,4,8,21,38.1,13,8,3,5,10,28,15,0,MF,25-29,Midfielder,England,Europe
503987,Noni Madueke,ENG,Chelsea,Premier League,2024,22.0,2002.0,11.5,14,10,6,7,1,9,21,42.9,12,11,0,11,5,19,5,0,FW,20-24,Forward,England,Europe
435338,Gabriel Magalhes,BRA,Arsenal,Premier League,2024,27.0,1997.0,14.1,11,7,5,5,1,5,9,55.6,4,28,20,8,8,19,44,2,DF,25-29,Defender,Brazil,South America
745181,Soungoutou Magassa,FRA,Monaco,Ligue 1,2024,21.0,2003.0,7.3,26,14,6,18,2,15,27,55.6,12,6,1,5,13,39,12,1,MF,20-24,Midfielder,France,Europe
310458,Giangiacomo Magnani,ITA,Hellas Verona,Serie A,2024,29.0,1995.0,10.4,20,15,14,6,0,7,7,100.0,0,16,9,7,13,33,60,1,DF,25-29,Defender,Italy,Europe
474662,Hugo Magnetti,FRA,Brest,Ligue 1,2024,26.0,1998.0,11.3,20,12,7,12,1,8,19,42.1,11,9,3,6,7,27,11,0,MF,25-29,Midfielder,France,Europe
807689,Frank Magri,CMR,Toulouse,Ligue 1,2024,25.0,1999.0,3.9,1,0,0,0,1,1,4,25.0,3,8,0,8,1,2,4,0,"FW,MF",25-29,Forward,Cameroon,Africa
296397,Arne Maier,GER,Augsburg,Bundesliga,2024,25.0,1999.0,5.1,6,2,1,5,0,4,8,50.0,4,9,1,8,1,7,6,1,MF,25-29,Midfielder,Germany,Europe
133731,Patrick Mainka,GER,Heidenheim,Bundesliga,2024,30.0,1994.0,15.0,31,16,17,14,0,18,29,62.1,11,30,16,14,32,63,73,0,DF,30-34,Defender,Germany,Europe
820374,Kobbie Mainoo,ENG,Manchester Utd,Premier League,2024,19.0,2005.0,10.1,23,17,13,6,4,14,21,66.7,7,11,2,9,15,38,5,1,MF,Under 20,Midfielder,England,Europe
285845,Ainsley Maitland-Niles,ENG,Lyon,Ligue 1,2024,27.0,1997.0,11.4,36,21,15,12,9,24,35,68.6,11,17,2,15,15,51,26,4,"DF,MF",25-29,Defender,England,Europe
387106,Lovro Majer,CRO,Wolfsburg,Bundesliga,2024,26.0,1998.0,1.6,0,0,0,0,0,0,2,0.0,2,2,0,2,0,0,1,0,MF,25-29,Midfielder,Croatia,Europe
830108,Julin Malatini,ARG,Werder Bremen,Bundesliga,2024,23.0,2001.0,4.8,10,9,4,5,1,4,10,40.0,6,6,3,3,7,17,16,0,DF,20-24,Defender,Argentina,South America
539134,Daniel Maldini,ITA,Monza,Serie A,2024,23.0,2001.0,11.0,14,6,5,9,0,6,10,60.0,4,7,2,5,4,18,10,2,MF,20-24,Midfielder,Italy,Europe
324377,Youssef Maleh,MAR,Empoli,Serie A,2024,26.0,1998.0,9.7,16,8,6,8,2,5,15,33.3,10,18,5,13,7,23,13,0,MF,25-29,Midfielder,Morocco,Africa
326029,Donyell Malen,NED,Dortmund,Bundesliga,2024,25.0,1999.0,6.7,0,0,0,0,0,0,2,0.0,2,2,0,2,3,3,6,0,"FW,MF",25-29,Forward,Netherlands,Europe
207877,Ruslan Malinovskyi,UKR,Genoa,Serie A,2024,31.0,1993.0,2.5,8,6,2,5,1,2,3,66.7,1,1,0,1,1,9,3,0,"MF,FW",30-34,Midfielder,Ukraine,Europe
397486,Dennis Man,ROU,Parma,Serie A,2024,26.0,1998.0,14.9,6,3,3,1,2,4,15,26.7,11,8,2,6,8,14,8,0,"FW,MF",25-29,Forward,Romania,Europe
256448,Gianluca Mancini,ITA,Roma,Serie A,2024,28.0,1996.0,15.4,19,11,11,6,2,11,13,84.6,2,9,6,3,17,36,28,0,DF,25-29,Defender,Italy,Europe
80293,Assa Mandi,ALG,Lille,Ligue 1,2024,33.0,1991.0,9.5,16,9,4,10,2,9,13,69.2,4,13,8,5,6,22,21,0,DF,30-34,Defender,Algeria,Africa
308279,Rolando Mandragora,ITA,Fiorentina,Serie A,2024,27.0,1997.0,3.7,2,0,1,0,1,0,2,0.0,2,4,1,3,6,8,6,1,MF,25-29,Midfielder,Italy,Europe
250845,Jos Mara Gimnez,URU,Atltico Madrid,La Liga,2024,29.0,1995.0,13.9,17,12,12,5,0,12,19,63.2,7,18,12,6,16,33,64,1,DF,25-29,Defender,Uruguay,South America
814446,Luca Marianucci,ITA,Empoli,Serie A,2024,20.0,2004.0,0.5,2,1,2,0,0,1,3,33.3,2,0,0,0,0,2,3,0,"DF,MF",20-24,Defender,Italy,Europe
295183,Rzvan Marin,ROU,Cagliari,Serie A,2024,28.0,1996.0,10.2,14,8,5,8,1,8,16,50.0,8,4,0,4,2,16,15,2,MF,25-29,Midfielder,Romania,Europe
445939,Omar Marmoush,EGY,Eint Frankfurt,Bundesliga,2024,25.0,1999.0,14.1,11,7,0,3,8,3,7,42.9,4,7,1,6,2,13,2,0,"FW,MF",25-29,Forward,Egypt,Africa
127142,Jonas Martin,FRA,Brest,Ligue 1,2024,34.0,1990.0,5.1,11,5,8,2,1,5,10,50.0,5,3,0,3,6,17,11,1,MF,30-34,Midfielder,France,Europe
655488,Gabriel Martinelli,BRA,Arsenal,Premier League,2024,23.0,2001.0,10.5,12,10,2,4,6,5,14,35.7,9,4,0,4,1,13,10,0,"FW,MF",20-24,Forward,Brazil,South America
406625,Lautaro Martnez,ARG,Inter,Serie A,2024,27.0,1997.0,12.9,9,5,3,3,3,4,9,44.4,5,7,1,6,5,14,3,0,FW,25-29,Forward,Argentina,South America
480762,Lisandro Martnez,ARG,Manchester Utd,Premier League,2024,26.0,1998.0,13.8,29,17,18,8,3,15,26,57.7,11,16,5,11,26,55,39,1,DF,25-29,Defender,Argentina,South America
373373,Lucas Martnez Quarta,ARG,Fiorentina,Serie A,2024,28.0,1996.0,3.9,12,7,9,3,0,8,13,61.5,5,5,2,3,3,15,25,1,DF,25-29,Defender,Argentina,South America
142031,Omar Mascarell,EQG,Mallorca,La Liga,2024,31.0,1993.0,10.1,15,7,8,7,0,9,16,56.3,7,16,10,6,25,40,37,2,MF,30-34,Midfielder,Equatorial Guinea,Africa
286949,Adam Masina,MAR,Torino,Serie A,2024,30.0,1994.0,15.5,25,11,18,6,1,18,33,54.5,15,21,13,8,18,43,58,2,DF,30-34,Defender,Morocco,Africa
605268,Igor Matanovic,CRO,Eint Frankfurt,Bundesliga,2024,21.0,2003.0,3.2,1,0,0,1,0,0,1,0.0,1,2,0,2,1,2,7,0,"FW,MF",20-24,Forward,Croatia,Europe
568693,Pape Matar Sarr,SEN,Tottenham,Premier League,2024,22.0,2002.0,10.1,29,21,11,16,2,6,13,46.2,7,15,3,12,16,45,11,0,MF,20-24,Midfielder,Senegal,Africa
420002,Jean-Philippe Mateta,FRA,Crystal Palace,Premier League,2024,27.0,1997.0,13.9,7,6,2,4,1,0,6,0.0,6,7,1,6,1,8,13,0,FW,25-29,Forward,France,Europe
861981,Alan Matturro,URU,Genoa,Serie A,2024,20.0,2004.0,7.2,9,4,4,5,0,3,12,25.0,9,5,2,3,11,20,25,0,DF,20-24,Defender,Uruguay,South America
217115,Neal Maupay,FRA,Marseille,Ligue 1,2024,28.0,1996.0,6.7,7,3,1,5,1,3,3,100.0,0,4,0,4,0,7,0,0,FW,25-29,Forward,France,Europe
340328,Stephy Mavididi,ENG,Leicester City,Premier League,2024,26.0,1998.0,9.4,20,13,9,7,4,9,23,39.1,14,16,1,15,2,22,4,0,FW,25-29,Forward,England,Europe
415912,Konstantinos Mavropanos,GRE,West Ham,Premier League,2024,27.0,1997.0,11.1,21,15,16,4,1,11,15,73.3,4,16,12,4,20,41,50,1,DF,25-29,Defender,Greece,Europe
903693,Senny Mayulu,FRA,Paris S-G,Ligue 1,2024,18.0,2006.0,2.1,9,5,4,4,1,3,6,50.0,3,5,3,2,2,11,3,0,"MF,DF",Under 20,Midfielder,France,Europe
340456,Noussair Mazraoui,MAR,Manchester Utd,Premier League,2024,27.0,1997.0,13.9,55,32,29,17,9,32,49,65.3,17,19,4,15,14,69,41,0,DF,25-29,Defender,Morocco,Africa
226025,Luca Mazzitelli,ITA,Como,Serie A,2024,29.0,1995.0,3.7,9,6,4,5,0,5,7,71.4,2,5,2,3,3,12,10,0,MF,25-29,Midfielder,Italy,Europe
250153,Pasquale Mazzocchi,ITA,Napoli,Serie A,2024,29.0,1995.0,4.3,5,2,3,1,1,2,6,33.3,4,3,1,2,3,8,12,0,"DF,FW",25-29,Defender,Italy,Europe
654991,Samuel Mbangula,BEL,Juventus,Serie A,2024,20.0,2004.0,4.0,11,8,7,3,1,5,8,62.5,3,4,0,4,1,12,2,0,FW,20-24,Forward,Belgium,Europe
903666,Ethan Mbapp,FRA,Lille,Ligue 1,2024,17.0,2006.0,0.9,1,0,0,1,0,0,2,0.0,2,4,0,4,0,1,0,0,"MF,FW",Under 20,Midfielder,France,Europe
1185888,Ibrahim Mbaye,FRA,Paris S-G,Ligue 1,2024,16.0,2008.0,1.0,0,0,0,0,0,0,3,0.0,3,0,0,0,0,0,0,0,"FW,MF",Under 20,Forward,France,Europe
413039,Bryan Mbeumo,CMR,Brentford,Premier League,2024,25.0,1999.0,16.9,21,12,7,7,7,9,13,69.2,4,12,2,10,7,28,24,0,FW,25-29,Forward,Cameroon,Africa
621193,Kasey McAteer,IRL,Leicester City,Premier League,2024,23.0,2001.0,3.7,10,7,6,3,1,5,12,41.7,7,7,1,6,1,11,8,0,"FW,MF",20-24,Forward,Republic of Ireland,Europe
193116,John McGinn,SCO,Aston Villa,Premier League,2024,30.0,1994.0,11.9,15,10,4,8,3,4,10,40.0,6,9,0,9,4,19,3,0,"FW,MF",30-34,Forward,Scotland,Europe
332697,Weston McKennie,USA,Juventus,Serie A,2024,26.0,1998.0,7.0,8,3,3,5,0,2,4,50.0,2,7,1,6,6,14,3,0,"MF,DF",25-29,Midfielder,United States,North America
584769,Dwight McNeil,ENG,Everton,Premier League,2024,25.0,1999.0,12.7,10,6,5,3,2,7,16,43.8,9,7,0,7,5,15,1,1,"MF,FW",25-29,Midfielder,England,Europe
474800,Facundo Medina,ARG,Lens,Ligue 1,2024,25.0,1999.0,13.7,28,19,14,12,2,13,21,61.9,8,13,4,9,18,46,30,0,"DF,MF",25-29,Defender,Argentina,South America
425400,Farid El Melali,ALG,Angers,Ligue 1,2024,27.0,1997.0,10.5,18,8,8,5,5,7,21,33.3,14,9,1,8,7,25,8,1,FW,25-29,Forward,Algeria,Africa
616341,Nuno Mendes,POR,Paris S-G,Ligue 1,2024,22.0,2002.0,7.0,13,9,5,7,1,9,15,60.0,6,10,5,5,5,18,12,0,DF,20-24,Defender,Portugal,Europe
557613,Quentin Merlin,FRA,Marseille,Ligue 1,2024,22.0,2002.0,6.2,6,5,4,1,1,2,6,33.3,4,3,1,2,7,13,6,1,"DF,MF",20-24,Defender,France,Europe
449151,Junior Messias,BRA,Genoa,Serie A,2024,33.0,1991.0,3.4,4,1,3,1,0,1,2,50.0,1,1,1,0,4,8,7,0,"MF,FW",30-34,Midfielder,Brazil,South America
522223,Connor Metcalfe,AUS,St. Pauli,Bundesliga,2024,25.0,1999.0,2.5,1,0,0,1,0,0,3,0.0,3,3,0,3,2,3,4,0,MF,25-29,Midfielder,Australia,Oceania
100986,Thomas Meunier,BEL,Lille,Ligue 1,2024,33.0,1991.0,6.9,14,10,10,3,1,8,13,61.5,5,9,3,6,12,26,24,0,DF,30-34,Defender,Belgium,Europe
729814,Georges Mikautadze,GEO,Lyon,Ligue 1,2024,24.0,2000.0,6.4,5,4,1,2,2,2,5,40.0,3,2,0,2,1,6,0,0,FW,20-24,Forward,Georgia,Asia
401530,der Milito,BRA,Real Madrid,La Liga,2024,26.0,1998.0,10.4,19,17,14,5,0,7,12,58.3,5,13,8,5,12,31,35,0,DF,25-29,Defender,Brazil,South America
569366,Enzo Millot,FRA,Stuttgart,Bundesliga,2024,22.0,2002.0,11.4,16,9,7,7,2,6,20,30.0,14,15,0,15,7,23,2,1,"MF,FW",20-24,Midfielder,France,Europe
289446,Yerry Mina,COL,Cagliari,Serie A,2024,30.0,1994.0,12.9,28,11,18,9,1,20,26,76.9,6,30,18,12,13,41,68,2,DF,30-34,Defender,Colombia,South America
165793,Takumi Minamino,JPN,Monaco,Ligue 1,2024,29.0,1995.0,10.7,11,6,2,5,4,3,13,23.1,10,9,1,8,4,15,8,0,"MF,FW",25-29,Midfielder,Japan,Asia
982393,Lucas Mincarelli,FRA,Montpellier,Ligue 1,2024,20.0,2004.0,2.8,4,4,1,2,1,1,5,20.0,4,1,1,0,1,5,8,0,DF,20-24,Defender,France,Europe
1012534,Yankuba Minteh,GAM,Brighton,Premier League,2024,20.0,2004.0,5.9,9,5,2,1,6,4,12,33.3,8,10,0,10,3,12,5,0,"FW,MF",20-24,Forward,Gambia,Africa
476219,Bojan Miovski,MKD,Girona,La Liga,2024,25.0,1999.0,7.1,6,4,1,2,3,2,7,28.6,5,4,0,4,2,8,7,0,FW,25-29,Forward,North Macedonia,Europe
571607,Fabio Miretti,ITA,Genoa,Serie A,2024,21.0,2003.0,8.0,17,9,5,6,6,12,19,63.2,7,7,1,6,5,22,5,0,"MF,FW",20-24,Midfielder,Italy,Europe
730893,Tyrick Mitchell,ENG,Crystal Palace,Premier League,2024,25.0,1999.0,16.4,45,31,30,12,3,10,23,43.5,13,35,5,30,7,52,43,1,DF,25-29,Defender,England,Europe
504849,Kaoru Mitoma,JPN,Brighton,Premier League,2024,27.0,1997.0,16.1,24,16,7,9,8,12,32,37.5,20,25,2,23,8,32,3,0,"FW,MF",25-29,Forward,Japan,Asia
295060,Koji Miyoshi,JPN,Bochum,Bundesliga,2024,27.0,1997.0,3.8,5,4,0,1,4,3,7,42.9,4,8,1,7,2,7,2,0,"MF,FW",25-29,Midfielder,Japan,Asia
55735,Henrikh Mkhitaryan,ARM,Inter,Serie A,2024,35.0,1989.0,14.6,23,14,7,10,6,10,21,47.6,11,10,2,8,11,34,16,0,MF,35-39,Midfielder,Armenia,Asia
462348,Mostafa Mohamed,EGY,Nantes,Ligue 1,2024,27.0,1997.0,5.4,8,5,3,4,1,2,7,28.6,5,2,0,2,2,10,10,0,FW,25-29,Forward,Egypt,Africa
262939,Johan Mojica,COL,Mallorca,La Liga,2024,32.0,1992.0,15.5,18,12,13,2,3,10,17,58.8,7,4,2,2,17,35,42,1,DF,30-34,Defender,Colombia,South America
424042,Nahuel Molina,ARG,Atltico Madrid,La Liga,2024,26.0,1998.0,8.5,19,9,10,9,0,14,29,48.3,15,8,0,8,7,26,23,0,DF,25-29,Defender,Argentina,South America
222859,Florent Mollet,FRA,Nantes,Ligue 1,2024,33.0,1991.0,1.8,1,1,1,0,0,1,1,100.0,0,2,0,2,1,2,2,0,"MF,FW",30-34,Midfielder,France,Europe
655006,Diego Moreira,POR,Strasbourg,Ligue 1,2024,20.0,2004.0,13.2,20,14,6,10,4,9,19,47.4,10,8,1,7,14,34,31,0,"DF,MF",20-24,Defender,Portugal,Europe
617074,Ilaix Moriba,GUI,Celta Vigo,La Liga,2024,21.0,2003.0,9.7,29,22,9,17,3,17,30,56.7,13,12,3,9,6,35,14,0,MF,20-24,Midfielder,Guinea,Africa
316934,Nikola Moro,CRO,Bologna,Serie A,2024,26.0,1998.0,7.4,21,17,6,11,4,15,19,78.9,4,13,6,7,7,28,10,0,MF,25-29,Midfielder,Croatia,Europe
123551,Sam Morsy,EGY,Ipswich Town,Premier League,2024,33.0,1991.0,15.9,37,20,18,15,4,15,37,40.5,22,16,6,10,17,54,26,2,MF,30-34,Midfielder,Egypt,Africa
651569,Daniel Mosquera,COL,Hellas Verona,Serie A,2024,25.0,1999.0,6.0,4,2,1,1,2,0,2,0.0,2,4,1,3,0,4,4,0,"FW,MF",25-29,Forward,Colombia,South America
347253,Dany Mota,POR,Monza,Serie A,2024,26.0,1998.0,10.7,8,1,2,0,6,2,4,50.0,2,11,0,11,7,15,9,1,"MF,FW",25-29,Midfielder,Portugal,Europe
467720,Youssoufa Moukoko,GER,Nice,Ligue 1,2024,20.0,2004.0,2.0,1,0,1,0,0,0,1,0.0,1,0,0,0,0,1,0,0,"FW,MF",20-24,Forward,Germany,Europe
238639,Steve Mouni,BEN,Augsburg,Bundesliga,2024,30.0,1994.0,2.6,3,3,0,1,2,0,1,0.0,1,1,1,0,0,3,4,0,"FW,MF",30-34,Forward,Benin,Africa
953901,Santiago Mourio,URU,Alavs,La Liga,2024,22.0,2002.0,7.0,15,11,11,4,0,8,15,53.3,7,6,0,6,11,26,28,0,DF,20-24,Defender,Uruguay,South America
904662,Louis Mouton,FRA,Saint-tienne,Ligue 1,2024,22.0,2002.0,6.0,15,8,6,5,4,4,9,44.4,5,4,1,3,6,21,10,0,MF,20-24,Midfielder,France,Europe
58358,Thomas Mller,GER,Bayern Munich,Bundesliga,2024,35.0,1989.0,6.2,4,2,1,2,1,2,6,33.3,4,5,0,5,0,4,7,0,"MF,FW",35-39,Midfielder,Germany,Europe
451801,Abdul Mumin,GHA,Rayo Vallecano,La Liga,2024,26.0,1998.0,15.0,19,12,14,5,0,7,16,43.8,9,23,14,9,18,37,93,0,DF,25-29,Defender,Ghana,Africa
735571,Rodrigo Muniz,BRA,Fulham,Premier League,2024,23.0,2001.0,5.9,4,2,1,2,1,3,3,100.0,0,5,1,4,4,8,5,0,FW,20-24,Forward,Brazil,South America
493003,Daniel Muoz,COL,Crystal Palace,Premier League,2024,28.0,1996.0,15.0,56,38,26,21,9,25,44,56.8,19,14,2,12,16,72,43,0,DF,25-29,Defender,Colombia,South America
1005649,Murillo,BRA,Nott'ham Forest,Premier League,2024,22.0,2002.0,16.7,21,12,15,5,1,12,23,52.2,11,31,22,9,13,34,102,1,DF,20-24,Defender,Brazil,South America
199527,Jacob Murphy,ENG,Newcastle Utd,Premier League,2024,29.0,1995.0,8.6,10,7,4,4,2,7,12,58.3,5,14,0,14,3,13,6,0,FW,25-29,Forward,England,Europe
580195,Jamal Musiala,GER,Bayern Munich,Bundesliga,2024,21.0,2003.0,11.2,21,13,5,8,8,5,15,33.3,10,15,0,15,6,27,4,1,MF,20-24,Midfielder,Germany,Europe
127573,Phillipp Mwene,AUT,Mainz 05,Bundesliga,2024,30.0,1994.0,14.8,25,15,9,13,3,7,19,36.8,12,18,4,14,15,40,30,0,DF,30-34,Defender,Austria,Europe
405397,Keito Nakamura,JPN,Reims,Ligue 1,2024,24.0,2000.0,12.9,15,10,6,5,4,7,15,46.7,8,10,0,10,7,22,7,0,FW,20-24,Forward,Japan,Asia
579928,Sebastian Nanasi,SWE,Strasbourg,Ligue 1,2024,22.0,2002.0,12.0,10,8,3,5,2,4,12,33.3,8,10,1,9,3,13,8,0,"FW,MF",20-24,Forward,Sweden,Europe
735568,Natan,BRA,Betis,La Liga,2024,23.0,2001.0,9.1,13,10,10,2,1,10,10,100.0,0,10,5,5,13,26,46,0,DF,20-24,Defender,Brazil,South America
623570,Iliman Ndiaye,SEN,Everton,Premier League,2024,24.0,2000.0,14.0,30,15,13,9,8,13,26,50.0,13,14,4,10,15,45,13,0,FW,20-24,Forward,Senegal,Africa
274839,Wilfred Ndidi,NGA,Leicester City,Premier League,2024,28.0,1996.0,13.5,48,28,26,19,3,15,33,45.5,18,32,12,20,9,57,47,0,MF,25-29,Midfielder,Nigeria,Africa
365108,Dan Ndoye,SUI,Bologna,Serie A,2024,24.0,2000.0,9.2,8,7,2,2,4,5,12,41.7,7,10,0,10,3,11,2,0,FW,20-24,Forward,Switzerland,Europe
503160,Paul Nebel,GER,Mainz 05,Bundesliga,2024,22.0,2002.0,8.7,13,8,4,5,4,4,11,36.4,7,14,1,13,8,21,14,1,MF,20-24,Midfielder,Germany,Europe
122840,Loc Nego,HUN,Le Havre,Ligue 1,2024,33.0,1991.0,8.7,19,11,10,7,2,14,22,63.6,8,6,0,6,14,33,19,0,"DF,FW",30-34,Defender,Hungary,Europe
469822,David Neres,BRA,Napoli,Serie A,2024,27.0,1997.0,4.4,5,2,1,2,2,2,4,50.0,2,2,0,2,2,7,0,0,"FW,MF",25-29,Forward,Brazil,South America
487465,Pedro Neto,POR,Chelsea,Premier League,2024,24.0,2000.0,9.0,10,5,3,6,1,4,9,44.4,5,7,0,7,5,15,2,0,FW,20-24,Forward,Portugal,Europe
670681,Joo Neves,POR,Paris S-G,Ligue 1,2024,20.0,2004.0,12.1,48,26,16,22,10,20,34,58.8,14,17,5,12,8,56,8,0,MF,20-24,Midfielder,Portugal,Europe
469669,Yvan Neyou,CMR,Legans,La Liga,2024,27.0,1997.0,12.4,28,20,11,15,2,12,22,54.5,10,17,0,17,14,42,18,1,MF,25-29,Midfielder,Cameroon,Africa
358032,Cyril Ngonge,BEL,Napoli,Serie A,2024,24.0,2000.0,1.2,4,3,1,3,0,1,3,33.3,2,0,0,0,0,4,3,0,"FW,DF",20-24,Forward,Belgium,Europe
490417,Ibrahima Niane,SEN,Angers,Ligue 1,2024,25.0,1999.0,7.4,5,2,3,2,0,3,3,100.0,0,5,1,4,2,7,3,2,FW,25-29,Forward,Senegal,Africa
430280,Hans Nicolussi Caviglia,ITA,Venezia,Serie A,2024,24.0,2000.0,11.9,21,11,4,12,5,15,25,60.0,10,10,2,8,8,29,16,2,MF,20-24,Midfielder,Italy,Europe
596153,Justin Njinmah,GER,Werder Bremen,Bundesliga,2024,24.0,2000.0,5.1,2,1,1,1,0,2,3,66.7,1,2,0,2,2,4,0,0,"MF,FW",20-24,Midfielder,Germany,Europe
340324,Eddie Nketiah,ENG,Crystal Palace,Premier League,2024,25.0,1999.0,6.4,12,5,6,2,4,5,9,55.6,4,6,0,6,1,13,5,0,"MF,FW",25-29,Midfielder,England,Europe
344381,Christopher Nkunku,FRA,Chelsea,Premier League,2024,27.0,1997.0,3.6,3,3,0,1,2,2,2,100.0,0,5,1,4,2,5,6,0,FW,25-29,Forward,France,Europe
406640,Felix Nmecha,GER,Dortmund,Bundesliga,2024,24.0,2000.0,9.7,22,15,2,14,6,8,14,57.1,6,13,5,8,14,36,20,0,MF,20-24,Midfielder,Germany,Europe
324811,Arnaud Nordin,FRA,Montpellier,Ligue 1,2024,26.0,1998.0,12.2,23,14,6,15,2,10,18,55.6,8,11,0,11,5,28,7,0,FW,25-29,Forward,France,Europe
728733,Brooke Norton-Cuffy,ENG,Genoa,Serie A,2024,20.0,2004.0,1.3,3,2,1,2,0,1,2,50.0,1,1,0,1,1,4,0,0,"DF,MF",20-24,Defender,England,Europe
457736,Tijjani Noslin,NED,Lazio,Serie A,2024,25.0,1999.0,6.0,4,3,1,1,2,0,3,0.0,3,13,1,12,0,4,7,0,"FW,MF",25-29,Forward,Netherlands,Europe
560483,Randy Nteka,ANG,Rayo Vallecano,La Liga,2024,27.0,1997.0,7.1,9,5,2,5,2,4,7,57.1,3,7,1,6,2,11,9,0,FW,25-29,Forward,Angola,Africa
955070,Ernest Nuamah,GHA,Lyon,Ligue 1,2024,21.0,2003.0,3.8,9,3,6,2,1,7,11,63.6,4,2,0,2,2,11,3,0,"FW,MF",20-24,Forward,Ghana,Africa
546543,Darwin Nez,URU,Liverpool,Premier League,2024,25.0,1999.0,7.2,16,14,9,3,4,5,12,41.7,7,3,0,3,1,17,8,0,FW,25-29,Forward,Uruguay,South America
111508,Allan Nyom,CMR,Getafe,La Liga,2024,36.0,1988.0,6.3,10,6,4,5,1,8,10,80.0,2,2,1,1,2,12,14,0,"DF,MF",35-39,Defender,Cameroon,Africa
1068110,Rabby Nzingoula,CGO,Montpellier,Ligue 1,2024,19.0,2005.0,8.0,29,17,11,13,5,12,24,50.0,12,9,2,7,12,41,10,0,MF,Under 20,Midfielder,Congo,Africa
148367,Christian Nrgaard,DEN,Brentford,Premier League,2024,30.0,1994.0,12.8,42,27,17,21,4,26,36,72.2,10,20,6,14,19,61,29,1,MF,30-34,Midfielder,Denmark,Europe
401320,Dara O'Shea,IRL,Ipswich Town,Premier League,2024,25.0,1999.0,13.7,20,13,12,7,1,7,11,63.6,4,26,21,5,19,39,76,3,DF,25-29,Defender,Republic of Ireland,Europe
568333,Adam Obert,SVK,Cagliari,Serie A,2024,22.0,2002.0,4.1,12,8,4,8,0,6,12,50.0,6,8,4,4,11,23,18,1,DF,20-24,Defender,Slovakia,Europe
189441,Lucas Ocampos,ARG,Sevilla,La Liga,2024,30.0,1994.0,1.9,3,2,2,0,1,1,2,50.0,1,2,0,2,0,3,2,0,FW,30-34,Forward,Argentina,South America
345590,Jens Odgaard,DEN,Bologna,Serie A,2024,25.0,1999.0,9.7,11,10,2,8,1,3,9,33.3,6,7,1,6,5,16,6,0,"MF,FW",25-29,Midfielder,Denmark,Europe
718312,Hamzat Ojediran,NGA,Lens,Ligue 1,2024,21.0,2003.0,3.2,17,10,5,10,2,4,11,36.4,7,8,2,6,9,26,5,0,MF,20-24,Midfielder,Nigeria,Africa
346890,Noah Okafor,SUI,Milan,Serie A,2024,24.0,2000.0,4.6,2,1,0,0,2,0,1,0.0,1,1,0,1,2,4,1,0,FW,20-24,Forward,Switzerland,Europe
453376,Joseph Okumu,KEN,Reims,Ligue 1,2024,27.0,1997.0,6.3,16,8,13,3,0,9,13,69.2,4,13,9,4,11,27,29,2,DF,25-29,Defender,Kenya,Africa
617021,Ben Old,NZL,Saint-tienne,Ligue 1,2024,22.0,2002.0,4.2,4,4,3,1,0,2,8,25.0,6,5,1,4,1,5,1,0,"MF,FW",20-24,Midfielder,New Zealand,Oceania
507344,Becir Omeragic,SUI,Montpellier,Ligue 1,2024,22.0,2002.0,8.3,16,6,11,4,1,9,14,64.3,5,8,4,4,5,21,29,0,DF,20-24,Defender,Switzerland,Europe
308133,Ado Onaiwu,JPN,Auxerre,Ligue 1,2024,29.0,1995.0,5.5,5,4,0,5,0,2,6,33.3,4,1,0,1,1,6,6,0,"MF,FW",25-29,Midfielder,Japan,Asia
485706,Amadou Onana,BEL,Aston Villa,Premier League,2024,23.0,2001.0,9.0,28,16,16,10,2,9,17,52.9,8,9,5,4,17,45,18,2,MF,20-24,Midfielder,Belgium,Europe
368887,Los Openda,BEL,RB Leipzig,Bundesliga,2024,24.0,2000.0,14.0,6,3,2,4,0,1,4,25.0,3,8,1,7,2,8,4,0,FW,20-24,Forward,Belgium,Europe
1018259,Gift Orban,NGA,Lyon,Ligue 1,2024,22.0,2002.0,2.1,0,0,0,0,0,0,1,0.0,1,0,0,0,0,0,0,0,"FW,DF",20-24,Forward,Nigeria,Africa
613393,Gaetano Oristanio,ITA,Venezia,Serie A,2024,22.0,2002.0,13.9,8,6,3,4,1,3,8,37.5,5,13,0,13,5,13,4,0,"MF,FW",20-24,Midfielder,Italy,Europe
364409,Gabriel Osho,NGA,Auxerre,Ligue 1,2024,26.0,1998.0,11.1,12,8,10,1,1,6,11,54.5,5,22,14,8,11,23,52,0,DF,25-29,Defender,Nigeria,Africa
823231,Dango Ouattara,BFA,Bournemouth,Premier League,2024,22.0,2002.0,7.8,23,19,9,7,7,13,27,48.1,14,15,4,11,7,30,18,0,"FW,DF",20-24,Forward,Burkina Faso,Africa
947360,Kassoum Ouattara,FRA,Monaco,Ligue 1,2024,20.0,2004.0,3.0,8,6,4,4,0,4,12,33.3,8,4,0,4,4,12,1,0,"DF,FW",20-24,Defender,France,Europe
395695,Elisha Owusu,GHA,Auxerre,Ligue 1,2024,27.0,1997.0,13.4,43,25,16,26,1,20,31,64.5,11,17,3,14,22,65,20,0,MF,25-29,Midfielder,Ghana,Africa
401578,Exequiel Palacios,ARG,Leverkusen,Bundesliga,2024,26.0,1998.0,3.9,7,6,1,4,2,3,5,60.0,2,8,1,7,3,10,4,0,MF,25-29,Midfielder,Argentina,South America
257455,Joo Palhinha,POR,Bayern Munich,Bundesliga,2024,29.0,1995.0,3.9,7,7,1,5,1,4,7,57.1,3,5,0,5,3,10,4,0,MF,25-29,Midfielder,Portugal,Europe
139279,Nicolas Pallois,FRA,Nantes,Ligue 1,2024,37.0,1987.0,9.0,22,9,15,6,1,13,23,56.5,10,12,4,8,12,34,59,1,DF,35-39,Defender,France,Europe
568177,Cole Palmer,ENG,Chelsea,Premier League,2024,22.0,2002.0,16.4,12,7,6,4,2,4,13,30.8,9,11,1,10,5,17,7,0,MF,20-24,Midfielder,England,Europe
444523,Lucas Paquet,BRA,West Ham,Premier League,2024,27.0,1997.0,13.3,30,18,16,12,2,10,25,40.0,15,20,2,18,9,39,22,3,MF,25-29,Midfielder,Brazil,South America
166237,Leandro Paredes,ARG,Roma,Serie A,2024,30.0,1994.0,4.4,10,8,5,4,1,4,7,57.1,3,4,1,3,8,18,5,1,MF,30-34,Midfielder,Argentina,South America
547985,Fabiano Parisi,ITA,Fiorentina,Serie A,2024,24.0,2000.0,2.0,6,4,1,3,2,1,2,50.0,1,1,0,1,2,8,4,0,DF,20-24,Defender,Italy,Europe
230784,Thomas Partey,GHA,Arsenal,Premier League,2024,31.0,1993.0,14.5,41,28,15,14,12,22,38,57.9,16,11,5,6,18,59,27,2,"MF,DF",30-34,Midfielder,Ghana,Africa
274461,Felix Passlack,GER,Bochum,Bundesliga,2024,26.0,1998.0,13.6,33,17,21,8,4,21,39,53.8,18,27,8,19,9,42,29,1,DF,25-29,Defender,Germany,Europe
364133,Pietro Pellegri,ITA,Empoli,Serie A,2024,23.0,2001.0,4.6,7,2,0,6,1,2,4,50.0,2,2,0,2,0,7,3,0,FW,20-24,Forward,Italy,Europe
286297,Lorenzo Pellegrini,ITA,Roma,Serie A,2024,28.0,1996.0,9.9,11,7,2,6,3,3,8,37.5,5,2,0,2,0,11,10,0,MF,25-29,Midfielder,Italy,Europe
346567,Luca Pellegrini,ITA,Lazio,Serie A,2024,25.0,1999.0,4.1,5,3,1,4,0,2,5,40.0,3,4,0,4,5,10,8,0,DF,25-29,Defender,Italy,Europe
343052,Nicolas Pp,CIV,Villarreal,La Liga,2024,29.0,1995.0,6.3,4,1,1,1,2,0,3,0.0,3,3,1,2,3,7,3,0,"FW,MF",25-29,Forward,Ivory Coast,Africa
203394,Andreas Pereira,BRA,Fulham,Premier League,2024,28.0,1996.0,11.2,10,4,3,4,3,5,20,25.0,15,6,1,5,4,14,3,0,MF,25-29,Midfielder,Brazil,South America
314965,Pedro Pereira,POR,Monza,Serie A,2024,26.0,1998.0,12.2,17,9,8,8,1,9,20,45.0,11,10,4,6,8,25,29,2,DF,25-29,Defender,Portugal,Europe
318523,Romain Perraud,FRA,Betis,La Liga,2024,27.0,1997.0,14.1,27,17,11,12,4,16,37,43.2,21,11,2,9,18,45,43,1,DF,25-29,Defender,France,Europe
353404,Gatan Perrin,FRA,Auxerre,Ligue 1,2024,28.0,1996.0,11.3,31,15,15,8,8,17,28,60.7,11,5,0,5,6,37,2,0,"MF,FW",25-29,Midfielder,France,Europe
336960,Giuseppe Pezzella,ITA,Empoli,Serie A,2024,27.0,1997.0,13.3,25,16,17,7,1,17,32,53.1,15,11,4,7,5,30,44,0,"DF,FW",25-29,Defender,Italy,Europe
351749,Kalvin Phillips,ENG,Ipswich Town,Premier League,2024,29.0,1995.0,6.3,15,7,4,9,2,8,18,44.4,10,16,3,13,8,23,11,1,MF,25-29,Midfielder,England,Europe
331362,Benedikt Pichler,AUT,Holstein Kiel,Bundesliga,2024,27.0,1997.0,8.1,5,2,1,0,4,2,4,50.0,2,4,2,2,2,7,11,0,FW,25-29,Forward,Austria,Europe
674806,Santiago Pierotti,ARG,Lecce,Serie A,2024,23.0,2001.0,7.7,15,11,10,4,1,10,20,50.0,10,8,2,6,5,20,12,0,FW,20-24,Forward,Argentina,South America
315865,Andrea Pinamonti,ITA,Genoa,Serie A,2024,25.0,1999.0,14.5,5,3,0,4,1,0,3,0.0,3,9,2,7,1,6,16,1,FW,25-29,Forward,Italy,Europe
442248,Ethan Pinnock,JAM,Brentford,Premier League,2024,31.0,1993.0,16.0,29,16,14,12,3,12,17,70.6,5,25,16,9,18,47,105,3,DF,30-34,Defender,Jamaica,North America
813137,Niccol Pisilli,ITA,Roma,Serie A,2024,20.0,2004.0,7.1,12,7,7,4,1,6,9,66.7,3,8,1,7,5,17,7,0,MF,20-24,Midfielder,Italy,Europe
167329,Alassane Pla,FRA,Gladbach,Bundesliga,2024,31.0,1993.0,11.5,4,2,0,1,3,2,5,40.0,3,5,0,5,2,6,3,1,"MF,FW",30-34,Midfielder,France,Europe
392538,Tommaso Pobega,ITA,Bologna,Serie A,2024,25.0,1999.0,5.5,16,10,7,6,3,10,16,62.5,6,11,3,8,8,24,7,0,MF,25-29,Midfielder,Italy,Europe
241307,Finn Porath,GER,Holstein Kiel,Bundesliga,2024,27.0,1997.0,11.6,30,18,16,9,5,18,34,52.9,16,19,6,13,11,41,29,0,"DF,MF",25-29,Defender,Germany,Europe
157635,Yussuf Poulsen,DEN,RB Leipzig,Bundesliga,2024,30.0,1994.0,2.2,5,3,1,4,0,3,6,50.0,3,4,2,2,0,5,4,0,"FW,MF",30-34,Forward,Denmark,Europe
315779,Christian Pulisic,USA,Milan,Serie A,2024,26.0,1998.0,10.9,20,12,6,7,7,6,14,42.9,8,9,1,8,0,20,5,1,"MF,FW",25-29,Midfielder,United States,North America
597432,Leopold Querfeld,AUT,Union Berlin,Bundesliga,2024,21.0,2003.0,6.2,7,3,5,2,0,3,6,50.0,3,8,1,7,8,15,32,0,DF,20-24,Defender,Austria,Europe
182913,Adrien Rabiot,FRA,Marseille,Ligue 1,2024,29.0,1995.0,8.6,20,14,9,8,3,10,14,71.4,4,9,0,9,10,30,14,0,MF,25-29,Midfielder,France,Europe
418571,Hamza Rafia,TUN,Lecce,Serie A,2024,25.0,1999.0,9.5,33,19,13,17,3,13,28,46.4,15,7,2,5,4,37,15,0,MF,25-29,Midfielder,Tunisia,Africa
442703,Ylber Ramadani,ALB,Lecce,Serie A,2024,28.0,1996.0,13.6,32,18,14,18,0,19,27,70.4,8,22,8,14,12,44,21,3,MF,25-29,Midfielder,Albania,Europe
503749,Jacob Ramsey,ENG,Aston Villa,Premier League,2024,23.0,2001.0,7.0,7,3,3,3,1,3,5,60.0,2,8,2,6,5,12,2,0,"FW,MF",20-24,Forward,England,Europe
405885,Giacomo Raspadori,ITA,Napoli,Serie A,2024,24.0,2000.0,2.9,3,1,2,1,0,2,4,50.0,2,5,1,4,2,5,1,0,"FW,MF",20-24,Forward,Italy,Europe
318204,David Raum,GER,RB Leipzig,Bundesliga,2024,26.0,1998.0,5.5,12,9,6,4,2,3,7,42.9,4,6,2,4,2,14,10,0,DF,25-29,Defender,Germany,Europe
187587,Ante Rebi,CRO,Lecce,Serie A,2024,31.0,1993.0,5.4,8,6,4,2,2,2,7,28.6,5,3,1,2,0,8,3,0,"FW,MF",30-34,Forward,Croatia,Europe
460939,Tijjani Reijnders,NED,Milan,Serie A,2024,26.0,1998.0,13.1,6,3,1,4,1,2,11,18.2,9,3,0,3,12,18,10,1,MF,25-29,Midfielder,Netherlands,Europe
592534,Nicolai Remberg,GER,Holstein Kiel,Bundesliga,2024,24.0,2000.0,10.2,19,11,7,11,1,7,13,53.8,6,17,5,12,6,25,29,0,MF,20-24,Midfielder,Germany,Europe
467992,Samuele Ricci,ITA,Torino,Serie A,2024,23.0,2001.0,16.1,19,10,9,6,4,9,12,75.0,3,11,6,5,14,33,25,2,MF,20-24,Midfielder,Italy,Europe
357662,Declan Rice,ENG,Arsenal,Premier League,2024,25.0,1999.0,13.3,23,11,7,13,3,8,14,57.1,6,14,8,6,10,33,20,0,MF,25-29,Midfielder,England,Europe
893675,Amir Richardson,MAR,Fiorentina,Serie A,2024,22.0,2002.0,4.2,13,5,8,5,0,3,8,37.5,5,4,1,3,1,14,11,1,MF,20-24,Midfielder,Morocco,Africa
507341,Fabian Rieder,SUI,Stuttgart,Bundesliga,2024,22.0,2002.0,7.1,13,11,3,6,4,6,21,28.6,15,8,1,7,6,19,3,0,"MF,FW",20-24,Midfielder,Switzerland,Europe
234803,Andrew Robertson,SCO,Liverpool,Premier League,2024,30.0,1994.0,12.6,21,13,13,5,3,16,26,61.5,10,2,1,1,7,28,19,0,DF,30-34,Defender,Scotland,Europe
349701,Antonee Robinson,USA,Fulham,Premier League,2024,27.0,1997.0,17.0,50,31,33,16,1,27,48,56.3,21,20,3,17,35,85,60,0,DF,25-29,Defender,United States,North America
948275,lvaro Rodrguez,URU,Getafe,La Liga,2024,20.0,2004.0,5.4,5,3,0,4,1,2,5,40.0,3,18,0,18,3,8,9,0,FW,20-24,Forward,Uruguay,South America
342385,Guido Rodrguez,ARG,West Ham,Premier League,2024,30.0,1994.0,9.2,26,13,17,9,0,11,26,42.3,15,15,7,8,10,36,22,1,MF,30-34,Midfielder,Argentina,South America
412363,Rodrygo,BRA,Real Madrid,La Liga,2024,23.0,2001.0,10.9,9,7,6,2,1,4,13,30.8,9,11,1,10,2,11,4,0,FW,20-24,Forward,Brazil,South America
503743,Morgan Rogers,ENG,Aston Villa,Premier League,2024,22.0,2002.0,15.6,15,8,3,7,5,7,20,35.0,13,12,2,10,3,18,10,0,"MF,FW",20-24,Midfielder,England,Europe
355915,Cristian Romero,ARG,Tottenham,Premier League,2024,26.0,1998.0,10.8,27,23,22,5,0,15,22,68.2,7,13,3,10,13,40,32,0,DF,25-29,Defender,Argentina,South America
332889,Valentin Rongier,FRA,Marseille,Ligue 1,2024,30.0,1994.0,5.4,17,11,8,8,1,8,13,61.5,5,14,5,9,11,28,14,1,"MF,DF",30-34,Midfielder,France,Europe
943837,Vitor Roque,BRA,Betis,La Liga,2024,19.0,2005.0,10.9,6,4,0,2,4,0,3,0.0,3,4,0,4,5,11,3,0,FW,Under 20,Forward,Brazil,South America
370791,Pablo Rosario,NED,Nice,Ligue 1,2024,27.0,1997.0,12.8,15,9,4,9,2,6,12,50.0,6,12,7,5,22,37,29,2,"MF,DF",25-29,Midfielder,Netherlands,Europe
512352,Lasse Rosenboom,GER,Holstein Kiel,Bundesliga,2024,22.0,2002.0,5.4,13,10,8,3,2,8,11,72.7,3,10,2,8,8,21,18,1,DF,20-24,Defender,Germany,Europe
441170,Valentin Rosier,FRA,Legans,La Liga,2024,28.0,1996.0,12.1,36,29,26,9,1,22,35,62.9,13,15,2,13,18,54,61,1,DF,25-29,Defender,France,Europe
798043,Tom Rothe,GER,Union Berlin,Bundesliga,2024,20.0,2004.0,10.3,30,15,21,8,1,19,32,59.4,13,22,3,19,7,37,26,1,"DF,MF",20-24,Defender,Germany,Europe
525704,Nicol Rovella,ITA,Lazio,Serie A,2024,23.0,2001.0,12.8,41,26,12,25,4,19,37,51.4,18,9,3,6,20,61,17,2,MF,20-24,Midfielder,Italy,Europe
86202,Antonio Rdiger,GER,Real Madrid,La Liga,2024,31.0,1993.0,17.1,13,8,8,5,0,8,10,80.0,2,18,11,7,7,20,69,1,DF,30-34,Defender,Germany,Europe
538977,Georginio Rutter,FRA,Brighton,Premier League,2024,22.0,2002.0,11.0,20,7,9,7,4,8,24,33.3,16,13,2,11,7,27,9,1,"FW,MF",20-24,Forward,France,Europe
526466,Elias Saad,TUN,St. Pauli,Bundesliga,2024,24.0,1999.0,3.8,12,7,4,5,3,6,11,54.5,5,6,0,6,1,13,1,0,"FW,MF",20-24,Forward,Tunisia,Africa
381187,Emmanuel Sabbi,USA,Le Havre,Ligue 1,2024,27.0,1997.0,4.9,7,5,3,2,2,3,4,75.0,1,2,0,2,2,9,3,0,"MF,FW",25-29,Midfielder,United States,North America
524925,Modibo Sagnan,MLI,Montpellier,Ligue 1,2024,25.0,1999.0,12.3,26,14,16,7,3,15,26,57.7,11,12,7,5,17,43,53,3,DF,25-29,Defender,Mali,Africa
580657,Osame Sahraoui,MAR,Lille,Ligue 1,2024,23.0,2001.0,8.1,5,3,2,2,1,1,4,25.0,3,10,1,9,4,9,5,1,"FW,MF",20-24,Forward,Morocco,Africa
182916,Wesley Sad,FRA,Lens,Ligue 1,2024,29.0,1995.0,4.2,3,2,1,2,0,1,2,50.0,1,0,0,0,0,3,1,0,"FW,MF",25-29,Forward,France,Europe
433177,Bukayo Saka,ENG,Arsenal,Premier League,2024,23.0,2001.0,14.1,22,13,5,10,7,9,19,47.4,10,16,0,16,2,24,7,0,"FW,MF",20-24,Forward,England,Europe
928323,Ibrahim Salah,MAR,Brest,Ligue 1,2024,23.0,2001.0,3.5,3,2,1,1,1,1,5,20.0,4,2,0,2,1,4,0,0,FW,20-24,Forward,Morocco,Africa
148455,Mohamed Salah,EGY,Liverpool,Premier League,2024,32.0,1992.0,15.6,9,6,3,3,3,3,4,75.0,1,1,0,1,4,13,4,0,FW,30-34,Forward,Egypt,Africa
980576,Amine Salama,FRA,Reims,Ligue 1,2024,24.0,2000.0,2.7,2,2,0,1,1,0,3,0.0,3,2,1,1,0,2,0,0,FW,20-24,Forward,France,Europe
495666,William Saliba,FRA,Arsenal,Premier League,2024,23.0,2001.0,15.3,36,22,24,12,0,15,19,78.9,4,10,5,5,11,47,47,3,DF,20-24,Defender,France,Europe
563963,Mohammed Salisu,GHA,Monaco,Ligue 1,2024,25.0,1999.0,7.3,20,11,11,9,0,10,10,100.0,0,9,7,2,8,28,38,2,DF,25-29,Defender,Ghana,Africa
381967,Albert Sambi Lokonga,BEL,Sevilla,La Liga,2024,25.0,1999.0,8.4,11,9,6,5,0,4,5,80.0,1,6,1,5,2,13,15,2,MF,25-29,Midfielder,Belgium,Europe
234523,Antonio Sanabria,PAR,Torino,Serie A,2024,28.0,1996.0,10.7,2,2,1,0,1,1,4,25.0,3,5,0,5,0,2,9,0,FW,25-29,Forward,Paraguay,South America
401173,Jadon Sancho,ENG,Chelsea,Premier League,2024,24.0,2000.0,7.4,4,3,1,1,2,2,5,40.0,3,2,0,2,0,4,0,0,FW,20-24,Forward,England,Europe
388409,Philipp Sander,GER,Gladbach,Bundesliga,2024,26.0,1998.0,6.3,15,9,7,7,1,6,10,60.0,4,9,2,7,7,22,16,0,MF,25-29,Midfielder,Germany,Europe
192565,Leroy San,GER,Bayern Munich,Bundesliga,2024,28.0,1996.0,6.3,8,5,1,4,3,1,3,33.3,2,3,0,3,2,10,1,0,FW,25-29,Forward,Germany,Europe
768380,Arouna Sangante,SEN,Le Havre,Ligue 1,2024,22.0,2002.0,5.8,9,7,4,5,0,5,8,62.5,3,7,4,3,14,23,21,1,DF,20-24,Defender,Senegal,Africa
643574,Kaishu Sano,JPN,Mainz 05,Bundesliga,2024,23.0,2000.0,14.8,32,21,9,18,5,11,24,45.8,13,35,10,25,27,59,22,0,MF,20-24,Midfielder,Japan,Asia
285323,Baptiste Santamaria,FRA,Rennes,Ligue 1,2024,29.0,1995.0,5.4,11,4,7,3,1,6,11,54.5,5,10,4,6,12,23,7,0,MF,25-29,Midfielder,France,Europe
743600,Andrey Santos,BRA,Strasbourg,Ligue 1,2024,20.0,2004.0,13.7,54,36,26,24,4,25,42,59.5,17,15,4,11,13,67,19,0,MF,20-24,Midfielder,Brazil,South America
816580,Tiago Santos,POR,Lille,Ligue 1,2024,22.0,2002.0,4.5,12,7,4,5,3,6,9,66.7,3,2,0,2,2,14,4,0,DF,20-24,Defender,Portugal,Europe
748382,Amin Sarr,SWE,Hellas Verona,Serie A,2024,23.0,2001.0,4.1,7,4,2,2,3,3,4,75.0,1,3,1,2,1,8,4,0,FW,20-24,Forward,Sweden,Europe
127156,Tji Savanier,FRA,Montpellier,Ligue 1,2024,33.0,1991.0,12.3,14,11,4,6,4,11,25,44.0,14,4,0,4,10,24,9,2,MF,30-34,Midfielder,France,Europe
708072,Nicol Savona,ITA,Juventus,Serie A,2024,21.0,2003.0,10.4,17,9,8,8,1,8,14,57.1,6,4,1,3,6,23,9,0,DF,20-24,Defender,Italy,Europe
473050,Kevin Schade,GER,Brentford,Premier League,2024,23.0,2001.0,8.4,19,14,8,5,6,9,12,75.0,3,6,1,5,1,20,9,0,FW,20-24,Forward,Germany,Europe
454863,Andrs Schfer,HUN,Union Berlin,Bundesliga,2024,25.0,1999.0,7.5,24,12,10,11,3,14,20,70.0,6,15,1,14,12,36,13,0,MF,25-29,Midfielder,Hungary,Europe
135343,Fabian Schr,SUI,Newcastle Utd,Premier League,2024,33.0,1991.0,14.3,13,8,4,9,0,3,12,25.0,9,20,12,8,21,34,51,0,DF,30-34,Defender,Switzerland,Europe
394033,Stefan Schimmer,GER,Heidenheim,Bundesliga,2024,30.0,1994.0,1.9,2,0,1,1,0,1,1,100.0,0,1,0,1,0,2,0,0,"FW,MF",30-34,Forward,Germany,Europe
413843,Keven Schlotterbeck,GER,Augsburg,Bundesliga,2024,27.0,1997.0,11.5,11,10,4,7,0,6,10,60.0,4,11,5,6,10,21,57,1,DF,25-29,Defender,Germany,Europe
388198,Nico Schlotterbeck,GER,Dortmund,Bundesliga,2024,25.0,1999.0,13.8,30,19,16,13,1,23,35,65.7,12,20,10,10,18,48,52,0,DF,25-29,Defender,Germany,Europe
346853,Romano Schmid,AUT,Werder Bremen,Bundesliga,2024,24.0,2000.0,14.8,21,10,4,12,5,12,30,40.0,18,21,1,20,10,31,5,0,MF,20-24,Midfielder,Austria,Europe
275249,Niklas Schmidt,GER,Toulouse,Ligue 1,2024,26.0,1998.0,2.3,6,4,1,5,0,4,7,57.1,3,0,0,0,1,7,4,0,MF,25-29,Midfielder,Germany,Europe
581357,Jan Schppner,GER,Heidenheim,Bundesliga,2024,25.0,1999.0,13.5,25,12,6,11,8,13,32,40.6,19,18,2,16,21,46,41,1,MF,25-29,Midfielder,Germany,Europe
855256,Alex Scott,ENG,Bournemouth,Premier League,2024,21.0,2003.0,2.9,16,7,8,4,4,12,16,75.0,4,9,1,8,6,22,5,0,MF,20-24,Midfielder,England,Europe
231572,Nlson Semedo,POR,Wolves,Premier League,2024,31.0,1993.0,13.6,34,19,23,6,5,17,32,53.1,15,17,6,11,7,41,61,1,DF,30-34,Defender,Portugal,Europe
583255,Antoine Semenyo,GHA,Bournemouth,Premier League,2024,24.0,2000.0,15.4,25,16,10,11,4,5,17,29.4,12,31,4,27,4,29,14,0,FW,20-24,Forward,Ghana,Africa
261905,Suat Serdar,GER,Hellas Verona,Serie A,2024,27.0,1997.0,6.1,12,8,5,7,0,3,10,30.0,7,4,1,3,4,16,5,0,MF,25-29,Midfielder,Germany,Europe
94529,Stephan El Shaarawy,ITA,Roma,Serie A,2024,32.0,1992.0,7.3,9,7,2,3,4,3,5,60.0,2,2,0,2,4,13,5,0,"DF,MF",30-34,Defender,Italy,Europe
358166,Eldor Shomurodov,UZB,Roma,Serie A,2024,29.0,1995.0,1.3,1,0,0,1,0,0,1,0.0,1,2,0,2,0,1,0,0,"FW,MF",25-29,Forward,Uzbekistan,Asia
569033,Armindo Sieb,GER,Mainz 05,Bundesliga,2024,21.0,2003.0,5.6,6,3,3,2,1,2,8,25.0,6,2,0,2,1,7,6,0,"FW,MF",20-24,Forward,Germany,Europe
241641,Bernardo Silva,POR,Manchester City,Premier League,2024,30.0,1994.0,15.3,16,11,3,8,5,7,23,30.4,16,19,3,16,11,27,12,3,"MF,FW",30-34,Midfielder,Portugal,Europe
505653,Fbio Silva,POR,Las Palmas,La Liga,2024,22.0,2002.0,10.7,5,1,1,2,2,1,8,12.5,7,8,0,8,3,8,14,0,"FW,MF",20-24,Forward,Portugal,Europe
663244,Jota Silva,POR,Nott'ham Forest,Premier League,2024,25.0,1999.0,5.8,11,5,5,5,1,2,14,14.3,12,4,0,4,10,21,9,0,"FW,MF",25-29,Forward,Portugal,Europe
776798,Abdallah Sima,SEN,Brest,Ligue 1,2024,23.0,2001.0,4.6,3,3,0,2,1,2,4,50.0,2,1,0,1,1,4,3,0,FW,20-24,Forward,Senegal,Africa
282388,Giovanni Simeone,ARG,Napoli,Serie A,2024,29.0,1995.0,2.9,0,0,0,0,0,0,3,0.0,3,3,0,3,1,1,2,0,FW,25-29,Forward,Argentina,South America
742201,Giuliano Simeone,ARG,Atltico Madrid,La Liga,2024,22.0,2002.0,6.8,8,4,1,3,4,5,8,62.5,3,10,1,9,5,13,5,0,"MF,DF",20-24,Midfielder,Argentina,South America
274862,Moses Simon,NGA,Nantes,Ligue 1,2024,29.0,1995.0,13.1,9,7,2,4,3,5,12,41.7,7,5,0,5,9,18,4,0,FW,25-29,Forward,Nigeria,Africa
566931,Xavi Simons,NED,RB Leipzig,Bundesliga,2024,21.0,2003.0,6.8,8,7,2,5,1,3,5,60.0,2,3,1,2,2,10,6,0,MF,20-24,Midfielder,Netherlands,Europe
346499,Danel Sinani,LUX,St. Pauli,Bundesliga,2024,27.0,1997.0,2.7,5,4,0,2,3,1,3,33.3,2,3,0,3,1,6,4,0,"FW,MF",25-29,Forward,Luxembourg,Europe
569140,Lassine Sinayoko,MLI,Auxerre,Ligue 1,2024,25.0,1999.0,11.6,15,8,6,4,5,7,12,58.3,5,9,1,8,9,24,24,0,"FW,MF",25-29,Forward,Mali,Africa
648779,Wilfried Singo,CIV,Monaco,Ligue 1,2024,24.0,2000.0,12.2,21,15,13,7,1,10,14,71.4,4,4,2,2,26,47,50,1,DF,20-24,Defender,Ivory Coast,Africa
512385,Luis Sinisterra,COL,Bournemouth,Premier League,2024,25.0,1999.0,2.3,5,1,1,2,2,0,4,0.0,4,3,0,3,0,5,5,0,"FW,MF",25-29,Forward,Colombia,South America
328658,Kristoffer Ajer,NOR,Brentford,Premier League,2024,26.0,1998.0,8.0,9,7,7,2,0,4,12,33.3,8,8,1,7,6,15,23,0,DF,25-29,Defender,Norway,Europe
355627,Sergio Akieme,ESP,Reims,Ligue 1,2024,27.0,1997.0,11.9,17,12,15,1,1,12,16,75.0,4,10,4,6,7,24,36,3,DF,25-29,Defender,Spain,Europe
284854,Carles Ale,ESP,Getafe,La Liga,2024,26.0,1998.0,3.5,6,3,2,3,1,4,8,50.0,4,7,1,6,0,6,2,0,"MF,FW",25-29,Midfielder,Spain,Europe
466807,Adri Altimira,ESP,Legans,La Liga,2024,23.0,2001.0,8.6,20,9,11,7,2,10,19,52.6,9,7,4,3,12,32,26,2,"DF,FW",20-24,Defender,Spain,Europe
466801,Sergi Altimira,ESP,Betis,La Liga,2024,23.0,2001.0,11.8,31,20,8,19,4,18,32,56.3,14,18,1,17,9,40,15,1,MF,20-24,Midfielder,Spain,Europe
892929,Hugo lvarez,ESP,Celta Vigo,La Liga,2024,21.0,2003.0,13.5,23,9,11,10,2,9,16,56.3,7,17,1,16,7,30,22,1,"MF,DF",20-24,Midfielder,Spain,Europe
255488,Yeray lvarez,ESP,Athletic Club,La Liga,2024,29.0,1995.0,9.0,10,7,6,3,1,4,7,57.1,3,6,3,3,18,28,33,1,DF,25-29,Defender,Spain,Europe
277179,Angelio,ESP,Roma,Serie A,2024,27.0,1997.0,16.0,26,10,10,14,2,9,14,64.3,5,19,6,13,12,38,39,0,DF,25-29,Defender,Spain,Europe
72047,Iago Aspas,ESP,Celta Vigo,La Liga,2024,37.0,1987.0,13.4,11,7,4,4,3,8,16,50.0,8,13,1,12,6,17,4,0,"FW,MF",35-39,Forward,Spain,Europe
711969,Lorenz Assignon,TOG,Rennes,Ligue 1,2024,24.0,2000.0,9.5,18,11,9,8,1,8,21,38.1,13,10,3,7,12,30,38,0,"DF,MF",20-24,Defender,Togo,Africa
636688,Alejandro Balde,ESP,Barcelona,La Liga,2024,21.0,2003.0,14.3,10,5,6,3,1,6,9,66.7,3,13,4,9,5,15,13,0,DF,20-24,Defender,Spain,Europe
616369,Ander Barrenetxea,ESP,Real Sociedad,La Liga,2024,22.0,2001.0,7.0,11,10,3,6,2,2,11,18.2,9,10,0,10,6,17,12,0,"MF,FW",20-24,Midfielder,Spain,Europe
775605,Pablo Barrios,ESP,Atltico Madrid,La Liga,2024,21.0,2003.0,11.8,22,15,8,13,1,7,18,38.9,11,5,1,4,18,40,16,3,MF,20-24,Midfielder,Spain,Europe
191217,Hctor Bellern,ESP,Betis,La Liga,2024,29.0,1995.0,5.8,12,7,6,4,2,9,16,56.3,7,4,3,1,6,18,18,0,DF,25-29,Defender,Spain,Europe
423444,Fran Beltrn,ESP,Celta Vigo,La Liga,2024,25.0,1999.0,11.9,24,16,12,9,3,11,25,44.0,14,15,4,11,8,32,18,2,MF,25-29,Midfielder,Spain,Europe
61812,Yuri Berchiche,ESP,Athletic Club,La Liga,2024,34.0,1990.0,12.6,17,9,11,5,1,9,17,52.9,8,13,2,11,13,30,35,1,DF,30-34,Defender,Spain,Europe
338425,lex Berenguer,ESP,Athletic Club,La Liga,2024,29.0,1995.0,11.5,14,6,2,7,5,9,14,64.3,5,6,2,4,5,19,6,0,"FW,MF",25-29,Forward,Spain,Europe
126719,Juan Bernat,ESP,Villarreal,La Liga,2024,31.0,1993.0,2.4,9,7,7,1,1,4,5,80.0,1,3,1,2,1,10,4,0,"DF,MF",30-34,Defender,Spain,Europe
495621,Antonio Blanco,ESP,Alavs,La Liga,2024,24.0,2000.0,13.1,29,19,10,18,1,14,35,40.0,21,16,5,11,23,52,20,1,MF,20-24,Midfielder,Spain,Europe
624258,Conor Bradley,NIR,Liverpool,Premier League,2024,21.0,2003.0,2.6,3,2,1,1,1,3,9,33.3,6,0,0,0,2,5,11,0,DF,20-24,Defender,Northern Ireland,Europe
741292,Iker Bravo,ESP,Udinese,Serie A,2024,19.0,2005.0,2.7,5,3,1,4,0,2,3,66.7,1,0,0,0,0,5,2,0,"FW,MF",Under 20,Forward,Spain,Europe
1063553,Pau Cabanes,ESP,Villarreal,La Liga,2024,19.0,2005.0,1.1,3,3,0,2,1,2,2,100.0,0,3,0,3,0,3,1,1,"MF,FW",Under 20,Midfielder,Spain,Europe
505674,Sergio Camello,ESP,Rayo Vallecano,La Liga,2024,23.0,2001.0,9.7,9,3,2,5,2,4,6,66.7,2,8,1,7,4,13,15,0,FW,20-24,Forward,Spain,Europe
120095,Jos Campaa,ESP,Las Palmas,La Liga,2024,31.0,1993.0,8.0,13,11,5,6,2,7,11,63.6,4,2,0,2,15,28,12,1,MF,30-34,Midfielder,Spain,Europe
251845,Sergi Cans,ESP,Valencia,La Liga,2024,27.0,1997.0,3.1,8,4,1,4,3,3,6,50.0,3,3,0,3,3,11,2,0,"MF,FW",25-29,Midfielder,Spain,Europe
678406,Sergi Cardona,ESP,Villarreal,La Liga,2024,25.0,1999.0,16.7,33,24,18,12,3,23,37,62.2,14,33,7,26,21,54,56,0,DF,25-29,Defender,Spain,Europe
596122,Pep Chavarra,ESP,Rayo Vallecano,La Liga,2024,26.0,1998.0,10.3,19,13,13,6,0,12,22,54.5,10,14,4,10,14,33,45,0,DF,25-29,Defender,Spain,Europe
380598,Santi Comesaa,ESP,Villarreal,La Liga,2024,28.0,1996.0,14.1,39,25,20,15,4,16,33,48.5,17,28,8,20,12,51,23,1,MF,25-29,Midfielder,Spain,Europe
1033005,Coba da Costa,ESP,Getafe,La Liga,2024,22.0,2002.0,2.9,7,7,1,6,0,1,7,14.3,6,3,0,3,2,9,2,0,"FW,MF",20-24,Forward,Spain,Europe
585700,Juan Cruz,ESP,Legans,La Liga,2024,24.0,2000.0,10.9,8,6,2,6,0,5,12,41.7,7,7,2,5,7,15,10,0,"FW,MF",20-24,Forward,Spain,Europe
142021,Sergi Darder,ESP,Mallorca,La Liga,2024,31.0,1993.0,13.5,24,13,11,8,5,9,20,45.0,11,8,1,7,7,31,13,1,"MF,FW",30-34,Midfielder,Spain,Europe
747009,Justin Devenny,NIR,Crystal Palace,Premier League,2024,21.0,2003.0,2.5,10,7,6,3,1,7,11,63.6,4,3,0,3,0,10,5,0,MF,20-24,Midfielder,Northern Ireland,Europe
1061282,Assane Diao,ESP,Betis,La Liga,2024,19.0,2005.0,3.1,5,3,1,3,1,4,9,44.4,5,3,0,3,0,5,3,0,FW,Under 20,Forward,Spain,Europe
905997,Pablo Durn,ESP,Celta Vigo,La Liga,2024,23.0,2001.0,3.7,3,2,0,2,1,2,5,40.0,3,1,1,0,3,6,3,0,"FW,MF",20-24,Forward,Spain,Europe
573775,Hugo Duro,ESP,Valencia,La Liga,2024,25.0,1999.0,12.6,7,5,3,3,1,2,6,33.3,4,8,1,7,6,13,6,0,FW,25-29,Forward,Spain,Europe
331496,Valery Fernndez,ESP,Mallorca,La Liga,2024,25.0,1999.0,2.5,8,7,3,2,3,5,7,71.4,2,2,1,1,0,8,1,0,"MF,FW",25-29,Midfielder,Spain,Europe
357885,Pablo Fornals,ESP,Betis,La Liga,2024,28.0,1996.0,10.9,11,7,5,5,1,4,14,28.6,10,17,0,17,14,25,8,1,"MF,FW",25-29,Midfielder,Spain,Europe
282700,Enric Franquesa,ESP,Legans,La Liga,2024,27.0,1997.0,6.8,17,9,9,6,2,9,13,69.2,4,7,1,6,5,22,12,0,"DF,FW",25-29,Defender,Spain,Europe
455181,Jorge de Frutos,ESP,Rayo Vallecano,La Liga,2024,27.0,1997.0,13.8,23,12,9,8,6,10,27,37.0,17,11,0,11,8,31,15,0,"MF,FW",25-29,Midfielder,Spain,Europe
1064403,lvaro Garca,ESP,Rayo Vallecano,La Liga,2024,32.0,1992.0,11.8,23,16,13,7,3,8,16,50.0,8,14,0,14,17,40,22,1,"FW,MF",30-34,Forward,Spain,Europe
466794,Eric Garca,ESP,Barcelona,La Liga,2024,23.0,2001.0,6.0,13,6,3,8,2,6,8,75.0,2,8,3,5,4,17,11,0,"MF,DF",20-24,Midfielder,Spain,Europe
361238,Rubn Garca,ESP,Osasuna,La Liga,2024,31.0,1993.0,11.2,27,18,11,10,6,16,27,59.3,11,17,1,16,10,37,17,0,"FW,MF",30-34,Forward,Spain,Europe
537382,Bryan Gil,ESP,Girona,La Liga,2024,23.0,2001.0,11.7,21,13,7,7,7,10,18,55.6,8,16,0,16,5,26,6,1,"FW,MF",20-24,Forward,Spain,Europe
366930,Sergio Gmez,ESP,Real Sociedad,La Liga,2024,24.0,2000.0,15.2,46,28,19,21,6,17,30,56.7,13,26,1,25,10,56,16,1,"MF,DF",20-24,Midfielder,Spain,Europe
834752,Unai Gmez,ESP,Athletic Club,La Liga,2024,21.0,2003.0,5.7,5,1,2,2,1,2,2,100.0,0,5,0,5,2,7,6,0,"MF,FW",20-24,Midfielder,Spain,Europe
289255,Andoni Gorosabel,ESP,Athletic Club,La Liga,2024,28.0,1996.0,4.9,10,2,7,2,1,6,13,46.2,7,6,1,5,3,13,18,0,DF,25-29,Defender,Spain,Europe
74294,Nemanja Gudelj,SRB,Sevilla,La Liga,2024,33.0,1991.0,15.0,26,11,8,14,4,10,13,76.9,3,15,5,10,18,44,42,0,"MF,DF",30-34,Midfielder,Serbia,Europe
495629,Hugo Guillamn,ESP,Valencia,La Liga,2024,24.0,2000.0,3.7,10,7,0,9,1,8,9,88.9,1,2,1,1,5,15,8,0,MF,20-24,Midfielder,Spain,Europe
268670,Gerard Gumbau,ESP,Rayo Vallecano,La Liga,2024,30.0,1994.0,5.0,12,10,6,5,1,6,11,54.5,5,5,3,2,3,15,9,0,MF,30-34,Midfielder,Spain,Europe
289257,Jon Guridi,ESP,Alavs,La Liga,2024,29.0,1995.0,11.4,16,9,4,10,2,7,23,30.4,16,11,0,11,8,24,6,0,MF,25-29,Midfielder,Spain,Europe
340205,Gorka Guruzeta,ESP,Athletic Club,La Liga,2024,28.0,1996.0,10.9,8,3,0,7,1,4,16,25.0,12,20,2,18,5,13,11,0,FW,25-29,Forward,Spain,Europe
418560,Erling Haaland,NOR,Manchester City,Premier League,2024,24.0,2000.0,17.0,6,4,2,2,2,1,2,50.0,1,3,0,3,3,9,15,0,FW,20-24,Forward,Norway,Europe
422466,Javi Hernndez,ESP,Legans,La Liga,2024,26.0,1998.0,12.8,18,11,9,6,3,10,27,37.0,17,15,3,12,17,35,53,0,DF,25-29,Defender,Spain,Europe
99343,Ander Herrera,ESP,Athletic Club,La Liga,2024,35.0,1989.0,3.0,8,4,1,7,0,3,6,50.0,3,1,0,1,2,10,10,0,MF,35-39,Midfielder,Spain,Europe
890290,Dean Huijsen,ESP,Bournemouth,Premier League,2024,19.0,2005.0,6.8,9,6,6,2,1,2,5,40.0,3,9,8,1,14,23,39,2,DF,Under 20,Defender,Spain,Europe
785353,Pablo Ibez,ESP,Osasuna,La Liga,2024,26.0,1998.0,6.0,8,4,4,3,1,4,14,28.6,10,11,5,6,10,18,14,0,MF,25-29,Midfielder,Spain,Europe
278359,Borja Iglesias,ESP,Celta Vigo,La Liga,2024,31.0,1993.0,10.2,5,5,1,3,1,1,6,16.7,5,5,2,3,3,8,6,0,FW,30-34,Forward,Spain,Europe
470794,Ivan Ili,SRB,Torino,Serie A,2024,23.0,2001.0,6.7,2,1,0,1,1,0,4,0.0,4,0,0,0,4,6,3,0,MF,20-24,Midfielder,Serbia,Europe
263727,Joan Jordn,ESP,Alavs,La Liga,2024,30.0,1994.0,6.8,17,10,7,8,2,7,16,43.8,9,8,0,8,4,21,9,0,MF,30-34,Midfielder,Spain,Europe
126737,Juanmi,ESP,Betis,La Liga,2024,31.0,1993.0,2.2,7,4,3,3,1,4,6,66.7,2,4,0,4,1,8,4,0,"FW,MF",30-34,Forward,Spain,Europe
53418,Kevin Kampl,SVN,RB Leipzig,Bundesliga,2024,34.0,1990.0,8.5,11,7,3,4,4,7,13,53.8,6,11,2,9,12,23,12,0,MF,30-34,Midfielder,Slovenia,Europe
74229,Koke,ESP,Atltico Madrid,La Liga,2024,32.0,1992.0,12.7,30,20,12,12,6,17,29,58.6,12,15,0,15,13,43,20,0,MF,30-34,Midfielder,Spain,Europe
337333,Alex Krl,CZE,Espanyol,La Liga,2024,26.0,1998.0,17.4,41,28,22,19,0,9,17,52.9,8,21,9,12,16,57,27,0,MF,25-29,Midfielder,Czech Republic,Europe
623521,Juanmi Latasa,ESP,Valladolid,La Liga,2024,23.0,2001.0,5.8,1,0,0,1,0,0,2,0.0,2,2,1,1,0,1,6,1,FW,20-24,Forward,Spain,Europe
70411,Darko Lazovi,SRB,Hellas Verona,Serie A,2024,34.0,1990.0,13.3,19,9,5,12,2,10,24,41.7,14,16,3,13,9,28,31,0,"FW,MF",30-34,Forward,Serbia,Europe
225873,Karol Linetty,POL,Torino,Serie A,2024,29.0,1995.0,11.9,26,18,11,15,0,14,25,56.0,11,13,5,8,7,33,19,1,MF,25-29,Midfielder,Poland,Europe
298975,Pol Lirola,ESP,Marseille,Ligue 1,2024,27.0,1997.0,4.0,8,5,4,4,0,3,9,33.3,6,4,2,2,0,8,5,0,DF,25-29,Defender,Spain,Europe
710131,Diego Llorente,ESP,Betis,La Liga,2024,31.0,1993.0,16.6,19,8,10,8,1,11,20,55.0,9,18,12,6,30,49,86,1,DF,30-34,Defender,Spain,Europe
947431,David Lpez,ESP,Girona,La Liga,2024,35.0,1989.0,16.4,19,13,12,5,2,13,23,56.5,10,16,9,7,10,29,62,1,DF,35-39,Defender,Spain,Europe
891091,Diego Lpez,ESP,Valencia,La Liga,2024,22.0,2002.0,14.3,13,9,3,7,3,7,21,33.3,14,12,0,12,4,17,4,0,"MF,FW",20-24,Midfielder,Spain,Europe
192009,Unai Lpez,ESP,Rayo Vallecano,La Liga,2024,29.0,1995.0,9.0,10,6,4,3,3,4,12,33.3,8,8,1,7,13,23,8,0,MF,25-29,Midfielder,Spain,Europe
632741,Iker Losada,ESP,Betis,La Liga,2024,23.0,2001.0,3.7,10,7,2,4,4,5,10,50.0,5,2,0,2,3,13,2,0,"MF,FW",20-24,Midfielder,Spain,Europe
268429,Sandi Lovri,SVN,Udinese,Serie A,2024,26.0,1998.0,11.2,21,11,12,6,3,10,21,47.6,11,17,2,15,14,35,12,0,MF,25-29,Midfielder,Slovenia,Europe
412045,Pol Lozano,ESP,Espanyol,La Liga,2024,25.0,1999.0,10.0,31,22,11,16,4,14,30,46.7,16,15,2,13,10,41,11,0,MF,25-29,Midfielder,Spain,Europe
251876,Pablo Maffeo,ESP,Mallorca,La Liga,2024,27.0,1997.0,12.2,26,15,19,6,1,14,20,70.0,6,15,6,9,12,38,36,1,DF,25-29,Defender,Spain,Europe
618813,Carlos Martn,ESP,Alavs,La Liga,2024,22.0,2002.0,7.2,21,10,9,8,4,5,24,20.8,19,14,1,13,2,23,9,0,"FW,MF",20-24,Forward,Spain,Europe
341278,Ivn Martn,ESP,Girona,La Liga,2024,25.0,1999.0,11.5,16,8,9,6,1,6,19,31.6,13,12,1,11,5,21,3,1,MF,25-29,Midfielder,Spain,Europe
302371,Toni Martnez,ESP,Alavs,La Liga,2024,27.0,1997.0,5.5,5,3,0,3,2,0,1,0.0,1,5,2,3,0,5,7,0,FW,25-29,Forward,Spain,Europe
227961,Jaime Mata,ESP,Las Palmas,La Liga,2024,36.0,1988.0,4.0,4,0,1,3,0,3,8,37.5,5,4,1,3,1,5,5,0,FW,35-39,Forward,Spain,Europe
309110,Brais Mndez,ESP,Real Sociedad,La Liga,2024,27.0,1997.0,11.2,16,11,5,7,4,7,16,43.8,9,9,1,8,4,20,12,1,MF,25-29,Midfielder,Spain,Europe
413507,Nikola Milenkovi,SRB,Nott'ham Forest,Premier League,2024,27.0,1997.0,16.0,17,13,11,6,0,5,6,83.3,1,23,12,11,15,32,67,0,DF,25-29,Defender,Serbia,Europe
281989,Luis Milla,ESP,Getafe,La Liga,2024,30.0,1994.0,17.8,33,23,18,13,2,17,36,47.2,19,19,0,19,14,47,13,0,MF,30-34,Midfielder,Spain,Europe
225593,Pere Milla,ESP,Espanyol,La Liga,2024,32.0,1992.0,2.5,3,1,2,0,1,0,10,0.0,10,9,2,7,2,5,2,0,"MF,FW",30-34,Midfielder,Spain,Europe
331505,scar Mingueza,ESP,Celta Vigo,La Liga,2024,25.0,1999.0,15.2,20,11,10,7,3,16,34,47.1,18,15,4,11,9,29,20,3,"MF,DF",25-29,Midfielder,Spain,Europe
341227,Juan Miranda,ESP,Bologna,Serie A,2024,24.0,2000.0,10.4,18,10,9,5,4,9,17,52.9,8,12,2,10,13,31,16,0,DF,20-24,Defender,Spain,Europe
733576,Alberto Moleiro,ESP,Las Palmas,La Liga,2024,21.0,2003.0,14.3,17,9,7,9,1,13,28,46.4,15,17,0,17,8,25,5,0,"FW,MF",20-24,Forward,Spain,Europe
552425,Jon Moncayola,ESP,Osasuna,La Liga,2024,26.0,1998.0,11.8,35,18,7,23,5,13,29,44.8,16,18,1,17,8,43,12,0,MF,25-29,Midfielder,Spain,Europe
568149,Alberto Moreno,ESP,Como,Serie A,2024,32.0,1992.0,13.2,19,9,12,7,0,9,16,56.3,7,9,1,8,11,30,23,2,DF,30-34,Defender,Spain,Europe
177467,Gerard Moreno,ESP,Villarreal,La Liga,2024,32.0,1992.0,4.2,5,4,2,1,2,3,5,60.0,2,0,0,0,2,7,1,0,FW,30-34,Forward,Spain,Europe
339816,Tete Morente,ESP,Lecce,Serie A,2024,28.0,1996.0,7.6,11,8,4,5,2,3,18,16.7,15,8,1,7,6,17,8,1,"FW,MF",25-29,Forward,Spain,Europe
646750,Cristhian Mosquera,ESP,Valencia,La Liga,2024,20.0,2004.0,16.9,14,9,9,5,0,4,9,44.4,5,18,10,8,19,33,51,1,DF,20-24,Defender,Spain,Europe
243760,lex Muoz,ESP,Las Palmas,La Liga,2024,30.0,1994.0,10.3,28,22,16,11,1,15,25,60.0,10,20,7,13,14,42,47,0,DF,30-34,Defender,Spain,Europe
15956,Jess Navas,ESP,Sevilla,La Liga,2024,39.0,1985.0,4.7,5,2,3,0,2,0,3,0.0,3,1,0,1,4,9,6,0,"FW,MF",35-39,Forward,Spain,Europe
148928,Sal guez,ESP,Sevilla,La Liga,2024,30.0,1994.0,5.2,11,8,3,5,3,2,8,25.0,6,8,1,7,7,18,9,0,MF,30-34,Midfielder,Spain,Europe
894914,Antonio Nusa,NOR,RB Leipzig,Bundesliga,2024,19.0,2005.0,11.7,21,13,11,5,5,12,27,44.4,15,13,2,11,7,28,8,0,"MF,DF",Under 20,Midfielder,Norway,Europe
166677,Brian Olivn,ESP,Espanyol,La Liga,2024,30.0,1994.0,9.1,12,9,6,6,0,4,12,33.3,8,6,2,4,7,19,19,0,DF,30-34,Defender,Spain,Europe
293385,Dani Olmo,ESP,Barcelona,La Liga,2024,26.0,1998.0,6.9,10,7,4,4,2,2,7,28.6,5,3,2,1,1,11,5,0,"MF,FW",25-29,Midfielder,Spain,Europe
634131,Aimar Oroz,ESP,Osasuna,La Liga,2024,23.0,2001.0,16.3,19,10,9,6,4,7,24,29.2,17,17,2,15,15,34,2,0,"MF,FW",20-24,Midfielder,Spain,Europe
591916,Aitor Paredes,ESP,Athletic Club,La Liga,2024,24.0,2000.0,11.4,8,7,6,2,0,4,9,44.4,5,15,7,8,15,23,67,2,DF,20-24,Defender,Spain,Europe
574671,Strahinja Pavlovi,SRB,Milan,Serie A,2024,23.0,2001.0,7.3,17,10,11,6,0,10,19,52.6,9,4,2,2,4,21,28,0,DF,20-24,Defender,Serbia,Europe
683840,Pedri,ESP,Barcelona,La Liga,2024,22.0,2002.0,15.8,28,14,7,18,3,13,38,34.2,25,23,2,21,12,40,11,1,MF,20-24,Midfielder,Spain,Europe
1004741,Pedro,ESP,Lazio,Serie A,2024,37.0,1987.0,5.2,9,5,1,5,3,5,9,55.6,4,4,0,4,1,10,2,0,"FW,MF",35-39,Forward,Spain,Europe
501418,Adri Pedrosa,ESP,Sevilla,La Liga,2024,26.0,1998.0,11.2,31,21,22,4,5,19,32,59.4,13,20,4,16,9,40,36,0,DF,25-29,Defender,Spain,Europe
238868,Rubn Pea,ESP,Osasuna,La Liga,2024,33.0,1991.0,5.0,6,0,1,1,4,1,12,8.3,11,8,0,8,4,10,7,0,"FW,MF",30-34,Forward,Spain,Europe
246968,Ayoze Prez,ESP,Villarreal,La Liga,2024,31.0,1993.0,8.2,11,7,3,6,2,3,9,33.3,6,8,0,8,2,13,7,0,FW,30-34,Forward,Spain,Europe
282810,Carles Prez,ESP,Getafe,La Liga,2024,26.0,1998.0,12.0,22,16,6,10,6,15,31,48.4,16,12,1,11,6,28,14,0,"MF,FW",25-29,Midfielder,Spain,Europe
527698,Kike Prez,ESP,Valladolid,La Liga,2024,27.0,1997.0,10.9,33,22,13,18,2,13,24,54.2,11,14,3,11,7,40,15,0,MF,25-29,Midfielder,Spain,Europe
358115,Luis Prez,ESP,Valladolid,La Liga,2024,29.0,1995.0,16.6,27,18,16,6,5,17,26,65.4,9,18,5,13,20,47,53,0,DF,25-29,Defender,Spain,Europe
553875,Pedro Porro,ESP,Tottenham,Premier League,2024,25.0,1999.0,16.0,31,22,11,13,7,20,37,54.1,17,24,9,15,18,49,42,1,DF,25-29,Defender,Spain,Europe
625047,Beat Prados,ESP,Athletic Club,La Liga,2024,23.0,2001.0,8.9,16,12,6,8,2,5,21,23.8,16,13,1,12,18,34,16,0,MF,20-24,Midfielder,Spain,Europe
408471,Javi Puado,ESP,Espanyol,La Liga,2024,26.0,1998.0,15.2,12,10,7,3,2,4,5,80.0,1,8,0,8,3,15,10,0,"FW,MF",25-29,Forward,Spain,Europe
413262,Dani Raba,ESP,Legans,La Liga,2024,29.0,1995.0,5.0,14,8,7,5,2,6,14,42.9,8,5,0,5,6,20,5,0,"FW,MF",25-29,Forward,Spain,Europe
199369,Sandro Ramrez,ESP,Las Palmas,La Liga,2024,29.0,1995.0,10.9,16,12,6,9,1,9,19,47.4,10,8,0,8,11,27,14,0,"FW,MF",25-29,Forward,Spain,Europe
249513,Diego Rico,ESP,Getafe,La Liga,2024,31.0,1993.0,16.0,41,20,23,15,3,21,37,56.8,16,14,1,13,18,59,31,1,DF,30-34,Defender,Spain,Europe
461617,Rodrigo Riquelme,ESP,Atltico Madrid,La Liga,2024,24.0,2000.0,4.5,8,3,3,5,0,4,9,44.4,5,2,0,2,1,9,3,0,"DF,MF",20-24,Defender,Spain,Europe
1255616,Alberto Risco,ESP,Getafe,La Liga,2024,19.0,2005.0,0.8,4,4,2,0,2,1,6,16.7,5,2,0,2,0,4,0,0,"MF,FW",Under 20,Midfielder,Spain,Europe
85370,Sergi Roberto,ESP,Como,Serie A,2024,32.0,1992.0,6.9,13,7,5,4,4,5,6,83.3,1,6,1,5,9,22,13,0,MF,30-34,Midfielder,Spain,Europe
834470,Dani Rodrguez,ESP,Mallorca,La Liga,2024,36.0,1988.0,11.4,25,16,11,9,5,8,10,80.0,2,9,1,8,4,29,14,0,"MF,FW",35-39,Midfielder,Spain,Europe
1076815,Javi Rodrguez,ESP,Celta Vigo,La Liga,2024,21.0,2003.0,12.7,25,16,17,8,0,14,22,63.6,8,13,1,12,19,44,44,0,DF,20-24,Defender,Spain,Europe
566574,Kirian Rodrguez,ESP,Las Palmas,La Liga,2024,28.0,1996.0,15.9,27,13,11,14,2,19,38,50.0,19,22,4,18,7,34,17,0,MF,25-29,Midfielder,Spain,Europe
709372,Carlos Romero,ESP,Espanyol,La Liga,2024,23.0,2001.0,11.7,31,21,22,8,1,17,33,51.5,16,13,2,11,8,39,34,0,"DF,MF",20-24,Defender,Spain,Europe
687609,Isaac Romero,ESP,Sevilla,La Liga,2024,24.0,2000.0,12.7,6,3,0,3,3,1,9,11.1,8,12,1,11,1,7,14,0,FW,20-24,Forward,Spain,Europe
378139,Aitor Ruibal,ESP,Betis,La Liga,2024,28.0,1996.0,6.8,12,8,7,2,3,8,14,57.1,6,9,2,7,8,20,13,0,"FW,DF",25-29,Forward,Spain,Europe
340376,Abel Ruiz,ESP,Girona,La Liga,2024,24.0,2000.0,9.3,3,1,1,1,1,2,5,40.0,3,4,1,3,2,5,3,0,FW,20-24,Forward,Spain,Europe
370789,Julian Ryerson,NOR,Dortmund,Bundesliga,2024,27.0,1997.0,10.5,16,10,12,3,1,14,21,66.7,7,11,1,10,12,28,11,1,DF,25-29,Defender,Norway,Europe
340339,Jorge Senz,ESP,Legans,La Liga,2024,28.0,1996.0,7.7,18,13,9,8,1,5,9,55.6,4,8,4,4,12,30,62,0,DF,25-29,Defender,Spain,Europe
571020,Oihan Sancet,ESP,Athletic Club,La Liga,2024,24.0,2000.0,11.2,10,6,6,3,1,4,9,44.4,5,8,0,8,5,15,4,0,MF,20-24,Midfielder,Spain,Europe
513031,Antonio Snchez,ESP,Mallorca,La Liga,2024,27.0,1997.0,8.9,15,9,11,3,1,9,19,47.4,10,11,2,9,11,26,20,0,"DF,MF",25-29,Defender,Spain,Europe
221311,Ivn Snchez,ESP,Valladolid,La Liga,2024,32.0,1992.0,8.3,18,11,9,4,5,7,16,43.8,9,10,3,7,8,26,4,0,"MF,FW",30-34,Midfielder,Spain,Europe
676042,Juanlu Snchez,ESP,Sevilla,La Liga,2024,21.0,2003.0,7.2,12,9,7,3,2,10,12,83.3,2,5,0,5,7,19,8,0,MF,20-24,Midfielder,Spain,Europe
74230,Pablo Sarabia,ESP,Wolves,Premier League,2024,32.0,1992.0,2.0,5,3,2,2,1,3,5,60.0,2,3,0,3,2,7,2,1,"MF,FW",30-34,Midfielder,Spain,Europe
674612,Youssouf Ndayishimiye,BDI,Nice,Ligue 1,2024,26.0,1998.0,6.5,16,7,12,3,1,7,11,63.6,4,8,5,3,7,23,32,1,"DF,MF",25-29,Defender,Burundi,Africa
484888,Ibrahim Sissoko,MLI,Saint-tienne,Ligue 1,2024,29.0,1995.0,8.9,11,9,5,3,3,2,5,40.0,3,9,1,8,2,13,13,0,FW,25-29,Forward,Mali,Africa
372712,Ibrahima Sissoko,MLI,Bochum,Bundesliga,2024,27.0,1997.0,13.0,31,21,16,13,2,10,20,50.0,10,15,4,11,15,46,23,0,MF,25-29,Midfielder,Mali,Africa
287920,Tim Skarke,GER,Union Berlin,Bundesliga,2024,28.0,1996.0,5.5,3,3,1,2,0,3,6,50.0,3,3,0,3,2,5,5,0,"FW,MF",25-29,Forward,Germany,Europe
406638,Oliver Skipp,ENG,Leicester City,Premier League,2024,24.0,2000.0,7.6,9,2,2,6,1,6,9,66.7,3,9,3,6,8,17,8,1,MF,20-24,Midfielder,England,Europe
93827,Steven Skrzybski,GER,Holstein Kiel,Bundesliga,2024,32.0,1992.0,6.0,9,1,1,4,4,4,9,44.4,5,9,0,9,5,14,2,0,"FW,MF",30-34,Forward,Germany,Europe
292534,Eric Smith,SWE,St. Pauli,Bundesliga,2024,27.0,1997.0,13.4,18,12,13,5,0,10,14,71.4,4,20,7,13,22,40,46,3,DF,25-29,Defender,Sweden,Europe
392765,Emile Smith Rowe,ENG,Fulham,Premier League,2024,24.0,2000.0,12.1,21,13,6,6,9,6,17,35.3,11,10,1,9,7,28,7,0,MF,20-24,Midfielder,England,Europe
507486,Simon Sohm,SUI,Parma,Serie A,2024,23.0,2001.0,14.8,14,8,4,7,3,9,19,47.4,10,5,1,4,12,26,23,0,MF,20-24,Midfielder,Switzerland,Europe
258889,Dominic Solanke,ENG,Tottenham,Premier League,2024,27.0,1997.0,13.8,11,7,1,8,2,2,6,33.3,4,8,2,6,0,11,18,0,FW,25-29,Forward,England,Europe
293194,Borna Sosa,CRO,Torino,Serie A,2024,26.0,1998.0,6.1,11,9,5,3,3,6,11,54.5,5,3,0,3,7,18,14,0,DF,25-29,Defender,Croatia,Europe
745191,Ramn Sosa,PAR,Nott'ham Forest,Premier League,2024,25.0,1999.0,1.7,3,2,2,0,1,1,2,50.0,1,3,0,3,2,5,2,0,"FW,MF",25-29,Forward,Paraguay,South America
354726,Florian Sotoca,FRA,Lens,Ligue 1,2024,34.0,1990.0,8.2,9,7,2,1,6,6,9,66.7,3,8,1,7,2,11,13,0,"FW,MF",30-34,Forward,France,Europe
568698,Issa Soumar,SEN,Le Havre,Ligue 1,2024,24.0,2000.0,6.9,4,2,0,2,2,2,8,25.0,6,5,1,4,3,7,7,0,"FW,MF",20-24,Forward,Senegal,Africa
212723,Djibril Sow,SUI,Sevilla,La Liga,2024,27.0,1997.0,8.3,5,3,2,3,0,0,3,0.0,3,4,1,3,6,11,5,0,MF,25-29,Midfielder,Switzerland,Europe
344069,Anton Stach,GER,Hoffenheim,Bundesliga,2024,26.0,1998.0,14.2,36,26,15,20,1,18,25,72.0,7,18,8,10,21,57,52,1,"DF,MF",25-29,Defender,Germany,Europe
289835,Jens Stage,DEN,Werder Bremen,Bundesliga,2024,28.0,1996.0,9.4,15,11,8,7,0,8,16,50.0,8,18,4,14,11,26,19,1,MF,25-29,Midfielder,Denmark,Europe
162434,Niklas Stark,GER,Werder Bremen,Bundesliga,2024,29.0,1995.0,9.1,15,9,9,5,1,6,9,66.7,3,21,15,6,15,30,49,0,DF,25-29,Defender,Germany,Europe
655012,Lucas Stassin,BEL,Saint-tienne,Ligue 1,2024,20.0,2004.0,5.9,5,3,1,2,2,3,5,60.0,2,4,0,4,0,5,3,0,FW,20-24,Forward,Belgium,Europe
443710,Angelo Stiller,GER,Stuttgart,Bundesliga,2024,23.0,2001.0,14.3,23,11,11,11,1,8,14,57.1,6,9,4,5,9,32,25,1,MF,20-24,Midfielder,Germany,Europe
106872,Kevin Stger,AUT,Gladbach,Bundesliga,2024,31.0,1993.0,7.8,16,9,10,3,3,8,20,40.0,12,13,1,12,6,22,13,1,"MF,FW",30-34,Midfielder,Austria,Europe
457673,Gabriel Strefezza,BRA,Como,Serie A,2024,27.0,1997.0,14.1,30,21,11,10,9,12,27,44.4,15,12,2,10,4,34,13,0,"FW,MF",25-29,Forward,Brazil,South America
59323,Cristhian Stuani,URU,Girona,La Liga,2024,38.0,1986.0,3.1,2,2,0,2,0,1,2,50.0,1,2,0,2,3,5,2,0,FW,35-39,Forward,Uruguay,South America
385105,Gabriel Suazo,CHI,Toulouse,Ligue 1,2024,27.0,1997.0,8.2,25,16,11,6,8,14,28,50.0,14,12,1,11,14,39,8,0,DF,25-29,Defender,Chile,South America
405385,Yukinari Sugawara,JPN,Southampton,Premier League,2024,24.0,2000.0,9.7,21,12,11,9,1,12,19,63.2,7,12,5,7,6,27,27,2,DF,20-24,Defender,Japan,Asia
166601,Niklas Sle,GER,Dortmund,Bundesliga,2024,29.0,1995.0,5.4,5,4,4,1,0,4,5,80.0,1,3,3,0,1,6,26,0,DF,25-29,Defender,Germany,Europe
474701,Crysencio Summerville,NED,West Ham,Premier League,2024,23.0,2001.0,7.1,13,7,2,8,3,3,8,37.5,5,10,4,6,0,13,7,0,"FW,MF",20-24,Forward,Netherlands,Europe
764859,Williot Swedberg,SWE,Celta Vigo,La Liga,2024,20.0,2004.0,7.6,8,7,3,4,1,6,8,75.0,2,8,1,7,1,9,4,1,"FW,MF",20-24,Forward,Sweden,Europe
220878,Issiaga Sylla,GUI,Montpellier,Ligue 1,2024,30.0,1994.0,7.6,19,6,14,5,0,11,21,52.4,10,8,3,5,7,26,22,0,"DF,MF",30-34,Defender,Guinea,Africa
292139,Sammie Szmodics,IRL,Ipswich Town,Premier League,2024,29.0,1995.0,9.1,12,8,2,8,2,5,16,31.3,11,8,1,7,4,16,10,0,FW,25-29,Forward,Republic of Ireland,Europe
451276,Dominik Szoboszlai,HUN,Liverpool,Premier League,2024,24.0,2000.0,12.4,14,9,5,5,4,7,17,41.2,10,22,2,20,7,21,6,0,MF,20-24,Midfielder,Hungary,Europe
203123,Haris Tabakovic,BIH,Hoffenheim,Bundesliga,2024,30.0,1994.0,3.5,1,1,0,0,1,0,1,0.0,1,2,1,1,1,2,7,0,"FW,MF",30-34,Forward,Bosnia and Herzegovina,Europe
131225,Nicols Tagliafico,ARG,Lyon,Ligue 1,2024,32.0,1992.0,7.9,27,17,9,11,7,15,20,75.0,5,11,4,7,17,44,21,0,DF,30-34,Defender,Argentina,South America
196357,Jonathan Tah,GER,Leverkusen,Bundesliga,2024,28.0,1996.0,15.0,6,5,4,1,1,3,5,60.0,2,13,8,5,15,21,50,2,DF,25-29,Defender,Germany,Europe
564545,Edmond Tapsoba,BFA,Leverkusen,Bundesliga,2024,25.0,1999.0,14.9,26,17,13,10,3,12,24,50.0,12,7,5,2,13,39,46,0,DF,25-29,Defender,Burkina Faso,Africa
173504,James Tarkowski,ENG,Everton,Premier League,2024,32.0,1992.0,15.9,36,22,20,14,2,17,28,60.7,11,27,22,5,15,51,92,2,DF,30-34,Defender,England,Europe
535955,Nuno Tavares,POR,Lazio,Serie A,2024,24.0,2000.0,10.8,19,16,9,6,4,9,20,45.0,11,7,1,6,11,30,29,1,DF,20-24,Defender,Portugal,Europe
458178,Jack Taylor,IRL,Ipswich Town,Premier League,2024,26.0,1998.0,3.7,5,1,2,3,0,3,8,37.5,5,3,1,2,3,8,12,0,MF,25-29,Midfielder,Republic of Ireland,Europe
607226,Loum Tchaouna,FRA,Lazio,Serie A,2024,21.0,2003.0,3.0,5,3,1,1,3,3,7,42.9,4,1,0,1,3,8,1,1,"FW,MF",20-24,Forward,France,Europe
848509,Jackson Tchatchoua,CMR,Hellas Verona,Serie A,2024,23.0,2001.0,15.4,26,13,18,5,3,19,26,73.1,7,14,7,7,8,34,32,0,"DF,MF",20-24,Defender,Cameroon,Africa
842338,Enzo Tchato,CMR,Montpellier,Ligue 1,2024,22.0,2002.0,10.8,21,12,13,7,1,12,24,50.0,12,18,5,13,14,35,29,0,DF,20-24,Defender,Cameroon,Africa
413112,Aurlien Tchouamni,FRA,Real Madrid,La Liga,2024,24.0,2000.0,13.2,24,11,11,12,1,9,19,47.4,10,11,9,2,24,48,20,0,"MF,DF",20-24,Midfielder,France,Europe
340322,Nathan Tella,NGA,Leverkusen,Bundesliga,2024,25.0,1999.0,4.7,4,3,1,2,1,2,6,33.3,4,5,0,5,2,6,1,0,"MF,FW",25-29,Midfielder,Nigeria,Africa
533568,Nahuel Tenaglia,ARG,Alavs,La Liga,2024,28.0,1996.0,14.3,39,25,28,8,3,21,33,63.6,12,9,2,7,14,53,44,0,DF,25-29,Defender,Argentina,South America
464598,Casper Tengstedt,DEN,Hellas Verona,Serie A,2024,24.0,2000.0,11.0,6,4,0,4,2,3,5,60.0,2,4,1,3,3,9,20,0,"FW,MF",20-24,Forward,Denmark,Europe
631007,Filippo Terracciano,ITA,Milan,Serie A,2024,21.0,2003.0,5.0,6,3,1,3,2,3,6,50.0,3,0,0,0,4,10,6,0,"DF,MF",20-24,Defender,Italy,Europe
206746,Kenny Tete,NED,Fulham,Premier League,2024,29.0,1995.0,14.0,41,27,20,12,9,17,28,60.7,11,19,6,13,28,69,36,0,DF,25-29,Defender,Netherlands,Europe
409153,Teddy Teuma,MLT,Reims,Ligue 1,2024,31.0,1993.0,3.2,7,4,1,4,2,4,11,36.4,7,6,1,5,5,12,4,0,MF,30-34,Midfielder,Malta,Europe
364245,Jordan Teze,NED,Monaco,Ligue 1,2024,25.0,1999.0,3.4,10,5,6,3,1,3,9,33.3,6,9,1,8,2,12,4,0,DF,25-29,Defender,Netherlands,Europe
184892,Florian Thauvin,FRA,Udinese,Serie A,2024,31.0,1993.0,11.2,12,10,6,4,2,7,15,46.7,8,5,0,5,5,17,6,0,"FW,MF",30-34,Forward,France,Europe
368891,Arthur Theate,BEL,Eint Frankfurt,Bundesliga,2024,24.0,2000.0,13.6,18,11,7,10,1,8,19,42.1,11,23,10,13,21,39,61,1,DF,20-24,Defender,Belgium,Europe
475416,Sorba Thomas,WAL,Nantes,Ligue 1,2024,25.0,1999.0,7.2,8,4,3,4,1,5,9,55.6,4,8,0,8,2,10,10,1,FW,25-29,Forward,Wales,Europe
215977,Adrien Thomasson,FRA,Lens,Ligue 1,2024,31.0,1993.0,13.4,48,27,21,16,11,29,51,56.9,22,20,1,19,11,59,20,0,MF,30-34,Midfielder,France,Europe
463618,Khphren Thuram,FRA,Juventus,Serie A,2024,23.0,2001.0,9.1,14,6,4,10,0,8,11,72.7,3,7,2,5,5,19,20,0,MF,20-24,Midfielder,France,Europe
249565,Youri Tielemans,BEL,Aston Villa,Premier League,2024,27.0,1997.0,16.3,38,25,15,20,3,18,33,54.5,15,12,6,6,15,53,16,2,MF,25-29,Midfielder,Belgium,Europe
288340,Phillip Tietz,GER,Augsburg,Bundesliga,2024,27.0,1997.0,11.0,10,5,2,6,2,5,8,62.5,3,5,1,4,3,13,14,0,FW,25-29,Forward,Germany,Europe
190393,Corentin Tolisso,FRA,Lyon,Ligue 1,2024,30.0,1994.0,10.6,24,11,12,8,4,9,23,39.1,14,18,5,13,9,33,16,1,MF,30-34,Midfielder,France,Europe
616344,Tiago Toms,POR,Wolfsburg,Bundesliga,2024,22.0,2002.0,11.4,12,8,5,3,4,6,18,33.3,12,7,1,6,6,18,6,0,"FW,MF",20-24,Forward,Portugal,Europe
397033,Sandro Tonali,ITA,Newcastle Utd,Premier League,2024,24.0,2000.0,9.2,18,12,7,11,0,8,15,53.3,7,12,5,7,17,35,11,1,MF,20-24,Midfielder,Italy,Europe
530902,Abdoulaye Tour,GUI,Le Havre,Ligue 1,2024,30.0,1994.0,12.9,31,15,17,10,4,18,26,69.2,8,17,10,7,19,50,20,2,MF,30-34,Midfielder,Guinea,Africa
353948,Lucas Tousart,FRA,Union Berlin,Bundesliga,2024,27.0,1997.0,1.7,2,1,0,2,0,0,2,0.0,2,3,1,2,2,4,2,0,MF,25-29,Midfielder,France,Europe
388294,Omar Traor,GER,Heidenheim,Bundesliga,2024,26.0,1998.0,12.3,21,15,14,7,0,12,15,80.0,3,14,2,12,10,31,26,0,"DF,FW",25-29,Defender,Germany,Europe
75921,Christopher Trimmel,AUT,Union Berlin,Bundesliga,2024,37.0,1987.0,8.5,19,14,11,7,1,16,25,64.0,9,5,1,4,8,27,27,0,"DF,MF",35-39,Defender,Austria,Europe
144028,Leandro Trossard,BEL,Arsenal,Premier League,2024,30.0,1994.0,10.2,14,10,3,8,3,7,17,41.2,10,12,0,12,7,21,10,0,FW,30-34,Forward,Belgium,Europe
654539,Adrien Truffert,FRA,Rennes,Ligue 1,2024,23.0,2001.0,11.6,25,11,12,8,5,16,22,72.7,6,16,2,14,8,33,22,0,"DF,MF",20-24,Defender,France,Europe
546213,Tuta,BRA,Eint Frankfurt,Bundesliga,2024,25.0,1999.0,12.5,26,16,14,10,2,18,26,69.2,8,22,13,9,21,47,73,0,"DF,MF",25-29,Defender,Brazil,South America
556385,Destiny Udogie,ITA,Tottenham,Premier League,2024,22.0,2002.0,14.5,44,28,25,12,7,23,34,67.6,11,24,2,22,16,60,25,1,DF,20-24,Defender,Italy,Europe
787151,Lukas Ullrich,GER,Gladbach,Bundesliga,2024,20.0,2004.0,6.1,3,1,2,0,1,2,7,28.6,5,11,3,8,7,10,20,0,DF,20-24,Defender,Germany,Europe
251106,Enes nal,TUR,Bournemouth,Premier League,2024,27.0,1997.0,2.7,1,0,0,0,1,0,2,0.0,2,1,0,1,0,1,4,0,"FW,MF",25-29,Forward,Turkey,Asia
339314,Deniz Undav,GER,Stuttgart,Bundesliga,2024,28.0,1996.0,7.1,4,4,1,1,2,0,5,0.0,5,3,0,3,3,7,3,0,"FW,MF",25-29,Forward,Germany,Europe
344695,Dayot Upamecano,FRA,Bayern Munich,Bundesliga,2024,26.0,1998.0,13.9,21,14,9,10,2,12,23,52.2,11,13,6,7,22,43,31,1,DF,25-29,Defender,France,Europe
816585,Can Uzun,TUR,Eint Frankfurt,Bundesliga,2024,19.0,2005.0,2.7,5,2,1,2,2,4,6,66.7,2,5,0,5,0,5,1,0,"MF,FW",Under 20,Midfielder,Turkey,Asia
448258,Josha Vagnoman,GER,Stuttgart,Bundesliga,2024,24.0,2000.0,12.1,11,5,8,3,0,8,15,53.3,7,8,2,6,9,20,29,0,"DF,MF",20-24,Defender,Germany,Europe
445126,Emanuele Valeri,ITA,Parma,Serie A,2024,26.0,1998.0,12.0,19,9,13,4,2,14,20,70.0,6,13,5,8,13,32,33,1,DF,25-29,Defender,Italy,Europe
369081,Federico Valverde,URU,Real Madrid,La Liga,2024,26.0,1998.0,17.3,27,17,12,13,2,15,21,71.4,6,25,4,21,35,62,21,1,"MF,DF",25-29,Midfielder,Uruguay,South America
139208,Virgil van Dijk,NED,Liverpool,Premier League,2024,33.0,1991.0,16.0,17,8,9,7,1,6,11,54.5,5,12,4,8,30,47,70,2,DF,30-34,Defender,Netherlands,Europe
789082,Vanderson,BRA,Monaco,Ligue 1,2024,23.0,2001.0,10.4,36,20,17,15,4,21,29,72.4,8,21,5,16,24,60,21,1,DF,20-24,Defender,Brazil,South America
197838,Jamie Vardy,ENG,Leicester City,Premier League,2024,37.0,1987.0,14.2,5,5,2,3,0,1,5,20.0,4,4,2,2,1,6,13,0,FW,35-39,Forward,England,Europe
532937,Johan Vsquez,MEX,Genoa,Serie A,2024,26.0,1998.0,14.5,19,10,6,10,3,5,16,31.3,11,24,15,9,21,40,57,1,DF,25-29,Defender,Mexico,North America
239962,Denis Vavro,SVK,Wolfsburg,Bundesliga,2024,28.0,1996.0,10.0,4,3,4,0,0,3,8,37.5,5,13,7,6,10,14,80,1,DF,25-29,Defender,Slovakia,Europe
164771,Jordan Veretout,FRA,Lyon,Ligue 1,2024,31.0,1993.0,9.1,12,6,5,6,1,6,19,31.6,13,9,2,7,1,13,11,0,MF,30-34,Midfielder,France,Europe
409517,Yorbe Vertessen,BEL,Union Berlin,Bundesliga,2024,23.0,2001.0,7.4,6,3,3,2,1,2,6,33.3,4,6,0,6,3,9,6,0,"MF,FW",20-24,Midfielder,Belgium,Europe
85393,Nicolas Viola,ITA,Cagliari,Serie A,2024,35.0,1989.0,5.3,5,5,1,4,0,0,4,0.0,4,1,0,1,2,7,2,0,"MF,FW",35-39,Midfielder,Italy,Europe
586853,Vitinha,POR,Genoa,Serie A,2024,24.0,2000.0,7.0,11,5,4,3,4,5,17,29.4,12,7,1,6,6,17,8,0,FW,20-24,Forward,Portugal,Europe
293200,Nikola Vlai,CRO,Torino,Serie A,2024,27.0,1997.0,6.2,19,12,7,8,4,7,12,58.3,5,6,2,4,6,25,6,0,"MF,FW",25-29,Midfielder,Croatia,Europe
330208,Alessandro Vogliacco,ITA,Genoa,Serie A,2024,26.0,1998.0,7.9,15,3,7,7,1,10,12,83.3,2,11,7,4,9,24,20,0,DF,25-29,Defender,Italy,Europe
111196,Stefan de Vrij,NED,Inter,Serie A,2024,32.0,1992.0,7.9,8,5,5,2,1,3,5,60.0,2,7,4,3,6,14,29,0,DF,30-34,Defender,Netherlands,Europe
659542,Elye Wahi,FRA,Marseille,Ligue 1,2024,21.0,2003.0,6.0,0,0,0,0,0,0,4,0.0,4,1,0,1,1,1,0,0,FW,20-24,Forward,France,Europe
154147,Hauke Wahl,GER,St. Pauli,Bundesliga,2024,30.0,1994.0,15.0,19,13,12,6,1,10,15,66.7,5,15,10,5,13,32,59,3,DF,30-34,Defender,Germany,Europe
95424,Kyle Walker,ENG,Manchester City,Premier League,2024,34.0,1990.0,10.2,17,10,7,7,3,14,25,56.0,11,13,4,9,3,20,11,1,DF,30-34,Defender,England,Europe
341051,Kyle Walker-Peters,ENG,Southampton,Premier League,2024,27.0,1997.0,14.9,20,13,12,5,3,9,19,47.4,10,15,7,8,11,31,43,0,DF,25-29,Defender,England,Europe
477758,Aaron Wan-Bissaka,ENG,West Ham,Premier League,2024,27.0,1997.0,15.0,30,22,15,13,2,11,14,78.6,3,13,5,8,27,57,49,0,DF,25-29,Defender,England,Europe
900909,Paul Wanner,GER,Heidenheim,Bundesliga,2024,19.0,2005.0,11.7,26,16,10,16,0,10,20,50.0,10,7,0,7,3,29,11,0,"MF,FW",Under 20,Midfielder,Germany,Europe
324358,Ollie Watkins,ENG,Aston Villa,Premier League,2024,28.0,1995.0,12.6,5,3,0,3,2,1,6,16.7,5,7,1,6,2,7,3,0,FW,25-29,Forward,England,Europe
370846,Timothy Weah,USA,Juventus,Serie A,2024,24.0,2000.0,7.7,10,5,2,5,3,4,8,50.0,4,7,1,6,4,14,5,0,FW,20-24,Forward,United States,North America
196792,Julian Weigl,GER,Gladbach,Bundesliga,2024,29.0,1995.0,13.5,22,7,16,4,2,12,16,75.0,4,18,9,9,27,49,29,0,MF,25-29,Midfielder,Germany,Europe
67063,Danny Welbeck,ENG,Brighton,Premier League,2024,34.0,1990.0,12.4,11,6,3,7,1,3,10,30.0,7,11,1,10,4,15,8,0,FW,30-34,Forward,England,Europe
170527,Timo Werner,GER,Tottenham,Premier League,2024,28.0,1996.0,4.5,3,2,2,1,0,2,10,20.0,8,10,1,9,1,4,6,0,"FW,MF",25-29,Forward,Germany,Europe
744149,Adam Wharton,ENG,Crystal Palace,Premier League,2024,20.0,2004.0,6.9,18,10,9,9,0,9,26,34.6,17,5,0,5,10,28,13,0,MF,20-24,Midfielder,England,Europe
335721,Ben White,ENG,Arsenal,Premier League,2024,27.0,1997.0,7.7,10,6,8,1,1,9,21,42.9,12,6,5,1,11,21,23,0,DF,25-29,Defender,England,Europe
255508,Iaki Williams,GHA,Athletic Club,La Liga,2024,30.0,1994.0,16.3,13,6,4,8,1,9,16,56.3,7,14,2,12,9,22,15,0,FW,30-34,Forward,Ghana,Africa
503680,Neco Williams,WAL,Nott'ham Forest,Premier League,2024,23.0,2001.0,8.2,24,14,20,4,0,13,24,54.2,11,12,2,10,5,29,34,0,DF,20-24,Defender,Wales,Europe
340329,Joe Willock,ENG,Newcastle Utd,Premier League,2024,25.0,1999.0,5.8,13,9,5,5,3,9,14,64.3,5,11,1,10,3,16,5,0,"MF,FW",25-29,Midfielder,England,Europe
279455,Harry Wilson,WAL,Fulham,Premier League,2024,27.0,1997.0,4.7,5,3,4,1,0,2,5,40.0,3,6,0,6,3,8,2,1,"FW,MF",25-29,Forward,Wales,Europe
533295,Patrick Wimmer,AUT,Wolfsburg,Bundesliga,2024,23.0,2001.0,7.1,15,10,7,6,2,6,12,50.0,6,10,1,9,9,24,4,0,"MF,FW",20-24,Midfielder,Austria,Europe
391004,Jonas Wind,DEN,Wolfsburg,Bundesliga,2024,25.0,1999.0,7.3,2,2,0,2,0,1,3,33.3,2,7,2,5,3,5,4,0,"MF,FW",25-29,Midfielder,Denmark,Europe
249126,Harry Winks,ENG,Leicester City,Premier League,2024,28.0,1996.0,10.1,14,8,6,6,2,7,15,46.7,8,10,4,6,4,18,14,0,MF,25-29,Midfielder,England,Europe
598577,Florian Wirtz,GER,Leverkusen,Bundesliga,2024,21.0,2003.0,13.4,18,10,6,8,4,6,13,46.2,7,17,1,16,8,26,1,0,MF,20-24,Midfielder,Germany,Europe
388165,Yoane Wissa,COD,Brentford,Premier League,2024,28.0,1996.0,11.6,3,2,0,1,2,0,5,0.0,5,6,1,5,3,6,4,0,FW,25-29,Forward,DR Congo,Africa
340459,Dani de Wit,NED,Bochum,Bundesliga,2024,26.0,1998.0,7.6,15,10,6,8,1,9,17,52.9,8,10,3,7,7,22,13,1,"MF,FW",25-29,Midfielder,Netherlands,Europe
455661,Nick Woltemade,GER,Stuttgart,Bundesliga,2024,22.0,2002.0,4.1,1,1,0,1,0,0,1,0.0,1,5,0,5,0,1,4,0,"FW,MF",20-24,Forward,Germany,Europe
108725,Chris Wood,NZL,Nott'ham Forest,Premier League,2024,33.0,1991.0,14.7,1,1,0,0,1,1,5,20.0,4,5,3,2,4,5,12,0,FW,30-34,Forward,New Zealand,Oceania
572326,Christopher Wooh,CMR,Rennes,Ligue 1,2024,23.0,2001.0,9.8,26,12,15,9,2,14,19,73.7,5,17,7,10,11,37,35,0,DF,20-24,Defender,Cameroon,Africa
111455,Granit Xhaka,SUI,Leverkusen,Bundesliga,2024,32.0,1992.0,15.0,18,10,4,12,2,9,17,52.9,8,12,4,8,3,21,15,0,MF,30-34,Midfielder,Switzerland,Europe
425902,Ryan Yates,ENG,Nott'ham Forest,Premier League,2024,27.0,1997.0,13.5,28,15,17,8,3,10,19,52.6,9,18,1,17,18,46,36,1,MF,25-29,Midfielder,England,Europe
439914,John Yeboah,ECU,Venezia,Serie A,2024,24.0,2000.0,2.8,3,3,1,1,1,0,6,0.0,6,2,0,2,2,5,0,0,"MF,FW",20-24,Midfielder,Ecuador,South America
672803,Bertu Yldrm,TUR,Getafe,La Liga,2024,22.0,2002.0,8.9,6,3,0,5,1,1,5,20.0,4,8,1,7,1,7,11,0,FW,20-24,Forward,Turkey,Asia
845654,Kenan Yldz,TUR,Juventus,Serie A,2024,19.0,2005.0,13.4,31,19,8,15,8,8,13,61.5,5,12,0,12,2,33,5,0,"FW,MF",Under 20,Forward,Turkey,Asia
14086,Ashley Young,ENG,Everton,Premier League,2024,39.0,1985.0,13.3,43,23,21,18,4,26,41,63.4,15,6,2,4,18,61,43,0,DF,35-39,Defender,England,Europe
1047097,Yoram Zague,FRA,Paris S-G,Ligue 1,2024,18.0,2006.0,1.8,4,3,2,1,1,2,3,66.7,1,2,0,2,2,6,2,0,DF,Under 20,Defender,France,Europe
810092,Warren Zare-Emery,FRA,Paris S-G,Ligue 1,2024,18.0,2006.0,12.6,32,14,10,14,8,14,27,51.9,13,22,3,19,13,45,15,2,"MF,DF",Under 20,Midfielder,France,Europe
334526,Denis Zakaria,SUI,Monaco,Ligue 1,2024,28.0,1996.0,9.3,12,8,5,5,2,7,11,63.6,4,10,4,6,14,26,22,0,MF,25-29,Midfielder,Switzerland,Europe
216872,Francesco Zampano,ITA,Venezia,Serie A,2024,31.0,1993.0,14.0,22,15,12,8,2,10,22,45.5,12,17,0,17,5,27,20,2,DF,30-34,Defender,Italy,Europe
392085,Nicol Zaniolo,ITA,Atalanta,Serie A,2024,25.0,1999.0,3.1,0,0,0,0,0,0,1,0.0,1,0,0,0,0,0,0,0,"FW,MF",25-29,Forward,Italy,Europe
397225,Alessandro Zanoli,ITA,Genoa,Serie A,2024,24.0,2000.0,10.1,20,14,7,11,2,6,10,60.0,4,7,2,5,5,25,24,0,"DF,FW",20-24,Defender,Italy,Europe
73794,Duvn Zapata,COL,Torino,Serie A,2024,33.0,1991.0,6.5,7,5,2,0,5,0,3,0.0,3,2,1,1,2,9,7,0,FW,30-34,Forward,Colombia,South America
392569,Gabriele Zappa,ITA,Cagliari,Serie A,2024,25.0,1999.0,16.5,21,12,11,9,1,10,16,62.5,6,22,12,10,10,31,45,0,DF,25-29,Defender,Italy,Europe
173859,Davide Zappacosta,ITA,Atalanta,Serie A,2024,32.0,1992.0,8.6,6,4,3,2,1,6,13,46.2,7,9,1,8,2,8,7,0,DF,30-34,Defender,Italy,Europe
491296,Anass Zaroury,MAR,Lens,Ligue 1,2024,24.0,2000.0,7.1,7,6,0,5,2,3,12,25.0,9,5,0,5,0,7,4,0,"FW,MF",20-24,Forward,Morocco,Africa
633530,Jordan Zemura,ZIM,Udinese,Serie A,2024,25.0,1999.0,10.2,20,10,10,7,3,10,18,55.6,8,13,3,10,13,33,27,0,DF,25-29,Defender,Zimbabwe,Africa
435648,Joshua Zirkzee,NED,Manchester Utd,Premier League,2024,23.0,2001.0,7.3,4,1,3,1,0,3,3,100.0,0,7,2,5,2,6,2,0,"FW,MF",20-24,Forward,Netherlands,Europe
392966,Nadir Zortea,ITA,Cagliari,Serie A,2024,25.0,1999.0,10.5,14,6,6,7,1,7,14,50.0,7,2,0,2,5,19,17,2,"DF,FW",25-29,Defender,Italy,Europe
431811,Ola Solbakken,NOR,Empoli,Serie A,2024,26.0,1998.0,6.6,5,3,0,5,0,2,4,50.0,2,0,0,0,2,7,8,0,"MF,FW",25-29,Midfielder,Norway,Europe
372246,Carlos Soler,ESP,West Ham,Premier League,2024,27.0,1997.0,6.7,6,6,3,3,0,2,13,15.4,11,11,3,8,2,8,6,0,MF,25-29,Midfielder,Spain,Europe
429983,Jrgen Strand Larsen,NOR,Wolves,Premier League,2024,24.0,2000.0,15.5,4,4,1,2,1,1,18,5.6,17,14,3,11,4,8,16,0,FW,20-24,Forward,Norway,Europe
165007,Denis Surez,ESP,Villarreal,La Liga,2024,30.0,1994.0,2.6,3,2,2,0,1,2,3,66.7,1,2,1,1,1,4,1,0,"MF,DF",30-34,Midfielder,Spain,Europe
111961,Suso,ESP,Sevilla,La Liga,2024,31.0,1993.0,1.6,1,0,1,0,0,1,4,25.0,3,0,0,0,0,1,0,0,"FW,MF",30-34,Forward,Spain,Europe
238407,Alexander Srloth,NOR,Atltico Madrid,La Liga,2024,29.0,1995.0,8.7,4,1,0,2,2,1,2,50.0,1,4,1,3,0,4,14,0,FW,25-29,Forward,Norway,Europe
707274,Csar Trrega,ESP,Valencia,La Liga,2024,22.0,2002.0,13.6,17,13,10,6,1,5,11,45.5,6,12,6,6,8,25,64,1,DF,20-24,Defender,Spain,Europe
290273,lvaro Tejero,ESP,Espanyol,La Liga,2024,28.0,1996.0,9.6,9,3,4,4,1,3,13,23.1,10,7,0,7,8,17,22,1,"MF,DF",25-29,Midfielder,Spain,Europe
226524,Morten Thorsby,NOR,Genoa,Serie A,2024,28.0,1996.0,11.0,25,19,10,10,5,8,16,50.0,8,11,1,10,4,29,13,0,MF,25-29,Midfielder,Norway,Europe
720038,Pablo Torre,ESP,Barcelona,La Liga,2024,21.0,2003.0,2.8,5,4,1,3,1,2,2,100.0,0,0,0,0,1,6,4,1,"MF,FW",20-24,Midfielder,Spain,Europe
399776,Pau Torres,ESP,Aston Villa,Premier League,2024,27.0,1997.0,16.0,17,12,10,6,1,9,12,75.0,3,11,7,4,6,23,42,2,DF,25-29,Defender,Spain,Europe
213670,Lucas Torr,ESP,Osasuna,La Liga,2024,30.0,1994.0,16.5,39,23,12,27,0,19,38,50.0,19,23,4,19,25,64,37,3,MF,30-34,Midfielder,Spain,Europe
364405,Adama Traor,ESP,Fulham,Premier League,2024,28.0,1996.0,9.4,9,5,6,2,1,3,8,37.5,5,5,0,5,1,10,4,1,"FW,MF",25-29,Forward,Spain,Europe
634431,Beat Turrientes,ESP,Real Sociedad,La Liga,2024,22.0,2002.0,6.2,11,3,4,6,1,3,7,42.9,4,12,2,10,4,15,6,0,MF,20-24,Midfielder,Spain,Europe
699442,Kacper Urbanski,POL,Bologna,Serie A,2024,20.0,2004.0,2.7,5,2,4,0,1,4,6,66.7,2,5,1,4,2,7,5,0,MF,20-24,Midfielder,Poland,Europe
517753,scar Valentn,ESP,Rayo Vallecano,La Liga,2024,30.0,1994.0,13.2,36,28,14,14,8,20,40,50.0,20,23,3,20,18,54,38,0,MF,30-34,Midfielder,Spain,Europe
221316,Lucas Vzquez,ESP,Real Madrid,La Liga,2024,33.0,1991.0,9.8,27,16,17,7,3,12,25,48.0,13,6,1,5,4,31,13,0,DF,30-34,Defender,Spain,Europe
540536,Carlos Vicente,ESP,Alavs,La Liga,2024,25.0,1999.0,16.7,17,12,11,3,3,10,17,58.8,7,12,1,11,5,22,15,0,"FW,MF",25-29,Forward,Spain,Europe
357498,Duan Vlahovi,SRB,Juventus,Serie A,2024,24.0,2000.0,13.8,2,1,0,1,1,1,2,50.0,1,5,3,2,1,3,8,1,FW,20-24,Forward,Serbia,Europe
709187,Nico Williams,ESP,Athletic Club,La Liga,2024,22.0,2002.0,13.8,23,14,8,9,6,8,21,38.1,13,11,0,11,5,28,5,0,FW,20-24,Forward,Spain,Europe
937958,Lamine Yamal,ESP,Barcelona,La Liga,2024,17.0,2007.0,14.2,22,16,2,10,10,6,13,46.2,7,7,0,7,9,31,3,0,FW,Under 20,Forward,Spain,Europe
713644,Bryan Zaragoza,ESP,Osasuna,La Liga,2024,23.0,2001.0,11.7,11,8,8,2,1,4,16,25.0,12,7,0,7,0,11,8,0,"FW,MF",20-24,Forward,Spain,Europe
181136,Piotr Zieliski,POL,Inter,Serie A,2024,30.0,1994.0,3.7,8,6,3,4,1,3,8,37.5,5,1,0,1,0,8,1,0,MF,30-34,Midfielder,Poland,Europe
355628,Igor Zubeldia,ESP,Real Sociedad,La Liga,2024,27.0,1997.0,15.4,21,16,13,7,1,12,20,60.0,8,22,14,8,16,37,55,2,DF,25-29,Defender,Spain,Europe
163222,Grgoire Defrel,MTQ,Sampdoria,Serie A,2018,27.0,1991.0,26.0,40,29,10,16,14,9,21,42.9,12,15,0,15,3,43,9,0,"FW,MF",25-29,Forward,France,Europe
337036,Florent Muslija,KVX,Hannover 96,Bundesliga,2018,20.0,1998.0,7.5,16,10,8,6,2,8,12,66.7,4,4,0,4,3,19,4,0,"MF,FW",20-24,Midfielder,Germany,Europe
163222,Grgoire Defrel,MTQ,Sassuolo,Serie A,2021,30.0,1991.0,15.1,15,9,4,8,3,6,16,37.5,10,11,1,10,4,19,11,0,FW,30-34,Forward,France,Europe
232320,Atakan Karazor,Trkiye,Stuttgart,Bundesliga,2021,24.0,1996.0,21.1,48,24,18,27,3,18,36,50.0,18,37,14,23,34,82,47,0,MF,20-24,Midfielder,Germany,Europe
351843,Yoann Salmier,GUF,Troyes,Ligue 1,2021,28.0,1992.0,29.6,58,33,44,11,3,26,34,76.5,8,30,14,16,40,98,94,0,DF,25-29,Defender,France,Europe
336125,Mrgim Vojvoda,KVX,Torino,Serie A,2021,26.0,1995.0,22.0,38,23,23,11,4,20,36,55.6,16,27,8,19,20,58,51,0,DF,25-29,Defender,Germany,Europe
496857,Edon Zhegrova,KVX,Lille,Ligue 1,2021,22.0,1999.0,5.3,14,5,2,8,4,5,6,83.3,1,4,1,3,2,16,2,0,"MF,FW",20-24,Midfielder,Germany,Europe
232320,Atakan Karazor,Trkiye,Stuttgart,Bundesliga,2024,28.0,1996.0,11.7,24,9,5,12,7,14,25,56.0,11,13,1,12,13,37,12,1,MF,25-29,Midfielder,Germany,Europe
337036,Florent Muslija,KVX,Freiburg,Bundesliga,2024,26.0,1998.0,1.9,5,4,3,1,1,2,2,100.0,0,0,0,0,1,6,1,0,"FW,MF",25-29,Forward,Germany,Europe
496857,Edon Zhegrova,KVX,Lille,Ligue 1,2024,25.0,1999.0,10.9,5,2,3,0,2,2,7,28.6,5,8,0,8,4,9,1,0,"FW,MF",25-29,Forward,Germany,Europe
